appid;name;genre;owners;positive;negative;overall;average_forever;median_forever;ccu
10;Counter-Strike;Action;10,000,000 - 20,000,000;210400;5371;205029;11455;174;15061
20;Team Fortress Classic;Action;5,000,000 - 10,000,000;6150;963;5187;1358;16;94
30;Day of Defeat;Action;5,000,000 - 10,000,000;5470;602;4868;1269;22;146
40;Deathmatch Classic;Action;5,000,000 - 10,000,000;2086;467;1619;1245;8;9
50;Half-Life: Opposing Force;Action;5,000,000 - 10,000,000;16082;813;15269;1046;172;142
60;Ricochet;Action;5,000,000 - 10,000,000;4077;903;3174;1394;4;11
70;Half-Life;Action;10,000,000 - 20,000,000;81565;2899;78666;947;184;766
80;Counter-Strike: Condition Zero;Action;5,000,000 - 10,000,000;20429;1948;18481;861;34;570
100;Counter-Strike: Condition Zero;Action;10,000,000 - 20,000,000;13442;1535;11907;342;37;52
130;Half-Life: Blue Shift;Action;5,000,000 - 10,000,000;11544;1056;10488;1126;78;59
220;Half-Life 2;Action;5,000,000 - 10,000,000;155138;3942;151196;706;347;1165
240;Counter-Strike: Source;Action;10,000,000 - 20,000,000;144615;5645;138970;7586;405;4894
280;Half-Life: Source;Action;2,000,000 - 5,000,000;8949;3599;5350;357;70;65
300;Day of Defeat: Source;Action;5,000,000 - 10,000,000;17524;1653;15871;606;142;576
320;Half-Life 2: Deathmatch;Action;10,000,000 - 20,000,000;10342;1097;9245;565;46;237
340;Half-Life 2: Lost Coast;Action;20,000,000 - 50,000,000;10003;1290;8713;68;22;21
360;Half-Life Deathmatch: Source;Action;5,000,000 - 10,000,000;2594;903;1691;119;23;10
380;Half-Life 2: Episode One;Action;2,000,000 - 5,000,000;22890;1027;21863;269;187;159
400;Portal;Action;10,000,000 - 20,000,000;122081;1886;120195;308;167;543
420;Half-Life 2: Episode Two;Action, Free to Play;5,000,000 - 10,000,000;31864;972;30892;452;273;264
440;Team Fortress 2;Action;50,000,000 - 100,000,000;878114;58371;819743;8571;360;99742
500;Left 4 Dead;Action;2,000,000 - 5,000,000;44482;1728;42754;1550;142;615
550;Left 4 Dead 2;Action, Free to Play, Strategy;20,000,000 - 50,000,000;692897;17659;675238;2063;516;28738
570;Dota 2;Action, Adventure;200,000,000 - 500,000,000;1598261;333977;1264284;38977;915;512487
620;Portal 2;Action;10,000,000 - 20,000,000;324677;4013;320664;880;548;2547
630;Alien Swarm;Action, Free to Play;2,000,000 - 5,000,000;19445;1051;18394;443;120;63
730;Counter-Strike: Global Offensive;;50,000,000 - 100,000,000;6143194;806960;5336234;29182;6139;1097985
852;ValveTestApp852;Indie;0 - 20,000;0;0;0;0;0;0
1002;Rag Doll Kung Fu;Action;20,000 - 50,000;62;24;38;424;424;0
1200;Red Orchestra: Ostfront 41-45;Action;500,000 - 1,000,000;1982;301;1681;504;252;25
1250;Killing Floor;Action;2,000,000 - 5,000,000;61045;3237;57808;1512;338;339
1300;SiN Episodes: Emergence;Action;100,000 - 200,000;836;94;742;127;116;0
1313;SiN: Gold;Action;100,000 - 200,000;254;43;211;202;194;1
1500;Darwinia;Indie, Strategy;0 - 20,000;768;203;565;141;215;2
1510;Uplink;Indie, Strategy;500,000 - 1,000,000;2011;193;1818;146;46;8
1520;DEFCON;Indie, Strategy;500,000 - 1,000,000;3191;474;2717;159;97;12
1530;Multiwinia;Indie;500,000 - 1,000,000;446;99;347;56;83;1
1600;Dangerous Waters;Strategy;50,000 - 100,000;253;78;175;0;0;2
1610;Space Empires IV Deluxe;Strategy;50,000 - 100,000;195;36;159;0;0;23
1630;Disciples II: Rise of the Elves ;Strategy;100,000 - 200,000;937;148;789;1266;366;29
1640;Disciples II: Gallean's Return;Strategy;50,000 - 100,000;1013;220;793;3208;5075;36
1670;Iron Warriors: T - 72 Tank Command ;Strategy;20,000 - 50,000;173;104;69;0;0;1
1690;Space Empires V;Strategy;50,000 - 100,000;288;118;170;1284;2489;20
1700;Arx Fatalis;RPG;200,000 - 500,000;1435;209;1226;605;678;17
1840;Source Filmmaker;Animation & Modeling, Video Production;1,000,000 - 2,000,000;29633;2124;27509;1009;62;1251
1900;Earth 2160;Strategy;500,000 - 1,000,000;877;373;504;1007;423;15
1930;Two Worlds Epic Edition;RPG;1,000,000 - 2,000,000;3911;1250;2661;414;408;39
2100;Dark Messiah of Might & Magic;Action, RPG;1,000,000 - 2,000,000;7992;726;7266;403;160;39
2200;Quake III Arena;Action;500,000 - 1,000,000;2922;137;2785;309;143;37
2210;Quake 4;Action;200,000 - 500,000;2267;323;1944;592;1056;20
2270;Wolfenstein 3D;Action;200,000 - 500,000;2949;191;2758;271;416;15
2280;DOOM (1993);Action;1,000,000 - 2,000,000;13770;485;13285;151;31;73
2290;Final DOOM;Action;500,000 - 1,000,000;1043;179;864;51;9;1
2300;DOOM II;Action;500,000 - 1,000,000;6641;349;6292;175;22;70
2310;Quake;Action;1,000,000 - 2,000,000;11048;436;10612;161;68;107
2320;Quake II;Action;200,000 - 500,000;3321;322;2999;213;64;36
2330;Quake II Mission Pack: The Reckoning;Action;200,000 - 500,000;148;33;115;9;13;0
2340;Quake II Mission Pack: Ground Zero;Action;20,000 - 50,000;127;85;42;43;1;0
2360;Hexen: Beyond Heretic;Action;200,000 - 500,000;502;62;440;199;38;3
2370;Hexen: Deathkings of the Dark Citadel;Action;50,000 - 100,000;119;34;85;236;2;0
2390;Heretic: Shadow of the Serpent Riders;Action;100,000 - 200,000;828;52;776;105;79;6
2400;The Ship: Murder Party;Action;1,000,000 - 2,000,000;5066;839;4227;233;137;8
2420;The Ship: Single Player;Action, Indie, RPG;200,000 - 500,000;640;267;373;70;52;1
2450;Bloody Good Time;Action, Indie, RPG;100,000 - 200,000;771;224;547;129;113;0
2500;Shadowgrounds;Action;200,000 - 500,000;1192;282;910;202;170;3
2520;Gumboy - Crazy Adventures;Action;50,000 - 100,000;61;59;2;4;5;0
2520;Gumboy - Crazy Adventures;Casual, Indie;50,000 - 100,000;61;59;2;4;5;0
2540;RIP - Trilogy;Casual, Indie;100,000 - 200,000;221;147;74;12;13;0
2570;Vigil: Blood Bitterness;Indie, RPG;50,000 - 100,000;30;115;-85;1;2;0
2590;Alpha Prime;Action;200,000 - 500,000;756;623;133;67;83;2
2600;Vampire: The Masquerade - Bloodlines;Action;500,000 - 1,000,000;11115;600;10515;835;152;88
2610;GUN;Action;100,000 - 200,000;1395;139;1256;104;136;7
2620;Call of Duty;Action;200,000 - 500,000;4430;244;4186;536;364;66
2630;Call of Duty 2;Action;5,000,000 - 10,000,000;7132;483;6649;803;659;323
2640;Call of Duty: United Offensive;Action;100,000 - 200,000;1311;187;1124;323;185;51
2700;RollerCoaster Tycoon 3: Platinum;Simulation, Strategy;1,000,000 - 2,000,000;4527;431;4096;557;312;73
2710;Act of War: Direct Action;Action;100,000 - 200,000;425;51;374;832;832;13
2720;ThreadSpace: Hyperbol;Action, Indie, Strategy;0 - 20,000;34;11;23;429;429;0
2780;ARMA: Combat Operations;Action;50,000 - 100,000;172;77;95;464;923;1
2800;X2: The Threat;Strategy;200,000 - 500,000;345;71;274;67;67;26
2810;X3: Reunion;Strategy;500,000 - 1,000,000;418;173;245;82;93;16
2820;X3: Terran Conflict;Action, Simulation, Strategy;500,000 - 1,000,000;2218;375;1843;1351;933;94
2840;X: Beyond the Frontier;Simulation, Strategy;200,000 - 500,000;237;81;156;34;35;2
2850;X: Tension;Simulation, Strategy;200,000 - 500,000;82;29;53;1;1;2
2870;X Rebirth;Action, Simulation;200,000 - 500,000;3107;4105;-998;2172;751;37
2900;688(I) Hunter/Killer;Strategy;20,000 - 50,000;126;38;88;0;0;1
2910;Fleet Command;Strategy;50,000 - 100,000;305;53;252;0;0;13
2920;Sub Command;Strategy;50,000 - 100,000;80;26;54;0;0;0
2990;FlatOut 2;Racing;200,000 - 500,000;13185;551;12634;346;167;126
3010;Xpand Rally;Racing;20,000 - 50,000;331;76;255;0;0;1
3020;Call of Juarez;Action;200,000 - 500,000;2112;493;1619;338;411;13
3050;Xpand Rally Xtreme;Racing;20,000 - 50,000;223;71;152;15;15;3
3130;Men of War: Red Tide;Strategy;200,000 - 500,000;575;100;475;844;895;10
3170;King's Bounty: Armored Princess;RPG, Strategy;500,000 - 1,000,000;934;88;846;671;816;55
3230;Genesis Rising;Strategy;20,000 - 50,000;41;105;-64;2;2;0
3260;Safecracker: The Ultimate Puzzle Adventure;Adventure, Casual;100,000 - 200,000;326;235;91;43;46;1
3270;Painkiller Overdose;Action;100,000 - 200,000;680;246;434;127;185;7
3300;Bejeweled 2 Deluxe;Casual;50,000 - 100,000;422;22;400;6;6;40
3310;Chuzzle Deluxe;Casual;50,000 - 100,000;735;52;683;542;799;70
3320;Insaniquarium Deluxe;Casual;200,000 - 500,000;3981;138;3843;217;245;74
3330;Zuma Deluxe;Casual;200,000 - 500,000;2784;143;2641;3169;145;615
3340;AstroPop Deluxe;Casual;20,000 - 50,000;62;20;42;0;0;4
3340;AstroPop Deluxe;Casual;20,000 - 50,000;62;20;42;0;0;4
3350;Bejeweled Deluxe;Casual;50,000 - 100,000;153;17;136;0;0;6
3360;Big Money! Deluxe;Casual;50,000 - 100,000;93;9;84;0;0;7
3380;Dynomite Deluxe;Casual;50,000 - 100,000;206;11;195;0;0;37
3390;Feeding Frenzy 2 Deluxe;Casual;100,000 - 200,000;1420;43;1377;219;268;18
3400;Hammer Heads Deluxe;Casual;20,000 - 50,000;50;6;44;0;0;2
3410;Heavy Weapon Deluxe;Casual;50,000 - 100,000;220;45;175;159;159;1
3410;Heavy Weapon Deluxe;Casual;50,000 - 100,000;220;45;175;159;159;1
3420;Iggle Pop Deluxe;Casual;20,000 - 50,000;42;7;35;0;0;3
3430;Pizza Frenzy Deluxe;Casual;50,000 - 100,000;144;6;138;0;0;1
3440;Rocket Mania Deluxe;Casual;20,000 - 50,000;66;3;63;0;0;5
3450;Typer Shark! Deluxe;Casual;50,000 - 100,000;234;44;190;0;0;22
3460;Talismania Deluxe;Casual;20,000 - 50,000;52;4;48;0;0;1
3480;Peggle Deluxe;Casual;200,000 - 500,000;5351;165;5186;1186;221;141
3483;Peggle Extreme;Casual;200,000 - 500,000;1422;102;1320;111;117;15
3490;Venice Deluxe;Casual;20,000 - 50,000;19;3;16;0;0;1
3500;Mystery P.I. - The Lottery Ticket;Casual;20,000 - 50,000;31;7;24;0;0;1
3510;Amazing Adventures The Lost Tomb;Casual;20,000 - 50,000;51;13;38;0;0;1
3520;Mystery P.I. - The Vegas Heist;Casual;20,000 - 50,000;32;8;24;0;0;2
3530;Amazing Adventures Around the World;Strategy, Casual;20,000 - 50,000;55;12;43;0;0;2
3540;Peggle Nights;Casual;100,000 - 200,000;1461;59;1402;2032;289;84
3560;Bejeweled Twist;Casual;50,000 - 100,000;318;63;255;0;0;15
3570;Mystery P.I. - The New York Fortune;Strategy;20,000 - 50,000;26;5;21;0;0;2
3590;Plants vs. Zombies GOTY Edition;Casual;2,000,000 - 5,000,000;97571;2602;94969;1643;560;5556
3600;Escape Rosecliff Island;Casual;50,000 - 100,000;159;77;82;787;1345;5
3620;Zuma's Revenge!;Action, Casual;100,000 - 200,000;1608;85;1523;351;599;238
3700;Sniper Elite;Action;500,000 - 1,000,000;2280;677;1603;319;133;31
3710;Judge Dredd: Dredd vs. Death;Action;100,000 - 200,000;840;123;717;54;76;4
3720;Evil Genius;Strategy;200,000 - 500,000;3151;206;2945;744;359;22
3730;Aliens versus Predator Classic 2000;Action;200,000 - 500,000;2012;288;1724;161;120;7
3800;Advent Rising;Action;50,000 - 100,000;374;100;274;65;124;1
3810;BloodRayne (Legacy);Action;50,000 - 100,000;471;129;342;151;233;0
3820;BloodRayne 2 (Legacy);Action;50,000 - 100,000;318;123;195;313;591;0
3830;Psychonauts;Action;2,000,000 - 5,000,000;14609;736;13873;448;220;89
3900;Sid Meier's Civilization IV;Strategy;1,000,000 - 2,000,000;2616;197;2419;299;327;864
3910;Sid Meier's Civilization III Complete;Strategy;1,000,000 - 2,000,000;5352;641;4711;355;12;1738
3920;Sid Meier's Pirates!;RPG;200,000 - 500,000;5334;325;5009;224;247;244
3960;Shattered Union;Strategy;20,000 - 50,000;71;70;1;0;0;6
3980;CivCity: Rome;Strategy;100,000 - 200,000;469;173;296;75;75;29
3990;Civilization IV: Warlords;Strategy;500,000 - 1,000,000;339;30;309;454;602;225
4000;Garry's Mod;Indie, Simulation;20,000,000 - 50,000,000;900605;31076;869529;10156;1548;35539
4100;Poker Superstars II;Casual, Strategy, Indie;0 - 20,000;6;7;-1;0;0;0
4230;RACE - The WTCC Game;Racing;20,000 - 50,000;136;52;84;69;111;0
4290;RACE: Caterham Expansion;Racing;0 - 20,000;6;6;0;1;1;0
4300;RoboBlitz;Action, Indie;20,000 - 50,000;57;20;37;104;104;0
4330;Star Trek: DAC - Demo;;0 - 20,000;0;0;0;0;0;0
4420;Silverfall;RPG;20,000 - 50,000;80;51;29;209;217;2
4460;City Life 2008;Simulation, Strategy;20,000 - 50,000;139;43;96;77;132;4
4470;Silverfall: Earth Awakening;RPG;20,000 - 50,000;55;22;33;1;1;0
4500;S.T.A.L.K.E.R.: Shadow of Chernobyl;Action, RPG;1,000,000 - 2,000,000;31951;1865;30086;4424;303;497
4520;Full Spectrum Warrior;Action, Strategy;50,000 - 100,000;170;78;92;5;7;0
4530;Full Spectrum Warrior: Ten Hammers;Action, Strategy;50,000 - 100,000;131;55;76;74;74;1
4560;Company of Heroes - Legacy Edition;Violent, Action, Strategy;2,000,000 - 5,000,000;6017;410;5607;321;57;138
4570;Warhammer 40,000: Dawn of War - Game of the Year Edition;Strategy;1,000,000 - 2,000,000;8111;409;7702;343;130;158
4580;Warhammer 40,000: Dawn of War - Dark Crusade;Strategy;1,000,000 - 2,000,000;6825;239;6586;1307;238;398
4700;Total War: MEDIEVAL II – Definitive Edition;Strategy;1,000,000 - 2,000,000;26074;1114;24960;2333;780;4432
4720;Condemned: Criminal Origins;Action;200,000 - 500,000;2639;403;2236;92;44;8
4760;Rome: Total War - Collection;Strategy;1,000,000 - 2,000,000;14007;808;13199;694;167;1110
4770;Rome: Total War - Alexander;Strategy;500,000 - 1,000,000;573;191;382;235;44;16
4780;Medieval II: Total War Kingdoms;Strategy;200,000 - 500,000;602;33;569;0;0;0
4800;Heroes of Annihilated Empires;Strategy;100,000 - 200,000;510;87;423;0;0;10
4850;Cossacks: Back to War;Strategy;200,000 - 500,000;1994;255;1739;601;505;229
4870;Cossacks: Art of War;Strategy;50,000 - 100,000;212;50;162;242;242;22
4880;Cossacks: European Wars;Strategy;100,000 - 200,000;336;124;212;425;790;33
4890;Cossacks II: Battle for Europe;Strategy;100,000 - 200,000;669;180;489;124;230;75
4900;Zen of Sudoku;Casual, Indie;20,000 - 50,000;226;31;195;1;1;8
4920;Natural Selection 2;Action, Indie, Strategy;1,000,000 - 2,000,000;10781;1834;8947;905;215;217
6000;STAR WARS Republic Commando;Action;1,000,000 - 2,000,000;12990;582;12408;277;119;124
6010;Indiana Jones and the Fate of Atlantis;Adventure;200,000 - 500,000;1066;64;1002;442;693;39
6020;STAR WARS Jedi Knight - Jedi Academy;Action;1,000,000 - 2,000,000;11538;467;11071;822;143;221
6030;STAR WARS Jedi Knight II - Jedi Outcast;Action;500,000 - 1,000,000;3730;361;3369;277;40;65
6040;The Dig;Adventure;100,000 - 200,000;918;81;837;354;630;19
6060;Star Wars: Battlefront 2 (Classic, 2005);Action;2,000,000 - 5,000,000;46142;2790;43352;509;168;581
6080;Thrillville: Off the Rails;Action, Adventure, Racing, Simulation, Strategy;50,000 - 100,000;648;53;595;84;93;19
6090;Armed and Dangerous;Action;20,000 - 50,000;227;20;207;0;0;0
6120;Shank;Action, Indie;200,000 - 500,000;2800;318;2482;228;87;5
6200;Ghost Master;Strategy;100,000 - 200,000;1491;181;1310;111;138;8
6210;Vegas: Make It Big;Strategy;20,000 - 50,000;112;38;74;20;20;0
6220;FlatOut;Racing;200,000 - 500,000;3813;311;3502;162;77;16
6250;Making History: The Calm & the Storm;Action, Strategy;50,000 - 100,000;480;120;360;152;152;4
6270;Ducati World Championship;Racing;20,000 - 50,000;86;106;-20;6;6;0
6300;Dreamfall: The Longest Journey;Adventure, RPG;200,000 - 500,000;852;158;694;1818;1818;8
6310;The Longest Journey;Action, Adventure, RPG;200,000 - 500,000;1633;167;1466;416;684;8
6370;Bloodline Champions;Action, Free to Play, Massively Multiplayer;200,000 - 500,000;1416;244;1172;3798;2955;6
6400;Joint Task Force;Action, Strategy;20,000 - 50,000;218;30;188;7;7;3
6420;Nexus - The Jupiter Incident;Indie, Simulation, Strategy;100,000 - 200,000;747;127;620;177;260;9
6510;Lost Planet: Extreme Condition;Action, Adventure;200,000 - 500,000;1207;287;920;166;118;9
6550;Devil May Cry 3 Special Edition;Action;200,000 - 500,000;2092;1370;722;78;116;16
6600;Bullet Candy;Casual, Indie;50,000 - 100,000;42;38;4;3;3;0
6800;Commandos: Behind Enemy Lines;Action;500,000 - 1,000,000;2822;340;2482;48;13;80
6810;Commandos: Beyond the Call of Duty;Action;500,000 - 1,000,000;758;102;656;73;109;33
6830;Commandos 2: Men of Courage;Action;200,000 - 500,000;2062;351;1711;518;414;41
6840;Commandos 3: Destination Berlin;Action;500,000 - 1,000,000;618;359;259;85;10;17
6850;Hitman 2: Silent Assassin;Action;1,000,000 - 2,000,000;2637;497;2140;202;54;21
6860;Hitman: Blood Money;Action;1,000,000 - 2,000,000;10352;626;9726;433;164;70
6870;Battlestations: Midway;Action;500,000 - 1,000,000;624;181;443;362;108;16
6880;Just Cause;Action;1,000,000 - 2,000,000;2890;1434;1456;287;36;17
6900;Hitman: Codename 47;Action;1,000,000 - 2,000,000;2218;817;1401;157;20;15
6910;Deus Ex: Game of the Year Edition;Action;1,000,000 - 2,000,000;11698;628;11070;293;36;102
6920;Deus Ex: Invisible War;Action;1,000,000 - 2,000,000;1101;826;275;406;140;4
6980;Thief: Deadly Shadows;Action;500,000 - 1,000,000;1751;386;1365;221;35;7
7000;Tomb Raider: Legend;Action, Adventure;200,000 - 500,000;3724;499;3225;294;158;33
7010;Project: Snowblind;Action;100,000 - 200,000;413;134;279;154;155;0
7020;Rogue Trooper;Action;50,000 - 100,000;369;25;344;386;386;1
7110;Jade Empire: Special Edition;RPG;200,000 - 500,000;1258;419;839;302;415;12
7200;Trackmania United Forever;Racing;200,000 - 500,000;2024;113;1911;15919;21192;187
7210;Runaway, A Road Adventure;Adventure;100,000 - 200,000;441;139;302;115;175;3
7220;Runaway, The Dream of The Turtle;Adventure;100,000 - 200,000;164;131;33;1137;1173;5
7260;Loki;RPG;20,000 - 50,000;124;74;50;192;192;1
7340;Azada;Casual, Indie;0 - 20,000;26;9;17;0;0;0
7510;X-Blades;Nudity, Violent, Action, Adventure, RPG;500,000 - 1,000,000;1898;1173;725;322;354;4
7520;Two Worlds II HD;Nudity, Violent, RPG;500,000 - 1,000,000;3876;2403;1473;637;423;53
7530;Two Worlds II Castle Defense;Strategy;200,000 - 500,000;302;290;12;312;324;4
7600;Sid Meier's Railroads!;Strategy;500,000 - 1,000,000;1940;814;1126;171;133;158
7610;Railroad Tycoon 3;Strategy;200,000 - 500,000;751;226;525;101;66;82
7620;Railroad Tycoon II Platinum;Strategy;200,000 - 500,000;954;121;833;180;180;113
7650;X-COM: Terror From the Deep;Strategy;500,000 - 1,000,000;659;63;596;14;24;49
7660;X-COM: Apocalypse;Strategy;500,000 - 1,000,000;684;88;596;56;107;26
7670;BioShock;Action, RPG;2,000,000 - 5,000,000;26896;1653;25243;347;146;113
7730;X-COM: Interceptor;Strategy;100,000 - 200,000;90;78;12;9;9;1
7760;X-COM: UFO Defense;Strategy;1,000,000 - 2,000,000;3162;176;2986;268;19;86
7770;X-COM: Enforcer;Strategy;100,000 - 200,000;206;167;39;0;0;1
7800;Stubbs the Zombie in Rebel Without a Pulse;Strategy;200,000 - 500,000;1469;222;1247;308;347;7
7830;Men of War;Racing;200,000 - 500,000;2728;317;2411;323;290;47
7840;Death Track: Resurrection;Action;50,000 - 100,000;76;58;18;41;41;0
7860;NecroVision;Action;100,000 - 200,000;911;427;484;35;25;3
7940;Call of Duty 4: Modern Warfare;Action, Adventure;2,000,000 - 5,000,000;18711;1297;17414;920;390;564
8000;Tomb Raider: Anniversary;Action;500,000 - 1,000,000;4433;948;3485;305;110;52
8080;Kane and Lynch: Dead Men;Action;500,000 - 1,000,000;1997;1148;849;165;68;3
8100;Conflict: Denied Ops;Action, Adventure;100,000 - 200,000;183;167;16;15;25;2
8140;Tomb Raider: Underworld;Action, Strategy;500,000 - 1,000,000;3877;1212;2665;463;88;36
8170;Battlestations Pacific;Action, Adventure;200,000 - 500,000;1715;710;1005;456;400;13
8190;Just Cause 2;Action, Adventure;2,000,000 - 5,000,000;44510;4479;40031;809;188;209
8200;Sam & Max 101: Culture Shock;Action, Adventure;50,000 - 100,000;438;52;386;113;136;1
8210;Sam & Max 102: Situation: Comedy;Action, Adventure;0 - 20,000;102;10;92;55;55;1
8220;Sam & Max 103: The Mole, the Mob and the Meatball;Action, Adventure;0 - 20,000;87;13;74;56;56;0
8230;Sam & Max 104: Abe Lincoln Must Die!;Action, Adventure;1,000,000 - 2,000,000;401;69;332;36;35;1
8240;Sam & Max 105: Reality 2.0;Action, Adventure;0 - 20,000;83;7;76;67;67;3
8250;Sam & Max 106: Bright Side of the Moon;Adventure;0 - 20,000;79;8;71;57;72;0
8260;Sam & Max 201: Ice Station Santa;Adventure;20,000 - 50,000;160;20;140;62;64;0
8270;Sam & Max 202: Moai Better Blues;Adventure;20,000 - 50,000;66;15;51;95;95;0
8270;Sam & Max 202: Moai Better Blues;Adventure;20,000 - 50,000;66;15;51;95;95;0
8290;Sam & Max 204: Chariots of the Dogs;Adventure;0 - 20,000;66;7;59;56;56;0
8300;Sam & Max 205: What's New Beelzebub?;Adventure;0 - 20,000;61;9;52;57;57;0
8310;Bone: Out From Boneville;Adventure;20,000 - 50,000;96;88;8;179;76;0
8320;Bone: The Great Cow Race;Casual;20,000 - 50,000;64;41;23;80;80;0
8330;Telltale Texas Hold ‘Em;Adventure;100,000 - 200,000;118;99;19;0;0;0
8340;Strong Bad's Cool Game for Attractive People: Season 1;Adventure;50,000 - 100,000;351;30;321;168;248;3
8350;Strong Bad's Cool Game for Attractive People: Episode 2;Adventure;0 - 20,000;36;6;30;170;170;1
8360;Strong Bad's Cool Game for Attractive People: Episode 3;Adventure;0 - 20,000;27;8;19;87;87;2
8370;Strong Bad's Cool Game for Attractive People: Episode 4;Adventure;0 - 20,000;26;7;19;127;127;0
8380;Strong Bad's Cool Game for Attractive People: Episode 5;Casual;0 - 20,000;26;6;20;23;23;1
8400;Geometry Wars: Retro Evolved;Action, Free to Play, Massively Multiplayer, RPG, Strategy;100,000 - 200,000;802;89;713;32;19;6
8500;EVE Online;Racing;2,000,000 - 5,000,000;22244;7728;14516;5028;144;5740
8600;RACE 07;;500,000 - 1,000,000;2117;383;1734;843;57;1
8640;RACE On;Racing, Simulation, Sports;100,000 - 200,000;0;0;0;1;1;0
8740;Puzzlegeddon;Strategy;0 - 20,000;0;0;0;0;0;1
8790;GTR 2 FIA GT Racing Game;Action;50,000 - 100,000;246;20;226;222;222;2
8800;Civilization IV: Beyond the Sword;Action;500,000 - 1,000,000;3497;134;3363;1783;1176;1854
8850;BioShock 2;RPG, Strategy;2,000,000 - 5,000,000;11668;1390;10278;364;130;42
8870;BioShock Infinite;RPG, Strategy;5,000,000 - 10,000,000;122208;7920;114288;1040;545;636
8880;Freedom Force;Strategy;200,000 - 500,000;268;213;55;36;31;8
8890;Freedom Force vs. the Third Reich;;100,000 - 200,000;209;39;170;35;30;0
8930;Sid Meier's Civilization V;Indie;5,000,000 - 10,000,000;182966;7329;175637;6739;2392;20451
8955;Borderlands DLC: Claptrap's New Robot Revolution;Action, RPG;0 - 20,000;0;0;0;0;0;0
8970;Axel & Pixel;Action;20,000 - 50,000;60;20;40;0;0;1
8980;Borderlands Game of the Year;Action;5,000,000 - 10,000,000;27668;2868;24800;1269;639;197
9000;Spear of Destiny;Action;200,000 - 500,000;420;77;343;106;150;5
9010;Return to Castle Wolfenstein;Action;500,000 - 1,000,000;6498;478;6020;285;133;73
9030;QUAKE Mission Pack 2: Dissolution of Eternity;Action;200,000 - 500,000;300;27;273;82;53;1
9040;QUAKE Mission Pack 1: Scourge of Armagon;Action;50,000 - 100,000;403;25;378;163;149;0
9050;DOOM 3;Action;500,000 - 1,000,000;5921;714;5207;453;222;32
9060;HeXen II;Action;100,000 - 200,000;336;71;265;229;294;2
9160;Master Levels for Doom II;Action;200,000 - 500,000;554;188;366;213;299;0
9180;Commander Keen;Strategy;200,000 - 500,000;1249;88;1161;19;24;4
9200;RAGE;Action, Strategy;1,000,000 - 2,000,000;12531;3714;8817;583;352;92
9310;Warhammer 40,000: Dawn of War – Winter Assault;Strategy;200,000 - 500,000;1535;176;1359;325;165;55
9340;Company of Heroes: Opposing Fronts;Strategy;1,000,000 - 2,000,000;893;80;813;533;59;47
9350;Supreme Commander;Strategy;500,000 - 1,000,000;2178;270;1908;578;372;75
9420;Supreme Commander: Forged Alliance;Action;1,000,000 - 2,000,000;11028;349;10679;2180;485;1485
9450;Warhammer 40,000: Dawn of War - Soulstorm;Action;1,000,000 - 2,000,000;13353;624;12729;1835;631;1178
9460;Frontlines: Fuel of War;Indie;200,000 - 500,000;574;289;285;169;190;8
9480;Saints Row 2;Action;2,000,000 - 5,000,000;13922;4196;9726;871;163;99
9500;Gish;;100,000 - 200,000;251;175;76;67;96;0
9710;Desperados 2: Cooper's Revenge;Action;50,000 - 100,000;104;123;-19;1;1;2
9730;Tycoon City: New York;Action, Adventure;20,000 - 50,000;92;143;-51;3;3;3
9760;Act of War: High Treason;Simulation, Strategy;50,000 - 100,000;349;79;270;46;92;10
9800;Death to Spies;Free to Play, Massively Multiplayer, RPG;100,000 - 200,000;608;206;402;110;111;4
9850;Codename: Panzers - Cold War;Free to Play, Massively Multiplayer, RPG;50,000 - 100,000;153;77;76;0;0;4
9880;Champions Online;Action, Adventure;1,000,000 - 2,000,000;2758;1095;1663;1048;356;142
9900;Star Trek Online;Adventure;2,000,000 - 5,000,000;13717;3708;10009;1478;192;2195
9940;Blade Kitten;Action;100,000 - 200,000;848;179;669;622;407;1
9960;Haunted House;Casual;0 - 20,000;12;15;-3;0;0;0
9960;Haunted House;Action;0 - 20,000;12;15;-3;0;0;0
9970;Star Raiders;Adventure;0 - 20,000;5;26;-21;0;0;1
9980;The UnderGarden;Adventure;20,000 - 50,000;55;31;24;44;44;0
10090;Call of Duty: World at War;Action, Casual;2,000,000 - 5,000,000;40224;3605;36619;2750;753;495
10100;King's Quest Collection;Action;100,000 - 200,000;257;45;212;13;13;14
10110;Space Quest Collection;Sports;100,000 - 200,000;276;54;222;5;5;7
10120;Aces of the Galaxy;Action, Adventure;0 - 20,000;18;21;-3;0;0;0
10130;TimeShift;Action;100,000 - 200,000;899;246;653;72;76;4
10150;Prototype;Action;500,000 - 1,000,000;7683;1871;5812;508;182;65
10180;Call of Duty: Modern Warfare 2 (2009);Adventure;5,000,000 - 10,000,000;47106;3335;43771;1044;443;589
10220;Postal III;Adventure;100,000 - 200,000;1187;1892;-705;72;76;5
10230;Dead Mountaineer's Hotel;Simulation;20,000 - 50,000;35;67;-32;638;638;0
10230;Dead Mountaineer's Hotel;Simulation;20,000 - 50,000;35;67;-32;638;638;0
10240;A Stroke of Fate: Operation Valkyrie;RPG, Strategy;20,000 - 50,000;16;12;4;0;0;0
10250;PT Boats: Knights of the Sea;Action;0 - 20,000;19;19;0;0;0;1
10260;PT Boats: South Gambit;Strategy;0 - 20,000;12;13;-1;0;0;0
10270;Disciples III: Reincarnation;Sports;100,000 - 200,000;1103;425;678;1215;1666;32
10460;The Club;Action;20,000 - 50,000;83;66;17;33;33;0
10500;Total War: EMPIRE – Definitive Edition;Racing;2,000,000 - 5,000,000;27173;2701;24472;3335;1145;3292
10520;Beijing 2008 - The Official Video Game of the Olympic Games;Adventure, RPG;0 - 20,000;0;1;-1;78;78;0
10520;Beijing 2008 - The Official Video Game of the Olympic Games;Adventure;0 - 20,000;0;1;-1;78;78;0
10680;Aliens vs. Predator;Adventure;1,000,000 - 2,000,000;15186;1526;13660;564;254;70
11020;TrackMania Nations Forever;Adventure;2,000,000 - 5,000,000;18638;2221;16417;288;60;522
11040;Sherlock Holmes - Nemesis;Adventure;100,000 - 200,000;338;128;210;2430;2430;9
11050;Dracula: Origin;Adventure, Casual;50,000 - 100,000;162;75;87;87;145;5
11130;Sherlock Holmes: The Mystery of the Mummy;Adventure, RPG;100,000 - 200,000;113;276;-163;8;8;1
11140;Sherlock Holmes: The Awakened (2008);Action;100,000 - 200,000;432;166;266;1018;1018;3
11150;Sherlock Holmes: The Silver Earring;Casual, Indie, Racing;100,000 - 200,000;299;205;94;2065;2065;1
11180;Sherlock Holmes: The Mystery of the Persian Carpet;Action, Indie, Strategy;50,000 - 100,000;142;245;-103;0;0;1
11190;Sherlock Holmes versus Jack the Ripper;;100,000 - 200,000;726;190;536;0;0;6
11200;Shadowgrounds Survivor;;200,000 - 500,000;429;290;139;231;226;2
11230;Gumboy Tournament;Action, Casual, Indie;50,000 - 100,000;330;139;191;34;56;0
11240;Space Trader: Merchant Marine;Casual, Indie;100,000 - 200,000;313;320;-7;10;13;0
11250;Pacific Storm;Action, Indie;0 - 20,000;29;19;10;2;2;0
11250;Pacific Storm;Indie;0 - 20,000;29;19;10;2;2;0
11260;Pacific Storm Allies;Adventure, Indie;20,000 - 50,000;116;83;33;82;82;8
11280;Penguins Arena: Sedna's World;Action, Racing;100,000 - 200,000;1150;135;1015;189;275;1
11330;Obulis;RPG;100,000 - 200,000;635;143;492;158;171;0
11340;Larva Mortus;Strategy;100,000 - 200,000;559;180;379;44;35;1
11360;Chains;Strategy;50,000 - 100,000;450;152;298;11;14;0
11370;Nikopol: Secrets of the Immortals;Simulation;100,000 - 200,000;192;161;31;7;8;0
11390;Crash Time 2;Action, Free to Play, Massively Multiplayer, RPG;100,000 - 200,000;1348;1035;313;22;16;2
11450;Overlord;Casual;500,000 - 1,000,000;5245;369;4876;470;267;32
11480;Soldiers: Heroes of World War II;Action;50,000 - 100,000;532;89;443;325;325;11
11550;Second Sight;Action;0 - 20,000;125;27;98;3;3;2
11560;Maelstrom: The Battle for Earth Begins;Action;20,000 - 50,000;93;57;36;38;38;1
11590;Hospital Tycoon;Action;20,000 - 50,000;231;339;-108;67;90;2
11610;Dragon Nest;Action;500,000 - 1,000,000;1639;608;1031;539;223;19
11920;LUMINES Advance Pack;Action;0 - 20,000;20;3;17;118;118;0
12100;Grand Theft Auto III;Racing;2,000,000 - 5,000,000;11607;1821;9786;309;45;82
12110;Grand Theft Auto: Vice City;Action;2,000,000 - 5,000,000;25209;2031;23178;725;110;228
12120;Grand Theft Auto: San Andreas;Action;5,000,000 - 10,000,000;72007;6469;65538;978;177;753
12130;Manhunt;Action, Adventure;200,000 - 500,000;2578;1139;1439;53;19;25
12140;Max Payne;Action, Adventure;500,000 - 1,000,000;10235;1220;9015;293;129;42
12150;Max Payne 2: The Fall of Max Payne;Action;500,000 - 1,000,000;6916;397;6519;229;146;40
12160;Midnight Club 2;RPG, Casual, Adventure;200,000 - 500,000;769;116;653;93;124;4
12170;Grand Theft Auto;Action, RPG;500,000 - 1,000,000;301;54;247;23;10;1
12180;Grand Theft Auto 2;Action;500,000 - 1,000,000;325;26;299;28;24;0
12200;Bully: Scholarship Edition;Adventure;2,000,000 - 5,000,000;21790;3989;17801;546;112;330
12210;Grand Theft Auto IV: The Complete Edition;Racing;5,000,000 - 10,000,000;94851;25431;69420;1422;635;2465
12220;Grand Theft Auto: Episodes from Liberty City;Strategy;2,000,000 - 5,000,000;7640;2711;4929;0;0;0
12310;Culpa Innata;Strategy;20,000 - 50,000;70;25;45;7609;7609;0
12310;Culpa Innata;Action;20,000 - 50,000;70;25;45;7609;7609;0
12320;Sacred Gold;Strategy;200,000 - 500,000;2946;528;2418;1208;750;95
12330;Darkstar One;Casual;100,000 - 200,000;420;91;329;692;757;4
12340;Jack Keane;Adventure;20,000 - 50,000;61;40;21;244;244;0
12360;FlatOut: Ultimate Carnage;Adventure;200,000 - 500,000;3683;565;3118;350;250;31
12370;Jagged Alliance 2 Gold;Strategy;50,000 - 100,000;0;0;0;149;296;12
12380;Jagged Alliance 2 Gold;Strategy;50,000 - 100,000;0;0;0;0;0;1
12390;Exodus from the Earth ;Strategy;50,000 - 100,000;115;88;27;33;59;23
12430;SlamIt Pinball Big Score;Casual;0 - 20,000;42;81;-39;0;0;0
12440;Ankh 2: Heart of Osiris ;Strategy;20,000 - 50,000;37;19;18;0;0;0
12450;Ankh 3: Battle of the Gods;Racing;0 - 20,000;23;11;12;0;0;0
12460;BC Kings;Action, Adventure, Strategy;20,000 - 50,000;117;73;44;0;0;0
12470;Port Royale 2;Casual;50,000 - 100,000;375;155;220;0;0;11
12480;9th Company: Roots Of Terror;Simulation;20,000 - 50,000;116;88;28;0;0;1
12480;9th Company: Roots Of Terror;;20,000 - 50,000;116;88;28;0;0;1
12500;PuzzleQuest: Challenge of the Warlords;;50,000 - 100,000;821;125;696;1252;1275;12
12510;Prison Tycoon 3: Lockdown;Racing;20,000 - 50,000;24;96;-72;171;171;1
12520;18 Wheels of Steel: American Long Haul;Racing;50,000 - 100,000;327;127;200;1127;1990;3
12520;18 Wheels of Steel: American Long Haul;RPG;50,000 - 100,000;327;127;200;1127;1990;3
12530;Hunting Unlimited 2008;Casual, Simulation;20,000 - 50,000;48;10;38;454;454;0
12540;Mahjongg Investigations: Under Suspicion;Casual, Simulation;20,000 - 50,000;24;8;16;0;0;1
12560;Ride! Carnival Tycoon;Simulation;0 - 20,000;20;27;-7;0;0;0
12570;Hot Dish;Simulation, Sports;20,000 - 50,000;14;17;-3;0;0;0
12580;Dr. Daisy Pet Vet;RPG;20,000 - 50,000;12;13;-1;0;0;0
12590;Sprint Cars Road to Knoxville;RPG;20,000 - 50,000;32;29;3;12;12;0
12600;Midnight Outlaw: 6 Hours to SunUp;Action, Adventure;0 - 20,000;15;32;-17;0;0;0
12640;Drakensang;RPG;100,000 - 200,000;463;117;346;819;1601;23
12650;Fetch It Again;Action;;;;0;;;
12660;Miss Popularity;Indie;;;;0;;;
12670;Mission Runway;Casual, Indie;0 - 20,000;13;8;5;1;1;0
12690;Hunting Unlimited 2010;;50,000 - 100,000;223;47;176;143;143;5
12710;Overlord: Raising Hell;Action;500,000 - 1,000,000;1712;123;1589;574;340;34
12770;Rise of the Argonauts;Action;200,000 - 500,000;507;209;298;14;17;1
12790;Damnation;Action;50,000 - 100,000;189;229;-40;260;260;0
12810;Overlord II;Action;1,000,000 - 2,000,000;3570;456;3114;841;631;52
12830;Operation Flashpoint: Dragon Rising;Action;500,000 - 1,000,000;1501;710;791;399;196;12
12900;AudioSurf;Action;1,000,000 - 2,000,000;10132;445;9687;729;148;19
13000;Ninja Reflex: Steamworks Edition;;0 - 20,000;53;7;46;197;197;0
13120;America's Army 3 Beta;Action, Adventure;0 - 20,000;0;0;0;0;0;0
13140;America's Army 3;Action;500,000 - 1,000,000;1673;722;951;348;29;2
13200;Unreal 2: The Awakening;Action, Adventure;200,000 - 500,000;381;170;211;9;10;1
13210;Unreal Tournament 3 Black;Action;1,000,000 - 2,000,000;3314;434;2880;770;99;23
13230;Unreal Tournament 2004: Editor's Choice Edition;Action;500,000 - 1,000,000;3531;127;3404;653;378;64
13240;Unreal Tournament: Game of the Year Edition;Action;500,000 - 1,000,000;3610;147;3463;281;75;35
13250;Unreal Gold;Action;500,000 - 1,000,000;1948;258;1690;313;26;15
13260;Unreal Development Kit;Action, Adventure;0 - 20,000;0;0;0;0;0;88
13500;Prince of Persia: Warrior Within;Action;200,000 - 500,000;2000;351;1649;288;239;15
13520;Far Cry;Action;1,000,000 - 2,000,000;6131;1293;4838;514;125;91
13530;Prince of Persia: The Two Thrones;Action;200,000 - 500,000;1178;309;869;128;190;16
13540;Tom Clancy's Rainbow Six Vegas;Action, Adventure;100,000 - 200,000;815;209;606;172;111;14
13560;Tom Clancy's Splinter Cell;Action, Adventure;200,000 - 500,000;2097;297;1800;318;320;11
13570;Tom Clancy's Splinter Cell Chaos Theory;Action;200,000 - 500,000;3594;248;3346;493;260;36
13580;Tom Clancy's Splinter Cell Double Agent;Action, Adventure;200,000 - 500,000;529;824;-295;160;260;2
13600;Prince of Persia: The Sands of Time;Simulation;200,000 - 500,000;2505;410;2095;80;54;23
13620;Tom Clancy's Ghost Recon Desert Siege;Strategy;20,000 - 50,000;94;6;88;13;18;0
13620;Tom Clancy's Ghost Recon Desert Siege;Action;20,000 - 50,000;94;6;88;13;18;0
13630;Tom Clancy's Ghost Recon Island Thunder;Simulation;20,000 - 50,000;93;13;80;41;42;0
15000;Tom Clancy's Rainbow Six Lockdown;Simulation;200,000 - 500,000;204;142;62;117;29;1
15080;Rayman Raving Rabbids;Simulation;50,000 - 100,000;845;166;679;49;67;2
15100;Assassin's Creed: Director's Cut Edition;Action;1,000,000 - 2,000,000;12777;2461;10316;475;269;111
15120;Tom Clancy's Rainbow Six Vegas 2;Action;500,000 - 1,000,000;4098;717;3381;433;287;38
15130;Beyond Good and Evil;Simulation;200,000 - 500,000;2632;401;2231;227;225;10
15160;Petz Horsez 2;Casual;0 - 20,000;122;46;76;302;302;1
15160;Petz Horsez 2;Strategy;0 - 20,000;122;46;76;302;302;1
15170;Heroes of Might & Magic V;Strategy;500,000 - 1,000,000;2733;375;2358;726;450;152
15190;Brothers in Arms: Road to Hill 30;Action;100,000 - 200,000;1227;168;1059;323;494;15
15200;Silent Hunter: Wolves of the Pacific;Strategy, Indie;100,000 - 200,000;577;260;317;47;47;33
15210;Silent Hunter III;Indie, Casual;200,000 - 500,000;1733;252;1481;461;798;80
15240;Silent Hunter: Wolves of the Pacific U-Boat Missions;Action, Indie, Sports;50,000 - 100,000;195;52;143;940;940;13
15300;Tom Clancy's Ghost Recon;Action, Early Access, Indie;200,000 - 500,000;1064;82;982;479;825;18
15320;IL-2 Sturmovik: 1946;Action, Indie, Sports;200,000 - 500,000;2266;284;1982;673;182;42
15350;Brain Spa;Strategy;0 - 20,000;4;5;-1;47;47;0
15370;Heroes of Might & Magic V: Tribes of the East;Adventure;200,000 - 500,000;2155;160;1995;3834;6920;325
15380;Heroes of Might & Magic V: Hammers of Fate;Adventure;50,000 - 100,000;222;38;184;116;209;29
15390;Brothers in Arms: Hell's Highway;Action, Adventure, Strategy;100,000 - 200,000;1528;161;1367;493;540;11
15400;Harvest: Massive Encounter;Action, Adventure, Strategy;50,000 - 100,000;113;33;80;111;118;3
15500;The Wonderful End of the World;Indie, Casual;100,000 - 200,000;473;143;330;158;204;1
15520;AaAaAA!!! - A Reckless Disregard for Gravity;Casual;100,000 - 200,000;607;118;489;36;36;0
15540;1... 2... 3... KICK IT! (Drop That Beat Like an Ugly Baby);Casual;50,000 - 100,000;151;383;-232;289;524;0
15560;AaaaaAAaaaAAAaaAAAAaAAAAA!!! for the Awesome;Casual;200,000 - 500,000;798;274;524;62;113;0
15620;Warhammer 40,000: Dawn of War II;Casual;2,000,000 - 5,000,000;9439;1144;8295;1731;773;247
15700;Oddworld: Abe's Oddysee;Casual;5,000,000 - 10,000,000;3475;584;2891;287;227;16
15710;Oddworld: Abe's Exoddus;Casual;200,000 - 500,000;1322;71;1251;70;114;10
15740;Oddworld: Munch's Oddysee;Casual;200,000 - 500,000;679;203;476;156;160;7
15750;Oddworld: Stranger's Wrath HD;Casual;200,000 - 500,000;1211;176;1035;54;50;3
15800;Planet Busters;Casual;0 - 20,000;1;2;-1;0;0;0
15900;7 Wonders II;Casual;50,000 - 100,000;136;38;98;0;0;5
15910;Luxor Amun Rising;Casual;0 - 20,000;16;8;8;0;0;0
15930;Luxor 3;Casual, Simulation;20,000 - 50,000;129;16;113;257;257;4
15960;Little Farm;Casual, Simulation;20,000 - 50,000;77;37;40;0;0;0
15970;Luxor;Casual, Simulation;20,000 - 50,000;62;28;34;1;1;4
16000;Discovery! A Seek and Find Adventure;Casual, Simulation;0 - 20,000;26;36;-10;0;0;1
16020;Samantha Swift and the Hidden Roses of Athena;Casual, Simulation;20,000 - 50,000;45;34;11;0;0;0
16030;7 Wonders: Treasures of Seven;Casual, Simulation;20,000 - 50,000;91;35;56;0;0;2
16040;Luxor: Quest for the Afterlife ;Indie, Casual;20,000 - 50,000;73;20;53;198;198;3
16060;Samantha Swift and the Golden Touch;Action;20,000 - 50,000;34;52;-18;0;0;1
16100;Virtual Villagers: A New Home;Casual, Indie;0 - 20,000;81;15;66;0;0;5
16120;Plant Tycoon;Indie, Racing, Sports;20,000 - 50,000;138;9;129;0;0;14
16130;Fish Tycoon;Indie, Racing, Sports;0 - 20,000;63;12;51;0;0;3
16180;Virtual Villagers - The Secret City;Action, Adventure;0 - 20,000;92;9;83;455;455;9
16200;Virtual Families;Action;0 - 20,000;42;9;33;0;0;4
16300;Everyday Shooter;Action;20,000 - 50,000;97;7;90;23;25;0
16450;F.E.A.R. 2: Project Origin;Strategy;500,000 - 1,000,000;5732;931;4801;574;359;93
16500;Chaos Theory;Action, Indie, Early Access;0 - 20,000;10;2;8;0;0;0
16600;Trials 2: Second Edition;Action, Free to Play;50,000 - 100,000;203;37;166;338;447;2
16620;Monster Trucks Nitro ;Strategy, Simulation;0 - 20,000;29;16;13;0;0;0
16710;Insecticide Part 1;Strategy, Simulation;100,000 - 200,000;331;117;214;45;74;1
16720;Velvet Assassin;RPG, Strategy;200,000 - 500,000;1453;919;534;80;97;5
16730;Legendary;Strategy;200,000 - 500,000;1326;1113;213;95;166;1
16810;Sid Meier's Civilization IV: Colonization;Action;1,000,000 - 2,000,000;900;151;749;419;462;319
16900;GROUND BRANCH;Action;1,000,000 - 2,000,000;10980;1083;9897;724;535;490
17080;Tribes: Ascend;Simulation;1,000,000 - 2,000,000;6868;1665;5203;551;43;0
17100;Children of the Nile: Enhanced Edition;Action, Adventure;50,000 - 100,000;317;65;252;448;448;13
17120;Children of the Nile: Alexandria;Action, Racing;20,000 - 50,000;114;25;89;425;846;13
17140;Hinterland;Simulation;50,000 - 100,000;174;49;125;200;200;3
17180;Mosby's Confederacy;RPG;20,000 - 50,000;24;13;11;0;0;0
17300;Crysis;Action, RPG;1,000,000 - 2,000,000;10099;2589;7510;440;362;18
17330;Crysis Warhead;Action;1,000,000 - 2,000,000;2889;498;2391;236;189;15
17390;SPORE;Strategy;2,000,000 - 5,000,000;45513;3876;41637;1432;491;964
17410;Mirror's Edge;Action, Free to Play, Indie;2,000,000 - 5,000,000;29131;4120;25011;338;158;52
17430;Need for Speed Undercover;Action, Free to Play, Indie;1,000,000 - 2,000,000;5707;1922;3785;765;464;47
17440;SPORE Creepy & Cute Parts Pack;Action, Free to Play, Indie;500,000 - 1,000,000;1451;173;1278;383;65;48
17450;Dragon Age: Origins;Action, Strategy;500,000 - 1,000,000;9524;856;8668;2123;539;76
17460;Mass Effect (2007);Action, Free to Play, Strategy;1,000,000 - 2,000,000;15022;1003;14019;1336;496;81
17470;Dead Space (2008);;2,000,000 - 5,000,000;22294;2074;20220;360;133;223
17480;Command & Conquer: Red Alert 3;Adventure, RPG;1,000,000 - 2,000,000;10025;1713;8312;1126;529;709
17500;Zombie Panic! Source;Adventure, RPG;500,000 - 1,000,000;6274;1114;5160;315;28;52
17570;Pirates, Vikings, and Knights II;Action, Indie, RPG;1,000,000 - 2,000,000;4927;678;4249;225;75;28
17580;Dystopia;Action, RPG, Indie;200,000 - 500,000;866;157;709;353;512;1
17710;Nuclear Dawn;Action, Adventure, RPG;200,000 - 500,000;1861;520;1341;320;268;5
17740;Empires Mod;Action, Casual, Indie, Strategy;500,000 - 1,000,000;831;135;696;0;0;0
17760;;Casual, Indie;0 - 20,000;0;0;0;0;0;0
18000;Precipice of Darkness, Episode One;;100,000 - 200,000;434;55;379;197;252;2
18020;Precipice of Darkness, Episode Two;Casual, Strategy;100,000 - 200,000;146;29;117;244;319;0
18040;DeathSpank;Casual, Strategy;100,000 - 200,000;755;46;709;374;572;0
18050;DeathSpank: Thongs of Virtue;Casual, Strategy;50,000 - 100,000;199;27;172;460;714;1
18070;The Baconing;Casual, Strategy;50,000 - 100,000;181;51;130;13;15;0
18110;Shattered Horizon;Casual, Strategy;100,000 - 200,000;399;72;327;246;147;0
18120;Unstoppable Gorg;Strategy;50,000 - 100,000;216;61;155;165;225;0
18300;Spectraball;Adventure;200,000 - 500,000;362;113;249;54;71;1
18310;Spectraball - Demo;Indie, Strategy;0 - 20,000;0;0;0;0;0;0
18400;Crazy Machines 2;Indie, Strategy;100,000 - 200,000;113;127;-14;74;70;1
18420;Crazy Machines;Action, Indie;50,000 - 100,000;137;32;105;9;9;1
18430;Crazy Machines 1.5;Action, Indie, Racing, Sports;0 - 20,000;2;1;1;0;0;0
18470;Helldorado;Adventure;50,000 - 100,000;100;40;60;6;6;6
18480;Mata Hari;Casual, RPG;50,000 - 100,000;70;49;21;350;350;1
18500;Defense Grid: The Awakening;Action, Adventure;500,000 - 1,000,000;4452;163;4289;780;609;89
18600;Mayhem Intergalactic;Action, Adventure, Casual;0 - 20,000;13;12;1;0;0;0
18700;And Yet It Moves;Action, Indie;200,000 - 500,000;835;377;458;56;53;0
18820;Zero Gear;Action, Indie, Casual;100,000 - 200,000;697;187;510;489;812;0
19000;Silent Hill Homecoming;Adventure, Indie;200,000 - 500,000;1116;1195;-79;125;172;14
19030;Rocket Knight;Action;0 - 20,000;102;36;66;0;0;0
19080;Biozone;Action;0 - 20,000;5;20;-15;0;0;0
19200;Tank Universal;Action;50,000 - 100,000;253;183;70;2;3;0
19320;Space Ark;Action;0 - 20,000;6;9;-3;0;0;0
19680;Alice: Madness Returns;Action, Adventure;2,000,000 - 5,000,000;10705;1307;9398;588;327;132
19800;Brothers in Arms: Earned in Blood;Indie, Casual, Sports;100,000 - 200,000;646;91;555;98;140;15
19810;The Sum of All Fears;Action;0 - 20,000;26;8;18;0;0;0
19830;Tom Clancy's Rainbow Six 3 Gold;Action, RPG;200,000 - 500,000;1442;132;1310;311;169;13
19900;Far Cry 2;Action;1,000,000 - 2,000,000;10326;3010;7316;454;217;96
19980;Prince of Persia;Strategy;200,000 - 500,000;2002;541;1461;181;175;14
20200;Galactic Bowling;Action, Strategy;0 - 20,000;6;11;-5;0;0;0
20500;Red Faction Guerrilla Steam Edition;Strategy;1,000,000 - 2,000,000;6730;725;6005;507;216;15
20510;S.T.A.L.K.E.R.: Clear Sky;Action, Indie, Strategy;1,000,000 - 2,000,000;14262;2380;11882;879;473;333
20530;Red Faction;Action, Indie, Strategy;500,000 - 1,000,000;2022;295;1727;125;65;3
20540;Company of Heroes: Tales of Valor;Action, Indie;1,000,000 - 2,000,000;1937;147;1790;1358;109;89
20550;Red Faction II;Action, RPG;100,000 - 200,000;526;477;49;31;36;1
20570;Warhammer 40,000: Dawn of War II Chaos Rising;RPG;1,000,000 - 2,000,000;2658;256;2402;1378;949;94
20700;Starscape;Action, Adventure;20,000 - 50,000;67;17;50;96;156;1
20710;Mr. Robot;Action;20,000 - 50,000;67;14;53;1;1;0
20820;Shatter;Action;200,000 - 500,000;1132;72;1060;86;67;3
20900;The Witcher: Enhanced Edition Director's Cut;Action;2,000,000 - 5,000,000;63987;8205;55782;935;159;801
20920;The Witcher 2: Assassins of Kings Enhanced Edition;Action;2,000,000 - 5,000,000;70061;8201;61860;947;326;774
21000;LEGO Batman: The Videogame;Action;500,000 - 1,000,000;6929;880;6049;377;181;385
21010;Watchmen: The End is Nigh;Action;20,000 - 50,000;333;151;182;6;6;0
21030;Watchmen: The End is Nigh Part 2;Action, Adventure;20,000 - 50,000;132;69;63;0;0;2
21090;F.E.A.R.;Indie, Casual;1,000,000 - 2,000,000;11728;756;10972;338;170;142
21100;F.E.A.R. 3;Strategy, Action, Indie;1,000,000 - 2,000,000;7804;3048;4756;350;249;82
21110;F.E.A.R.;Racing;1,000,000 - 2,000,000;0;0;0;145;104;24
21120;F.E.A.R.;Casual, Strategy;1,000,000 - 2,000,000;0;0;0;313;256;23
21130;LEGO Harry Potter: Years 1-4;Casual, Strategy;500,000 - 1,000,000;6295;963;5332;606;320;336
21300;Gravitron 2;Action;0 - 20,000;26;5;21;5;5;0
21400;Project Aftermath;;0 - 20,000;11;9;2;8;8;0
21500;Pyroblazer;;0 - 20,000;6;3;3;5;5;0
21600;Age of Booty;Action, Adventure;20,000 - 50,000;77;120;-43;0;0;0
21640;Flock!;Racing;20,000 - 50,000;164;42;122;22;26;1
21660;Street Fighter IV;Strategy;100,000 - 200,000;340;159;181;37;48;0
21670;Bionic Commando;Action;200,000 - 500,000;1038;378;660;222;229;4
21680;Bionic Commando: Rearmed;Indie;200,000 - 500,000;587;374;213;93;123;4
21690;Resident Evil 5;Indie, RPG;1,000,000 - 2,000,000;28359;4217;24142;891;588;496
21780;Driver Parallel Lines;Nudity, Gore, Action, Adventure, Indie;50,000 - 100,000;823;84;739;873;873;5
21800;Tom Clancy's EndWar;Strategy;100,000 - 200,000;596;157;439;437;443;19
21980;Call of Juarez: Bound in Blood;Adventure, Indie;200,000 - 500,000;2819;461;2358;380;326;21
22000;World of Goo;Gore, Action, Adventure, Indie;1,000,000 - 2,000,000;4932;291;4641;153;60;18
22100;Mount & Blade;;500,000 - 1,000,000;5354;431;4923;797;213;95
22120;Penumbra: Black Plague Gold Edition;;200,000 - 500,000;2183;136;2047;165;178;7
22130;Hearts of Iron 2 Complete;;100,000 - 200,000;447;77;370;864;864;89
22140;Penumbra: Requiem;;100,000 - 200,000;444;417;27;61;86;1
22180;Penumbra Overture;;200,000 - 500,000;2809;300;2509;194;204;5
22200;Zeno Clash;;200,000 - 500,000;2396;404;1992;199;209;5
22230;Rock of Ages;;200,000 - 500,000;3206;299;2907;141;88;4
22300;Fallout 3;;500,000 - 1,000,000;14353;3687;10666;587;220;107
22310;Rogue Warrior;;100,000 - 200,000;840;412;428;70;97;1
22320;The Elder Scrolls III: Morrowind Game of the Year Edition;;1,000,000 - 2,000,000;20508;987;19521;675;185;738
22330;The Elder Scrolls IV: Oblivion Game of the Year Edition;;1,000,000 - 2,000,000;38018;1750;36268;1232;441;1351
22340;Call of Cthulhu: Dark Corners of the Earth;;200,000 - 500,000;1911;911;1000;122;48;7
22350;BRINK;Action, Indie, Racing, Strategy;1,000,000 - 2,000,000;4598;2818;1780;224;94;11
22370;Fallout 3: Game of the Year Edition;RPG;2,000,000 - 5,000,000;31711;8036;23675;868;172;697
22380;Fallout: New Vegas;Action;5,000,000 - 10,000,000;167714;6161;161553;3399;960;5130
22450;Hunted: The Demon’s Forge;RPG;200,000 - 500,000;815;288;527;591;991;4
22490;Fallout: New Vegas;RPG;500,000 - 1,000,000;46753;2153;44600;3127;1797;677
22500;Spectromancer;;50,000 - 100,000;224;34;190;0;0;13
22600;Worms Reloaded;Action, Free to Play;500,000 - 1,000,000;3866;601;3265;478;184;32
22610;Alien Breed: Impact;RPG;200,000 - 500,000;1161;418;743;91;75;3
22650;Alien Breed 2: Assault;Action, RPG;500,000 - 1,000,000;627;289;338;51;48;0
22670;Alien Breed 3: Descent;Action, Adventure;200,000 - 500,000;364;136;228;184;75;2
23130;Mole Control;Action, RPG;0 - 20,000;0;0;0;0;0;1
23140;KrissX;;0 - 20,000;0;0;0;0;0;1
23150;Fluttabyes;;0 - 20,000;19;8;11;0;0;0
23300;Yosumin!;Strategy;100,000 - 200,000;122;81;41;377;381;2
23310;The Last Remnant;Action;500,000 - 1,000,000;3207;738;2469;406;133;30
23380;Gyromancer;Action;100,000 - 200,000;161;144;17;896;1714;3
23400;Imperium Romanum Gold Edition;Action;100,000 - 200,000;335;63;272;182;196;4
23420;Europa Universalis: Rome - Gold Edition;;50,000 - 100,000;148;74;74;15;15;6
23450;Grand Ages: Rome;;200,000 - 500,000;505;182;323;356;369;25
23460;Ceville;Casual, Indie;50,000 - 100,000;132;30;102;5;5;1
23490;Tropico 3;Casual;1,000,000 - 2,000,000;1539;198;1341;460;27;16
23500;Puzzle Quest: Galactrix;RPG;20,000 - 50,000;143;164;-21;0;0;1
23530;Earth Defense Force: Insect Armageddon;RPG;50,000 - 100,000;904;119;785;704;845;0
23600;Depths of Peril;Simulation, Strategy;50,000 - 100,000;98;30;68;11;11;1
23700;Puzzle Kingdoms;Strategy;50,000 - 100,000;168;123;45;68;93;3
24010;Train Simulator Classic;Simulation, Strategy;1,000,000 - 2,000,000;17313;7536;9777;799;340;1525
24200;DC Universe Online;Action, Adventure, Strategy;2,000,000 - 5,000,000;15310;3756;11554;2028;1071;615
24240;PAYDAY The Heist;Simulation, Strategy;2,000,000 - 5,000,000;36178;2587;33591;526;207;67
24400;King Arthur - The Role-playing Wargame;Casual, RPG;200,000 - 500,000;382;166;216;880;112;4
24410;Crusaders: Thy Kingdom Come;Action;20,000 - 50,000;23;15;8;20;20;0
24420;Aquaria;Indie, RPG, Strategy;200,000 - 500,000;1230;164;1066;391;284;2
24460;King Arthur: Fallen Champions;Casual;50,000 - 100,000;19;31;-12;20;20;0
24480;King Arthur II: The Role-Playing Wargame;Simulation;100,000 - 200,000;251;208;43;1;1;3
24640;Trainz: Classic Cabon City;Action, Adventure, Free to Play, Massively Multiplayer, RPG;20,000 - 50,000;16;32;-16;7;7;0
24650;Trainz Settle and Carlisle;Action;0 - 20,000;27;20;7;0;0;0
24660;Trainz: Murchison 2;RPG, Strategy;0 - 20,000;19;14;5;0;0;1
24670;Trainz Simulator 12;Strategy;200,000 - 500,000;1202;470;732;138;177;56
24720;SPORE Galactic Adventures;Indie;500,000 - 1,000,000;5148;687;4461;692;142;221
24740;Burnout Paradise: The Ultimate Box;RPG, Strategy;1,000,000 - 2,000,000;11470;1702;9768;376;170;46
24780;SimCity 4 Deluxe Edition;RPG, Strategy;1,000,000 - 2,000,000;6106;1425;4681;640;198;500
24790;Command & Conquer 3: Tiberium Wars;Simulation;500,000 - 1,000,000;5634;591;5043;1140;310;434
24800;Command & Conquer: Red Alert 3 - Uprising;Simulation;500,000 - 1,000,000;3449;655;2794;1696;319;294
24810;Command & Conquer 3: Kane's Wrath;Simulation;200,000 - 500,000;3251;148;3103;2300;1561;441
24840;Medal of Honor: Airborne;Simulation;200,000 - 500,000;3749;902;2847;267;275;40
24870;Need for Speed: Shift;Action, Simulation;200,000 - 500,000;2083;618;1465;328;203;14
24960;Battlefield: Bad Company 2;Racing;2,000,000 - 5,000,000;30708;5415;25293;2499;557;137
24980;Mass Effect 2 (2010);Simulation, Strategy;1,000,000 - 2,000,000;14525;905;13620;1250;452;53
25000;Overgrowth;Strategy;500,000 - 1,000,000;5802;1578;4224;728;339;49
25010;Lugaru HD;Strategy;100,000 - 200,000;390;102;288;22;40;0
25500;Cricket Revolution;Strategy;0 - 20,000;69;56;13;3072;3072;1
25600;Eschalon: Book I;Action;50,000 - 100,000;271;44;227;5;5;7
25620;Eschalon: Book II;Racing;50,000 - 100,000;95;16;79;0;0;4
25700;Madballs in Babo:Invasion;Action;50,000 - 100,000;232;44;188;60;96;0
25730;Madballs in...Babo: Invasion Dev;RPG;0 - 20,000;0;0;0;0;0;0
25800;Europa Universalis III Complete;Action, Indie;200,000 - 500,000;1555;300;1255;699;188;74
25808;Europa Universalis III: Divine Wind;Action;20,000 - 50,000;30;6;24;0;0;0
25830;Knights of Honor;Indie, Simulation, Sports;200,000 - 500,000;1997;162;1835;733;640;47
25850;Elven Legacy;Indie, RPG;50,000 - 100,000;112;39;73;15;15;1
25890;Hearts of Iron III;Indie, RPG;500,000 - 1,000,000;4249;1254;2995;1067;211;109
25900;King's Bounty: The Legend;Indie;200,000 - 500,000;2503;270;2233;966;829;122
25910;Supreme Ruler 2020 Gold;;20,000 - 50,000;183;50;133;796;1590;13
25930;East India Company;Strategy;50,000 - 100,000;84;71;13;1853;1853;4
25930;East India Company;Strategy;50,000 - 100,000;84;71;13;1853;1853;4
25980;Majesty 2;RPG, Strategy;200,000 - 500,000;655;288;367;1694;2144;31
25990;Majesty Gold HD;Strategy;100,000 - 200,000;468;30;438;133;200;3
26000;The Maw;RPG, Strategy;50,000 - 100,000;228;46;182;99;99;1
26300;Drug Wars;Strategy;0 - 20,000;13;30;-17;0;0;0
26500;Cogs;Strategy;200,000 - 500,000;759;98;661;101;68;1
26800;Braid;Simulation, Strategy;1,000,000 - 2,000,000;8342;543;7799;169;106;13
26900;Crayon Physics Deluxe;Strategy, Simulation;500,000 - 1,000,000;875;142;733;70;16;2
27000;The Path;Action, Indie;100,000 - 200,000;636;196;440;128;115;2
27020;The Graveyard;Action, Indie;20,000 - 50,000;355;229;126;5;5;0
27050;Fatale;Indie, Casual;20,000 - 50,000;66;55;11;69;125;0
27200;Summer Athletics;Casual, Indie, Strategy;0 - 20,000;22;17;5;10;15;0
27330;Blacklight: Tango Down;Casual, Indie;50,000 - 100,000;143;211;-68;166;235;0
27400;Dangerous High School Girls in Trouble!;Adventure, Indie;50,000 - 100,000;121;79;42;14;27;0
27600;Mevo and The Grooveriders;Indie, Simulation;0 - 20,000;24;2;22;0;0;0
27800;Space Giraffe;Adventure, Casual, Indie;20,000 - 50,000;51;21;30;0;0;0
27810;Gridrunner Revolution;Sports;20,000 - 50,000;54;12;42;0;0;0
27900;Twin Sector;Action;50,000 - 100,000;101;170;-69;25;30;0
27920;Booster Trooper;RPG, Indie, Casual;50,000 - 100,000;96;101;-5;10;10;0
27940;Dead Horde;Indie, Casual;50,000 - 100,000;217;433;-216;53;80;0
27940;Dead Horde;Indie;50,000 - 100,000;217;433;-216;53;80;0
28000;Kane & Lynch 2: Dog Days;Indie;500,000 - 1,000,000;5157;2959;2198;235;185;7
29017;Blood Bowl 2 - Review;;0 - 20,000;0;0;0;0;0;0
29120;Yumsters 2: Around the World;;20,000 - 50,000;55;29;26;2;2;0
29130;Musaic Box;Action, Indie;20,000 - 50,000;227;19;208;2;2;0
29160;Blueberry Garden;Action, Indie;20,000 - 50,000;113;34;79;13;13;0
29180;Osmos;Action;200,000 - 500,000;1071;154;917;121;59;2
29540;Guild Wars Game of the Year Edition;;0 - 20,000;8;1;7;0;0;0
29570;Guild Wars Trilogy;Indie, Casual;0 - 20,000;34;2;32;0;0;0
29700;Guild Wars: Eye of the North;Indie, Casual;0 - 20,000;2;0;2;0;0;0
29800;Caster;Adventure, Indie;200,000 - 500,000;3202;842;2360;178;133;1
29900;Dark Sector;Indie, Casual;50,000 - 100,000;530;134;396;384;512;2
31100;Wallace & Gromit’s Grand Adventures;Action, Adventure, Casual, Indie, RPG, Strategy;20,000 - 50,000;147;24;123;33;46;1
31170;Tales of Monkey Island: Complete Season;Action;200,000 - 500,000;561;70;491;108;123;5
31180;Tales of Monkey Island Complete Pack: Chapter 2 - The Siege of Spinner Cay;Adventure;0 - 20,000;104;12;92;134;165;3
31190;Tales of Monkey Island Complete Pack: Chapter 3 - Lair of the Leviathan;Adventure;20,000 - 50,000;90;8;82;120;128;2
31190;Tales of Monkey Island Complete Pack: Chapter 3 - Lair of the Leviathan;Adventure;20,000 - 50,000;90;8;82;120;128;2
31200;Tales of Monkey Island Complete Pack: Chapter 4 - The Trial and Execution of Guybrush Threepwood;Adventure;20,000 - 50,000;89;22;67;149;153;4
31200;Tales of Monkey Island Complete Pack: Chapter 4 - The Trial and Execution of Guybrush Threepwood;Adventure;20,000 - 50,000;89;22;67;149;153;4
31210;Tales of Monkey Island Complete Pack: Chapter 5 - Rise of the Pirate God;Action, Adventure;20,000 - 50,000;111;14;97;189;261;1
31220;Sam & Max 301: The Penal Zone;Adventure;100,000 - 200,000;436;47;389;36;44;4
31230;Sam & Max 302: The Tomb of Sammun-Mak;Adventure;0 - 20,000;69;12;57;59;59;1
31240;Sam & Max 303: They Stole Max's Brain!;Adventure;0 - 20,000;68;7;61;67;67;2
31250;Sam & Max 304: Beyond the Alley of the Dolls;Adventure;0 - 20,000;54;6;48;86;86;1
31260;Sam & Max 305: The City That Dares Not Sleep;Adventure, Casual;0 - 20,000;77;6;71;55;55;1
31270;Puzzle Agent;Casual, Sports;500,000 - 1,000,000;2126;280;1846;124;89;2
31280;Poker Night at the Inventory;Adventure;1,000,000 - 2,000,000;7981;959;7022;189;122;19
31290;Back to the Future: The Game;Action;500,000 - 1,000,000;2019;267;1752;156;172;3
31300;Tunnel Rats;Action, Indie;0 - 20,000;14;24;-10;0;0;0
31700;Iron Grip: Warlord;Adventure;100,000 - 200,000;355;59;296;201;376;1
31800;Nancy Drew: Danger by Design;Adventure;20,000 - 50,000;89;25;64;0;0;7
31810;Nancy Drew: Last Train to Blue Moon Canyon;Adventure;20,000 - 50,000;238;9;229;0;0;5
31820;Nancy Drew: The Haunted Carousel;Adventure;20,000 - 50,000;149;9;140;181;181;3
31830;Nancy Drew: Curse of Blackmoor Manor;Adventure;50,000 - 100,000;242;31;211;15;15;15
31840;Nancy Drew: Danger on Deception Island;Adventure;20,000 - 50,000;158;9;149;182;182;7
31850;Nancy Drew: Ghost Dogs of Moon Lake;Adventure;20,000 - 50,000;157;14;143;220;220;9
31860;Nancy Drew: Legend of the Crystal Skull;Adventure, Casual;20,000 - 50,000;134;12;122;0;0;5
31870;Nancy Drew Dossier: Lights, Camera, Curses!;Adventure;20,000 - 50,000;40;20;20;0;0;0
31880;Nancy Drew: Secret of the Old Clock;Action;20,000 - 50,000;149;14;135;0;0;11
31890;Nancy Drew: Secret of the Scarlet Hand;Adventure;20,000 - 50,000;119;15;104;211;211;8
31900;Nancy Drew: The Creature of Kapu Cave;Adventure;20,000 - 50,000;75;30;45;0;0;4
31910;Nancy Drew: The Haunting of Castle Malloy;Adventure;20,000 - 50,000;112;27;85;0;0;4
31920;Nancy Drew: The Phantom of Venice;Adventure;20,000 - 50,000;118;17;101;0;0;5
31930;Nancy Drew: The White Wolf of Icicle Creek;Adventure;50,000 - 100,000;119;42;77;0;0;10
31980;Nancy Drew: Ransom of the Seven Ships;Indie, Casual;20,000 - 50,000;40;19;21;0;0;1
31980;Nancy Drew: Ransom of the Seven Ships;Casual;20,000 - 50,000;40;19;21;0;0;1
32000;Raycatcher;Casual;0 - 20,000;1;14;-13;0;0;0
32110;LUXOR: Mah Jong;Adventure, Casual;20,000 - 50,000;75;28;47;16;16;14
32140;Midnight Mysteries;Casual, Indie, Strategy;50,000 - 100,000;110;49;61;0;0;0
32150;Everyday Genius: SquareLogic;Sports, Casual;0 - 20,000;374;7;367;2;2;8
32160;Zombie Bowl-o-Rama;Action, Indie, Racing, Sports;50,000 - 100,000;334;52;282;17;17;1
32200;Metal Drift;Adventure;20,000 - 50,000;87;47;40;29;29;0
32330;LEGO Indiana Jones: The Original Adventures;Action, Adventure;100,000 - 200,000;2215;297;1918;124;81;161
32340;LOOM;Adventure;100,000 - 200,000;468;60;408;65;97;9
32350;STAR WARS Starfighter;Action, Simulation;50,000 - 100,000;304;280;24;63;22;3
32360;The Secret of Monkey Island: Special Edition;Adventure;500,000 - 1,000,000;4650;223;4427;458;384;142
32370;STAR WARS - Knights of the Old Republic;Adventure, RPG;1,000,000 - 2,000,000;25138;2452;22686;763;137;377
32380;STAR WARS Jedi Knight: Dark Forces II;Action;500,000 - 1,000,000;1384;389;995;210;41;7
32390;STAR WARS Jedi Knight - Mysteries of the Sith;Action;200,000 - 500,000;559;283;276;152;106;7
32400;STAR WARS - Dark Forces;Action;500,000 - 1,000,000;2315;276;2039;117;30;16
32410;Lucidity;Casual;20,000 - 50,000;43;18;25;0;0;0
32410;Lucidity;Action;20,000 - 50,000;43;18;25;0;0;0
32420;STAR WARS: The Clone Wars - Republic Heroes;Action;100,000 - 200,000;351;392;-41;35;27;12
32430;STAR WARS - The Force Unleashed Ultimate Sith Edition;Adventure;1,000,000 - 2,000,000;6344;2289;4055;360;186;178
32440;LEGO Star Wars - The Complete Saga;Adventure;1,000,000 - 2,000,000;19403;662;18741;578;208;595
32450;LEGO Indiana Jones 2: The Adventure Continues;Adventure;50,000 - 100,000;1019;193;826;561;781;50
32460;Monkey Island 2 Special Edition: LeChuck’s Revenge;Strategy;200,000 - 500,000;2244;104;2140;523;786;64
32470;STAR WARS Empire at War - Gold Pack;Action;1,000,000 - 2,000,000;29962;771;29191;2144;460;2433
32500;STAR WARS: The Force Unleashed II;Action, Adventure;1,000,000 - 2,000,000;3764;2319;1445;340;280;65
32510;LEGO Star Wars III - The Clone Wars;Action;500,000 - 1,000,000;6242;359;5883;1525;368;195
32610;Delta Force Xtreme 2;Action;20,000 - 50,000;109;80;29;373;557;1
32620;Delta Force;Action;20,000 - 50,000;443;45;398;46;70;4
32630;Delta Force 2;Action;50,000 - 100,000;330;52;278;32;55;4
32640;Delta Force Land Warrior;Action;50,000 - 100,000;255;19;236;117;170;10
32650;Delta Force: Task Force Dagger;Action;20,000 - 50,000;110;29;81;37;43;7
32660;Delta Force: Xtreme;Action;20,000 - 50,000;111;30;81;252;375;2
32670;Delta Force: Black Hawk Down;Action;100,000 - 200,000;607;49;558;761;1517;8
32680;Delta Force — Black Hawk Down: Team Sabre;Simulation;50,000 - 100,000;398;39;359;796;927;20
32710;Armored Fist 3;Simulation;0 - 20,000;51;17;34;0;0;0
32720;F-16 Multirole Fighter;Simulation;20,000 - 50,000;84;20;64;0;0;0
32730;F-22 Lightning 3;Simulation;20,000 - 50,000;99;53;46;32;32;1
32740;MiG-29 Fulcrum;Action, Simulation;0 - 20,000;65;11;54;5;5;0
32750;Comanche 4;Simulation;50,000 - 100,000;219;25;194;54;54;5
32760;Tachyon: The Fringe;Action;50,000 - 100,000;171;20;151;10;10;1
32770;Joint Operations: Combined Arms Gold;Action, RPG;20,000 - 50,000;220;30;190;503;503;15
32800;Lord of the Rings: War in the North;Casual, Indie, Simulation, Strategy;1,000,000 - 2,000,000;7159;1751;5408;422;215;35
32900;Restaurant Empire II;Action, Indie, RPG;0 - 20,000;237;79;158;14;16;12
33100;Alien Shooter;Action, Indie, RPG;500,000 - 1,000,000;3014;162;2852;190;132;54
33110;Alien Shooter: Revisited;Action, Indie, RPG;200,000 - 500,000;399;209;190;30;40;9
33120;Alien Shooter 2: Reloaded;Action, Indie, RPG;200,000 - 500,000;2356;201;2155;255;246;58
33130;Zombie Shooter;Action, Indie, RPG;200,000 - 500,000;813;163;650;109;145;3
33180;Zombie Shooter 2;Simulation, Strategy;100,000 - 200,000;518;144;374;180;226;6
33210;Dawn of Discovery;Action, Adventure;100,000 - 200,000;373;41;332;191;252;4
33220;Tom Clancy's Splinter Cell Conviction;Action, Adventure;200,000 - 500,000;2532;1004;1528;537;509;16
33229;Tom Clancy's Splinter Cell Conviction Deluxe Edition;Action, Indie;500,000 - 1,000,000;2532;1004;1528;0;0;0
33230;Assassin's Creed 2;Adventure, Simulation;2,000,000 - 5,000,000;36836;4391;32445;1092;801;320
33320;Prince of Persia: The Forgotten Sands;Simulation, Strategy;200,000 - 500,000;1216;562;654;137;207;3
33390;Zeit²;Action, RPG;0 - 20,000;31;7;24;0;0;0
33460;From Dust;RPG, Simulation, Strategy;200,000 - 500,000;1744;882;862;266;201;9
33520;Tropico Reloaded;Simulation, Strategy;200,000 - 500,000;662;88;574;22;33;24
33550;Time of Shadows;Adventure;0 - 20,000;7;11;-4;0;0;0
33570;Patrician III;Adventure;100,000 - 200,000;591;134;457;290;575;57
33580;The Great Art Race;Action, Racing;0 - 20,000;105;43;62;199;379;2
33600;Broken Sword 2 - the Smoking Mirror: Remastered;Casual;200,000 - 500,000;920;104;816;383;444;22
33610;Broken Sword 3 - the Sleeping Dragon;Casual, Indie;100,000 - 200,000;359;271;88;231;271;2
33620;Crash Time 3;Strategy, RPG;20,000 - 50,000;448;92;356;667;745;3
33650;Puzzler World;Indie;50,000 - 100,000;337;42;295;1368;1368;0
33660;Ziro;Casual, Simulation;0 - 20,000;21;11;10;25;25;0
33670;Disciples III - Renaissance Steam Special Edition;Casual, Simulation;200,000 - 500,000;244;214;30;42;42;11
33680;eversion;Casual, Simulation;50,000 - 100,000;1125;102;1023;120;120;2
33700;Paws and Claws: Pampered Pets;Simulation;;;;0;;;
33710;Paws and Claws: Pet School;Simulation;;;;0;;;
33720;Paws and Claws: Pet Vet;Casual;;;;0;;;
33730;18 Wheels of Steel: Extreme Trucker;RPG;50,000 - 100,000;157;65;92;22;23;0
33750;Prison Tycoon 4: SuperMax;Casual;0 - 20,000;7;29;-22;0;0;0
33760;The Search for Amelia Earhart;Action, Simulation, Strategy;20,000 - 50,000;4;10;-6;0;0;0
33770;Drakensang: The River of Time;Action, Simulation, Strategy;50,000 - 100,000;262;67;195;0;0;5
33790;Elizabeth Find M.D. - Diagnosis Mystery - Season 2;Casual, Indie;0 - 20,000;17;16;1;0;0;0
33900;Arma 2;Action;2,000,000 - 5,000,000;1783;351;1432;429;76;1
33930;Arma 2: Operation Arrowhead;Adventure;2,000,000 - 5,000,000;20055;1658;18397;3288;339;440
33950;Fish Fillets 2;Action, RPG;50,000 - 100,000;196;61;135;3;3;0
33980;Pound of Ground;Strategy;20,000 - 50,000;96;62;34;0;0;0
33980;Pound of Ground;Sports;20,000 - 50,000;96;62;34;0;0;0
33990;Alternativa;Racing;50,000 - 100,000;96;102;-6;0;0;0
34010;Alpha Protocol;Action, Adventure, Casual, RPG;200,000 - 500,000;3725;887;2838;322;190;11
34030;Total War: NAPOLEON – Definitive Edition;;1,000,000 - 2,000,000;18619;1819;16800;1898;854;1631
34180;Vancouver 2010 - The Official Video Game of the Olympic Winter Games;Action;0 - 20,000;3;3;0;0;0;0
34190;Sonic & SEGA All-Stars Racing;Strategy;200,000 - 500,000;2071;360;1711;206;181;21
34270;SEGA Mega Drive and Genesis Classics;Indie, Simulation, Strategy;1,000,000 - 2,000,000;8553;1530;7023;191;28;99
34272;Comix Zone;Strategy;20,000 - 50,000;15;0;15;0;0;0
34273;Crack Down;Strategy;0 - 20,000;9;0;9;0;0;0
34274;Ecco the Dolphin;Strategy;20,000 - 50,000;9;1;8;0;0;0
34275;Gain Ground;Adventure;50,000 - 100,000;7;0;7;0;0;0
34276;Golden Axe;Action, Simulation;20,000 - 50,000;19;2;17;0;0;0
34276;Golden Axe;Simulation;20,000 - 50,000;19;2;17;0;0;0
34277;Shinobi III: Return of the Ninja Master;Action;50,000 - 100,000;6;0;6;0;0;0
34278;Sonic 3D Blast;Action;50,000 - 100,000;13;3;10;0;0;0
34279;Space Harrier II;Indie;0 - 20,000;7;0;7;0;0;0
34280;VectorMan;Action, Casual, Indie;0 - 20,000;8;1;7;0;0;0
34281;Altered Beast;Action, Adventure;0 - 20,000;12;1;11;0;0;0
34282;Shadow Dancer;Casual;20,000 - 50,000;31;1;30;0;0;0
34284;Bonanza Bros.;Action, Adventure;0 - 20,000;9;0;9;0;0;0
34285;Columns;Action, Adventure;0 - 20,000;9;2;7;0;0;0
34286;Dr. Robotnik’s Mean Bean Machine;Strategy;20,000 - 50,000;10;2;8;0;0;0
34287;Ecco Jr.;Action, Racing;0 - 20,000;6;1;5;0;0;0
34288;Eternal Champions;Racing;0 - 20,000;5;1;4;0;0;0
34310;Galaxy Force II;Action, Massively Multiplayer, Simulation;0 - 20,000;5;1;4;0;0;0
34311;Kid Chameleon;Action, Adventure, Indie;0 - 20,000;6;0;6;0;0;0
34312;Ristar;;20,000 - 50,000;9;0;9;0;0;0
34313;Sonic Spinball;Strategy, Indie, Casual;0 - 20,000;8;2;6;0;0;0
34314;Super Thunder Blade;Adventure, Casual, Strategy;0 - 20,000;4;1;3;0;0;0
34314;Super Thunder Blade;Action, Adventure, Indie;0 - 20,000;4;1;3;0;0;0
34315;Alien Storm;Action, Adventure, Indie;0 - 20,000;7;0;7;0;0;0
34316;Bio-Hazard Battle;Casual, Indie;0 - 20,000;8;1;7;0;0;0
34317;Columns III;Action, Indie;20,000 - 50,000;5;1;4;0;0;0
34318;Decap Attack;Casual;0 - 20,000;8;0;8;0;0;0
34390;Football Manager 2011 Demo;Casual;0 - 20,000;0;0;0;0;0;0
34410;Death to Spies: Moment of Truth;Casual;100,000 - 200,000;382;65;317;19;26;1
34420;XIII Century – Gold Edition;Casual;100,000 - 200,000;90;72;18;16;16;0
34500;Light of Altair;Casual;20,000 - 50,000;36;9;27;0;0;0
34600;Order of War;Casual;200,000 - 500,000;418;156;262;750;1391;12
34630;Massive Assault;;0 - 20,000;23;2;21;0;0;2
34640;Massive Assault: Phantom Renaissance;Casual;0 - 20,000;27;4;23;0;0;4
34810;Project Freedom;Strategy, Casual;20,000 - 50,000;141;29;112;18;18;1
34820;Combat Wings: Battle of Britain;Adventure, Casual;100,000 - 200,000;526;142;384;49;73;2
34830;Sniper: Ghost Warrior;Action, Simulation;1,000,000 - 2,000,000;4114;3057;1057;576;96;45
34870;Sniper: Ghost Warrior 2;Action, Simulation;1,000,000 - 2,000,000;12473;4186;8287;272;151;111
34900;Bad Rats: the Rats' Revenge;Nudity, Action, Adventure;200,000 - 500,000;11652;3109;8543;95;90;21
34920;Razor2: Hidden Skies;Action;50,000 - 100,000;54;161;-107;3;3;0
35000;Mini Ninjas;Strategy;200,000 - 500,000;3486;419;3067;72;29;10
35010;Batman: Arkham Asylum Game of the Year Edition;Action, RPG, Indie;50,000 - 100,000;21567;916;20651;1705;1705;0
35070;Flora's Fruit Farm;Simulation;20,000 - 50,000;85;70;15;29;29;0
35130;Lara Croft and the Guardian of Light;Simulation;500,000 - 1,000,000;3760;350;3410;230;144;16
35140;Batman: Arkham Asylum Game of the Year Edition;Simulation;2,000,000 - 5,000,000;47122;1785;45337;700;390;1529
35300;Warfare;Simulation;20,000 - 50,000;154;30;124;0;0;0
35310;Clutch;Adventure;20,000 - 50,000;144;63;81;0;0;0
35320;Insane 2;Adventure, RPG;50,000 - 100,000;459;94;365;0;0;0
35450;Red Orchestra 2: Heroes of Stalingrad with Rising Storm;Simulation;2,000,000 - 5,000,000;33519;2756;30763;1288;267;240
35460;The Ball;Casual;200,000 - 500,000;765;272;493;148;80;1
35470;The Ball Beta;Simulation;0 - 20,000;0;0;0;0;0;0
35480;Dwarfs!?;Casual;200,000 - 500,000;740;238;502;126;99;2
35600;Big Brain Wolf;Casual;20,000 - 50,000;46;44;2;0;0;0
35700;Trine Enchanted Edition;Casual;2,000,000 - 5,000,000;13253;575;12678;309;233;44
35720;Trine 2: Complete Story;Casual;2,000,000 - 5,000,000;19771;917;18854;450;222;69
35800;BRAINPIPE: A Plunge to Unhumanity;Casual;20,000 - 50,000;153;26;127;21;21;0
36000;Foreign Legion: Buckets of Blood;Casual;100,000 - 200,000;189;119;70;41;20;0
36100;Tradewinds Classics;Casual;0 - 20,000;71;4;67;0;0;1
36130;Tradewinds Caravans + Odyssey Pack;Casual;0 - 20,000;7;1;6;0;0;1
36150;Westward Collection;Adventure, Indie;0 - 20,000;17;1;16;0;0;0
36180;Cake Mania Collection;Indie, Casual;0 - 20,000;57;20;37;0;0;0
36210;Monster Mash;Adventure, Casual, Indie;0 - 20,000;18;4;14;0;0;0
36240;Kuros;Action;0 - 20,000;11;1;10;0;0;0
36270;Super Granny Collection;Indie, Casual;0 - 20,000;15;3;12;2;2;0
36300;Cake Mania Main Street;Casual;0 - 20,000;23;6;17;0;0;1
36310;Westward IV: All Aboard;Casual;0 - 20,000;24;1;23;0;0;0
36320;Iron Roses;Casual, Simulation;0 - 20,000;4;4;0;0;0;0
36900;Angle of Attack;Simulation;20,000 - 50,000;0;3;-3;0;0;0
36910;All Aspect Warfare;Simulation;50,000 - 100,000;3;10;-7;0;0;0
37000;The Void;Simulation;50,000 - 100,000;797;184;613;101;119;4
37010;Ninja Blade;Simulation;20,000 - 50,000;189;132;57;0;0;1
37030;UFO: Extraterrestrials Gold;Casual;100,000 - 200,000;173;52;121;268;384;2
37100;Aztaka;Casual;50,000 - 100,000;105;47;58;0;0;0
37210;Chocolatier: Decadence by Design;Casual;20,000 - 50,000;133;61;72;285;285;2
37220;Cooking Dash;Casual;0 - 20,000;66;28;38;255;255;7
37220;Cooking Dash;Casual;0 - 20,000;66;28;38;255;255;7
37230;Diaper Dash;Casual;0 - 20,000;18;5;13;0;0;0
37240;Diner Dash: Hometown Hero;Casual;0 - 20,000;71;145;-74;0;0;5
37260;Emerald City Confidential;Casual;0 - 20,000;73;4;69;0;0;0
37270;Wandering Willows;Casual;0 - 20,000;25;1;24;0;0;0
37280;Wedding Dash 2: Rings Around the World;Simulation;0 - 20,000;36;11;25;0;0;5
37290;Zenerchi;RPG;0 - 20,000;11;1;10;0;0;0
37300;DinerTown Tycoon;RPG;0 - 20,000;10;9;1;0;0;0
37310;DinerTown Detective Agency;Strategy;0 - 20,000;6;11;-5;0;0;0
37320;The Nightshift Code;Action;0 - 20,000;3;4;-1;0;0;0
37330;Nightshift Legacy: The Jaguar's Eye;;0 - 20,000;3;1;2;0;0;0
37340;Fitness Dash;Action;0 - 20,000;10;3;7;9;9;0
37360;Mahjong Roadshow;Action;0 - 20,000;6;3;3;0;0;0
37370;TriJinx: A Kristine Kross Mystery;Action, Adventure;0 - 20,000;5;2;3;0;0;1
37380;Valerie Porter and the Scarlet Scandal;Casual, Indie;0 - 20,000;6;6;0;0;0;0
37390;Gemini Lost;Casual, Indie;0 - 20,000;36;1;35;0;0;4
37390;Gemini Lost;Casual, Indie, Strategy;0 - 20,000;36;1;35;0;0;4
37400;Time Gentlemen, Please! and Ben There, Dan That! Special Edition  Double Pack;Action, Indie;200,000 - 500,000;545;131;414;16;9;0
37600;Windosill;Adventure, Simulation, Strategy;100,000 - 200,000;987;92;895;43;55;1
37700;Darkest of Days;Casual;20,000 - 50,000;231;73;158;520;520;3
37800;Quantz;Free to Play, Massively Multiplayer, RPG;0 - 20,000;30;14;16;36;60;0
37970;Jewel Quest Pack;RPG;0 - 20,000;19;3;16;0;0;0
38000;Mahjong Quest Collection;RPG;0 - 20,000;37;3;34;0;0;5
38070;Coconut Queen;Action, RPG;0 - 20,000;14;1;13;0;0;0
38080;Build-A-Lot;RPG;0 - 20,000;39;2;37;0;0;3
38090;Build-A-Lot 2: Town of the Year;RPG;0 - 20,000;17;0;17;0;0;2
38100;Build-A-Lot 3: Passport to Europe;Massively Multiplayer, RPG;0 - 20,000;12;2;10;0;0;0
38110;Build-A-Lot 4: Power Source;Action, RPG;0 - 20,000;16;5;11;0;0;0
38120;Farm Frenzy;Action, RPG;0 - 20,000;60;4;56;15;15;0
38130;Farm Frenzy 2;Simulation, Strategy;0 - 20,000;94;3;91;0;0;15
38140;Farm Frenzy: Pizza Party;Action;0 - 20,000;25;3;22;0;0;4
38150;Farm Frenzy 3;Action, RPG;20,000 - 50,000;33;1;32;0;0;0
38160;Farm Frenzy 3: American Pie;RPG, Strategy;0 - 20,000;8;0;8;0;0;1
38170;Cradle of Rome;Action;0 - 20,000;41;3;38;0;0;14
38180;Cradle of Persia;Action;0 - 20,000;7;0;7;0;0;5
38190;Romance of Rome;Action;0 - 20,000;6;5;1;0;0;0
38210;Roogoo;Simulation, Strategy;50,000 - 100,000;270;65;205;14;14;0
38230;Hotel Giant 2;Simulation, Strategy;20,000 - 50,000;113;143;-30;10;10;4
38400;Fallout: A Post Nuclear Role Playing Game;Action;2,000,000 - 5,000,000;14860;1007;13853;358;50;130
38410;Fallout 2: A Post Nuclear Role Playing Game;Simulation, Strategy;1,000,000 - 2,000,000;10828;663;10165;1244;163;194
38420;Fallout Tactics: Brotherhood of Steel;RPG;1,000,000 - 2,000,000;1619;425;1194;35;28;40
38430;Kingpin — Life of Crime;Action, Indie;20,000 - 50,000;280;77;203;46;46;2
38440;Sacrifice;Action;50,000 - 100,000;505;44;461;0;0;2
38450;MDK;Strategy;20,000 - 50,000;224;67;157;18;27;0
38460;MDK 2;Casual;20,000 - 50,000;141;35;106;0;0;2
38490;Earthworm Jim 2;Casual;20,000 - 50,000;69;29;40;0;0;0
38600;Faerie Solitaire;RPG;20,000 - 50,000;2274;224;2050;601;565;6
38700;Toki Tori;Strategy;200,000 - 500,000;1799;251;1548;193;66;1
38720;RUSH;Adventure;200,000 - 500,000;1117;126;991;50;47;1
38740;EDGE;Adventure;200,000 - 500,000;1908;166;1742;100;18;1
39000;Moonbase Alpha;Adventure;1,000,000 - 2,000,000;11376;1226;10150;113;38;12
39110;SEASON OF MYSTERY: The Cherry Blossom Murders;Racing;20,000 - 50,000;218;49;169;427;427;1
39120;RIFT;RPG;2,000,000 - 5,000,000;7996;2723;5273;1214;262;185
39140;FINAL FANTASY VII;Indie, Strategy;1,000,000 - 2,000,000;21346;1600;19746;731;177;457
39150;FINAL FANTASY VIII;Casual, Indie;500,000 - 1,000,000;7366;941;6425;2681;1376;110
39160;Dungeon Siege III;Action, Strategy, Indie;200,000 - 500,000;1514;1100;414;355;210;23
39190;Dungeon Siege;Adventure, Indie;500,000 - 1,000,000;2638;637;2001;206;100;61
39200;Dungeon Siege II;Adventure, Casual, Indie;500,000 - 1,000,000;1603;581;1022;1026;1124;57
39210;FINAL FANTASY XIV Online;Indie;2,000,000 - 5,000,000;56613;7192;49421;19597;3330;29546
39360;Freeze Tag Fun Pack #1;Adventure, Indie;0 - 20,000;0;0;0;0;0;0
39500;Gothic 3;Simulation, Strategy;1,000,000 - 2,000,000;7429;1597;5832;891;366;491
39510;Gothic II: Gold Edition;Simulation, Strategy;500,000 - 1,000,000;10512;775;9737;1147;326;551
39520;The Guild Gold Edition;Simulation, Strategy;100,000 - 200,000;337;123;214;246;368;5
39530;Painkiller: Black Edition;Simulation, Strategy;100,000 - 200,000;1387;163;1224;422;222;23
39540;SpellForce - Platinum Edition;Violent, Action, Adventure;200,000 - 500,000;1822;277;1545;1538;1730;301
39550;SpellForce 2 - Anniversary Edition;Action, Indie;100,000 - 200,000;733;254;479;901;1045;41
39560;Painkiller: Resurrection;Action, Indie;100,000 - 200,000;133;356;-223;97;139;1
39630;AquaNox;Action, Indie;100,000 - 200,000;232;92;140;15;23;3
39640;AquaNox 2: Revelation;Action, Indie;50,000 - 100,000;163;57;106;123;244;3
39650;The Guild II;Action, Indie;500,000 - 1,000,000;536;230;306;146;185;9
39660;The Guild II - Pirates of the European Seas;Action, Free to Play, Indie;100,000 - 200,000;162;68;94;469;746;4
39670;Chaser;;100,000 - 200,000;800;324;476;719;828;3
39680;The Guild II Renaissance;Action, Indie;200,000 - 500,000;3021;636;2385;939;476;59
39690;ArcaniA;RPG;500,000 - 1,000,000;1397;1118;279;97;58;29
39800;Nation Red;Action, Adventure;200,000 - 500,000;2348;316;2032;359;179;4
39900;Coniclysm;Action, Adventure, Indie;0 - 20,000;16;17;-1;0;0;0
40100;Supreme Commander 2;Indie;1,000,000 - 2,000,000;9767;1318;8449;2856;994;310
40210;ItzaZoo;Action, RPG;0 - 20,000;12;1;11;0;0;0
40300;Risen;Action, Adventure, Simulation;500,000 - 1,000,000;7091;909;6182;938;278;281
40320;Rush for Berlin Gold;Indie, Simulation, Strategy;20,000 - 50,000;134;19;115;0;0;5
40330;Secret Files: Tunguska;Action, Adventure, RPG;100,000 - 200,000;309;50;259;690;994;7
40340;Secret Files 2: Puritas Cordis;Casual, Indie;20,000 - 50,000;127;24;103;80;80;6
40350;Lost Horizon;Action;50,000 - 100,000;374;38;336;49;49;0
40370;Emergency 2012;Adventure, Casual, Indie;0 - 20,000;6;2;4;13;13;0
40380;nail'd;Action, Adventure, Indie, RPG, Strategy;100,000 - 200,000;939;232;707;134;198;1
40390;Risen 2: Dark Waters;;1,000,000 - 2,000,000;4461;1134;3327;759;186;110
40400;AI War: Fleet Command;Adventure;200,000 - 500,000;1261;264;997;207;209;3
40420;Tidalis;Adventure;100,000 - 200,000;146;78;68;74;107;1
40500;Sacraboar;Adventure;20,000 - 50,000;15;49;-34;0;0;0
40700;Machinarium;Action, Indie;500,000 - 1,000,000;11204;518;10686;223;194;34
40720;Samorost 2;Action;100,000 - 200,000;1481;238;1243;344;501;1
40800;Super Meat Boy;Action;2,000,000 - 5,000,000;29357;1600;27757;293;121;74
40930;The Misadventures of P.B. Winterbottom;Strategy;100,000 - 200,000;381;50;331;221;288;3
40950;Stronghold HD;Strategy;1,000,000 - 2,000,000;7760;369;7391;406;204;306
40960;Stronghold 2: Steam Edition;Strategy;200,000 - 500,000;3540;488;3052;633;356;258
40970;Stronghold Crusader HD;Action, RPG;1,000,000 - 2,000,000;14603;374;14229;1032;280;1431
40980;Stronghold Legends: Steam Edition;Strategy;100,000 - 200,000;1574;260;1314;499;362;91
40990;Mafia;Strategy;1,000,000 - 2,000,000;10009;1459;8550;211;35;253
41000;Serious Sam HD: The First Encounter;Strategy;1,000,000 - 2,000,000;6452;433;6019;261;199;31
41014;Serious Sam HD: The Second Encounter;Strategy;200,000 - 500,000;556;52;504;0;0;0
41050;Serious Sam Classic: The First Encounter;Strategy;200,000 - 500,000;2519;104;2415;543;49;10
41060;Serious Sam Classic: The Second Encounter;Strategy;200,000 - 500,000;1515;59;1456;646;218;13
41070;Serious Sam 3: BFE;Strategy;500,000 - 1,000,000;22660;2972;19688;486;280;104
41100;Hammerfight;Action;200,000 - 500,000;1310;544;766;238;330;5
41300;Altitude;Simulation;100,000 - 200,000;1693;144;1549;396;102;2
41310;Altitude - Demo;Action, Indie;0 - 20,000;0;0;0;0;0;0
41400;Doom Rails;Simulation, Strategy;0 - 20,000;8;23;-15;0;0;0
41500;Torchlight;Adventure;1,000,000 - 2,000,000;5631;516;5115;997;679;42
41600;Earthworm Jim 3D;Action, Indie, Racing;20,000 - 50,000;53;53;0;18;18;0
41660;Tommy Tronic;Action, Strategy;0 - 20,000;9;8;1;0;0;0
41680;Death and the Fly;Racing, Sports;0 - 20,000;3;10;-7;0;0;0
41700;S.T.A.L.K.E.R.: Call of Pripyat;Racing, Simulation, Sports;1,000,000 - 2,000,000;22988;1162;21826;1747;442;420
41730;Ion Assault;Racing, Sports;20,000 - 50,000;110;49;61;24;25;0
41730;Ion Assault;Racing;20,000 - 50,000;110;49;61;24;25;0
41740;Cargo! The Quest for Gravity;Racing, Simulation, Sports;200,000 - 500,000;308;79;229;58;111;0
41800;Gratuitous Space Battles;Indie, Strategy;100,000 - 200,000;601;208;393;237;117;2
41900;The Bard's Tale ARPG: Remastered and Resnarkled;Casual, Indie;500,000 - 1,000,000;903;279;624;106;77;5
42000;Trino;Simulation;0 - 20,000;8;5;3;0;0;0
42120;Lead and Gold: Gangs of the Wild West;Indie;500,000 - 1,000,000;1553;604;949;258;44;0
42140;Hamilton's Great Adventure;Racing;50,000 - 100,000;208;95;113;179;186;1
42147;Hamilton's Great Adventure - Retro Fever DLC;Casual, Indie, Simulation;20,000 - 50,000;1;0;1;0;0;0
42170;Krater;Casual, Indie;200,000 - 500,000;477;383;94;118;142;1
42200;Nancy Drew Dossier: Resorting to Danger!;Action, Adventure;20,000 - 50,000;68;13;55;0;0;0
42210;Nancy Drew: Secrets Can Kill REMASTERED;Action, Adventure;20,000 - 50,000;177;60;117;187;187;5
42220;Nancy Drew: The Captive Curse;Action, Adventure;20,000 - 50,000;142;19;123;0;0;6
42230;Nancy Drew: Trail of the Twister;Action, Adventure;20,000 - 50,000;78;40;38;0;0;4
42500;DogFighter;Action, Adventure;100,000 - 200,000;262;165;97;95;118;0
42670;Singularity;Action, Adventure;200,000 - 500,000;4454;351;4103;425;610;11
42700;Call of Duty: Black Ops;Action;2,000,000 - 5,000,000;29407;2964;26443;1390;595;574
42810;For The Glory: A Europa Universalis Game;Action, Adventure;50,000 - 100,000;93;40;53;0;0;3
42850;Arsenal of Democracy: A Hearts of Iron Game;Adventure, Indie;50,000 - 100,000;283;49;234;0;0;39
42890;Sword of the Stars: Complete Collection;Action, Racing;100,000 - 200,000;529;67;462;1646;3253;32
42900;Hearts of Iron III: Semper Fi;Action;50,000 - 100,000;1;0;1;0;0;0
42910;Magicka;RPG, Strategy;2,000,000 - 5,000,000;25719;3356;22363;584;280;107
42920;The Kings' Crusade;RPG, Strategy;50,000 - 100,000;59;91;-32;6;6;0
42930;Elven Legacy: Magic;RPG, Strategy;20,000 - 50,000;15;5;10;0;0;0
42940;Elven Legacy: Siege;Strategy;20,000 - 50,000;15;4;11;0;0;0
42950;Elven Legacy: Ranger;Simulation, Strategy;20,000 - 50,000;20;1;19;0;0;0
42960;Victoria II;Strategy;1,000,000 - 2,000,000;15606;1282;14324;4729;1067;827
42980;Victoria I Complete;Simulation, Strategy;100,000 - 200,000;160;63;97;3;3;5
42990;Sword of the Stars II: Enhanced Edition;Simulation;200,000 - 500,000;398;506;-108;334;605;5
43000;Front Mission Evolved;Strategy;200,000 - 500,000;649;390;259;66;104;1
43100;World of Zoo;Action, RPG;50,000 - 100,000;170;37;133;0;0;4
43190;The Haunted: Hells Reach;Action, Indie, RPG;;;;0;;;
43190;The Haunted: Hells Reach;Strategy;;;;0;;;
43500;M.U.D. TV;Indie, RPG, Strategy;20,000 - 50,000;71;101;-30;0;0;0
43500;M.U.D. TV;Adventure;20,000 - 50,000;71;101;-30;0;0;0
43600;Nancy Drew: Warnings at Waverly Academy;;20,000 - 50,000;191;22;169;0;0;2
44100;Super Laser  Racer;Adventure;20,000 - 50,000;82;12;70;46;46;1
44340;Operation Flashpoint: Red River;Adventure;500,000 - 1,000,000;766;709;57;347;95;3
44360;F1 2011;Adventure, Casual;50,000 - 100,000;534;177;357;958;1697;6
44600;GTR - FIA GT Racing Game;Adventure;20,000 - 50,000;69;36;33;34;34;0
44680;RACE Injection;Action, Indie;0 - 20,000;14;1;13;1;1;0
44690;GT Legends;Action, Strategy;20,000 - 50,000;265;29;236;119;178;0
44690;GT Legends;Adventure;20,000 - 50,000;265;29;236;119;178;0
45000;Sol Survivor;Strategy;100,000 - 200,000;364;39;325;1043;1452;6
45100;Secret of the Magic Crystals;Adventure, Indie, RPG, Strategy;50,000 - 100,000;1370;293;1077;145;209;3
45200;Defense of the Oasis;Action, Casual, Indie;20,000 - 50,000;36;3;33;0;0;0
45300;Wings of Prey;Strategy;100,000 - 200,000;408;220;188;1529;1831;5
45400;Fortix;Strategy;50,000 - 100,000;844;73;771;269;362;0
45410;Ignite;RPG;20,000 - 50,000;168;127;41;0;0;0
45420;Land It!;RPG;0 - 20,000;10;1;9;0;0;0
45450;Fortix 2;Simulation;50,000 - 100,000;510;48;462;181;155;0
45700;Devil May Cry 4;Adventure, Indie;200,000 - 500,000;1900;177;1723;192;214;8
45710;Dark Void;Strategy;50,000 - 100,000;299;255;44;194;137;0
45720;Lost Planet: Extreme Condition Colonies Edition;Indie, Simulation, Strategy;20,000 - 50,000;237;135;102;53;60;1
45730;Dark Void Zero;Strategy;20,000 - 50,000;138;149;-11;29;38;0
45740;Dead Rising 2;Strategy;500,000 - 1,000,000;4854;1366;3488;364;235;70
45750;Lost Planet 2;Strategy;200,000 - 500,000;1714;823;891;451;314;12
45760;Ultra Street Fighter IV;Casual;500,000 - 1,000,000;11395;1322;10073;1136;261;167
45770;Dead Rising 2: Off the Record;Adventure, Casual;200,000 - 500,000;2350;625;1725;478;312;46
46000;Bob Came in Pieces;Action;50,000 - 100,000;78;34;44;123;121;0
46200;A.I.M. Racing;Action;20,000 - 50,000;65;37;28;26;26;0
46250;NecroVisioN: Lost Company;Adventure;50,000 - 100,000;319;137;182;21;26;2
46260;Star Wolves 3: Civil War;Simulation, Strategy;100,000 - 200,000;481;115;366;296;371;12
46270;Star Wolves;Free to Play, Massively Multiplayer, Strategy;50,000 - 100,000;303;62;241;169;169;4
46280;Star Wolves 2;Casual;50,000 - 100,000;54;82;-28;0;0;1
46290;Theatre of War;Casual;100,000 - 200,000;182;112;70;16;16;0
46340;Theatre of War 2: Africa 1943;RPG, Casual;50,000 - 100,000;156;71;85;57;57;2
46350;Real Warfare 1242;Casual;20,000 - 50,000;48;42;6;1;1;0
46360;Theatre of War 2: Kursk 1943;Strategy;50,000 - 100,000;133;59;74;1;1;5
46370;Rig n Roll;RPG;50,000 - 100,000;287;217;70;216;216;3
46380;Reign: Conflict of Nations;Action;20,000 - 50,000;51;52;-1;14;14;1
46400;Greed: Black Border;Action;100,000 - 200,000;127;173;-46;84;132;0
46410;Avencast: Rise of the Mage;Strategy;50,000 - 100,000;446;203;243;38;68;1
46440;Future Wars;RPG;50,000 - 100,000;90;209;-119;61;73;0
46450;Grotesque Tactics: Evil Heroes;Racing;100,000 - 200,000;265;163;102;17;28;1
46460;Scratches - Director's Cut;Simulation;100,000 - 200,000;316;71;245;78;154;0
46470;Grotesque Tactics: Evil Heroes - Dev;Racing;0 - 20,000;0;0;0;0;0;0
46480;Still Life;Adventure, Indie;100,000 - 200,000;715;146;569;43;72;4
46490;Still Life 2;Simulation;100,000 - 200,000;209;243;-34;0;0;4
46500;Syberia;Casual;500,000 - 1,000,000;4592;583;4009;165;158;55
46510;Syberia II;Action, Adventure;500,000 - 1,000,000;1961;319;1642;237;242;16
46520;Wasteland Angel;RPG, Strategy;50,000 - 100,000;177;129;48;0;0;1
46540;Trapped Dead;Strategy;100,000 - 200,000;291;432;-141;197;251;0
46550;Post Mortem;Action, RPG;100,000 - 200,000;178;149;29;4;4;1
46560;Robin Hood: The Legend of Sherwood;Action, RPG;200,000 - 500,000;848;484;364;184;360;15
46570;Grotesque Tactics 2 – Dungeons and Donuts;Simulation;50,000 - 100,000;120;112;8;0;0;0
46600;Swarm Arena;Indie;50,000 - 100,000;45;16;29;83;83;0
46700;Ironclads: American Civil War;Strategy;0 - 20,000;10;36;-26;0;0;0
46710;Ironclads: High Seas;Casual;20,000 - 50,000;15;24;-9;0;0;0
46740;World Basketball Manager 2010;Strategy;20,000 - 50,000;40;87;-47;0;0;2
46750;Dark Fall: Lost Souls;Casual;50,000 - 100,000;143;91;52;184;350;1
46760;Ironclads: Schleswig War 1864;Strategy;20,000 - 50,000;8;17;-9;0;0;0
46770;Making History II: The War of the World;Strategy;50,000 - 100,000;283;75;208;970;970;34
46790;Armada 2526;Action, RPG;0 - 20,000;19;16;3;0;0;1
46830;Ironclads: Anglo Russian War 1866;Action;20,000 - 50,000;9;19;-10;0;0;0
46840;Ironclads: Chincha Islands War 1866;Action, Casual, Indie;20,000 - 50,000;3;12;-9;0;0;0
46850;Zombie Pirates;Action, Indie;0 - 20,000;33;21;12;0;0;0
47000;4 Elements;Indie;50,000 - 100,000;633;93;540;80;80;7
47120;Escape From Paradise 2;Action, Indie;0 - 20,000;2;2;0;0;0;1
47130;Book of Legends;Indie, Racing;0 - 20,000;6;2;4;0;0;0
47400;Stronghold 3 Gold;Action;500,000 - 1,000,000;1347;2899;-1552;232;113;31
47410;Stronghold Kingdoms;Action, Adventure;1,000,000 - 2,000,000;5697;3114;2583;4712;77;533
47500;Mishap: An Accidental Haunting;;0 - 20,000;13;3;10;0;0;0
47520;The Otherside: Realm of Eons;Action;0 - 20,000;5;1;4;0;0;0
47540;Puzzle Quest 2;Action, Adventure;50,000 - 100,000;311;61;250;1703;1703;8
47570;Mishap 2: An Intentional Haunting - Collector's Edition;Indie;0 - 20,000;2;0;2;0;0;0
47700;Command & Conquer 4: Tiberian Twilight;Casual;200,000 - 500,000;546;2547;-2001;336;232;3
47730;Dragon Age: Origins Awakening;Casual, Indie;100,000 - 200,000;137;11;126;1;1;1
47780;Dead Space 2;Casual;2,000,000 - 5,000,000;19445;1215;18230;553;296;411
47790;Medal of Honor;Casual;1,000,000 - 2,000,000;5861;2097;3764;176;94;45
47810;Dragon Age: Origins - Ultimate Edition;Casual;1,000,000 - 2,000,000;17670;1919;15751;2037;962;868
47870;Need For Speed: Hot Pursuit;Casual;2,000,000 - 5,000,000;16217;3467;12750;693;255;75
47880;Battlefield: Bad Company 2 Vietnam;Casual;50,000 - 100,000;217;4;213;0;0;0
47890;The Sims 3;;2,000,000 - 5,000,000;24884;3863;21021;2739;931;2181
47920;Shift 2 Unleashed;;100,000 - 200,000;1645;800;845;407;698;7
48000;LIMBO;;2,000,000 - 5,000,000;41761;2902;38859;156;113;74
48110;Silent Hunter 5: Battle of the Atlantic;Casual;100,000 - 200,000;1014;1290;-276;896;1574;22
48150;Voodoo Dice;Casual, Simulation;20,000 - 50,000;13;2;11;0;0;0
48190;Assassin’s Creed Brotherhood;Casual;1,000,000 - 2,000,000;15126;1879;13247;2240;660;196
48220;Might & Magic: Heroes VI;Casual, Indie;500,000 - 1,000,000;3877;4191;-314;2970;1678;108
48240;Anno 2070;Adventure, Casual;500,000 - 1,000,000;7016;4633;2383;2033;866;120
48700;Mount & Blade: Warband;Adventure, Indie, Strategy;2,000,000 - 5,000,000;146159;3364;142795;7250;1848;4203
48720;Mount & Blade: With Fire & Sword;;1,000,000 - 2,000,000;10932;1487;9445;1382;410;238
48800;Ship Simulator Extremes;Indie, Strategy;100,000 - 200,000;1053;1022;31;258;283;19
48900;Saira;Action;20,000 - 50,000;239;63;176;9;11;0
48950;Greed Corp;Action;200,000 - 500,000;445;74;371;117;118;1
49000;Hotel Dash Suite Success;;0 - 20,000;65;15;50;0;0;2
49300;Commander: Conquest of the Americas;Racing;50,000 - 100,000;81;83;-2;220;220;4
49320;Woody Two-Legs: Attack of the Zombie Pirates;Action;20,000 - 50,000;32;28;4;0;0;0
49330;Pirates of Black Cove;;50,000 - 100,000;102;56;46;221;221;1
49470;Magic: The Gathering - Duels of the Planeswalkers 2012;;100,000 - 200,000;822;116;706;1066;789;16
49520;Borderlands 2;Action;10,000,000 - 20,000,000;253754;16840;236914;3270;1043;4418
49540;Aliens: Colonial Marines Collection;Action, Adventure;1,000,000 - 2,000,000;5987;4158;1829;383;318;36
49600;Beat Hazard;Casual, Indie;500,000 - 1,000,000;6791;373;6418;289;208;6
49800;Flight of the Icarus;Action, Adventure, Indie;50,000 - 100,000;99;151;-52;21;22;0
49810;CreaVures;Strategy;50,000 - 100,000;133;36;97;0;0;0
49900;Plain Sight;Adventure;50,000 - 100,000;188;91;97;136;148;1
50000;Nimbus;RPG, Strategy;50,000 - 100,000;223;12;211;134;134;0
50000;Nimbus;Action, Adventure;50,000 - 100,000;223;12;211;134;134;0
50130;Mafia II (Classic);Simulation, Strategy;2,000,000 - 5,000,000;46747;2445;44302;1510;850;770
50300;Spec Ops: The Line;Action, Casual, Indie;2,000,000 - 5,000,000;46410;3446;42964;299;188;289
50400;Mafia II - JAPAN;RPG, Simulation, Strategy;0 - 20,000;0;0;0;0;0;2
50510;Burn Zombie Burn!;Adventure, Casual, Indie;50,000 - 100,000;73;103;-30;70;83;0
50620;Darksiders;Action;2,000,000 - 5,000,000;10509;1258;9251;589;80;28
50820;Max and the Magic Marker;Adventure, Casual, Indie;0 - 20,000;39;16;23;46;46;0
50910;Professor Fizzwizzle and the Molten Mystery;Adventure, Casual, Indie;0 - 20,000;29;0;29;0;0;0
50920;Hidden Expedition: Amazon;Casual, Indie;0 - 20,000;13;7;6;0;0;0
50930;Hidden Expedition: Everest;Sports, Strategy;0 - 20,000;7;4;3;0;0;0
50940;Hidden Expedition: Titanic;Strategy;0 - 20,000;15;3;12;0;0;0
50960;Mystery Case Files: Huntsville;Adventure;0 - 20,000;46;12;34;0;0;1
50970;Mystery Case Files: Madame Fate;Adventure;0 - 20,000;39;12;27;0;0;0
50980;Mystery Case Files: Prime Suspects;Strategy;0 - 20,000;37;9;28;304;304;5
50990;Mystery Case Files: Ravenhearst;Action, Adventure, Casual;0 - 20,000;81;11;70;0;0;3
51000;Mystery Case Files: Return to Ravenhearst;Adventure, Casual, Indie;50,000 - 100,000;64;15;49;0;0;1
51010;My Tribe;Action, Indie;0 - 20,000;75;19;56;0;0;6
51020;Unwell Mel;Strategy, Indie;0 - 20,000;10;1;9;0;0;0
51030;Atlantis Sky Patrol;RPG;0 - 20,000;13;2;11;0;0;0
51060;Drawn: The Painted Tower;Indie, Casual;0 - 20,000;143;25;118;192;192;0
55000;Flotilla;Indie, Casual;100,000 - 200,000;179;35;144;158;168;0
55020;Air Forte;RPG, Strategy;0 - 20,000;42;34;8;9;9;0
55040;Atom Zombie Smasher;RPG, Strategy;200,000 - 500,000;1694;207;1487;112;111;5
55100;Homefront;RPG, Strategy;2,000,000 - 5,000,000;7095;4687;2408;211;94;13
55110;Red Faction: Armageddon;Indie, Casual;1,000,000 - 2,000,000;3248;1219;2029;268;135;9
55130;HOMEFRONT Demo;RPG, Strategy;0 - 20,000;0;0;0;1;1;1
55140;MX vs. ATV Reflex;Action, Indie, Casual;200,000 - 500,000;2861;439;2422;2291;86;34
55150;Warhammer 40,000: Space Marine - Anniversary Edition;Action, Casual;2,000,000 - 5,000,000;19828;1747;18081;746;342;183
55190;HOMEFRONT [Alpha];Casual;0 - 20,000;0;0;0;0;0;0
55210;HOMEFRONT - Japanese;Action, Casual, Indie, Strategy;0 - 20,000;0;0;0;0;0;0
55230;Saints Row: The Third;Adventure;2,000,000 - 5,000,000;63709;2740;60969;1549;911;251
56437;Warhammer 40,000: Dawn of War II: Retribution;Action, Strategy, Indie, Sports;1,000,000 - 2,000,000;10025;1026;8999;0;0;0
56438;Dawn of War II: Retribution – The Last Stand;;20,000 - 50,000;29;1;28;0;0;0
57000;NyxQuest: Kindred Spirits;Action;20,000 - 50,000;103;12;91;0;0;0
57200;Puzzle Dimension;Action, Casual, Indie, Strategy;50,000 - 100,000;437;45;392;3;5;0
57300;Amnesia: The Dark Descent;Adventure, Casual;500,000 - 1,000,000;28844;1611;27233;199;68;70
57400;Batman: Arkham City;Adventure, Casual;20,000 - 50,000;1987;27;1960;922;856;0
57640;Broken Sword: Director's Cut;Adventure, Casual;200,000 - 500,000;2117;161;1956;591;741;23
57650;Dungeons;Adventure, Casual;200,000 - 500,000;320;391;-71;355;292;3
57680;The First Templar - Steam Special Edition;Adventure, Casual;100,000 - 200,000;648;264;384;269;404;1
57690;Tropico 4;Adventure, Casual;2,000,000 - 5,000,000;10816;977;9839;565;190;143
57700;Who's That Flying?!;Action, Casual, Indie;20,000 - 50,000;111;47;64;62;63;0
57740;Jagged Alliance - Back in Action;Action, Indie;200,000 - 500,000;1095;435;660;351;308;71
57800;Doc Clock: The Toasted Sandwich of Time;Adventure, Indie, RPG, Strategy;20,000 - 50,000;84;98;-14;9;15;0
57900;Duke Nukem Forever;Strategy;1,000,000 - 2,000,000;6483;3044;3439;457;245;87
58200;Jolly Rover;RPG, Strategy;100,000 - 200,000;285;35;250;147;147;1
58230;MacGuffin's Curse;Strategy;20,000 - 50,000;101;20;81;833;1394;0
58400;Turba;Simulation;20,000 - 50,000;49;91;-42;14;20;0
58520;Blood Bowl - Legendary Edition;Strategy;100,000 - 200,000;809;263;546;1388;137;6
58550;A Game of Thrones - Genesis;Strategy;100,000 - 200,000;234;448;-214;93;152;0
58560;Runaway: A Twist of Fate;Racing, Simulation;100,000 - 200,000;326;39;287;118;118;1
58570;The Next BIG Thing;Adventure;100,000 - 200,000;494;92;402;178;247;1
58610;Wargame: European Escalation;Simulation;500,000 - 1,000,000;2377;679;1698;1090;204;32
60340;Luxor: 5th Passage;Simulation;20,000 - 50,000;62;33;29;0;0;4
60350;Glowfish;Action, Indie;20,000 - 50,000;122;18;104;2;2;0
60600;ProtoGalaxy;Strategy, Indie;50,000 - 100,000;35;26;9;4;4;0
60700;Power of Defense;Adventure;0 - 20,000;9;30;-21;0;0;0
60800;Numen: Contest of Heroes;RPG, Strategy;50,000 - 100,000;86;91;-5;48;48;1
61100;Lucid;Action, RPG;50,000 - 100,000;189;57;132;21;29;1
61310;Fractal: Make Blooms Not War;Action;100,000 - 200,000;155;51;104;77;11;0
61500;Age of Wonders;RPG;200,000 - 500,000;632;168;464;456;587;18
61510;Age of Wonders II: The Wizard's Throne;RPG;100,000 - 200,000;228;51;177;9;10;8
61520;Age of Wonders Shadow Magic;Casual;100,000 - 200,000;451;57;394;33;33;40
61600;Zen Bound 2;Simulation;100,000 - 200,000;482;72;410;58;96;0
61700;Might & Magic: Clash of Heroes;Action, Strategy;200,000 - 500,000;2010;353;1657;2325;1223;47
61730;Critter Crunch;Action, Simulation, Strategy;20,000 - 50,000;301;18;283;18;18;0
62000;Flight Control HD;Action, Simulation, Strategy;50,000 - 100,000;472;40;432;83;81;3
62100;Chime;Action, Indie, RPG, Strategy;50,000 - 100,000;672;46;626;166;156;4
63000;HOARD;Action;200,000 - 500,000;792;187;605;61;66;1
63110;Alter Ego;Strategy;50,000 - 100,000;180;75;105;0;0;1
63200;Monday Night Combat;Action, Casual, Indie;200,000 - 500,000;870;242;628;428;554;0
63200;Monday Night Combat;Action;200,000 - 500,000;870;242;628;428;554;0
63230;Monday Night Combat Development;Action, Indie;0 - 20,000;0;0;0;0;0;0
63380;Sniper Elite V2;Simulation;2,000,000 - 5,000,000;21823;2899;18924;521;229;92
63500;Swords and Soldiers HD;Indie, Simulation;200,000 - 500,000;734;206;528;412;55;2
63610;Riven: The Sequel to MYST;Indie;200,000 - 500,000;930;131;799;95;95;15
63620;Cosmic Osmo and the Worlds Beyond the Mackerel;Adventure, Casual, Simulation;20,000 - 50,000;69;21;48;0;0;0
63630;The Manhole: Masterpiece Edition;Adventure, Casual, Indie, Simulation;0 - 20,000;36;14;22;0;0;0
63640;Spelunx and the Caves of Mr. Seudo;Action, Indie;0 - 20,000;28;11;17;0;0;0
63650;URU: Complete Chronicles;RPG, Indie;20,000 - 50,000;118;30;88;84;84;1
63660;Myst: Masterpiece Edition;Action, RPG, Indie;100,000 - 200,000;610;113;497;58;63;12
63700;BIT.TRIP BEAT;Action, Adventure, Casual, Indie;200,000 - 500,000;674;164;510;73;69;2
63710;BIT.TRIP RUNNER;Strategy;500,000 - 1,000,000;3290;535;2755;142;89;4
63800;Delve Deeper;Sports, Strategy;50,000 - 100,000;252;160;92;309;609;0
63900;Fantasy Wars;Strategy;100,000 - 200,000;206;36;170;0;0;1
63910;King's Bounty: Crossworlds;Casual, Strategy;200,000 - 500,000;1061;99;962;3828;3171;89
63940;Men of War: Vietnam;Casual;200,000 - 500,000;675;370;305;299;497;12
63950;IL-2 Sturmovik: Cliffs of Dover;Indie, Strategy;100,000 - 200,000;662;332;330;1457;223;1
63960;Theatre of War 3: Korea;Action, Indie, Simulation;50,000 - 100,000;73;98;-25;68;68;0
64000;Men of War: Assault Squad;Action, Racing;500,000 - 1,000,000;3921;521;3400;1230;286;57
65070;Ride 'em Low;Simulation, Sports;20,000 - 50,000;66;59;7;0;0;0
65080;Kaptain Brawe: A Brawe New World;;200,000 - 500,000;101;34;67;7;7;0
65200;Dive to the Titanic;Action;0 - 20,000;29;54;-25;0;0;0
65270;Demolition Company Gold Edition;;20,000 - 50,000;263;34;229;0;0;0
65300;Dustforce DX;;200,000 - 500,000;1924;270;1654;488;62;12
65400;Archon Classic;Action;20,000 - 50,000;131;25;106;0;0;1
65500;Aura: Fate of the Ages;Indie;20,000 - 50,000;110;80;30;5;5;0
65530;SpellForce 2: Faith in Destiny;Casual, Indie, Simulation;100,000 - 200,000;192;125;67;95;155;10
65540;Gothic 1;Adventure, Indie;500,000 - 1,000,000;10247;856;9391;567;119;332
65560;Painkiller Redemption;Casual, Indie;200,000 - 500,000;285;320;-35;293;293;2
65600;Gothic 3: Forsaken Gods Enhanced Edition;;200,000 - 500,000;512;493;19;71;38;12
65610;ArcaniA: Fall of Setarrif;;100,000 - 200,000;275;405;-130;15;15;2
65710;Pat & Mat;RPG;20,000 - 50,000;387;76;311;0;0;1
65730;Take On Helicopters;Adventure, Indie, RPG;200,000 - 500,000;407;316;91;431;499;2
65740;Carrier Command: Gaea Mission;Simulation;200,000 - 500,000;498;563;-65;579;796;6
65780;ARMA: Gold Edition;Strategy;500,000 - 1,000,000;845;283;562;638;158;8
65790;ARMA: Cold War Assault;Strategy;1,000,000 - 2,000,000;4489;1211;3278;173;18;36
65800;Dungeon Defenders;Strategy;2,000,000 - 5,000,000;14920;1127;13793;2907;920;264
65930;The Bureau: XCOM Declassified;Simulation, Strategy;2,000,000 - 5,000,000;7939;3398;4541;226;136;26
65980;Sid Meier's Civilization: Beyond Earth;RPG, Simulation, Strategy;1,000,000 - 2,000,000;12622;8795;3827;1560;1191;566
67000;The Polynomial - Space of the music;Strategy;100,000 - 200,000;354;132;222;14;16;2
67370;The Darkness II;Strategy, Casual;1,000,000 - 2,000,000;16460;1542;14918;211;116;100
70000;Dino D-Day;Action, Indie, Strategy;1,000,000 - 2,000,000;12597;2417;10180;182;124;14
70100;Hacker Evolution;Casual, Indie, Simulation, Strategy;100,000 - 200,000;643;336;307;241;199;1
70110;Hacker Evolution: Untold;Adventure, Indie;200,000 - 500,000;233;158;75;209;228;0
70120;Hacker Evolution Duality;Adventure, Indie;200,000 - 500,000;174;334;-160;32;33;0
70200;Governor of Poker 2;Adventure, Indie;20,000 - 50,000;117;38;79;0;0;14
70210;Governor of Poker 2 - Premium Edition;Adventure, Indie;20,000 - 50,000;213;41;172;375;375;18
70300;VVVVVV;Adventure, Indie;100,000 - 200,000;8729;336;8393;111;76;21
70400;Recettear: An Item Shop's Tale;Adventure, Indie;500,000 - 1,000,000;6414;257;6157;556;447;27
70420;Chantelise - A Tale of Two Sisters;Simulation;100,000 - 200,000;510;171;339;50;76;2
70500;Diamond Dan;Adventure, Casual;20,000 - 50,000;42;14;28;0;0;0
70600;Worms Ultimate Mayhem;Strategy;500,000 - 1,000,000;4345;596;3749;339;121;27
70620;Worms Crazy Golf;;200,000 - 500,000;514;124;390;74;81;1
70640;Worms;Indie, Racing;100,000 - 200,000;461;84;377;30;60;1
70650;Worms Blast;Action, Indie, Strategy;100,000 - 200,000;174;138;36;61;61;1
70660;Worms Pinball;Action, RPG;200,000 - 500,000;210;223;-13;13;21;0
70900;Star Ruler;Action, Simulation, Strategy;100,000 - 200,000;257;54;203;76;107;0
71110;ESWAT: City Under Siege;Action, Casual, Indie, Strategy;0 - 20,000;4;0;4;0;0;0
71111;Flicky;Action, Indie, RPG;0 - 20,000;5;0;5;0;0;0
71112;Golden Axe II;Casual, Indie;0 - 20,000;9;3;6;0;0;0
71113;Sonic The Hedgehog;Indie, Casual;100,000 - 200,000;34;4;30;0;0;0
71114;Sword of Vermilion;Action, Racing;0 - 20,000;6;0;6;0;0;0
71115;Virtua Fighter 2;Action, Adventure, Indie, Strategy;0 - 20,000;10;3;7;0;0;0
71116;Alien Soldier;Indie, Strategy;0 - 20,000;12;0;12;0;0;0
71117;Gunstar Heroes;Action, Indie;0 - 20,000;16;1;15;0;0;0
71119;Light Crusader;Action, Indie;0 - 20,000;7;0;7;0;0;0
71120;Shining Force;Action, Indie;20,000 - 50,000;19;1;18;0;0;0
71160;Shining Force II;Action, Indie;20,000 - 50,000;13;0;13;0;0;0
71161;Shining in the Darkness;Indie;0 - 20,000;5;0;5;0;0;0
71162;Sonic 3 & Knuckles;Action, Indie;100,000 - 200,000;39;2;37;0;0;0
71164;Streets of Rage;Action;0 - 20,000;18;1;17;0;0;0
71165;Streets of Rage 2;Indie, Simulation;20,000 - 50,000;22;1;21;0;0;0
71166;ToeJam & Earl;Simulation;0 - 20,000;8;0;8;0;0;0
71166;ToeJam & Earl;Action, Indie, Strategy;0 - 20,000;8;0;8;0;0;0
71167;ToeJam & Earl in Panic on Funkotron;Indie, Casual;20,000 - 50,000;3;0;3;0;0;0
71230;Crazy Taxi;Action, Indie;200,000 - 500,000;2623;434;2189;96;34;12
71240;SEGA Bass Fishing;Adventure, Casual, Indie;100,000 - 200,000;688;92;596;10;14;5
71250;Sonic Adventure DX;Action, Indie, Sports;500,000 - 1,000,000;10935;1167;9768;262;183;127
71260;Space Channel 5: Part 2;;100,000 - 200,000;1403;172;1231;115;136;3
71300;Football Manager 2012 Review;;0 - 20,000;0;0;0;0;0;0
71310;Football Manager 2012 Korean;;0 - 20,000;0;0;0;0;0;20
71340;Sonic Generations Collection;;1,000,000 - 2,000,000;19223;1410;17813;408;109;166
71390;Virtua Tennis 4;Adventure, Casual;20,000 - 50,000;227;89;138;113;170;0
72000;Closure;;200,000 - 500,000;799;134;665;123;109;1
72200;Universe Sandbox Legacy;Adventure, Casual;500,000 - 1,000,000;2367;552;1815;141;88;25
72400;Clones;Adventure, Casual;200,000 - 500,000;276;91;185;143;185;0
72500;Arcadia;Action, Casual, Indie;0 - 20,000;37;43;-6;4;4;0
72520;Arcadia - Beta;Action, Indie;0 - 20,000;0;0;0;0;0;0
72530;Arcadia Beta;Action, Adventure, Indie;0 - 20,000;0;0;0;0;0;0
72850;The Elder Scrolls V: Skyrim;Free to Play, Indie;5,000,000 - 10,000,000;296425;16066;280359;6214;2810;4032
72900;Winter Voices;Action, Simulation;20,000 - 50,000;161;88;73;229;250;0
73010;Cities in Motion;Adventure, Casual, Indie;200,000 - 500,000;783;226;557;460;320;22
73020;Majesty 2 Collection;Action, Casual, Indie;200,000 - 500,000;1010;347;663;636;209;28
73060;Defenders of Ardania;Action, Indie;20,000 - 50,000;38;76;-38;30;54;0
73170;Darkest Hour: A Hearts of Iron Game;Action;200,000 - 500,000;1663;190;1473;919;622;142
73190;Pride of Nations;Action, Indie, Strategy;50,000 - 100,000;55;61;-6;0;0;2
73210;Sengoku;Indie, Casual;100,000 - 200,000;259;161;98;70;133;1
73220;Supreme Ruler: Cold War;Action;20,000 - 50,000;118;79;39;0;0;2
78000;Bejeweled 3;Strategy;200,000 - 500,000;5356;226;5130;577;76;445
80000;APOX;Strategy;20,000 - 50,000;50;127;-77;98;98;0
80200;Fate of the World;Strategy;50,000 - 100,000;326;88;238;169;169;3
80300;Puzzle Bots;Strategy;20,000 - 50,000;120;38;82;128;128;1
80310;Gemini Rue;Adventure, Indie, Casual;100,000 - 200,000;1494;179;1315;362;511;9
80330;The Blackwell Legacy;Indie, Strategy;100,000 - 200,000;1201;144;1057;390;485;4
80340;Blackwell Unbound;Action, Casual, Simulation, Strategy;100,000 - 200,000;561;37;524;482;675;4
80350;Blackwell Convergence;Action, Indie;50,000 - 100,000;477;19;458;418;505;5
80360;Blackwell Deception;Action, Indie;100,000 - 200,000;479;21;458;452;619;3
90200;Farming Simulator 2011;Action, Casual, Indie, Simulation, Strategy;50,000 - 100,000;671;74;597;404;593;5
90500;Guardians of Graxia;Casual, Indie, RPG;20,000 - 50,000;67;107;-40;75;75;0
90800;Crasher;;0 - 20,000;0;0;0;0;0;0
91100;SkyDrift;Action, Casual, Indie, Strategy;100,000 - 200,000;982;128;854;286;462;1
91200;Anomaly: Warzone Earth;Action, RPG;500,000 - 1,000,000;3667;559;3108;172;147;6
91330;Iron Front: Digital War Edition;;500,000 - 1,000,000;501;331;170;1609;1921;1
91600;Sanctum;Action;500,000 - 1,000,000;2830;332;2498;403;271;13
91700;E.Y.E: Divine Cybermancy;Casual;500,000 - 1,000,000;6048;1110;4938;394;299;21
91800;Cloning Clyde;Action;20,000 - 50,000;109;11;98;338;338;1
91810;Ancients of Ooga;Action, Indie;20,000 - 50,000;34;8;26;0;0;0
91810;Ancients of Ooga;Action, Indie;20,000 - 50,000;34;8;26;0;0;0
91900;Post Apocalyptic Mayhem;Casual, Indie, Strategy;100,000 - 200,000;1253;236;1017;200;210;1
92000;Hydrophobia: Prophecy;Action, Adventure, Casual, Free to Play, Indie, Massively Multiplayer, RPG;200,000 - 500,000;1359;911;448;100;152;1
92100;DETOUR;Adventure, Casual, Free to Play, Massively Multiplayer, Strategy;200,000 - 500,000;1105;680;425;196;177;10
92200;Gundemonium Recollection;;20,000 - 50,000;143;14;129;42;42;0
92210;Hitogata Happa;Animation & Modeling;50,000 - 100,000;143;33;110;30;30;0
92220;GundeadliGne;Animation & Modeling;50,000 - 100,000;132;26;106;33;33;0
92300;A.R.E.S.: Extinction Agenda;Adventure, Indie, RPG;50,000 - 100,000;610;272;338;248;453;0
92400;B.U.T.T.O.N. (Brutally Unfair Tactics Totally OK Now);;0 - 20,000;38;12;26;0;0;0
92400;B.U.T.T.O.N. (Brutally Unfair Tactics Totally OK Now);Action, Indie, Strategy;0 - 20,000;38;12;26;0;0;0
92600;Xotic;Action, RPG;50,000 - 100,000;129;48;81;35;42;0
92700;Shadow Harvest: Phantom Ops;Action, Indie, Strategy;20,000 - 50,000;37;88;-51;0;0;0
92800;SpaceChem;Action, Adventure, Indie;1,000,000 - 2,000,000;4390;382;4008;149;81;20
92900;Agricultural Simulator 2011: Extended Edition;Action, Adventure, Indie;100,000 - 200,000;90;86;4;12;19;0
93200;Revenge of the Titans;Action, Adventure, Indie;200,000 - 500,000;958;203;755;132;116;3
94000;Dinner Date;Indie, Strategy;20,000 - 50,000;451;376;75;222;326;0
94200;Jamestown;Casual, Indie;500,000 - 1,000,000;2133;127;2006;87;38;3
94300;The Dream Machine: Chapter 1 & 2;Action, Strategy, Indie;200,000 - 500,000;1764;246;1518;140;167;8
94400;Nidhogg;Adventure, Indie;500,000 - 1,000,000;6572;775;5797;199;119;18
94500;Back to the Future: Ep 2 - Get Tannen!;;20,000 - 50,000;166;20;146;99;108;1
94510;Back to the Future: Ep 3 - Citizen Brown;Action, Adventure, Indie, RPG;20,000 - 50,000;157;17;140;98;105;0
94520;Back to the Future: Ep 4 - Double Visions;Adventure, Indie;20,000 - 50,000;146;18;128;76;81;1
94590;Puzzle Agent 2;Adventure, Casual, Indie;500,000 - 1,000,000;840;131;709;157;220;3
94600;Hector: Episode 1;Casual, Indie;20,000 - 50,000;93;32;61;37;54;0
94610;Hector: Episode 2;Action, Indie;0 - 20,000;50;13;37;0;0;0
94620;Hector: Badge of Carnage - Full Series;Simulation, Strategy;100,000 - 200,000;209;20;189;0;0;1
95000;Super Splatters;Action, Adventure, Indie, RPG;50,000 - 100,000;129;42;87;60;78;0
95300;Capsized;Action, Adventure, Indie;200,000 - 500,000;807;248;559;75;43;0
95400;ibb & obb;Action, Casual, Indie;500,000 - 1,000,000;5368;528;4840;212;190;128
95700;The Cat and the Coup;Action, Indie, RPG;100,000 - 200,000;946;66;880;9;14;0
95900;Air Conflicts: Secret Wars;Action, Indie, RPG, Strategy;100,000 - 200,000;270;132;138;80;155;1
96000;The Tiny Bang Story;RPG, Indie;5,000,000 - 10,000,000;5313;753;4560;385;302;6
96100;Defy Gravity Extended;Indie, RPG;500,000 - 1,000,000;7409;1204;6205;146;97;1
96200;Steel Storm: Burning Retribution;Action, Simulation, Strategy;100,000 - 200,000;209;134;75;101;116;1
96800;Nexuiz;Action, Casual, Indie;200,000 - 500,000;178;133;45;52;50;0
96900;Slam Bolt Scrappers;Action, Indie, Casual;20,000 - 50,000;24;23;1;9;9;0
97000;Solar 2;RPG, Simulation;200,000 - 500,000;1835;189;1646;276;228;5
97100;Section 8: Prejudice;Casual, Indie, Strategy;500,000 - 1,000,000;798;236;562;274;243;3
97110;Kohan: Immortal Sovereigns;Casual, Simulation, Strategy;20,000 - 50,000;76;16;60;0;0;1
97120;Kohan: Ahriman's Gift;Action, Indie, Strategy;20,000 - 50,000;110;15;95;0;0;7
97130;Kohan II: Kings of War;Indie, RPG, Simulation, Early Access;50,000 - 100,000;193;13;180;0;0;7
97330;Magic: The Gathering - Duels of the Planeswalkers 2013;;200,000 - 500,000;1112;159;953;1172;1015;19
98100;Trauma;Action, Adventure;100,000 - 200,000;445;209;236;57;84;0
98200;Frozen Synapse;Action;500,000 - 1,000,000;2111;448;1663;432;96;4
98300;Toy Soldiers;Casual, Indie;200,000 - 500,000;1232;141;1091;236;185;5
98400;Hard Reset Extended Edition;Action, Indie;500,000 - 1,000,000;3740;807;2933;183;117;5
98500;Naval Warfare;Adventure, Free to Play, Massively Multiplayer, RPG;100,000 - 200,000;143;126;17;31;31;0
98600;Demolition Inc.;Indie, Strategy;50,000 - 100,000;222;63;159;142;189;1
98800;Dungeons of Dredmor;Indie, Racing;200,000 - 500,000;4732;299;4433;960;273;41
98810;Dungeons of Dredmor - Beta;Action, Indie;0 - 20,000;0;0;0;0;0;0
98900;Alien Hallway;Action, Indie;200,000 - 500,000;186;113;73;2;2;0
99100;Dungeons and Dragons: Daggerdale;Action, Indie;100,000 - 200,000;134;329;-195;344;344;0
99110;Dungeons & Dragons: Daggerdale - Demo;Action, Indie;0 - 20,000;0;0;0;0;0;0
99120;Yar's Revenge;Adventure, Strategy;0 - 20,000;43;25;18;0;0;0
99200;YOU DON’T KNOW JACK;Indie, Casual;0 - 20,000;104;11;93;14;14;0
99300;Renegade Ops;Adventure, Casual, Indie;500,000 - 1,000,000;2208;378;1830;157;155;5
99400;Garshasp: The Monster Slayer;Casual, Indie, Racing;50,000 - 100,000;173;186;-13;28;42;0
99700;NightSky;Action, Racing, Sports;200,000 - 500,000;828;116;712;63;56;2
99900;Spiral Knights;Action, Indie;2,000,000 - 5,000,000;19142;3641;15501;3064;122;151
99910;Puzzle Pirates;Action, Indie;200,000 - 500,000;1451;354;1097;1161;2168;88
99930;[Test] Puzzle Pirates;Casual, Indie;0 - 20,000;0;0;0;0;0;0
100400;Silo 2;Action, Strategy;0 - 20,000;57;25;32;0;0;3
100980;3DCoat 4.9;RPG, Indie;0 - 20,000;127;15;112;0;0;9
102200;Runespell: Overture;Action, Adventure, Casual, Indie, Strategy;50,000 - 100,000;278;96;182;241;262;0
102210;Runespell: Overture - Press;Action, Adventure, Indie, RPG;0 - 20,000;0;0;0;0;0;0
102400;Vertex Dispenser;Action, Free to Play, Massively Multiplayer;0 - 20,000;23;9;14;25;25;0
102500;Kingdoms of Amalur: Reckoning;Free to Play, Massively Multiplayer, RPG;1,000,000 - 2,000,000;11223;1501;9722;835;358;69
102600;Orcs Must Die!;Adventure, Casual, RPG;1,000,000 - 2,000,000;7021;263;6758;455;227;23
102810;Gatling Gears;Adventure, Indie;50,000 - 100,000;122;25;97;182;182;1
102840;Shank 2;Action, Strategy;200,000 - 500,000;2476;547;1929;187;117;8
102850;Warp;Strategy;50,000 - 100,000;241;99;142;751;751;1
104000;iBomber Defense;Strategy;50,000 - 100,000;169;62;107;22;38;2
104020;Storm in a Teacup;Strategy;50,000 - 100,000;99;44;55;1;1;0
104100;Inside a Star-filled Sky;Action, Adventure;20,000 - 50,000;60;32;28;18;18;1
104200;BEEP;Action, Adventure, Indie;500,000 - 1,000,000;3948;713;3235;201;152;2
104900;ORION: Prelude;Indie, Racing;2,000,000 - 5,000,000;21721;7168;14553;219;103;11
105000;A New Beginning - Final Cut;Action, Indie;200,000 - 500,000;1342;449;893;75;51;4
105100;Lume;Casual, Strategy;50,000 - 100,000;223;267;-44;1;1;0
105300;Critical Mass;Action;100,000 - 200,000;305;126;179;24;34;0
105420;Ms. Splosion Man;Adventure;50,000 - 100,000;210;54;156;12;12;1
105450;Age of Empires III (2007);Casual, Indie, Strategy;2,000,000 - 5,000,000;28125;2843;25282;1732;345;842
105600;Terraria;Casual, Strategy;20,000,000 - 50,000,000;1067563;24035;1043528;7068;2203;39165
105700;Tobe's Vertical Adventure;Strategy;20,000 - 50,000;79;53;26;31;53;0
105800;PixelJunk Eden;Adventure, Indie;100,000 - 200,000;603;149;454;101;136;1
107100;Bastion;Action, Free to Play, Indie, Massively Multiplayer, RPG;2,000,000 - 5,000,000;34026;1568;32458;375;243;49
107200;Space Pirates and Zombies;Racing, Simulation;200,000 - 500,000;2691;257;2434;551;183;24
107300;Breath of Death VII;Action, Adventure;500,000 - 1,000,000;1133;215;918;63;17;1
107310;Cthulhu Saves the World;;1,000,000 - 2,000,000;3065;265;2800;188;110;5
107410;Arma 3;Strategy, Casual;5,000,000 - 10,000,000;217117;22890;194227;13321;1518;15895
107600;Waves;Indie, Strategy;200,000 - 500,000;1311;64;1247;66;62;2
107800;Rochard;Action, Indie, Simulation;200,000 - 500,000;1573;140;1433;191;183;1
108110;Starpoint Gemini;Adventure;200,000 - 500,000;46;92;-46;0;0;1
108200;Ticket to Ride;Strategy;500,000 - 1,000,000;4247;430;3817;313;259;464
108210;Memoir '44 Online;RPG, Simulation, Strategy;200,000 - 500,000;365;207;158;167;167;10
108500;Vessel;Strategy;200,000 - 500,000;642;85;557;231;58;2
108600;Project Zomboid;Action, Adventure, Indie, RPG;5,000,000 - 10,000,000;161533;11513;150020;2407;753;43672
108700;Death Rally;Action, Adventure, Indie;;;;0;;;
108710;Alan Wake;Indie, RPG;2,000,000 - 5,000,000;34705;3477;31228;388;190;96
108800;Crysis 2 - Maximum Edition;;1,000,000 - 2,000,000;11033;1962;9071;393;172;67
109200;Legend of Fae;Strategy, RPG, Indie;0 - 20,000;90;28;62;0;0;1
109200;Legend of Fae;Strategy, RPG, Indie;0 - 20,000;90;28;62;0;0;1
109500;Fowl Space;Strategy, RPG, Indie;20,000 - 50,000;106;74;32;15;15;0
109600;Neverwinter;Strategy, RPG, Indie;5,000,000 - 10,000,000;27529;7995;19534;2857;278;1456
109700;Achron;Strategy, RPG, Indie;20,000 - 50,000;69;37;32;0;0;0
109700;Achron;Action, Indie, Strategy;20,000 - 50,000;69;37;32;0;0;0
110400;inMomentum;Free to Play, RPG, Strategy;50,000 - 100,000;129;48;81;53;104;0
110500;Data Jammers: FastForward;Free to Play, Massively Multiplayer, RPG;20,000 - 50,000;63;35;28;11;11;0
110600;Astro Tripper;Strategy;20,000 - 50,000;34;28;6;32;32;0
110610;Alien Zombie Megadeath;Adventure, Casual, Indie;20,000 - 50,000;52;19;33;0;0;0
110630;Mutant Storm: Reloaded;Action, Indie, RPG;0 - 20,000;33;14;19;0;0;0
110800;L.A. Noire;Simulation, Strategy;2,000,000 - 5,000,000;24556;4250;20306;771;402;258
111000;The Clockwork Man;Racing;0 - 20,000;46;37;9;0;0;0
111010;The Clockwork Man: The Hidden World;Action, Indie;0 - 20,000;47;28;19;0;0;2
111100;Snuggle Truck;Action, Indie, Strategy;100,000 - 200,000;373;86;287;57;61;1
111300;Smash Cars;Action;0 - 20,000;30;13;17;238;238;0
111400;Bunch of Heroes;Adventure;100,000 - 200,000;202;219;-17;73;62;0
111600;Serious Sam Double D XXL;Action, Adventure;200,000 - 500,000;645;131;514;133;45;1
111800;Blocks That Matter;;200,000 - 500,000;587;173;414;130;63;2
111900;Guardians of Middle-earth;Action;200,000 - 500,000;324;1068;-744;108;87;1
112100;Avadon: The Black Fortress;Strategy;200,000 - 500,000;451;98;353;43;61;4
113020;Monaco: What's Yours Is Mine;Action, Adventure;1,000,000 - 2,000,000;7677;782;6895;217;165;19
113200;The Binding of Isaac;Indie, Strategy;2,000,000 - 5,000,000;52653;2582;50071;1444;354;269
113400;APB Reloaded;;5,000,000 - 10,000,000;22968;13184;9784;2632;130;812
113420;Fallen Earth Free2Play;;1,000,000 - 2,000,000;4370;3049;1321;106;22;45
115100;Costume Quest;Action;200,000 - 500,000;3357;238;3119;297;214;14
115110;Stacking;Action, Indie;200,000 - 500,000;1466;179;1287;287;219;8
115120;Iron Brigade;;200,000 - 500,000;842;156;686;338;481;6
115200;Cossacks II: Napoleonic Wars;Adventure;50,000 - 100,000;280;236;44;761;761;18
115210;American Conquest;Indie, Strategy;100,000 - 200,000;342;168;174;60;60;13
115300;Call of Duty: Modern Warfare 3;Nudity, Violent, Action, RPG, Strategy;2,000,000 - 5,000,000;29196;3962;25234;0;0;1
115320;Prototype 2;Action, Adventure, Indie;1,000,000 - 2,000,000;9985;3228;6757;1017;522;85
115800;Owlboy;Action, Adventure;200,000 - 500,000;4549;833;3716;532;418;16
116100;Super Toy Cars;Strategy;50,000 - 100,000;220;161;59;101;135;1
116120;Lightfish;Action;50,000 - 100,000;136;31;105;12;22;0
200010;Quantum Conundrum;Action;200,000 - 500,000;1627;300;1327;191;135;4
200020;Global Ops: Commando Libya;Action, Adventure;50,000 - 100,000;150;219;-69;509;509;0
200080;Nancy Drew: Shadow at the Water's Edge;Action, Casual, Indie;50,000 - 100,000;226;56;170;0;0;16
200130;Puzzler World 2;Action, Free to Play;20,000 - 50,000;170;50;120;13;13;0
200150;Battle Chess: Game of Kings;RPG, Strategy;50,000 - 100,000;165;156;9;58;107;3
200170;Worms Revolution;Action, Indie, RPG;1,000,000 - 2,000,000;6907;1039;5868;414;227;76
200190;Sideway New York;Casual, Indie;20,000 - 50,000;70;50;20;85;85;0
200210;Realm of the Mad God Exalt;Strategy;2,000,000 - 5,000,000;36218;7049;29169;2620;101;1778
200230;Off-Road Drive;Adventure;50,000 - 100,000;395;224;171;397;780;0
200260;Batman: Arkham City - Game of the Year Edition;Racing;1,000,000 - 2,000,000;48997;2084;46913;797;430;1250
200350;Starvoid;Action;0 - 20,000;0;0;0;0;0;1
200370;A Game of Dwarves;RPG, Simulation, Strategy;100,000 - 200,000;331;189;142;1465;2600;0
200390;Oil Rush;Adventure, Casual, Indie;200,000 - 500,000;238;205;33;34;37;1
200410;SOL: Exodus;Adventure, Indie;50,000 - 100,000;54;52;2;0;0;0
200490;Memento Mori;Action, Indie;50,000 - 100,000;113;59;54;0;0;2
200510;XCOM: Enemy Unknown;Action, Adventure, RPG;2,000,000 - 5,000,000;48335;2859;45476;2288;1156;1365
200550;Dungeons - The Dark Lord;Adventure, Indie;100,000 - 200,000;101;156;-55;117;125;1
200670;Disciples III - Resurrection;Action;100,000 - 200,000;85;176;-91;619;782;1
200710;Torchlight II;Adventure;2,000,000 - 5,000,000;38743;2910;35833;1849;761;363
200900;Cave Story+;Adventure, Indie, Strategy;500,000 - 1,000,000;6501;467;6034;375;244;18
200910;Before the Echo;Adventure, Casual, Indie;100,000 - 200,000;1195;183;1012;338;443;1
200940;Sonic CD;Casual, Indie, Strategy;200,000 - 500,000;4487;522;3965;146;77;8
200960;Geneforge 1;Action, Free to Play, Indie, Strategy;100,000 - 200,000;341;26;315;1939;2142;4
200980;Geneforge 2;Action, Indie;50,000 - 100,000;63;5;58;3199;3199;3
200990;Geneforge 3;Action, Adventure, Casual, Indie, RPG;50,000 - 100,000;42;4;38;2292;2292;1
201000;Geneforge 4: Rebellion;Action, Indie;50,000 - 100,000;34;3;31;338;338;2
201010;Geneforge 5: Overthrow;Adventure, Casual;50,000 - 100,000;101;7;94;0;0;4
201070;Revelations 2012;Action, Indie, Strategy;50,000 - 100,000;222;166;56;0;0;0
201210;Pox Nora;Action, RPG, Strategy;200,000 - 500,000;543;188;355;23;43;29
201230;EverQuest II;Action, Casual;500,000 - 1,000,000;1725;471;1254;6507;8347;235
201270;Total War: SHOGUN 2;Action, Adventure, Indie, Racing;2,000,000 - 5,000,000;49702;4341;45361;0;0;1
201290;Sins of a Solar Empire: Trinity;Action;100,000 - 200,000;570;175;395;608;662;24
201420;Toki Tori 2+;Action, Strategy;200,000 - 500,000;792;141;651;181;176;2
201480;Serious Sam: The Random Encounter;Indie, Strategy;200,000 - 500,000;371;381;-10;263;29;0
201490;Airline Tycoon 2;Strategy;50,000 - 100,000;92;455;-363;458;458;2
201510;Flatout 3: Chaos & Destruction;Casual, Indie;100,000 - 200,000;549;2767;-2218;44;41;2
201570;Really Big Sky;Adventure, Casual, Indie;200,000 - 500,000;1430;462;968;161;160;2
201790;Orcs Must Die! 2;Action, Indie;2,000,000 - 5,000,000;17119;1148;15971;576;325;97
201810;Wolfenstein: The New Order;Action, Indie;2,000,000 - 5,000,000;44167;4358;39809;898;608;329
201870;Assassin's Creed Revelations;Action, Indie;1,000,000 - 2,000,000;11675;1939;9736;859;735;117
201930;Jamestown IGF;Action, Casual, Indie;0 - 20,000;0;0;0;0;0;0
202070;Choplifter HD;Action, Adventure;50,000 - 100,000;222;49;173;11;11;0
202130;Impire;Casual, Simulation;100,000 - 200,000;191;236;-45;273;383;2
202170;Sleeping Dogs;Action;2,000,000 - 5,000,000;15856;923;14933;880;689;22
202200;Galactic Civilizations II: Ultimate Edition;Utilities;500,000 - 1,000,000;1165;357;808;425;25;42
202310;Ridge Racer Unbounded;Indie, Simulation, Strategy;100,000 - 200,000;860;566;294;612;895;9
202370;Scary Girl;Action, Indie, Casual;20,000 - 50,000;52;30;22;8;8;0
202410;Scoregasm;Action, Simulation, Strategy;20,000 - 50,000;115;25;90;26;26;0
202530;Sonic the Hedgehog 4 - Episode I;Adventure;200,000 - 500,000;1126;1555;-429;588;607;13
202670;Nancy Drew: Alibi in Ashes;Adventure, Indie;20,000 - 50,000;168;18;150;1134;1134;12
202690;Hegemony Gold: Wars of Ancient Greece;Free to Play, Massively Multiplayer, RPG;20,000 - 50,000;177;7;170;0;0;5
202690;Hegemony Gold: Wars of Ancient Greece;Action, Adventure, Indie;20,000 - 50,000;177;7;170;0;0;5
202710;Demigod;RPG, Simulation, Strategy;50,000 - 100,000;840;281;559;157;203;8
202730;Dynamite Jack;Action, Indie, Casual;100,000 - 200,000;363;60;303;66;112;0
202750;Alan Wake's American Nightmare;Adventure;1,000,000 - 2,000,000;4924;2032;2892;152;177;8
202860;Real Warfare 2: Northern Crusades;Indie, Casual;50,000 - 100,000;48;60;-12;28;28;0
202970;Call of Duty: Black Ops II;Indie;2,000,000 - 5,000,000;34952;5642;29310;518;172;223
203140;Hitman: Absolution;Action;2,000,000 - 5,000,000;37117;3365;33752;740;416;271
203160;Tomb Raider;Action;5,000,000 - 10,000,000;211065;8386;202679;641;473;669
203210;Titan Attacks!;Strategy;50,000 - 100,000;859;86;773;69;103;3
203290;America's Army: Proving Grounds;RPG, Indie;2,000,000 - 5,000,000;8339;2236;6103;108;31;256
203350;King's Bounty: Warriors of the North;RPG, Indie;200,000 - 500,000;1260;268;992;1728;1786;121
203510;Fortune Summoners;RPG, Indie;100,000 - 200,000;693;119;574;5;8;3
203560;Containment: The Zombie Puzzler;Action, Indie, Strategy;50,000 - 100,000;218;56;162;102;200;1
203630;Warlock - Master of the Arcane;Action, Free to Play;500,000 - 1,000,000;2119;334;1785;386;172;55
203650;Sonic the Hedgehog 4 - Episode II;Action;100,000 - 200,000;1252;399;853;96;152;7
203750;Binary Domain;Action, Indie, RPG;500,000 - 1,000,000;5896;1017;4879;140;93;11
203770;Crusader Kings II;Action, Indie;2,000,000 - 5,000,000;62625;6884;55741;2208;255;3192
203810;Dear Esther;Casual, Strategy;200,000 - 500,000;4639;1494;3145;62;60;0
203830;The Dark Eye: Chains of Satinav;Action, Adventure;200,000 - 500,000;1854;288;1566;468;766;9
203990;SATAZIUS;Adventure, Indie, RPG;50,000 - 100,000;248;36;212;91;116;0
204030;Fable - The Lost Chapters;Action, Adventure, Free to Play, Massively Multiplayer, RPG;500,000 - 1,000,000;6530;542;5988;900;285;55
204060;Superbrothers: Sword & Sworcery EP;Action, Free to Play, Indie, Strategy;500,000 - 1,000,000;1942;566;1376;146;151;1
204100;Max Payne 3;Casual, Indie;2,000,000 - 5,000,000;38256;6461;31795;607;543;287
204120;LEGO Harry Potter: Years 5-7;Casual, Indie, Strategy;200,000 - 500,000;2240;279;1961;1039;636;136
204180;Waveform;Action;200,000 - 500,000;1778;363;1415;182;154;1
204220;Snapshot;Action, Adventure, Indie;100,000 - 200,000;179;69;110;108;139;0
204240;The Bridge;Racing;200,000 - 500,000;3557;497;3060;141;78;9
204300;Awesomenauts - the 2D moba;Action, Indie;2,000,000 - 5,000,000;22439;4043;18396;889;237;164
204340;Serious Sam 2;Indie;1,000,000 - 2,000,000;9563;1079;8484;366;167;62
204360;Castle Crashers;Action, Casual, Indie, Racing, Sports;5,000,000 - 10,000,000;93825;3618;90207;543;295;529
204390;Pineapple Smash Crew ;Action, Indie, Strategy;20,000 - 50,000;97;22;75;76;76;0
204440;Pickers;Adventure, Indie, RPG;20,000 - 50,000;167;32;135;0;0;0
204450;Call of Juarez: Gunslinger;Action, Adventure, Racing;2,000,000 - 5,000,000;30132;1560;28572;258;118;119
204530;Infested Planet;Action, Free to Play, Indie;200,000 - 500,000;2583;171;2412;424;374;10
204560;Confrontation;Indie, Strategy;100,000 - 200,000;89;252;-163;24;17;0
204580;Rotastic;Action, Adventure, RPG;0 - 20,000;32;5;27;0;0;0
204630;Retro City Rampage DX;Audio Production;200,000 - 500,000;2044;273;1771;293;204;7
204760;Deep Black: Reloaded;Action, Adventure, RPG;20,000 - 50,000;62;157;-95;0;0;0
204860;Men of War: Condemned Heroes;Action, Indie;100,000 - 200,000;379;164;215;212;323;10
204880;Sins of a Solar Empire: Rebellion;Action;2,000,000 - 5,000,000;13747;1014;12733;823;395;384
204940;Crusader Kings Complete;Action;100,000 - 200,000;132;79;53;68;70;2
204960;Magical Drop V;Action, Adventure, Indie;20,000 - 50,000;222;206;16;138;138;0
205020;Lumino City;Casual, Indie, RPG;200,000 - 500,000;1105;163;942;199;203;1
205060;BIT.TRIP CORE;Action, Adventure;50,000 - 100,000;83;58;25;506;635;0
205070;BIT.TRIP VOID;Action, Indie;20,000 - 50,000;67;21;46;441;441;0
205080;BIT.TRIP FATE;Indie, Casual;20,000 - 50,000;83;45;38;99;99;0
205100;Dishonored;Adventure;2,000,000 - 5,000,000;70377;1754;68623;844;597;502
205190;Rocksmith;Action, Indie, Strategy;200,000 - 500,000;1170;108;1062;2101;1122;8
205230;Hell Yeah! Wrath of the Dead Rabbit;Indie, Casual;1,000,000 - 2,000,000;3039;510;2529;140;32;4
205270;3DMark 11;Adventure, Casual, Indie;0 - 20,000;40;7;33;1;1;0
205530;Gratuitous Tank Battles;Casual, Indie, Strategy;50,000 - 100,000;52;49;3;46;57;0
205550;Foreign Legion: Multi Massacre;Action, Strategy;50,000 - 100,000;195;116;79;103;113;3
205610;Port Royale 3;Action, Casual, Indie;200,000 - 500,000;952;339;613;840;613;46
205650;The Testament of Sherlock Holmes;Simulation;200,000 - 500,000;2426;661;1765;397;145;21
205690;1000 Amps;Action;100,000 - 200,000;254;70;184;194;270;0
205710;EverQuest;Action, Free to Play, Indie;500,000 - 1,000,000;1446;359;1087;670;330;420
205730;Insanely Twisted Shadow Planet;Adventure, Casual;200,000 - 500,000;686;97;589;407;414;5
205810;Jagged Alliance: Crossfire;Strategy;100,000 - 200,000;172;109;63;9;9;7
205830;Luxor Evolved;Action;50,000 - 100,000;277;22;255;204;204;2
205840;Yesterday;Strategy, RPG, Indie;100,000 - 200,000;732;147;585;36;63;3
205870;Auditorium;Action, Indie, Strategy;50,000 - 100,000;233;48;185;59;62;0
205910;Tiny and Big: Grandpa's Leftovers;Adventure;500,000 - 1,000,000;3702;333;3369;130;104;1
205950;Jet Set Radio;Racing, Simulation, Sports;1,000,000 - 2,000,000;6108;841;5267;82;18;29
205990;Warlock 2: The Exiled;Simulation, Strategy;100,000 - 200,000;803;357;446;865;1197;36
206020;Avernum 4;RPG;50,000 - 100,000;82;15;67;1;1;4
206040;Avernum 5;Indie, Simulation;50,000 - 100,000;25;5;20;0;0;4
206060;Avernum 6;Adventure, Casual;50,000 - 100,000;58;5;53;0;0;5
206190;Gunpoint;Adventure, Casual;500,000 - 1,000,000;11995;302;11693;341;230;12
206210;Gotham City Impostors Free to Play;Adventure, Casual;2,000,000 - 5,000,000;10081;1786;8295;197;65;7
206230;Clan of Champions;Action, Adventure;0 - 20,000;47;24;23;0;0;0
206250;Cladun X2;Action, Adventure;20,000 - 50,000;100;50;50;146;146;4
206370;Tales From Space: Mutant Blobs Attack;Action, Indie;100,000 - 200,000;710;71;639;181;181;3
206410;Crazy Machines Elements;Action, RPG;20,000 - 50,000;26;9;17;21;21;0
206420;Saints Row IV: Re-Elected;Action, Adventure, Indie, RPG;2,000,000 - 5,000,000;67380;8611;58769;1184;806;235
206440;To the Moon;Action, Adventure;1,000,000 - 2,000,000;63700;2353;61347;341;231;58
206480;Dungeons & Dragons Online;Action, Indie;1,000,000 - 2,000,000;4156;1738;2418;572;69;378
206500;AirMech Strike;Action, Adventure, Indie, Simulation;1,000,000 - 2,000,000;8528;1612;6916;367;138;35
206610;3SwitcheD;Action;200,000 - 500,000;249;353;-104;257;265;1
206690;iBomber Defense Pacific;Action;200,000 - 500,000;472;98;374;19;37;1
206760;Painkiller: Recurring Evil;Action;100,000 - 200,000;159;198;-39;85;85;1
207000;Alien Spidy;Action, Indie;50,000 - 100,000;105;102;3;79;79;0
207020;Bang Bang Racing;Adventure, Casual;;;;0;;;
207040;Sine Mora;Indie, Strategy;100,000 - 200,000;762;170;592;102;128;0
207080;Indie Game: The Movie;Action, Adventure, Indie;200,000 - 500,000;1661;135;1526;158;141;3
207140;SpeedRunners;;2,000,000 - 5,000,000;32245;2092;30153;602;250;235
207150;Stellar Impact;Action, Indie;200,000 - 500,000;216;347;-131;149;187;0
207170;Legend of Grimrock;Indie;500,000 - 1,000,000;5469;354;5115;480;237;37
207190;Fireburst;Sports, Strategy;20,000 - 50,000;90;77;13;50;50;0
207230;ArcheBlade;Casual, Indie, Racing;1,000,000 - 2,000,000;5657;2071;3586;134;52;2
207250;Cubemen;Action, Indie, Simulation;100,000 - 200,000;354;147;207;76;97;0
207320;Ys: The Oath in Felghana;Casual, Indie, Simulation;100,000 - 200,000;1510;97;1413;440;570;9
207340;Sound Forge Mac 2.0 - Steam Powered;Action, Adventure;0 - 20,000;1;1;0;0;0;0
207350;Ys Origin;Action;200,000 - 500,000;2704;160;2544;700;667;13
207370;eXceed - Gun Bullet Children;Action, Indie, Strategy;50,000 - 100,000;226;257;-31;174;216;0
207380;eXceed 2nd - Vampire REX;Strategy, Indie, Casual;50,000 - 100,000;225;39;186;229;311;0
207400;eXceed 3rd - Jade Penetrate Black Package;Action, RPG;50,000 - 100,000;582;46;536;195;232;0
207420;Wizorb;Action;100,000 - 200,000;641;267;374;83;97;2
207430;Hack, Slash, Loot;Indie, Casual;50,000 - 100,000;366;353;13;201;268;1
207490;Rayman Origins;Action, Adventure, Indie, RPG, Simulation;200,000 - 500,000;3171;199;2972;145;75;54
207530;Noitu Love 2: Devolution;Casual, Indie, Strategy;20,000 - 50,000;555;37;518;204;335;0
207570;English Country Tune;Action, Free to Play;200,000 - 500,000;327;75;252;100;17;0
207610;The Walking Dead;Casual, Indie, Strategy;2,000,000 - 5,000,000;58765;1768;56997;547;324;212
207650;A Virus Named TOM;Action, Indie, Strategy;200,000 - 500,000;409;318;91;115;95;1
207670;AVSEQ;Adventure;20,000 - 50,000;31;38;-7;36;36;0
207690;Botanicula;Action, Strategy, Indie;200,000 - 500,000;5072;231;4841;176;139;11
207710;Bumbledore;Casual;20,000 - 50,000;29;16;13;0;0;0
207730;Arena Wars 2;Action, Indie, Strategy;20,000 - 50,000;130;264;-134;22;32;0
207750;Symphony;Indie;100,000 - 200,000;1228;229;999;190;178;1
207790;Jane's Advanced Strike Fighters;Action, Adventure;20,000 - 50,000;125;247;-122;25;25;3
207930;Sacred Citadel;Adventure, Indie;500,000 - 1,000,000;756;341;415;251;328;1
208090;Loadout;Action, Indie, RPG;5,000,000 - 10,000,000;34548;5226;29322;495;184;0
208110;Myst V: End of Ages;Action, Casual, Strategy;50,000 - 100,000;128;73;55;269;435;3
208140;ENDLESS Space - Definitive Edition;Action, Adventure;1,000,000 - 2,000,000;7285;1778;5507;599;336;728
208200;DOOM 3;Adventure, Casual, Indie;1,000,000 - 2,000,000;7853;1258;6595;456;112;101
208400;Avernum: Escape From the Pit;Action, Indie;100,000 - 200,000;997;94;903;509;813;23
208460;Tryst;Action, Indie;0 - 20,000;14;41;-27;23;23;0
208460;Tryst;Adventure, Indie, RPG;0 - 20,000;14;41;-27;23;23;0
208480;Assassin’s Creed III;Adventure, Indie;1,000,000 - 2,000,000;10379;3604;6775;1343;980;38
208500;F1 2012;;200,000 - 500,000;3636;279;3357;1913;1065;68
208520;Omerta - City of Gangsters;Action, Adventure, Indie;200,000 - 500,000;1449;741;708;348;351;18
208580;STAR WARS Knights of the Old Republic II - The Sith Lords;Action, RPG;;;;0;;;
208600;Lunar Flight;Indie;50,000 - 100,000;526;122;404;99;99;0
208620;Midnight Mysteries: Salem Witch Trials;Free to Play, Racing, Simulation, Sports;50,000 - 100,000;90;48;42;0;0;1
208630;Midnight Mysteries 3: Devil on the Mississippi;Action, Adventure, Indie, RPG;20,000 - 50,000;89;28;61;0;0;0
208640;Midnight Mysteries 4: Haunted Houdini;Action, Simulation;50,000 - 100,000;75;11;64;0;0;0
208650;Batman: Arkham Knight;Action, Simulation;2,000,000 - 5,000,000;82808;14622;68186;1480;817;2958
208670;Blades of Time;Action;200,000 - 500,000;1783;449;1334;148;143;7
208710;Colour Bind;Casual, Indie;0 - 20,000;24;10;14;0;0;0
208730;Game of Thrones;Action, Adventure, Casual, Indie, RPG;200,000 - 500,000;1596;628;968;211;234;6
208750;Apotheon;Indie, Strategy;200,000 - 500,000;3031;338;2693;318;262;7
209000;Batman: Arkham Origins;Racing;2,000,000 - 5,000,000;37705;5030;32675;875;584;917
209060;Drunken Robot Pornography;Action, Indie, Simulation, Strategy;100,000 - 200,000;546;104;442;73;108;0
209080;Guns of Icarus Online;Action, Indie;2,000,000 - 5,000,000;13211;1445;11766;434;284;4
209100;Resident Evil: Operation Raccoon City;Adventure, Indie;200,000 - 500,000;2092;1787;305;271;218;3
209120;Street Fighter X Tekken;Action, Free to Play, Massively Multiplayer, Simulation;100,000 - 200,000;1245;1007;238;224;227;6
209160;Call of Duty: Ghosts;;1,000,000 - 2,000,000;17624;10841;6783;354;314;92
209170;Call of Duty: Ghosts;Action, Indie;1,000,000 - 2,000,000;15087;10789;4298;1327;525;208
209190;Stealth Bastard Deluxe;Action, Adventure, Free to Play, Massively Multiplayer, RPG;200,000 - 500,000;960;122;838;393;59;4
209230;Sherlock Holmes and The Hound of The Baskervilles;Action, Adventure, Casual, Free to Play, Massively Multiplayer, RPG, Simulation;50,000 - 100,000;494;74;420;121;121;2
209270;Hero Academy;Action, Free to Play, Massively Multiplayer, RPG;100,000 - 200,000;511;234;277;267;377;0
209330;A Valley Without Wind;Action;100,000 - 200,000;287;198;89;238;362;1
209340;Ride to Hell: Retribution;Racing, Sports;0 - 20,000;0;0;0;0;0;1
209360;All Zombies Must Die!: Scorepocalypse ;Free to Play, Massively Multiplayer, RPG;20,000 - 50,000;57;21;36;294;544;0
209370;Analogue: A Hate Story;Action;100,000 - 200,000;2043;152;1891;235;274;2
209390;Dungeonbowl - Knockout Edition;Indie, Simulation, Strategy;0 - 20,000;19;55;-36;0;0;0
209520;Mini Motor Racing EVO;Action, Adventure, Indie;50,000 - 100,000;439;237;202;181;241;0
209540;Strike Suit Zero;Indie, Simulation, Sports;500,000 - 1,000,000;1259;374;885;240;178;1
209610;Roller Coaster Rampage;Action, Free to Play, Indie;20,000 - 50,000;63;51;12;2;2;0
209630;Magrunner: Dark Pulse;Indie, RPG;200,000 - 500,000;718;271;447;90;127;2
209650;Call of Duty: Advanced Warfare - Gold Edition;;500,000 - 1,000,000;15192;8649;6543;492;447;75
209670;Cortex Command;Action, Adventure;1,000,000 - 2,000,000;4199;1662;2537;380;188;11
209690;Fieldrunners;Action;100,000 - 200,000;186;103;83;38;50;4
209730;R.A.W. Realms of Ancient War;Indie, Casual;200,000 - 500,000;366;378;-12;63;33;2
209750;Cannon Fodder 3;Action;20,000 - 50,000;83;75;8;6;7;0
209790;Splice;Casual, Free to Play, Indie, Strategy;200,000 - 500,000;510;67;443;120;159;1
209830;Lone Survivor: The Director's Cut;Action, Adventure, RPG;200,000 - 500,000;1090;180;910;78;35;0
209850;Highborn;Strategy;0 - 20,000;41;22;19;0;0;0
209870;Blacklight: Retribution;;2,000,000 - 5,000,000;12465;3997;8468;540;99;0
209950;Triple Town;Strategy, Indie, Casual, Simulation;20,000 - 50,000;696;60;636;470;470;12
210170;Spirits;Indie, Simulation;100,000 - 200,000;165;74;91;113;148;1
210230;Nancy Drew: Tomb of the Lost Queen;Strategy;0 - 20,000;86;9;77;0;0;7
210350;Max Payne RU;RPG;20,000 - 50,000;339;40;299;346;406;2
210490;Fray: Reloaded Edition;Action;0 - 20,000;1;49;-48;0;0;0
210550;Angry Birds Space;Action, Adventure;100,000 - 200,000;468;50;418;249;417;1
210770;Sanctum 2;;2,000,000 - 5,000,000;12542;1393;11149;302;137;41
210870;Cloudberry Kingdom;Adventure, Indie;20,000 - 50,000;193;19;174;104;104;1
210950;Rune Classic;Action, Indie, Strategy;100,000 - 200,000;723;86;637;410;495;1
210970;The Witness;;1,000,000 - 2,000,000;12726;2205;10521;393;201;129
211010;Alien Shooter 2 Conscription;Action, Free to Play, Indie;100,000 - 200,000;402;83;319;282;408;6
211070;Check vs Mate;Action;20,000 - 50,000;74;40;34;3;3;1
211120;The Political Machine;Action, Adventure;20,000 - 50,000;201;92;109;698;790;0
211160;Viking: Battle for Asgard;Casual, Indie, Simulation, Strategy;500,000 - 1,000,000;1061;1128;-67;119;33;3
211180;Unmechanical;Action, Adventure, Indie;100,000 - 200,000;415;34;381;130;171;1
211200;Beyond Oasis;Action;0 - 20,000;6;0;6;0;0;0
211201;Dynamite Headdy;Action, Indie;20,000 - 50,000;8;0;8;0;0;0
211202;Golden Axe III;Adventure, Indie;0 - 20,000;4;0;4;0;0;0
211204;Phantasy Star III: Generations of Doom;Action;0 - 20,000;2;1;1;0;0;0
211205;Phantasy Star IV: The End of the Millennium;Adventure, Casual, Indie;20,000 - 50,000;7;0;7;0;0;0
211207;The Revenge of Shinobi;Action, Adventure, RPG, Simulation, Strategy;20,000 - 50,000;4;1;3;0;0;0
211209;Wonder Boy in Monster World;Action, Adventure, Indie;0 - 20,000;6;0;6;0;0;0
211260;They Bleed Pixels;Adventure, Indie, Strategy;0 - 20,000;2063;404;1659;208;204;1
211260;They Bleed Pixels;Action, Casual, RPG;0 - 20,000;2063;404;1659;208;204;1
211280;Primal Fears;Action;50,000 - 100,000;180;126;54;94;94;0
211340;Magical Diary: Horse Hall;Action, Simulation;50,000 - 100,000;882;98;784;0;0;3
211360;Offspring Fling!;Strategy;200,000 - 500,000;476;105;371;104;110;0
211380;Shoot Many Robots: Arena Kings;Action, Indie;0 - 20,000;0;0;0;0;0;0
211400;Deadlight;Adventure, Free to Play, Massively Multiplayer, RPG, Strategy;500,000 - 1,000,000;9683;2583;7100;157;139;3
211420;DARK SOULS: Prepare To Die Edition;Free to Play, Massively Multiplayer, RPG;2,000,000 - 5,000,000;70312;6639;63673;3553;1204;273
211440;Adventures of Shuggy;Free to Play, Massively Multiplayer, RPG;200,000 - 500,000;1020;170;850;82;30;0
211500;RaceRoom Racing Experience;Adventure;2,000,000 - 5,000,000;13495;4850;8645;362;41;776
211580;Wanderlust: Rebirth;Action, Adventure, Free to Play, Massively Multiplayer, RPG;100,000 - 200,000;257;244;13;180;151;1
211600;Thief Gold;Action, Simulation;500,000 - 1,000,000;2920;246;2674;253;27;24
211740;Thief II: The Metal Age;Action, Casual, Indie;200,000 - 500,000;1535;92;1443;1030;242;17
211780;Conflict Desert Storm;Action, Indie;200,000 - 500,000;694;256;438;142;272;3
211800;Dead Hungry Diner;;20,000 - 50,000;102;36;66;0;0;0
211820;Starbound;Adventure, Indie;2,000,000 - 5,000,000;148210;11676;136534;3039;1242;1978
211900;Conquest of Elysium 3;Action, Adventure, Indie, RPG;50,000 - 100,000;252;61;191;505;981;2
211970;Test Drive: Ferrari Racing Legends;Violent, Gore, Action, Adventure, Indie, RPG;50,000 - 100,000;171;122;49;0;0;0
212010;Galaxy on Fire 2 Full HD;;200,000 - 500,000;1454;473;981;128;114;5
212030;Kung Fu Strike - The Warrior's Rise;Action, Adventure, RPG;100,000 - 200,000;857;235;622;105;165;1
212050;Resonance;Adventure, Indie;100,000 - 200,000;442;44;398;416;457;0
212070;Star Conflict;Action, Indie;2,000,000 - 5,000,000;10557;3621;6936;645;55;227
212090;Endless Space VIP;Action, Strategy, Casual;0 - 20,000;0;0;0;0;0;0
212110;Sugar Cube: Bittersweet Factory;Action, Indie, Strategy;20,000 - 50,000;142;53;89;0;0;0
212110;Sugar Cube: Bittersweet Factory;Casual, Simulation;20,000 - 50,000;142;53;89;0;0;0
212160;Vindictus;Action, Free to Play, Massively Multiplayer, RPG;;;;0;;;
212200;Mabinogi;Free to Play, Massively Multiplayer;500,000 - 1,000,000;2598;886;1712;6531;266;481
212390;Continent of the Ninth Seal;RPG, Strategy;500,000 - 1,000,000;984;382;602;285;154;1
212410;Inversion;Casual, Indie, Strategy;20,000 - 50,000;369;230;139;364;364;1
212480;Sonic & All-Stars Racing Transformed Collection;Action, Indie, Strategy;500,000 - 1,000,000;14518;935;13583;498;247;93
212500;The Lord of the Rings Online;Indie, Strategy;2,000,000 - 5,000,000;13932;3135;10797;1278;168;1261
212630;Tom Clancy's Ghost Recon: Future Soldier;Casual, Free to Play, Massively Multiplayer, RPG;200,000 - 500,000;3197;1508;1689;588;592;13
212680;FTL: Faster Than Light;Adventure;2,000,000 - 5,000,000;64225;2860;61365;1493;612;1298
212700;Party of Sin;Action, RPG;50,000 - 100,000;98;98;0;139;240;2
212740;TERA - Action MMORPG;Indie, Simulation, Sports;1,000,000 - 2,000,000;5974;1693;4281;1121;340;1
212780;New Star Soccer 5;Indie;50,000 - 100,000;408;197;211;34;34;15
212800;Super Crate Box;Indie, Strategy;1,000,000 - 2,000,000;5823;735;5088;161;54;2
213030;Penny Arcade's On the Rain-Slick Precipice of Darkness 3;Sports, Strategy;200,000 - 500,000;479;83;396;98;129;1
213050;Starvoid Beta;Action, RPG;0 - 20,000;0;0;0;0;0;0
213330;LEGO Batman 2: DC Super Heroes;Casual;200,000 - 500,000;4396;302;4094;374;257;242
213390;Atooms to Moolecules Demo;Action, Adventure, Indie;0 - 20,000;10;6;4;0;0;0
213610;Sonic Adventure 2;Action, Casual, Indie, Early Access;500,000 - 1,000,000;14549;2041;12508;1973;130;316
213650;Dwarfs - F2P;Action;500,000 - 1,000,000;1409;243;1166;78;51;2
213670;South Park: The Stick of Truth;Strategy;2,000,000 - 5,000,000;51645;1275;50370;763;706;665
213850;Magic 2014 — Duels of the Planeswalkers;Action, Indie;500,000 - 1,000,000;3759;791;2968;1705;941;34
214050;Sanctum Beta;Action, Indie, RPG;0 - 20,000;0;0;0;0;0;0
214100;Rigonauts;Adventure, Indie;0 - 20,000;31;26;5;109;109;0
214130;Aerofly FS 1 Flight Simulator;Action, Adventure, Free to Play, Massively Multiplayer, RPG;20,000 - 50,000;108;54;54;0;0;0
214150;Galactic Civilizations I: Ultimate Edition;Simulation;200,000 - 500,000;114;129;-15;31;38;2
214170;Divine Divinity;Action;500,000 - 1,000,000;2560;347;2213;439;86;45
214190;Minimum;Strategy, RPG, Indie;500,000 - 1,000,000;2436;1631;805;110;113;0
214250;I Am Alive;Indie, Simulation, Strategy;200,000 - 500,000;1692;820;872;190;122;2
214270;Mensa Academy;Action, Indie;0 - 20,000;0;0;0;0;0;1
214340;Deponia;Indie, Strategy;1,000,000 - 2,000,000;9597;1352;8245;332;225;31
214360;Tower Wars;Action, Free to Play, Massively Multiplayer;200,000 - 500,000;1251;459;792;302;195;5
214400;American Mensa Academy;Indie, RPG, Strategy;0 - 20,000;0;0;0;0;0;1
214420;Gear Up;Indie, Strategy;1,000,000 - 2,000,000;6327;2171;4156;145;36;2
214490;Alien: Isolation;Action, RPG;2,000,000 - 5,000,000;46915;3563;43352;551;207;227
214510;LEGO The Lord of the Rings;Violent, Gore, Action, Adventure, Indie;1,000,000 - 2,000,000;10015;1091;8924;455;110;267
214550;Eets Munchies;Action, Adventure, Indie;200,000 - 500,000;580;139;441;124;81;1
214560;Mark of the Ninja;Adventure, Casual, Strategy;1,000,000 - 2,000,000;15257;472;14785;516;230;12
214570;ETHER VAPOR Remaster;Adventure, Casual;50,000 - 100,000;213;66;147;164;229;0
214590;Fairy Bloom Freesia;Adventure, Indie;100,000 - 200,000;915;163;752;311;456;0
214610;Cherry Tree High Comedy Club;Audio Production, Utilities, Video Production;50,000 - 100,000;490;88;402;14;14;1
214630;Call of Duty: Black Ops - Mac Edition;Action, Adventure, Indie, RPG;50,000 - 100,000;179;116;63;452;452;0
214700;Thirty Flights of Loving;Casual, Simulation, Strategy;200,000 - 500,000;1053;661;392;12;14;1
214730;Space Rangers HD: A War Apart;Action, Indie;200,000 - 500,000;5387;295;5092;5351;7648;252
214770;Guacamelee! Gold Edition;Action, Indie;500,000 - 1,000,000;5385;387;4998;622;249;6
214790;The Basement Collection;Action, Indie;200,000 - 500,000;1119;184;935;67;45;2
214830;Half Minute Hero: Super Mega Neo Climax Ultimate Boy;Action, Indie;200,000 - 500,000;1235;194;1041;163;97;3
214870;Painkiller Hell & Damnation;Free to Play, Indie, RPG, Strategy;200,000 - 500,000;2916;850;2066;273;148;9
214910;Air Conflicts: Pacific Carriers;Action, Indie;100,000 - 200,000;265;241;24;230;230;3
214950;Total War: ROME II - Emperor Edition;Adventure, Casual, Indie;2,000,000 - 5,000,000;62556;14028;48528;6080;2478;6021
214970;Intrusion 2;Free to Play, Strategy;200,000 - 500,000;1436;206;1230;148;71;3
215080;WAKFU;Adventure, Indie, Simulation;1,000,000 - 2,000,000;6811;2273;4538;3444;141;396
215100;Ragnarok Online;RPG;500,000 - 1,000,000;1462;509;953;1695;621;77
215120;ROSE Online;RPG;200,000 - 500,000;310;135;175;1;1;0
215160;The Book of Unwritten Tales;Action, Free to Play, Indie;200,000 - 500,000;1762;166;1596;497;623;9
215280;Secret World Legends;Adventure, Indie;500,000 - 1,000,000;5764;2840;2924;1212;322;82
215390;Damage Inc. Pacific Squadron WWII;Adventure, Indie;0 - 20,000;10;7;3;0;0;0
215450;Transcripted;Adventure;0 - 20,000;50;3;47;0;0;0
215470;Primal Carnage;Action, Adventure, Indie, RPG;200,000 - 500,000;4492;1360;3132;252;178;4
215490;Primal Carnage Beta;Adventure, Indie;0 - 20,000;0;0;0;0;0;0
215510;Rocketbirds: Hardboiled Chicken;Action, Racing;200,000 - 500,000;2436;639;1797;169;60;1
215530;The Incredible Adventures of Van Helsing;Indie, Simulation;500,000 - 1,000,000;7590;1542;6048;747;263;25
215550;Zombie Playground;Action, Adventure;20,000 - 50,000;149;186;-37;151;208;0
215590;Endless Space QA;Casual, Simulation;0 - 20,000;0;0;0;0;0;0
215630;Demonicon;Adventure;200,000 - 500,000;626;291;335;380;693;0
215670;Home;Action, Adventure;200,000 - 500,000;1134;559;575;149;159;4
215690;Zeno Clash 2;Action, Indie;200,000 - 500,000;950;283;667;209;204;1
215710; Fieldrunners 2;Indie, Strategy;100,000 - 200,000;384;65;319;129;129;12
215770;Shad'O;Design & Illustration, Web Publishing;50,000 - 100,000;58;52;6;199;204;0
215790;Dream Pinball 3D;Adventure, Indie;500,000 - 1,000,000;333;505;-172;273;287;1
215830;Closers;Indie;500,000 - 1,000,000;3337;1145;2192;6850;69;72
215870;Dungeon-Party;Violent, Gore, Action, Indie, Racing;200,000 - 500,000;163;221;-58;31;60;0
215930;Jagged Alliance 2 - Wildfire;Action, Adventure, Indie;500,000 - 1,000,000;1087;325;762;468;424;104
216090;Go Home Dinosaurs!;Action, Casual, Indie, Strategy;50,000 - 100,000;451;60;391;357;406;2
216110;Tiny Troopers;Photo Editing;100,000 - 200,000;952;227;725;50;26;3
216130;Gemini Wars;Animation & Modeling, Education, Software Training, Utilities;50,000 - 100,000;45;111;-66;158;158;1
216150;MapleStory;Indie, RPG, Simulation, Strategy;1,000,000 - 2,000,000;7181;3054;4127;10157;177;4097
216210;Secret Files 3;Action, Adventure;20,000 - 50,000;96;44;52;69;69;2
216260;Don Bradman Cricket 14;Action, Adventure, Massively Multiplayer;0 - 20,000;621;74;547;125;125;12
216290;Gateways;Indie, Strategy;50,000 - 100,000;215;20;195;5;9;0
216670;Great Big War Game;Animation & Modeling;20,000 - 50,000;53;4;49;0;0;1
216890;Blood Bowl: Chaos Edition;Adventure, Casual, Indie;200,000 - 500,000;1356;322;1034;1634;613;17
216910;Of Orcs And Men;Strategy;200,000 - 500,000;1277;455;822;281;218;2
216930;Luxor: Amun Rising HD;Indie, Strategy;20,000 - 50,000;44;14;30;0;0;3
217100;Dementium II HD;Action, Indie;100,000 - 200,000;517;570;-53;230;176;3
217120;Waves 2: Notorious;Casual, Simulation;20,000 - 50,000;225;20;205;94;21;0
217140;Rise of the Triad;Adventure;100,000 - 200,000;1583;799;784;166;145;2
217200;Worms Armageddon;Adventure, Indie;1,000,000 - 2,000,000;7924;485;7439;531;143;249
217270;Karateka;Adventure, Indie;50,000 - 100,000;223;94;129;10;10;1
217290;Din's Curse;Action, Indie, Simulation;20,000 - 50,000;190;32;158;0;0;1
217690;Anna - Extended Edition;Adventure, Indie;100,000 - 200,000;947;582;365;168;156;1
217750;Age of Conan: Unchained;Action, Indie;500,000 - 1,000,000;1599;710;889;2404;170;101
217790;Dogfight 1942;;100,000 - 200,000;726;211;515;204;203;4
217920;Alien Rage - Unlimited;Action;500,000 - 1,000,000;2191;1031;1160;163;161;2
218020;Nethergate: Resurrection;Action;50,000 - 100,000;81;11;70;138;188;2
218040;Democracy 2;Action, Adventure;20,000 - 50,000;57;50;7;1;1;0
218060;BIT.TRIP Presents... Runner2: Future Legend of Rhythm Alien;Action, Free to Play, Indie, Racing;200,000 - 500,000;2758;238;2520;324;212;4
218090;Unity of Command: Stalingrad Campaign;Free to Play, Indie, Massively Multiplayer, RPG;100,000 - 200,000;704;177;527;146;146;11
218230;PlanetSide 2;Adventure, Strategy;5,000,000 - 10,000,000;56305;12624;43681;1672;142;1901
218410;Defender's Quest: Valley of the Forgotten (DX edition);Indie, Simulation, Strategy;200,000 - 500,000;3148;140;3008;733;857;16
218510;Planets Under Attack;Strategy;200,000 - 500,000;764;285;479;322;302;3
218620;PAYDAY 2;Action, Indie, Strategy;20,000,000 - 50,000,000;549227;63573;485654;6949;581;59512
218640;Lucius;Action;500,000 - 1,000,000;7805;1830;5975;271;171;34
218660;iBomber Attack;Action, Indie, RPG;20,000 - 50,000;127;35;92;432;432;0
218680;Scribblenauts Unlimited;Strategy, Casual;1,000,000 - 2,000,000;9838;676;9162;494;198;67
218700;Angelica Weaver: Catch Me When You Can;Action, Adventure;20,000 - 50,000;94;39;55;0;0;1
218740;Pid;;200,000 - 500,000;2013;391;1622;37;22;1
218820;Mercenary Kings: Reloaded Edition;Action, Indie;200,000 - 500,000;1672;699;973;394;228;7
218980;Patterns;Indie, Casual;0 - 20,000;22;134;-112;0;0;0
219070;Miner Wars Arena;RPG;0 - 20,000;11;20;-9;4;4;0
219150;Hotline Miami;Indie, Massively Multiplayer, RPG;2,000,000 - 5,000,000;78101;2094;76007;351;290;172
219190;Ultratron;Action, Adventure, Indie, RPG, Simulation;100,000 - 200,000;586;69;517;83;83;0
219200;Droid Assault;Action, Indie, Racing;50,000 - 100,000;297;64;233;79;90;1
219340;The Banner Saga: Factions;Action, Adventure, Indie;200,000 - 500,000;608;212;396;275;74;0
219640;Chivalry: Medieval Warfare;Casual, Indie, RPG, Simulation, Strategy, Early Access;5,000,000 - 10,000,000;54648;11623;43025;854;232;91
219680;Proteus;Action, Adventure, Indie;200,000 - 500,000;1985;659;1326;43;28;1
219700;Dogs of War Online;Action, Free to Play, Indie, RPG, Strategy;200,000 - 500,000;445;252;193;4;4;0
219740;Don't Starve;Action, Adventure, Indie;2,000,000 - 5,000,000;97026;3226;93800;1234;320;2651
219760;Beyond Divinity;Action, Adventure, Indie;200,000 - 500,000;299;267;32;42;42;7
219780;Divinity II: Developer's Cut;Free to Play, Simulation;500,000 - 1,000,000;3423;644;2779;459;349;58
219830;King Arthur's Gold;Action, Adventure, RPG;500,000 - 1,000,000;4179;791;3388;297;84;42
219890;Antichamber;Indie, Simulation, Strategy;1,000,000 - 2,000,000;15107;775;14332;278;174;25
219910;Edna & Harvey: Harvey's New Eyes;Utilities;200,000 - 500,000;2473;296;2177;108;129;16
219950;NiGHTS Into Dreams;Free to Play, Simulation;200,000 - 500,000;1315;219;1096;80;109;6
219990;Grim Dawn;Action, Adventure, Casual, Racing;5,000,000 - 10,000,000;76572;5271;71301;4140;721;3997
220090;The Journey Down: Chapter One;Action, Free to Play, Indie;100,000 - 200,000;1080;158;922;157;171;1
220160;Trials Evolution: Gold Edition;;200,000 - 500,000;1609;473;1136;442;439;8
220200;Kerbal Space Program;Action, Adventure;2,000,000 - 5,000,000;106380;5853;100527;3789;741;5349
220240;Far Cry 3;Audio Production, Software Training, Utilities, Video Production, Web Publishing;2,000,000 - 5,000,000;80098;8851;71247;1218;812;575
220260;Farming Simulator 2013 Titanium Edition;Indie, RPG, Simulation, Strategy, Early Access;200,000 - 500,000;4597;395;4202;2662;1744;46
220420;Nancy Drew: The Deadly Device;Adventure, Indie;0 - 20,000;45;4;41;0;0;6
220440;DmC: Devil May Cry;Action, Adventure, Indie;1,000,000 - 2,000,000;23496;1654;21842;661;481;113
220460;Cargo Commander;Indie, Simulation, Strategy;50,000 - 100,000;726;159;567;177;238;5
220660;StarDrive;Action, Indie;200,000 - 500,000;634;803;-169;2148;3920;5
220700;RPG Maker VX Ace;Action, Free to Play, Massively Multiplayer, RPG;100,000 - 200,000;4025;245;3780;2397;420;178
220740;Chaos on Deponia;Strategy, Casual;500,000 - 1,000,000;2186;223;1963;387;417;18
220780;Thomas Was Alone;Indie, Simulation, Strategy;500,000 - 1,000,000;8318;543;7775;148;137;4
220820;Zombie Driver HD;Indie;200,000 - 500,000;2925;600;2325;282;53;10
220860;McPixel;Action, Indie;500,000 - 1,000,000;3194;607;2587;99;85;1
220900;Jack Lumber;Indie, Strategy;100,000 - 200,000;225;128;97;27;28;2
220960;ACDSee 15;Action, Simulation, Strategy;0 - 20,000;14;10;4;0;0;0
220980;CRYENGINE;Action, Adventure;100,000 - 200,000;166;64;102;0;0;0
221020;Towns;Action, Adventure;100,000 - 200,000;717;2010;-1293;740;489;3
221040;Resident Evil 6;Action, Adventure;2,000,000 - 5,000,000;32844;8271;24573;961;480;601
221100;DayZ;Action, Adventure;5,000,000 - 10,000,000;244989;91344;153645;9852;2217;52728
221180;Eufloria HD;Action, Adventure;;;;0;;;
221220;iPi Recorder 2;Action;0 - 20,000;12;3;9;0;0;0
221260;Little Inferno;Action, Adventure, Indie;500,000 - 1,000,000;10298;585;9713;331;267;39
221380;Age of Empires II (2013);Action;5,000,000 - 10,000,000;92470;4152;88318;2271;603;4891
221540;DG2: Defense Grid 2;Action, Adventure, Strategy;200,000 - 500,000;2373;407;1966;1278;719;46
221640;Super Hexagon;Action, Indie, RPG;1,000,000 - 2,000,000;22874;759;22115;218;78;20
221680;Rocksmith 2014 Edition - Remastered;Action, Adventure;500,000 - 1,000,000;18926;1995;16931;3574;938;1017
221810;The Cave;Action, Adventure;200,000 - 500,000;2234;325;1909;230;195;10
221830;The Book of Unwritten Tales: The Critter Chronicles;Action, RPG;100,000 - 200,000;346;64;282;152;152;1
221910;The Stanley Parable;Simulation, Strategy;2,000,000 - 5,000,000;39767;3259;36508;220;147;84
222140;Puddle;Action, Adventure;100,000 - 200,000;341;129;212;93;98;1
222160;Hamlet or the Last Game without MMORPG Features, Shaders and Product Placement;Action, Indie;200,000 - 500,000;317;182;135;288;303;1
222180;Mushroom Men: Truffle Trouble;RPG;0 - 20,000;27;17;10;205;205;0
222320;Football Manager 2013 Asia;Action, Casual, Free to Play, Indie;0 - 20,000;0;0;0;0;0;3
222420;THE KING OF FIGHTERS '98 ULTIMATE MATCH FINAL EDITION;Action, Casual, Indie, Strategy;200,000 - 500,000;2100;244;1856;352;120;77
222440;THE KING OF FIGHTERS 2002 UNLIMITED MATCH;Adventure, Casual, Indie, Strategy;100,000 - 200,000;3393;190;3203;671;106;154
222480;Resident Evil Revelations;Adventure;1,000,000 - 2,000,000;9625;1567;8058;576;353;91
222500;Rail Adventures - VR Tech Demo;Racing, Sports;50,000 - 100,000;19;20;-1;0;0;0
222520;Champions of Regnum;Adventure, Casual, Indie, RPG, Strategy;200,000 - 500,000;738;363;375;173;35;49
222618;Train Simulator: East Coast Main Line London-Peterborough Route Add-On;Action, Indie, Massively Multiplayer, RPG, Simulation;50,000 - 100,000;47;11;36;0;0;0
222640;Aarklash: Legacy;Action;100,000 - 200,000;577;209;368;303;370;2
222660;Retro/Grade;Adventure, Casual, Indie, RPG, Simulation;50,000 - 100,000;317;58;259;74;96;0
222730;Reus;;500,000 - 1,000,000;4305;1182;3123;200;121;15
222750;Wargame: Airland Battle;Racing, Sports;200,000 - 500,000;3733;520;3213;927;440;66
222820;Emergency 2013;Adventure;0 - 20,000;12;0;12;0;0;0
222860;Left 4 Dead 2 Dedicated Server;RPG, Strategy;20,000 - 50,000;34;7;27;0;0;2
222880;Insurgency;Indie, Strategy;2,000,000 - 5,000,000;114337;10255;104082;932;250;537
222940;THE KING OF FIGHTERS XIII STEAM EDITION;Action, RPG;500,000 - 1,000,000;8288;872;7416;1182;200;168
222980;Dead Pixels;Casual, Indie, Strategy;200,000 - 500,000;2066;315;1751;92;35;0
223000;7 Wonders: Ancient Alien Makeover;Adventure, Indie;50,000 - 100,000;227;39;188;0;0;2
223100;Homefront: The Revolution;Simulation, Strategy;500,000 - 1,000,000;8984;6157;2827;674;410;74
223140;Risen 2 Dark Waters JP;Indie, RPG, Simulation, Strategy;0 - 20,000;0;0;0;0;0;0
223220;Giana Sisters: Twisted Dreams;Adventure, Indie;200,000 - 500,000;1388;393;995;163;99;5
223280;Cut the Rope;Action;0 - 20,000;252;25;227;7;7;0
223330;Sea Dogs: To Each His Own - Pirate Open World RPG;Action, Indie, Simulation;200,000 - 500,000;1557;512;1045;0;0;147
223410;Perpetuum;Free to Play, Indie, Massively Multiplayer, RPG, Simulation, Strategy;20,000 - 50,000;532;204;328;1232;1232;14
223430;Miner Wars 2081;Action, Adventure, Indie;50,000 - 100,000;128;233;-105;55;76;0
223450;Dyad;Action, Adventure, Indie, RPG, Strategy;20,000 - 50,000;173;52;121;15;15;0
223470;POSTAL 2;Utilities;5,000,000 - 10,000,000;78752;3022;75730;414;209;453
223490;Blockscape;Indie, Simulation;20,000 - 50,000;412;477;-65;267;267;1
223510;Miasmata;Action, Adventure, Casual;100,000 - 200,000;878;263;615;17;19;1
223630;AirBuccaneers;Action, Indie, Massively Multiplayer, RPG;100,000 - 200,000;409;263;146;77;105;1
223710;Cry of Fear;Action;2,000,000 - 5,000,000;38264;6008;32256;159;63;230
223730;Fly'N;Action, Indie;100,000 - 200,000;419;66;353;334;467;0
223750;DCS World Steam Edition;Action, Casual, Indie, RPG;2,000,000 - 5,000,000;22912;3729;19183;693;41;1638
223810;Ys I & II Chronicles+;Adventure, Casual;200,000 - 500,000;1906;235;1671;407;567;12
223830;Xenonauts;Simulation, Strategy;500,000 - 1,000,000;3718;494;3224;1806;2280;227
223850;3DMark;Action, Indie, Early Access;1,000,000 - 2,000,000;12157;831;11326;824;194;713
224000;Project Eagle: A 3D Interactive Mars Base;Action, Indie;200,000 - 500,000;391;127;264;0;0;0
224040;LocoCycle;Indie, Strategy;20,000 - 50,000;248;66;182;20;20;1
224260;No More Room in Hell;Strategy, Casual;5,000,000 - 10,000,000;60588;6829;53759;401;77;697
224280;RPG Maker VX Ace Lite;Strategy, Casual;20,000 - 50,000;151;6;145;0;0;5
224300;Legacy of Kain: Defiance;Action, Free to Play, Indie, Massively Multiplayer;200,000 - 500,000;788;134;654;417;200;5
224380;Virtual DJ - Broadcaster Edition;Audio Production, Software Training, Utilities, Video Production;0 - 20,000;38;38;0;173;173;0
224440;Folk Tale;Violent, Action, Strategy;200,000 - 500,000;1057;1722;-665;72;72;1
224460;Contrast;Indie, RPG, Strategy;200,000 - 500,000;4690;489;4201;613;429;3
224480;Octodad: Dadliest Catch;RPG, Strategy;500,000 - 1,000,000;8468;582;7886;235;173;32
224500;Gnomoria;Action, Adventure;200,000 - 500,000;2661;810;1851;206;275;17
224540;Ace of Spades: Battle Builder;Action, Adventure, Indie, Strategy;1,000,000 - 2,000,000;12058;6507;5551;634;312;1
224600;Defiance;Adventure;2,000,000 - 5,000,000;9672;3006;6666;657;155;1
224700;The Game of Life;Action, Indie, Racing, Simulation, Sports;0 - 20,000;31;49;-18;0;0;0
224760;FEZ;Action, Simulation;1,000,000 - 2,000,000;12758;1036;11722;167;69;29
224820;Super House of Dead Ninjas;Indie, Strategy;100,000 - 200,000;1522;66;1456;116;151;3
224860;Arma Tactics;Racing, Sports;200,000 - 500,000;293;623;-330;182;195;1
224900;Iron Sky: Invasion;Indie, Strategy;200,000 - 500,000;634;449;185;387;423;2
224920;Legacy of Kain: Soul Reaver;Action, Adventure, RPG;500,000 - 1,000,000;1300;463;837;444;320;3
224940;Legacy of Kain: Soul Reaver 2;Casual, Indie, Strategy;200,000 - 500,000;573;283;290;1037;1553;5
224960;Tomb Raider I;Action, Indie, Simulation, Early Access;500,000 - 1,000,000;3480;602;2878;94;16;32
224980;Tomb Raider IV: The Last Revelation;Adventure, Indie;200,000 - 500,000;959;151;808;120;37;35
225000;Tomb Raider V: Chronicles;Casual, Indie, Simulation;200,000 - 500,000;528;184;344;647;38;16
225020;Tomb Raider VI: The Angel of Darkness;Action, Indie;200,000 - 500,000;768;504;264;170;121;4
225080;Brothers - A Tale of Two Sons;Action;1,000,000 - 2,000,000;37429;2146;35283;176;127;25
225160;Shadow Warrior Classic Redux;Action, Casual, Indie, Racing;200,000 - 500,000;2740;284;2456;229;153;9
225260;Brutal Legend;Utilities;2,000,000 - 5,000,000;16116;1200;14916;324;281;43
225280;Full Mojo Rampage;Indie, Strategy;200,000 - 500,000;1037;190;847;304;370;0
225300;Tomb Raider II;Indie;200,000 - 500,000;1741;264;1477;253;123;42
225320;Tomb Raider III;Indie, RPG;200,000 - 500,000;1081;201;880;68;20;35
225360;DARK;Adventure, Indie, Simulation;100,000 - 200,000;666;595;71;166;186;4
225420;Cities in Motion 2;Indie, Simulation, Strategy;500,000 - 1,000,000;1377;1028;349;298;94;34
225540;Just Cause 3;Adventure, Indie;2,000,000 - 5,000,000;88810;18612;70198;1844;461;1478
225600;Blade Symphony;Adventure, Indie, RPG, Strategy;200,000 - 500,000;3119;1620;1499;263;160;7
225640;Sacred 2 Gold;Action;500,000 - 1,000,000;2221;719;1502;440;203;128
225840;Sven Co-op;Casual, Indie, Simulation, Early Access;5,000,000 - 10,000,000;24951;1735;23216;1507;68;478
226100;PixelJunk Nom Nom Galaxy;Action, Free to Play, Indie, RPG;100,000 - 200,000;736;238;498;62;93;4
226120;Weird Worlds: Return to Infinite Space;Massively Multiplayer;200,000 - 500,000;375;205;170;11;9;0
226280;Warp Frontier;Action, Free to Play;0 - 20,000;39;2;37;0;0;0
226560;Escape Dead Island;Indie, Simulation, Sports, Strategy;100,000 - 200,000;803;490;313;117;142;3
226580;F1 2014;Action, Adventure, Indie;200,000 - 500,000;2416;449;1967;985;630;27
226620;Desktop Dungeons;Casual, Indie;100,000 - 200,000;1251;140;1111;305;394;21
226700;Infestation: Survivor Stories 2020;Adventure, Indie;1,000,000 - 2,000,000;10673;14873;-4200;3048;673;39
226720;LOST PLANET 3;Action, Adventure, Casual, Indie;200,000 - 500,000;2077;1244;833;442;316;11
226740;Monster Loves You!;Action, Adventure, Indie, Strategy;200,000 - 500,000;921;257;664;109;152;0
226760;Rugby Challenge 2;Adventure, Indie;0 - 20,000;0;0;0;0;0;1
226780;MUD Motocross World Championship;Indie, Simulation;20,000 - 50,000;72;51;21;261;261;1
226820;Nancy Drew: Ghost of Thornton Hall;Action, Adventure, Casual, Indie;20,000 - 50,000;180;15;165;314;314;11
226820;Nancy Drew: Ghost of Thornton Hall;Free to Play, Massively Multiplayer, RPG;20,000 - 50,000;180;15;165;314;314;11
226840;Age of Wonders III;Simulation;1,000,000 - 2,000,000;9394;2272;7122;500;134;723
226860;Galactic Civilizations III;Action, Adventure, Indie;1,000,000 - 2,000,000;7678;2355;5323;1150;468;366
226920;Hellraid;Adventure, Indie;0 - 20,000;0;0;0;0;0;0
226960;Ironclad Tactics;Adventure, Indie;50,000 - 100,000;420;187;233;176;305;3
227000;Primordia;Action, Adventure;100,000 - 200,000;2883;84;2799;316;431;5
227020;Rise of Venice;Strategy;100,000 - 200,000;280;189;91;218;232;6
227060;Hegemony Rome: The Rise of Caesar;Casual, Indie;50,000 - 100,000;263;173;90;80;127;4
227080;Papo & Yo;Indie, RPG;200,000 - 500,000;2577;179;2398;84;68;2
227100;Sniper Elite: Nazi Zombie Army;Action, Adventure, Casual;200,000 - 500,000;3815;515;3300;342;250;7
227160;Kinetic Void;Indie, Simulation;100,000 - 200,000;275;1273;-998;107;111;0
227180;Kingdom Wars;Indie, Strategy;500,000 - 1,000,000;1847;885;962;336;300;5
227200;Waking Mars;Action;200,000 - 500,000;1012;132;880;55;75;3
227220;Sang-Froid - Tales of Werewolves;Adventure, Indie;200,000 - 500,000;1642;231;1411;75;113;1
227260;DisplayFusion;Casual, Free to Play, RPG, Strategy;100,000 - 200,000;888;125;763;40;41;8
227300;Euro Truck Simulator 2;Action, RPG;10,000,000 - 20,000,000;606969;16200;590769;5718;1626;35363
227380;Dragon's Lair;Action, Indie;50,000 - 100,000;446;131;315;25;25;1
227400;Darkfall Unholy Wars;Adventure, Casual, Indie;50,000 - 100,000;339;303;36;0;0;0
227480;God Mode;Indie, Simulation, Strategy, Early Access;200,000 - 500,000;1754;744;1010;429;344;1
227560;Scourge: Outbreak;Simulation, Strategy;100,000 - 200,000;353;194;159;235;259;1
227580;10,000,000;Racing, Sports;100,000 - 200,000;1952;222;1730;293;405;6
227580;10,000,000;;100,000 - 200,000;1952;222;1730;293;405;6
227600;Castle of Illusion;Action, Casual, Indie;200,000 - 500,000;2798;304;2494;181;212;19
227760;March of the Eagles;Indie, Strategy;50,000 - 100,000;233;108;125;534;686;5
227780;Serious Sam Classics: Revolution;Action, Adventure;200,000 - 500,000;2796;273;2523;445;77;23
227800;Retrovirus;Action, Indie, Simulation;20,000 - 50,000;125;45;80;731;731;1
227800;Retrovirus;Action, Indie;20,000 - 50,000;125;45;80;731;731;1
227860;Castle Story;Action, Simulation;200,000 - 500,000;5382;3240;2142;1107;429;77
227900;Battleship;Adventure, Indie;0 - 20,000;27;17;10;0;0;0
227920;Risk;Action, Adventure;20,000 - 50,000;159;141;18;68;68;14
227940;Heroes & Generals;Action, Adventure, RPG;10,000,000 - 20,000,000;94879;47101;47778;1069;74;2140
228180;Action! - Gameplay Recording and Streaming;Indie, RPG, Strategy;200,000 - 500,000;5331;875;4456;19227;14829;518
228200;Company of Heroes;Action, Adventure, RPG;1,000,000 - 2,000,000;12852;769;12083;1430;395;1715
228260;Fallen Enchantress: Legendary Heroes;Adventure;200,000 - 500,000;1726;592;1134;225;292;60
228280;Baldur's Gate: Enhanced Edition;Action;1,000,000 - 2,000,000;11648;1087;10561;1107;425;777
228300;Remember Me;Indie, Simulation, Strategy;500,000 - 1,000,000;12004;2426;9578;412;316;27
228320;A Valley Without Wind 2;Adventure, Indie, RPG;20,000 - 50,000;99;117;-18;11;11;1
228360;Full Throttle Remastered;Casual, Indie;200,000 - 500,000;2176;181;1995;155;190;10
228380;Wreckfest;Action, Indie;1,000,000 - 2,000,000;28489;4120;24369;963;324;817
228400;Ace Combat Assault Horizon - Enhanced Edition;Action, Adventure;200,000 - 500,000;2965;2144;821;297;94;6
228440;Cubemen 2;Action, Indie, Racing;50,000 - 100,000;155;70;85;338;338;0
228560;Teenage Mutant Ninja Turtles: Out of the Shadows;Animation & Modeling, Design & Illustration, Photo Editing, Utilities;100,000 - 200,000;424;353;71;37;37;0
228760;TrackMania² Canyon;Casual, Indie, RPG, Strategy;100,000 - 200,000;1420;323;1097;444;367;32
228960;Skulls of the Shogun;Action, Indie, Simulation;100,000 - 200,000;653;71;582;187;127;4
229480;Dungeons & Dragons: Chronicles of Mystara;Indie, Strategy;500,000 - 1,000,000;1259;263;996;129;150;6
229520;Dungeon Hearts;;50,000 - 100,000;327;192;135;189;210;3
229560;Hacker Evolution IMMERSION;Strategy;0 - 20,000;20;17;3;0;0;0
229580;Dream;Action, Indie, RPG, Simulation, Strategy;50,000 - 100,000;546;423;123;259;259;1
229600;Bientôt l'été;Action, Indie, RPG;20,000 - 50,000;126;151;-25;25;25;0
229790;Might & Magic: Heroes VI - Shades of Darkness;Action, Adventure;50,000 - 100,000;4;1;3;0;0;0
229810;A Fistful of Gun;Casual, Strategy;100,000 - 200,000;297;171;126;245;353;0
229870;ShootMania Storm;Action, Adventure;50,000 - 100,000;703;119;584;884;960;13
229950;Resident Evil 6 Benchmark Tool;Action, Indie;50,000 - 100,000;318;57;261;0;0;4
229970;Armada 2526 Gold Edition;Action, Indie, Simulation;50,000 - 100,000;69;35;34;102;102;1
230050;DLC Quest;Adventure, Casual, Indie;200,000 - 500,000;5507;722;4785;132;123;4
230070;The Age of Decadence;Action, Adventure, Indie;200,000 - 500,000;2662;597;2065;294;417;19
230150;Incredipede;Casual, Free to Play, RPG;50,000 - 100,000;249;97;152;19;21;0
230190;War for the Overworld;Casual;500,000 - 1,000,000;6089;990;5099;789;551;74
230210;ASYLUM;Action, Adventure, Indie;0 - 20,000;0;0;0;0;0;0
230230;Divinity: Original Sin (Classic);Action, Indie;1,000,000 - 2,000,000;10687;968;9719;1446;811;33
230270;N++ (NPLUSPLUS);Action, Indie, Racing;200,000 - 500,000;2608;163;2445;224;228;34
230290;Universe Sandbox;Racing, Simulation, Sports;1,000,000 - 2,000,000;18651;747;17904;608;263;505
230310;Akaneiro: Demon Hunters;Adventure, Indie, RPG, Strategy;50,000 - 100,000;137;235;-98;107;108;0
230330;FINAL FANTASY XI: Ultimate Collection Seekers Edition;Action, Adventure;0 - 20,000;230;29;201;1;1;13
230410;Warframe;Casual, Sports;20,000,000 - 50,000,000;457199;71028;386171;7819;372;49667
230650;Lords of Football;Education, Software Training, Utilities, Web Publishing;50,000 - 100,000;166;159;7;166;216;1
230700;La-Mulana;Action, Adventure, Indie;200,000 - 500,000;1766;427;1339;281;323;29
230760;DIVO;Adventure, Casual, Indie, Simulation;0 - 20,000;8;15;-7;0;0;0
230780;articy:draft;Adventure, Casual, Indie;0 - 20,000;75;10;65;1410;1410;1
230780;articy:draft;Action, Indie;0 - 20,000;75;10;65;1410;1410;1
230820;The Night of the Rabbit;Action, Adventure;200,000 - 500,000;2565;297;2268;246;257;15
230840;Daylight;Casual, Indie, Strategy;100,000 - 200,000;781;768;13;168;202;0
230860;Cannon Brawl;Indie, Strategy;200,000 - 500,000;700;68;632;321;540;1
230980;Starseed Pilgrim;Action, Free to Play, Massively Multiplayer, RPG;200,000 - 500,000;300;201;99;60;103;1
231020;Storm;Casual, Indie, RPG, Strategy;20,000 - 50,000;68;32;36;73;73;1
231040;Beatbuddy: Tale of the Guardians;Strategy;200,000 - 500,000;875;269;606;125;100;3
231060;Ragnarok Online 2;Adventure, Free to Play, Indie, Massively Multiplayer, RPG, Strategy;1,000,000 - 2,000,000;1811;1273;538;1651;174;5
231140;Cities XL Platinum;Action;200,000 - 500,000;892;657;235;222;233;6
231160;The Swapper;Indie, Strategy;500,000 - 1,000,000;6621;378;6243;184;135;3
231200;Kentucky Route Zero: PC Edition;Action, Indie;200,000 - 500,000;2713;644;2069;180;212;8
231310;MirrorMoon EP;Action, Adventure;50,000 - 100,000;312;215;97;167;220;0
231330;Deadfall Adventures;Casual, Indie, Strategy;100,000 - 200,000;1750;630;1120;232;149;4
231430;Company of Heroes 2;Indie, Strategy;5,000,000 - 10,000,000;78128;21249;56879;3655;282;6962
231720;Bad Hotel;Action, Indie, Strategy;50,000 - 100,000;125;247;-122;40;62;1
231740;Knights of Pen and Paper +1 Edition;Indie;200,000 - 500,000;2573;509;2064;349;343;9
231910;Leisure Suit Larry in the Land of the Lounge Lizards: Reloaded;Action, Indie;20,000 - 50,000;384;88;296;227;227;0
232010;Euro Truck Simulator;Web Publishing;1,000,000 - 2,000,000;5501;1155;4346;131;61;12
232050;Eador. Masters of the Broken World;Casual, Indie;1,000,000 - 2,000,000;1775;819;956;419;272;58
232090;Killing Floor 2;Casual, Indie;2,000,000 - 5,000,000;99251;13939;85312;4446;663;4805
232430;Gone Home;Action, Adventure, Indie, RPG;500,000 - 1,000,000;13068;3947;9121;260;117;7
232450;SolForge;Action, Free to Play, Indie, RPG, Strategy;200,000 - 500,000;779;414;365;88;150;0
232750;Mars: War Logs;Indie, Strategy;200,000 - 500,000;1911;642;1269;378;419;4
232770;POSTAL;Action, RPG, Simulation;5,000,000 - 10,000,000;5722;773;4949;173;215;23
232790;Broken Age;Casual;500,000 - 1,000,000;6298;1239;5059;408;264;19
232810;Godus;Action, Indie, RPG, Simulation, Early Access;200,000 - 500,000;1798;5359;-3561;716;511;5
232890;Stronghold Crusader 2;Action, Free to Play, Massively Multiplayer, Simulation;1,000,000 - 2,000,000;10101;4201;5900;682;264;509
232910;TrackMania² Stadium;Action, RPG;500,000 - 1,000,000;5592;707;4885;5535;401;144
232950;Bridge Project;Action;;;;0;;;
232970;Thunder Wolves;Action;50,000 - 100,000;581;88;493;90;90;1
233110;Defense Technica;Action, Indie;20,000 - 50,000;67;105;-38;175;175;1
233130;Shadow Warrior;Action, Simulation, Strategy;2,000,000 - 5,000,000;22590;1844;20746;312;199;142
233150;LUFTRAUSERS;Sports, Strategy;200,000 - 500,000;3840;363;3477;333;170;5
233190;Final Exam;Action, Indie, Strategy;100,000 - 200,000;933;180;753;132;203;2
233210;Air Conflicts: Vietnam;Casual, Simulation;100,000 - 200,000;92;214;-122;0;0;1
233210;Air Conflicts: Vietnam;Simulation, Strategy;100,000 - 200,000;92;214;-122;0;0;1
233230;Kairo;Action;100,000 - 200,000;1244;453;791;160;150;1
233270;Far Cry 3 - Blood Dragon;Utilities;1,000,000 - 2,000,000;13216;1686;11530;472;189;15
233290;Murdered: Soul Suspect;Adventure, Indie;1,000,000 - 2,000,000;12945;2230;10715;281;189;18
233310;Avadon 2: The Corruption;Adventure;100,000 - 200,000;143;35;108;0;0;1
233350;Sudeki;Action;100,000 - 200,000;720;99;621;184;210;8
233370;The Raven - Legacy of a Master Thief;Action, Adventure, Casual, Free to Play, Massively Multiplayer, RPG;200,000 - 500,000;596;192;404;259;270;1
233410;Tomb Raider - The Final Hours Digital Book;Indie, Sports, Strategy;20,000 - 50,000;156;17;139;1;1;0
233450;Prison Architect;Audio Production, Software Training, Utilities, Video Production;5,000,000 - 10,000,000;58603;6325;52278;2155;608;1543
233470;Evoland;Indie, RPG, Strategy;200,000 - 500,000;4753;993;3760;232;256;4
233510;Lunnye Devitsy;Strategy;20,000 - 50,000;107;57;50;173;197;0
233530;Wake;Adventure, Indie, RPG;0 - 20,000;51;140;-89;308;315;0
233550;Another World – 20th Anniversary Edition;Indie, RPG;200,000 - 500,000;1449;297;1152;85;86;2
233610;Distance;Action, Adventure, Casual;200,000 - 500,000;6175;480;5695;522;212;28
233680;Black Ink;Action, Adventure, Indie;0 - 20,000;395;60;335;0;0;6
233700;Sword of the Stars: The Pit;Action, Indie;200,000 - 500,000;1247;213;1034;439;233;7
233720;Surgeon Simulator;Adventure, Indie;1,000,000 - 2,000,000;13063;2794;10269;204;135;30
233740;Organ Trail: Director's Cut;Action, Adventure, Indie, RPG, Simulation;200,000 - 500,000;2541;338;2203;232;196;11
233800;Arma 3 Tools;Adventure, RPG, Strategy;100,000 - 200,000;362;59;303;0;0;28
233840;Worms Clan Wars;Action, Indie, RPG;500,000 - 1,000,000;2327;648;1679;1161;292;44
233860;Kenshi;Indie, Strategy;2,000,000 - 5,000,000;62155;3192;58963;3564;1016;6530
233980;UnEpic;Adventure, Indie;500,000 - 1,000,000;7004;612;6392;698;461;19
234080;Castlevania: Lords of Shadow – Ultimate Edition;Indie, RPG, Strategy;500,000 - 1,000,000;5939;1426;4513;623;471;37
234140;Mad Max;Action, RPG;2,000,000 - 5,000,000;61404;5517;55887;1390;847;776
234160;Strike Suit Infinity;Action;100,000 - 200,000;492;96;396;41;37;1
234190;Receiver;Action;500,000 - 1,000,000;3240;810;2430;156;40;7
234270;Ken Follett's The Pillars of the Earth;Action, Adventure;200,000 - 500,000;5279;404;4875;482;607;32
234290;Zack Zero;Action, RPG;50,000 - 100,000;266;145;121;121;151;0
234330;MARVEL Puzzle Quest;Action, Adventure, Indie, RPG;500,000 - 1,000,000;2905;1243;1662;779;738;425
234350;Luxor 2 HD;Free to Play, Simulation;20,000 - 50,000;106;24;82;0;0;5
234370;Shattered Haven;Action, Indie, RPG;50,000 - 100,000;28;65;-37;14;24;0
234390;Teleglitch: Die More Edition;Action, Adventure, Indie;500,000 - 1,000,000;2369;413;1956;112;72;3
234490;Rush Bros.;Action, Adventure;100,000 - 200,000;533;341;192;66;72;6
234510;Rising Storm Game of the Year Edition;Action, Adventure, Indie;500,000 - 1,000,000;104;1;103;0;0;0
234630;Project CARS;Action, Adventure, Casual, Indie;1,000,000 - 2,000,000;11159;2982;8177;1157;330;86
234650;Shadowrun Returns;Action, Casual, Indie;1,000,000 - 2,000,000;11202;1450;9752;511;269;43
234670;NARUTO SHIPPUDEN: Ultimate Ninja STORM 3 Full Burst HD;Action, Indie;500,000 - 1,000,000;11203;1269;9934;797;568;73
234710;Poker Night 2;RPG;1,000,000 - 2,000,000;5973;878;5095;417;278;29
234820;Driver Fusion - The Best Driver & Device Solution;Action, Strategy;20,000 - 50,000;295;131;164;59;59;35
234900;Anodyne;Indie, Simulation, Strategy;200,000 - 500,000;1137;212;925;223;265;5
234920;Dyscourse;Indie, RPG, Strategy;50,000 - 100,000;345;97;248;95;95;0
234940;The 39 Steps;Casual, Indie, Simulation, Strategy;200,000 - 500,000;1145;372;773;190;228;1
235070;Bad Bots;Action, Adventure, Free to Play, Indie, Massively Multiplayer, RPG;20,000 - 50,000;145;111;34;89;167;0
235210;STRIDER / ストライダー飛竜;Adventure, Indie;500,000 - 1,000,000;2857;585;2272;342;212;16
235250;Super Sanctum TD;Action, Adventure, Indie, RPG;20,000 - 50,000;1324;182;1142;181;236;2
235320;Original War;Action;200,000 - 500,000;1671;92;1579;1253;1808;44
235340;Prime World;RPG;1,000,000 - 2,000,000;2205;1602;603;23488;780;0
235360;Prime World: Defenders;Action, RPG;200,000 - 500,000;756;242;514;346;365;2
235380;Blitzkrieg 3;Action, Adventure;200,000 - 500,000;3908;3093;815;1055;1643;11
235400;King’s Bounty: Legions;Action, Adventure, Indie;200,000 - 500,000;698;603;95;70;63;14
235460;METAL GEAR RISING: REVENGEANCE;Action, Adventure;2,000,000 - 5,000,000;58191;2516;55675;674;579;706
235520;The White Laboratory;Indie;50,000 - 100,000;245;71;174;0;0;3
235520;The White Laboratory;Action, Adventure, Indie;50,000 - 100,000;245;71;174;0;0;3
235540;Warhammer: End Times - Vermintide;;1,000,000 - 2,000,000;16107;4039;12068;1500;372;65
235600;Tom Clancy’s Splinter Cell Blacklist;Action, Free to Play;1,000,000 - 2,000,000;14220;3056;11164;903;506;40
235620;Small World;Indie;200,000 - 500,000;930;402;528;82;108;14
235660;Eador: Genesis;Action;100,000 - 200,000;317;60;257;0;0;17
235720;Cubetractor;Action, Indie;200,000 - 500,000;352;115;237;7;13;1
235800;Audiosurf 2;Casual, Indie, Simulation, Strategy;200,000 - 500,000;4729;1016;3713;383;185;16
235820;Element4l;Indie, RPG, Strategy;50,000 - 100,000;539;107;432;78;78;1
235900;RPG Maker XP;;100,000 - 200,000;891;67;824;220;104;209
235980;Tetrobot and Co.;Action, Free to Play, Massively Multiplayer, RPG;50,000 - 100,000;451;13;438;1058;1058;2
236010;Bloxitivity;Action, Adventure, Casual;0 - 20,000;17;13;4;244;244;0
236090;Dust: An Elysian Tail;Action, Adventure, Casual;500,000 - 1,000,000;16960;784;16176;522;415;18
236110;Dungeon Defenders II;Action, Adventure, Indie;2,000,000 - 5,000,000;15732;4569;11163;852;147;589
236130;Horizon;Racing, Simulation, Sports;200,000 - 500,000;266;189;77;0;0;8
236150;Starpoint Gemini 2;Action, Adventure, Indie, RPG;500,000 - 1,000,000;2799;1217;1582;287;186;14
236290;Cranky Cat;;0 - 20,000;20;5;15;42;42;0
236370;Interstellar Marines;Action;200,000 - 500,000;4347;3493;854;288;68;2
236390;War Thunder;Adventure, Indie, RPG, Strategy;20,000,000 - 50,000,000;292814;80159;212655;7344;412;82029
236430;DARK SOULS II;Action, Indie, RPG;1,000,000 - 2,000,000;35661;4451;31210;5109;2434;302
236450;PAC-MAN Championship Edition DX+;Indie, Strategy;200,000 - 500,000;7006;322;6684;138;31;18
236470;PAC-MAN MUSEUM;Casual, Indie, Simulation;50,000 - 100,000;169;101;68;0;0;1
236490;Hexodius;Adventure;0 - 20,000;26;17;9;107;107;0
236510;Takedown: Red Sabre;Adventure, Indie, Strategy;200,000 - 500,000;2296;3335;-1039;197;192;1
236690;Blood Bowl 2;Adventure, Indie;1,000,000 - 2,000,000;6388;1754;4634;3347;660;518
236730;Anomaly 2;Action, Indie, Strategy;200,000 - 500,000;719;182;537;194;196;1
236790;Agricultural Simulator 2013 - Steam Edition;Action, RPG, Simulation;50,000 - 100,000;144;500;-356;11;11;0
236850;Europa Universalis IV;Action, Massively Multiplayer, Racing;2,000,000 - 5,000,000;99168;15078;84090;20516;1936;20164
236870;HITMAN;Action, Adventure, Indie, RPG;2,000,000 - 5,000,000;30360;6216;24144;766;363;229
236890;PCMark 8;Violent, Gore, Indie, RPG;0 - 20,000;27;22;5;1988;1988;0
236930;Blackwell Epiphany;Audio Production, Software Training;50,000 - 100,000;767;15;752;478;609;5
236970;Jack Keane 2 - The Fire Within;Utilities;0 - 20,000;28;35;-7;11;11;2
237110;Mortal Kombat Komplete Edition;Action, Indie;1,000,000 - 2,000,000;15969;1562;14407;549;276;48
237310;Elsword;Action, Adventure, Indie;1,000,000 - 2,000,000;6780;2304;4476;1253;91;359
237350;Frozen Cortex;Audio Production;20,000 - 50,000;190;78;112;145;169;0
237370;PlayClaw 5 - Game Recording and Streaming;Adventure, Indie;0 - 20,000;288;117;171;6924;11214;8
237370;PlayClaw 5 - Game Recording and Streaming;;0 - 20,000;288;117;171;6924;11214;8
237430;Expeditions: Conquistador;Action, Adventure;100,000 - 200,000;1108;285;823;61;92;8
237470;Battle Worlds: Kronos;Action, Casual, Indie, Racing;20,000 - 50,000;195;94;101;0;0;6
237550;Realms of Arkania: Blade of Destiny;Action, Indie, Simulation;100,000 - 200,000;215;179;36;4;4;6
237570;Penny Arcade's On the Rain-Slick Precipice of Darkness 4;;200,000 - 500,000;275;66;209;298;301;0
237570;Penny Arcade's On the Rain-Slick Precipice of Darkness 4;;200,000 - 500,000;275;66;209;298;301;0
237630;DuckTales: Remastered;Action;200,000 - 500,000;5489;793;4696;274;205;22
237740;Angry Video Game Nerd Adventures;Action, Adventure;100,000 - 200,000;2752;353;2399;209;199;4
237760;Intake;Indie, Strategy;20,000 - 50,000;366;29;337;138;199;0
237850;Dreamfall Chapters;Action, Indie, Early Access;200,000 - 500,000;3505;723;2782;225;243;10
237870;Planet Explorers;Action;200,000 - 500,000;4176;2487;1689;570;437;20
237890;Agarest: Generations of War;Action, Indie, RPG;100,000 - 200,000;1307;515;792;294;476;9
237930;Transistor;Action;1,000,000 - 2,000,000;27434;1639;25795;264;172;32
237950;UFO: Afterlight;Action, Free to Play, Indie;200,000 - 500,000;296;167;129;77;78;6
237970;Memento Mori 2;Action, Adventure, Indie, Simulation;0 - 20,000;84;34;50;0;0;0
237990;The Banner Saga;Adventure, Indie;500,000 - 1,000,000;12991;1587;11404;499;324;59
238010;Deus Ex: Human Revolution - Director's Cut;Action, Indie;2,000,000 - 5,000,000;23176;1975;21201;1033;339;215
238050;The Apogee Throwback Pack;Action, Adventure, Indie, RPG;200,000 - 500,000;270;29;241;442;57;0
238090;Sniper Elite 3;Action, Indie, Strategy;2,000,000 - 5,000,000;19700;4293;15407;749;304;264
238210;System Shock 2;Action, Indie;500,000 - 1,000,000;6271;360;5911;326;205;34
238240;Edge of Space;Indie, Simulation, Strategy;200,000 - 500,000;928;1797;-869;231;369;7
238260;Pinball Arcade;RPG;500,000 - 1,000,000;2768;1013;1755;275;32;38
238280;Legend of Dungeon;Action;200,000 - 500,000;1178;423;755;260;381;6
238320;Outlast;Action;2,000,000 - 5,000,000;94276;3549;90727;257;155;390
238370;Magicka 2;RPG;1,000,000 - 2,000,000;9282;2008;7274;296;219;89
238430;Contagion;;1,000,000 - 2,000,000;10674;4051;6623;369;188;72
238460;BattleBlock Theater;Simulation;5,000,000 - 10,000,000;65409;1831;63578;513;293;186
238530;Super Puzzle Platformer Deluxe;Action;20,000 - 50,000;426;43;383;17;23;3
238630;Fist Puncher;Action, Adventure, Indie;20,000 - 50,000;208;75;133;110;208;0
238750;Might & Magic X - Legacy;Action, Adventure, Indie;200,000 - 500,000;1984;1034;950;3162;4673;41
238870;Citadels;;50,000 - 100,000;68;396;-328;0;0;1
238890;Skyward Collapse;Adventure, Indie;100,000 - 200,000;140;172;-32;126;134;0
238910;Bionic Dues;Indie;200,000 - 500,000;722;244;478;225;238;1
238930;7 Grand Steps: What Ancients Begat;Action, Indie, Strategy;50,000 - 100,000;392;346;46;432;587;0
238960;Path of Exile;Racing, Sports;20,000,000 - 50,000,000;172411;24199;148212;7943;340;24567
239030;Papers, Please;Action, Racing, Simulation, Sports;2,000,000 - 5,000,000;56043;1693;54350;360;232;693
239070;Hammerwatch;Action, Adventure;500,000 - 1,000,000;5615;645;4970;420;218;27
239090;Samurai Gunn;Strategy;20,000 - 50,000;400;31;369;167;169;2
239120;Final Fantasy III (3D Remake);Action, Racing, Sports;200,000 - 500,000;2300;483;1817;684;336;52
239140;Dying Light;Education, Software Training;10,000,000 - 20,000,000;348869;17960;330909;2180;1219;16705
239160;Thief;Action, RPG;1,000,000 - 2,000,000;15980;5598;10382;468;226;119
239200;Amnesia: A Machine for Pigs;Action, RPG, Strategy;1,000,000 - 2,000,000;6804;3025;3779;120;50;13
239250;Castlevania: Lords of Shadow 2;Action, Indie, Strategy;200,000 - 500,000;3891;722;3169;686;682;38
239350;Spelunky;Simulation;1,000,000 - 2,000,000;14116;1198;12918;1193;259;108
239430;Q.U.B.E: Director's Cut;Free to Play, Simulation;500,000 - 1,000,000;1476;299;1177;119;130;2
239490;America's Army: Proving Grounds Beta (Closed);Casual, Strategy;0 - 20,000;0;0;0;0;0;1
239660;Soldier Front 2;Casual, Strategy;500,000 - 1,000,000;1565;418;1147;4050;624;0
239700;Hate Plus;Simulation, Strategy;50,000 - 100,000;482;90;392;241;310;0
239720;PAC-MAN and the Ghostly Adventures;Indie, Racing, Simulation, Sports;0 - 20,000;170;39;131;0;0;3
239800;Bleed;Indie, Simulation, Strategy;100,000 - 200,000;1727;133;1594;320;484;1
239820;Game Dev Tycoon;Adventure, Indie;1,000,000 - 2,000,000;34126;1657;32469;920;523;272
239840;Dead State: Reanimated;Action, Simulation, Strategy;100,000 - 200,000;1744;617;1127;104;166;21
240220;Dead Island Riptide JP;Action, Indie, Sports;0 - 20,000;0;0;0;0;0;1
240320;Panzar;Adventure, Indie;1,000,000 - 2,000,000;3315;1736;1579;588;71;25
240340;Space Ace;Adventure, Indie;0 - 20,000;113;23;90;0;0;1
240360;Dragon's Lair 2: Time Warp;Action, Indie;0 - 20,000;72;16;56;69;69;0
240440;Quadrilateral Cowboy;Action, Indie, Strategy;200,000 - 500,000;771;69;702;403;403;1
240600;MotoGP13;Action, Adventure, Indie, RPG, Simulation, Strategy, Early Access;100,000 - 200,000;694;204;490;7;7;6
240620;Wanderlust Adventures;Action, Adventure, Casual, Indie;50,000 - 100,000;147;99;48;37;37;4
240660;Rain Blood Chronicles: Mirage;Utilities;0 - 20,000;114;49;65;0;0;1
240720;Getting Over It with Bennett Foddy;Action, Indie, Simulation, Strategy;2,000,000 - 5,000,000;47304;9804;37500;277;114;443
240760;Wasteland 2: Director's Cut;Action, Indie;500,000 - 1,000,000;6573;1409;5164;1601;983;11
240970;Half Minute Hero: The Second Coming;Action, Indie;50,000 - 100,000;495;44;451;154;172;1
241000;Jon Shafer's At the Gates;Adventure, Indie;0 - 20,000;202;269;-67;0;0;3
241240;Contraption Maker;Free to Play, Indie, Simulation, Sports;200,000 - 500,000;1075;101;974;419;374;10
241260;Sherlock Holmes: Crimes and Punishments;Adventure, Casual, Indie;200,000 - 500,000;5365;557;4808;533;261;23
241300;Card City Nights 2;Action, Adventure;0 - 20,000;145;24;121;42;42;1
241320;Ittle Dew;RPG, Strategy;100,000 - 200,000;1134;96;1038;380;395;10
241410;CastleStorm;Adventure, Casual, Indie;100,000 - 200,000;1336;160;1176;582;674;3
241540;State of Decay;Action, Indie;500,000 - 1,000,000;14907;2736;12171;2067;732;12
241560;The Crew;Action, Adventure;500,000 - 1,000,000;10514;4698;5816;3250;1993;28
241600;Rogue Legacy;Action, Adventure;1,000,000 - 2,000,000;16700;1263;15437;836;418;70
241620;Inquisitor;;200,000 - 500,000;421;202;219;198;222;4
241660;Ohm Studio;Strategy;100,000 - 200,000;168;113;55;28;42;15
241680;Actual Multiple Monitors;Adventure;0 - 20,000;2;2;0;0;0;0
241720;Guncraft;Adventure, RPG;100,000 - 200,000;576;607;-31;137;113;0
241760;Kill to Collect;Adventure, RPG;20,000 - 50,000;190;81;109;0;0;1
241790;Z3TA+ 2;Adventure, RPG;20,000 - 50,000;36;7;29;0;0;0
241910;Goodbye Deponia;Indie, Simulation, Strategy;200,000 - 500,000;1857;229;1628;337;349;8
241930;Middle-earth: Shadow of Mordor;Racing;5,000,000 - 10,000,000;72740;6077;66663;996;817;1185
242050;Assassin’s Creed IV Black Flag;RPG, Simulation, Strategy;5,000,000 - 10,000,000;49531;5754;43777;2002;1234;737
242110;Joe Danger 2: The Movie;Action, Adventure, RPG;100,000 - 200,000;230;156;74;72;79;2
242130;Vector Thrust;Adventure, Casual, Indie;200,000 - 500,000;346;358;-12;146;146;1
242320;Football Manager 2014 Russian;Indie, Simulation, Strategy;0 - 20,000;0;0;0;0;0;0
242360;Football Manager 2014 Korean;Indie, Strategy;0 - 20,000;0;0;0;8915;8915;18
242530;The Chaos Engine;Action, Adventure, Indie, Simulation, Early Access;100,000 - 200,000;253;132;121;374;611;0
242550;Rayman Legends;Casual, Indie;200,000 - 500,000;5754;576;5178;659;395;75
242570;Space Hulk;Action, Indie, Strategy;200,000 - 500,000;1408;581;827;264;261;3
242610;Grappledrome;Action;0 - 20,000;16;3;13;0;0;0
242640;Styx: Master of Shadows;Casual, Indie, Simulation, Strategy;1,000,000 - 2,000,000;7439;1529;5910;529;200;50
242680;Nuclear Throne;Action, Adventure, Indie;500,000 - 1,000,000;15748;604;15144;1219;475;156
242700;Injustice: Gods Among Us Ultimate Edition;Action, Indie;1,000,000 - 2,000,000;15299;2524;12775;378;197;108
242720;GunZ 2: The Second Duel;Adventure, Casual, Indie;2,000,000 - 5,000,000;7015;3584;3431;284;50;13
242760;The Forest;Action, Adventure, Indie;10,000,000 - 20,000,000;440660;21281;419379;1452;805;13735
242780;Cognition: An Erica Reed Thriller;Adventure, Indie, RPG, Strategy;200,000 - 500,000;629;133;496;187;261;2
242820;140;Action, Indie;200,000 - 500,000;4058;319;3739;209;153;1
242840;In Verbis Virtus;Action, Adventure, Casual, Indie, Early Access;50,000 - 100,000;1307;338;969;177;190;1
242860;Verdun;Action, Adventure, RPG;1,000,000 - 2,000,000;31134;5130;26004;505;295;167
242880;Sir, You Are Being Hunted;Action, Indie, Early Access;500,000 - 1,000,000;2966;840;2126;160;101;2
242920;Banished;Indie, Simulation;2,000,000 - 5,000,000;35508;3862;31646;1766;489;998
242940;Anachronox;Action, Indie;200,000 - 500,000;371;138;233;126;189;0
242960;Blood Omen 2: Legacy of Kain;Indie, Strategy;200,000 - 500,000;626;308;318;244;244;5
242980;Daikatana;Action, Indie;200,000 - 500,000;492;426;66;68;100;1
243000;Omikron: The Nomad Soul;Adventure, Casual, Indie;100,000 - 200,000;358;173;185;694;903;3
243020;Pandemonium;Indie, RPG, Strategy;50,000 - 100,000;182;89;93;80;137;3
243040;Startopia;Action, Indie, Simulation, Strategy;200,000 - 500,000;782;90;692;230;356;0
243060;Urban Chaos;Action, Indie, RPG;20,000 - 50,000;139;56;83;18;24;1
243120;Betrayer;Action, Adventure;200,000 - 500,000;2974;666;2308;225;166;2
243160;Mushroom 11;Casual, Indie;100,000 - 200,000;533;107;426;385;481;1
243180;The Harvest;Action, Adventure, Indie;0 - 20,000;0;0;0;26;26;0
243200;The Dark Eye: Memoria;Early Access, Indie;200,000 - 500,000;1914;216;1698;263;146;9
243220;FRACT OSC;Action, Indie, Simulation;50,000 - 100,000;491;82;409;571;571;0
243280;Poöf;Action, Indie;20,000 - 50,000;172;55;117;93;185;1
243360;TrackMania² Valley;Action;50,000 - 100,000;440;109;331;989;1028;12
243450;Urban Trial Freestyle;Nudity, Violent, Gore, Action, Adventure;100,000 - 200,000;1290;275;1015;373;162;1
243470;Watch_Dogs;Action, Indie, Massively Multiplayer, RPG, Simulation;1,000,000 - 2,000,000;25504;8886;16618;2779;858;203
243780;PixelJunk Monsters Ultimate;Indie, RPG, Simulation, Strategy;200,000 - 500,000;863;222;641;263;294;17
243800;Gas Guzzlers Extreme;Action, Adventure;200,000 - 500,000;3121;497;2624;171;119;6
243890;Mavis Beacon Teaches Typing Family Edition;Action, RPG;20,000 - 50,000;12;13;-1;0;0;0
243930;Bound By Flame;Animation & Modeling, Education, Utilities, Web Publishing;200,000 - 500,000;2344;1111;1233;612;471;11
243950;Divinity: Dragon Commander;Sexual Content, Violent, Adventure, Indie;200,000 - 500,000;1592;565;1027;433;393;7
243970;Invisible, Inc.;Casual, Indie, Simulation;500,000 - 1,000,000;4789;430;4359;304;81;53
244030;Take On Mars;Casual, Indie, Simulation, Strategy;50,000 - 100,000;1067;868;199;2086;1693;12
244050;Rise of Flight United;Action, Indie;500,000 - 1,000,000;1241;1032;209;175;46;14
244070;Sid Meier’s Ace Patrol;Action, Indie, Racing;200,000 - 500,000;495;236;259;198;242;22
244090;Sid Meier’s Ace Patrol: Pacific Skies;Action, Indie;500,000 - 1,000,000;245;149;96;213;238;13
244160;Homeworld Remastered Collection;Simulation;1,000,000 - 2,000,000;10232;1318;8914;903;300;205
244210;Assetto Corsa;Indie, RPG, Simulation, Strategy;2,000,000 - 5,000,000;80938;6807;74131;2526;329;12878
244410;Supreme Ruler 1936;Action, Indie, RPG;20,000 - 50,000;202;74;128;547;592;2
244430;realMyst: Masterpiece Edition;Action, Indie, RPG, Simulation;100,000 - 200,000;1190;150;1040;251;391;7
244450;Men of War: Assault Squad 2;Action, Adventure, Indie;2,000,000 - 5,000,000;33972;3363;30609;3472;1203;2179
244590;Epigenesis;Adventure;100,000 - 200,000;752;395;357;150;200;1
244690;Face Noir;Indie, Strategy;50,000 - 100,000;199;102;97;1541;2761;0
244710;Shelter;Action, Adventure, Casual, Indie, Simulation, Sports;200,000 - 500,000;3030;528;2502;175;203;2
244730;Divekick;Action, Adventure, Indie;100,000 - 200,000;1488;282;1206;184;214;1
244810;Foul Play;Action, Free to Play, Indie, Strategy;100,000 - 200,000;508;126;382;100;136;1
244830;Wing IDE 5;Action, Indie, Strategy;0 - 20,000;18;2;16;0;0;0
244830;Wing IDE 5;Action, Indie, Simulation, Strategy;0 - 20,000;18;2;16;0;0;0
244850;Space Engineers;Action, Indie, RPG, Early Access;2,000,000 - 5,000,000;104532;13907;90625;6343;1035;7645
244870;Electronic Super Joy;Adventure, Casual, Indie;;;;0;;;
244890;VelocityUltra;Action, Indie, RPG;50,000 - 100,000;170;55;115;135;142;5
244910;Homesick;Action, Indie;50,000 - 100,000;1022;280;742;128;146;0
244930;SNOW - The Ultimate Edition;Adventure, Casual, Indie, RPG;1,000,000 - 2,000,000;7897;4168;3729;269;28;9
244950;Where is my Heart?;Action, Indie, RPG;20,000 - 50,000;133;38;95;0;0;0
245050;SpellForce 2 - Demons of the Past;Indie, RPG, Strategy;200,000 - 500,000;143;144;-1;0;0;11
245150;The Novelist;Action, Indie;100,000 - 200,000;751;255;496;257;317;1
245170;Skullgirls 2nd Encore;Adventure, Indie, RPG, Strategy;2,000,000 - 5,000,000;25771;1621;24150;518;327;232
245280;ENSLAVED: Odyssey to the West Premium Edition;Action, Adventure;200,000 - 500,000;5536;946;4590;295;230;18
245300;Disney Epic Mickey 2:  The Power of Two;Strategy;100,000 - 200,000;526;168;358;62;62;40
245300;Disney Epic Mickey 2:  The Power of Two;RPG;100,000 - 200,000;526;168;358;62;62;40
245350;Metro Last Light JP;Indie, Simulation, Strategy;0 - 20,000;0;0;0;0;0;1
245370;Etherium;Indie, RPG, Simulation, Strategy;100,000 - 200,000;342;575;-233;157;199;0
245390;I Have No Mouth, and I Must Scream;Indie, Massively Multiplayer, RPG;200,000 - 500,000;1310;168;1142;311;387;3
245410;Wizardry 6: Bane of the Cosmic Forge;Indie, Massively Multiplayer, Strategy;100,000 - 200,000;152;49;103;33;65;4
245430;Wizardry 7: Crusaders of the Dark Savant;Indie;100,000 - 200,000;164;36;128;14;25;20
245450;Wizardry 8;Action, Casual, Indie;100,000 - 200,000;833;94;739;110;110;47
245470;Democracy 3;Action, Adventure, Indie, RPG;200,000 - 500,000;5356;1835;3521;570;450;28
245490;Trials Fusion;Indie, RPG, Strategy;200,000 - 500,000;1449;659;790;383;463;10
245620;Tropico 5;Action, Adventure;1,000,000 - 2,000,000;10560;2900;7660;1556;485;208
245730;Flashback;Action, Adventure, Casual, Strategy;20,000 - 50,000;276;197;79;0;0;0
246070;Hack 'n' Slash;Simulation;200,000 - 500,000;449;388;61;172;190;2
246090;Spacebase DF-9;;200,000 - 500,000;766;3423;-2657;579;450;2
246110;MASSIVE CHALICE;Action, Adventure, Indie, RPG;50,000 - 100,000;1282;492;790;492;512;5
246300;Paranormal;Adventure, Indie;20,000 - 50,000;297;214;83;247;442;0
246360;Perfection.;Action, Adventure, Casual, Indie;20,000 - 50,000;27;40;-13;0;0;0
246420;Kingdom Rush  - Tower Defense;Action, Indie;500,000 - 1,000,000;10613;302;10311;785;506;206
246580;The Typing of The Dead: Overkill;Action, Indie;200,000 - 500,000;2937;433;2504;125;98;9
246620;Plague Inc: Evolved;Action;2,000,000 - 5,000,000;44101;2580;41521;737;323;789
246680;Secrets of Rætikon;Adventure, Indie;100,000 - 200,000;278;187;91;90;127;0
246700;Strike Vector;Adventure;100,000 - 200,000;1520;730;790;38;37;0
246720;Wayward Manor;Action, Indie, Simulation;0 - 20,000;28;51;-23;0;0;0
246740;Huntsman: The Orphanage (Halloween Edition);Utilities, Video Production;50,000 - 100,000;75;189;-114;54;63;0
246760;Legends of Eisenwald;Indie;100,000 - 200,000;1289;396;893;201;320;24
246800;BeatBlasters III;Action, Adventure, RPG;20,000 - 50,000;33;51;-18;0;0;0
246820;Jeklynn Heights;Action, Adventure, Free to Play, Indie, Massively Multiplayer, RPG;0 - 20,000;17;5;12;0;0;0
246840;FATE;Casual, Indie, Simulation;200,000 - 500,000;2865;153;2712;147;160;118
246880;Recruits;Action, Adventure, Indie;0 - 20,000;26;66;-40;0;0;0
246900;Viscera Cleanup Detail;Indie, RPG;1,000,000 - 2,000,000;16485;1174;15311;679;303;295
246920;Bombernauts;Action, Indie, RPG, Strategy, Early Access;0 - 20,000;141;33;108;35;35;0
246920;Bombernauts;Indie, RPG;0 - 20,000;141;33;108;35;35;0
246940;Lords of the Black Sun;Action, Indie, RPG;100,000 - 200,000;78;309;-231;0;0;1
246960;Giana Sisters: Twisted Dreams - Rise of the Owlverlord;Casual, Free to Play, Indie;100,000 - 200,000;314;68;246;283;242;2
246980;InFlux;Action, Adventure, Indie;50,000 - 100,000;147;69;78;0;0;0
247000;Talisman: Digital Edition;Action, Indie;500,000 - 1,000,000;6380;1751;4629;751;411;284
247020;Cook, Serve, Delicious!;Action, Adventure, Indie;500,000 - 1,000,000;5033;284;4749;806;277;32
247080;Crypt of the NecroDancer;Adventure, Indie, RPG;2,000,000 - 5,000,000;21870;911;20959;1076;250;163
247120;Portal 2 Sixense Perceptual Pack;Action, Indie;1,000,000 - 2,000,000;288;236;52;194;2;0
247140;Soundodger+;Action, Indie, Simulation;50,000 - 100,000;719;78;641;104;116;2
247240;Volgarr the Viking;Action, Adventure, Indie;200,000 - 500,000;1897;437;1460;157;159;5
247310;Gravi;Action;20,000 - 50,000;40;60;-20;0;0;0
247350;Artemis Spaceship Bridge Simulator;Simulation;50,000 - 100,000;411;48;363;148;116;1
247370;Mutant Mudds Deluxe;Strategy;50,000 - 100,000;423;146;277;131;131;0
247430;Hitman: Contracts;Adventure, Indie;500,000 - 1,000,000;1975;291;1684;221;87;16
247660;Deadly Premonition: The Director's Cut;Indie, RPG, Strategy;200,000 - 500,000;2584;1265;1319;385;563;12
247870;Redshirt;RPG;20,000 - 50,000;162;226;-64;91;91;1
247910;Sniper Elite: Nazi Zombie Army 2;Adventure;200,000 - 500,000;3395;602;2793;348;240;7
247950;Sacred 3;Casual, Indie, Strategy;200,000 - 500,000;1119;3126;-2007;264;269;4
248170;Clickteam Fusion 2.5;Action, Adventure, Indie;100,000 - 200,000;1229;135;1094;726;1080;186
248190;Knytt Underground;Adventure, Indie, RPG;50,000 - 100,000;356;62;294;145;220;1
248270;Songs2See;RPG;0 - 20,000;38;39;-1;0;0;1
248290;Reach for the Sun;Adventure, Indie;20,000 - 50,000;228;101;127;86;109;0
248310;Freedom Planet;Action, Indie;200,000 - 500,000;4224;213;4011;463;245;10
248330;Dino Run DX;Action, Adventure, Indie, RPG, Strategy;50,000 - 100,000;1160;82;1078;121;175;7
248370;Bridge It +;Action, Indie;50,000 - 100,000;95;45;50;152;197;1
248390;Craft The World;Adventure, Indie;500,000 - 1,000,000;11968;1562;10406;1896;1008;502
248410;Legends of Aethereus;Free to Play, RPG;50,000 - 100,000;78;210;-132;421;421;0
248450;Salvation Prophecy;Action, Indie;50,000 - 100,000;150;77;73;46;46;0
248470;Doorways: Prelude;Indie;100,000 - 200,000;378;230;148;142;190;1
248490;1953 - KGB Unleashed;Action, Casual, Indie;100,000 - 200,000;354;256;98;30;41;1
248510;Dominions 3: The Awakening;Action, Strategy;20,000 - 50,000;100;22;78;0;0;2
248530;Depth Hunter 2: Deep Dive;Nudity, Violent, Gore, Action, Adventure, Indie, RPG, Simulation, Strategy, Early Access;200,000 - 500,000;712;248;464;206;179;1
248550;Megabyte Punch;Adventure, Indie, RPG, Strategy;500,000 - 1,000,000;961;115;846;142;118;1
248570;Toribash;Indie;2,000,000 - 5,000,000;13913;1762;12151;592;57;113
248610;Door Kickers;Action, Adventure, Indie, Strategy;500,000 - 1,000,000;8806;505;8301;510;263;36
248630;Kingdoms Rise;Action, Indie, Sports;50,000 - 100,000;447;616;-169;153;184;0
248650;Draw a Stickman: EPIC;Adventure, Indie, RPG, Strategy;200,000 - 500,000;881;255;626;146;113;3
248710;Iesabel;Adventure, Indie, RPG;200,000 - 500,000;226;515;-289;41;48;0
248730;A Walk in the Dark;Action;20,000 - 50,000;302;73;229;0;0;0
248800;Dysfunctional Systems: Learning to Manage Chaos;Animation & Modeling, Design & Illustration, Education, Software Training, Utilities;50,000 - 100,000;602;190;412;111;111;0
248820;Risk of Rain;Action, Adventure, Indie;1,000,000 - 2,000,000;26858;1815;25043;708;299;89
248860;NEO Scavenger;Action, Adventure, Indie;500,000 - 1,000,000;4351;470;3881;613;739;32
248970;Vector;Adventure;50,000 - 100,000;796;111;685;63;66;3
249050;Dungeon of the ENDLESS;Adventure, Indie, Simulation, Early Access;1,000,000 - 2,000,000;10260;1459;8801;431;216;137
249130;LEGO Marvel Super Heroes;Indie, Strategy;1,000,000 - 2,000,000;17854;986;16868;1248;439;345
249190;Ancient Space;Action, Free to Play, Indie, Massively Multiplayer, RPG, Simulation, Strategy, Early Access;100,000 - 200,000;152;191;-39;227;324;0
249230;Risen 3 - Titan Lords;Indie, RPG, Simulation, Strategy;500,000 - 1,000,000;4065;1409;2656;977;820;106
249330;Unholy Heights;Action, Indie;100,000 - 200,000;1331;161;1170;178;235;2
249360;Zafehouse: Diaries;Action, Indie, RPG;50,000 - 100,000;297;140;157;68;80;1
249550;NEStalgia;Simulation;20,000 - 50,000;228;132;96;664;987;4
249570;The Castle Doctrine;Action, Indie;20,000 - 50,000;186;189;-3;1;1;0
249570;The Castle Doctrine;Indie, Simulation, Early Access;20,000 - 50,000;186;189;-3;1;1;0
249590;Teslagrad;Action, Indie, Simulation;200,000 - 500,000;1956;340;1616;258;333;2
249610;Galactic Arms Race;Adventure, Casual, Indie;20,000 - 50,000;41;41;0;166;166;1
249630;Delver;Casual, Indie;200,000 - 500,000;2350;345;2005;1957;156;9
249650;Blackguards;Action, Strategy;500,000 - 1,000,000;2175;1334;841;445;293;26
249680;Marlow Briggs and the Mask of Death;Action, Adventure;100,000 - 200,000;1914;187;1727;81;107;3
249870;Scribblenauts Unmasked: A DC Comics Adventure;Indie, Simulation, Strategy;200,000 - 500,000;1739;350;1389;321;125;38
249930;A-Train 8;Action, Indie, Strategy;0 - 20,000;25;30;-5;0;0;1
249950;Forge Quest;Adventure, Indie;20,000 - 50,000;430;110;320;110;110;1
249990;FORCED: Slightly Better Edition;Action, Indie;500,000 - 1,000,000;2004;706;1298;213;201;2
250030;Lilly Looking Through;Action, Adventure, Indie;100,000 - 200,000;507;167;340;221;325;1
250050;Life Goes On: Done to Death;Action, Indie;200,000 - 500,000;2246;96;2150;92;116;5
250070;TorqueL;Adventure, Indie;0 - 20,000;28;5;23;0;0;0
250110;Assault Android Cactus+;Indie, Simulation, Strategy;200,000 - 500,000;1710;106;1604;272;354;7
250180;METAL SLUG 3;Action, Adventure, Indie;500,000 - 1,000,000;6815;794;6021;171;98;81
250260;Jazzpunk: Director's Cut;Action, Indie;200,000 - 500,000;6057;468;5589;299;174;13
250320;The Wolf Among Us;Indie, Strategy;1,000,000 - 2,000,000;28983;668;28315;646;525;97
250340;Blockland;Action, Adventure, Indie, RPG, Simulation, Strategy;200,000 - 500,000;4062;1499;2563;3120;1427;20
250360;MovieWriterPro;Action, Adventure, Indie, Massively Multiplayer, RPG;0 - 20,000;14;5;9;0;0;0
250380;Knock-knock;Simulation;100,000 - 200,000;1435;208;1227;147;160;4
250400;How to Survive;Adventure, Casual, Indie;1,000,000 - 2,000,000;13867;2908;10959;528;171;21
250420;8BitMMO;Action, Adventure, Indie;500,000 - 1,000,000;2629;1786;843;66;23;3
250460;Bridge Constructor;Action, Indie, RPG;200,000 - 500,000;1100;350;750;88;92;14
250500;Super Amazing Wagon Adventure;Action, Adventure, Indie, RPG;100,000 - 200,000;1818;89;1729;64;64;2
250520;UnderRail;Adventure, Casual, Indie;200,000 - 500,000;4472;639;3833;4441;6625;102
250560;Fight The Dragon;Indie, RPG, Strategy;100,000 - 200,000;1051;281;770;344;452;1
250580;Paranautical Activity: Deluxe Atonement Edition;Adventure;100,000 - 200,000;972;443;529;180;107;2
250600;The Plan;Casual, Indie;500,000 - 1,000,000;20476;1719;18757;9;7;1
250620;Among the Sleep - Enhanced Edition;Action, Adventure, Casual, Indie, Strategy;200,000 - 500,000;5653;785;4868;520;234;6
250640;[Old Edition] Croixleur Sigma;Action, Adventure, Indie, RPG, Early Access;20,000 - 50,000;266;68;198;125;159;0
250660;Bunny Must Die! Chelsea and the 7 Devils;Action, Adventure, Indie;20,000 - 50,000;241;113;128;30;35;0
250680;BELOW;Action, Indie, Sports, Early Access;100,000 - 200,000;798;339;459;47;52;3
250700;Super Time Force Ultra;Action, Adventure, Indie, Simulation, Early Access;100,000 - 200,000;812;97;715;201;278;1
250720;Starlight Inception;Adventure, Casual;0 - 20,000;13;45;-32;0;0;0
250760;Shovel Knight: Treasure Trove;Simulation;500,000 - 1,000,000;14180;573;13607;885;666;100
250820;SteamVR;Action, Indie, Racing, Sports;1,000,000 - 2,000,000;37011;4179;32832;0;0;0
250900;The Binding of Isaac: Rebirth;Action, Indie, Strategy;5,000,000 - 10,000,000;224666;5342;219324;9848;3436;18584
251020;Railroad X;Action, Indie, Racing;0 - 20,000;23;26;-3;0;0;0
251060;Wargame: Red Dragon;Animation & Modeling, Design & Illustration, Education, Software Training, Utilities, Video Production;1,000,000 - 2,000,000;14996;1812;13184;4531;841;1182
251110;INFRA;Adventure, Indie;100,000 - 200,000;2118;252;1866;859;1228;26
251130;Chroma Squad;Action, Indie, RPG, Strategy;100,000 - 200,000;3691;274;3417;360;498;53
251150;The Legend of Heroes: Trails in the Sky;Indie, Simulation, Strategy;200,000 - 500,000;6776;495;6281;1525;1703;156
251170;Damned;Adventure, Indie;200,000 - 500,000;2713;1131;1582;337;254;1
251210;Hive;Indie, Simulation, Strategy;100,000 - 200,000;240;37;203;261;264;1
251230;Livelock;Action, Indie;100,000 - 200,000;544;145;399;204;232;0
251270;Corpse Party;Adventure;20,000 - 50,000;1026;110;916;998;1085;4
251290;The Legend of Heroes: Trails in the Sky SC;Action, Adventure, Indie;200,000 - 500,000;2612;59;2553;1239;1558;112
251310;Eleusis;Action, Adventure;50,000 - 100,000;177;143;34;231;397;2
251370;Escape Goat;Animation & Modeling, Design & Illustration, Education, Software Training, Utilities;20,000 - 50,000;637;25;612;327;355;0
251390;Call of Cthulhu: The Wasted Land;Action, Adventure, Indie, RPG;20,000 - 50,000;130;62;68;0;0;1
251410;Dark Matter;Action, Adventure, Indie, RPG;200,000 - 500,000;105;137;-32;292;292;1
251430;The Inner World;Violent, Action, Adventure, Indie;100,000 - 200,000;974;100;874;155;164;4
251450;Heroes of Havoc: Idle Adventures;Action, Free to Play, Massively Multiplayer, RPG;50,000 - 100,000;93;134;-41;0;0;0
251470;TowerFall Ascension;Indie, Strategy;200,000 - 500,000;2894;161;2733;310;293;23
251490;Gravity Ghost;Action, Indie;20,000 - 50,000;283;9;274;12;12;0
251510;Constant C;Action, Indie;0 - 20,000;45;6;39;0;0;0
251530;Anomaly Korea;Indie, RPG, Strategy;200,000 - 500,000;555;149;406;199;224;2
251570;7 Days to Die;Action, Casual, Indie, Simulation;10,000,000 - 20,000,000;219801;28785;191016;4278;1114;27338
251590;Soul Saga;Animation & Modeling;0 - 20,000;13;37;-24;0;0;0
251630;The Impossible Game;Action, Adventure, Casual, Indie;50,000 - 100,000;1078;187;891;69;79;1
251650;Ray's The Dead;Action, Adventure, Free to Play, Simulation, Sports;0 - 20,000;36;21;15;0;0;0
251690;Speedball 2 HD;Action, Indie;50,000 - 100,000;395;204;191;154;179;0
251730;Legend of Grimrock 2;Simulation;200,000 - 500,000;3050;302;2748;787;440;77
251770;Shadow Man;Indie, Strategy;20,000 - 50,000;609;80;529;149;149;2
251810;Leadwerks Game Engine;Action, Adventure, Indie;0 - 20,000;250;95;155;0;0;0
251830;Stick it to The Man!;Strategy;50,000 - 100,000;734;39;695;195;202;1
251850;Master Reboot;Strategy;50,000 - 100,000;507;165;342;213;231;1
251870;Go! Go! Nippon! ~My First Trip to Japan~;Simulation, Strategy;200,000 - 500,000;2683;416;2267;122;118;6
251890;World of Diving;RPG, Strategy;100,000 - 200,000;372;349;23;204;204;2
251910;Solar Flux;RPG;100,000 - 200,000;227;77;150;186;204;0
251950;WWII Online;Adventure;500,000 - 1,000,000;1613;1736;-123;60;41;23
251990;Long Live The Queen;RPG;200,000 - 500,000;6458;339;6119;218;163;14
252010;Oniken: Unstoppable Edition;RPG, Strategy;50,000 - 100,000;698;156;542;144;150;15
252030;Valdis Story: Abyssal City;Strategy;200,000 - 500,000;2184;408;1776;294;417;4
252070;Gimbal;Strategy;20,000 - 50,000;171;60;111;350;350;0
252090;Lacuna Passage;Adventure, Casual, Indie, RPG, Simulation, Strategy;0 - 20,000;72;31;41;24;24;0
252110;Lovers in a Dangerous Spacetime;;200,000 - 500,000;3181;236;2945;349;294;70
252130;Divide By Sheep;Adventure, Massively Multiplayer, RPG, Strategy;2,000,000 - 5,000,000;2290;229;2061;111;34;4
252150;Grimm;Indie, Strategy;1,000,000 - 2,000,000;30905;908;29997;1091;259;127
252170;Anomaly Warzone Earth Mobile Campaign;Action, RPG, Simulation;100,000 - 200,000;373;96;277;226;235;0
252230;YAIBA: NINJA GAIDEN Z;Casual, Indie, Simulation, Sports, Strategy;50,000 - 100,000;517;285;232;75;107;0
252250;Maia;Action, Adventure;20,000 - 50,000;463;578;-115;1;1;2
252270;Zombie Tycoon 2: Brainhov's Revenge;Action, Adventure;50,000 - 100,000;220;96;124;162;230;1
252290;Elegy for a Dead World;Indie, Simulation;50,000 - 100,000;195;106;89;0;0;0
252310;Syder Arcade;Action, Adventure;100,000 - 200,000;560;106;454;135;147;1
252330;Slender: The Arrival;Strategy;200,000 - 500,000;6628;905;5723;144;115;13
252350;Double Dragon: Neon;Strategy;200,000 - 500,000;1819;532;1287;245;284;3
252370;The Shivah;Simulation, Strategy;100,000 - 200,000;609;138;471;231;232;0
252390;DwarfCorp;Strategy;0 - 20,000;99;66;33;0;0;0
252410;SteamWorld Dig;Strategy;;;;0;;;
252430;Dusty Revenge:Co-Op Edition;Action, RPG, Strategy;50,000 - 100,000;82;133;-51;0;0;1
252450;StarDrive 2;Action, Adventure, Indie;50,000 - 100,000;1141;881;260;3;3;12
252470;Space Pirates And Zombies 2;Racing, Sports;200,000 - 500,000;2140;574;1566;1086;1323;13
252490;Rust;Simulation;20,000,000 - 50,000,000;773564;116769;656795;20509;3070;122216
252530;OMSI 2: Steam Edition;Adventure, Indie;500,000 - 1,000,000;8296;1531;6765;8416;2000;1451
252550;Qbeh-1: The Atlas Cube;Adventure, Indie;50,000 - 100,000;595;79;516;138;169;0
252570;Depths of Fear :: Knossos;Adventure, Indie;20,000 - 50,000;278;142;136;295;295;1
252610;Death Road to Canada;Action, Casual, Indie;200,000 - 500,000;6654;497;6157;688;438;68
252630;Eldritch;Action, Indie;200,000 - 500,000;1836;258;1578;161;150;2
252670;Nihilumbra;Adventure;100,000 - 200,000;2522;315;2207;188;219;2
252690;Fantasy Grounds Classic;Strategy;100,000 - 200,000;974;243;731;47;47;17
252730;YOU DON'T KNOW JACK Vol. 1 XL;Gore, Indie, Simulation;0 - 20,000;140;45;95;3;5;3
252750;MouseCraft;Simulation, Strategy;20,000 - 50,000;251;29;222;59;59;2
252830;Claire;Action;50,000 - 100,000;254;131;123;81;81;1
252850;Streamline;Adventure;500,000 - 1,000,000;1443;586;857;183;209;1
252870;PULSAR: Lost Colony;Adventure;200,000 - 500,000;4448;426;4022;602;425;164
252890;Dracula: Love Kills;Adventure, Simulation;50,000 - 100,000;195;55;140;446;446;3
252910;Skyscraper Simulator;Indie, RPG, Strategy;20,000 - 50,000;89;387;-298;8;8;0
252910;Skyscraper Simulator;Indie, RPG;20,000 - 50,000;89;387;-298;8;8;0
252950;Rocket League;Racing;10,000,000 - 20,000,000;500803;63917;436886;16450;2812;39851
252970;McDROID;Action;0 - 20,000;141;50;91;0;0;0
253030;Race The Sun;RPG;500,000 - 1,000,000;5837;392;5445;225;154;7
253050;Camtasia - Subscription;Racing;50,000 - 100,000;274;104;170;0;0;0
253110;The Cat Lady;Racing, Simulation, Sports;200,000 - 500,000;4622;321;4301;537;594;8
253150;Halfway;Racing, Simulation, Sports;20,000 - 50,000;651;222;429;106;108;2
253190;Kingdom Wars 2: Battles;Action, Indie, Strategy;50,000 - 100,000;604;351;253;136;136;0
253230;A Hat in Time;Indie, RPG;500,000 - 1,000,000;45213;919;44294;1023;763;265
253250;Stonehearth;Action, Indie;500,000 - 1,000,000;8795;2730;6065;2079;1635;225
253290;FOTONICA;Action, Adventure, Indie;0 - 20,000;723;100;623;181;310;1
253310;Fester Mudd: Curse of the Gold - Episode 1;Action, Indie, Strategy;20,000 - 50,000;91;23;68;101;158;0
253330;Neverending Nightmares;Indie, Simulation, Strategy;100,000 - 200,000;1972;639;1333;266;341;0
253350;Tiny Barbarian DX;Adventure;20,000 - 50,000;191;42;149;136;145;0
253370;Axis Game Factory's AGFPRO v3;Adventure, Casual;100,000 - 200,000;240;138;102;147;265;0
253390;Hot Tin Roof: The Cat That Wore A Fedora;RPG, Strategy;100,000 - 200,000;131;74;57;81;81;0
253410;Ravensword: Shadowlands;Animation & Modeling, Design & Illustration, Utilities, Video Production;100,000 - 200,000;254;248;6;8;11;0
253430;CastleMiner Z;Action, Adventure, Indie;500,000 - 1,000,000;7761;2016;5745;498;204;63
253490;CABAL Online;Design & Illustration;200,000 - 500,000;751;359;392;1024;951;0
253510;WARMACHINE: Tactics;Action, Indie;100,000 - 200,000;495;628;-133;1626;1619;3
253570;Gentlemen!;Utilities;20,000 - 50,000;52;82;-30;167;222;0
253610;Wrack;Casual, Indie, Strategy;50,000 - 100,000;401;167;234;43;76;0
253630;Steam Marines;Adventure, Indie;100,000 - 200,000;165;159;6;121;151;2
253650;Sparkle 2 Evo;Casual, Free to Play, Indie;200,000 - 500,000;1422;551;871;178;201;1
253670;Aartform Curvy 3D 3.0;Free to Play, Indie, Massively Multiplayer, Strategy;0 - 20,000;31;13;18;0;0;0
253690;Tiny Brains;Action, Adventure, Casual, Indie;50,000 - 100,000;386;112;274;140;172;3
253710;theHunter Classic;Action, Indie, Strategy;5,000,000 - 10,000,000;21616;17179;4437;2184;40;1585
253750;Ikaruga;Action, Indie, Racing, Simulation, Sports;100,000 - 200,000;1902;109;1793;86;79;7
253770;Bus-Simulator 2012;Adventure, Indie;50,000 - 100,000;417;574;-157;66;67;2
253790;rymdkapsel;Action, Adventure, Indie, RPG;20,000 - 50,000;206;44;162;348;348;0
253840;Shantae: Half-Genie Hero;Adventure, Indie, RPG;100,000 - 200,000;2069;219;1850;249;328;6
253860;Earth 2140;Indie, Simulation, Strategy, Early Access;200,000 - 500,000;303;180;123;416;270;0
253880;Earth 2150 Trilogy;Indie, RPG;200,000 - 500,000;594;189;405;326;333;6
253900;Knights and Merchants;Casual, Indie;1,000,000 - 2,000,000;3538;664;2874;318;240;163
253920;Gorky 17;Action, Indie, RPG;500,000 - 1,000,000;1467;392;1075;287;316;5
253940;Septerra Core;Action, Indie, Strategy;200,000 - 500,000;787;269;518;318;302;6
253960;Jack Orlando: Director's Cut;Action, Indie;500,000 - 1,000,000;397;195;202;251;266;4
253980;Enclave;Adventure, Indie, RPG;2,000,000 - 5,000,000;4857;1270;3587;228;236;5
254060;KnightShift;Action, Adventure, RPG;500,000 - 1,000,000;789;395;394;276;289;13
254080;World War III: Black Gold;Indie, RPG, Strategy;200,000 - 500,000;421;309;112;262;291;5
254100;World War II: Panzer Claws;Action, RPG;100,000 - 200,000;336;183;153;779;265;3
254200;FortressCraft Evolved!;Indie, Strategy;100,000 - 200,000;2089;795;1294;878;345;42
254270;Dungeonland - All access pass;Adventure, Indie;0 - 20,000;0;0;0;0;0;0
254320;Duskers;Action, Adventure;100,000 - 200,000;2062;234;1828;554;777;17
254370;Aquanox Deep Descent;Indie, Simulation;20,000 - 50,000;289;300;-11;453;453;2
254440;Pool Nation;Simulation;200,000 - 500,000;2457;278;2179;225;235;12
254460;Obscure;Indie;100,000 - 200,000;1726;85;1641;226;265;19
254480;Obscure II (Obscure: The Aftermath);RPG;100,000 - 200,000;754;178;576;322;237;7
254590;Theme Park Studio;Adventure, Indie;0 - 20,000;201;272;-71;45;45;2
254700;resident evil 4 (2005);Action, Adventure, RPG;2,000,000 - 5,000,000;51954;4533;47421;658;265;1230
254840;Ground Control II: Operation Exodus;Action, Free to Play, Massively Multiplayer, RPG;50,000 - 100,000;188;27;161;15;15;3
254860;Lords of the Realm III;Indie, Strategy;0 - 20,000;12;14;-2;1;1;1
254880;MoonBase Commander;Action, Adventure;20,000 - 50,000;138;17;121;0;0;1
254900;Gunlok;Adventure, Indie, RPG, Strategy;0 - 20,000;9;2;7;0;0;0
254900;Gunlok;Action, Adventure;0 - 20,000;9;2;7;0;0;0
254920;Lords of the Realm;Action, Adventure;0 - 20,000;63;15;48;18;19;3
254940;Free Running;Action, Casual;0 - 20,000;63;8;55;0;0;1
254940;Free Running;Action, Casual, Indie;0 - 20,000;63;8;55;0;0;1
254960;Silent Storm Gold Edition;Action, Indie;200,000 - 500,000;815;97;718;219;219;16
255070;Abyss Odyssey;Adventure, Casual, Indie, RPG, Strategy;100,000 - 200,000;1529;917;612;222;238;2
255220;GRID Autosport;Action, Indie, RPG;500,000 - 1,000,000;6611;1891;4720;1041;364;34
255260;Pro Cycling Manager 2014;Action, Indie, Simulation, Early Access;20,000 - 50,000;178;89;89;111;111;2
255280;1954 Alcatraz;Indie;200,000 - 500,000;1087;401;686;147;207;3
255300;Journey of a Roach;Action, Indie, Sports;200,000 - 500,000;1550;196;1354;213;232;2
255320;Edna & Harvey: The Breakout;Action, Indie, Sports;200,000 - 500,000;1177;214;963;350;474;6
255340;Escape Goat 2;Action, Indie;50,000 - 100,000;382;17;365;570;570;3
255370;KickBeat Steam Edition;Adventure, Casual, Indie, RPG;100,000 - 200,000;506;255;251;115;136;2
255390;Max: The Curse of Brotherhood;Action, Adventure, Indie, Strategy, Early Access;50,000 - 100,000;1274;71;1203;0;0;4
255420;Magic 2015 - Duels of the Planeswalkers;Adventure, Indie;200,000 - 500,000;1831;2217;-386;1356;1656;12
255520;Viscera Cleanup Detail: Shadow Warrior;Action, Indie, RPG;500,000 - 1,000,000;3132;766;2366;49;27;11
255710;Cities: Skylines;Action, Adventure, Indie;5,000,000 - 10,000,000;207589;14933;192656;3598;932;23434
255870;PixelJunk Shooter;Action, Adventure, Indie, Simulation, Strategy;100,000 - 200,000;499;60;439;216;260;2
255920;The 7th Guest;Adventure, Indie, RPG;50,000 - 100,000;313;159;154;78;115;1
255940;The 11th Hour;Action, Indie;50,000 - 100,000;87;118;-31;0;0;1
255960;Bad Mojo Redux;Adventure, Indie, Simulation;20,000 - 50,000;131;21;110;0;0;0
256030;Shadows: Heretic Kingdoms;Adventure, Casual;20,000 - 50,000;255;170;85;60;60;1
256190;Enemy Front;Action, Adventure, Indie, RPG;200,000 - 500,000;3258;1728;1530;234;222;16
256290;Child of Light;Action, Casual, Indie;500,000 - 1,000,000;11626;939;10687;338;203;14
256330;WRC 4 FIA World Rally Championship;Action, Adventure, Casual, Indie;200,000 - 500,000;1179;444;735;181;181;6
256370;MXGP - The Official Motocross Videogame;Action, Indie;200,000 - 500,000;1106;285;821;1253;1701;5
256390;MotoGP14;Action, Strategy;50,000 - 100,000;271;244;27;1;1;1
256440;Monsters & Munitions;Simulation;0 - 20,000;10;15;-5;0;0;0
256460;Cosmic Star Heroine;Simulation;100,000 - 200,000;710;92;618;223;223;11
257030;Project Nimbus: Complete Edition;Casual, Indie;20,000 - 50,000;1257;215;1042;146;146;4
257050;Darkout;Casual, Indie;100,000 - 200,000;418;442;-24;268;272;1
257120;Not The Robots;Casual, Indie;100,000 - 200,000;444;111;333;176;230;1
257170;Rebuild 3: Gangs of Deadsville;Casual, Indie;200,000 - 500,000;1487;240;1247;769;938;43
257220;Secret Files: Sam Peters;Casual, Indie;50,000 - 100,000;128;51;77;0;0;0
257260;Inherit the Earth: Quest for the Orb;Casual, Indie;0 - 20,000;97;6;91;226;226;0
257350;Baldur's Gate II: Enhanced Edition;Casual, Indie;1,000,000 - 2,000,000;7106;669;6437;1407;65;655
257400;Fuse;Casual, Indie;200,000 - 500,000;1410;773;637;225;91;21
257420;Serious Sam 4;Adventure, RPG, Strategy;500,000 - 1,000,000;10616;2156;8460;685;751;121
257510;The Talos Principle;Action, Adventure, Indie;1,000,000 - 2,000,000;25134;1141;23993;669;436;115
257630;Blast Em!;Action, Adventure;50,000 - 100,000;137;160;-23;9;9;0
257650;Mosaico;Action, Adventure;0 - 20,000;29;14;15;0;0;0
257670;Elder Sign: Omens;Adventure;20,000 - 50,000;310;88;222;166;166;4
257690;J.U.L.I.A.: Among the Stars;Action, Indie;100,000 - 200,000;733;119;614;419;494;1
257710;Max Gentlemen;Adventure, Casual;100,000 - 200,000;754;117;637;17;6;0
257730;Infinity Wars: Animated Trading Card Game;Action, Indie, Strategy;500,000 - 1,000,000;2653;778;1875;506;185;23
257750;Bloody Trapland;Indie, Strategy;500,000 - 1,000,000;3172;682;2490;175;127;20
257770;Signal Ops;Casual, Free to Play, Indie;0 - 20,000;52;36;16;0;0;0
257790;Riptide GP2;Casual, Free to Play, Massively Multiplayer, Simulation;20,000 - 50,000;433;50;383;14;14;1
257830;Violett Remastered;Simulation;100,000 - 200,000;503;290;213;222;285;0
257850;Hyper Light Drifter;Action, Indie, Strategy;500,000 - 1,000,000;14965;1029;13936;480;296;50
257870;Eschalon: Book III;Adventure, Casual;50,000 - 100,000;63;20;43;0;0;2
257970;Loren The Amazon Princess;Adventure, Casual;50,000 - 100,000;468;101;367;939;939;3
257990;Oozi: Earth Adventure;Action;20,000 - 50,000;776;126;650;163;241;3
258010;Ring Runner: Flight of the Sages;Adventure;100,000 - 200,000;659;128;531;125;152;2
258050;Survivor Squad;Adventure;100,000 - 200,000;533;271;262;191;220;0
258090;99 Spirits;Action, Strategy;200,000 - 500,000;231;159;72;171;289;0
258180;Deus Ex: The Fall;Adventure, Casual;500,000 - 1,000,000;1454;2660;-1206;182;175;5
258200;Talisman: Prologue;Action, Adventure, Indie;200,000 - 500,000;204;155;49;228;237;1
258220;Blood Knights;Simulation;100,000 - 200,000;584;341;243;277;380;1
258240;Tank Operations: European Campaign;Audio Production, Utilities;20,000 - 50,000;38;85;-47;66;66;1
258520;The Vanishing of Ethan Carter;Adventure;500,000 - 1,000,000;7546;974;6572;169;150;3
258590;Adventure Time: Finn and Jake's Epic Quest;Action;50,000 - 100,000;344;123;221;22;22;0
258643;Train Simulator: NEC: New York-New Haven Route Add-On;Action, Indie, Sports;20,000 - 50,000;26;9;17;0;0;0
258760;Scania Truck Driving Simulator;Adventure, Casual, Indie, RPG, Early Access;200,000 - 500,000;1357;339;1018;129;62;3
258880;Professional Farmer 2014;Simulation, Strategy;50,000 - 100,000;281;330;-49;225;273;1
258890;Type:Rider;Action, Indie;200,000 - 500,000;1264;324;940;106;135;0
258910;Citizens of Earth;Adventure, Indie;100,000 - 200,000;291;93;198;565;842;4
258950;Montague's Mount;Action, Adventure, Indie;20,000 - 50,000;244;175;69;0;0;0
258970;Gauntlet Slayer Edition;Action;1,000,000 - 2,000,000;7142;1686;5456;420;298;64
259020;Dragon's Prophet;Simulation, Sports;200,000 - 500,000;593;268;325;2001;1250;0
259060;Dominions 4: Thrones of Ascension;Action, RPG;100,000 - 200,000;1305;127;1178;7435;14860;12
259080;Just Cause 2: Multiplayer Mod;Adventure, Indie;2,000,000 - 5,000,000;13836;1246;12590;371;191;33
259130;Wasteland 1 - The Original Classic;Action, Indie;200,000 - 500,000;326;85;241;10;13;3
259170;Alone in the Dark (2008);Adventure, Casual, Indie, RPG, Strategy;50,000 - 100,000;425;628;-203;9;9;4
259190;Alone in the Dark: The New Nightmare;Action, Indie;20,000 - 50,000;314;149;165;355;533;1
259320;Heli Heroes;Action, Indie, RPG;100,000 - 200,000;291;245;46;282;272;0
259340;Chicken Shoot Gold;Action, Casual, Indie;100,000 - 200,000;567;277;290;2530;300;3
259390;Ballpoint Universe - Infinite;Action, Adventure, Indie, RPG;50,000 - 100,000;541;154;387;329;351;1
259410;Sneaky Sneaky;Utilities;20,000 - 50,000;249;29;220;0;0;0
259430;Zigfrak;Adventure, Casual, Indie;50,000 - 100,000;174;64;110;334;334;1
259450;Drifter;Adventure, Casual, Indie;0 - 20,000;114;88;26;1;2;0
259470;Particulars;Adventure;0 - 20,000;59;30;29;4;4;1
259490;Beast Boxing Turbo;Indie, RPG, Strategy;0 - 20,000;256;30;226;7;7;0
259510;Shufflepuck Cantina Deluxe;Action, Indie;100,000 - 200,000;441;83;358;287;311;1
259530;Savant - Ascent;Action, Casual, Indie;200,000 - 500,000;2565;204;2361;161;222;67
259550;Hero of the Kingdom;Action, Casual, Indie, Simulation, Strategy;200,000 - 500,000;4003;283;3720;308;228;12
259570;EDEN STAR;Sexual Content, Action, Casual, Indie;50,000 - 100,000;619;454;165;322;527;0
259600;Finding Teddy;Action, Indie;100,000 - 200,000;765;169;596;162;197;1
259620;3079 -- Block Action RPG;Action, Adventure, Casual, Indie;50,000 - 100,000;241;241;0;126;176;0
259640;Guise Of The Wolf;Action, Indie;50,000 - 100,000;78;138;-60;0;0;1
259660;Void Destroyer;Action, Indie;50,000 - 100,000;206;134;72;45;64;0
259680;Tales of Maj'Eyal;RPG, Simulation, Strategy;500,000 - 1,000,000;5411;250;5161;5567;2786;298
259700;Dead Sky;Adventure, Indie, RPG;20,000 - 50,000;81;141;-60;57;73;0
259720;Fading Hearts;Action, Indie;20,000 - 50,000;127;67;60;3;3;0
259740;Nightmares from the Deep: The Cursed Heart;Free to Play, Indie, Simulation;100,000 - 200,000;1421;133;1288;219;253;2
259760;Two Brothers;Casual, Indie, Strategy;50,000 - 100,000;49;126;-77;1;1;0
259780;Nimble Quest;Action, Adventure, Casual, Indie, RPG;50,000 - 100,000;661;67;594;293;531;1
259810;Home Sheep Home: Farmageddon Party Edition;Animation & Modeling, Design & Illustration, Web Publishing;20,000 - 50,000;225;12;213;0;0;2
259830;Wooden Sen'SeY;Adventure, Indie;20,000 - 50,000;68;57;11;0;0;0
259870;OMG Zombies!;Action, Indie;100,000 - 200,000;308;72;236;186;186;2
259890;Agricultural Simulator: Historical Farming;Indie;50,000 - 100,000;70;207;-137;8;8;0
259910;Farming Giant;Audio Production;20,000 - 50,000;61;190;-129;159;159;0
259940;YOU DON'T KNOW JACK Vol. 2;Action, Adventure, Indie;0 - 20,000;60;12;48;3;6;1
259960;YOU DON'T KNOW JACK Vol. 3;Animation & Modeling;0 - 20,000;56;9;47;2;2;2
259980;YOU DON'T KNOW JACK Vol. 4 The Ride;Casual, Indie, Racing;0 - 20,000;102;18;84;10;18;2
259980;YOU DON'T KNOW JACK Vol. 4 The Ride;Action, Indie, Simulation, Strategy;0 - 20,000;102;18;84;10;18;2
260000;YOU DON'T KNOW JACK MOVIES;Action, Adventure, Indie;0 - 20,000;39;34;5;1;1;0
260020;YOU DON'T KNOW JACK SPORTS;Action, Indie, RPG;0 - 20,000;22;20;2;1;1;0
260040;YOU DON'T KNOW JACK TELEVISION;Adventure, Indie;0 - 20,000;32;18;14;2;4;0
260060;YOU DON'T KNOW JACK HEADRUSH;Action, Indie, RPG;0 - 20,000;34;18;16;1;1;0
260080;YOU DON'T KNOW JACK Vol. 6 The Lost Gold;Adventure, Indie;0 - 20,000;28;43;-15;0;0;0
260080;YOU DON'T KNOW JACK Vol. 6 The Lost Gold;Simulation;0 - 20,000;28;43;-15;0;0;0
260130;Agarest: Generations of War Zero;Casual, Indie, Simulation, Strategy;50,000 - 100,000;268;92;176;181;225;2
260160;The Last Tinker: City of Colors;Action, Indie;100,000 - 200,000;707;168;539;215;302;1
260190;Marc Eckō's Getting Up: Contents Under Pressure;Adventure;100,000 - 200,000;1432;171;1261;299;354;4
260210;Assassin’s Creed Liberation HD;Action, Adventure, Indie, RPG;200,000 - 500,000;1325;1175;150;704;733;5
260230;Valiant Hearts: The Great War / Soldats Inconnus : Mémoires de la Grande Guerre;Action, Indie;500,000 - 1,000,000;21639;974;20665;337;317;24
260250;Blood of the Werewolf;Action, Casual, Indie, Sports;50,000 - 100,000;360;241;119;200;286;1
260330;Flockers;Adventure, Casual, Indie, RPG, Simulation, Strategy, Early Access;50,000 - 100,000;143;43;100;0;0;0
260380;Ninja Cats vs Samurai Dogs;Action, Indie;0 - 20,000;24;14;10;0;0;0
260410;Get Off My Lawn!;Action, Indie, RPG;200,000 - 500,000;1221;436;785;121;48;3
260430;The Four Kings Casino and Slots;Indie;200,000 - 500,000;2453;1143;1310;310;38;50
260510;World Basketball Tycoon;Adventure, Indie, Simulation;20,000 - 50,000;16;89;-73;0;0;0
260530;So Many Me;Adventure, Indie, RPG;0 - 20,000;95;6;89;0;0;0
260550;Haunted;Adventure, Casual, Indie;20,000 - 50,000;74;25;49;259;270;0
260570;Gray Matter;Action, Adventure, Casual, Indie, RPG, Early Access;100,000 - 200,000;573;66;507;7607;7522;3
260650;Cold War;Adventure, Casual, Indie, Racing, Simulation;20,000 - 50,000;166;81;85;68;81;0
260690;Dark Fall: The Journal;Action;50,000 - 100,000;178;52;126;22;33;1
260730;Desperados: Wanted Dead or Alive;Indie, RPG;200,000 - 500,000;1629;245;1384;510;963;57
260750;Neighbours from Hell Compilation;Action, Adventure, Indie;200,000 - 500,000;2585;65;2520;56;70;7
260790;1001 Spikes;Action, Indie, RPG;50,000 - 100,000;568;124;444;177;177;2
260930;Emergency 2014;Adventure, Indie, RPG;50,000 - 100,000;197;115;82;1188;843;2
260990;Odesi Music Composition;Adventure, Indie, Strategy;0 - 20,000;44;21;23;0;0;1
261030;The Walking Dead: Season Two;Action, Casual, Indie, Sports;1,000,000 - 2,000,000;25915;1033;24882;695;582;67
261110;Killer is Dead - Nightmare Edition;Adventure, Casual, Indie;1,000,000 - 2,000,000;5941;1931;4010;236;164;9
261180;Lethal League;Action, Indie;500,000 - 1,000,000;5646;348;5298;458;230;8
261350;Steam Bandits: Outpost;English, German, Spanish - Spain, Polish, Russian, Turkish;0 - 20,000;35;36;-1;0;0;0
261470;Distant Worlds: Universe;Adventure, Casual, Indie;100,000 - 200,000;1320;410;910;1683;3337;18
261490;Bedlam;Free to Play, Indie, Massively Multiplayer, RPG;100,000 - 200,000;653;204;449;255;238;0
261510;Tesla Effect: A Tex Murphy Adventure;Adventure, Indie, RPG;200,000 - 500,000;1059;154;905;280;405;3
261530;Lifeless Planet Premier Edition;Animation & Modeling, Design & Illustration, Utilities;200,000 - 500,000;2563;801;1762;221;266;2
261550;Mount & Blade II: Bannerlord;Action, Indie;10,000,000 - 20,000,000;190017;26557;163460;8070;3349;19856
261570;Ori and the Blind Forest;Gore, Action, Adventure, Indie;2,000,000 - 5,000,000;47524;2308;45216;605;393;210
261600;Basketball Pro Management 2014;Action, Adventure, Indie;0 - 20,000;10;42;-32;0;0;0
261640;Borderlands: The Pre-Sequel;Action, Adventure, Casual, Indie;2,000,000 - 5,000,000;30837;7176;23661;1429;664;641
261700;Eryi's Action;Action, Casual, Indie;100,000 - 200,000;1199;165;1034;179;222;0
261720;Holy Avatar vs. Maidens of the Dead;Action, Indie, RPG, Sports;50,000 - 100,000;83;61;22;0;0;0
261760;Lichdom: Battlemage;Action, Indie, Simulation;200,000 - 500,000;1622;1236;386;209;170;6
261880;Corporate Lifestyle Simulator;Strategy;50,000 - 100,000;538;112;426;2;2;0
261900;The Real Texas;Action, Adventure, Indie, RPG;0 - 20,000;28;2;26;0;0;0
261920;Catzilla 4K - Advanced;Indie, Strategy;0 - 20,000;66;103;-37;84;119;0
261940;The Mysterious Cities of Gold;Action, Indie;50,000 - 100,000;76;28;48;0;0;0
261960;Cube & Star: An Arbitrary Love;Action, Adventure, Indie, RPG, Early Access;20,000 - 50,000;82;55;27;0;0;0
262000;Gabriel Knight: Sins of the Fathers 20th Anniversary Edition;Simulation;100,000 - 200,000;875;92;783;2156;2196;5
262060;Darkest Dungeon;Action, Adventure, Indie;2,000,000 - 5,000,000;110799;10444;100355;2408;696;4947
262080;Iron Soul;Action, Adventure, Indie;0 - 20,000;10;50;-40;55;55;0
262100;Trench Run;Action, Adventure, Indie;0 - 20,000;48;41;7;0;0;0
262120;Toy Soldiers: Complete;Utilities;100,000 - 200,000;733;225;508;561;803;5
262150;Vanguard Princess;Adventure, Casual, Indie;200,000 - 500,000;2008;850;1158;126;102;1
262190;Zombeer;Action, Adventure, Indie, Racing;50,000 - 100,000;197;64;133;0;0;0
262210;Last Knight: Rogue Rider Edition;Free to Play, Indie, Racing, Simulation, Sports;20,000 - 50,000;184;43;141;177;233;0
262240;SUGURI;Adventure, Indie, RPG, Simulation;20,000 - 50,000;156;27;129;143;174;1
262260;Jets'n'Guns Gold;Action, Indie, RPG, Strategy;100,000 - 200,000;1214;171;1043;123;139;8
262280;Dungeons 2;Action, Casual, Indie;1,000,000 - 2,000,000;3970;916;3054;502;282;51
262300;Tsukumogami;Action, Adventure, Indie;20,000 - 50,000;34;20;14;1;1;0
262370;A.N.N.E;Action, Adventure, Indie, RPG;0 - 20,000;21;12;9;0;0;0
262390;Cloudbuilt;Violent, Action, Indie, Strategy;100,000 - 200,000;761;130;631;50;74;1
262410;World of Guns: Gun Disassembly;Action, Indie;2,000,000 - 5,000,000;14861;2866;11995;165;40;140
262450;Dead Man's Draw;Action, Adventure, Indie, RPG;100,000 - 200,000;500;95;405;352;304;1
262470;Rollers of the Realm;Adventure, Casual;100,000 - 200,000;582;70;512;202;232;1
262490;Manga Maker Comipo;Action, Adventure, Casual, Indie;20,000 - 50,000;549;170;379;1;1;19
262510;CRIMSON ROOM DECADE;Indie;0 - 20,000;36;25;11;0;0;0
262550;Gunman Clive;Adventure;20,000 - 50,000;664;88;576;7;7;2
262590;Chuck's Challenge 3D 2020;Design & Illustration;20,000 - 50,000;175;25;150;37;37;0
262610;Liquid Rhythm;Action, Indie, Early Access;0 - 20,000;23;12;11;0;0;0
262630;Tom vs. The Armies of Hell;Action, Adventure, Indie;0 - 20,000;13;3;10;0;0;0
262650;RaySupreme 3D;Action, Adventure, Indie;50,000 - 100,000;19;31;-12;0;0;0
262690;Little Racers STREET;Adventure, Indie;100,000 - 200,000;863;180;683;204;265;3
262750;GoD Factory: Wingmen;Action, Indie;20,000 - 50,000;201;94;107;632;632;1
262770;Freedom Fall;Adventure, Indie, RPG;20,000 - 50,000;355;30;325;662;662;0
262790;Our Darker Purpose;Adventure, Casual;50,000 - 100,000;592;130;462;294;376;0
262810;Super Turbo Demon Busters!;Indie, RPG;0 - 20,000;91;76;15;0;0;1
262830;Crimsonland;Adventure, Indie;100,000 - 200,000;2465;208;2257;535;511;24
262850;The Journey Down: Chapter Two;Action, Indie;50,000 - 100,000;484;18;466;235;297;0
262870;Recovery Search & Rescue Simulation;Action, Indie, RPG, Strategy;0 - 20,000;11;60;-49;20;20;0
262900;Smooth Operators;;20,000 - 50,000;200;73;127;276;276;0
262920;Super Chain Crusher Horizon;Indie, Strategy;20,000 - 50,000;19;14;5;152;211;0
262940;Broken Sword 5 - the Serpent's Curse;Action, Indie;200,000 - 500,000;2042;257;1785;415;465;19
262960;Castle In The Darkness;Gore, Indie, Simulation;50,000 - 100,000;927;263;664;47;49;1
262980;C-RUSH;Casual, Strategy;20,000 - 50,000;24;81;-57;0;0;0
263020;STARWHAL;Action, RPG;50,000 - 100,000;610;77;533;133;162;1
263040;Bot Colony;Adventure, Indie;0 - 20,000;68;29;39;0;0;1
263060;Blockstorm;Action, Adventure, Indie;500,000 - 1,000,000;5160;1278;3882;251;248;4
263080;Pixel Boy and the Ever Expanding Dungeon;Action, Adventure, Indie, RPG;20,000 - 50,000;158;76;82;210;210;0
263100;9.03m;Action;20,000 - 50,000;901;183;718;15;15;0
263140;Postmortem: One Must Die (Extended Cut);Action, Indie, RPG, Strategy;20,000 - 50,000;72;111;-39;17;17;0
263180;Squirt's Adventure;Adventure, RPG;0 - 20,000;15;5;10;0;0;0
263200;Signs of Life;Action, Free to Play, Indie;50,000 - 100,000;612;160;452;2628;2628;0
263300;BlazBlue: Calamity Trigger;Adventure, Indie;200,000 - 500,000;2514;406;2108;232;171;9
263320;Saturday Morning RPG;Adventure, Indie;100,000 - 200,000;394;116;278;218;276;1
263340;Continue?9876543210;Action, Adventure, RPG;0 - 20,000;98;76;22;0;0;0
263360;3089 -- Futuristic Action RPG;Action, Indie;50,000 - 100,000;387;160;227;143;172;0
263380;Driftmoon;Action, Free to Play, Indie, Massively Multiplayer;50,000 - 100,000;226;29;197;0;0;0
263400;War of the Human Tanks;Adventure, Indie;100,000 - 200,000;457;72;385;338;406;0
263420;Probably Archery;Casual, Indie, Simulation, Strategy;20,000 - 50,000;174;211;-37;45;45;0
263460;Girls Like Robots;Action, Adventure, Indie;100,000 - 200,000;180;76;104;483;650;0
263480;Final Rush;Adventure, Casual, Indie, RPG, Strategy;50,000 - 100,000;68;81;-13;185;185;0
263500;Dragons and Titans;Casual, Indie, Strategy;1,000,000 - 2,000,000;2684;742;1942;392;31;0
263520;Enola;Casual, Indie, Simulation;50,000 - 100,000;104;49;55;0;0;0
263540;Villagers and Heroes;Adventure, Indie;500,000 - 1,000,000;1941;1282;659;85;27;41
263560;Paper Sorcerer;RPG, Strategy;50,000 - 100,000;483;130;353;230;248;1
263620;Mitsurugi Kamui Hikae;Indie, RPG;200,000 - 500,000;2598;638;1960;148;216;1
263640;CDF Ghostship;Casual, Indie;20,000 - 50,000;43;65;-22;0;0;0
263680;Unearthed: Trail of Ibn Battuta - Episode 1 - Gold Edition;Free to Play, Indie, Strategy;200,000 - 500,000;430;379;51;673;673;0
263700;Muffin Knight;Action, Adventure, Indie;20,000 - 50,000;325;95;230;0;0;0
263720;Brawlout;Adventure, RPG, Simulation;50,000 - 100,000;577;195;382;34;47;0
263740;FootLOL: Epic Soccer League;Action, Indie;100,000 - 200,000;883;169;714;96;104;1
263760;Turbo Dismount;Action, RPG, Simulation, Strategy;500,000 - 1,000,000;4806;357;4449;457;286;19
263800;Spaceforce Constellations;Action, Casual, Free to Play;0 - 20,000;2;18;-16;0;0;0
263820;EvilQuest;Action, Indie, RPG;50,000 - 100,000;568;78;490;99;99;1
263860;SPACECOM;Action, Adventure, Indie, RPG, Early Access;50,000 - 100,000;317;141;176;232;194;3
263880;Aqua Kitty - Milk Mine Defender;Indie, RPG;50,000 - 100,000;409;60;349;106;106;0
263920;Zombie Grinder;Indie, RPG;20,000 - 50,000;205;95;110;0;0;1
263940;Red Baron Pack;Action, Indie;0 - 20,000;77;18;59;0;0;4
263960;Wyv and Keep: The Temple of the Lost Idol;Casual, Sports;0 - 20,000;76;17;59;159;213;1
263980;Out There Somewhere;Simulation;500,000 - 1,000,000;6410;477;5933;137;127;6
264000;Son of Nor;Animation & Modeling, Design & Illustration, Education, Software Training, Utilities, Game Development;20,000 - 50,000;125;77;48;212;212;0
264020;Geekbench 3;Action, Indie;0 - 20,000;19;11;8;37;37;0
264080;Vangers;Action, Racing, Early Access;100,000 - 200,000;902;70;832;74;74;5
264120;Victory: The Age of Racing;Casual, Indie, Simulation, Strategy;200,000 - 500,000;653;652;1;131;23;10
264140;Pixel Piracy;Massively Multiplayer, Racing, Simulation, Sports;200,000 - 500,000;4619;2497;2122;370;207;71
264160;WazHack;Casual, Free to Play, Indie, Early Access;20,000 - 50,000;594;75;519;50;50;11
264200;One Finger Death Punch;Action, Indie, Simulation, Early Access;500,000 - 1,000,000;15711;318;15393;266;150;21
264220;Mr. Bree+;Adventure, Indie, RPG;20,000 - 50,000;194;34;160;225;237;0
264240;CONSORTIUM;Action, Indie, RPG;200,000 - 500,000;1086;427;659;214;202;2
264260;Global Outbreak: Doomsday Edition;Simulation, Strategy;0 - 20,000;52;20;32;362;445;0
264280;99 Levels To Hell;Adventure;50,000 - 100,000;366;224;142;120;124;1
264300;Guns n Zombies;Casual, Indie;100,000 - 200,000;669;292;377;403;409;3
264320;Captain Morgane and the Golden Turtle;Utilities;20,000 - 50,000;105;66;39;77;153;0
264340;Major Mayhem;Action, Indie, RPG, Strategy;20,000 - 50,000;234;47;187;94;95;1
264380;Narcissu 1st & 2nd;Casual, Indie, Strategy;200,000 - 500,000;3848;189;3659;62;28;22
264400;Jacob Jones and the Bigfoot Mystery : Episode 1;Action;0 - 20,000;34;0;34;0;0;0
264420;Comicado;Action, Adventure;0 - 20,000;30;13;17;0;0;0
264440;Children of Liberty;Action, Adventure;0 - 20,000;3;20;-17;0;0;0
264460;A-Men;Simulation;0 - 20,000;25;28;-3;0;0;0
264540;Platformines;Simulation;50,000 - 100,000;207;107;100;0;0;0
264560;Quest for Infamy;RPG;50,000 - 100,000;176;32;144;99;99;0
264580;Lost Civilization;Indie, Strategy;20,000 - 50,000;65;59;6;0;0;0
264690;Coin Crypt;Indie, RPG, Strategy;50,000 - 100,000;508;78;430;147;189;0
264690;Coin Crypt;Action;50,000 - 100,000;508;78;430;147;189;0
264710;Subnautica;Action;5,000,000 - 10,000,000;212594;7595;204999;1978;1067;4201
264730;Deadly 30;Action, Racing;100,000 - 200,000;1291;407;884;87;129;5
265000;FORCED SHOWDOWN;Action;50,000 - 100,000;539;106;433;497;932;1
265000;FORCED SHOWDOWN;Strategy;50,000 - 100,000;539;106;433;497;932;1
265020;Ashes Cricket 2013;Action;0 - 20,000;0;0;0;0;0;0
265120;Meridian: New World;Action, Adventure, Indie, Strategy;100,000 - 200,000;236;261;-25;131;142;0
265170;Acceleration of SUGURI X-Edition HD;Action, Adventure, Strategy;20,000 - 50,000;183;42;141;241;288;0
265210;Viscera Cleanup Detail: Santa's Rampage;Action, Indie;1,000,000 - 2,000,000;4827;472;4355;179;148;19
265240;Crazy Machines: Golden Gears;Action, Adventure, Indie;20,000 - 50,000;10;24;-14;0;0;0
265300;Lords Of The Fallen 2014;Casual, Indie;500,000 - 1,000,000;10988;7333;3655;717;269;62
265330;Gomo;Indie;200,000 - 500,000;1269;389;880;195;229;2
265380;Grimind;Action, Adventure, Indie, RPG;100,000 - 200,000;174;95;79;231;308;0
265470;Even the Ocean;Indie, Racing;0 - 20,000;199;31;168;0;0;1
265550;Dead Rising 3 Apocalypse Edition;Strategy;1,000,000 - 2,000,000;11988;3958;8030;714;585;119
265590;The Red Solstice;Adventure, Casual, Free to Play, Massively Multiplayer, RPG;1,000,000 - 2,000,000;1723;659;1064;218;243;8
265610;Epic Battle Fantasy 4;Strategy;200,000 - 500,000;2750;93;2657;917;905;23
265630;Fistful of Frags;Action, Adventure, Indie;2,000,000 - 5,000,000;31459;2959;28500;282;68;170
265670;Imagine Me;Adventure, Indie;20,000 - 50,000;139;295;-156;297;297;1
265690;NaissanceE;Action, Adventure, Indie, RPG, Simulation, Strategy, Early Access;100,000 - 200,000;2443;463;1980;72;98;5
265730;Frane: Dragons' Odyssey;Action, Adventure, Indie, RPG, Early Access;0 - 20,000;6;3;3;0;0;0
265750;Secret Ponchos;Indie;20,000 - 50,000;934;388;546;6910;13547;0
265770;Cannons Lasers Rockets;Action, Adventure, Indie, RPG;200,000 - 500,000;126;392;-266;13;19;0
265790;Residue: Final Cut;Adventure, Indie;20,000 - 50,000;62;39;23;382;382;0
265810;The Sandbox;Adventure, Casual, Indie;20,000 - 50,000;322;242;80;811;185;1
265830;Monochroma;Utilities;100,000 - 200,000;513;174;339;358;358;0
265870;Alpha Kimori 1;Action, Indie, Strategy;50,000 - 100,000;127;91;36;104;104;0
265890;Hexcells;Simulation;200,000 - 500,000;4970;163;4807;477;145;9
265930;Goat Simulator;Action, Indie;2,000,000 - 5,000,000;56589;6110;50479;579;152;128
265950;Ether One;Adventure, Indie, RPG;20,000 - 50,000;313;109;204;32;42;1
265970;Worlds of Magic;Adventure, Indie, RPG, Early Access;20,000 - 50,000;229;266;-37;0;0;1
266010;LYNE;Action, Indie;200,000 - 500,000;7655;329;7326;435;261;10
266030;DRAKERZ-Confrontation;Indie, RPG;50,000 - 100,000;135;123;12;0;0;0
266050;Into the Dark: Ultimate Trash Edition;Indie, RPG;50,000 - 100,000;97;127;-30;476;586;1
266110;Tower of Guns;Adventure, Indie;200,000 - 500,000;932;227;705;112;133;2
266130;Breach & Clear;Adventure, Casual, Indie, RPG;200,000 - 500,000;1947;416;1531;208;211;3
266150;Lost Saga NA;Action, Casual, Indie, Simulation;200,000 - 500,000;417;274;143;2284;3403;0
266170;Windforge;Casual, Indie, Simulation, Sports, Strategy;50,000 - 100,000;397;193;204;2424;2424;2
266190;Astral Terra;RPG, Early Access;0 - 20,000;79;74;5;0;0;0
266210;One Way Heroics;Action, Adventure, Indie, Massively Multiplayer, RPG;500,000 - 1,000,000;3686;225;3461;319;219;24
266250;Procyon;Action, Indie;20,000 - 50,000;105;13;92;184;184;0
266270;Gridiron Solitaire;Indie;0 - 20,000;61;17;44;0;0;0
266310;GameGuru Classic;Action, Indie;200,000 - 500,000;1479;551;928;1353;29;11
266330;Ethan: Meteor Hunter;Utilities, Video Production;100,000 - 200,000;142;89;53;184;192;1
266390;Farm for your Life;Action, Adventure, Indie, RPG, Simulation, Strategy;100,000 - 200,000;493;111;382;342;342;1
266410;iRacing;Adventure, Indie;200,000 - 500,000;2407;379;2028;290;326;206
266430;Anarchy Arcade;Adventure, Indie, Early Access;500,000 - 1,000,000;1527;698;829;31;16;3
266490;Lili: Child of Geos - Complete Edition;Action, Indie, RPG;100,000 - 200,000;828;132;696;706;706;0
266510;Hand of Fate;Racing;500,000 - 1,000,000;9211;1043;8168;311;179;16
266840;Age of Mythology: Extended Edition;Audio Production, Utilities;2,000,000 - 5,000,000;26574;2193;24381;1290;273;2292
266980;The Labyrinth of Time;Action, Adventure, Casual, Indie, RPG, Strategy;0 - 20,000;9;8;1;0;0;0
267060;Gravity Badgers;Action, Indie, Massively Multiplayer, Early Access;100,000 - 200,000;266;167;99;143;184;0
267130;Star Swarm Stress Test;Audio Production, Utilities, Video Production;200,000 - 500,000;284;30;254;0;0;2
267220;Line Of Defense Tactics - Tactical Advantage;Education, Software Training;0 - 20,000;1;18;-17;0;0;0
267340;Beware Planet Earth;Indie, RPG, Strategy, Early Access;50,000 - 100,000;206;89;117;416;623;0
267360;MURI;Action, Adventure, Early Access, Indie, Strategy;20,000 - 50,000;428;43;385;73;73;0
267490;Batman: Arkham Origins Blackgate - Deluxe Edition;Action, Indie;200,000 - 500,000;907;1280;-373;266;239;19
267530;The LEGO Movie - Videogame;Action, Adventure, Indie, RPG;200,000 - 500,000;3482;550;2932;649;393;53
267600;Airport Simulator 2014;Action, Adventure, Indie;100,000 - 200,000;175;842;-667;10;16;1
267610;Woodcutter Simulator 2013;Adventure, Indie, RPG;50,000 - 100,000;140;394;-254;5;5;0
267670;Realms of Arkania 1 - Blade of Destiny Classic;Action, Casual, Indie, Strategy;20,000 - 50,000;80;35;45;53;100;3
267730;Ground Pounders;Simulation, Sports;20,000 - 50,000;18;30;-12;299;299;0
267750;Shadowrun Chronicles - Boston Lockdown;Action, Adventure, Indie, RPG, Early Access;200,000 - 500,000;788;543;245;59;76;1
267900;Guilty Gear Isuka;Adventure, Indie;50,000 - 100,000;224;202;22;227;399;1
267920;Gun Metal;Action, Adventure, Indie;200,000 - 500,000;764;190;574;210;222;2
267940;Glacier 3: The Meltdown;Adventure, Indie;50,000 - 100,000;121;330;-209;2;2;0
267960;Hyper Fighters;Simulation;50,000 - 100,000;98;322;-224;3;4;0
267980;Hostile Waters: Antaeus Rising;Adventure, Indie;100,000 - 200,000;314;97;217;250;240;1
268050;The Evil Within;Action, Casual, Indie;1,000,000 - 2,000,000;21053;3704;17349;709;410;260
268130;Heat Signature;Action, Casual, Indie, Simulation, Sports;500,000 - 1,000,000;6161;342;5819;1012;775;39
268200;Antisquad;Adventure, Indie, RPG;50,000 - 100,000;154;134;20;0;0;0
268220;Meltdown;Action, Adventure, Indie, RPG;100,000 - 200,000;682;120;562;262;279;0
268240;Mechanic Escape;Action, Indie;50,000 - 100,000;667;110;557;167;217;2
268240;Mechanic Escape;Action, Adventure, Indie, RPG;50,000 - 100,000;667;110;557;167;217;2
268260;Let's Sing;Adventure, Casual, Indie;50,000 - 100,000;74;76;-2;0;0;0
268320;Grapple;Action, Indie;50,000 - 100,000;301;30;271;157;203;0
268340;High Strangeness;Free to Play, Indie, RPG, Simulation;0 - 20,000;22;6;16;43;43;0
268360;Krautscape;Adventure, Casual, Indie;20,000 - 50,000;158;79;79;60;62;0
268400;Panzer Corps Gold;Indie;200,000 - 500,000;2088;186;1902;2484;735;287
268420;Aura Kingdom;Adventure, Casual, Indie;2,000,000 - 5,000,000;6819;1873;4946;1494;138;2
268500;XCOM 2;Action, Indie, RPG;5,000,000 - 10,000,000;71936;13673;58263;3934;1223;5944
268520;Orc Attack: Flatulent Rebellion;Adventure, Indie;20,000 - 50,000;34;33;1;3;6;0
268540;The Whispered World Special Edition;Action, Adventure, Indie;200,000 - 500,000;1284;413;871;177;187;8
268650;From the Depths;Violent, Gore, Action, Indie;200,000 - 500,000;8679;972;7707;4307;1545;488
268670;The Memory of Eldurim;Action, Adventure, Indie, RPG;20,000 - 50,000;100;144;-44;26;26;0
268710;Zero Point;Action, Indie, Sports;0 - 20,000;30;31;-1;0;0;0
268750;Magicite;Adventure, Indie, RPG;500,000 - 1,000,000;6392;1106;5286;724;385;19
268770;Treasure Adventure World;Action, Indie;0 - 20,000;219;45;174;0;0;0
268810;Paranormal State: Poison Spring;Action, Casual, Indie, Strategy;50,000 - 100,000;265;81;184;157;169;1
268850;EVGA Precision X1;Adventure, Indie;500,000 - 1,000,000;3434;899;2535;1898;47;1271
268870;Satellite Reign;Action, Adventure, Indie;500,000 - 1,000,000;3535;1421;2114;400;199;23
268890;Masters of the World - Geopolitical Simulator 3;Action, Adventure, Indie, RPG;0 - 20,000;261;321;-60;1730;2332;6
268890;Masters of the World - Geopolitical Simulator 3;Action, Casual, Indie;0 - 20,000;261;321;-60;1730;2332;6
268910;Cuphead;RPG;2,000,000 - 5,000,000;126549;4511;122038;1125;433;2125
268930;Malevolence: The Sword of Ahkranox;RPG;0 - 20,000;62;27;35;0;0;0
268970;You Are Not The Hero;Strategy;0 - 20,000;8;29;-21;0;0;0
268990;The Dishwasher: Vampire Smile;Adventure, Indie, RPG, Strategy;50,000 - 100,000;997;62;935;106;106;6
269010;Science Girls;Action, Casual, Indie, Racing;50,000 - 100,000;103;50;53;0;0;0
269030;The Yawhg;Simulation;50,000 - 100,000;1117;242;875;300;307;2
269050;Year Walk;Simulation;100,000 - 200,000;1747;169;1578;137;200;1
269110;Super Motherload;Indie, Simulation;100,000 - 200,000;575;176;399;256;317;2
269150;Luxuria Superbia;Action, Indie, Strategy;20,000 - 50,000;175;74;101;3;3;0
269170;Sports Bar VR;Casual, Simulation;100,000 - 200,000;698;131;567;76;91;0
269190;Edge Of Eternity;Indie, Simulation, Strategy;200,000 - 500,000;2381;722;1659;466;518;120
269210;Hero Siege;Simulation, Strategy;2,000,000 - 5,000,000;26336;8658;17678;1115;311;1075
269230;Aces Wild: Manic Brawling Action!;Simulation, Strategy;50,000 - 100,000;265;77;188;87;142;0
269250;WORLD END ECONOMiCA episode.01;Action;50,000 - 100,000;572;101;471;243;355;1
269270;LOVE;Casual, Indie, Strategy;50,000 - 100,000;1023;100;923;231;239;0
269290;liteCam Game: 100 FPS Game Capture;Action, Indie;0 - 20,000;265;261;4;0;0;1
269310;Infectonator: Survivors;Action, Adventure;50,000 - 100,000;673;320;353;281;438;7
269330;Chronology;Action, Indie;100,000 - 200,000;706;98;608;190;237;1
269350;Montas;Action, Indie;0 - 20,000;64;100;-36;7;7;0
269370;Reaper - Tale of a Pale Swordsman;Action, Adventure, Indie, Strategy;50,000 - 100,000;291;137;154;33;57;3
269430;Burning Cars;RPG;100,000 - 200,000;4;34;-30;289;291;0
269470;MorphVOX Pro 4 - Voice Changer (Old);Adventure, Casual, Indie;0 - 20,000;331;260;71;2416;2926;82
269490;Bardbarian;Indie;100,000 - 200,000;1294;164;1130;301;409;3
269530;Voice of Pripyat;Casual, Indie, Strategy;0 - 20,000;32;50;-18;0;0;0
269550;Zoom Player 13 : Steam Edition;Simulation;0 - 20,000;60;26;34;0;0;1
269570;Gamer To Game Developer Series 1: More Than a Gamer;Nudity, Indie, RPG;0 - 20,000;71;19;52;7;10;0
269590;Claustrophobia: The Downward Struggle;Adventure, Casual, Indie, RPG, Strategy;20,000 - 50,000;89;113;-24;10;10;1
269610;Arcane Worlds;Adventure, Casual, Indie, RPG;20,000 - 50,000;110;115;-5;0;0;0
269630;A Mass of Dead;Casual, Indie;0 - 20,000;22;24;-2;541;541;0
269650;Dex;Adventure, Indie;200,000 - 500,000;2717;401;2316;199;207;6
269670;BADLAND: Game of the Year Edition;Action, Indie, Early Access;200,000 - 500,000;2392;381;2011;405;175;8
269690;RymdResa;Adventure, Indie, RPG, Strategy;50,000 - 100,000;223;76;147;622;622;0
269710;Tumblestone;Utilities;100,000 - 200,000;1388;430;958;430;485;7
269730;The Golf Club;Action, Indie;100,000 - 200,000;700;394;306;866;866;15
269770;Secrets of Grindea;Action, Adventure, Indie, RPG;200,000 - 500,000;5347;554;4793;1586;2096;33
269790;DreadOut;Action, Adventure;200,000 - 500,000;3636;1131;2505;258;232;6
269810;Spate;Adventure, Indie;50,000 - 100,000;260;106;154;0;0;0
269850;Get Packed: Fully Loaded;Action, Indie;0 - 20,000;34;2;32;0;0;0
269890;AR-K;Indie, Sports;100,000 - 200,000;269;206;63;249;128;1
269950;X-Plane 11;Action, Indie, Racing, Early Access;1,000,000 - 2,000,000;14237;1145;13092;10415;1662;1142
269990;Infinite Space III: Sea of Stars;Casual, Indie;20,000 - 50,000;82;34;48;0;0;0
270010;Time Rifters;Simulation, Sports, Strategy;50,000 - 100,000;362;44;318;203;203;1
270030;Snow Horse;Indie, Simulation, Strategy;0 - 20,000;20;7;13;0;0;0
270050;Quest of Dungeons;Action, Casual, Free to Play, Massively Multiplayer;100,000 - 200,000;521;164;357;122;181;1
270070;The Girl and the Robot;Action, Indie;0 - 20,000;46;20;26;0;0;0
270090;//N.P.P.D. RUSH//- The milk of Ultraviolet;Action, Free to Play;100,000 - 200,000;255;520;-265;295;268;0
270110;Block Story;Action, Indie;50,000 - 100,000;1000;251;749;616;637;23
270130;The Gallery - Episode 1: Call of the Starseed;;50,000 - 100,000;1263;247;1016;117;148;0
270150;RUNNING WITH RIFLES;Action;1,000,000 - 2,000,000;12329;1642;10687;558;346;315
270170;Depression Quest;Action;200,000 - 500,000;2301;1602;699;92;153;4
270190;1HEART;Action;20,000 - 50,000;105;70;35;0;0;0
270210;Melody's Escape;Action;100,000 - 200,000;4492;333;4159;186;154;2
270230;Prominence;Action;0 - 20,000;122;19;103;516;516;0
270270;Frozen State;Casual, Simulation;20,000 - 50,000;346;195;151;130;224;0
270310;Dominique Pamplemousse;Simulation;50,000 - 100,000;336;106;230;55;55;0
270410;I Want To Be Human;Racing, Simulation, Sports;20,000 - 50,000;34;42;-8;0;0;1
270430;Cypress Inheritance: The Beginning;Simulation;0 - 20,000;4;18;-14;0;0;0
270450;Robot Roller-Derby Disco Dodgeball;Simulation, Strategy;200,000 - 500,000;3562;291;3271;241;104;5
270490;The Forest of Doom (Standalone);Simulation;20,000 - 50,000;222;54;168;0;0;1
270510;EPOCH;Simulation;20,000 - 50,000;85;22;63;0;0;6
270570;Reversion - The Escape (1st Chapter);Simulation;200,000 - 500,000;1187;345;842;184;94;3
270590;Long Night;Action, Simulation;0 - 20,000;39;44;-5;0;0;0
270630;Haunt the House: Terrortown;Racing, Simulation, Sports;100,000 - 200,000;1396;219;1177;117;163;3
270750;Realms of Arkania 2 - Star Trail Classic;Simulation;20,000 - 50,000;45;12;33;99;99;2
270760;Realms of Arkania 3 - Shadows over Riva Classic;Simulation;20,000 - 50,000;55;15;40;21;40;0
270770;Etherlords;Casual, Simulation;100,000 - 200,000;89;118;-29;7;8;0
270790;Etherlords II;Simulation;200,000 - 500,000;340;69;271;399;796;4
270810;Jones On Fire;Action, Indie, Simulation, Strategy;50,000 - 100,000;131;87;44;30;30;2
270830;Global ATC Simulator;Action, Simulation;0 - 20,000;71;42;29;0;0;1
270850;Car Mechanic Simulator 2014;Action;500,000 - 1,000,000;4095;847;3248;163;92;9
270880;American Truck Simulator;Action, Indie;2,000,000 - 5,000,000;118273;4128;114145;9173;1228;7995
270910;Worms World Party Remastered;Action, Adventure, Casual, Indie;100,000 - 200,000;729;684;45;110;162;14
270950;Ski Region Simulator - Gold Edition;Action, Indie;20,000 - 50,000;368;100;268;46;46;2
271240;Offworld Trading Company;Indie, Sports;200,000 - 500,000;4067;1232;2835;408;283;41
271260;Star Control: Origins;Action, Adventure, Indie;100,000 - 200,000;1748;649;1099;645;955;37
271360;Industry Giant 2;Adventure, Indie;100,000 - 200,000;685;108;577;763;998;62
271370;Transport Giant;Indie, RPG;50,000 - 100,000;229;166;63;101;101;23
271500;Sniper Art of Victory;Adventure, Indie;200,000 - 500,000;521;1215;-694;170;157;4
271550;Tribloos 2;Action, Indie, RPG;100,000 - 200,000;238;46;192;316;417;0
271570;Space Farmers;Action, Indie;200,000 - 500,000;1353;462;891;160;141;1
271590;Grand Theft Auto V;Action, Adventure, Indie, RPG;50,000,000 - 100,000,000;1296280;218046;1078234;13183;6102;129482
271640;Humanity Asset;Action, Adventure, Indie;100,000 - 200,000;150;341;-191;260;259;1
271670;10 Second Ninja;Action, Free to Play, Indie, RPG, Early Access;50,000 - 100,000;631;109;522;190;201;0
271730;Light;Indie, Strategy;50,000 - 100,000;197;144;53;60;88;0
271760;Dungeon Lords Steam Edition;Indie, Racing, Sports;100,000 - 200,000;444;128;316;173;230;15
271820;Card City Nights;Action, Indie;100,000 - 200,000;843;108;735;196;235;1
271860;Super Killer Hornet: Resurrection;Animation & Modeling, Video Production;200,000 - 500,000;498;297;201;261;249;0
271900;Hexcells Plus;Action, Indie;100,000 - 200,000;2188;123;2065;870;550;20
271920;Worlds Adrift Island Creator;Indie, RPG, Simulation, Strategy, Early Access;200,000 - 500,000;421;87;334;122;36;0
271970;Hero and Daughter+;Indie, Simulation, Strategy;20,000 - 50,000;193;22;171;0;0;4
271990;Dreamscape;;0 - 20,000;50;10;40;0;0;0
272010;Aveyond 3-1: Lord of Twilight;Animation & Modeling, Design & Illustration;50,000 - 100,000;97;49;48;181;181;0
272040;KAMI;Action, Adventure;100,000 - 200,000;1120;49;1071;145;153;3
272060;Serena;Casual, Indie, Simulation;10,000,000 - 20,000,000;4871;1431;3440;291;3;1
272230;Sub Rosa;Adventure, Casual, Indie;200,000 - 500,000;2354;768;1586;496;390;47
272270;Torment: Tides of Numenera;Adventure, Casual, RPG;200,000 - 500,000;2787;1203;1584;307;444;21
272300;CardFile3D;Action, Adventure, Indie;0 - 20,000;9;12;-3;0;0;0
272330;Shadow Blade: Reload;Strategy;20,000 - 50,000;295;41;254;77;95;0
272470;The Incredible Adventures of Van Helsing II;Simulation;500,000 - 1,000,000;1614;737;877;596;136;6
272510;NARUTO SHIPPUDEN: Ultimate Ninja STORM Revolution;Casual;500,000 - 1,000,000;6603;1247;5356;422;329;86
272600;Detective Grimoire;Indie, Strategy;50,000 - 100,000;1630;82;1548;166;202;2
272620;Serious Sam's Bogus Detour;Action, Adventure, Indie;50,000 - 100,000;352;78;274;221;245;0
272890;Vertiginous Golf;Action, Indie, Strategy;;;;0;;;
272920;Rail Adventures;Action, Casual, Indie;0 - 20,000;0;2;-2;0;0;0
272990;GAUGE;Strategy;50,000 - 100,000;155;87;68;11;11;0
273030;Pro Rugby Manager 2015;Action, Strategy;20,000 - 50,000;33;128;-95;0;0;3
273070;The Last Federation;Action, RPG;50,000 - 100,000;367;118;249;365;498;2
273110;Counter-Strike Nexon: Studio;Action;5,000,000 - 10,000,000;26943;13752;13191;1575;57;493
273350;Evolve Stage 2;Indie, Strategy;5,000,000 - 10,000,000;33801;14675;19126;461;128;59
273500;Over 9000 Zombies!;Casual, Strategy;100,000 - 200,000;1254;191;1063;147;163;23
273570;Descent;Casual, Strategy;100,000 - 200,000;387;12;375;138;268;2
273580;Descent 2;Action, Adventure;20,000 - 50,000;113;9;104;175;175;2
273590;Descent 3;Casual, Simulation;50,000 - 100,000;56;28;28;0;0;0
273600;Descent: FreeSpace – The Great War;Casual, Simulation;20,000 - 50,000;161;44;117;44;71;2
273620;Freespace 2;Casual, Simulation, Sports;20,000 - 50,000;220;63;157;714;714;3
273730;Driving School Simulator;Casual, Simulation, Sports;0 - 20,000;51;148;-97;0;0;1
273730;Driving School Simulator;Casual, Simulation, Sports;0 - 20,000;51;148;-97;0;0;1
273740;Extreme Roads USA;Casual, Simulation;0 - 20,000;7;60;-53;0;0;0
273750;Formula Truck 2013;Casual;0 - 20,000;156;37;119;0;0;3
273750;Formula Truck 2013;Casual;0 - 20,000;156;37;119;0;0;3
273760;Towtruck Simulator 2015;Casual;20,000 - 50,000;52;252;-200;12;12;0
273770;Game Tycoon 1.5;Action, Indie;100,000 - 200,000;99;560;-461;234;244;0
273790;Agricultural Simulator 2012: Deluxe Edition;Strategy;20,000 - 50,000;12;26;-14;0;0;0
273790;Agricultural Simulator 2012: Deluxe Edition;RPG, Strategy;20,000 - 50,000;12;26;-14;0;0;0
273800;Forestry 2017 - The Simulation;Indie, Simulation, Strategy, Early Access;20,000 - 50,000;50;72;-22;0;0;2
273820;Mining & Tunneling Simulator;Action, Adventure, RPG;50,000 - 100,000;28;104;-76;1;1;0
273830;Aviator - Bush Pilot;Adventure, Casual;0 - 20,000;13;59;-46;0;0;0
273840;Stock Car Extreme;Adventure, Casual;20,000 - 50,000;487;70;417;22864;22864;3
273850;Ski-World Simulator;Action, Indie, Sports;0 - 20,000;10;46;-36;0;0;0
273860;Snowcat Simulator;Action;20,000 - 50,000;12;31;-19;1;1;0
273890;Arctic Trucker Simulator;Strategy;0 - 20,000;8;35;-27;0;0;0
273940;Warehouse and Logistics Simulator;Indie, Strategy;20,000 - 50,000;101;173;-72;5;7;0
273960;Mechs & Mercs: Black Talons;Adventure, Indie, RPG;20,000 - 50,000;61;80;-19;158;158;0
274010;Ship Simulator: Maritime Search and Rescue;Action, Indie, Strategy;50,000 - 100,000;94;64;30;142;142;0
274130;Rambo The Video Game + Baker Team DLC;Casual, Indie, Simulation;0 - 20,000;328;233;95;0;0;0
274170;Hotline Miami 2: Wrong Number;Action, Adventure, Casual, Indie;2,000,000 - 5,000,000;43844;2964;40880;618;420;301
274190;Broforce;Action, Adventure, Indie;2,000,000 - 5,000,000;49714;1506;48208;754;327;613
274230;RONIN;Casual;100,000 - 200,000;1552;664;888;312;299;0
274250;OlliOlli;Casual;100,000 - 200,000;664;181;483;51;27;1
274270;NOT A HERO;Action, Adventure;100,000 - 200,000;1710;258;1452;263;391;3
274290;Gods Will Be Watching;Simulation, Strategy;500,000 - 1,000,000;1937;794;1143;150;176;7
274310;Always Sometimes Monsters;Action, Adventure, Indie, RPG;200,000 - 500,000;1791;600;1191;218;235;6
274350;Dropsy;Casual, Indie;50,000 - 100,000;1642;110;1532;317;532;2
274480;Drox Operative;Indie;20,000 - 50,000;275;31;244;0;0;1
274500;Brigador: Up-Armored Edition;Indie, Sports;200,000 - 500,000;4495;250;4245;145;90;20
274520;Darkwood;Action, Adventure, Indie, RPG;1,000,000 - 2,000,000;14131;794;13337;585;117;92
274560;Revolution Ace;Action, Adventure, Indie;200,000 - 500,000;1381;534;847;224;192;0
274620;Skara - The Blade Remains;Adventure, Indie, RPG, Simulation;200,000 - 500,000;367;264;103;175;243;1
274700;868-HACK;Adventure, Indie, RPG, Early Access;0 - 20,000;86;9;77;0;0;1
274880;Jet Car Stunts;Action;50,000 - 100,000;118;42;76;0;0;0
274900;Murder Miners;Action;500,000 - 1,000,000;5309;854;4455;200;174;11
274920;FaceRig;Audio Production;500,000 - 1,000,000;6868;1603;5265;0;0;619
274940;Depth;Adventure, Casual, Indie;1,000,000 - 2,000,000;28405;3922;24483;489;313;70
274960;Tech Executive Tycoon;Action, Adventure, Indie;0 - 20,000;10;42;-32;0;0;0
274980;Influent;Indie, Simulation;200,000 - 500,000;1121;391;730;188;238;8
275000;Platformines Demo;Casual, RPG;0 - 20,000;0;0;0;0;0;0
275030;Punch! ViaCAD 2D/3D v9 + 3D Printing PowerPack LT;Adventure, Casual, Indie, RPG;0 - 20,000;25;12;13;0;0;1
275080;Post Master;Action;100,000 - 200,000;122;163;-41;315;325;1
275100;Shelter 2;Adventure, Indie, RPG;200,000 - 500,000;3381;602;2779;158;108;10
275180;Costume Quest 2;Simulation;100,000 - 200,000;741;93;648;499;499;2
275200;Westerado: Double Barreled;Adventure, Casual, Indie;200,000 - 500,000;1625;148;1477;160;133;2
275290;Graviteam Tactics: Operation Star;Casual, Indie, RPG;50,000 - 100,000;370;76;294;6382;6382;2
275330;Anmynor Puzzles;Action, Adventure, Indie, RPG;0 - 20,000;2;4;-2;0;0;0
275350;Sentinel 3: Homeworld;Action, Adventure, Indie;20,000 - 50,000;104;24;80;0;0;2
275390;Guacamelee! Super Turbo Championship Edition;Action, Adventure, Indie, Strategy;5,000,000 - 10,000,000;5654;467;5187;237;127;32
275470;Chip;Action;200,000 - 500,000;947;193;754;215;277;1
275490;Canyon Capers;Action, Indie;200,000 - 500,000;860;1054;-194;233;256;1
275510;Z Steel Soldiers;Indie, Strategy;50,000 - 100,000;122;109;13;163;180;2
275530;Z;Action, Indie;200,000 - 500,000;871;280;591;350;366;16
275570;Summoner;Action, Adventure;100,000 - 200,000;371;72;299;60;72;1
275610;Warhammer 40,000: Kill Team;Action, Adventure, Indie, RPG;100,000 - 200,000;592;465;127;564;746;1
275610;Warhammer 40,000: Kill Team;Indie, Simulation, Strategy;100,000 - 200,000;592;465;127;564;746;1
275670;Space Run;Action, Adventure;200,000 - 500,000;1711;272;1439;213;290;5
275810;7 Wonders of the Ancient World;Adventure, Indie;50,000 - 100,000;118;50;68;0;0;7
275830;7 Wonders: Magical Mystery Tour;Audio Production;20,000 - 50,000;93;10;83;0;0;3
275850;No Man's Sky;Casual, Simulation, Strategy;5,000,000 - 10,000,000;200033;58239;141794;3182;1115;5252
276220;My Best Friends - Cats & Dogs;Adventure, Indie, RPG;0 - 20,000;36;18;18;0;0;0
276240;My Vet Practice - In the Country;Sports;0 - 20,000;16;8;8;0;0;1
276300;My Riding Stables: Your Horse world;Casual, Strategy;0 - 20,000;32;19;13;0;0;0
276340;My Riding Stables: Life with Horses;Adventure;20,000 - 50,000;180;31;149;1416;1416;4
276380;My Pet Hotel;Action, Casual, Indie, Racing, Simulation;0 - 20,000;3;12;-9;0;0;0
276430;My Pet Hotel 2;Casual, Indie;0 - 20,000;9;7;2;0;0;0
276440;Kingdom Tales;Adventure;0 - 20,000;26;25;1;0;0;1
276460;Tales From The Dragon Mountain 2: The Lair;Action, Adventure, Casual, Indie;20,000 - 50,000;7;10;-3;0;0;0
276730;Tango Fiesta;Indie, Strategy;20,000 - 50,000;41;31;10;221;221;0
276750;Fritz Chess 14;RPG;0 - 20,000;75;30;45;0;0;2
276810;Mordheim: City of the Damned;Photo Editing, Utilities, Video Production;500,000 - 1,000,000;5102;2182;2920;629;232;154
276870;Dwelvers;Adventure, Casual;0 - 20,000;144;114;30;421;421;0
276890;FATE: Undiscovered Realms;Adventure, Indie;20,000 - 50,000;273;74;199;119;182;11
277110;Return to Mysterious Island;Action, Indie;50,000 - 100,000;288;62;226;106;106;7
277390;VIDEOBALL;Adventure;0 - 20,000;159;24;135;0;0;0
277430;Halo: Spartan Assault;Casual, Indie, RPG, Simulation;200,000 - 500,000;3408;895;2513;120;57;5
277450;Imperial Glory;Action, Indie, Early Access;100,000 - 200,000;867;260;607;103;103;19
277460;Praetorians;Action, Indie, RPG;100,000 - 200,000;477;116;361;100;100;17
277470;The Book of Legends;Adventure, Casual, Indie, RPG;50,000 - 100,000;182;88;94;186;186;1
277490;Battle Group 2;Action, Adventure, Indie;100,000 - 200,000;407;82;325;157;159;3
277500;Farming World;Action, Adventure;20,000 - 50,000;118;185;-67;198;226;0
277510;Shiny The Firefly;Action, Indie;20,000 - 50,000;66;43;23;242;242;0
277510;Shiny The Firefly;Indie, Simulation, Strategy;20,000 - 50,000;66;43;23;242;242;0
277520;Albedo: Eyes from Outer Space;Casual, Indie, RPG;50,000 - 100,000;140;124;16;403;436;0
277540;Tales From The Dragon Mountain: The Strix;Adventure, Indie, RPG, Simulation, Strategy;50,000 - 100,000;27;42;-15;0;0;0
277560;Where Angels Cry;Action, Strategy;100,000 - 200,000;59;52;7;0;0;0
277590;Assassin's Creed Freedom Cry;Action, Indie;200,000 - 500,000;1530;469;1061;211;309;11
277630;Panzer Tactics HD;Action, Indie, Racing;20,000 - 50,000;142;51;91;151;151;11
277650;Kult: Heretic Kingdoms;Action, Adventure, Indie, RPG;20,000 - 50,000;107;34;73;8;14;1
277680;About Love, Hate and the other ones;Casual, Indie, Simulation, Strategy;100,000 - 200,000;701;79;622;292;403;0
277700;On Rusty Trails;Action, Indie;20,000 - 50,000;211;24;187;157;182;0
277751;The Count of Monster Disco;Action, Indie, RPG;0 - 20,000;12;2;10;0;0;0
277850;Sportsfriends;Action, Indie, RPG;0 - 20,000;46;14;32;1;1;0
277870;Diehard Dungeon;Animation & Modeling, Design & Illustration, Photo Editing;50,000 - 100,000;357;118;239;171;258;2
277890;Shantae: Risky's Revenge - Director's Cut;Indie, Simulation, Strategy, Early Access;100,000 - 200,000;1149;192;957;200;254;4
277910;Mars Colony:Challenger;Action, Adventure, Casual, Free to Play, Indie, Massively Multiplayer, RPG, Simulation;0 - 20,000;78;44;34;0;0;0
278080;DYNASTY WARRIORS 8: Xtreme Legends Complete Edition;Casual, Indie, Sports;1,000,000 - 2,000,000;9632;1800;7832;1242;967;696
278100;RIVE: Wreck, Hack, Die, Retry!;Action, Adventure, Indie;100,000 - 200,000;769;136;633;165;178;4
278190;ACID Music Studio 10 - Steam Powered;Action, Adventure, Indie;0 - 20,000;47;22;25;0;0;0
278360;A Story About My Uncle;Action, Indie, Racing;5,000,000 - 10,000,000;25853;2306;23547;530;225;17
278420;Spider: Rite of the Shrouded Moon;Action, Casual, Indie, Strategy;20,000 - 50,000;92;16;76;1308;1308;0
278420;Spider: Rite of the Shrouded Moon;Adventure, Indie;20,000 - 50,000;92;16;76;1308;1308;0
278440;0RBITALIS;Adventure;50,000 - 100,000;208;84;124;0;0;0
278460;Skyborn;Action;200,000 - 500,000;1448;217;1231;262;302;3
278490;Aveyond 3-2: Gates of Night;Adventure;50,000 - 100,000;67;41;26;14;14;1
278510;JUDGEMENT SILVERSWORD - Resurrection -;Action;0 - 20,000;61;3;58;52;52;0
278550;A-Train 9 V4.0 : Japan Rail Simulator;Racing;0 - 20,000;79;41;38;0;0;2
278570;Labyrinthine Dreams;Strategy;100,000 - 200,000;260;68;192;239;239;8
278590;Heroes of Legionwood;Indie;0 - 20,000;27;12;15;0;0;0
278620;TinyKeep;Strategy;50,000 - 100,000;272;138;134;145;217;0
278640;Terrian Saga: KR-17;Action;50,000 - 100,000;196;70;126;113;119;3
278810;LA Cops;RPG;20,000 - 50,000;87;78;9;22;22;0
278850;Spaceforce Homeworld;Strategy;0 - 20,000;2;5;-3;0;0;0
278890;Angvik;Adventure;100,000 - 200,000;2106;297;1809;721;637;7
278910;Interplanetary;Simulation;100,000 - 200,000;625;167;458;309;433;2
278930;GIGANTIC ARMY;Strategy;50,000 - 100,000;257;82;175;87;105;1
278970;Digger Online;Indie, RPG, Strategy;200,000 - 500,000;8753;9553;-800;106;57;30
279070;9th Dawn II;Adventure, Casual, Indie;0 - 20,000;129;24;105;0;0;1
279140;Making History: The Great War;Action, Adventure, Casual, Indie;20,000 - 50,000;331;100;231;0;0;4
279160;Ultionus: A Tale of Petty Revenge;Indie;20,000 - 50,000;210;106;104;20;20;0
279260;Richard & Alice;Action, Indie;50,000 - 100,000;299;105;194;217;223;0
279280;Ohmicide;Design & Illustration;100,000 - 200,000;1;0;1;0;0;0
279420;Gardens Inc. – From Rakes to Riches;Action, Adventure, Indie;20,000 - 50,000;76;11;65;0;0;0
279440;Joe Dever's Lone Wolf HD Remastered;Action, Adventure, Indie;50,000 - 100,000;540;172;368;314;394;1
279480;Abalone;Simulation, Strategy;20,000 - 50,000;92;58;34;249;249;0
279500;Nicolas Eymerich - The Inquisitor - Book 1 : The Plague;Action, Indie, Racing;50,000 - 100,000;60;36;24;0;0;1
279500;Nicolas Eymerich - The Inquisitor - Book 1 : The Plague;Action, Indie, Racing;50,000 - 100,000;60;36;24;0;0;1
279520;Rage Runner;Racing, Simulation, Sports;0 - 20,000;27;25;2;529;926;0
279560;Dracula 4 and  5 - Special Steam Edition;Adventure, Indie, Simulation;20,000 - 50,000;77;53;24;1;1;3
279580;Devil's Dare 悪魔の挑戦;Action, Adventure, Casual, Indie, RPG;20,000 - 50,000;104;48;56;62;62;0
279640;The Troma Project;Action, Adventure, Indie;200,000 - 500,000;183;171;12;242;261;1
279720;The I of the Dragon;Strategy;2,000,000 - 5,000,000;593;289;304;218;253;5
279740;3D ParticleGen Visual FX;Action, Indie;50,000 - 100,000;43;26;17;283;283;0
279800;Grim Legends 2: Song of the Dark Swan;Simulation, Strategy;100,000 - 200,000;1132;46;1086;188;205;8
279900;Soul Axiom;Action;50,000 - 100,000;176;67;109;710;1391;1
279920;Infinity Runner;Action, Adventure;20,000 - 50,000;88;39;49;0;0;0
279940;The Book of Unwritten Tales 2;Simulation, Strategy;50,000 - 100,000;801;74;727;198;318;1
279990;Bridge Constructor Playground;Indie, Strategy;50,000 - 100,000;157;72;85;41;65;1
280010;Gunjitsu;Action, Indie, Simulation;50,000 - 100,000;693;166;527;322;322;0
280040;A Wizard's Lizard;Action, Adventure, Indie;50,000 - 100,000;306;131;175;132;137;0
280140;Millennium - A New Hope;Utilities;200,000 - 500,000;293;102;191;225;269;1
280160;Aragami;Indie, Strategy;500,000 - 1,000,000;10185;1096;9089;299;268;81
280180;Hover;Action, Casual, Indie, Early Access;200,000 - 500,000;1618;384;1234;67;32;5
280200;Eterium;Casual, Indie;50,000 - 100,000;45;47;-2;1;1;1
280220;Creeper World 3: Arc Eternal;Action, Adventure, Indie;200,000 - 500,000;4094;151;3943;988;558;109
280320;Adventurer Manager;Indie, Strategy;20,000 - 50,000;341;217;124;229;232;0
280360;Interstellaria;Action, Indie, RPG, Simulation;200,000 - 500,000;226;178;48;8;8;1
280380;Uprising44: The Silent Shadows;Casual, Indie, Strategy, Early Access;0 - 20,000;8;37;-29;0;0;0
280460;Pulstar;;20,000 - 50,000;64;49;15;65;65;0
280520;Crea;Indie, Early Access;50,000 - 100,000;1039;305;734;988;1210;4
280540;GhostControl Inc.;Indie, Strategy;20,000 - 50,000;124;49;75;0;0;1
280560;Danmaku Unlimited 2;Indie, Strategy;20,000 - 50,000;406;28;378;117;182;1
280600;BloodLust Shadowhunter;Adventure, Indie, RPG;0 - 20,000;259;69;190;1945;1950;2
280640;Dark Shadows - Army of Evil;Adventure, Casual, Free to Play, Massively Multiplayer, RPG;200,000 - 500,000;88;192;-104;258;259;1
280680;Krita;Action, Adventure, Indie, RPG;100,000 - 200,000;2608;143;2465;1719;1852;325
280720;Imagine Earth;Action, Indie, Massively Multiplayer, RPG, Early Access;50,000 - 100,000;619;143;476;548;604;10
280790;Creativerse;Action, Indie, Simulation;1,000,000 - 2,000,000;24114;6386;17728;463;99;107
280830;Foosball - Street Edition;Adventure, Indie;0 - 20,000;130;52;78;11;11;0
280830;Foosball - Street Edition;Adventure, Casual, Indie;0 - 20,000;130;52;78;11;11;0
280850;Dollhouse;Action, RPG, Strategy;0 - 20,000;80;61;19;242;423;0
280890;Ghostship Aftermath;Action, Adventure;0 - 20,000;41;63;-22;438;438;0
280910;T.E.C. 3001;RPG;20,000 - 50,000;352;41;311;593;952;1
280930;Battlepillars Gold Edition;Action;20,000 - 50,000;276;48;228;202;231;0
281060;Reversion - The Meeting (2nd Chapter);Action;50,000 - 100,000;144;48;96;284;265;1
281080;Reversion - The Return (Last Chapter);Action;20,000 - 50,000;66;9;57;0;0;0
281200;A Boy and His Blob;Action;100,000 - 200,000;329;154;175;119;219;0
281220;BloodRayne Betrayal;Action;50,000 - 100,000;531;341;190;642;653;0
281240;Adventure Chronicles: The Search For Lost Treasure;Action, Adventure;20,000 - 50,000;56;31;25;0;0;1
281260;Desert Gunner;Casual;0 - 20,000;30;38;-8;29;29;0
281280;Mashed;Casual;50,000 - 100,000;368;98;270;873;873;5
281350;US and THEM;Sports;20,000 - 50,000;33;59;-26;0;0;0
281370;Real Horror Stories Ultimate Edition;Simulation;100,000 - 200,000;496;785;-289;147;201;0
281390;ORB;Simulation;20,000 - 50,000;74;21;53;0;0;0
281410;Ubersoldier II;Simulation;100,000 - 200,000;356;121;235;31;47;1
281430;Clans;Simulation;20,000 - 50,000;80;53;27;15;15;0
281450;Disciples Sacred Lands Gold;Violent, Gore, Action, Indie, RPG;50,000 - 100,000;261;45;216;457;457;8
281560;D.W.A.R.F.S.;Action, Casual, Indie;0 - 20,000;9;10;-1;0;0;0
281580;Wings Over Europe;Action, Indie;20,000 - 50,000;63;45;18;0;0;0
281610;Homeworld: Deserts of Kharak;Action, Indie;500,000 - 1,000,000;5810;1169;4641;611;486;56
281640;The Banner Saga 2;Action, Indie;200,000 - 500,000;2902;329;2573;506;606;35
281750;Munin;Adventure, Free to Play, Indie, RPG;200,000 - 500,000;703;150;553;154;216;1
281840;4PM;Adventure, Casual;0 - 20,000;76;159;-83;3;3;1
281860;RefleX;Adventure, Casual;50,000 - 100,000;189;26;163;492;903;1
281900;Indie Graphics Bundle - Royalty Free Sprites;Adventure, Casual;0 - 20,000;18;13;5;0;0;0
281920;Splatter - Zombiecalypse Now;Adventure, Casual;200,000 - 500,000;2038;225;1813;189;213;2
281940;Woolfe - The Red Hood Diaries;Adventure, Casual;200,000 - 500,000;853;600;253;131;206;1
281990;Stellaris;Adventure, Casual;2,000,000 - 5,000,000;126928;16682;110246;7151;1461;15219
282010;Carmageddon Max Pack;Adventure;100,000 - 200,000;661;79;582;135;268;6
282030;Carmageddon 2: Carpocalypse Now;Indie, Simulation, Strategy;50,000 - 100,000;632;88;544;328;328;1
282050;MX vs. ATV Supercross Encore;Action, Adventure, Indie, RPG;50,000 - 100,000;458;296;162;597;840;5
282070;This War of Mine;Racing, Simulation, Early Access;2,000,000 - 5,000,000;84766;6393;78373;740;266;1088
282100;Fearless Fantasy;Action, Adventure, Indie;500,000 - 1,000,000;790;259;531;150;38;1
282140;SOMA;Casual, Indie;2,000,000 - 5,000,000;33317;1405;31912;433;285;93
282210;Sid Meier's Starships;Action, Indie;100,000 - 200,000;1108;1154;-46;294;405;59
282370;Future Perfect;Adventure, Indie;0 - 20,000;0;0;0;0;0;0
282400;SuperPower 2 Steam Edition;Indie;100,000 - 200,000;1999;499;1500;1233;1233;51
282440;Quake Live;Racing, Simulation;2,000,000 - 5,000,000;12573;2032;10541;803;63;394
282530;Castlevania: Lords of Shadow – Mirror of Fate HD;Adventure, Indie;100,000 - 200,000;1534;305;1229;445;351;9
282560;RollerCoaster Tycoon World;Action, Adventure, Indie;200,000 - 500,000;1381;4203;-2822;316;228;22
282590;Star Ruler 2;Action, Indie;200,000 - 500,000;569;129;440;1054;1436;7
282620;The Battle of Sol;Action, Indie, Strategy;20,000 - 50,000;57;38;19;0;0;1
282640;LOST ORBIT;Adventure, Casual;0 - 20,000;47;3;44;242;242;0
282660;Easy eSports;Adventure, Casual;1,000,000 - 2,000,000;8003;1932;6071;748;110;9
282680;Warring States;Adventure, Casual;0 - 20,000;75;23;52;0;0;1
282740;Organic Panic;Adventure, Casual;0 - 20,000;11;14;-3;0;0;0
282760;Circuits;Adventure, Casual;100,000 - 200,000;1853;225;1628;106;99;0
282780;Stick 'Em Up 2: Paper Adventures;Adventure, Casual;20,000 - 50,000;82;39;43;48;48;0
282800;100% Orange Juice;Adventure, Casual;500,000 - 1,000,000;22243;1686;20557;688;155;284
282860;Masterspace;Casual;0 - 20,000;50;122;-72;657;657;0
282880;FaeVerse Alchemy;Adventure, Casual;200,000 - 500,000;217;114;103;527;582;1
282900;Hyperdimension Neptunia Re;Adventure, Casual;;;;0;;;
282960;The Sands Whisper Your Name;Action, RPG, Early Access;0 - 20,000;6;0;6;0;0;0
283000;Strategic War in Europe;Action, Indie, Racing;20,000 - 50,000;68;90;-22;381;393;0
283020;The Campaign Series: Fall Weiss;Casual, Indie, Simulation;20,000 - 50,000;26;46;-20;310;310;0
283040;Paper Dungeons;Action, Indie;0 - 20,000;44;41;3;312;330;0
283060;Lucent Heart;Action, Indie;100,000 - 200,000;164;163;1;57;76;2
283080;Super Chibi Knight;Action, Casual, Indie, Simulation, Strategy;20,000 - 50,000;342;45;297;162;246;1
283160;House of the Dying Sun;Action, Adventure, Indie;100,000 - 200,000;1480;164;1316;55;81;3
283180;The Samaritan Paradox;Action, Indie, Strategy;50,000 - 100,000;149;57;92;1803;1823;1
283230;Spoiler Alert;Indie, Simulation, Strategy, Early Access;100,000 - 200,000;918;307;611;278;303;2
283270;Jagged Alliance 1: Gold Edition;Casual, Simulation, Strategy;50,000 - 100,000;308;84;224;23;23;7
283290;Nosferatu: The Wrath of Malachi;Action, Adventure;200,000 - 500,000;2373;353;2020;189;194;6
283310;Soulbringer;Action, Simulation, Strategy;50,000 - 100,000;139;89;50;8;8;1
283330;Desert Thunder;Simulation, Strategy;20,000 - 50,000;99;143;-44;5;6;0
283350;Eurofighter Typhoon;Simulation, Strategy;20,000 - 50,000;50;161;-111;0;0;0
283370;Marine Sharpshooter II: Jungle Warfare;Indie, Strategy;100,000 - 200,000;175;390;-215;32;50;0
283390;Incoming Forces;Simulation, Early Access;100,000 - 200,000;175;146;29;235;223;0
283410;CT Special Forces: Fire for Effect;Casual, RPG;20,000 - 50,000;133;109;24;315;370;0
283430;Litil Divil;Action, Indie;20,000 - 50,000;200;232;-32;3;4;0
283470;The Secret Of Hildegards;Strategy;20,000 - 50,000;10;42;-32;0;0;0
283490;IHF Handball Challenge 12;Action, Racing, RPG;0 - 20,000;47;29;18;78;78;0
283560;Munich Bus Simulator;Action, Racing;50,000 - 100,000;162;122;40;0;0;6
283600;World of Subways 2 – Berlin Line 7;Action, Free to Play, Indie, Sports, Strategy, Early Access;20,000 - 50,000;182;61;121;0;0;3
283620;World of Subways 3 – London Underground Circle Line;Action, Simulation;100,000 - 200,000;434;149;285;0;0;4
283640;Salt and Sanctuary;Casual, Indie, Simulation;500,000 - 1,000,000;15793;1726;14067;929;270;115
283660;Rabbit Hole 3D: Steam Edition;Adventure, Casual, Indie, RPG, Strategy;50,000 - 100,000;198;115;83;220;220;1
283680;Astebreed: Definitive Edition;Action, Indie, Racing;100,000 - 200,000;1315;172;1143;103;121;0
283820;KAMUI;Action, Indie;50,000 - 100,000;149;15;134;74;74;2
283840;ALLTYNEX Second;Action, Adventure, Casual, Indie;20,000 - 50,000;114;18;96;135;202;1
283880;Heroine's Quest: The Herald of Ragnarok;Action, Indie;200,000 - 500,000;1133;155;978;130;16;2
283920;Putt-Putt Joins the Parade;Action, Casual, Indie;20,000 - 50,000;252;17;235;0;0;6
283940;Freddi Fish and the Case of the Missing Kelp Seeds;Action, Indie;50,000 - 100,000;538;20;518;115;121;16
283960;Pajama Sam: No Need to Hide When It's Dark Outside;Action, Casual, Indie, Strategy;100,000 - 200,000;978;25;953;325;568;15
283980;"Spy Fox in ""Dry Cereal""";Action, Indie;50,000 - 100,000;427;20;407;110;134;10
284000;Putt-Putt and Pep's Balloon-o-Rama;Action, Indie;0 - 20,000;63;14;49;0;0;2
284020;Freddi Fish and Luther's Maze Madness;RPG;0 - 20,000;53;14;39;1;1;0
284050;Sanitarium;Adventure, Indie;200,000 - 500,000;880;54;826;423;423;9
284100;Unclaimed World;Casual, Indie, RPG, Simulation, Strategy;0 - 20,000;98;94;4;0;0;1
284140;Majestic Nights;Adventure, Casual, Indie, RPG, Strategy;20,000 - 50,000;61;50;11;0;0;0
284160;BeamNG.drive;RPG;2,000,000 - 5,000,000;158540;4909;153631;7670;799;14538
284180;Magicians & Looters;Indie, Racing, RPG, Sports;0 - 20,000;111;14;97;289;324;1
284180;Magicians & Looters;Adventure;0 - 20,000;111;14;97;289;324;1
284200;Robot Rescue Revolution;Simulation, Strategy;0 - 20,000;39;18;21;53;53;0
284220;Diadra Empty;Indie;0 - 20,000;66;19;47;275;275;0
284240;Maize;Adventure, Indie;200,000 - 500,000;1518;366;1152;119;205;3
284260;PANORAMICAL;Adventure, Indie;0 - 20,000;186;21;165;0;0;0
284290;Farm Machines Championships 2014;Adventure, Indie;20,000 - 50,000;47;72;-25;53;53;0
284390;The Last Door - Collector's Edition;Casual, Indie, Strategy;100,000 - 200,000;1954;108;1846;434;512;5
284410;Cornerstone: The Song of Tyrim;Action, Indie, Strategy;20,000 - 50,000;57;40;17;627;627;0
284460;DeadCore;Adventure;100,000 - 200,000;1679;295;1384;73;65;1
284710;Abyss: The Wraiths of Eden;Adventure;100,000 - 200,000;1214;128;1086;386;250;5
284730;Dark Arcana: The Carnival;Action, Casual, Strategy;100,000 - 200,000;593;73;520;162;223;2
284750;Enigmatis: The Ghosts of Maple Creek;Adventure;100,000 - 200,000;1209;223;986;378;477;9
284770;Enigmatis 2: The Mists of Ravenwood;Racing, Sports;100,000 - 200,000;1330;40;1290;381;422;5
284790;Nightmares from the Deep 2: The Siren`s Call;Action, Indie;50,000 - 100,000;786;35;751;619;900;0
284830;Clockwork Tales: Of Glass and Ink;Action;100,000 - 200,000;970;86;884;209;213;2
284850;Grim Legends: The Forsaken Bride;Action, Simulation;100,000 - 200,000;1372;54;1318;404;414;7
284870;9 Clues: The Secret of Serpent Creek;Casual, Simulation, Strategy;100,000 - 200,000;1231;137;1094;192;233;2
284890;Left in the Dark: No One on Board;Action;100,000 - 200,000;573;118;455;69;87;1
284910;Purgatory: War of the Damned;Simulation;0 - 20,000;7;17;-10;1;1;0
284930;Speed Kills;Action, Racing;100,000 - 200,000;200;206;-6;248;300;0
284950;Pixel Puzzles: Japan;Action, Racing;200,000 - 500,000;2062;470;1592;304;319;4
284970;Project Root;Action, Adventure;20,000 - 50,000;57;54;3;48;48;0
284990;Solarix;Action, Indie, RPG;100,000 - 200,000;263;166;97;175;268;0
285010;Pixel Puzzles: UndeadZ;Action, Adventure, Free to Play, Sports, Strategy;200,000 - 500,000;637;229;408;305;316;1
285070;Between Me and The Night;Adventure;100,000 - 200,000;614;187;427;285;315;1
285090;Robowars;Strategy;100,000 - 200,000;126;156;-30;234;229;1
285110;GearCity;Action, Indie;20,000 - 50,000;1063;140;923;791;791;54
285130;Battleplan: American Civil War;Action, Casual;200,000 - 500,000;140;151;-11;225;228;0
285160;LEGO The Hobbit;Adventure, Casual, Indie, Massively Multiplayer, Simulation;1,000,000 - 2,000,000;6766;1630;5136;306;88;197
285190;Warhammer 40,000: Dawn of War III;Casual, Indie, Simulation, Strategy;1,000,000 - 2,000,000;9699;10868;-1169;946;550;152
285310;RollerCoaster Tycoon: Deluxe;Casual, Indie, Simulation;500,000 - 1,000,000;6021;347;5674;395;63;314
285330;RollerCoaster Tycoon 2: Triple Thrill Pack;Racing;500,000 - 1,000,000;4015;495;3520;228;80;171
285350;Kingdom Elemental;Action, Adventure;0 - 20,000;14;13;1;14;14;0
285380;On The Road - Truck Simulator;Racing, Sports;20,000 - 50,000;502;510;-8;249;303;14
285420;Deadly Sin 2;Action;100,000 - 200,000;93;15;78;193;202;0
285440;Crimzon Clover WORLD IGNITION;Simulation, Strategy;100,000 - 200,000;1371;98;1273;119;149;3
285480;The Entente Gold;Simulation, Strategy;50,000 - 100,000;281;329;-48;132;149;1
285500;Hard Truck Apocalypse / Ex Machina;Adventure, Casual, Indie, Simulation;100,000 - 200,000;1827;351;1476;263;492;22
285520;Sledgehammer / Gear Grinder;Adventure, RPG;0 - 20,000;101;32;69;0;0;0
285580;ACE - Arena: Cyber Evolution;Action, Adventure;200,000 - 500,000;712;358;354;612;27;0
285740;Kitty Powers' Matchmaker;Adventure, Casual;50,000 - 100,000;1158;54;1104;1555;1555;18
285800;Braveland;Adventure, Casual, Indie;5,000,000 - 10,000,000;2394;526;1868;1413;247;5
285820;Action Henk;Indie;100,000 - 200,000;725;94;631;161;222;1
285840;Enemy Mind;Action, Adventure, Indie;50,000 - 100,000;668;113;555;145;189;1
285840;Enemy Mind;Action, Indie;50,000 - 100,000;668;113;555;145;189;1
285900;Gang Beasts;Simulation;2,000,000 - 5,000,000;37656;8208;29448;625;190;1579
285920;TerraTech;Action, Free to Play, Indie, Massively Multiplayer, RPG;500,000 - 1,000,000;17159;1747;15412;2372;1396;436
285960;Q*bert: Rebooted;Indie, Strategy;20,000 - 50,000;103;63;40;0;0;0
285980;Kromaia;Indie, Simulation, Strategy;20,000 - 50,000;81;27;54;36;36;1
286000;Tooth and Tail;Action, Adventure, Indie, Early Access;200,000 - 500,000;3064;761;2303;53;38;11
286040;Dead Effect;Action, Adventure, Indie;200,000 - 500,000;2583;984;1599;208;255;5
286100;You Have to Win the Game;Adventure, Indie;200,000 - 500,000;5216;396;4820;53;25;8
286120;QuestRun;Adventure, Indie;200,000 - 500,000;428;379;49;269;302;1
286140;Eidolon;Action;50,000 - 100,000;249;167;82;0;0;0
286160;Tabletop Simulator;Adventure, Indie, RPG, Strategy;2,000,000 - 5,000,000;54222;3579;50643;1962;496;6884
286200;ReignMaker;Indie, Simulation, Sports, Strategy;50,000 - 100,000;211;128;83;345;412;1
286220;Pier Solar and the Great Architects;Adventure, Indie;50,000 - 100,000;66;53;13;434;434;0
286220;Pier Solar and the Great Architects;Indie, Simulation;50,000 - 100,000;66;53;13;434;434;0
286240;Dog Sled Saga;Action, Casual, Indie, Strategy;20,000 - 50,000;602;52;550;598;1057;5
286260;fault - milestone one;Education, Software Training, Utilities, Video Production;200,000 - 500,000;2942;216;2726;325;361;3
286280;Steel Armor: Blaze of War;Action, Indie;20,000 - 50,000;240;50;190;1163;1163;5
286300;Algo Bot;Audio Production;50,000 - 100,000;93;18;75;175;175;1
286320;Oknytt;RPG;100,000 - 200,000;489;42;447;237;328;0
286340;FarSky;Adventure, Indie;200,000 - 500,000;2861;997;1864;262;368;2
286360;Shadows on the Vatican Act I: Greed;Casual;100,000 - 200,000;524;182;342;137;158;1
286380;Strata;Adventure, Casual;50,000 - 100,000;304;42;262;10;10;0
286460;Black Mirror II;Racing;100,000 - 200,000;465;52;413;0;0;4
286480;Black Mirror III;Adventure, Casual;100,000 - 200,000;365;39;326;15;15;11
286520;Viking Brothers;Casual;20,000 - 50,000;31;14;17;497;497;1
286540;Nearwood - Collector's Edition;Casual, Simulation;50,000 - 100,000;252;27;225;156;293;2
286570;F1 2015;Casual;2,000,000 - 5,000,000;5355;3147;2208;418;348;19
286660;Avoid - Sensory Overload;Adventure, Indie;20,000 - 50,000;176;32;144;0;0;2
286690;Metro 2033 Redux;Adventure;2,000,000 - 5,000,000;61414;7770;53644;553;406;484
286730;Gunship!;Adventure;0 - 20,000;37;42;-5;1;1;0
286750;Zoo Empire;Adventure;20,000 - 50,000;100;36;64;0;0;0
286770;Shadow Ops: Red Mercury;Adventure, Indie, RPG;50,000 - 100,000;189;53;136;7;9;3
286790;Falcon A.T.;Action, Adventure, Indie;0 - 20,000;4;6;-2;0;0;0
286810;Hard Truck Apocalypse: Rise Of Clans / Ex Machina: Meridian 113;Adventure, Indie;50,000 - 100,000;537;183;354;292;335;3
286830;Hard Truck Apocalypse: Arcade / Ex Machina: Arcade;Adventure;20,000 - 50,000;57;152;-95;265;265;0
286880;Disney Planes;Casual;0 - 20,000;55;12;43;59;59;2
286930;Crouching Pony Hidden Dragon;Strategy;20,000 - 50,000;27;55;-28;0;0;0
286940;S.K.I.L.L. - Special Force 2 (Shooter);Adventure, Casual, Indie, RPG, Simulation;2,000,000 - 5,000,000;8113;3374;4739;527;89;0
287020;Harvester;RPG, Strategy;50,000 - 100,000;983;101;882;959;974;3
287070;Battle Academy;Action, RPG, Simulation;50,000 - 100,000;249;42;207;0;0;12
287100;Chaos Domain;RPG, Strategy;200,000 - 500,000;258;575;-317;73;73;0
287120;Ionball 2: Ionstorm;Action, RPG;200,000 - 500,000;460;193;267;247;223;0
287140;Selfie : Sisters of the Amniotic Lens;Strategy;100,000 - 200,000;114;77;37;252;249;0
287200;Wildlife Park 3;Adventure;100,000 - 200,000;289;207;82;36;36;4
287220;Autocraft;Action;0 - 20,000;167;131;36;406;531;0
287220;Autocraft;Action, Simulation, Strategy;0 - 20,000;167;131;36;406;531;0
287260;Toybox Turbos;Adventure, Casual;100,000 - 200,000;1452;258;1194;208;225;5
287290;Resident Evil Revelations 2;Strategy;1,000,000 - 2,000,000;18113;4946;13167;470;197;161
287310;Re-Volt;RPG;20,000 - 50,000;801;60;741;0;0;9
287340;Colin McRae Rally;RPG;200,000 - 500,000;996;1301;-305;285;248;2
287370;COH 2 - The Western Front Armies: US Forces;Action, Adventure, Simulation;500,000 - 1,000,000;288;88;200;0;0;0
287371;CoH 2 - The Western Front Armies: Oberkommando West;RPG;200,000 - 500,000;305;72;233;0;0;0
287390;Metro: Last Light Redux;Strategy;2,000,000 - 5,000,000;49733;6033;43700;737;516;520
287450;Rise of Nations: Extended Edition;Casual, Racing;1,000,000 - 2,000,000;11490;692;10798;981;311;858
287580;Pandora: First Contact;Action, Adventure, Simulation;100,000 - 200,000;376;222;154;1049;1668;5
287600;Sunset;Strategy;0 - 20,000;181;81;100;100;200;0
287600;Sunset;RPG, Strategy;0 - 20,000;181;81;100;100;200;0
287630;The Council;Strategy;200,000 - 500,000;3762;701;3061;125;40;32
287700;METAL GEAR SOLID V: THE PHANTOM PAIN;RPG, Strategy;2,000,000 - 5,000,000;74596;7365;67231;3040;1205;2116
287720;Nostradamus: The Last Prophecy;Action, Adventure;50,000 - 100,000;133;56;77;137;272;2
287740;The Witch's Yarn;Action, Adventure;0 - 20,000;4;24;-20;0;0;0
287780;Derrick the Deathfin;Action, Adventure;0 - 20,000;19;8;11;0;0;0
287840;TY the Tasmanian Tiger 4;Action, Casual, Indie, Sports, Strategy;20,000 - 50,000;209;46;163;245;245;0
287900;Pro Pinball Ultra;Free to Play, Massively Multiplayer, RPG;50,000 - 100,000;197;39;158;0;0;3
287920;Mortal Online;Adventure, Casual;500,000 - 1,000,000;1531;1401;130;351;50;10
287960;Yomi;Adventure, Casual;0 - 20,000;114;27;87;0;0;0
287980;Mini Metro;Adventure, Casual;500,000 - 1,000,000;12843;471;12372;344;220;143
288000;Oncoming Death Steam Edition;RPG, Simulation, Strategy;0 - 20,000;4;6;-2;0;0;0
288020;Rex Rocket;Casual, Simulation, Strategy;20,000 - 50,000;181;58;123;212;265;0
288040;Actual Sunlight;Casual, Simulation;50,000 - 100,000;423;140;283;302;303;0
288060;Whispering Willows;Action, Casual, Indie;200,000 - 500,000;1272;284;988;173;227;3
288100;MechRunner;Indie, Simulation;0 - 20,000;11;11;0;0;0;0
288120;Dungeonmans;Action, Adventure, Indie;100,000 - 200,000;896;83;813;0;0;8
288140;Perfect Golf;Adventure, Indie;100,000 - 200,000;568;300;268;0;0;28
288160;The Room;Action, Indie, RPG, Simulation;500,000 - 1,000,000;22263;513;21750;221;164;68
288220;Backstage Pass;Indie;20,000 - 50,000;234;31;203;443;443;0
288260;Conflicks - Revolutionary Space Battles;Action, Indie;0 - 20,000;124;49;75;0;0;0
288270;liteCam HD 5.0: Screen/Stream Capture;Action, Adventure, Indie, RPG, Simulation;0 - 20,000;33;42;-9;0;0;2
288370;Strike Suit Zero: Director's Cut;Action, Adventure, Indie;100,000 - 200,000;277;64;213;23;23;0
288420;Deckadance 2;Adventure, Indie, RPG, Strategy;0 - 20,000;9;5;4;0;0;0
288470;Fable Anniversary;Casual, Indie;1,000,000 - 2,000,000;9922;1778;8144;1131;645;225
288500;Black Rainbow;Action, Indie;20,000 - 50,000;31;17;14;0;0;0
288610;Kingdom Tales 2;Casual, RPG;0 - 20,000;9;8;1;0;0;0
288630;Sharpe Investigations: Death on the Seine;Action, Free to Play, RPG;0 - 20,000;11;11;0;0;0;0
288650;HTR+ Slot Car Simulation;Action, Indie;0 - 20,000;34;21;13;0;0;0
288670;Myths Of Orion: Light From The North;Adventure, Casual, Indie;0 - 20,000;31;7;24;0;0;0
288690;Sudokuball Detective;Action, Indie;0 - 20,000;7;14;-7;0;0;0
288710;Demolition Master 3D;Action, Adventure, Casual, Indie, RPG;0 - 20,000;4;10;-6;0;0;0
288730;Redneck Racers;Casual, Free to Play, Indie, Massively Multiplayer, Strategy;0 - 20,000;27;35;-8;0;0;0
288750;Hotel Collectors Edition;Action, Adventure, Indie;0 - 20,000;15;21;-6;0;0;0
288830;Voodoo Whisperer Curse of a Legend;Strategy;20,000 - 50,000;48;37;11;917;917;0
288840;Haunted Past: Realm of Ghosts;Early Access;20,000 - 50,000;131;30;101;0;0;0
288860;Realms of Arkania: Star Trail;Indie, Strategy;0 - 20,000;122;46;76;0;0;0
288880;Pineview Drive;Action, Casual, Indie, RPG, Strategy;20,000 - 50,000;371;208;163;105;165;1
288930;The Charnel House Trilogy;Indie, Simulation, Strategy;50,000 - 100,000;493;124;369;336;385;1
288970;Dark Lore Mysteries: The Hunt For Truth;Casual, Indie, Simulation;20,000 - 50,000;45;24;21;351;351;1
288970;Dark Lore Mysteries: The Hunt For Truth;Action, Adventure, Indie;20,000 - 50,000;45;24;21;351;351;1
289050;Shannon Tweed's Attack Of The Groupies;Casual, Indie, Simulation;20,000 - 50,000;21;26;-5;0;0;0
289060;The Emerald Tablet;Indie, RPG, Strategy;0 - 20,000;12;8;4;0;0;0
289070;Sid Meier’s Civilization VI;Action, Indie;5,000,000 - 10,000,000;216459;39229;177230;4950;1453;56814
289090;Ampu-Tea;Action, Adventure, Casual, Indie;200,000 - 500,000;1275;766;509;209;210;0
289130;ENDLESS Legend;Casual, Free to Play, Simulation, Strategy;1,000,000 - 2,000,000;14219;2653;11566;1378;693;247
289180;A.I.M.2 Clan Wars;Casual, Indie, Strategy;50,000 - 100,000;353;94;259;786;1568;3
289200;Ascension to the Throne;Indie, RPG, Strategy;100,000 - 200,000;446;55;391;58;116;5
289220;BorderZone;Action, Adventure, Indie, Simulation;20,000 - 50,000;40;58;-18;291;363;0
289240;Perimeter: Emperor's Testament;Action, Casual, Indie;20,000 - 50,000;27;12;15;0;0;0
289260;Dreamscapes: The Sandman - Premium Edition;Adventure, Casual, Indie;50,000 - 100,000;189;40;149;365;365;2
289280;El Matador;Action, Casual, Indie, Sports;50,000 - 100,000;296;126;170;107;116;0
289300;Faces of War;Action, Indie;100,000 - 200,000;823;109;714;232;353;12
289320;Fairy Tale About Father Frost, Ivan and Nastya;Free to Play, Indie, Strategy;20,000 - 50,000;73;36;37;3916;7537;1
289340;Freight Tycoon Inc.;Action, Casual, Indie;20,000 - 50,000;218;198;20;233;312;2
289360;Konung 2;Indie, RPG, Simulation, Strategy;50,000 - 100,000;136;28;108;252;252;5
289380;Konung 3: Ties of the Dynasty;Action, Free to Play, Massively Multiplayer;20,000 - 50,000;68;27;41;10;10;1
289400;Parkan 2;Action, Free to Play, Indie;50,000 - 100,000;224;91;133;255;326;2
289420;Planet Alcatraz;Indie;50,000 - 100,000;454;93;361;278;320;10
289440;Perimeter;Adventure;50,000 - 100,000;175;34;141;216;221;7
289460;RC Cars;Adventure;50,000 - 100,000;294;95;199;4;4;0
289480;The Tomorrow War;RPG;0 - 20,000;50;51;-1;181;228;1
289480;The Tomorrow War;Adventure, Indie;0 - 20,000;50;51;-1;181;228;1
289500;UFO: Aftershock;Adventure, Indie;50,000 - 100,000;146;47;99;158;158;2
289520;King's Bounty: Dark Side;Adventure, Indie;200,000 - 500,000;1126;408;718;203;301;97
289580;Aggression: Europe Under Fire;RPG, Strategy;50,000 - 100,000;53;51;2;0;0;2
289600;Marauder;Action, Indie, RPG, Strategy;100,000 - 200,000;441;171;270;0;0;2
289620;Collapse;Action, Simulation;100,000 - 200,000;557;207;350;150;150;1
289650;Assassin's Creed Unity;Simulation, Strategy;2,000,000 - 5,000,000;40792;12423;28369;1104;681;530
289690;LARA CROFT AND THE TEMPLE OF OSIRIS;Action, Adventure, RPG, Strategy;500,000 - 1,000,000;2518;1265;1253;212;36;12
289760;ROCKETSROCKETSROCKETS;RPG;200,000 - 500,000;413;133;280;182;306;0
289780;Requiem: Rise of the Reaver;Action;200,000 - 500,000;536;256;280;16;29;47
289800;Dracula: The Resurrection;Casual;50,000 - 100,000;203;224;-21;77;154;2
289820;Dracula 2: The Last Sanctuary;RPG;20,000 - 50,000;71;163;-92;122;122;1
289840;Dracula 3: The Path of the Dragon;RPG;50,000 - 100,000;75;149;-74;72;127;0
289890;7,62 High Calibre;Strategy;50,000 - 100,000;319;95;224;211;275;2
289930;TransOcean: The Shipping Company;Simulation;100,000 - 200,000;822;316;506;908;939;42
289950;Construction Simulator 2015;Casual, Indie, Strategy;500,000 - 1,000,000;5248;1172;4076;2139;635;75
290000;DubWars;Design & Illustration, Utilities;50,000 - 100,000;225;64;161;42;42;0
290020;LogicBots;Adventure, Casual;0 - 20,000;139;34;105;355;429;1
290040;Retro Game Crunch;Adventure, Casual;50,000 - 100,000;326;84;242;38;53;0
290060;Glitchspace;Adventure, Casual;20,000 - 50,000;252;90;162;308;308;0
290080;Life is Feudal: Your Own;Adventure, Casual;200,000 - 500,000;7675;3933;3742;7686;691;672
290180;Gnomancer;Indie, Simulation, Strategy;0 - 20,000;15;4;11;0;0;0
290260;Sokobond;Education, Software Training;20,000 - 50,000;498;35;463;70;75;4
290280;Volt;Indie, RPG;100,000 - 200,000;272;127;145;161;211;0
290300;Rebel Galaxy;Casual, Racing;500,000 - 1,000,000;6491;1138;5353;838;705;46
290320;Project Temporality;Action;20,000 - 50,000;85;17;68;145;145;0
290320;Project Temporality;Adventure, Indie, RPG;20,000 - 50,000;85;17;68;145;145;0
290340;Armello;Racing;1,000,000 - 2,000,000;12117;2678;9439;1450;582;195
290380;Micron;Action, Simulation;20,000 - 50,000;160;5;155;0;0;0
290440;QUALIA 3: Multi Agent;Action, Indie;20,000 - 50,000;22;26;-4;1;1;0
290440;QUALIA 3: Multi Agent;Action, Adventure, Indie;20,000 - 50,000;22;26;-4;1;1;0
290460;Legionwood 2: Rise of the Eternal's Realm - Director's Cut;Action, Indie;20,000 - 50,000;27;22;5;15;15;0
290470;Onigiri;Action, Indie;100,000 - 200,000;651;258;393;40;41;47
290490;The Flock;Indie;20,000 - 50,000;123;179;-56;0;0;0
290510;GNOG;Adventure, Casual, Indie;50,000 - 100,000;769;61;708;211;310;2
290530;Clandestine;Adventure;50,000 - 100,000;369;96;273;256;337;4
290650;Time Ramesside (A New Reckoning);Adventure;50,000 - 100,000;70;296;-226;13817;317;1
290690;Tonight We Riot;Action, Adventure;0 - 20,000;479;22;457;0;0;0
290690;Tonight We Riot;Strategy;0 - 20,000;479;22;457;0;0;0
290730;My Lands: Black Gem Hunting;Adventure, Casual;500,000 - 1,000,000;2767;517;2250;2993;4443;109
290770;The Fall;Adventure, Casual;200,000 - 500,000;3129;430;2699;252;311;2
290790;Grey Goo;Adventure, Casual;200,000 - 500,000;2795;1298;1497;338;216;12
290810;Colossal Kaiju Combat: Kaijuland Battles;Casual;0 - 20,000;39;66;-27;0;0;0
290850;X-Team;Casual;0 - 20,000;5;5;0;0;0;0
290870;Steam Squad;Adventure;20,000 - 50,000;60;30;30;0;0;0
290890;You Must Build A Boat;Adventure;100,000 - 200,000;812;170;642;295;332;3
290970;1849;Adventure;20,000 - 50,000;251;98;153;0;0;0
290990;Flower Shop: Summer In Fairbrook;Strategy;0 - 20,000;86;39;47;20;20;2
291010;The Hat Man: Shadow Ward;Adventure, Indie, RPG, Strategy;200,000 - 500,000;2239;1159;1080;179;163;1
291030;Always Remember Me;Action, Adventure, Indie;20,000 - 50,000;158;106;52;1;1;0
291050;Planet Stronghold;Indie, Strategy;20,000 - 50,000;61;42;19;369;369;1
291070;Slip;Action, Indie, Early Access;20,000 - 50,000;86;23;63;45;45;0
291130;Akane the Kunoichi;Action, Adventure, Indie, Strategy;50,000 - 100,000;358;376;-18;136;188;1
291170;Royal Defense;Free to Play, RPG, Strategy;100,000 - 200,000;249;87;162;252;299;2
291190;Heroes of Steel RPG;Adventure, Indie;100,000 - 200,000;201;55;146;0;0;3
291250;Jumpdrive;Casual, Indie, Simulation;20,000 - 50,000;65;98;-33;0;0;0
291270;Vitrum;;20,000 - 50,000;30;40;-10;112;112;0
291290;Motte Island;Action, Adventure, Massively Multiplayer, Simulation, Early Access;0 - 20,000;67;17;50;0;0;0
291290;Motte Island;Action, Casual, Indie;0 - 20,000;67;17;50;0;0;0
291330;Final Slam 2;Action, Adventure, Indie, RPG;50,000 - 100,000;104;368;-264;247;238;2
291370;Undead Overlord;Action, Indie, RPG;0 - 20,000;49;138;-89;0;0;0
291370;Undead Overlord;Adventure, Casual, Indie, RPG, Early Access;0 - 20,000;49;138;-89;0;0;0
291390;Three Dead Zed;Indie, Simulation;100,000 - 200,000;110;56;54;210;222;1
291410;Duelyst;Action, Free to Play, Indie, Massively Multiplayer, RPG;500,000 - 1,000,000;3972;844;3128;2152;260;0
291430;Lost Marbles;Action, Indie;0 - 20,000;36;12;24;167;167;0
291450;Smugglers 5;Adventure, Indie;50,000 - 100,000;87;64;23;0;0;1
291480;Warface;Adventure, Indie, RPG;10,000,000 - 20,000,000;54367;26216;28151;949;121;1530
291550;Brawlhalla;Action, Indie;20,000,000 - 50,000,000;263450;51127;212323;2745;169;15697
291610;Growing Pains;Indie;0 - 20,000;21;8;13;0;0;0
291610;Growing Pains;Simulation, Strategy, Early Access;0 - 20,000;21;8;13;0;0;0
291630;Mirror Mysteries;Action, Indie, RPG;20,000 - 50,000;185;55;130;2;2;0
291640;Mirror Mysteries 2;Action, Indie;20,000 - 50,000;50;29;21;113;113;0
291650;Pillars of Eternity;Adventure, Casual, Indie;1,000,000 - 2,000,000;19164;2578;16586;1989;1055;581
291690;Empathy: Path of Whispers;Adventure, Casual, Indie, RPG;0 - 20,000;117;70;47;154;154;0
291710;The Lost Crown;Action, Casual, Indie;50,000 - 100,000;359;75;284;843;843;2
291770;The Last Crown: Midnight Horror;Casual, Indie, RPG, Simulation;20,000 - 50,000;99;27;72;178;178;1
291840;The Feud: Wild West Tactics;Action, Indie, Simulation, Strategy;0 - 20,000;57;37;20;0;0;0
291860;Pit People;Indie, Simulation, Strategy;200,000 - 500,000;7025;475;6550;1835;448;39
291910;Firefighters 2014;Adventure, Indie;50,000 - 100,000;337;224;113;386;386;3
291930;Industry Empire;Action, Indie;50,000 - 100,000;81;150;-69;0;0;3
291960;Elminage Gothic;Adventure, Indie, RPG, Simulation, Strategy;20,000 - 50,000;124;61;63;0;0;1
292030;The Witcher 3: Wild Hunt;Action, Adventure, Casual, Indie, RPG;10,000,000 - 20,000,000;678931;28663;650268;3341;823;23135
292060;Titanfall - The Final Hours;Action, Adventure, Indie;20,000 - 50,000;101;192;-91;0;0;0
292090;Rube Works: The Official Rube Goldberg Invention Game;Indie, Simulation, Strategy;20,000 - 50,000;20;4;16;0;0;0
292120;FINAL FANTASY XIII;Action, Adventure, Indie;500,000 - 1,000,000;11150;3839;7311;1549;797;250
292140;FINAL FANTASY XIII-2;Free to Play, Indie, Strategy;200,000 - 500,000;2785;1945;840;2445;978;67
292160;UFO: Aftermath;Adventure, Indie;100,000 - 200,000;196;54;142;636;636;2
292180;X-Plane 10 Global - 64 Bit;Action, Casual, Indie;100,000 - 200,000;717;303;414;73;73;5
292200;Crazy Plant Shop;Action, Adventure, Casual;20,000 - 50,000;206;61;145;0;0;0
292230;Game Character Hub;Indie, RPG, Strategy;100,000 - 200,000;219;100;119;145;30;2
292240;"Spy Fox 2 ""Some Assembly Required""";Adventure;0 - 20,000;147;12;135;120;122;5
292260;"Spy Fox 3 ""Operation Ozone""";Adventure, Indie;0 - 20,000;102;14;88;170;170;3
292280;Spy Fox In: Cheese Chase;Action, Adventure, Indie;0 - 20,000;34;21;13;8;8;0
292300;Spy Fox In: Hold the Mustard;Adventure, Casual;0 - 20,000;15;22;-7;15;15;1
292330;Starship Corporation;Adventure, Casual;100,000 - 200,000;224;302;-78;137;137;1
292350;Gamer To Game Developer Series 2: Learn Unity 2D;Adventure, Casual;0 - 20,000;20;6;14;0;0;0
292370;DarkEnd;Adventure, Casual;200,000 - 500,000;178;164;14;318;309;1
292380;Racer 8;Adventure, Casual;200,000 - 500,000;598;733;-135;205;187;1
292390;Realms of the Haunting;Action, Strategy;200,000 - 500,000;351;107;244;14;20;1
292400;Unrest;Adventure, Casual;20,000 - 50,000;130;59;71;324;326;0
292410;Street Racing Syndicate;Adventure, Casual;500,000 - 1,000,000;2953;572;2381;251;191;7
292420;Panzer Elite Action Gold Edition;Adventure, Casual;20,000 - 50,000;76;120;-44;605;605;2
292500;Kero Blaster;Adventure, Casual;200,000 - 500,000;1116;76;1040;134;160;2
292570;Chompy Chomp Chomp;Adventure, Casual;200,000 - 500,000;389;165;224;210;249;0
292600;Duet;Adventure, Casual;20,000 - 50,000;710;42;668;82;105;1
292620;Pressured;Adventure, Casual;200,000 - 500,000;269;275;-6;248;235;0
292630;Uriel's Chasm;Casual;200,000 - 500,000;487;2241;-1754;206;202;0
292660;Princess Isabella;Casual, Simulation, Strategy;20,000 - 50,000;109;35;74;4;4;0
292670;Princess Isabella - Return of the Curse;Action, Indie, Strategy;20,000 - 50,000;75;21;54;84;84;0
292730;Call of Duty: Infinite Warfare;Action, Indie, Strategy;1,000,000 - 2,000,000;13505;11030;2475;1470;686;246
292760;Rise of Prussia Gold;Action, Indie, Strategy;0 - 20,000;28;12;16;0;0;0
292800;Pajama Sam 3: You Are What You Eat From Your Head To Your Feet;Action;0 - 20,000;305;11;294;70;70;9
292820;Pajama Sam 4: Life Is Rough When You Lose Your Stuff!;Simulation, Strategy;20,000 - 50,000;51;79;-28;69;69;4
292840;Pajama Sam's Sock Works;Action, RPG, Strategy;20,000 - 50,000;54;8;46;97;97;2
292860;Pajama Sam's Lost & Found;Action, Adventure, Massively Multiplayer;0 - 20,000;19;14;5;19;19;2
292860;Pajama Sam's Lost & Found;Adventure, Indie;0 - 20,000;19;14;5;19;19;2
292880;Robin's Quest;Action, Adventure;20,000 - 50,000;96;14;82;0;0;1
292910;Deponia: The Complete Journey;Free to Play, Massively Multiplayer, RPG;1,000,000 - 2,000,000;5216;785;4431;439;273;56
292930;Black Mirror I;Indie, RPG, Simulation, Strategy;200,000 - 500,000;892;182;710;851;851;8
292990;NOBUNAGA'S AMBITION: Souzou;Action, Adventure, Indie;50,000 - 100,000;866;133;733;730;730;113
293160;AntharioN;Indie, Strategy;50,000 - 100,000;124;57;67;0;0;2
293180;Overcast - Walden and the Werewolf;Action, Adventure, Indie;1,000,000 - 2,000,000;1719;1093;626;3290;233;4
293200;Sentinel;Action, Indie;20,000 - 50,000;48;31;17;7;7;0
293220;H-Hour: World's Elite;Action, Adventure, Indie;50,000 - 100,000;644;431;213;601;601;21
293240;Cosmochoria;Free to Play, Indie, Massively Multiplayer, Racing, RPG, Strategy;20,000 - 50,000;413;49;364;185;185;0
293260;Card Hunter;Action, Indie;1,000,000 - 2,000,000;4245;696;3549;593;54;82
293320;Coma: Mortuary;Indie;100,000 - 200,000;479;424;55;450;425;0
293340;The Good Life;Action;0 - 20,000;81;78;3;0;0;0
293360;Second Chance Heroes;Action, Adventure, Casual, Indie;0 - 20,000;0;0;0;0;0;0
293440;Elliot Quest;Adventure, Casual, Indie, RPG;20,000 - 50,000;129;46;83;0;0;0
293480;FRONTIERS;Action, Indie, RPG;20,000 - 50,000;89;235;-146;9;9;0
293520;Carnivores: Dinosaur Hunter Reborn;Action, Adventure;50,000 - 100,000;578;208;370;47;47;1
293540;Guns and Robots;Casual, Indie, Racing;1,000,000 - 2,000,000;1120;586;534;65;36;1
293600;Arson and Plunder: Unleashed;Violent, Action, Adventure, Indie, Massively Multiplayer, RPG;20,000 - 50,000;39;53;-14;376;376;0
293660;TRI: Of Friendship and Madness;Strategy;50,000 - 100,000;408;61;347;502;689;1
293680;Cinders;Action, Indie, RPG;20,000 - 50,000;664;98;566;0;0;1
293720;Dark Raid;Action, Adventure, Indie;20,000 - 50,000;29;107;-78;1970;3918;0
293740;Road Not Taken;Indie, RPG;50,000 - 100,000;271;59;212;102;133;1
293760;Automation - The Car Company Tycoon Game;Adventure, Indie, Strategy;200,000 - 500,000;8635;695;7940;1315;1274;604
293780;Crawl;Action, Indie, Simulation, Sports;500,000 - 1,000,000;6001;332;5669;264;76;67
293840;Cult of the Wind;Action, Adventure, Indie;100,000 - 200,000;218;219;-1;22;40;0
293860;White Noise Online;Simulation, Strategy;100,000 - 200,000;451;230;221;97;150;0
293880;Dark Scavenger;Adventure, Casual, Strategy;50,000 - 100,000;201;30;171;232;266;1
293900;Pivvot;Adventure, Casual, Strategy;20,000 - 50,000;209;23;186;0;0;1
293920;Spirited Heart Deluxe;Indie, Simulation, Strategy;0 - 20,000;34;40;-6;131;131;0
293940;Kill The Bad Guy;Action, Casual, Indie;50,000 - 100,000;215;130;85;54;69;1
293960;Spice Road;Indie, Simulation, Sports;20,000 - 50,000;41;20;21;0;0;0
293980;Baron Wittard;Action, Indie, Strategy;20,000 - 50,000;8;2;6;0;0;0
294000;Knight Squad;Action, Adventure, Indie;20,000 - 50,000;322;50;272;184;241;5
294020;Merchants of Kaidan;RPG;100,000 - 200,000;330;157;173;290;323;0
294040;Loot Hero DX;Adventure, Indie;200,000 - 500,000;1055;370;685;239;239;1
294060;Aaru's Awakening;RPG;20,000 - 50,000;93;39;54;220;220;0
294100;RimWorld;Indie, Strategy;2,000,000 - 5,000,000;152729;2916;149813;9996;3945;21741
294140;They Breathe;Action, Adventure, Free to Play, Indie;100,000 - 200,000;1043;196;847;21;21;1
294160;Galcon 2: Galactic Conquest;Action, Casual, Indie, Strategy;200,000 - 500,000;706;134;572;63;79;2
294190;A-Men 2;Indie;0 - 20,000;14;13;1;595;595;0
294230;Millie;Action, Adventure, Indie;100,000 - 200,000;572;133;439;154;177;1
294280;Scooby Doo! & Looney Tunes Cartoon Universe: Adventure;Sports;0 - 20,000;24;22;2;19;19;0
294370;Crowntakers;Casual, Indie, Racing, Simulation, Sports, Early Access;50,000 - 100,000;464;159;305;227;204;2
294390;Escape The Lost Kingdom: The Forgotten Pharaoh;Action, Indie, Early Access;20,000 - 50,000;42;35;7;8;8;0
294420;7 Days to Die Dedicated Server;Action, Adventure, Indie, Simulation;50,000 - 100,000;123;36;87;0;0;122
294440;Shadowgate;Adventure, Indie;50,000 - 100,000;556;86;470;158;210;3
294460;Fenix Rage;Adventure, Casual, Indie;20,000 - 50,000;129;35;94;100;169;0
294530;Freddi Fish 2: The Case of the Haunted Schoolhouse;Action;0 - 20,000;248;8;240;182;182;7
294550;Freddi Fish 4: The Case of the Hogfish Rustlers of Briny Gulch;Action, Casual, Indie;0 - 20,000;116;6;110;5;5;7
294570;Freddi Fish 5: The Case of the Creature of Coral Cove;Action, Adventure, Indie, RPG;0 - 20,000;121;10;111;25;25;4
294580;Freddi Fish and Luther's Water Worries;Adventure, Indie, RPG, Strategy;0 - 20,000;34;17;17;0;0;0
294590;Wars and Warriors: Joan of Arc;RPG, Strategy;20,000 - 50,000;256;20;236;175;175;4
294650;Putt-Putt Goes to the Moon;Action, Casual, Indie, Strategy;0 - 20,000;181;15;166;0;0;7
294660;Putt-Putt Saves The Zoo;Action, Indie, Strategy;20,000 - 50,000;598;24;574;0;0;17
294670;Putt-Putt Travels Through Time;Adventure;20,000 - 50,000;265;19;246;8;8;12
294680;Putt-Putt Enters the Race;Casual, Indie, Strategy;20,000 - 50,000;153;9;144;1;1;8
294690;Putt-Putt Joins the Circus;Action, Adventure, Simulation;0 - 20,000;74;11;63;0;0;3
294700;Putt-Putt: Pep's Birthday Surprise;Casual, Indie;20,000 - 50,000;46;38;8;0;0;1
294710;Putt-Putt and Pep's Dog on a Stick;Action, Indie;0 - 20,000;45;10;35;0;0;0
294720;Putt-Putt and Fatty Bear's Activity Pack;Action, Adventure, Indie;0 - 20,000;77;17;60;0;0;4
294720;Putt-Putt and Fatty Bear's Activity Pack;Casual, Free to Play, Indie, RPG, Strategy;0 - 20,000;77;17;60;0;0;4
294730;Marine Park Empire;Adventure, Casual, Indie;0 - 20,000;84;20;64;0;0;5
294750;Anomaly Defenders;Action, Indie, Sports, Early Access;200,000 - 500,000;419;110;309;239;263;3
294770;Haegemonia: Legions of Iron;Casual, Indie, Simulation, Strategy;0 - 20,000;49;25;24;1;1;0
294790;Haegemonia: The Solon Heritage;Adventure, Indie;50,000 - 100,000;68;33;35;353;353;0
294810;BlazBlue: Continuum Shift Extend;Action, Adventure, Casual, Indie;100,000 - 200,000;1339;137;1202;271;96;12
294830;RECYCLE;Action, Adventure, Indie;20,000 - 50,000;132;146;-14;0;0;2
294860;Valkyria Chronicles;Action, Indie;500,000 - 1,000,000;10972;1143;9829;705;269;86
295110;Just Survive;Indie, Massively Multiplayer, RPG, Early Access;2,000,000 - 5,000,000;46549;32292;14257;4266;918;8
295250;Stranded;Indie;50,000 - 100,000;165;310;-145;109;116;1
295490;Schrodinger’s Cat And The Raiders Of The Lost Quark;Strategy;20,000 - 50,000;85;39;46;11;11;0
295550;Royal Quest;Adventure, Indie;500,000 - 1,000,000;966;404;562;98;68;1
295590;Hero Generations;Action;20,000 - 50,000;119;97;22;29;29;0
295610;Inescapable;Action, Adventure, Indie;20,000 - 50,000;48;73;-25;3;3;0
295630;Defense Zone 2;Adventure, Indie;0 - 20,000;117;20;97;89;89;7
295650;Streng Check;Action, Indie;20,000 - 50,000;6;8;-2;0;0;0
295670;Hive Jump;Simulation, Strategy;100,000 - 200,000;254;107;147;197;215;0
295690;PARTICLE MACE;Racing, Simulation, Sports, Strategy;200,000 - 500,000;1207;166;1041;125;154;0
295710;Darkwind: War on Wheels;Action, Racing;100,000 - 200,000;229;229;0;7;9;4
295730;Sweezy Gunner;Simulation, Strategy;20,000 - 50,000;187;39;148;143;143;0
295750;The Floor is Jelly;Adventure;50,000 - 100,000;343;70;273;73;125;2
295770;Rogue Shooter: The FPS Roguelike;Strategy;0 - 20,000;270;90;180;0;0;0
295790;Never Alone (Kisima Ingitchuna);Strategy;500,000 - 1,000,000;6455;1516;4939;223;204;8
295850;Vlad the Impaler;Action, Adventure;20,000 - 50,000;296;108;188;393;393;0
295850;Vlad the Impaler;Adventure, Indie;20,000 - 50,000;296;108;188;393;393;0
295870;The Dungeoning;Casual, Free to Play, Indie, Massively Multiplayer, RPG;0 - 20,000;52;22;30;0;0;0
295930;Swipecart;Action, Adventure, Indie, RPG;50,000 - 100,000;242;290;-48;91;83;0
295990;Evopollution;Indie, Simulation;20,000 - 50,000;33;93;-60;91;91;1
296010;NeonXSZ;Action, Casual, Free to Play, Indie, Simulation;0 - 20,000;84;20;64;0;0;0
296030;Qasir al-Wasat: International Edition;Adventure, Free to Play, Indie;0 - 20,000;36;9;27;0;0;0
296050;Battlepaths;Action, Indie, Early Access;200,000 - 500,000;590;260;330;318;317;1
296070;MIND: Path to Thalamus Enhanced Edition;Action, Indie, Racing, Simulation;100,000 - 200,000;906;466;440;121;135;1
296150;G-Ball;Action, Indie, Strategy;0 - 20,000;27;56;-29;0;0;0
296180;Iron Storm;Adventure, Casual, Indie, Simulation;50,000 - 100,000;84;51;33;34;67;0
296210;Brigade E5: New Jagged Union;Action, Casual, Indie;0 - 20,000;76;34;42;0;0;5
296220;Farm Frenzy 4;Indie;20,000 - 50,000;308;76;232;2;2;9
296240;The Promised Land;Action, Simulation, Strategy;20,000 - 50,000;597;98;499;1384;1384;3
296300;Ballistic Overkill;Action, Indie, Simulation;200,000 - 500,000;5370;1737;3633;2320;1550;25
296470;Mount Your Friends;Action, Indie;500,000 - 1,000,000;7250;361;6889;173;109;27
296490;GemCraft - Chasing Shadows;Action, Indie;200,000 - 500,000;3470;149;3321;394;591;107
296510;Magnetic By Nature;Adventure, Casual, Early Access;0 - 20,000;57;25;32;156;156;0
296510;Magnetic By Nature;Action, Adventure, Indie, Simulation, Strategy;0 - 20,000;57;25;32;156;156;0
296530;Coldfire Keep;Action, Adventure, Indie;0 - 20,000;45;64;-19;183;183;0
296550;Niko: Through The Dream;Adventure, Casual, Indie, RPG;20,000 - 50,000;148;45;103;0;0;2
296570;Lords of Xulima;Adventure, Casual, Indie, RPG;50,000 - 100,000;936;223;713;393;402;13
296590;Draconian Wars;Adventure, Casual, Indie, RPG;0 - 20,000;17;26;-9;0;0;0
296590;Draconian Wars;Adventure, Casual, Indie, RPG;0 - 20,000;17;26;-9;0;0;0
296650;The Great Jitters: Pudding Panic;Action, Adventure;20,000 - 50,000;47;25;22;16;23;0
296710;Monstrum;Adventure, Indie;200,000 - 500,000;2640;255;2385;133;33;15
296730;Viktor;Adventure, Indie;20,000 - 50,000;163;66;97;0;0;0
296770;Real Boxing;Casual;100,000 - 200,000;819;463;356;110;149;2
296810;Jump Tanks;Action, Adventure;0 - 20,000;4;1;3;0;0;0
296830;Lucius II;Action, Adventure;200,000 - 500,000;1212;771;441;182;229;7
296850;Al Emmo and the Lost Dutchman's Mine;Strategy;20,000 - 50,000;36;24;12;232;232;0
296870;Dreaming Sarah;Indie, Simulation;200,000 - 500,000;2328;227;2101;234;258;8
296890;Neon Shadow;Indie;20,000 - 50,000;59;13;46;0;0;0
296910;8BitBoy;Adventure;200,000 - 500,000;1410;511;899;27;27;0
296930;Ascendant;Adventure;20,000 - 50,000;157;45;112;110;110;0
296970;Renowned Explorers: International Society;Adventure;200,000 - 500,000;2502;214;2288;223;317;20
297000;Heroes of Might & Magic III - HD Edition;Adventure;1,000,000 - 2,000,000;13941;3921;10020;1248;670;1824
297020;The Culling Of The Cows;Adventure;200,000 - 500,000;2517;866;1651;229;256;3
297060;Freaking Meatbags;Simulation;20,000 - 50,000;136;21;115;0;0;0
297070;Nicolas Eymerich The Inquisitor Book II : The Village;Action, Indie, Strategy;0 - 20,000;22;14;8;0;0;0
297080;Navpoint;Action, Indie, Simulation, Strategy;0 - 20,000;13;10;3;0;0;0
297080;Navpoint;Action, Free to Play, Massively Multiplayer, Strategy;0 - 20,000;13;10;3;0;0;0
297100;Beyond Space Remastered Edition;Action, Adventure, Casual, Indie;20,000 - 50,000;57;116;-59;72;72;0
297110;Cosmic DJ;Adventure, Indie;50,000 - 100,000;935;131;804;49;49;0
297120;Heavy Bullets;Action, Free to Play, Indie, Early Access;100,000 - 200,000;1183;255;928;141;134;3
297120;Heavy Bullets;Violent, Gore, Action, Indie, Strategy;100,000 - 200,000;1183;255;928;141;134;3
297130;Titan Souls;Action, Adventure, Indie;500,000 - 1,000,000;8761;2367;6394;154;61;18
297190;Grayland;Action, Indie;0 - 20,000;26;6;20;0;0;0
297310;Pro Wrestling X;Casual, Sports;20,000 - 50,000;129;131;-2;0;0;0
297330;Arcadecraft;Indie, RPG;20,000 - 50,000;80;65;15;72;72;1
297350;The Old City: Leviathan;Action, Adventure, Indie, RPG, Early Access;20,000 - 50,000;505;191;314;1568;3096;0
297370;Hero of Many;Indie, RPG;0 - 20,000;114;16;98;0;0;0
297410;Trace Vector;Action, Casual, Indie;0 - 20,000;41;10;31;0;0;1
297450;Zombies on a Plane;Adventure, Casual, Indie;50,000 - 100,000;142;123;19;253;253;0
297470;Xsyon - Prelude;Casual, Indie, Strategy;0 - 20,000;266;95;171;0;0;6
297490;Spy Chameleon - RGB Agent;Action, Adventure, Indie, Massively Multiplayer, RPG, Simulation, Strategy;20,000 - 50,000;259;34;225;88;128;0
297570;Warrior Kings;Adventure, Indie, RPG;20,000 - 50,000;75;30;45;0;0;0
297590;Monsters Ate My Birthday Cake;Action, Indie;0 - 20,000;92;2;90;0;0;0
297620;Rocko's Quest;Adventure, Casual, Indie;0 - 20,000;35;25;10;0;0;0
297620;Rocko's Quest;Action, Indie;0 - 20,000;35;25;10;0;0;0
297660;Super Rad Raygun;Free to Play, Indie, Strategy;0 - 20,000;59;7;52;0;0;0
297750;Close Combat - Gateway to Caen;Action, Indie;100,000 - 200,000;294;139;155;67;67;9
297760;Qvadriga;Action, Adventure, Free to Play, Indie, Massively Multiplayer, RPG, Strategy;50,000 - 100,000;322;63;259;9;9;5
297860;Split/Second;Adventure, Indie;200,000 - 500,000;1409;360;1049;236;226;20
297920;Space Colony: Steam Edition;Free to Play, Strategy;100,000 - 200,000;397;117;280;92;130;4
298020;Escape The Museum;Casual, Simulation, Strategy;20,000 - 50,000;25;38;-13;0;0;0
298030;Total Annihilation;Adventure, Casual, RPG;200,000 - 500,000;2691;106;2585;3964;1945;145
298050;Master of Orion;Action, Adventure, Indie, Racing;500,000 - 1,000,000;5345;1709;3636;1156;1882;815
298110;Far Cry 4;Adventure, Indie;2,000,000 - 5,000,000;37197;7442;29755;1908;1137;668
298140;Rhiannon: Curse of the Four Branches;Casual, Indie, Strategy;50,000 - 100,000;84;51;33;225;337;0
298160;Eldevin;Strategy;200,000 - 500,000;1257;341;916;97;103;19
298180;The Desolate Hope;Action, Adventure, Indie;500,000 - 1,000,000;1139;110;1029;346;11;1
298220;Terraformer Expedition to Mars;Adventure, Casual;0 - 20,000;14;23;-9;0;0;0
298240;War Trigger 3;Action, Adventure, Indie, Racing, Simulation;1,000,000 - 2,000,000;4924;3353;1571;167;31;20
298260;Only If;Racing;500,000 - 1,000,000;3757;2209;1548;69;30;1
298280;XenoRaptor;Casual;0 - 20,000;130;25;105;0;0;0
298340;FLASHOUT 2;Adventure, Indie, RPG;20,000 - 50,000;125;95;30;0;0;0
298360;Immortal Defense;Adventure, Indie, RPG, Strategy;0 - 20,000;159;25;134;0;0;1
298380;Reef Shot;Indie, Simulation;0 - 20,000;9;4;5;0;0;0
298420;Dreii;Action, Indie;0 - 20,000;12;5;7;0;0;0
298480;Victory At Sea;Casual, Simulation, Sports;100,000 - 200,000;399;136;263;400;400;2
298480;Victory At Sea;Adventure, Casual, Indie;100,000 - 200,000;399;136;263;400;400;2
298520;Orbital Gear;Casual, Indie, Simulation, Sports, Strategy;200,000 - 500,000;1466;301;1165;119;104;0
298560;Captain Forever Remix;Action, Indie, Strategy, Early Access;20,000 - 50,000;295;68;227;28;28;0
298600;Lovely Planet;Action, Adventure;200,000 - 500,000;2340;229;2111;178;206;2
298610;Ylands;Action, Adventure, Casual, Indie;500,000 - 1,000,000;4158;2726;1432;500;68;217
298630;The Escapists;Indie;1,000,000 - 2,000,000;13924;1521;12403;546;371;65
298790;Rock Boshers DX: Directors Cut;Action;0 - 20,000;44;5;39;0;0;0
298820;Millennium 2 - Take Me Higher;Free to Play, Massively Multiplayer, RPG;20,000 - 50,000;48;12;36;213;234;1
298830;Millennium 3 - Cry Wolf;Adventure, Indie;20,000 - 50,000;40;7;33;199;233;1
298840;Millennium 4 - Beyond Sunset;Simulation, Sports;20,000 - 50,000;36;6;30;94;120;0
298850;Millennium 5 - The Battle of the Millennium;Adventure, Casual, Indie;20,000 - 50,000;31;17;14;0;0;0
298900;Space Hulk: Deathwing;Action, Casual, Indie;200,000 - 500,000;3042;2613;429;267;253;3
298930;Darkness Within 1: In Pursuit of Loath Nolder;Action, Casual, Indie;100,000 - 200,000;377;135;242;930;968;2
298950;Darkness Within 2: The Dark Lineage;Action, Adventure, Indie, RPG;50,000 - 100,000;149;65;84;377;377;1
299020;Runaway Express Mystery;Casual, Sports;20,000 - 50,000;34;14;20;0;0;0
299030;Blood: One Unit Whole Blood;Casual, Simulation, Strategy;100,000 - 200,000;1210;115;1095;114;208;1
299050;Blood II: The Chosen + Expansion;Action, Casual, Indie;20,000 - 50,000;218;225;-7;36;39;2
299070;Warrior Kings: Battles;Indie, Simulation;50,000 - 100,000;227;20;207;0;0;10
299090;Cosplay Maker;Action, Indie;0 - 20,000;25;18;7;0;0;0
299100;Back To Life 2;Adventure, Indie;0 - 20,000;3;6;-3;0;0;0
299110;Theatre Of The Absurd;Action, Adventure, Indie;50,000 - 100,000;202;51;151;204;204;0
299150;Empress Of The Deep;Action, Indie;20,000 - 50,000;94;45;49;114;114;0
299150;Empress Of The Deep;Action, Adventure, Indie, Simulation;20,000 - 50,000;94;45;49;114;114;0
299170;Vault Cracker;Action, Free to Play, Indie, Massively Multiplayer, RPG, Simulation;0 - 20,000;21;23;-2;0;0;0
299180;Millionaire Manor;Action, Casual, Indie;20,000 - 50,000;45;39;6;219;219;0
299250;European Ship Simulator;Design & Illustration, Photo Editing;100,000 - 200,000;294;383;-89;0;0;3
299260;Commando Jack;Action;200,000 - 500,000;279;272;7;220;228;0
299340;Habitat;Action, Strategy;20,000 - 50,000;100;153;-53;728;728;0
299360;Block N Load;Adventure;2,000,000 - 5,000,000;12050;3324;8726;758;85;8
299380;Masquerade: The Baubles of Doom;Action, Indie;0 - 20,000;16;46;-30;321;321;0
299400;XING: The Land Beyond;Casual;20,000 - 50,000;260;27;233;0;0;2
299420;CubeGun;Casual;100,000 - 200,000;185;131;54;112;160;0
299480;Rogue Stormers;Casual;200,000 - 500,000;659;298;361;126;149;6
299500;International Snooker;Casual;100,000 - 200,000;376;224;152;9;14;17
299540;Heroes Rise: The Prodigy;Action, Adventure, Casual, Indie, Simulation, Strategy;20,000 - 50,000;321;70;251;3;3;2
299600;Dragon Fin Soup;Action, Adventure, Racing;50,000 - 100,000;169;120;49;0;0;0
299660;6180 the moon;Action, Adventure;20,000 - 50,000;438;43;395;0;0;0
299680;Tengami;Action, Indie;100,000 - 200,000;1310;308;1002;83;101;0
299720;Terrorhedron Tower Defense;Adventure, Indie;200,000 - 500,000;958;184;774;409;542;1
299740;Miscreated;Action;500,000 - 1,000,000;21093;10653;10440;846;348;145
299780;Noir Syndrome;Adventure, Indie, Strategy;20,000 - 50,000;116;59;57;217;217;0
299800;The Land of Eyas;Adventure, Indie, Strategy;20,000 - 50,000;57;9;48;0;0;0
299840;Metal Planet;Action, Indie;0 - 20,000;13;42;-29;419;452;0
299910;Forgotten Myths CCG;Action, Adventure;20,000 - 50,000;39;38;1;0;0;0
299950;GET EVEN;Casual;50,000 - 100,000;1176;365;811;241;252;5
300040;Divine Souls F2P MMO;Action, Indie;500,000 - 1,000,000;441;445;-4;18;29;0
300060;ADR1FT;Indie, Simulation;100,000 - 200,000;951;766;185;75;99;0
300080;Total War Battles: KINGDOM;Indie, Simulation;500,000 - 1,000,000;1872;1729;143;74;42;3
300160;Bridge!;Adventure;20,000 - 50,000;11;35;-24;0;0;0
300220;Victim of Xen;Adventure;200,000 - 500,000;267;170;97;224;271;0
300260;Planetoid Pioneers;Adventure, Casual;0 - 20,000;245;134;111;1243;1243;0
300280;Adventurezator: When Pigs Fly;Adventure, Casual;20,000 - 50,000;72;30;42;196;196;0
300300;Ichi;Adventure, Casual;100,000 - 200,000;544;88;456;108;123;2
300320;The Few;Adventure;50,000 - 100,000;95;90;5;141;145;0
300340;Lemma;Action;20,000 - 50,000;196;36;160;63;81;0
300360;Evil Pumpkin: The Lost Halloween;Action;20,000 - 50,000;55;35;20;251;290;0
300380;Road Redemption;Action, Adventure, Casual, Indie;500,000 - 1,000,000;8834;1930;6904;399;175;31
300400;Unpossible;Action, Indie, RPG, Strategy;20,000 - 50,000;110;19;91;0;0;0
300510;Them - The Summoning;Casual, Indie, Simulation;20,000 - 50,000;15;38;-23;0;0;0
300540;Sweet Lily Dreams;Adventure, Casual, Indie, RPG, Strategy;100,000 - 200,000;74;68;6;345;335;0
300550;Shadowrun: Dragonfall - Director's Cut;Simulation, Strategy;500,000 - 1,000,000;5192;606;4586;1389;1082;53
300570;Infinifactory;Action, Adventure;200,000 - 500,000;2149;118;2031;1630;2253;15
300580;GALAK-Z;Adventure;200,000 - 500,000;377;138;239;389;376;0
300610;Pure Pool;Adventure;20,000 - 50,000;313;233;80;162;162;3
300620;Flyhunter Origins;Adventure;0 - 20,000;27;4;23;0;0;0
300630;Pure Chess Grandmaster Edition;Adventure;0 - 20,000;164;62;102;0;0;6
300760;Epsilon;Casual, Free to Play, Indie;50,000 - 100,000;58;55;3;417;439;0
300820;Disney•Pixar Toy Story 3: The Video Game;Adventure, Casual;200,000 - 500,000;735;297;438;1505;1379;154
300840;JUJU;Simulation;0 - 20,000;97;5;92;0;0;0
300900;Hippocampal: The White Sofa;Casual;20,000 - 50,000;36;68;-32;0;0;0
300970;Fiesta Online NA;RPG, Strategy;200,000 - 500,000;395;278;117;575;510;34
301050;Night Shift;Adventure, Casual, Strategy;0 - 20,000;74;41;33;173;173;0
301120;Eastside Hockey Manager;Action;200,000 - 500,000;1064;180;884;6200;6289;161
301150;The Treasures of Montezuma 4;Action, Adventure, Indie, RPG, Simulation, Strategy;20,000 - 50,000;447;94;353;130;130;6
301190;Frederic: Resurrection of Music;Action, Casual, Free to Play, Indie, Massively Multiplayer, Early Access;100,000 - 200,000;796;155;641;213;253;1
301200;Frederic: Evil Strikes Back;Action, Indie;200,000 - 500,000;657;125;532;217;260;1
301220;Legends of Persia;Casual, Indie;50,000 - 100,000;22;153;-131;3916;3916;0
301250;SPORT1 Live : Duel;Action, Free to Play, Indie, Simulation, Strategy;0 - 20,000;3;8;-5;0;0;0
301260;Gardens Inc. 2: The Road to Fame;Adventure, Indie;0 - 20,000;47;7;40;0;0;3
301300;Chicken Invaders 4;Action, Indie, Racing;20,000 - 50,000;424;11;413;12;12;8
301320;NoLimits 2 Roller Coaster Simulation;Adventure, Casual;;;;0;;;
301360;Kill Fun Yeah;Casual, Indie, Strategy;0 - 20,000;38;46;-8;0;0;0
301380;Date Warp;Action, Indie;0 - 20,000;144;17;127;0;0;0
301420;Third Eye Crime;Action, Adventure, Indie, RPG, Early Access;0 - 20,000;33;15;18;0;0;0
301460;Electronic Super Joy: Groove City;Action, Free to Play, Early Access;50,000 - 100,000;455;110;345;64;72;0
301500;BOMB: Who let the dogfight?;Action, Indie;0 - 20,000;47;27;20;0;0;1
301520;Robocraft;Action, Adventure, Indie;10,000,000 - 20,000,000;86102;32380;53722;1539;183;242
301540;Rhythm Destruction;Action, Adventure, Indie;50,000 - 100,000;61;70;-9;322;330;0
301560;White Night;Adventure, Casual, Indie;0 - 20,000;244;80;164;0;0;1
301640;Zombie Army Trilogy;Indie, Strategy;500,000 - 1,000,000;13584;1947;11637;350;204;53
301650;Battlezone 98 Redux;Adventure, Indie;100,000 - 200,000;828;73;755;143;143;18
301670;Salammbô: Battle for Carthage;Action, Adventure, Indie;20,000 - 50,000;56;20;36;0;0;0
301680;Psichodelya;Adventure;20,000 - 50,000;37;60;-23;336;347;0
301690;Cobi Treasure Deluxe;Adventure;200,000 - 500,000;190;179;11;0;0;0
301700;Numba Deluxe;Action, Indie;200,000 - 500,000;168;96;72;1;1;1
301730;300 Dwarves;Action, Casual, Indie;20,000 - 50,000;38;37;1;0;0;0
301740;Castle: Never Judge a Book by its Cover;Action, Adventure, Casual, Indie;20,000 - 50,000;114;56;58;0;0;0
301750;RADical ROACH Remastered;Action, Strategy;500,000 - 1,000,000;578;496;82;333;375;1
301760;Disney•Pixar Cars 2: The Video Game;Action, Adventure, Casual, Indie;200,000 - 500,000;491;168;323;23;41;31
301830;Disney•Pixar Brave: The Video Game;Indie, Simulation;20,000 - 50,000;123;9;114;0;0;8
301840;City of Brass;Action, Adventure, Indie;0 - 20,000;576;150;426;189;189;2
301860;Submerged;Action, Casual;200,000 - 500,000;3345;1080;2265;140;170;4
301910;Saints Row: Gat out of Hell;Action;500,000 - 1,000,000;6807;2254;4553;369;344;15
301920;War of the Human Tanks - ALTeR;Action, Adventure, RPG;20,000 - 50,000;91;5;86;0;0;0
301920;War of the Human Tanks - ALTeR;Action, Adventure, RPG;20,000 - 50,000;91;5;86;0;0;0
301930;War of the Human Tanks - Limited Operations;Casual, Indie;20,000 - 50,000;29;3;26;0;0;0
301980;Disney Pirates of the Caribbean: At Worlds End;Action, Indie;20,000 - 50,000;219;70;149;23;23;18
301990;School Bus Fun;RPG;20,000 - 50,000;60;29;31;259;259;0
302010;The Blue Flamingo;Adventure, Strategy;200,000 - 500,000;279;329;-50;177;239;0
302060;Trucks & Trailers;Racing;50,000 - 100,000;332;157;175;54;100;2
302080;Bus Driver;Action, Casual, Indie;200,000 - 500,000;1563;382;1181;62;30;7
302110;Small Town Terrors: Pilgrim's Hook Collector's Edition;Action, Indie, Strategy;0 - 20,000;104;27;77;180;180;2
302130;Brink of Consciousness: Dorian Gray Syndrome Collector's Edition;Action, Adventure;50,000 - 100,000;241;39;202;216;257;0
302160;The Egyptian Prophecy: The Fate of Ramses;Indie;20,000 - 50,000;64;49;15;5;5;0
302170;The Cameron Files: The Secret at Loch Ness;Simulation, Strategy;20,000 - 50,000;44;28;16;150;150;0
302190;Amerzone: The Explorer’s Legacy;Indie;20,000 - 50,000;210;74;136;15;15;1
302210;Curse: The Eye of Isis;Free to Play, Massively Multiplayer, RPG;0 - 20,000;106;38;68;41;41;0
302240;Chernobyl Commando;Action, Adventure, Casual, Free to Play, Massively Multiplayer, RPG;50,000 - 100,000;116;382;-266;32;32;0
302250;Manhunter;Action;100,000 - 200,000;233;515;-282;304;304;0
302260;Truffle Saga;Action;20,000 - 50,000;51;69;-18;7;7;0
302270;Dungeon Defenders Eternity;Casual;100,000 - 200,000;796;796;0;498;639;0
302290;Infinite Game Works Episode 0;Action, Adventure;0 - 20,000;6;11;-5;0;0;0
302310;Dungeon of Elements;Indie, RPG;50,000 - 100,000;112;125;-13;410;478;1
302320;Storm over the Pacific;Casual, Indie, Simulation, Strategy;20,000 - 50,000;15;17;-2;0;0;1
302320;Storm over the Pacific;Action;20,000 - 50,000;15;17;-2;0;0;1
302330;Tex Murphy: Mean Streets;Casual, Indie, Strategy;50,000 - 100,000;56;26;30;334;334;0
302340;Tex Murphy: Martian Memorandum;Action, Adventure, Indie;50,000 - 100,000;36;12;24;15;15;0
302350;Tex Murphy: Under a Killing Moon;Adventure, Indie;50,000 - 100,000;123;5;118;317;317;0
302360;Tex Murphy: The Pandora Directive;Casual, Indie;20,000 - 50,000;58;8;50;533;533;1
302360;Tex Murphy: The Pandora Directive;Action;20,000 - 50,000;58;8;50;533;533;1
302370;Tex Murphy: Overseer;Action, Sports;50,000 - 100,000;22;21;1;0;0;0
302390;Necronomicon: The Dawning of Darkness;Casual, Simulation;20,000 - 50,000;71;103;-32;166;166;1
302440;Roadside Assistance Simulator;Adventure, Indie, RPG;0 - 20,000;45;41;4;0;0;0
302460;I Am Vegend - Zombiegeddon;Casual, Indie, Strategy;20,000 - 50,000;36;41;-5;461;461;0
302470;Battle Mages;Free to Play, Indie, Massively Multiplayer;50,000 - 100,000;121;42;79;853;867;8
302490;Ballad of Solar;Casual, Indie, Simulation;20,000 - 50,000;162;24;138;74;74;1
302510;Ryse: Son of Rome;Adventure, Casual;1,000,000 - 2,000,000;29001;4675;24326;413;314;92
302570;Dangerous;Indie;20,000 - 50,000;14;34;-20;4;4;0
302590;Of Guards And Thieves;Action, Adventure, Indie;500,000 - 1,000,000;3631;630;3001;168;68;9
302610;Boson X;Action, Indie, Simulation;200,000 - 500,000;1438;116;1322;647;1200;5
302650;Cyto;Action, Adventure, Casual, Free to Play, Indie;20,000 - 50,000;72;22;50;165;218;0
302670;Call to Arms;Adventure, Casual, Indie, RPG, Simulation;1,000,000 - 2,000,000;15491;4012;11479;14079;124;483
302690;Metal Dead;Animation & Modeling, Design & Illustration, Utilities;20,000 - 50,000;410;71;339;279;443;0
302710;BlazeRush;Action, Adventure, Indie;100,000 - 200,000;1258;171;1087;146;168;14
302730;Namariel Legends: Iron Lord Premium Edition;Action, Adventure, Indie;20,000 - 50,000;113;22;91;152;152;1
302790;Momodora III;Action, Adventure, Indie;50,000 - 100,000;1088;69;1019;197;220;1
302810;Divinia Chronicles: Relics of Gan-Ti;Free to Play, Simulation, Strategy;0 - 20,000;61;8;53;0;0;0
302830;BLOCKADE 3D;Audio Production, Utilities;2,000,000 - 5,000,000;15403;11033;4370;396;70;9
302850;Team Indie;Action;50,000 - 100,000;57;53;4;0;0;0
302870;Stained;Indie, Strategy;0 - 20,000;13;14;-1;0;0;0
302910;The House;Action, Indie, RPG, Early Access;0 - 20,000;34;60;-26;0;0;0
302950;Heileen 1: Sail Away;Adventure, Casual, Indie;50,000 - 100,000;64;54;10;0;0;1
302970;Radiant Defense;Adventure, Casual, Indie, Simulation;20,000 - 50,000;91;20;71;173;173;1
303210;The Beginner's Guide;Action, Indie, RPG;200,000 - 500,000;16278;2354;13924;140;101;5
303260;TRISTOY;Action, Strategy, Early Access;20,000 - 50,000;73;54;19;273;273;0
303290;OZMAFIA!!;Adventure, Indie, Simulation, Strategy;20,000 - 50,000;501;97;404;0;0;2
303310;The House in Fata Morgana;Indie, RPG, Strategy;50,000 - 100,000;3034;145;2889;2185;2191;40
303340;Concursion;Action, Casual, Indie, Simulation, Strategy, Early Access;20,000 - 50,000;43;33;10;160;160;1
303390;Dead Bits;Casual, Indie, Simulation, Early Access;2,000,000 - 5,000,000;5006;3453;1553;2229;332;4
303430;Roundabout;Action, Adventure, Indie, RPG, Simulation, Strategy, Early Access;20,000 - 50,000;514;38;476;420;650;1
303470;Rush for Glory;Adventure, Indie, RPG;20,000 - 50,000;90;50;40;5;5;0
303510;Dungeons: The Eye of Draconus;Casual, Indie;100,000 - 200,000;89;102;-13;213;213;0
303530;Sentris;Adventure, Indie;0 - 20,000;23;13;10;0;0;0
303550;Adventures of Pip;Action, Indie;20,000 - 50,000;220;29;191;21;21;1
303590;Hidden in Plain Sight;Casual, Indie;20,000 - 50,000;465;5;460;137;203;1
303680;FATE: The Traitor Soul;RPG, Simulation, Strategy, Early Access;20,000 - 50,000;387;30;357;131;131;17
303690;FATE: The Cursed King;Design & Illustration, Utilities;100,000 - 200,000;360;45;315;144;187;21
303720;#KILLALLZOMBIES;Adventure, Indie;50,000 - 100,000;237;60;177;323;326;1
303790;Faery - Legends of Avalon;Adventure, Indie;100,000 - 200,000;497;187;310;582;823;2
303800;The Witcher Adventure Game;Indie, Simulation, Strategy;100,000 - 200,000;975;302;673;98;89;2
303830;Motorcycle Club;Action, Indie, RPG, Simulation, Early Access;20,000 - 50,000;37;87;-50;240;240;1
303840;Point Perfect;Action;20,000 - 50,000;141;65;76;161;208;1
303860;Machines At War 3;Action, Adventure, Casual, Indie;0 - 20,000;56;15;41;1410;1410;1
303870;Blinding Dark;Action, Strategy;20,000 - 50,000;19;40;-21;9;16;0
303880;Triblaster;Casual, Indie, Simulation, Strategy;0 - 20,000;11;21;-10;0;0;0
303910;Time of Fury;Massively Multiplayer, RPG;0 - 20,000;22;19;3;0;0;0
303940;CAPSULE;Casual, Strategy;20,000 - 50,000;125;41;84;0;0;0
304030;ArcheAge;Action, Indie, Strategy;1,000,000 - 2,000,000;3750;3431;319;2855;302;107
304050;Trove;RPG, Simulation, Strategy;10,000,000 - 20,000,000;71780;17274;54506;2713;193;1834
304150;Bloodbath;Action, Racing, Sports;0 - 20,000;8;35;-27;10;10;0
304170;Kick-Ass 2;Simulation;100,000 - 200,000;58;196;-138;229;229;0
304190;Bloonz Toonz;Casual, Indie;20,000 - 50,000;1;4;-3;0;0;0
304240;Resident Evil;Action, Adventure, Indie;1,000,000 - 2,000,000;17448;1394;16054;559;155;203
304290;Heroes Rise: The Hero Project;Casual, Indie, Simulation, Strategy;0 - 20,000;133;32;101;0;0;1
304350;Wildlife Park 2;Simulation, Strategy;100,000 - 200,000;346;146;200;63;63;5
304390;FOR HONOR;Indie, RPG;5,000,000 - 10,000,000;86838;39089;47749;2190;547;4467
304410;Hexcells Infinite;Strategy;100,000 - 200,000;3666;106;3560;2667;4042;222
304430;INSIDE;Simulation, Strategy;2,000,000 - 5,000,000;42168;1500;40668;331;246;130
304460;Qora;Strategy;20,000 - 50,000;321;155;166;161;240;4
304500;Rooms: The Main Building;Indie, Simulation, Strategy;20,000 - 50,000;139;28;111;97;150;0
304530;Agents of Mayhem;Action, Adventure;200,000 - 500,000;2639;1832;807;467;306;7
304540;FreakOut: Extreme Freeride;Casual, Indie;0 - 20,000;57;13;44;0;0;0
304580;CITYCONOMY: Service for your City;Action, Indie;50,000 - 100,000;190;202;-12;51;51;0
304650;SUNLESS SEA;Adventure, Indie;1,000,000 - 2,000,000;7148;1443;5705;541;276;77
304670;Aeon Command;Free to Play, Massively Multiplayer, Strategy;100,000 - 200,000;301;84;217;47;71;8
304670;Aeon Command;RPG;100,000 - 200,000;301;84;217;47;71;8
304690;Star Sonata 2;Adventure, Indie, RPG;100,000 - 200,000;135;78;57;0;0;12
304730;Train Fever;Action, Adventure, Indie;200,000 - 500,000;2192;1228;964;1425;1023;30
304750;Voodoo Chronicles: The First Sign HD - Director’s Cut Edition;Adventure, Casual, Indie;0 - 20,000;3;27;-24;0;0;0
304810;TesserAct;Adventure, Indie, RPG;0 - 20,000;5;11;-6;0;0;0
304850;Worlds;Action, Indie, Early Access;0 - 20,000;48;5;43;0;0;1
304870;Stones of Harlath;Action, Indie, Simulation, Early Access;20,000 - 50,000;7;1;6;0;0;0
304910;Sky Gamblers: Storm Raiders;Action, Adventure, Indie;50,000 - 100,000;191;46;145;0;0;2
304930;Unturned;Action, Adventure, Indie, RPG, Early Access;20,000,000 - 50,000,000;462293;42949;419344;7087;321;49493
304950;Castaway Paradise - live among the animals;Action, Casual, Indie;20,000 - 50,000;404;163;241;428;609;0
304970;SolidFace Parametric CAD Modeler 2D/3D;Adventure, Casual, Simulation;0 - 20,000;1;0;1;0;0;0
305010;Toxic Bunny HD;Action, Indie, RPG;0 - 20,000;10;36;-26;0;0;0
305050;Outland;Casual, Indie, Strategy;500,000 - 1,000,000;3120;735;2385;218;120;3
305070;FIST OF AWESOME;Indie;20,000 - 50,000;209;136;73;45;81;0
305260;Battle Islands;Adventure, Casual, Free to Play, Indie, RPG;500,000 - 1,000,000;2586;821;1765;117;38;30
305280;Cakewalk Loop Manager;Action;50,000 - 100,000;22;3;19;1;1;0
305380;Blue Estate The Game;Action;50,000 - 100,000;1323;128;1195;211;211;1
305390;World War 2: Time of Wrath;Sports;20,000 - 50,000;29;38;-9;0;0;0
305460;FranknJohn;Casual, Indie, Strategy;0 - 20,000;13;9;4;0;0;0
305480;Heileen 2: The Hands Of Fate;Strategy;0 - 20,000;25;21;4;0;0;0
305490;Heileen 3: New Horizons;Adventure, Indie;0 - 20,000;45;28;17;0;0;1
305500;Trapped Dead: Lockdown;Adventure, Indie;50,000 - 100,000;97;78;19;17;17;1
305510;Servo;Action, Indie;0 - 20,000;48;60;-12;258;448;0
305510;Servo;Action, Adventure, Indie, RPG, Strategy;0 - 20,000;48;60;-12;258;448;0
305620;The Long Dark;Action, Indie;2,000,000 - 5,000,000;87582;8453;79129;1246;330;2461
305640;Shattered Planet;RPG;200,000 - 500,000;420;191;229;83;107;2
305660;Infect and Destroy;Adventure, Indie, RPG, Strategy;0 - 20,000;20;35;-15;6;6;0
305700;Infinite Scuba;Action, Adventure, Racing;0 - 20,000;9;7;2;0;0;0
305720;Heroes of Issachar;Simulation, Strategy;0 - 20,000;11;5;6;0;0;0
305740;Pitiri 1977;Casual, Indie, Simulation, Strategy;0 - 20,000;65;49;16;94;108;0
305760;Redirection;Action;0 - 20,000;135;7;128;0;0;1
305780;Echo of the Wilds;Action, Adventure, Indie, RPG, Simulation, Early Access;100,000 - 200,000;138;42;96;470;470;1
305800;POP: Methodology Experiment One;Casual, Indie, Simulation, Strategy;0 - 20,000;51;33;18;0;0;0
305800;POP: Methodology Experiment One;Casual, Indie, Simulation, Strategy;0 - 20,000;51;33;18;0;0;0
305820;Cute Things Dying Violently;Casual, Indie, Simulation, Strategy;0 - 20,000;37;13;24;1571;1571;0
305840;Shallow Space;Action, Adventure, Indie;;;;0;;;
305860;AutoTileGen;Action, Simulation;0 - 20,000;27;18;9;0;0;0
305880;Leona's Tricky Adventures;Sports;;;;0;;;
305920;Another Perspective;Casual, Indie, Simulation, Strategy;50,000 - 100,000;274;40;234;54;85;0
305960;Dragon: The Game;Action, Adventure;20,000 - 50,000;249;518;-269;40;40;0
305980;Heavy Fire: Afghanistan;Action, Casual, Indie;50,000 - 100,000;185;148;37;96;109;0
306000;Super Dungeon Bros;Action, Adventure, Indie;20,000 - 50,000;49;68;-19;0;0;0
306020;Bloons TD 5;Action, Indie, Racing, Simulation, Sports, Early Access;500,000 - 1,000,000;9554;544;9010;2266;1000;267
306040;The Howler;Indie, Simulation, Strategy;200,000 - 500,000;1622;465;1157;173;166;1
306130;The Elder Scrolls Online;Adventure;5,000,000 - 10,000,000;107027;23705;83322;7285;1385;19599
306200;The Happy Hereafter;Simulation, Strategy;100,000 - 200,000;303;82;221;229;201;2
306260;Selknam Defense;Adventure;0 - 20,000;23;32;-9;25;25;1
306290;7,62 Hard Life;Casual, Indie;50,000 - 100,000;365;93;272;0;0;33
306350;Slipstream 5000;Indie, Strategy;200,000 - 500,000;286;94;192;205;216;1
306370;World of Subways 1 – The Path;Action, Casual;50,000 - 100,000;68;39;29;0;0;0
306410;Crystals of Time;Action, Indie, RPG;200,000 - 500,000;659;355;304;236;215;0
306480;Wildlife Park 2 - Crazy Zoo;Action, Indie;0 - 20,000;38;16;22;0;0;0
306490;Railroad Pioneer;Indie, Strategy;0 - 20,000;143;95;48;24;24;1
306550;Runers;Indie, Massively Multiplayer, RPG, Early Access;20,000 - 50,000;226;50;176;141;141;0
306620;Frontline : Road to Moscow;Action, Indie, Simulation, Early Access;20,000 - 50,000;32;26;6;0;0;0
306630;Civil War II;Adventure, Indie;20,000 - 50,000;228;63;165;0;0;15
306640;Battle Academy 2: Eastern Front;Action, Indie, Racing;20,000 - 50,000;179;14;165;0;0;6
306660;Ultimate General: Gettysburg;Action, Indie, RPG, Early Access;200,000 - 500,000;2126;496;1630;100;154;16
306670;Overlord: Fellowship of Evil;Action, Indie, Early Access;100,000 - 200,000;146;486;-340;193;248;1
306680;Lexica;Adventure, Indie, RPG, Simulation, Strategy;50,000 - 100,000;266;90;176;24;24;1
306700;Iron Fisticle;Indie, Strategy;50,000 - 100,000;337;60;277;302;326;2
306760;Obduction;Casual, Indie, Simulation;200,000 - 500,000;2780;695;2085;524;397;23
306930;BattleSpace;Action, Indie, RPG;100,000 - 200,000;29;54;-25;0;0;0
306950;Heroes & Legends: Conquerors of Kolhar;Adventure;20,000 - 50,000;52;39;13;224;224;0
307010;Northmark: Hour of the Wolf;Free to Play, Indie;20,000 - 50,000;251;46;205;0;0;0
307030;Fractured Soul;Simulation, Strategy;0 - 20,000;21;1;20;0;0;0
307050;Shan Gui (山桂);RPG;100,000 - 200,000;1637;630;1007;167;209;0
307050;Shan Gui (山桂);Adventure;100,000 - 200,000;1637;630;1007;167;209;0
307070;Memories of a Vagabond;Simulation, Strategy;100,000 - 200,000;950;232;718;217;239;0
307090;Fancy Skulls;Simulation, Strategy;50,000 - 100,000;224;86;138;95;95;0
307110;We Need To Go Deeper;Action, Adventure, Indie, RPG, Strategy;500,000 - 1,000,000;4483;670;3813;653;671;38
307130;Asteria;Racing, Simulation, Sports;20,000 - 50,000;132;104;28;95;159;0
307150;Survival Games;Simulation;0 - 20,000;25;26;-1;137;137;0
307170;Borealis;Action, Indie;20,000 - 50,000;299;200;99;49;47;0
307190;Nicole;Action, Indie;0 - 20,000;81;37;44;0;0;0
307210;Will Fight for Food: Super Actual Sellout: Game of the Hour;Action;20,000 - 50,000;49;37;12;145;145;0
307230;I, Zombie;Action, Adventure;200,000 - 500,000;2030;381;1649;182;150;4
307290;Velvet Sundown;Action, Indie;500,000 - 1,000,000;1091;722;369;63;77;0
307340;Platypus;Action, Adventure, Indie;50,000 - 100,000;434;45;389;294;308;0
307350;Nux;Action, Adventure, Indie, Simulation;100,000 - 200,000;183;283;-100;243;235;0
307430;Othello;Simulation, Sports, Strategy;20,000 - 50,000;71;29;42;97;97;0
307560;Run For Rum;Action, Indie, RPG, Strategy;20,000 - 50,000;8;6;2;0;0;0
307570;A Golden Wake;Action;20,000 - 50,000;191;69;122;110;148;2
307580;Technobabylon;Indie, Strategy;100,000 - 200,000;1297;69;1228;119;147;6
307590;Penarium;Action;50,000 - 100,000;313;55;258;285;321;0
307620;Curses 'N Chaos;Action, Adventure, Indie;20,000 - 50,000;71;49;22;7;7;0
307640;Stick RPG 2: Director's Cut;Strategy;50,000 - 100,000;729;137;592;659;659;6
307670;Hard West;RPG, Strategy;200,000 - 500,000;3337;1016;2321;522;298;43
307690;Sleeping Dogs: Definitive Edition;Action, Simulation;2,000,000 - 5,000,000;47749;3811;43938;1173;455;610
307760;Zoo Park;Action, Simulation;0 - 20,000;168;125;43;38;38;1
307770;Wildlife Park 2 - Horses;Action;0 - 20,000;56;17;39;0;0;0
307780;Mortal Kombat X;Action;2,000,000 - 5,000,000;40564;7970;32594;1443;573;603
307880;Savage Lands;Casual, Indie;200,000 - 500,000;3678;2933;745;430;163;11
307900;Wildlife Park 2 - Marine World;Action, Adventure, Indie;0 - 20,000;29;11;18;0;0;2
307920;Wildlife Park 2 - Farm World;Action, Adventure;0 - 20,000;24;9;15;0;0;3
307930;Wildlife Park 2 - Dino World;Adventure;20,000 - 50,000;44;26;18;0;0;1
307960;IL-2 Sturmovik: Battle of Stalingrad;Action, Adventure, Indie;500,000 - 1,000,000;5915;1443;4472;990;505;334
307980;Cricket Captain 2014;RPG, Simulation, Strategy, Early Access;0 - 20,000;35;22;13;0;0;3
307990;Wildlife Park 2 - Fantasy;RPG, Strategy;20,000 - 50,000;38;41;-3;9;9;1
308000;Gold Rush! Classic;Action, Adventure, Indie, Massively Multiplayer, Simulation, Strategy, Early Access;100,000 - 200,000;257;106;151;325;301;0
308040;Back to Bed;Action, Adventure;1,000,000 - 2,000,000;2082;489;1593;168;192;3
308060;Black The Fall;Action, Casual, Indie, Racing, Simulation;200,000 - 500,000;1217;345;872;304;430;4
308080;Wing Breakers;Action, Indie;0 - 20,000;104;39;65;0;0;0
308173;Hegemony III: Clash of the Ancients;Action, Indie;50,000 - 100,000;390;91;299;0;0;8
308180;Jacob Jones and the Bigfoot Mystery : Episode 2;Action, Adventure;0 - 20,000;20;3;17;0;0;0
308270;Buzz Aldrin's Space Program Manager;Adventure, Casual, Simulation;20,000 - 50,000;354;99;255;0;0;4
308360;LogiGun;Action, Adventure, Indie;0 - 20,000;50;11;39;0;0;0
308400;Cube Samurai: RUN!;Indie, RPG, Strategy;0 - 20,000;2;0;2;0;0;0
308420;Ziggurat;Action;200,000 - 500,000;3205;512;2693;395;300;11
308440;Pushcat;Action, Adventure;20,000 - 50,000;84;11;73;0;0;1
308460;War in a Box: Paper Tanks;Action, Indie, RPG, Early Access;20,000 - 50,000;137;57;80;9;15;0
308520;Minimon;Action, Indie, Racing;0 - 20,000;38;43;-5;0;0;0
308540;SLEEPOVER;Casual, Indie, Simulation, Strategy;0 - 20,000;20;11;9;0;0;0
308560;City Quest;Casual;0 - 20,000;31;10;21;0;0;0
308580;Orborun;Adventure, Indie, RPG, Simulation;100,000 - 200,000;312;98;214;146;285;0
308600;Gene Shift Auto;Action, Indie, RPG;2,000,000 - 5,000,000;1785;397;1388;1200;323;28
309900;Super Sky Arena;Simulation;0 - 20,000;32;6;26;0;0;0
310060;Knights of Pen and Paper 2;Action, Indie;200,000 - 500,000;2109;313;1796;478;605;23
310070;The Nightmare Cooperative;Action, Indie;20,000 - 50,000;62;59;3;46;64;0
310080;Hatoful Boyfriend;Action, Indie, Strategy, Early Access;200,000 - 500,000;6495;428;6067;123;101;7
310110;NS2: Combat;Action, Adventure;50,000 - 100,000;129;127;2;336;336;0
310360;Higurashi When They Cry Hou - Ch.1 Onikakushi;Casual, Indie, Strategy;100,000 - 200,000;3775;168;3607;358;520;23
310370;The Way of Life Free Edition;Action, Adventure;500,000 - 1,000,000;4759;1659;3100;24;10;1
310390;Advanced Tactics Gold;Action, Free to Play, Indie, Early Access;0 - 20,000;117;22;95;0;0;7
310450;Steel & Steam: Episode 1;Action, Adventure, Indie, RPG;20,000 - 50,000;31;66;-35;51;51;0
310460;Corto Maltese - Secrets of Venice;Action, Adventure, Indie, Early Access;0 - 20,000;8;25;-17;0;0;0
310470;Grand Ages: Medieval;Action, Adventure, Indie, RPG;100,000 - 200,000;899;1010;-111;1260;1242;22
310490;Crookz - The Big Heist;Action, Adventure, Indie;20,000 - 50,000;256;58;198;218;218;1
310510;Deathtrap;Action, Adventure, Indie;200,000 - 500,000;1641;320;1321;180;183;17
310560;DiRT Rally;Casual, Free to Play, Indie, Strategy;2,000,000 - 5,000,000;33851;4677;29174;672;155;255
310640;European Fishing;Indie, RPG;0 - 20,000;6;23;-17;0;0;1
310700;Super Win the Game;Action, Indie, Simulation;50,000 - 100,000;547;69;478;27;27;1
310740;NEON STRUCT;Strategy;50,000 - 100,000;269;57;212;810;857;0
310790;Geometry Wars 3: Dimensions Evolved;Simulation, Strategy;100,000 - 200,000;1247;143;1104;176;267;9
310810;Shiftlings;Strategy;50,000 - 100,000;71;26;45;125;242;0
310830;Retrobooster;Strategy;0 - 20,000;11;2;9;0;0;0
310850;Onikira - Demon Killer;Indie, Strategy;100,000 - 200,000;139;216;-77;84;156;0
310870;The Tower;Strategy;20,000 - 50,000;15;87;-72;0;0;0
310880;Basketball Pro Management 2015;Simulation, Strategy;0 - 20,000;23;39;-16;0;0;0
310890;Breach & Clear: Deadline Rebirth (2016);Strategy;100,000 - 200,000;466;386;80;559;634;2
310950;Street Fighter V;Free to Play, Simulation, Strategy;2,000,000 - 5,000,000;26790;13758;13032;2943;404;2625
310970;Legions of Ashworld;Action, Indie;20,000 - 50,000;27;16;11;0;0;1
310990;Man in a Maze: Deathmatch;Action, Adventure, Indie;0 - 20,000;6;3;3;0;0;0
311010;The Way;Action, Indie;100,000 - 200,000;983;184;799;192;164;2
311040;Rulers of Nations;Action, Adventure, RPG;50,000 - 100,000;81;82;-1;0;0;4
311060;Battle Mages: Sign of Darkness;Action, RPG;0 - 20,000;98;25;73;152;231;3
311060;Battle Mages: Sign of Darkness;RPG, Strategy;0 - 20,000;98;25;73;152;231;3
311080;Echelon;Action;20,000 - 50,000;62;72;-10;117;204;14
311100;Echelon: Wind Warriors;Indie, Strategy;20,000 - 50,000;61;25;36;572;1092;3
311120;The Stalin Subway: Red Veil;Action, Indie;200,000 - 500,000;249;268;-19;133;157;1
311140;The Stalin Subway;Action;200,000 - 500,000;343;229;114;122;169;2
311170;Moonlight Minions;Action, Adventure;20,000 - 50,000;21;24;-3;0;0;0
311210;Call of Duty: Black Ops III;Action, Adventure;5,000,000 - 10,000,000;129364;28940;100424;3361;1290;7919
311240;Zero Escape: Zero Time Dilemma;Casual, Indie, Strategy;1,000,000 - 2,000,000;2839;489;2350;417;766;67
311250;Doorways: The Underworld;RPG;100,000 - 200,000;265;114;151;177;216;1
311260;The Guild 3;Action, Adventure;200,000 - 500,000;3954;2390;1564;1114;1297;219
311290;SpellForce 3 Reforced;Adventure, RPG, Strategy;500,000 - 1,000,000;5115;1613;3502;1229;1209;60
311310;Naval Action;Adventure, RPG;500,000 - 1,000,000;6316;4516;1800;2738;3306;711
311340;METAL GEAR SOLID V: GROUND ZEROES;Action, Casual, Indie;1,000,000 - 2,000,000;12238;2458;9780;267;144;65
311400;OCEAN CITY RACING;Sports;100,000 - 200,000;245;449;-204;1;1;0
311480;Vertical Drop Heroes HD;Action, Indie, Strategy;100,000 - 200,000;586;139;447;76;68;0
311490;Spirit Run - Fire vs. Ice;Adventure;0 - 20,000;17;16;1;0;0;0
311560;Assassin’s Creed Rogue;Simulation, Strategy;1,000,000 - 2,000,000;11161;1992;9169;1065;588;151
311680;Flower Shop: Winter In Fairbrook;Action, Adventure, Free to Play, Indie;0 - 20,000;66;34;32;0;0;0
311690;Enter the Gungeon;Simulation;2,000,000 - 5,000,000;68739;2888;65851;1905;569;1196
311720;Sproggiwood;Adventure, Indie, RPG;100,000 - 200,000;447;105;342;295;534;0
311730;DEAD OR ALIVE 5 Last Round: Core Fighters;Action, Adventure;500,000 - 1,000,000;6074;2977;3097;317;20;48
311770;LEGO Pirates of the Caribbean: The Video Game;Action, Indie, Strategy;200,000 - 500,000;3102;307;2795;583;393;378
311800;Black Ice;Adventure, Indie, Early Access;20,000 - 50,000;545;27;518;475;475;0
311820;RC Mini Racers;Indie;20,000 - 50,000;88;45;43;5;5;1
311840;Wildlife Park;Adventure, Indie;0 - 20,000;50;28;22;0;0;0
311850;Zombie Solitaire;Simulation;20,000 - 50,000;106;42;64;0;0;0
311860;Data Hacker: Initiation;Casual;1,000,000 - 2,000,000;143;83;60;300;316;0
311870;Super Trench Attack!;Adventure;50,000 - 100,000;1152;106;1046;143;187;0
311910;DIG IT! - A Digger Simulator;Action;50,000 - 100,000;122;75;47;171;171;1
311930;Tinertia;Racing;;;;0;;;
311940;P-3 Biotic;Casual, Indie, RPG, Simulation;0 - 20,000;4;1;3;0;0;0
311980;Isomer;Adventure, Casual;0 - 20,000;12;61;-49;0;0;0
312010;Bird Assassin;Action, Indie, Simulation;0 - 20,000;299;39;260;7;7;0
312020;Bounders and Cads;Action, Indie;0 - 20,000;4;4;0;0;0;0
312050;Red Johnson's Chronicles - 1+2 - Steam Special Edition;Indie, RPG;20,000 - 50,000;24;41;-17;0;0;0
312150;Wild Warfare;Strategy;200,000 - 500,000;700;307;393;40;39;0
312200;Chasm;Strategy;100,000 - 200,000;1548;597;951;349;648;13
312210;The Fifth Day;Action, Adventure, Indie;100,000 - 200,000;365;557;-192;33;33;0
312220;Tales of Adventure 2;Simulation, Strategy;0 - 20,000;14;27;-13;0;0;0
312230;Spirits of Xanadu;Adventure, Indie, Simulation;20,000 - 50,000;327;92;235;277;299;2
312240;SEAL Team 12;Casual;0 - 20,000;18;3;15;0;0;0
312280;Simply Chess;Simulation, Strategy;500,000 - 1,000,000;2439;825;1614;91;28;68
312310;Ensign-1;Action, Adventure;0 - 20,000;6;14;-8;2;2;0
312350;Commander: The Great War;Free to Play, Indie, RPG, Strategy;20,000 - 50,000;208;51;157;183;183;9
312360;To End All Wars;Sexual Content, Nudity, Indie;20,000 - 50,000;113;63;50;0;0;5
312370;Warhammer 40,000: Armageddon;Adventure, Indie;50,000 - 100,000;695;165;530;947;833;22
312400;Frontline : Longest Day;Action, Adventure, RPG;20,000 - 50,000;4;12;-8;0;0;0
312410;Defense Zone;Adventure, Indie, Strategy;0 - 20,000;55;12;43;0;0;2
312420;Hell;Adventure;20,000 - 50,000;25;27;-2;0;0;0
312430;Sovereignty: Crown of Kings;Adventure, Indie;20,000 - 50,000;138;148;-10;0;0;0
312440;Legions of Steel;Action, Indie;0 - 20,000;22;21;1;0;0;0
312450;Order of Battle: World War II;Casual, Free to Play, Indie, Simulation, Sports, Strategy;200,000 - 500,000;1990;593;1397;377;73;409
312510;Mega Coin Squad;Action, Casual, Free to Play, Indie, Strategy;0 - 20,000;70;13;57;77;77;0
312520;Rain World;Adventure, Casual, Indie;1,000,000 - 2,000,000;10860;937;9923;674;125;2355
312530;Duck Game;Action;1,000,000 - 2,000,000;33370;1197;32173;1209;304;243
312540;Ys VI: The Ark of Napishtim;Casual, Indie, Racing;100,000 - 200,000;921;104;817;528;658;9
312560;Xanadu Next;Indie, Simulation, Sports;20,000 - 50,000;424;31;393;1062;1062;0
312560;Xanadu Next;Indie, RPG;20,000 - 50,000;424;31;393;1062;1062;0
312600;Rime Berta;Action;20,000 - 50,000;90;45;45;213;213;0
312610;METAL SLUG X;Simulation;200,000 - 500,000;2534;331;2203;107;70;55
312630;OTTTD;Action, Indie;20,000 - 50,000;252;78;174;58;58;0
312640;Power-Up;Adventure, Indie;100,000 - 200,000;149;107;42;317;352;0
312650;Battlezone Gold Edition;Adventure, Indie;0 - 20,000;277;83;194;0;0;4
312660;Sniper Elite 4;Action, Indie;2,000,000 - 5,000,000;41979;4291;37688;1095;444;1212
312670;Strange Brigade;Action, Indie, Early Access;200,000 - 500,000;5079;903;4176;461;460;63
312720;Khet 2.0;Adventure, Indie, RPG, Simulation, Strategy;100,000 - 200,000;139;15;124;0;0;0
312750;Final Fantasy IV (3D Remake);Action, Adventure, Indie;200,000 - 500,000;2056;373;1683;584;625;71
312780;Way of the Samurai 4;Action, Adventure, Free to Play, Indie;200,000 - 500,000;1325;329;996;1969;2847;66
312790;Agarest: Generations of War 2;Action, Indie;20,000 - 50,000;137;95;42;305;305;0
312790;Agarest: Generations of War 2;Action, Adventure, Casual, Indie, Early Access;20,000 - 50,000;137;95;42;305;305;0
312840;Fahrenheit: Indigo Prophecy Remastered;Casual, Indie, Simulation, Strategy;200,000 - 500,000;4274;1035;3239;318;319;18
312860;Defense Grid 2: A Matter of Endurance;Adventure, Indie, Strategy;0 - 20,000;5;13;-8;2;3;0
312900;Zoo Rampage;Indie, Sports, Strategy;50,000 - 100,000;85;42;43;0;0;0
312920;Rugby League Live 3;Action, Indie, Strategy, Early Access;20,000 - 50,000;120;35;85;0;0;2
312960;Starion Tactics;Adventure, Indie;50,000 - 100,000;72;101;-29;283;293;1
312970;My Ex-Boyfriend the Space Tyrant;Indie;20,000 - 50,000;89;33;56;0;0;0
312980;Graviteam Tactics: Mius-Front;Adventure, Indie, RPG;20,000 - 50,000;718;92;626;503;503;33
312990;The Expendabros;Action, Adventure, Indie, RPG;2,000,000 - 5,000,000;17260;495;16765;104;56;29
313010;Cities XXL;Action, Indie, Strategy;200,000 - 500,000;842;1370;-528;320;296;28
313020;Soul Gambler;Action, Indie;100,000 - 200,000;2299;339;1960;130;143;2
313040;Pixel Hunter;Indie, RPG;20,000 - 50,000;92;113;-21;0;0;0
313080;The Masterplan;Design & Illustration, Photo Editing;50,000 - 100,000;329;191;138;231;282;1
313120;Stranded Deep;Adventure, Casual;1,000,000 - 2,000,000;29797;9726;20071;801;302;698
313130;Metrocide;Simulation, Sports;50,000 - 100,000;91;76;15;235;285;0
313140;Blackbay Asylum;Action, Adventure, Indie, Early Access;200,000 - 500,000;302;243;59;255;256;0
313160;Farming Simulator 15;Adventure;500,000 - 1,000,000;12956;1166;11790;4446;1204;269
313190;Pacific Liberation Force;Action, Adventure, Indie, RPG;20,000 - 50,000;3;13;-10;0;0;0
313200;The Abbey;Action, Adventure, Indie;0 - 20,000;33;25;8;0;0;0
313210;Alpha Zylon;Action, Casual, Indie;20,000 - 50,000;102;62;40;0;0;0
313330;4x4 Dream Race;Strategy;20,000 - 50,000;17;37;-20;20;20;0
313340;Mountain;Violent, Adventure, Casual, Indie;500,000 - 1,000,000;14067;1840;12227;737;141;91
313360;The Maker's Eden;Action, Adventure, Indie;20,000 - 50,000;83;33;50;194;194;0
313360;The Maker's Eden;Action;20,000 - 50,000;83;33;50;194;194;0
313390;Vertical Strike Endless Challenge;Utilities;0 - 20,000;144;39;105;79;79;0
313400;REVOLVER360 RE:ACTOR;Utilities;50,000 - 100,000;338;27;311;212;230;0
313480;Blitzkrieg Anthology;Indie, Strategy;100,000 - 200,000;1100;112;988;796;1576;97
313500;Blitzkrieg 2 Anthology;Indie, Simulation;200,000 - 500,000;912;168;744;302;487;55
313620;The Terminal 2;Adventure, Indie;0 - 20,000;45;130;-85;0;0;0
313630;The Solus Project;Adventure, Indie;200,000 - 500,000;2020;507;1513;247;313;4
313650;Time Mysteries 2: The Ancient Spectres;Adventure, Indie, RPG, Strategy;100,000 - 200,000;318;212;106;239;239;2
313660;Alea Jacta Est;Adventure;50,000 - 100,000;86;28;58;0;0;2
313690;LEGO Batman 3: Beyond Gotham;Indie, Simulation, Strategy;500,000 - 1,000,000;5620;682;4938;759;344;325
313700;Burger Patrol;Free to Play, Indie, Strategy;0 - 20,000;19;2;17;0;0;2
313730;Sunrider: Mask of Arcadius;Indie, Simulation, Strategy;500,000 - 1,000,000;2551;203;2348;251;374;15
313740;Sakura Spirit;Casual, Indie, Simulation;200,000 - 500,000;5635;1543;4092;183;178;3
313780;Conarium;Casual, Indie, Early Access;50,000 - 100,000;1505;406;1099;283;354;0
313810;Legend of Kay Anniversary;Indie, Strategy;20,000 - 50,000;202;86;116;1;1;2
313830;See No Evil;Action, Indie;100,000 - 200,000;237;117;120;143;175;0
313870;A Vampyre Story;Adventure, Indie;20,000 - 50,000;97;57;40;56;56;0
314000;Pool Nation FX Lite;Education, Software Training, Utilities, Video Production;500,000 - 1,000,000;1237;521;716;78;25;28
314010;Boid;;200,000 - 500,000;584;147;437;105;138;2
314020;Morphopolis;Action, Adventure, Casual, Indie, RPG;500,000 - 1,000,000;3977;792;3185;167;171;1
314050;Spheritis;Action, Adventure, Casual, Indie, RPG, Simulation, Strategy, Early Access;0 - 20,000;4;2;2;0;0;0
314070;Super Mega Baseball: Extra Innings;Action, Indie;100,000 - 200,000;830;91;739;716;930;5
314120;Frayed Knights: The Skull of S'makh-Daon;Action, Adventure, Indie, Strategy;0 - 20,000;23;11;12;0;0;0
314120;Frayed Knights: The Skull of S'makh-Daon;Adventure, Indie;0 - 20,000;23;11;12;0;0;0
314150;Double Dragon Trilogy;Action, Indie, RPG, Strategy;50,000 - 100,000;489;389;100;161;193;1
314160;Microsoft Flight Simulator X: Steam Edition;Action, Indie;2,000,000 - 5,000,000;19966;3238;16728;3192;315;1045
314180;Deathsmiles;Action, Indie, Early Access;20,000 - 50,000;455;16;439;37;37;4
314200;Bionic Heart;Indie, Simulation;20,000 - 50,000;87;29;58;55;55;0
314210;Tesla Breaks the World!;Action, Adventure, Indie;20,000 - 50,000;8;47;-39;167;167;0
314220;Bombing Bastards;Action, Casual, Indie;20,000 - 50,000;72;47;25;0;0;0
314230;Rodina;Simulation;20,000 - 50,000;1221;85;1136;530;748;4
314240;RPG Tycoon;Action;50,000 - 100,000;258;234;24;61;61;0
314250;Jet Gunner;Adventure, Indie, RPG, Strategy;200,000 - 500,000;452;158;294;85;50;2
314280;The Forgotten Ones;Adventure;200,000 - 500,000;968;626;342;54;82;1
314290;Obludia;Action, Indie;20,000 - 50,000;35;35;0;0;0;0
314300;CubeZ;Action, Indie, RPG, Early Access;0 - 20,000;14;35;-21;0;0;0
314320;GamersGoMakers;Action, Casual, Indie;20,000 - 50,000;304;90;214;941;1256;0
314330;DROD: Gunthro and the Epic Blunder;Indie, RPG;20,000 - 50,000;122;11;111;0;0;4
314340;Chess 2: The Sequel;Action, Indie;20,000 - 50,000;50;55;-5;0;0;1
314350;Abatron;Indie, RPG, Strategy;0 - 20,000;11;2;9;0;0;0
314360;Aritana and the Harpy's Feather;Action, Adventure, Indie;0 - 20,000;103;11;92;0;0;0
314360;Aritana and the Harpy's Feather;Free to Play, Strategy;0 - 20,000;103;11;92;0;0;0
314370;boxlife;Action, Indie;20,000 - 50,000;106;28;78;0;0;0
314410;Rampage Knights;Action, Adventure;200,000 - 500,000;3149;246;2903;418;129;13
314430;M.A.R.S.;Adventure, Indie, Strategy;200,000 - 500,000;524;347;177;166;298;78
314450;Star Saviors;Adventure, Indie;200,000 - 500,000;1378;297;1081;234;180;2
314460;Jamsouls;Adventure;0 - 20,000;31;28;3;297;332;0
314470;Heroes of a Broken Land;Action, Indie;20,000 - 50,000;172;32;140;548;548;0
314500;Pixeluvo;Simulation;0 - 20,000;184;34;150;65;65;2
314510;Fall of the New Age Premium Edition;Action, Adventure;20,000 - 50,000;92;66;26;8;8;0
314520;Euro Fishing;Action, Adventure, Racing;100,000 - 200,000;1106;614;492;135;229;8
314540;Paper Monsters Recut;Action, Indie, RPG;0 - 20,000;30;13;17;0;0;0
314560;Kyn;Action, Free to Play, Massively Multiplayer, RPG;0 - 20,000;88;61;27;47;47;0
314570;The Sun at Night;Casual;0 - 20,000;20;21;-1;64;122;0
314590;room13;Action, Strategy;50,000 - 100,000;58;17;41;0;0;0
314610;Vincere Totus Astrum;Adventure, Indie;50,000 - 100,000;2;0;2;0;0;0
314630;The Thin Silence;Action, Indie;0 - 20,000;21;5;16;0;0;0
314650;SpaceEngine;Indie;200,000 - 500,000;6867;297;6570;396;389;136
314660;Oddworld: New 'n' Tasty;Design & Illustration;200,000 - 500,000;2749;417;2332;208;229;13
314710;Mighty No. 9;Design & Illustration;200,000 - 500,000;1556;1564;-8;281;333;3
314720;ShaderTool;Action, Casual, Indie, Strategy;0 - 20,000;28;6;22;0;0;0
314730;WorldCreator;Sports, Strategy;20,000 - 50,000;11;8;3;0;0;0
314760;Direct Hit: Missile War;Casual;0 - 20,000;10;13;-3;0;0;0
314770;Pe-2: Dive Bomber;Adventure, Indie, RPG;0 - 20,000;9;6;3;0;0;0
314790;Silence;Casual;100,000 - 200,000;1872;337;1535;391;541;6
314810;Randal's Monday;Adventure;100,000 - 200,000;1042;312;730;206;195;7
314830;Blackguards 2;Action, Indie;100,000 - 200,000;717;366;351;144;175;8
314850;Haunted House: Cryptic Graves;Animation & Modeling, Design & Illustration;0 - 20,000;2;23;-21;0;0;0
314860;DayBreak Online;Indie, RPG;50,000 - 100,000;166;82;84;0;0;0
314950;Spectre;Adventure, Indie;0 - 20,000;12;30;-18;16;16;0
314970;Age of Conquest IV;Action, Indie;500,000 - 1,000,000;2000;470;1530;219;230;416
314980;Supreme Ruler Ultimate;Casual;100,000 - 200,000;862;259;603;0;0;129
315060;Bloop Reloaded;Action, Adventure, Indie;100,000 - 200,000;228;119;109;217;307;1
315070;Blob From Space;Casual;100,000 - 200,000;34;110;-76;341;366;0
315080;Foresight;Adventure, Casual;0 - 20,000;35;8;27;342;375;0
315110;Woah Dave!;Action, RPG;20,000 - 50,000;86;27;59;0;0;0
315130;CO-OP : Decrypted;Action;0 - 20,000;30;39;-9;28;28;0
315240;liteCam Android: No Root Android Screen Recorder;Racing, Simulation, Sports;0 - 20,000;20;37;-17;0;0;0
315260;Space Hack;Action, Adventure, Indie;200,000 - 500,000;328;440;-112;9;10;1
315320;Skilltree Saga;Action, Adventure, Indie;20,000 - 50,000;60;122;-62;0;0;2
315320;Skilltree Saga;Adventure, Indie, RPG;20,000 - 50,000;60;122;-62;0;0;2
315330;All Guns On Deck;Adventure, Indie;0 - 20,000;167;315;-148;9;10;0
315340;A.R.E.S. Extinction Agenda EX;Adventure, Indie, Simulation;20,000 - 50,000;146;52;94;0;0;0
315430;Polarity;Adventure, Indie;500,000 - 1,000,000;3774;953;2821;129;130;1
315450;Bliss;Strategy;0 - 20,000;28;20;8;0;0;0
315460;Dig or Die;Action, Free to Play, Indie;200,000 - 500,000;3600;374;3226;556;334;25
315480;The Escapist;Indie, RPG;0 - 20,000;4;18;-14;0;0;0
315550;Taxi;Indie, Strategy;20,000 - 50,000;167;180;-13;61;61;1
315610;Spud's Quest;Action, Free to Play, Indie;0 - 20,000;26;6;20;0;0;0
315650;Deep Under the Sky;Action, Casual, Indie, Racing, Simulation, Sports;100,000 - 200,000;38;18;20;0;0;0
315660;Trainz: A New Era;Action, Adventure, Casual, Free to Play, Indie, Massively Multiplayer;200,000 - 500,000;1639;579;1060;5423;5423;116
315670;Raiden III Digital Edition;Action, Casual;20,000 - 50,000;256;92;164;46;62;1
315680;Spellcrafter;Action, Indie;0 - 20,000;21;39;-18;1;1;0
315810;eden*;Casual;100,000 - 200,000;2957;105;2852;192;226;6
315830;Daedalus - No Escape;Action, Indie, Strategy;20,000 - 50,000;107;24;83;36;68;0
315840;Catacomb Kids;RPG, Strategy;0 - 20,000;510;57;453;14;14;1
315850;Amazing Princess Sarah;Action, Indie;20,000 - 50,000;134;71;63;0;0;0
315860;Celestian Tales: Old North;Action, Indie, Strategy;50,000 - 100,000;291;130;161;81;149;0
315920;Stonerid;Action, Adventure, Indie, Simulation, Early Access;100,000 - 200,000;126;66;60;220;220;379
315930;Bravada;Indie, RPG;0 - 20,000;50;10;40;0;0;0
315940;Top Hat;Action, Casual;0 - 20,000;38;25;13;2;2;0
316010;Magic Duels;Casual, Indie, Strategy;2,000,000 - 5,000,000;16990;6995;9995;2007;113;68
316020;Hangeki;Adventure, Indie;0 - 20,000;35;4;31;0;0;0
316030;Disney Alice in Wonderland;Adventure, Indie;20,000 - 50,000;149;66;83;159;212;11
316080;Parcel;Action;20,000 - 50,000;110;18;92;218;218;0
316140;Appointment With FEAR;Strategy;0 - 20,000;52;46;6;0;0;0
316160;Broken Sword 4 - the Angel of Death;Casual, Indie, Strategy;100,000 - 200,000;153;204;-51;309;575;12
316180;A City Sleeps;Action, Indie, Massively Multiplayer;20,000 - 50,000;52;41;11;74;74;0
316240;Professional Lumberjack 2015;Indie, RPG;20,000 - 50,000;24;90;-66;509;975;0
316260;Disney Universe;Action, Adventure, Simulation;20,000 - 50,000;222;45;177;373;373;30
316320;Disney•Pixar Cars Toon: Mater's Tall Tales;Action, Adventure, Indie, RPG, Strategy;0 - 20,000;39;18;21;33;33;4
316370;Wave of Darkness;Casual, Indie, Simulation;0 - 20,000;48;43;5;0;0;0
316370;Wave of Darkness;Adventure;0 - 20,000;48;43;5;0;0;0
316420;The Curse of the Werewolves;Indie, RPG;0 - 20,000;18;5;13;0;0;0
316430;Battle of Empires : 1914-1918;Indie, RPG;100,000 - 200,000;1391;631;760;393;393;19
316480;Shadow Puppeteer;Adventure, Casual;50,000 - 100,000;117;39;78;102;113;0
316600;QP Shooting - Dangerous!!;Adventure, Indie;50,000 - 100,000;448;32;416;67;119;0
316610;A Good Snowman Is Hard To Build;Casual, Indie, Strategy;50,000 - 100,000;761;37;724;53;34;3
316620;Space Galaxy - Graphics Pack;Action, Adventure, Indie, Strategy;0 - 20,000;7;4;3;0;0;0
316630;Character Creator - Graphics Pack;Action, Adventure, Indie;0 - 20,000;5;2;3;0;0;0
316660;Toast Time;Action, Casual, Indie;0 - 20,000;58;18;40;0;0;0
316700;Front Page Sports Football;Indie, Strategy;0 - 20,000;6;56;-50;0;0;0
316720;planetarian ~the reverie of a little planet~;Action, Adventure, Indie;50,000 - 100,000;1965;49;1916;232;315;1
316740;Biglands: A Game Made By Kids;Indie, Strategy;0 - 20,000;31;29;2;0;0;1
316750;Tetris Ultimate;Casual;50,000 - 100,000;126;293;-167;0;0;0
316790;Grim Fandango Remastered;Adventure, Indie;200,000 - 500,000;6203;654;5549;305;215;27
316810;Shadowcrypt;Action, Indie;20,000 - 50,000;62;48;14;0;0;0
316830;Sprite Lamp;Adventure;0 - 20,000;15;10;5;62;62;0
316840;The Sacred Tears TRUE;Action, Adventure, Indie;20,000 - 50,000;55;24;31;0;0;1
316930;Kings of Kung Fu;Action, Adventure;50,000 - 100,000;447;242;205;0;0;0
316970;The Waste Land;Adventure, Indie, RPG;0 - 20,000;48;47;1;0;0;0
317020;Pajama Sam: Games to Play on Any Day;Indie, RPG, Strategy;20,000 - 50,000;41;5;36;0;0;4
317030;Fatty Bear's Birthday Surprise;Action;0 - 20,000;162;14;148;0;0;2
317030;Fatty Bear's Birthday Surprise;Action, Indie;0 - 20,000;162;14;148;0;0;2
317040;Strife: Veteran Edition;Action, Free to Play;100,000 - 200,000;486;54;432;104;136;0
317060;Attractio;Action, Adventure;20,000 - 50,000;54;80;-26;40;40;0
317080;MotorSport Revolution;Action;0 - 20,000;14;66;-52;0;0;0
317100;Republique;Adventure, Indie, RPG;100,000 - 200,000;518;154;364;71;82;3
317250;Airscape - The Fall of Gravity;Adventure, Indie, Strategy;500,000 - 1,000,000;2184;480;1704;139;88;1
317280;Solstice;Action, Adventure, Indie, RPG;0 - 20,000;135;44;91;153;181;0
317290;Bionic Heart 2;Casual, Indie, Strategy;20,000 - 50,000;22;18;4;1;1;0
317300;Roommates;Action, Indie;0 - 20,000;162;63;99;211;422;2
317320;Nelly Cootalot: The Fowl Fleet;Casual;20,000 - 50,000;247;13;234;0;0;0
317330;Defenders of Time;Adventure, Casual;0 - 20,000;18;26;-8;0;0;0
317360;Double Action: Boogaloo;Adventure;2,000,000 - 5,000,000;10383;806;9577;97;38;9
317370;The Keep;Action, Adventure, Indie, RPG;20,000 - 50,000;104;43;61;20;20;1
317380;War on Folvos;Adventure, Indie;50,000 - 100,000;79;31;48;0;0;1
317410;Color Symphony;Action, Indie;200,000 - 500,000;946;348;598;14;9;0
317440;Quantum Rush Champions;Action, Indie;20,000 - 50,000;93;69;24;299;335;0
317470;Cubic Castles;Indie, Simulation;500,000 - 1,000,000;3141;1129;2012;600;67;22
317510;Beyond Gravity;Casual, Racing;20,000 - 50,000;784;107;677;6;6;0
317530;Congo;Indie, Strategy;0 - 20,000;113;80;33;56;56;0
317580;Disney•Pixar Toy Story Mania!;Action, Casual, Free to Play, Indie, RPG, Strategy;0 - 20,000;24;19;5;97;97;0
317610;Prophour23;Action, Adventure;20,000 - 50,000;49;24;25;430;430;0
317620;Space Hulk: Ascension;Action, Free to Play, Massively Multiplayer, RPG, Strategy;50,000 - 100,000;631;231;400;287;417;4
317710;Velocibox;Indie, Strategy;50,000 - 100,000;562;74;488;107;179;1
317720;Tiestru;Indie, Strategy;0 - 20,000;13;33;-20;0;0;0
317730;REVERSE SIDE;Simulation;20,000 - 50,000;32;58;-26;112;112;0
317820;Guild of Dungeoneering Ultimate Edition;Action, Indie, Simulation;200,000 - 500,000;1880;568;1312;393;229;5
317840;Dokuro;Casual, Indie, Simulation;0 - 20,000;52;12;40;0;0;1
317850;Company of Heroes 2 - Ardennes Assault;Action, Adventure, Indie;50,000 - 100,000;527;347;180;0;0;0
317920;Hills Of Glory 3D;Adventure, Indie;0 - 20,000;14;14;0;0;0;0
317940;Karmaflow: The Rock Opera Videogame - Act I & Act II;Adventure, Indie, RPG;0 - 20,000;136;58;78;0;0;0
317950;KEL Reaper of Entropy;Indie, Simulation;0 - 20,000;23;25;-2;0;0;0
317970;Dusk 12;Casual;20,000 - 50,000;85;95;-10;61;89;2
318020;Act of Aggression - Reboot Edition;Indie, Simulation;100,000 - 200,000;1947;1029;918;417;415;39
318090;DICETINY: The Lord of the Dice;Action, Indie, Racing, Simulation, Sports;20,000 - 50,000;167;74;93;0;0;0
318100;AXYOS;Action, Adventure, Indie;200,000 - 500,000;1182;1107;75;160;179;0
318130;Doom & Destiny;Action, Adventure, Indie;50,000 - 100,000;2077;83;1994;424;835;6
318220;Enforcer: Police Crime Action;Racing, Simulation;100,000 - 200,000;1093;1210;-117;589;249;2
318230;Convoy;Racing;100,000 - 200,000;1077;281;796;330;509;4
318260;Supreme: Pizza Empire;Action, RPG;0 - 20,000;72;39;33;0;0;0
318300;Phineas and Ferb: New Inventions;Adventure, Casual, Indie;0 - 20,000;10;8;2;0;0;0
318310;Choice of the Deathless;Adventure, Indie, Simulation, Strategy;0 - 20,000;294;24;270;6;6;1
318330;Mecha Ace;Casual, Strategy;0 - 20,000;126;17;109;0;0;0
318430;Squishy the Suicidal Pig;Action, Strategy;200,000 - 500,000;2896;552;2344;115;84;0
318480;Burnstar;Casual, Strategy;0 - 20,000;43;4;39;163;187;0
318530;Wings of Vi;Adventure, Indie;100,000 - 200,000;976;230;746;323;276;2
318560;Unlimited Escape 2;Action, Casual, Indie, Racing;0 - 20,000;1;7;-6;0;0;0
318570;Hunters Of The Dead;Adventure, Casual;20,000 - 50,000;92;58;34;0;0;0
318600;The Flame in the Flood;Adventure, Casual;200,000 - 500,000;5153;1635;3518;389;123;18
318650;SunAge: Battle for Elysium;Adventure, Casual;0 - 20,000;108;48;60;0;0;1
318660;Moorhuhn / Crazy Chicken Tales;Adventure, Casual;20,000 - 50,000;30;14;16;0;0;0
318680;History in Letters - The Eternal Alchemist;Adventure, Casual, Indie;0 - 20,000;5;3;2;0;0;0
318690;Cargo 3;Adventure;50,000 - 100,000;77;119;-42;0;0;0
318740;Disney The Princess and the Frog;Action, Indie;0 - 20,000;33;13;20;0;0;1
318860;Malebolgia;Adventure, Indie;0 - 20,000;79;48;31;0;0;0
318950;Disney Tangled;Action, Simulation;0 - 20,000;69;24;45;0;0;2
318970;StarCrawlers;Casual;20,000 - 50,000;701;125;576;808;808;12
319050;Chaos Reborn;Indie;50,000 - 100,000;828;263;565;332;437;2
319080;Disney Princess: My Fairytale Adventure;Indie, Simulation;0 - 20,000;186;25;161;0;0;18
319140;Xeodrifter;Action, Adventure;20,000 - 50,000;597;186;411;178;178;0
319150;Hazard Ops;Adventure, Casual, Indie;500,000 - 1,000,000;672;272;400;99;72;0
319170;Disney G-Force;Casual, Indie, Sports;0 - 20,000;481;29;452;338;493;31
319180;Platypus II;Adventure;200,000 - 500,000;349;224;125;230;239;1
319210;Space Salvager;;0 - 20,000;9;18;-9;0;0;0
319230;Gold Rush! Anniversary;Action, Indie;50,000 - 100,000;105;81;24;230;286;1
319250;Magicmaker;Action;50,000 - 100,000;517;55;462;288;439;1
319270;Great Permutator;Simulation;20,000 - 50,000;119;18;101;84;117;0
319280;Yatagarasu Attack on Cataclysm;Indie, Simulation, Early Access;20,000 - 50,000;187;96;91;334;334;0
319300;Trainz Trouble;Action, Casual, Free to Play, Indie;20,000 - 50,000;35;14;21;0;0;0
319300;Trainz Trouble;Action, Indie, Simulation, Strategy;20,000 - 50,000;35;14;21;0;0;0
319320;Time Mysteries 3: The Final Enigma;Action, Indie;100,000 - 200,000;324;65;259;189;221;2
319400;Disney Winnie the Pooh;Adventure, Indie;50,000 - 100,000;198;22;176;0;0;5
319430;CHAOS - In the Darkness;Action, Adventure, Casual, Indie, RPG, Simulation, Early Access;0 - 20,000;10;20;-10;0;0;0
319430;CHAOS - In the Darkness;Action, Casual, Free to Play, Indie, Sports;0 - 20,000;10;20;-10;0;0;0
319450;Chariot;Simulation, Strategy;100,000 - 200,000;305;72;233;198;198;5
319470;Ninja Pizza Girl;Racing, Simulation;50,000 - 100,000;251;61;190;128;140;0
319480;Odallus: The Dark Call;Casual, Free to Play, Indie, Strategy;50,000 - 100,000;1051;129;922;218;300;6
319510;Five Nights at Freddy's;Racing, Simulation, Sports;1,000,000 - 2,000,000;33434;2806;30628;157;94;124
319540;A Year Of Rain;Animation & Modeling;50,000 - 100,000;282;331;-49;121;121;0
319550;The Collider;Action, Indie;50,000 - 100,000;764;167;597;70;70;0
319560;Reprisal Universe;Casual;20,000 - 50,000;303;91;212;3;3;0
319570;Heroes of SoulCraft - Arcade MOBA;Casual;200,000 - 500,000;194;284;-90;9;14;0
319630;Life is Strange - Episode 1;Simulation;5,000,000 - 10,000,000;153027;6145;146882;592;178;315
319730;GRANADO ESPADA;Action;50,000 - 100,000;119;121;-2;1;1;0
319740;There Came an Echo;Adventure, RPG, Strategy;20,000 - 50,000;274;99;175;44;44;0
319760;Oh My Gore!;Action, Casual, Indie, Early Access;50,000 - 100,000;369;57;312;191;225;0
319780;Airport Simulator 2015;Adventure, Casual, Free to Play, Indie, Simulation;50,000 - 100,000;67;95;-28;0;0;1
319830;AX:EL - Air XenoDawn;Adventure, Indie;1,000,000 - 2,000,000;946;281;665;240;72;1
319850;Bridge Constructor Medieval;Casual, Indie, RPG;50,000 - 100,000;385;85;300;41;47;4
319870;Jenny LeClue - Detectivu;Adventure, Casual, Indie, RPG;20,000 - 50,000;894;119;775;0;0;7
319910;Trine 3: The Artifacts of Power;Action, Adventure, Indie;500,000 - 1,000,000;5124;2855;2269;235;226;14
319970;The Detail;Action, Indie, RPG;100,000 - 200,000;474;179;295;333;333;2
320040;Moon Hunters;Action, Adventure, Indie;500,000 - 1,000,000;3593;950;2643;213;181;25
320090;This Starry Midnight We Make;RPG, Strategy;0 - 20,000;42;7;35;0;0;0
320110;Train Town;Adventure, Indie, RPG, Early Access;20,000 - 50,000;45;26;19;123;123;0
320120;Meadowland;Indie;0 - 20,000;38;30;8;0;0;0
320140;Absolute Drift;Action, Indie;200,000 - 500,000;2438;321;2117;224;109;7
320150;Deadlings: Rotten Edition;Action, Indie;50,000 - 100,000;227;43;184;185;263;0
320240;We Happy Few;Adventure;500,000 - 1,000,000;8944;2765;6179;485;308;100
320300;Car Mechanic Simulator 2015;Action, Indie;500,000 - 1,000,000;13113;1100;12013;758;274;65
320310;World Truck Racing;Action, Adventure, Indie, RPG, Strategy;20,000 - 50,000;43;86;-43;0;0;0
320320;Darkstone;Action, Indie;50,000 - 100,000;352;96;256;0;0;1
320330;Earthworms;Action, Adventure, RPG;50,000 - 100,000;134;32;102;1;1;0
320340;Cosmonautica;Indie, Massively Multiplayer, RPG, Early Access;200,000 - 500,000;544;584;-40;157;181;1
320400;Magnifico;Adventure, Indie, Simulation;100,000 - 200,000;95;59;36;251;296;6
320410;Near Impact;Education;0 - 20,000;2;5;-3;0;0;0
320430;Ascension: Deckbuilding Game;Action, Adventure, Casual, Indie, Simulation, Strategy;100,000 - 200,000;1145;152;993;57;65;59
320520;Oscura: Lost Light;Action, Adventure, Indie;20,000 - 50,000;76;38;38;12;12;1
320540;Coffin Dodgers;Adventure, Casual, Indie;50,000 - 100,000;496;220;276;251;371;1
320610;Questerium: Sinister Trinity HD Collector's Edition;Action, Indie;20,000 - 50,000;147;39;108;0;0;1
320630;Season Match;Action;50,000 - 100,000;141;39;102;151;204;15
320650;Season Match 2;Indie, Strategy;20,000 - 50,000;62;41;21;150;226;11
320650;Season Match 2;Action, Indie;20,000 - 50,000;62;41;21;150;226;11
320670;Season Match 3 - Curse of the Witch Crow;Adventure, Casual, Indie;50,000 - 100,000;114;27;87;141;215;1
320690;The Treasures of Montezuma 3;RPG;50,000 - 100,000;256;121;135;372;372;12
320760;Tokyo School Life;Action, Adventure, Indie;20,000 - 50,000;625;43;582;239;239;2
320790;Fabula Mortis;Action, Indie, RPG;20,000 - 50,000;35;50;-15;0;0;0
320820;Toren;Action, Adventure, RPG, Early Access;100,000 - 200,000;829;468;361;152;182;1
320840;Wings! Remastered Edition;Action, Adventure, Indie, Massively Multiplayer, Early Access;50,000 - 100,000;374;104;270;70;129;1
320970;IGT Slots Paradise Garden;Simulation, Sports;20,000 - 50,000;85;46;39;11;11;5
321030;ONE DAY for Ched;Indie, Strategy;;;;0;;;
321060;Gender Bender DNA Twister Extreme;Action, Indie, Strategy;0 - 20,000;172;48;124;72;72;1
321150;Melissa K. and the Heart of Gold Collector's Edition;Action, Adventure, Simulation;200,000 - 500,000;525;210;315;274;252;0
321160;Timber Tennis: Versus;Indie, Simulation;20,000 - 50,000;48;24;24;0;0;2
321190;Cho Dengeki Stryker All Ages Version;Casual, Indie, Simulation, Sports, Strategy;0 - 20,000;108;6;102;0;0;2
321210;Blade Symphony Beta;Adventure, Indie;0 - 20,000;0;0;0;0;0;0
321260;Wickland;Action, Casual, Strategy;50,000 - 100,000;446;402;44;196;296;4
321270;UNLOVED;Casual;100,000 - 200,000;861;244;617;132;151;6
321290;Dandelion - Wishes brought to you -;Action, Casual, Indie, Strategy;20,000 - 50,000;624;99;525;42;42;4
321330;ENYO Arcade;Casual, Indie;20,000 - 50,000;68;27;41;0;0;0
321350;Fairspace;Indie;0 - 20,000;19;7;12;0;0;0
321360;Primal Carnage: Extinction;Indie, RPG, Strategy;200,000 - 500,000;6641;1413;5228;1737;2346;126
321370;Sign Motion;Simulation, Strategy;0 - 20,000;57;31;26;0;0;0
321390;Zone 22;Action, Adventure, Indie, RPG;0 - 20,000;1;11;-10;0;0;0
321400;Supraball;Action, RPG;500,000 - 1,000,000;2520;731;1789;111;72;3
321410;Command: Modern Air / Naval Operations WOTY;Casual, Strategy;20,000 - 50,000;508;93;415;1576;1576;2
321450;Aquadelic GT;Casual;0 - 20,000;51;7;44;0;0;0
321480;Sigils of Elohim;Casual;200,000 - 500,000;961;86;875;16;21;2
321490;MotoGP14 Compact;Casual;20,000 - 50,000;28;48;-20;15;15;0
321560;The Sun and Moon;Adventure, Casual, Indie;20,000 - 50,000;148;21;127;8;8;1
321600;The Flying Dutchman;Action, Adventure, Free to Play, Massively Multiplayer, RPG;20,000 - 50,000;9;51;-42;0;0;0
321610;Demonlisher;Action, Adventure, Indie, Simulation, Strategy;20,000 - 50,000;13;13;0;0;0;0
321710;Battle Of Europe;Action, Adventure, Indie;0 - 20,000;17;5;12;0;0;0
321800;Icewind Dale: Enhanced Edition;Action, Adventure, RPG;200,000 - 500,000;2307;264;2043;278;324;174
321830;Cavern Kings;Action;20,000 - 50,000;150;70;80;108;108;0
321840;Rising Angels: Reborn;Action;100,000 - 200,000;470;114;356;1;1;0
321870;Silence of the Sleep;Adventure, Casual, Indie;50,000 - 100,000;487;160;327;144;218;2
321880;Aveyond 3-3: The Lost Orb;Action, Adventure, Indie;0 - 20,000;22;7;15;0;0;0
321890;Aveyond 3-4: The Darkthrop Prophecy;Utilities;0 - 20,000;27;5;22;0;0;1
321920;Schein;Indie;100,000 - 200,000;234;78;156;271;354;0
321940;Moorhuhn: Tiger and Chicken;Indie, Racing, Sports, Early Access;20,000 - 50,000;46;12;34;0;0;0
321950;Yury;Adventure, Indie;100,000 - 200,000;234;262;-28;286;284;0
321960;Might & Magic Heroes VII;Casual, Indie;500,000 - 1,000,000;3033;2601;432;3570;3096;303
321980;Hardland;Adventure, Indie;50,000 - 100,000;403;165;238;535;535;1
322030;Unlimited Escape;Simulation;0 - 20,000;2;3;-1;0;0;0
322080;Disorder;Action, Indie;20,000 - 50,000;63;23;40;91;91;0
322110;20XX;Casual, Free to Play, Indie, Strategy;200,000 - 500,000;3761;315;3446;1416;2257;19
322130;Disney Princess: Enchanted Journey;Utilities;20,000 - 50,000;234;22;212;115;115;25
322170;Geometry Dash;Simulation;5,000,000 - 10,000,000;212432;14900;197532;5988;574;10063
322190;SteamWorld Heist;Action, Indie, Racing;;;;0;;;
322210;Guns, Gore & Cannoli;Action, Adventure, Indie, RPG, Early Access;100,000 - 200,000;2762;253;2509;597;428;26
322290;Gurumin: A Monstrous Adventure;Simulation, Sports, Strategy;0 - 20,000;783;67;716;242;242;1
322300;The Repopulation;Racing, Sports;20,000 - 50,000;606;529;77;780;780;0
322330;Don't Starve Together;Adventure, Casual, Indie;10,000,000 - 20,000,000;363471;14893;348578;2548;530;28730
322410;Bin Weevils Arty Arcade;Action, Casual;0 - 20,000;11;8;3;0;0;0
322430;Bubonic: Outbreak;Adventure, Casual;0 - 20,000;2;6;-4;0;0;0
322440;Red Goddess: Inner World;Nudity, Indie;0 - 20,000;36;38;-2;0;0;0
322450;FRAMED Collection;Action, Adventure, Indie, Simulation, Early Access;200,000 - 500,000;1772;130;1642;126;152;15
322500;SUPERHOT;Action, Adventure, Indie;1,000,000 - 2,000,000;30148;3157;26991;257;166;81
322520;DYNASTY WARRIORS 8 Empires;Action, Indie, RPG, Simulation, Strategy;50,000 - 100,000;916;454;462;1082;1082;23
322540;Galactic Inheritors;Adventure, Indie;50,000 - 100,000;37;44;-7;239;239;0
322550;StandPoint;Simulation;0 - 20,000;15;8;7;0;0;0
322580;Dungeon Lurk II - Leona;Action, Indie, Strategy, Early Access;0 - 20,000;11;25;-14;0;0;0
322630;Mind Zero;Action, Adventure, Indie;0 - 20,000;41;50;-9;0;0;0
322630;Mind Zero;Indie, Strategy;0 - 20,000;41;50;-9;0;0;0
322680;BLACKHOLE;Indie, Strategy;200,000 - 500,000;867;133;734;190;308;2
322750;Drifting Lands;Indie, Racing, Early Access;20,000 - 50,000;204;51;153;148;148;2
322770;Vanishing Realms;Action, Adventure, Indie, Massively Multiplayer, RPG;200,000 - 500,000;2314;246;2068;212;335;3
322780;Worlds Adrift;Action, Indie, Strategy;100,000 - 200,000;3458;2019;1439;2450;2145;0
322850;Pro Cycling Manager 2015;Action;50,000 - 100,000;232;145;87;5376;10709;4
322900;War, the Game;Adventure, Indie;20,000 - 50,000;304;141;163;179;228;0
322910;Warhammer 40,000: Regicide;Action, Adventure;200,000 - 500,000;1279;591;688;193;258;3
322920;theHunter: Primal;Strategy;100,000 - 200,000;2340;1728;612;1202;1931;12
322930;aerofly RC 7;Adventure, Casual, Indie;20,000 - 50,000;164;37;127;0;0;4
322950;Pure Hold'em;Adventure, Indie, RPG;0 - 20,000;56;52;4;0;0;2
322970;Subject 13;Action, Adventure, Indie;100,000 - 200,000;171;122;49;144;156;6
322980;Gods vs Humans;Adventure, Casual, Racing;20,000 - 50,000;61;48;13;4;4;0
322990;Black Viper: Sophia's Fate;Action, Racing;20,000 - 50,000;29;49;-20;0;0;0
323000;Roaming Fortress;Adventure;0 - 20,000;7;6;1;0;0;0
323020;Destructamundo;Action, Adventure;0 - 20,000;13;3;10;0;0;0
323040;Laserlife;Action, Free to Play, Indie;20,000 - 50,000;85;28;57;221;221;0
323060;Tharsis;Indie;500,000 - 1,000,000;1676;706;970;92;131;3
323190;Frostpunk;Adventure, Casual, RPG;2,000,000 - 5,000,000;80433;7203;73230;1271;651;1797
323220;Vagante;Casual;200,000 - 500,000;3677;429;3248;1231;2257;96
323240;The World II: Hunting BOSS;Adventure, Casual, Indie;20,000 - 50,000;29;35;-6;0;0;0
323250;Hexus;Action, Indie;20,000 - 50,000;55;20;35;0;0;3
323260;Robin's Island Adventure;Adventure, Indie;20,000 - 50,000;28;24;4;3;3;0
323270;Jane Angel: Templar Mystery;Animation & Modeling, Design & Illustration, Education, Software Training, Utilities, Web Publishing;20,000 - 50,000;30;33;-3;0;0;0
323280;Sea Legends: Phantasmal Light Collector's Edition;Action, Adventure, Indie, Early Access;20,000 - 50,000;101;28;73;293;293;2
323320;Grow Home;Action, Casual, Indie, Early Access;200,000 - 500,000;4654;427;4227;311;68;6
323380;The Magic Circle;Adventure, RPG;100,000 - 200,000;1254;102;1152;148;147;2
323450;Alphadia Genesis;Video Production;20,000 - 50,000;98;25;73;345;345;0
323460;Raiden IV: OverKill;Action, Adventure, Indie, Strategy;50,000 - 100,000;469;89;380;189;209;2
323470;DRAGON BALL XENOVERSE;Action, Indie, Racing, Simulation, Early Access;1,000,000 - 2,000,000;15415;1872;13543;2381;1089;107
323490;Oblivious Garden ~Carmina Burana;Action, Adventure, Indie, RPG, Simulation, Early Access;0 - 20,000;495;49;446;108;108;0
323490;Oblivious Garden ~Carmina Burana;Strategy, Early Access;0 - 20,000;495;49;446;108;108;0
323580;Jotun: Valhalla Edition;Adventure, Casual, Indie;2,000,000 - 5,000,000;6322;1809;4513;125;103;9
323620;eden - 3D Screensaver;Strategy;0 - 20,000;2;8;-6;0;0;0
323630;Ubinota;Simulation, Strategy;50,000 - 100,000;204;20;184;11;11;0
323670;Super Indie Karts;Action, Adventure, Indie, RPG, Strategy;50,000 - 100,000;336;71;265;0;0;1
323680;Caffeine;Indie, RPG, Strategy;0 - 20,000;8;42;-34;0;0;0
323700;Poltergeist: A Pixelated Horror;Action, Indie, Strategy;0 - 20,000;29;14;15;0;0;0
323720;Decay: The Mare;Action, Indie;100,000 - 200,000;1354;416;938;120;131;5
323780;Fireworks Simulator;Indie;20,000 - 50,000;146;106;40;0;0;0
323850;Move or Die;Animation & Modeling, Design & Illustration, Photo Editing;1,000,000 - 2,000,000;19534;2151;17383;266;156;223
323900;March of War: FaceOff - M;Action, Adventure, Indie;100,000 - 200,000;321;111;210;443;443;0
323910;SteamVR Performance Test;Action, Indie;500,000 - 1,000,000;4102;1272;2830;0;0;30
324050;Farm Mechanic Simulator 2015;Action, Indie;0 - 20,000;55;41;14;0;0;0
324070;iO;Casual;20,000 - 50,000;172;39;133;136;187;0
324080;Rising World;Action, Indie, RPG;200,000 - 500,000;3980;749;3231;613;631;47
324090;Football Club Simulator - FCS #21;Free to Play, Massively Multiplayer, RPG;0 - 20,000;172;90;82;58;58;0
324110;Moto Racer Collection;Adventure, Casual, Indie;20,000 - 50,000;50;64;-14;4;4;0
324120;Verde Station;Adventure, Casual, Indie;20,000 - 50,000;239;80;159;41;41;0
324140;Kalimba;Indie, RPG, Simulation, Strategy;50,000 - 100,000;414;25;389;178;282;5
324160;CLANNAD;Action, Adventure, Sports;100,000 - 200,000;6739;103;6636;668;370;70
324170;Pyrite Heart;Free to Play, Massively Multiplayer, RPG;0 - 20,000;193;89;104;0;0;0
324190;CodeSpells;Adventure, Casual;0 - 20,000;102;136;-34;0;0;1
324240;I Will Escape;Action, Adventure, Indie, RPG;0 - 20,000;8;9;-1;0;0;0
324260;VoidExpanse;Action, Adventure, Casual, Indie;50,000 - 100,000;526;207;319;2208;2296;1
324270;Revenge: Rhobar's myth;Action, Casual, Indie, Massively Multiplayer, Strategy, Early Access;0 - 20,000;3;6;-3;0;0;0
324310;Bus Simulator 16;Action, Indie, Racing;200,000 - 500,000;2384;1038;1346;676;601;32
324360;TOTM;Adventure, Casual, Simulation;0 - 20,000;7;11;-4;1;1;0
324390;The Body Changer;Casual;0 - 20,000;41;13;28;0;0;0
324400;Pocket God vs Desert Ashes;Action, Simulation, Sports, Strategy;0 - 20,000;7;11;-4;0;0;0
324420;Desert Ashes;Simulation, Sports, Strategy;20,000 - 50,000;41;34;7;235;235;0
324470;SinaRun;Indie, RPG;20,000 - 50,000;135;39;96;108;194;0
324470;SinaRun;RPG, Strategy;20,000 - 50,000;135;39;96;108;194;0
324510;Boundless;Action, Indie;50,000 - 100,000;1900;778;1122;439;837;95
324570;Halo: Spartan Strike;Adventure, Indie, RPG;200,000 - 500,000;1018;240;778;94;157;5
324610;The Shopkeeper;Action, Adventure, Indie;0 - 20,000;18;125;-107;0;0;0
324650;Gemini: Heroes Reborn;Adventure, Indie, RPG;50,000 - 100,000;394;106;288;0;0;1
324680;Impossible Creatures Steam Edition;Action;100,000 - 200,000;1393;66;1327;382;610;36
324710;To Be or Not To Be;Action, Indie;0 - 20,000;230;22;208;0;0;0
324710;To Be or Not To Be;Indie, Simulation, Early Access;0 - 20,000;230;22;208;0;0;0
324730;Caverns of the Snow Witch (Standalone);Action, Racing;0 - 20,000;26;8;18;0;0;0
324740;The Warlock of Firetop Mountain;Action, Strategy;100,000 - 200,000;485;155;330;104;122;3
324750;StuntMANIA Reloaded;Action, Indie;0 - 20,000;61;46;15;20;20;0
324770;eXperience 112;Action, Adventure, Indie, Massively Multiplayer, RPG, Simulation, Early Access;20,000 - 50,000;56;39;17;0;0;1
324800;Shadow Warrior 2;Action, Adventure, Indie, Massively Multiplayer, RPG, Simulation;1,000,000 - 2,000,000;19819;2809;17010;522;313;2990
324810;TOXIKK;Design & Illustration;500,000 - 1,000,000;4223;1258;2965;98;39;266
325090;Deep Dungeons of Doom;Action, Indie, RPG, Strategy;200,000 - 500,000;547;149;398;168;221;1
325110;Save the Furries;Indie;20,000 - 50,000;32;13;19;0;0;0
325120;Notch - The Innocent LunA: Eclipsed SinnerS;Adventure, Indie;100,000 - 200,000;1041;122;919;675;675;1
325150;Run or Die;Indie;20,000 - 50,000;132;25;107;164;164;0
325160;Bik - A Space Adventure;Action, Casual, Indie;20,000 - 50,000;45;3;42;368;368;0
325180;AppGameKit Classic: Easy Game Development;Casual;100,000 - 200,000;522;105;417;1075;32;3
325210;Arctico;Adventure, Simulation;20,000 - 50,000;819;300;519;128;174;5
325260;PANZER BALL;Adventure, Simulation;100,000 - 200,000;1109;129;980;115;66;2
325300;BEARZERKERS;Adventure, Simulation;0 - 20,000;9;0;9;0;0;0
325320;Mythos: The Beginning - Director's Cut;Adventure, Indie, RPG;0 - 20,000;45;22;23;73;73;0
325330;Muvee Reveal 11;Action, Adventure, Casual, Indie, RPG;20,000 - 50,000;1;5;-4;0;0;0
325420;Homebrew - Patent Unknown;Adventure, Casual, Indie;50,000 - 100,000;709;240;469;138;231;1
325430;Metaverse;Animation & Modeling, Design & Illustration, Utilities;0 - 20,000;33;43;-10;0;0;0
325470;1953: NATO vs Warsaw Pact;Action, Indie;0 - 20,000;16;55;-39;0;0;0
325520;Fire: Ungh’s Quest;Action, Indie, RPG;100,000 - 200,000;494;87;407;1356;1356;1
325610;Total War: ATTILA;Action, Adventure, Indie;2,000,000 - 5,000,000;24564;5695;18869;5514;2022;2617
325630;Arms Dealer;Action, Adventure, Indie;0 - 20,000;85;112;-27;0;0;0
325730;The Hive;Free to Play, Indie, Strategy, Early Access;20,000 - 50,000;253;89;164;0;0;1
325790;Fallen: A2P Protocol;Casual, Indie;50,000 - 100,000;86;140;-54;312;312;0
325860;Fat Chicken;Indie, RPG, Strategy;0 - 20,000;32;13;19;42;42;0
325870;Clash of Puppets;Action, Free to Play, Strategy;0 - 20,000;42;21;21;0;0;0
325910;Substance B2M3;Action;0 - 20,000;70;14;56;1869;1869;1
325930;Viking Squad;Action, Adventure, Indie;20,000 - 50,000;207;38;169;87;87;1
326060;Starlight Drifter;Action, Adventure, Indie, RPG;0 - 20,000;33;14;19;0;0;1
326110;Defenders of the Last Colony;Action, Indie;0 - 20,000;10;15;-5;0;0;0
326120;Horizon Shift;Action, Adventure, Indie, Simulation;100,000 - 200,000;242;73;169;248;264;0
326130;Alcatraz Builder;Action, Adventure, Strategy;20,000 - 50,000;33;32;1;0;0;0
326150;Death Skid Marks;Adventure;20,000 - 50,000;637;55;582;959;959;0
326160;Shroud of the Avatar: Forsaken Virtues;Adventure, RPG;500,000 - 1,000,000;1541;1392;149;26392;51865;58
326180;Sinister City;Adventure;100,000 - 200,000;1007;520;487;330;272;1
326340;River City Super Sports Challenge ~All Stars Special~;Adventure, Simulation;100,000 - 200,000;551;261;290;129;152;1
326360;Warspear Online;Adventure, Indie, RPG, Early Access;200,000 - 500,000;1672;529;1143;16299;24359;133
326380;Mystery of Neuschwanstein;RPG;20,000 - 50,000;68;18;50;0;0;1
326410;Windward;RPG;200,000 - 500,000;2740;686;2054;585;393;17
326460;ShellShock Live;Action, Adventure, Casual, Free to Play, Racing;500,000 - 1,000,000;29561;2071;27490;1414;560;861
326470;Space Warp;Action, Indie;0 - 20,000;29;12;17;4;4;0
326480;If My Heart Had Wings;Indie, Simulation, Strategy, Early Access;50,000 - 100,000;4053;338;3715;284;100;18
326520;Chime Sharp;Adventure, Indie, RPG;50,000 - 100,000;103;41;62;571;571;2
326590;Cinemaware Anthology: 1986-1991;Indie, RPG, Simulation;20,000 - 50,000;84;27;57;0;0;1
326630;Club Manager 2015;Adventure, Indie;0 - 20,000;46;54;-8;213;213;1
326650;The Legend of Candlewind: Nights & Candles;Simulation;20,000 - 50,000;6;44;-38;0;0;0
326670;Warhammer Quest;Adventure;100,000 - 200,000;739;347;392;304;409;16
326720;Instant Dungeon!;Strategy;0 - 20,000;149;22;127;188;188;0
326730;Whisper of a Rose;Strategy;50,000 - 100,000;44;45;-1;105;105;1
326840;Heart&Slash;Action, Racing;50,000 - 100,000;440;105;335;138;138;2
326950;Sword of Asumi;Action;50,000 - 100,000;272;98;174;225;251;0
326960;Killing Floor - Toy Master;Indie;500,000 - 1,000,000;26;3;23;0;0;0
326990;Deep Eclipse: New Space Odyssey;Action, Indie, Early Access;50,000 - 100,000;87;48;39;168;202;3
327000;Infinite Game Works Episode 1;Indie, RPG;0 - 20,000;0;4;-4;0;0;0
327010;Motorama;Action, Adventure, Indie;50,000 - 100,000;133;240;-107;25;25;0
327030;Worms W.M.D;Strategy;500,000 - 1,000,000;7989;1447;6542;438;207;289
327060;FEIST;Action, Adventure, Indie;20,000 - 50,000;383;123;260;61;89;0
327070;Gloria Victis: Medieval MMORPG;Action, Indie;200,000 - 500,000;6082;2573;3509;2178;391;3717
327090;Out of Reach;Action, Sports;50,000 - 100,000;1730;1254;476;636;173;8
327140;Tilt Brush;Casual, Indie;200,000 - 500,000;1098;70;1028;206;227;9
327150;Deadstone;Action, Adventure, Indie, Early Access;20,000 - 50,000;51;13;38;0;0;0
327210;Cheesecake Cool Conrad;Casual, Indie;0 - 20,000;22;10;12;0;0;0
327220;Anna's Quest;Action, Adventure, Indie, RPG, Early Access;200,000 - 500,000;1764;236;1528;177;218;7
327260;Super Life of Pixel;Action, Adventure, Casual, Indie, RPG, Strategy;50,000 - 100,000;298;74;224;258;298;1
327310;The Marvellous Miss Take;Indie;50,000 - 100,000;255;57;198;20;20;1
327370;Brink of Consciousness: The Lonely Hearts Murders;Action, Casual, Simulation, Sports, Strategy;20,000 - 50,000;120;20;100;0;0;0
327390;Sid Meier's Covert Action (Classic);Adventure, Casual;20,000 - 50,000;113;13;100;1;1;2
327400;Sid Meier's Colonization (Classic);Casual, Strategy;50,000 - 100,000;721;39;682;188;188;188
327410;A Bird Story;Simulation;200,000 - 500,000;7700;1426;6274;236;134;6
327440;Hail to the King: Deathbat;Simulation;0 - 20,000;158;45;113;1;1;0
327450;Ballads of Reemus: When the Bed Bites;Simulation;0 - 20,000;66;2;64;0;0;0
327500;Zenzizenzic;Indie;20,000 - 50,000;74;11;63;0;0;0
327510;WASTED;Indie;100,000 - 200,000;852;266;586;836;831;7
327520;Traverser;Adventure, Indie, RPG, Simulation;20,000 - 50,000;71;28;43;0;0;0
327560;Near Death;Free to Play, Indie, RPG;20,000 - 50,000;863;82;781;137;256;2
327640;CaesarIA;Action, Adventure, Indie, RPG, Early Access;500,000 - 1,000,000;819;576;243;23;28;8
327650;May’s Mysteries: The Secret of Dragonville;Action;0 - 20,000;25;42;-17;0;0;0
327670;Ironcast;Action, Indie, Simulation, Strategy, Early Access;100,000 - 200,000;647;211;436;125;125;4
327690;Gigantic;Action, Adventure, Casual, Free to Play, RPG, Strategy;1,000,000 - 2,000,000;5681;1766;3915;122;59;0
327740;TRON 2.0;Action, Indie, Strategy;200,000 - 500,000;527;57;470;333;333;17
327760;Bacon Man: An Adventure;Action, Indie, Simulation, Sports, Early Access;0 - 20,000;30;6;24;0;0;0
327860;Salt;Adventure, Indie;50,000 - 100,000;1692;515;1177;305;307;10
327880;Sublevel Zero Redux;Action, Indie, RPG;20,000 - 50,000;441;58;383;0;0;1
327890;I Am Bread;Indie, Strategy, Early Access;500,000 - 1,000,000;4398;1265;3133;132;95;5
327910;7th Legion;Action, Adventure, Indie, Early Access;0 - 20,000;48;35;13;0;0;0
327920;BloodNet;Action, Casual, Indie;20,000 - 50,000;23;23;0;7;7;0
327930;Darklands;Action, Indie;20,000 - 50,000;185;20;165;229;456;4
327940;Dragonsphere;Action, Adventure, Indie;20,000 - 50,000;26;6;20;0;0;1
327960;Journey of the King;Action, RPG, Simulation;0 - 20,000;6;19;-13;0;0;0
327980;Dragon Fantasy: The Volumes of Westeria;Adventure;0 - 20,000;36;7;29;264;264;0
327980;Dragon Fantasy: The Volumes of Westeria;Action, Adventure, Indie, Racing;0 - 20,000;36;7;29;264;264;0
328000;Dragon Fantasy: The Black Tome of Ice;Action, Adventure, Indie;0 - 20,000;16;15;1;482;482;0
328070;Reflex Arena;Action;50,000 - 100,000;1308;234;1074;730;573;7
328080;Rise to Ruins;Simulation, Sports;200,000 - 500,000;6286;790;5496;319;198;67
328100;Gunspell - Steam Edition;Strategy;50,000 - 100,000;175;154;21;7;7;1
328220;Wild Season;Strategy;0 - 20,000;125;230;-105;0;0;1
328270;Leviathan: The Last Day of the Decade;Action;50,000 - 100,000;517;125;392;431;431;0
328310;Logistics Company;Action;50,000 - 100,000;47;68;-21;0;0;1
328430;Rex Nebular and the Cosmic Gender Bender;Simulation;20,000 - 50,000;25;17;8;16;16;0
328440;Deadlock: Planetary Conquest;Simulation;20,000 - 50,000;35;50;-15;394;394;0
328450;Deadlock II: Shrine Wars;Simulation;20,000 - 50,000;42;19;23;2;2;0
328460;Redline;Adventure, Indie, Sports;0 - 20,000;65;31;34;28;28;0
328470;Slave Zero;Action, Indie, RPG;20,000 - 50,000;161;30;131;42;77;0
328500;Potatoman Seeks the Troof;Free to Play, Strategy;100,000 - 200,000;572;197;375;340;380;4
328510;Monsters and Monocles;Adventure;0 - 20,000;77;23;54;0;0;0
328510;Monsters and Monocles;Action, Casual, Indie, Simulation;0 - 20,000;77;23;54;0;0;0
328550;Thieves' Gambit: The Curse of the Black Cat;Animation & Modeling, Design & Illustration, Education, Software Training, Utilities, Early Access;0 - 20,000;24;6;18;0;0;0
328590;Don't Knock Twice;RPG, Strategy, Early Access;50,000 - 100,000;368;137;231;140;204;1
328600;Frozen Synapse Prime;Adventure, Indie;100,000 - 200,000;213;121;92;195;305;1
328640;Rock Zombie;Free to Play, Strategy;0 - 20,000;32;17;15;0;0;0
328650;Knight of the Hamsters;Action, Adventure, Indie, RPG;0 - 20,000;10;5;5;0;0;0
328670;Deer Hunt Legends;Video Production;0 - 20,000;10;39;-29;104;104;0
328680;Crab Cakes Rescue;Action, Indie, RPG, Simulation;20,000 - 50,000;46;32;14;239;221;0
328710;One Last Day;Action, Indie;0 - 20,000;65;39;26;0;0;0
328730;Letter Quest: Grimm's Journey;Action, Indie, RPG;50,000 - 100,000;359;27;332;243;334;1
328740;Bit Odyssey;Action, Adventure, Casual, Indie;0 - 20,000;18;21;-3;0;0;0
328760;SanctuaryRPG: Black Edition;Action, Casual, Simulation;100,000 - 200,000;1397;122;1275;374;463;3
328780;Vampires: Guide Them to Safety!;RPG;0 - 20,000;37;9;28;0;0;0
328830;Rugby Union Team Manager 2015;Adventure;0 - 20,000;46;35;11;40;40;0
328880;Space Legends: At the Edge of the Universe;Action, Casual, Indie;0 - 20,000;56;75;-19;0;0;0
328890;Fritz for Fun 13;Action, Adventure, Indie, RPG, Simulation, Strategy, Early Access;0 - 20,000;20;12;8;0;0;1
328900;B-17 Flying Fortress: The Mighty 8th;Indie;20,000 - 50,000;62;14;48;0;0;0
328920;F-117A Nighthawk Stealth Fighter 2.0;Casual;0 - 20,000;93;18;75;7;7;1
328930;Fleet Defender: The F-14 Tomcat Simulation;Indie, Racing, Sports, Early Access;0 - 20,000;27;6;21;0;0;0
328940;The Deer God;Action, Indie, Early Access;20,000 - 50,000;298;167;131;315;372;0
328990;Koya Rift;Action, Indie, Early Access;0 - 20,000;13;29;-16;0;0;0
329000;Data Hacker: Corruption;Action, Simulation, Strategy;500,000 - 1,000,000;59;63;-4;297;323;1
329020;Battlegrounds of Eldhelm;Indie, RPG, Simulation, Strategy;50,000 - 100,000;147;63;84;34;34;0
329040;Dungeon Kingdom: Sign of the Moon;Action, Indie, Simulation;0 - 20,000;108;40;68;0;0;1
329050;Devil May Cry 4 Special Edition;Action, Indie;1,000,000 - 2,000,000;11564;1244;10320;556;449;170
329070;SpyParty;Action, Indie;200,000 - 500,000;1008;221;787;3845;7508;14
329130;Reassembly;Strategy;200,000 - 500,000;3437;220;3217;1881;1274;38
329200;Astray;Action, Indie, Racing;20,000 - 50,000;152;68;84;149;186;0
329200;Astray;Adventure, Indie;20,000 - 50,000;152;68;84;149;186;0
329240;The Weaponographist;Adventure;0 - 20,000;58;22;36;0;0;0
329280;Avalon Lords: Dawn Rises;Adventure;20,000 - 50,000;76;69;7;4;4;0
329280;Avalon Lords: Dawn Rises;Action, Adventure, Casual, Massively Multiplayer, RPG, Early Access;20,000 - 50,000;76;69;7;4;4;0
329310;Tile Miner;Adventure, Casual;0 - 20,000;38;24;14;0;0;0
329320;QbQbQb;Action, Adventure, Indie;20,000 - 50,000;91;11;80;0;0;0
329340;cloudphobia;Adventure, Racing;0 - 20,000;16;4;12;0;0;0
329340;cloudphobia;Action, Indie;0 - 20,000;16;4;12;0;0;0
329380;Stealth Inc 2: A Game of Clones;Adventure, Casual, Indie, Simulation;200,000 - 500,000;737;229;508;208;251;4
329430;State of Decay: YOSE;Adventure, Casual, Indie;500,000 - 1,000,000;8400;1971;6429;734;145;134
329440;Sonic Lost World;Action, Indie;200,000 - 500,000;2304;1400;904;56;81;20
329460;JumpJet Rex;Action, Indie;50,000 - 100,000;424;62;362;42;42;0
329480;Snow Light;Adventure, Indie;0 - 20,000;4;17;-13;0;0;0
329490;Phantom Breaker: Battle Grounds;Action, Free to Play, Indie, Massively Multiplayer, Racing, Sports, Strategy;200,000 - 500,000;2414;471;1943;150;139;2
329610;R.B.I. Baseball 15;Indie, RPG, Strategy;0 - 20,000;69;91;-22;0;0;0
329620;Across the Rhine;Action, Adventure, Casual, Indie, RPG;0 - 20,000;17;13;4;0;0;0
329630;Command HQ;Action, Adventure, Indie, RPG;0 - 20,000;66;7;59;0;0;8
329630;Command HQ;Action, Adventure;0 - 20,000;66;7;59;0;0;8
329640;Eradicator;Adventure, Casual, Indie;0 - 20,000;72;13;59;54;76;1
329650;NAM;Adventure, Casual, Free to Play, Indie;100,000 - 200,000;182;65;117;228;228;0
329660;Silent Service;Adventure, Casual, Indie;0 - 20,000;18;10;8;0;0;0
329670;Silent Service 2;Action, Strategy;20,000 - 50,000;37;21;16;0;0;0
329680;Task Force 1942: Surface Naval Action in the South Pacific;Adventure, Indie;0 - 20,000;15;11;4;8;8;0
329690;BasketBelle;Action, Adventure, Casual, Indie;0 - 20,000;131;21;110;0;0;1
329770;4089: Ghost Within;Free to Play, Indie;20,000 - 50,000;60;43;17;105;105;0
329790;Krosmaster Arena;Action;100,000 - 200,000;185;110;75;65;68;0
329830;The Moon Sliver;;200,000 - 500,000;715;243;472;164;194;0
329860;Catlateral Damage;Action, Indie, Racing;50,000 - 100,000;1131;133;998;293;366;7
329890;MyRPG Master;Casual, Indie, Strategy;0 - 20,000;23;46;-23;22;22;0
329970;KeeperRL;Action, Adventure, Indie;100,000 - 200,000;909;124;785;462;462;26
330000;Kingdoms CCG;Action, Indie, Strategy;200,000 - 500,000;72;66;6;58;48;0
330020;Children of Morta;Adventure;1,000,000 - 2,000,000;14060;1578;12482;465;295;292
330070;VEGAS Movie Studio 13 Platinum - Steam Powered;Adventure, Indie;50,000 - 100,000;975;326;649;3417;4924;44
330100;BossConstructor;Adventure, Indie, RPG;20,000 - 50,000;157;49;108;116;211;1
330180;Pix the Cat;Adventure, Indie;100,000 - 200,000;302;70;232;271;271;3
330270;Warlocks vs Shadows;Casual, Simulation;50,000 - 100,000;172;111;61;233;293;0
330350;Robotex;Simulation;200,000 - 500,000;269;595;-326;145;167;0
330370;Reload;Simulation;0 - 20,000;75;23;52;0;0;1
330390;GRANDIA II HD Remaster;Action, Adventure, Strategy;100,000 - 200,000;1824;247;1577;846;1323;27
330420;The Interactive Adventures of Dog Mendonça & Pizzaboy;Adventure, Casual, Indie;20,000 - 50,000;187;53;134;177;202;1
330450;Runes of Brennos;Adventure, Free to Play, Massively Multiplayer, RPG;0 - 20,000;28;14;14;380;380;0
330460;Celestial Command;Action, Indie, Early Access;50,000 - 100,000;405;182;223;1864;1864;2
330470;Over The Void;Action, Adventure, Indie;20,000 - 50,000;109;53;56;194;194;0
330500;planktOs;Action, Indie, Racing;0 - 20,000;9;3;6;0;0;0
330520;Tail Drift;Racing;0 - 20,000;9;9;0;0;0;0
330570;Noct;Action, Adventure, Indie;50,000 - 100,000;306;265;41;65;65;0
330580;Shark Attack Deathmatch 2;Adventure;100,000 - 200,000;1418;452;966;106;126;1
330590;Independence War Deluxe Edition;Action;0 - 20,000;8;4;4;0;0;0
330620;It's A Wipe!;Animation & Modeling, Design & Illustration, Utilities;0 - 20,000;94;30;64;0;0;2
330660;Luna's Wandering Stars;Adventure, Indie;20,000 - 50,000;64;43;21;308;463;9
330670;DiscStorm;Adventure, Casual, Indie, RPG;0 - 20,000;28;4;24;0;0;0
330680;Solar Struggle;Adventure, Casual, Indie, RPG, Strategy;50,000 - 100,000;5;20;-15;0;0;0
330720;Flashpoint Campaigns: Red Storm Player's Edition;Action, Adventure, Casual, Indie, RPG, Strategy;0 - 20,000;199;20;179;0;0;9
330770;Radial-G : Racing Revolved;Adventure, Casual, Indie, RPG;0 - 20,000;113;31;82;0;0;0
330770;Radial-G : Racing Revolved;Action, Indie;0 - 20,000;113;31;82;0;0;0
330820;2064: Read Only Memories;Simulation, Strategy;200,000 - 500,000;1226;316;910;177;235;1
330830;Tales from the Borderlands;Action, Adventure, Indie, RPG, Early Access;500,000 - 1,000,000;15807;796;15011;799;478;36
330840;Game of Thrones - A Telltale Games Series;Action, Indie;500,000 - 1,000,000;7989;2544;5445;597;602;3
330880;Redemption;Indie, RPG, Strategy;0 - 20,000;12;7;5;0;0;0
330990;Demon Hunter: Chronicles from Beyond;Adventure, Indie, Early Access;50,000 - 100,000;297;169;128;100;108;1
331120;Passing Pineview Forest;Adventure, Casual, Indie;200,000 - 500,000;1110;555;555;31;20;0
331160;Disney•Pixar Cars;Action, Adventure, Indie, RPG;100,000 - 200,000;1571;181;1390;287;415;74
331190;Master Spy;Adventure, Indie;50,000 - 100,000;278;64;214;98;114;2
331200;Grass Simulator;Adventure, Indie;50,000 - 100,000;580;408;172;114;121;0
331210;Bolt Riley, A Reggae Adventure;Action, Massively Multiplayer, RPG, Early Access;0 - 20,000;23;24;-1;0;0;0
331210;Bolt Riley, A Reggae Adventure;Action, Adventure, Indie;0 - 20,000;23;24;-1;0;0;0
331220;Thief Town;Indie, RPG;20,000 - 50,000;132;38;94;15;25;0
331290;Miko Gakkou: Second Year;Action, Indie;0 - 20,000;13;3;10;0;0;0
331340;Tulpa;Action, Indie, Early Access;50,000 - 100,000;129;112;17;196;248;0
331360;Heavy Metal Machines;Action, Indie;1,000,000 - 2,000,000;2969;984;1985;755;32;2
331390;Winged Sakura: Mindy's Arc;Violent, Gore, Action, Indie;0 - 20,000;143;36;107;0;0;0
331430;Toby's Island;Indie;0 - 20,000;5;0;5;0;0;0
331440;bit Dungeon II;Adventure, Casual;100,000 - 200,000;1756;374;1382;1039;1036;2
331450;Disney•Pixar Finding Nemo;Casual, Indie;0 - 20,000;96;37;59;54;54;7
331460;ROOMS: The Toymaker's Mansion;Action, Indie, Strategy;0 - 20,000;105;11;94;14;14;0
331470;Everlasting Summer;Action, Adventure, Indie, RPG;2,000,000 - 5,000,000;61634;2907;58727;1016;314;1036
331480;Pinstripe;Adventure, Indie, Simulation, Early Access;200,000 - 500,000;2037;242;1795;192;229;2
331500;Executive Assault;Casual, Indie;100,000 - 200,000;1239;205;1034;430;586;1
331510;Amphora;Action, Adventure, Indie;0 - 20,000;152;42;110;117;117;0
331570;Wimp: Who Stole My Pants?;Action, Casual, Indie, Strategy;0 - 20,000;37;9;28;0;0;0
331580;ULTRAWORLD EXODUS;Indie;0 - 20,000;55;20;35;0;0;1
331600;One Piece Pirate Warriors 3;Action, Adventure, Casual, Indie, RPG;500,000 - 1,000,000;7108;1755;5353;1343;811;109
331610;Movie Studio Boss: The Sequel;Adventure, Casual, Indie;;;;0;;;
331650;Carmageddon TDR 2000;Action, Indie;50,000 - 100,000;291;104;187;61;97;1
331670;The Jackbox Party Pack;Adventure, Indie, RPG, Strategy;200,000 - 500,000;1479;135;1344;272;132;94
331690;Crossing Souls;Action, Indie, RPG;100,000 - 200,000;1092;284;808;46;66;3
331720;Survivor Squad: Gauntlets;Action, Adventure, Casual, Indie, Racing, RPG, Simulation, Early Access;20,000 - 50,000;118;36;82;169;334;0
331750;Disney•Pixar WALL-E;Strategy;50,000 - 100,000;711;29;682;47;81;46
331760;Supreme League of Patriots;Indie, RPG, Early Access;20,000 - 50,000;65;34;31;226;226;2
331790;Data Hacker: Reboot;Adventure, Indie, RPG;100,000 - 200,000;113;79;34;242;244;0
331810;Lost Region;Strategy;0 - 20,000;80;194;-114;310;333;0
331870;AER Memories of Old;Adventure;200,000 - 500,000;5198;826;4372;187;154;9
331880;Truck Mechanic Simulator 2015;Adventure, Indie;20,000 - 50,000;99;89;10;237;88;0
331910;Beach Resort Simulator;Action, Indie;0 - 20,000;17;39;-22;0;0;0
331920;Airline Tycoon Deluxe;Indie, Simulation, Strategy;50,000 - 100,000;386;91;295;228;228;9
331970;Disney's Treasure Planet: Battle of Procyon;Action, Casual, Indie;20,000 - 50,000;207;6;201;0;0;0
331970;Disney's Treasure Planet: Battle of Procyon;Sexual Content, Nudity, Casual, Indie;20,000 - 50,000;207;6;201;0;0;0
331980;Last Inua;Adventure, Indie, RPG, Strategy, Early Access;50,000 - 100,000;156;112;44;206;240;1
332070;School of Dragons;Adventure, Casual, Indie, Strategy;1,000,000 - 2,000,000;2999;2127;872;196;47;119
332150;LEVEL UP!;Action, Indie, Strategy;0 - 20,000;2;2;0;0;0;0
332200;Axiom Verge;Adventure, Indie;200,000 - 500,000;4662;419;4243;487;491;26
332250;The Next Penelope;Indie, RPG;20,000 - 50,000;184;75;109;0;0;0
332260;Disney•Pixar Cars Mater-National Championship;Action, Indie;20,000 - 50,000;296;26;270;0;0;16
332270;Gunmetal Arcadia;Indie;0 - 20,000;36;12;24;12;12;0
332310;LEGO Worlds;Adventure, Casual, Indie, RPG, Strategy;500,000 - 1,000,000;11334;3195;8139;668;368;122
332330;PixelJunk Shooter Ultimate;Action, Free to Play;50,000 - 100,000;149;25;124;109;109;1
332360;Spriter Pro;Action, Indie, Simulation, Strategy, Early Access;20,000 - 50,000;274;83;191;167;264;5
332370;Miko Gakkou Monogatari: Kaede Episode;Indie, Strategy;0 - 20,000;13;1;12;0;0;0
332380;Asguaard;Action, Adventure, Casual, RPG;0 - 20,000;82;16;66;0;0;1
332390;Undefeated;Indie, RPG;20,000 - 50,000;133;26;107;0;0;0
332400;Girlfriend Rescue;Free to Play, Indie, Strategy;100,000 - 200,000;173;32;141;397;563;7
332410;Moonchild;Action;50,000 - 100,000;108;30;78;139;142;0
332480;Phoenix Force;Action, Adventure, Indie;100,000 - 200,000;646;125;521;198;214;5
332490;Battle Fleet 2;Action, Adventure, Casual, Indie;50,000 - 100,000;253;86;167;0;0;8
332490;Battle Fleet 2;Adventure, Indie;50,000 - 100,000;253;86;167;0;0;8
332500;GRAV;Action, Casual, Indie;500,000 - 1,000,000;3325;3566;-241;378;295;2
332540;We Slay Monsters;Action, Casual, Indie;0 - 20,000;68;4;64;0;0;2
332570;Amazing Frog?;Action, Indie, Strategy;500,000 - 1,000,000;7665;590;7075;1649;1649;68
332580;Mimpi;Indie, RPG, Strategy;50,000 - 100,000;237;44;193;198;198;19
332610;Mystik Belle;Indie;0 - 20,000;175;20;155;39;39;1
332620;PONCHO;Indie, Simulation, Strategy;20,000 - 50,000;123;62;61;0;0;0
332630;The Guilt and the Shadow;Action, Adventure, Indie;50,000 - 100,000;43;12;31;0;0;0
332650;The Exiled;Indie, Massively Multiplayer, Simulation, Strategy;50,000 - 100,000;225;239;-14;18;18;0
332700;Mike was Сursed;Casual, Indie, Strategy;50,000 - 100,000;61;30;31;204;257;0
332710;1Quest;Action, Adventure, Indie;50,000 - 100,000;90;78;12;298;298;0
332730;Barbarian Brawl;Action, Indie;0 - 20,000;15;17;-2;0;0;0
332760;Friendship Club;Adventure, Indie, RPG, Strategy;0 - 20,000;15;4;11;0;0;0
332790;Darkness Assault;Adventure, Casual;200,000 - 500,000;301;302;-1;246;245;81
332800;Five Nights at Freddy's 2;Adventure, Casual;500,000 - 1,000,000;15342;1044;14298;128;63;58
332810;Midnight Mysteries: Witches of Abraham - Collector's Edition;Adventure, Casual;20,000 - 50,000;38;9;29;0;0;2
332830;Prelogate;Action, Indie, Simulation, Early Access;0 - 20,000;87;8;79;28;28;0
332880;DSY: Don't Shoot Yourself;Action, Indie;0 - 20,000;27;7;20;0;0;0
332950;Dark Deception;Action, Indie, Sports;1,000,000 - 2,000,000;12650;1413;11237;81;34;161
333100;Demesne;Action, Adventure, Indie;0 - 20,000;33;33;0;0;0;0
333120;Inside The Gear;Indie;100,000 - 200,000;48;79;-31;302;392;0
333130;Do Not Fall;Action, Indie;0 - 20,000;10;1;9;0;0;0
333210;Kaiju-A-GoGo;Action, Indie;20,000 - 50,000;203;99;104;52;52;2
333220;Cherry Tree High I! My! Girls!;Casual, Indie, RPG, Simulation;20,000 - 50,000;116;51;65;0;0;0
333250;Forward to the Sky;Free to Play, Indie, Simulation, Strategy;200,000 - 500,000;1722;374;1348;237;253;0
333260;Marvin's Mittens;Adventure, Indie;20,000 - 50,000;186;7;179;58;109;0
333290;Mos Speedrun 2;Action, Indie, Simulation;0 - 20,000;19;2;17;0;0;0
333300;ADOM (Ancient Domains Of Mystery);Adventure, Indie;50,000 - 100,000;1128;193;935;355;418;46
333330;Song of the Myrne: What Lies Beneath;Adventure, Casual, Indie;0 - 20,000;66;22;44;253;253;1
333340;Star Rangers XE;Indie;0 - 20,000;63;90;-27;0;0;0
333350;Cults and Daggers;Simulation;0 - 20,000;33;18;15;0;0;0
333380;SilverQuest: Gaiden;Action, Casual, Indie, Racing, Simulation, Sports;0 - 20,000;6;12;-6;0;0;0
333390;Tales of Aravorn: Seasons Of The Wolf;Action, Indie, Racing;0 - 20,000;51;12;39;88;88;1
333420;Cossacks 3;Indie, Strategy;1,000,000 - 2,000,000;9211;2132;7079;1486;769;1327
333430;Sinking Island;Adventure, RPG;50,000 - 100,000;156;66;90;0;0;1
333490;Replay - VHS is not dead;Free to Play;20,000 - 50,000;41;4;37;0;0;0
333510;Isbarah;Adventure, Indie, RPG;0 - 20,000;45;11;34;0;0;0
333540;Neocolonialism;Action, Adventure;0 - 20,000;22;20;2;0;0;0
333580;Slow Down, Bull;Adventure, Indie, Early Access;0 - 20,000;14;3;11;0;0;0
333600;NEKOPARA Vol. 1;Casual, Indie;500,000 - 1,000,000;24898;1193;23705;1599;165;47
333640;Caves of Qud;Free to Play, Indie, Massively Multiplayer;200,000 - 500,000;5451;256;5195;847;1346;276
333650;Pahelika: Revelations;Action, RPG;20,000 - 50,000;32;41;-9;1;1;0
333660;Towers of Altrac - Epic Defense Battles;Simulation;20,000 - 50,000;71;47;24;0;0;0
333690;Epanalepsis;Action;0 - 20,000;22;9;13;0;0;0
333730;Dark Gates;Action, Free to Play;0 - 20,000;17;25;-8;0;0;0
333760;Vintage Year;RPG;20,000 - 50,000;69;19;50;54;54;0
333870;Feel-A-Maze;Action, Free to Play, Indie;20,000 - 50,000;87;23;64;0;0;0
333880;Braveland Wizard;Action, Strategy;20,000 - 50,000;332;84;248;0;0;3
333930;Dirty Bomb;Adventure, Indie, RPG;5,000,000 - 10,000,000;47050;10873;36177;553;76;129
333950;Medieval Engineers;Adventure, Indie, RPG;200,000 - 500,000;3795;3225;570;1399;644;46
333970;A Druid's Duel;Indie;20,000 - 50,000;79;29;50;11;11;0
333980;AKIBA'S TRIP: Undead ＆ Undressed;Action, Casual, Indie;100,000 - 200,000;2654;406;2248;346;453;8
333990;Conclave;Indie;0 - 20,000;54;14;40;272;516;1
334030;Epic Arena;RPG;100,000 - 200,000;193;100;93;26;34;0
334040;Down To One;Adventure, Casual, Indie;200,000 - 500,000;801;1295;-494;96;131;2
334070;Hektor;Adventure, Indie, RPG;200,000 - 500,000;606;362;244;142;189;0
334100;Extreme Exorcism;Adventure, Casual, Indie, Simulation;0 - 20,000;49;12;37;0;0;0
334120;Armikrog;Action, Indie, RPG;50,000 - 100,000;823;630;193;64;108;1
334140;Roche Fusion;Action, Indie, RPG;0 - 20,000;90;7;83;0;0;0
334190;Insanity's Blade;Action, Adventure, Casual, Indie;50,000 - 100,000;204;71;133;341;341;0
334210;Fortified;Adventure, Free to Play, Massively Multiplayer, RPG;500,000 - 1,000,000;1263;409;854;393;297;5
334230;Town of Salem;Action, Indie, Strategy;1,000,000 - 2,000,000;31648;4017;27631;1746;583;711
334260;Icebound;Action, Casual, Indie;0 - 20,000;7;0;7;0;0;0
334270;Star Traders: 4X Empires;Adventure, Indie, RPG, Early Access;50,000 - 100,000;42;26;16;0;0;0
334280;Lost Sea;Indie;0 - 20,000;39;24;15;34;34;0
334290;Gates of Horizon;Adventure, Indie, RPG, Strategy;0 - 20,000;67;35;32;1620;1620;0
334300;Fake Colours;Adventure, Indie;100,000 - 200,000;128;24;104;282;298;0
334310;Plebby Quest: The Crusades;Strategy, Early Access;200,000 - 500,000;2153;329;1824;1157;1157;33
334350;Don't Move;Racing, Simulation, Sports;0 - 20,000;0;0;0;0;0;0
334360;Passcode Breaker: The Day Before;Casual, Indie;0 - 20,000;5;1;4;0;0;0
334410;JUMP;Indie, Racing;0 - 20,000;26;13;13;0;0;0
334420;Out There: Ω Edition;Action, Free to Play, Indie, RPG, Strategy;200,000 - 500,000;1197;386;811;245;290;2
334470;Adventures of Robinson Crusoe;Action;20,000 - 50,000;63;55;8;0;0;0
334480;Robinson Crusoe and the Cursed Pirates;Strategy;20,000 - 50,000;28;7;21;0;0;0
334490;The Fool;Action, Indie;20,000 - 50,000;41;8;33;0;0;0
334540;Vox Machinae;Action, Strategy;20,000 - 50,000;1007;115;892;52;62;4
334560;Square Heroes;Action, Indie;20,000 - 50,000;214;34;180;163;175;1
334620;Soccertron;Adventure, Indie, RPG;50,000 - 100,000;45;15;30;0;0;4
334690;Squirreltopia;Adventure, Indie, RPG;20,000 - 50,000;214;71;143;32;32;1
334710;Ilamentia;Sports;20,000 - 50,000;64;32;32;0;0;1
334750;Farm Expert 2016;Action, Indie;0 - 20,000;109;157;-48;0;0;0
334830;Entropy Rising;Action, Casual, Indie, Strategy;20,000 - 50,000;31;13;18;0;0;0
334830;Entropy Rising;Action, Indie, Early Access;20,000 - 50,000;31;13;18;0;0;0
334840;Drive to Hell;Action, Adventure, Indie, Early Access;20,000 - 50,000;55;16;39;13;13;0
334850;1931: Scheherazade at the Library of Pergamum;Indie;50,000 - 100,000;129;52;77;124;130;1
334920;Zero-K;Adventure, Indie;500,000 - 1,000,000;2806;167;2639;665;168;155
334940;Yoku's Island Express;Action, Racing, Sports;200,000 - 500,000;3724;150;3574;170;208;18
334960;Cell HD: emergence;Indie, RPG;0 - 20,000;6;8;-2;0;0;0
334980;Into Blue Valley;Indie, Simulation, Strategy;0 - 20,000;30;30;0;0;0;0
335000;Tormentum - Dark Sorrow;Adventure, Casual, Indie;100,000 - 200,000;2302;147;2155;207;285;0
335010;Steam and Metal;Action, Indie, Strategy;20,000 - 50,000;54;17;37;208;208;0
335050;World Of Leaders;Action, Indie, RPG, Early Access;0 - 20,000;22;95;-73;0;0;0
335070;VRC PRO;Free to Play, Massively Multiplayer, RPG, Strategy;20,000 - 50,000;575;94;481;51;51;23
335090;Goscurry;Animation & Modeling, Design & Illustration, Photo Editing, Software Training, Utilities, Video Production;0 - 20,000;37;0;37;0;0;0
335100;Dwarf Tower;Action, Adventure, RPG;20,000 - 50,000;185;76;109;402;402;0
335120;Serpent in the Staglands;Indie, Racing;50,000 - 100,000;113;60;53;49;49;0
335190;200% Mixed Juice!;Free to Play;100,000 - 200,000;616;224;392;805;920;2
335200;ManaCollect;Casual, Indie, Sports, Strategy;0 - 20,000;44;26;18;0;0;0
335210;Rift's Cave;Casual, Indie;20,000 - 50,000;43;34;9;146;210;90
335220;But to Paint a Universe;Adventure, Indie;0 - 20,000;20;14;6;455;455;0
335240;Transformice;Adventure, Indie;2,000,000 - 5,000,000;20872;3027;17845;770;51;1999
335300;DARK SOULS II: Scholar of the First Sin;Adventure, Casual;2,000,000 - 5,000,000;74715;13003;61712;3929;2014;1906
335310;Eisenbahn X;Adventure, Casual;0 - 20,000;11;10;1;0;0;0
335320;Bet On Soldier;Adventure, Casual;100,000 - 200,000;176;81;95;248;388;1
335330;Brick-Force;Action, Indie;1,000,000 - 2,000,000;1656;2324;-668;101;14;0
335420;ルナティックドーン 前途への道標;Action, Indie;0 - 20,000;40;6;34;9;9;5
335430;Grimoire: Manastorm;Action, Adventure, Indie;200,000 - 500,000;694;324;370;148;151;0
335440;Dungeon Shooter 2;Action, RPG;0 - 20,000;1;3;-2;0;0;0
335450;Curse of the Assassin;Indie, RPG, Strategy;0 - 20,000;19;2;17;0;0;0
335560;Light Bound;Utilities;0 - 20,000;19;3;16;0;0;1
335570;Back To Life 3;Action, Adventure, Indie;0 - 20,000;3;5;-2;0;0;0
335620;Star Traders: Frontiers;Adventure;100,000 - 200,000;2703;485;2218;329;471;112
335660;CAFE 0 ~The Drowned Mermaid~;Indie, Strategy;20,000 - 50,000;106;59;47;827;827;0
335670;LISA: The Painful;Action;200,000 - 500,000;12363;479;11884;451;341;52
335690;dUpLicity ~Beyond the Lies~;Adventure, Indie, RPG, Strategy;0 - 20,000;24;38;-14;297;297;0
335700;I am Weapon: Revival;Indie, Simulation, Strategy;20,000 - 50,000;196;88;108;77;116;0
335770;Tkl Online;Adventure, Casual, Indie, RPG;0 - 20,000;14;8;6;0;0;0
335790;Words for Evil;Action, Adventure, Indie;20,000 - 50,000;359;89;270;211;246;1
335820;Dream Of Mirror Online;Action, Indie;100,000 - 200,000;299;226;73;11430;11430;12
335830;Distant Star: Revenant Fleet;Action, Indie, Early Access;50,000 - 100,000;190;98;92;0;0;0
335840;Goats on a Bridge;Adventure, Indie, RPG;20,000 - 50,000;127;39;88;0;0;1
335890;Nanofights;Action, Casual, Indie;50,000 - 100,000;288;243;45;0;0;0
335890;Nanofights;Action;50,000 - 100,000;288;243;45;0;0;0
335900;Angels of Fasaria: Version 2.0;Free to Play, Massively Multiplayer, RPG;50,000 - 100,000;24;38;-14;442;539;0
335920;Ephemerid: A Musical Adventure;Action, Adventure, Casual, Indie;20,000 - 50,000;199;17;182;0;0;0
335940;Mech Marines: Steel March;Casual, Indie;0 - 20,000;16;16;0;0;0;0
336010;MXGP - The Official Motocross Videogame Compact;Action, Adventure;20,000 - 50,000;115;43;72;20;20;1
336020;Pahelika: Secret Legends;Indie;0 - 20,000;29;33;-4;0;0;0
336030;Race.a.bit;Adventure, Indie;0 - 20,000;58;23;35;249;273;0
336040;Combat Monsters;Action, Indie;100,000 - 200,000;134;56;78;0;0;0
336060;Raptor: Call of The Shadows - 2015 Edition;Action, Casual, Indie;50,000 - 100,000;338;127;211;13;13;0
336080;Vietnam ‘65;Adventure, Simulation, Strategy;20,000 - 50,000;320;68;252;0;0;2
336090;Sky Mercenaries;Action, Adventure, Indie, Simulation;20,000 - 50,000;80;34;46;179;179;0
336100;Rooster Teeth vs. Zombiens;Adventure, Indie;0 - 20,000;36;20;16;0;0;0
336110;Bloody Streets;Action, Casual, Indie;20,000 - 50,000;95;25;70;0;0;0
336130;Shardlight;Simulation, Strategy;50,000 - 100,000;551;56;495;167;167;4
336140;Unavowed;Indie, Simulation, Strategy;100,000 - 200,000;1815;75;1740;367;367;12
336150;Virtual Pool 4;Adventure, Indie, RPG, Strategy;50,000 - 100,000;483;94;389;14626;21931;54
336200;Starlaxis Supernova Edition;Adventure, Indie, Simulation;0 - 20,000;33;21;12;339;433;1
336210;Just Death;Casual, Indie;0 - 20,000;14;18;-4;0;0;0
336220;ORBITOR;Simulation;0 - 20,000;22;11;11;0;0;0
336240;Typoman;Adventure, Casual, Indie, Simulation;100,000 - 200,000;619;95;524;53;53;1
336250;Monster Jam Battlegrounds;Free to Play, Massively Multiplayer, RPG, Early Access;20,000 - 50,000;58;69;-11;0;0;0
336280;Chronicles of a Dark Lord: Episode 1 Tides of Fate Complete;Indie, Sports;50,000 - 100,000;63;33;30;239;252;0
336380;Catmouth Island;Casual, Indie, Simulation, Strategy;20,000 - 50,000;43;39;4;152;152;0
336420;Bloodsports.TV;Adventure, Casual, Indie, RPG;100,000 - 200,000;444;133;311;339;360;1
336510;Anno Online;Action, Free to Play, Indie;200,000 - 500,000;486;535;-49;27;7;0
336520;Might & Magic Heroes Online;Action, Adventure, RPG, Early Access;200,000 - 500,000;314;466;-152;45;28;0
336530;PD Howler 9.6 Digital Painter and Visual FX box;Indie, Racing;0 - 20,000;18;9;9;0;0;0
336610;Outcast 1.1;Adventure, Casual, Indie;100,000 - 200,000;474;52;422;373;373;1
336630;Crash And Burn Racing;Casual;0 - 20,000;30;16;14;0;0;0
336630;Crash And Burn Racing;RPG;0 - 20,000;30;16;14;0;0;0
336670;HIT;Simulation;200,000 - 500,000;179;298;-119;16;17;0
336680;TREBUCHET;Simulation;0 - 20,000;31;11;20;0;0;0
336700;Elastrix;Simulation;0 - 20,000;21;3;18;0;0;0
336710;Supreme League of Patriots - Episode 2: Patriot Frames;Adventure, Casual;20,000 - 50,000;31;11;20;245;245;0
336730;Supreme League of Patriots - Episode 3: Ice Cold in Ellis;Casual, Indie;20,000 - 50,000;27;14;13;247;247;0
336760;Pilot Brothers;Strategy;50,000 - 100,000;204;31;173;0;0;1
336770;Pilot Brothers 2;Action, Adventure, Indie, RPG;0 - 20,000;63;12;51;0;0;0
336840;Color Guardians;Action, Indie;0 - 20,000;23;3;20;0;0;0
336840;Color Guardians;Action, Free to Play;0 - 20,000;23;3;20;0;0;0
336930;Redux: Dark Matters;Action, Adventure, Casual, Indie, Racing;;;;0;;;
336940;Basingstoke;Action, Indie;20,000 - 50,000;241;103;138;253;364;0
337000;Deus Ex: Mankind Divided;Casual, Indie;2,000,000 - 5,000,000;28281;9429;18852;1234;555;309
337040;Deadnaut;Action, Adventure;50,000 - 100,000;100;51;49;142;142;1
337070;Dimmdrive :: Gaming Ramdrive @ 10,000+ MB/s;Action, Adventure, Indie, RPG;20,000 - 50,000;270;160;110;32;32;5
337130;Bosch's Damnation;Adventure, Indie, RPG;0 - 20,000;8;3;5;0;0;0
337150;Sentinels of the Multiverse;Action, Indie;100,000 - 200,000;1320;152;1168;1304;360;41
337180;Velocity 2X;Casual, Indie, Simulation, Strategy;50,000 - 100,000;81;47;34;194;194;0
337210;Royal Bounty HD;Action, RPG;0 - 20,000;95;64;31;0;0;1
337270;Ostrich Island;Adventure, Indie, RPG;50,000 - 100,000;218;39;179;197;197;0
337280;Planetship;Action, Casual, Indie;0 - 20,000;46;21;25;0;0;0
337290;Still Not Dead;Action, Free to Play, Massively Multiplayer, RPG, Simulation, Strategy;20,000 - 50,000;143;38;105;91;102;0
337320;Paint the Town Red;Casual, Indie;1,000,000 - 2,000,000;20578;950;19628;811;556;297
337340;Finding Paradise;Indie, Simulation, Strategy;200,000 - 500,000;14499;315;14184;254;299;18
337350;Flywrench;Casual, Indie, Simulation;20,000 - 50,000;274;10;264;0;0;1
337360;Dead Island Retro Revenge;;100,000 - 200,000;229;167;62;491;491;0
337410;Karos;Casual, Indie, Strategy;200,000 - 500,000;377;248;129;484;327;472
337420;Final Dusk;Action, Indie;100,000 - 200,000;288;93;195;167;185;1
337460;18 Wheels of Steel: Pedal to the Metal;Indie, Simulation, Strategy;0 - 20,000;48;6;42;0;0;1
337480;Zombie Vikings;Free to Play, Indie, Strategy;20,000 - 50,000;253;68;185;326;335;0
337490;Four Sided Fantasy;Indie, RPG, Strategy;50,000 - 100,000;311;69;242;12;12;0
337650;Soft Body;Action, RPG, Early Access;0 - 20,000;39;4;35;0;0;0
337670;Default Dan;Action, Indie, Racing;0 - 20,000;52;7;45;0;0;0
337680;Star Hammer: The Vanguard Prophecy;Casual, Simulation, Strategy;0 - 20,000;110;37;73;178;178;0
337700;SCS deORBIT;Casual, Simulation, Strategy;0 - 20,000;17;8;9;0;0;0
337720;The Sea Will Claim Everything;Action, Casual, Indie;20,000 - 50,000;201;6;195;0;0;0
337730;Battletank LOBA;Action, Adventure;0 - 20,000;4;9;-5;0;0;0
337760;Decisive Campaigns: The Blitzkrieg from Warsaw to Paris;Adventure, Indie;0 - 20,000;93;10;83;0;0;4
337820;The Mims Beginning;Casual, Indie;20,000 - 50,000;193;63;130;3;3;1
337850;Avernum 2: Crystal Souls;Action, Adventure, Free to Play, Indie;50,000 - 100,000;238;29;209;0;0;9
337880;One Late Night: Deadline;Adventure, Indie;0 - 20,000;44;116;-72;0;0;0
337890;Dysfunctional Systems: Orientation;Casual, Indie;0 - 20,000;42;11;31;0;0;0
337930;Nameless ~The one thing you must recall~;Adventure, Indie;20,000 - 50,000;662;48;614;0;0;6
337940;X-note;;20,000 - 50,000;125;124;1;150;247;0
337950;The SKIES - BETA;Simulation, Strategy;1,000,000 - 2,000,000;1683;2311;-628;82;30;0
337970;Wildlife Park - Wild Creatures;Action, Adventure;0 - 20,000;16;8;8;0;0;0
337980;Vagrant Hearts;Action, Adventure, Indie, Early Access;20,000 - 50,000;84;31;53;0;0;0
338000;Echoes+;Action, Indie, RPG, Strategy;100,000 - 200,000;792;67;725;37;69;0
338030;Mission Control: NanoMech;Action, Free to Play, RPG, Strategy;0 - 20,000;3;9;-6;0;0;0
338040;Bears Can't Drift!?;Action, Casual, Indie;0 - 20,000;40;20;20;0;0;0
338050;Anoxemia;Casual, Indie;200,000 - 500,000;265;151;114;264;310;0
338060;Mahjong Pretty Girls Battle;Action, Adventure;20,000 - 50,000;240;138;102;285;312;0
338070;ルナティックドーン レジェンドパック;Indie, RPG;0 - 20,000;17;2;15;0;0;1
338080;A列車で行こう8;Casual, Indie, RPG, Strategy;0 - 20,000;8;2;6;0;0;0
338090;ATLAS レジェンドパック;Action, Indie, Early Access;0 - 20,000;10;6;4;0;0;0
338100;栄冠は君に レジェンドパック;Action, Adventure, Indie;0 - 20,000;4;1;3;0;0;0
338110;Khaba;Adventure, Casual, Indie;0 - 20,000;27;3;24;207;207;0
338120;Marble Duel: Sphere-Matching Tactical Fantasy;Action, Casual, Indie;50,000 - 100,000;195;114;81;266;294;1
338130;Strategy & Tactics: Wargame Collection;Indie, RPG;50,000 - 100,000;174;75;99;242;242;3
338140;Venetica - Gold Edition;Action, Adventure, Casual, Indie, Strategy, Early Access;100,000 - 200,000;431;119;312;134;194;3
338170;Ratz Instagib;Action, Indie, RPG, Early Access;100,000 - 200,000;3232;413;2819;277;358;29
338180;Batla;Casual, Indie, Early Access;500,000 - 1,000,000;1970;1162;808;140;26;1
338190;Just Get Through;Indie, RPG, Strategy;20,000 - 50,000;185;29;156;245;245;0
338260;Usagi Yojimbo: Way of the Ronin;Adventure, Indie, RPG, Strategy;0 - 20,000;13;13;0;0;0;0
338290;Molecats;Action, Adventure, Casual, Indie;0 - 20,000;17;4;13;121;121;0
338300;Disney's Chicken Little: Ace in Action;Free to Play, Massively Multiplayer, Strategy;0 - 20,000;35;16;19;0;0;0
338310;Warden: Melody of the Undergrowth;Action, Casual, Free to Play, Massively Multiplayer, Sports;0 - 20,000;60;14;46;0;0;0
338310;Warden: Melody of the Undergrowth;Indie, RPG, Strategy;0 - 20,000;60;14;46;0;0;0
338330;Super Treasure Arena;Action, Indie;0 - 20,000;41;22;19;84;84;0
338350;Farm World;Action, Adventure, Indie, RPG;0 - 20,000;7;11;-4;0;0;0
338350;Farm World;Action, Adventure, Indie;0 - 20,000;7;11;-4;0;0;0
338390;The Technomancer;Indie;100,000 - 200,000;1765;792;973;560;1045;8
338420;Alum;Racing, Simulation, Sports;50,000 - 100,000;123;48;75;1;1;0
338530;Trouble In The Manor;Indie, RPG, Simulation, Strategy;200,000 - 500,000;172;133;39;257;237;0
338540;Navy Field 2 : Conqueror of the Ocean;RPG, Early Access;500,000 - 1,000,000;613;764;-151;76;38;0
338550;Terra Lander Remastered;Adventure, Indie;50,000 - 100,000;129;91;38;0;0;0
338590;The Race for the White House;Adventure, Indie;0 - 20,000;31;18;13;104;104;0
338630;Wildlife Camp;Adventure, Indie, Massively Multiplayer, RPG, Strategy;0 - 20,000;30;11;19;0;0;0
338640;Subsiege;Action, Indie, Early Access;20,000 - 50,000;52;41;11;0;0;0
338710;Urja;Action;20,000 - 50,000;90;84;6;285;345;0
338760;Death Ray Manta SE;Indie, RPG;50,000 - 100,000;153;49;104;107;211;0
338810;Demise of Nations;Action, Adventure, Indie, RPG, Simulation, Strategy;200,000 - 500,000;377;89;288;565;847;10
338820;Retro Commander;Casual, Indie, Strategy;0 - 20,000;89;19;70;0;0;2
338830;Star Nomad;Action, Casual;0 - 20,000;28;17;11;236;236;0
338830;Star Nomad;Action, Casual;0 - 20,000;28;17;11;236;236;0
338890;Harold;Action, Casual, Indie, Massively Multiplayer, RPG, Early Access;0 - 20,000;39;14;25;0;0;0
338960;Rescue Team;Indie, Simulation, Strategy, Early Access;20,000 - 50,000;124;12;112;147;232;4
338980;MOAI: Build Your Dream;Action, RPG;20,000 - 50,000;145;36;109;0;0;2
339000;Ukrainian Ninja;Action, Simulation, Early Access;100,000 - 200,000;547;175;372;179;188;3
339040;Disney's Chicken Little;Casual, Indie, Simulation;20,000 - 50,000;331;131;200;256;256;9
339090;Pig Eat Ball;Indie, Strategy;20,000 - 50,000;73;2;71;0;0;0
339110;Plith;Indie, Strategy;0 - 20,000;17;16;1;212;212;4
339120;Fork Parker's Holiday Profit Hike;Indie;100,000 - 200,000;563;110;453;145;97;0
339130;Morningstar: Descent to Deadrock;Casual, Indie;50,000 - 100,000;478;34;444;178;201;0
339160;Tales of the Orient: The Rising Sun;Indie;50,000 - 100,000;299;60;239;285;303;0
339190;Dead Synchronicity: Tomorrow Comes Today;Action, Indie;100,000 - 200,000;1054;203;851;98;153;2
339200;Oceanhorn: Monster of Uncharted Seas;Adventure, Casual, Indie;200,000 - 500,000;1512;379;1133;215;279;5
339210;RESCUE 2: Everyday Heroes;Adventure, Casual, Indie;;;;0;;;
339230;ZOMBI;Adventure, Indie, RPG;100,000 - 200,000;1511;841;670;554;687;7
339240;10 Years After;Adventure, Indie, RPG, Strategy;0 - 20,000;14;105;-91;10;10;0
339250;Winged Sakura: Endless Dream;Casual, Indie, Simulation;0 - 20,000;19;8;11;0;0;2
339280;Strife;Action, Free to Play, Indie;1,000,000 - 2,000,000;3632;1155;2477;259;131;0
339290;Castle;Casual, Indie, Strategy;100,000 - 200,000;182;88;94;142;215;4
339320;Snake Blocks;Adventure, Casual;20,000 - 50,000;48;19;29;9;9;0
339320;Snake Blocks;Action, Indie;20,000 - 50,000;48;19;29;9;9;0
339340;Resident Evil 0;Action, Indie;500,000 - 1,000,000;7561;1494;6067;376;182;95
339400;Runestone Keeper;Indie, RPG;200,000 - 500,000;2040;366;1674;479;602;3
339440;Critical Annihilation;Racing, Sports, Early Access;0 - 20,000;179;25;154;0;0;0
339460;A Pixel Story;Action, Indie, RPG, Strategy;0 - 20,000;35;8;27;13;13;0
339460;A Pixel Story;Indie;0 - 20,000;35;8;27;13;13;0
339470;Retention;Action, Casual, Free to Play, Indie, Strategy;500,000 - 1,000,000;222;445;-223;224;221;34
339500;Blasted Fortress;Adventure, Casual, Indie;0 - 20,000;4;10;-6;0;0;0
339510;Psy High;Action, Casual, Indie;0 - 20,000;113;31;82;2959;2959;0
339530;Factions: Origins of Malu;Indie;0 - 20,000;15;12;3;0;0;0
339560;Man Alive;Adventure, Casual, RPG, Strategy;0 - 20,000;5;17;-12;0;0;0
339580;Ember;Action, Indie;200,000 - 500,000;691;217;474;324;493;3
339590;Crowman & Wolfboy;Indie, RPG, Sports, Strategy, Early Access;20,000 - 50,000;59;16;43;168;168;0
339600;VEGA Conflict;Action, Adventure, Free to Play, Massively Multiplayer;500,000 - 1,000,000;2670;1891;779;2898;245;528
339610;Freestyle 2: Street Basketball;Action;5,000,000 - 10,000,000;8801;3253;5548;659;69;302
339640;Jagged Alliance Online: Reloaded;Casual, Indie, Simulation, Strategy, Early Access;0 - 20,000;80;69;11;369;369;0
339690;Paperbound;Action, Indie;0 - 20,000;26;3;23;0;0;0
339700;I, Gladiator;Indie, RPG, Strategy;20,000 - 50,000;98;55;43;0;0;0
339710;Cyber Chicken;Action, Casual, Indie;0 - 20,000;9;10;-1;0;0;0
339720;Debugger 3.16: Hack'n'Run;Indie, RPG;0 - 20,000;25;7;18;0;0;0
339790;rFactor;Action, Casual, Indie, Early Access;50,000 - 100,000;604;63;541;5;5;54
339800;HuniePop;Casual, Indie;1,000,000 - 2,000,000;26390;1002;25388;710;650;183
339820;Starwalker;Adventure, Casual, Indie, Strategy;100,000 - 200,000;10;20;-10;240;277;0
339830;The Church in the Darkness ;Casual, Indie, Simulation;0 - 20,000;73;49;24;190;190;1
339840;The Moment of Silence;Action, Indie;20,000 - 50,000;60;33;27;847;847;2
339840;The Moment of Silence;Action, Casual, Indie;20,000 - 50,000;60;33;27;847;847;2
339850;Overclocked: A History of Violence;Indie;20,000 - 50,000;77;23;54;0;0;0
339860;none;Action, Adventure, Casual, Free to Play, Indie, Massively Multiplayer, RPG, Early Access;50,000 - 100,000;84;36;48;470;559;0
339910;Uncraft World;Action, Indie, RPG;20,000 - 50,000;395;71;324;192;283;0
340000;Headlander;Action, Adventure, Indie;100,000 - 200,000;861;88;773;146;136;4
340030;Dungeon of gain;Action, Indie, Simulation;50,000 - 100,000;7;46;-39;269;269;0
340050;Survivalist;Indie, Strategy;200,000 - 500,000;1959;485;1474;136;132;12
340070;Battle Ranch: Pigs vs Plants;Strategy;100,000 - 200,000;491;495;-4;210;230;4
340130;Moorhuhn Invasion (Crazy Chicken Invasion);Indie;20,000 - 50,000;43;13;30;0;0;0
340140;Elemental World Part 1:Rise Of The Guardians;Indie, Simulation, Sports, Early Access;0 - 20,000;3;3;0;0;0;0
340150;Basement;Action, Adventure;100,000 - 200,000;1504;616;888;204;279;9
340170;FINAL FANTASY TYPE-0 HD;Casual, Indie, Simulation, Strategy;200,000 - 500,000;1754;1090;664;195;223;17
340190;Night Crisis;Action, Adventure, Indie, Early Access;0 - 20,000;8;28;-20;0;0;0
340200;Bloop;Action, Adventure, Indie, RPG;100,000 - 200,000;167;192;-25;144;146;0
340210;Predestination;Indie, Simulation, Strategy;0 - 20,000;39;41;-2;0;0;0
340220;Shadows of War;Indie, Strategy;50,000 - 100,000;49;95;-46;182;240;0
340250;Crystal Towers 2 XL;Action, Adventure, Indie;0 - 20,000;19;2;17;439;439;0
340270;TIMEframe;Action, Indie;50,000 - 100,000;429;222;207;0;0;1
340280;Cubot;Action;20,000 - 50,000;248;24;224;81;97;0
340290;Dr.Green;Action, Adventure, Casual, Indie;0 - 20,000;28;13;15;0;0;0
340300;Teddy Floppy Ear - Mountain Adventure;Indie;50,000 - 100,000;619;82;537;293;304;0
340310;Teddy Floppy Ear - Kayaking;Indie, RPG, Strategy;100,000 - 200,000;453;134;319;204;221;3
340320;Sinless + OST;Action, Adventure, Casual, Indie;100,000 - 200,000;179;71;108;171;210;1
340330;Deity Quest;;0 - 20,000;21;7;14;0;0;0
340340;Domestic Dog;Action, Adventure, Casual, Indie;20,000 - 50,000;388;96;292;24;39;0
340350;Quintet;Indie, RPG, Early Access;100,000 - 200,000;274;86;188;16;21;0
340360;Tomb of Tyrants;Casual, Indie;20,000 - 50,000;253;52;201;0;0;1
340370;Shades of Black;Adventure, Indie, RPG;0 - 20,000;17;1;16;0;0;0
340380;Pizzarian;Action, Indie;0 - 20,000;16;2;14;0;0;0
340390;Abomination Tower;Adventure, Indie;0 - 20,000;32;9;23;0;0;0
340400;Lucid Awakening 2;Indie, RPG, Strategy;0 - 20,000;6;2;4;0;0;0
340410;SuperBike TT;Action, Indie;0 - 20,000;3;3;0;0;0;0
340440;Grand Class Melee 2;RPG;20,000 - 50,000;37;11;26;0;0;0
340450;Crashed Lander;Action, Adventure, RPG, Simulation, Strategy;0 - 20,000;40;12;28;1;1;0
340460;Spartans Vs Zombies Defense;Action, Casual, Indie, RPG, Early Access;200,000 - 500,000;339;396;-57;104;139;0
340470;You Are Not a Banana: Better Edition;Action, Adventure, Indie, Strategy;20,000 - 50,000;90;50;40;306;416;0
340480;Project Green Beat;Casual, Indie, RPG;0 - 20,000;14;6;8;0;0;0
340500;The Warriorlock;Action, Indie;0 - 20,000;27;9;18;0;0;0
340520;Tallowmere;Adventure, Casual, Indie, Simulation;100,000 - 200,000;726;69;657;0;0;2
340530;Soccer Legends;Action, Indie;20,000 - 50,000;7;12;-5;0;0;0
340540;TDP4:Team Battle;Action, Indie, RPG, Strategy, Early Access;200,000 - 500,000;440;397;43;30;46;0
340550;Crunch Time!;Adventure, Indie, RPG, Simulation, Strategy;0 - 20,000;38;37;1;0;0;0
340560;Wanted Corp.;Action, Adventure, RPG, Early Access;0 - 20,000;5;6;-1;0;0;0
340570;WolfWars;Action, Indie, Simulation;0 - 20,000;9;7;2;0;0;0
340580;Armed with Wings: Rearmed;Adventure, Indie;50,000 - 100,000;408;57;351;156;278;0
340600;The Depths of Tolagal;Indie, RPG, Simulation;20,000 - 50,000;33;6;27;0;0;0
340630;Ninja Guy;Casual, Indie, Simulation, Strategy;20,000 - 50,000;43;120;-77;0;0;0
340650;Elements: Soul of Fire;Casual, Free to Play, Indie, Simulation;50,000 - 100,000;95;97;-2;306;279;0
340680;Bunny Bash;Action, Indie;0 - 20,000;8;5;3;0;0;0
340700;Aqua Panic !;Adventure, Indie;0 - 20,000;11;1;10;0;0;0
340720;The Tiny Tale 2;Action, Indie;0 - 20,000;30;5;25;0;0;1
340730;Sunrider Academy;Indie, Strategy;50,000 - 100,000;960;190;770;422;443;6
340750;Gunslugs 2;Indie, RPG;0 - 20,000;18;17;1;0;0;0
340750;Gunslugs 2;Indie;0 - 20,000;18;17;1;0;0;0
340770;Death Goat;Casual, Indie, Simulation;50,000 - 100,000;259;80;179;538;805;1
340800;Unhack;Action, Adventure, Indie;20,000 - 50,000;253;42;211;62;62;2
340810;Deepworld;Action, Adventure, Indie;200,000 - 500,000;436;293;143;209;65;0
340830;Razenroth;Action, Indie;100,000 - 200,000;477;109;368;266;301;3
340840;The Corridor: On Behalf Of The Dead;Indie, RPG, Strategy;200,000 - 500,000;24;7;17;0;0;0
340860;RaidersSphere4th;Indie, Simulation, Strategy;20,000 - 50,000;113;45;68;191;235;0
340880;Solar War;Action, Indie;100,000 - 200,000;26;4;22;0;0;0
340920;Siege of Turtle Enclave;Indie, Strategy;0 - 20,000;5;11;-6;0;0;0
340920;Siege of Turtle Enclave;Animation & Modeling, Design & Illustration, Photo Editing, Video Production;0 - 20,000;5;11;-6;0;0;0
340950;Let There Be Life;Action, Adventure, Indie;0 - 20,000;21;12;9;0;0;0
340960;Pulsen;Action, Adventure, Indie;0 - 20,000;49;14;35;0;0;0
340990;Disney Bolt;Adventure, Indie, RPG;0 - 20,000;110;35;75;0;0;1
341000;Mad Games Tycoon;Indie;500,000 - 1,000,000;3954;406;3548;710;908;16
341010;Pluck;Action, Indie, RPG;0 - 20,000;0;3;-3;0;0;0
341020;Chronicles of Teddy;Action, Free to Play, Strategy;20,000 - 50,000;208;91;117;52;52;0
341030;Colonial Conquest;Action, Adventure, Indie;20,000 - 50,000;146;91;55;0;0;2
341030;Colonial Conquest;Indie, Strategy;20,000 - 50,000;146;91;55;0;0;2
341040;Wars Across The World;Action, Free to Play, Massively Multiplayer, Simulation, Strategy;0 - 20,000;139;31;108;0;0;2
341060;The Lady;Action, Indie, Simulation;50,000 - 100,000;92;125;-33;307;309;0
341070;Stay Dead Evolution;Action, Indie;20,000 - 50,000;46;71;-25;0;0;0
341080;NeXus: One Core;Adventure, Casual, Indie;20,000 - 50,000;14;9;5;0;0;0
341090;On A Roll 3D;Adventure, Indie;50,000 - 100,000;229;32;197;549;549;0
341120;Glorkian Warrior: The Trials Of Glork;Action, Adventure, Indie, Massively Multiplayer;20,000 - 50,000;305;33;272;183;229;1
341150;Age of Fear 2: The Chaos Lord GOLD;Action, Indie;20,000 - 50,000;247;63;184;463;463;2
341160;Steam Heroes;Indie, Simulation, Strategy;20,000 - 50,000;31;79;-48;379;360;0
341170;Adventures of Chris;Action, Adventure, Indie;0 - 20,000;115;14;101;0;0;1
341190;Hotline Miami 2: Wrong Number Digital Comic;Adventure, Casual, Indie;100,000 - 200,000;276;23;253;11;12;2
341260;Isaac the Adventurer;Sexual Content, Nudity, Casual, Indie;0 - 20,000;11;17;-6;0;0;0
341270;Samphi;Adventure, Indie;0 - 20,000;15;14;1;0;0;0
341290;Lazors;Action, Indie;0 - 20,000;20;2;18;0;0;0
341310;Greyfox RPG;Adventure, Indie;500,000 - 1,000,000;1302;444;858;258;237;1
341360;Paparazzi;Indie, Simulation, Strategy;0 - 20,000;9;8;1;0;0;0
341380;Countless Rooms of Death;Casual, Indie, RPG;20,000 - 50,000;13;25;-12;284;300;0
341440;BANZAI PECAN: The Last Hope For the Young Century;Action, Indie;0 - 20,000;42;53;-11;0;0;0
341460;Fallen Temple;Action, Casual, Indie, Early Access;0 - 20,000;2;2;0;0;0;0
341470;Loot Hunter;Adventure, Indie, Early Access;20,000 - 50,000;71;31;40;1259;1259;0
341490;Undead Legions II;Indie;0 - 20,000;6;2;4;0;0;0
341500;Camera Obscura;Action, Indie, Strategy;200,000 - 500,000;1115;421;694;211;201;0
341510;Crayon Chronicles;Action, Casual, Free to Play, RPG, Simulation, Strategy;0 - 20,000;39;15;24;0;0;0
341530;Stardust Vanguards;Casual, Strategy;20,000 - 50,000;81;18;63;205;264;1
341540;TRIP Steam Edition;Indie;0 - 20,000;136;155;-19;1;2;0
341550;Super Cyborg;Action, Adventure, Casual, Indie;50,000 - 100,000;618;88;530;432;440;2
341570;Throbax TD;Adventure, Casual;0 - 20,000;23;5;18;0;0;0
341640;Relativity Wars - A Science Space RTS;Action, Adventure, Indie, RPG, Simulation;20,000 - 50,000;9;14;-5;0;0;0
341660;Barren Roads;Action, Casual, Indie, Racing, Simulation;0 - 20,000;32;42;-10;0;0;0
341680;stratO;Action, Sports, Strategy, Early Access;0 - 20,000;51;9;42;0;0;0
341690;The Great Fusion;Action, Casual, Indie;20,000 - 50,000;43;23;20;0;0;0
341700;Cahors Sunset;Indie, RPG, Strategy;0 - 20,000;48;27;21;0;0;0
341710;Crest - an indirect god sim;Action, Adventure, Indie, Racing, Simulation, Sports, Early Access;0 - 20,000;245;122;123;223;223;0
341720;Among Ripples;Casual, Strategy;200,000 - 500,000;970;453;517;11;7;0
341730;Dustoff Heli Rescue;Indie, Simulation, Early Access;20,000 - 50,000;303;55;248;67;67;0
341750;A.V.;Action, Casual, Indie;0 - 20,000;12;10;2;12;12;0
341760;Flem;Indie, Massively Multiplayer, RPG, Early Access;;;;0;;;
341770;Geared;Casual, Indie, Simulation, Strategy;0 - 20,000;4;7;-3;0;0;0
341780;Chronicles of a Dark Lord: Episode II War of The Abyss;Action, Free to Play, Indie, RPG;50,000 - 100,000;33;20;13;267;267;0
341800;Keep Talking and Nobody Explodes;Adventure, Casual, Indie;1,000,000 - 2,000,000;11519;263;11256;256;142;517
341820;Plush;Adventure;0 - 20,000;67;11;56;95;95;0
341860;SickBrick;Action, Indie;50,000 - 100,000;111;94;17;106;106;0
341870;TEMBO THE BADASS ELEPHANT;Simulation;50,000 - 100,000;396;135;261;399;504;0
341890;HitBox;Indie, Simulation;20,000 - 50,000;79;56;23;9;9;0
341910;Ultimate Space Commando;Action, Adventure, Casual, Indie, RPG, Strategy;0 - 20,000;42;9;33;0;0;0
341930;Space Station Alpha;Action, Casual, Indie, Racing, Simulation, Sports;20,000 - 50,000;36;41;-5;2;2;0
341940;Hatred;Adventure, Racing;500,000 - 1,000,000;11456;2694;8762;212;199;39
341950;Lux Delux;Action, Adventure, Casual, Indie, RPG;100,000 - 200,000;270;68;202;232;232;18
341960;DP Animation Maker;Action, Indie;0 - 20,000;43;9;34;0;0;2
342020;BiT Evolution;Casual;50,000 - 100,000;96;79;17;707;1403;1
342080;Rogue Invader;Casual, Indie;20,000 - 50,000;48;2;46;0;0;0
342090;The Clans - Saga of the Twins;Adventure, Indie;50,000 - 100,000;22;41;-19;754;1061;7
342100;Sym;Action, Indie, RPG, Simulation, Strategy;0 - 20,000;31;5;26;0;0;0
342130;Hashtag Dungeon;Action, Indie, RPG;0 - 20,000;20;13;7;0;0;0
342150;Games of Glory;Action, Indie;20,000 - 50,000;322;244;78;39;42;0
342180;Arizona Sunshine;Casual, Indie, Strategy;500,000 - 1,000,000;6601;1671;4930;223;134;64
342190;Skyworld;Indie, RPG;20,000 - 50,000;195;51;144;0;0;4
342200;MechWarrior Online Solaris 7;Casual;1,000,000 - 2,000,000;8154;2128;6026;2076;74;826
342230;Air Guardians;Indie;50,000 - 100,000;77;100;-23;11;11;0
342250;Aspectus: Rinascimento Chronicles;Adventure, Casual;0 - 20,000;2;0;2;0;0;0
342260;Nevermind;Action, Casual, Indie, Racing, Simulation;50,000 - 100,000;325;93;232;198;198;0
342280;Manyland;Indie;0 - 20,000;237;39;198;0;0;3
342300;Zombie Kill of the Week - Reborn;Casual, Indie;50,000 - 100,000;901;87;814;234;241;2
342310;RIOT: Civil Unrest;Action, Casual, Free to Play, Strategy;100,000 - 200,000;1021;469;552;402;511;3
342350;Into The Gloom;Action;20,000 - 50,000;177;42;135;291;291;1
342360;Train of Afterlife;Adventure, Indie;20,000 - 50,000;91;90;1;0;0;0
342380;Sakura Angels;Adventure, Casual, Free to Play, Indie;200,000 - 500,000;1854;361;1493;324;287;2
342450;Sword Daughter;Action, Casual, Free to Play, Indie;20,000 - 50,000;62;56;6;0;0;0
342480;Gunscape;Indie, RPG;200,000 - 500,000;849;389;460;47;65;0
342490;Shipwreck;Casual, Indie;0 - 20,000;169;40;129;0;0;0
342500;Human Extinction Simulator;Casual, Indie, Simulation;20,000 - 50,000;13;25;-12;4;4;0
342510;Bret Airborne;Adventure, Indie;0 - 20,000;42;25;17;0;0;0
342520;BoxesWithGuns;Adventure, Indie;20,000 - 50,000;17;65;-48;24;24;0
342530;Heroes Never Lose: Professor Puzzler's Perplexing Ploy;Adventure, Indie;0 - 20,000;64;10;54;315;315;0
342540;Terminal Hacker - Into the Deep;Adventure, Indie;0 - 20,000;3;11;-8;0;0;0
342550;Phantasmal: Survival Horror Roguelike;Adventure, Indie;20,000 - 50,000;140;177;-37;0;0;1
342550;Phantasmal: Survival Horror Roguelike;Adventure, Indie;20,000 - 50,000;140;177;-37;0;0;1
342560;Airships: Conquer the Skies;Adventure, Casual, Indie, Strategy;200,000 - 500,000;4557;189;4368;436;534;89
342580;12 Labours of Hercules;Casual, Strategy;100,000 - 200,000;2740;185;2555;379;298;7
342610;HyperRogue;Adventure, Casual;100,000 - 200,000;377;18;359;148;148;3
342620;It came from space and ate our brains;Adventure, Casual, Early Access;200,000 - 500,000;400;97;303;95;138;0
342630;Witch's Pranks: Frog's Fortune Collector's Edition;Action, Adventure, Casual, Indie, RPG;20,000 - 50,000;192;35;157;372;372;0
342640;Pixel Privateers;Action, Indie;50,000 - 100,000;624;256;368;74;132;1
342650;Fermi's Path;Casual, Indie, Simulation, Strategy;0 - 20,000;35;18;17;5;5;0
342660;Brawlerz Arena;Action, Early Access;0 - 20,000;1;1;0;0;0;0
342860;Dark Quest;Free to Play, Indie, RPG, Strategy;20,000 - 50,000;99;35;64;0;0;1
342870;Corona MotorSport;Action, Indie, Racing, Early Access;0 - 20,000;24;45;-21;0;0;0
342890;Synonymy;Casual, Indie, Simulation, Strategy;20,000 - 50,000;37;40;-3;87;87;1
342910;Vantage: Primitive Survival Game;Action, Adventure, Indie, RPG, Strategy;0 - 20,000;43;29;14;0;0;0
342920;Toto Temple Deluxe;Adventure, Indie, RPG;0 - 20,000;45;7;38;0;0;0
342940;Project: Gorgon;Casual, Indie, Strategy;50,000 - 100,000;1677;269;1408;927;927;126
342970;Pixel Survivors;Action, Indie;50,000 - 100,000;185;91;94;271;294;3
342980;Destination Sol;Indie, Simulation, Sports, Strategy;500,000 - 1,000,000;1051;278;773;27;14;0
342990;15 Days;Action, Adventure, Indie;20,000 - 50,000;45;93;-48;637;637;0
343000;The Mystery of the Druids;Adventure, Casual;20,000 - 50,000;58;52;6;0;0;0
343020;MagNets;Indie;0 - 20,000;10;2;8;203;203;0
343070;World of Subways 4 – New York Line 7;Adventure, Indie;50,000 - 100,000;223;106;117;163;163;2
343090;SimpleRockets;Adventure;100,000 - 200,000;300;52;248;1821;2017;2
343100;Overture;Action, Adventure, Indie, Strategy;200,000 - 500,000;942;285;657;181;178;2
343120;Motorbike;Action, Adventure, Indie, RPG, Simulation;0 - 20,000;36;23;13;0;0;0
343140;Disney•Pixar Cars: Radiator Springs Adventures;Indie;0 - 20,000;43;30;13;0;0;4
343150;Endica VII The Dream King;Simulation, Sports;0 - 20,000;25;33;-8;0;0;0
343170;Cyberpunk 3776;Simulation, Sports;0 - 20,000;28;31;-3;0;0;0
343250;Gene;Indie, RPG, Simulation, Strategy, Early Access;0 - 20,000;4;1;3;0;0;0
343270;Disillusions Manga Horror;Indie, Simulation, Strategy;20,000 - 50,000;311;216;95;154;181;0
343280;Zotrix;Indie, Simulation, Strategy;50,000 - 100,000;122;78;44;292;294;0
343320;StaudSoft's Synthetic World Beta;Adventure, Indie, RPG, Strategy;0 - 20,000;16;8;8;0;0;0
343340;Tiamat X;Action, Adventure, Indie, RPG;20,000 - 50,000;41;71;-30;226;234;1
343360;Particula;Action, Adventure, Casual, Indie, Racing, RPG, Simulation, Strategy, Early Access;500,000 - 1,000,000;1604;697;907;315;327;8
343370;SLAMMED!;Action, Indie;0 - 20,000;103;5;98;0;0;0
343390;Elementary My Dear Majesty!;Action, Adventure, Indie;200,000 - 500,000;125;45;80;198;209;0
343410;inSynch;Adventure, Casual, Indie;0 - 20,000;8;2;6;0;0;0
343430;Hypnosis;Indie, Massively Multiplayer, Simulation, Strategy;0 - 20,000;24;4;20;0;0;0
343440;Crash Drive 2;Action, Adventure, RPG, Early Access;200,000 - 500,000;1139;141;998;253;264;5
343560;Bob Was Hungry;Simulation;50,000 - 100,000;526;69;457;310;448;1
343570;Rainbow Hero;Action, Casual, Indie;0 - 20,000;23;3;20;0;0;0
343630;CroNix;Action, Indie;200,000 - 500,000;206;235;-29;173;332;0
343690;Silicone-2;Casual, Indie, Strategy;0 - 20,000;17;17;0;139;139;0
343710;Kholat;Action, Adventure, Indie;2,000,000 - 5,000,000;4244;2060;2184;1096;301;9
343730;Irrational Exuberance: Prologue;Action, Casual, Indie;100,000 - 200,000;300;53;247;11;15;0
343740;InMind VR;Adventure, Indie;200,000 - 500,000;334;88;246;6;6;0
343750;Firefly Online Cortex;Action, Adventure, Indie, RPG;100,000 - 200,000;278;380;-102;15;22;0
343770;Rotieer;Action, Adventure, Casual, Indie;0 - 20,000;5;9;-4;0;0;0
343780;Cat Goes Fishing;Strategy;200,000 - 500,000;7647;464;7183;461;314;116
343800;Shadowgate: MacVenture Series;Adventure, Indie;20,000 - 50,000;38;25;13;55;108;1
343810;The Uninvited: MacVenture Series;Action, Strategy;20,000 - 50,000;50;7;43;87;113;0
343820;Déjà Vu: MacVenture Series;Action, Strategy;20,000 - 50,000;39;15;24;7;7;0
343830;Déjà Vu II: MacVenture Series;Action, Adventure, Indie;0 - 20,000;14;7;7;315;315;0
343840;Trash TV;Adventure;20,000 - 50,000;110;15;95;17;29;0
343860;Tacoma;Design & Illustration, Education;100,000 - 200,000;3494;565;2929;233;218;2
343930;Fort Defense;Design & Illustration, Education, Utilities;200,000 - 500,000;273;87;186;253;276;48
343990;Anti-Opoly;Action, Adventure, Indie, Strategy, Early Access;0 - 20,000;21;31;-10;0;0;0
344030;Ghost Pirates of Vooju Island;Action, Adventure, Indie;0 - 20,000;42;34;8;0;0;0
344100;Never Ending Night;RPG;0 - 20,000;14;7;7;0;0;0
344130;Cataegis : The White Wind;Utilities;200,000 - 500,000;246;121;125;318;337;0
344160;World of Cinema - Movie Tycoon;Adventure;0 - 20,000;13;29;-16;0;0;0
344180;Valiant;Adventure, Indie;0 - 20,000;34;19;15;0;0;0
344190;Immortal Empire;Action, Adventure, Indie;100,000 - 200,000;207;80;127;340;499;0
344220;Janky Tanks;Free to Play, Indie, Strategy;0 - 20,000;8;6;2;0;0;0
344230;Pixel Puzzles 2: Birds;Adventure, Indie;200,000 - 500,000;242;68;174;284;282;3
344240;Man O' War: Corsair - Warhammer Naval Battles;Adventure, Casual, Indie;20,000 - 50,000;468;281;187;125;125;5
344270;InnerCube;Action, Indie, Simulation, Strategy;20,000 - 50,000;18;3;15;0;0;0
344300;Heckabomb;Adventure, Casual;200,000 - 500,000;180;108;72;373;275;0
344340;Front Office Football Seven;Adventure, Casual;0 - 20,000;117;26;91;0;0;1
344340;Front Office Football Seven;Action, Adventure, Casual;0 - 20,000;117;26;91;0;0;1
344410;Magnetic: Cage Closed;Adventure, RPG;50,000 - 100,000;219;103;116;227;227;0
344440;Sacra Terra: Angelic Night;Free to Play, Indie;50,000 - 100,000;284;48;236;217;245;0
344480;Quell;Racing, Simulation, Sports;0 - 20,000;351;8;343;0;0;3
344500;Three Fourths Home: Extended Edition;Action, Indie;20,000 - 50,000;128;78;50;197;197;2
344630;Princess Evangile All Ages Version;Adventure, Casual, Indie;50,000 - 100,000;206;21;185;193;193;1
344740;CRYPTARK;Action, Adventure, Indie, Strategy, Early Access;100,000 - 200,000;815;150;665;289;429;2
344760;Reign Of Kings;Simulation, Strategy;200,000 - 500,000;8568;6421;2147;1879;683;32
344770;fault - milestone two side:above;Casual, Indie, Simulation;50,000 - 100,000;2435;71;2364;321;414;1
344800;World of Mixed Martial Arts 3;Action, Adventure, Indie, RPG;20,000 - 50,000;104;43;61;1;1;2
344810;Total Extreme Wrestling 2010;Action, Indie;0 - 20,000;95;26;69;0;0;0
344820;Forsaken Fortress Strategy;Adventure, Indie;20,000 - 50,000;67;129;-62;23;23;1
344840;Gratuitous Space Battles 2;Action;50,000 - 100,000;113;167;-54;150;232;1
344850;Big Pharma;Indie, Simulation, Early Access;200,000 - 500,000;1375;413;962;363;324;10
344860;Crystal Story II;Action, Adventure, Indie;0 - 20,000;278;16;262;208;216;2
344890;A.R.M. PLANETARY PROSPECTORS EP1 Asteroid Resource Mining;Adventure;0 - 20,000;27;38;-11;0;0;0
344900;Undeadz!;Casual, Indie, Strategy;0 - 20,000;28;43;-15;3;3;0
344910;Sun Blast: Star Fighter;Adventure, Indie;200,000 - 500,000;403;248;155;285;239;1
344960;Jaques Roque;Action, Adventure, Indie, Massively Multiplayer, RPG;0 - 20,000;10;2;8;0;0;0
345010;Ascent - The Space Game;Action, Free to Play, Indie, Massively Multiplayer;20,000 - 50,000;230;110;120;0;0;0
345020;A Feeble Saga;Adventure, Indie, Racing;0 - 20,000;37;12;25;0;0;0
345030;3d Engineers;Adventure, Casual;0 - 20,000;10;15;-5;0;0;0
345060;Stay Alight;Action, Adventure, Indie, Simulation, Strategy, Early Access;50,000 - 100,000;155;36;119;309;309;0
345080;Flame Over;Casual, Indie, RPG;20,000 - 50,000;118;46;72;0;0;0
345090;Ancient Planet Tower Defense;Action, Indie;100,000 - 200,000;764;165;599;665;493;18
345120;Vox Populi Vox Dei 2;Adventure, Indie;20,000 - 50,000;403;60;343;212;214;1
345130;Dark Matter;Casual, Strategy;20,000 - 50,000;88;61;27;9;15;0
345140;Crystal Rift;Massively Multiplayer, RPG, Simulation;0 - 20,000;77;51;26;89;89;0
345180;Victor Vran ARPG;Indie, Simulation;500,000 - 1,000,000;5195;835;4360;884;522;26
345200;Tasty Blue;Adventure, Casual, Free to Play, Indie;0 - 20,000;486;49;437;419;584;5
345200;Tasty Blue;Action, Adventure, Indie, Early Access;0 - 20,000;486;49;437;419;584;5
345220;Agent Awesome;Indie, Simulation, Strategy;200,000 - 500,000;535;327;208;216;220;0
345230;The Dark Inside Me;Action, Adventure, Free to Play, Indie, Early Access;0 - 20,000;104;56;48;109;109;0
345240;SHOGUN: Total War - Collection;Action, Indie, RPG;50,000 - 100,000;689;91;598;169;328;94
345260;Medieval: Total War - Collection;Action, Indie;200,000 - 500,000;1208;540;668;22;22;198
345280;Lost in a Forest;Casual, Indie, Strategy;0 - 20,000;45;45;0;0;0;0
345290;The Quivering;Indie, RPG, Simulation;0 - 20,000;11;7;4;0;0;0
345300;Wildlife Creative Studio;Indie;0 - 20,000;4;4;0;0;0;0
345310;My Family Creative Studio;Casual, Indie, Massively Multiplayer, Racing;0 - 20,000;7;5;2;0;0;0
345330;Eden Rising;Action, Adventure, Indie;100,000 - 200,000;909;481;428;274;91;11
345340;The Grave Digger;Action, Indie, Racing, Simulation;0 - 20,000;22;7;15;0;0;0
345350;LIGHTNING RETURNS: FINAL FANTASY XIII;Simulation, Sports;200,000 - 500,000;3077;774;2303;2199;539;57
345370;TyranoBuilder Visual Novel Studio;Action, Indie;20,000 - 50,000;577;97;480;20;20;27
345390;King's Quest;Action, Adventure, Indie, Racing;200,000 - 500,000;2339;269;2070;544;605;20
345430;The Cursed Forest;Action, Casual, Indie;20,000 - 50,000;638;76;562;116;150;2
345440;Vapour;Adventure, Indie;50,000 - 100,000;69;107;-38;348;363;0
345460;War of Omens Card Game;Adventure, Casual, Indie, RPG;50,000 - 100,000;544;93;451;0;0;21
345480;Lumo;Free to Play, Indie, Racing, Simulation, Sports, Early Access;0 - 20,000;76;32;44;0;0;0
345540;Inbetween Land;Action, Adventure, Indie;20,000 - 50,000;193;46;147;21;21;1
345580;Universal Combat CE;Casual, Indie;20,000 - 50,000;107;157;-50;99;71;0
345610;The Fruit of Grisaia;Action, Indie, Strategy;50,000 - 100,000;910;64;846;1966;2029;4
345620;The Labyrinth of Grisaia;Action, Casual, Indie;0 - 20,000;111;16;95;1256;1256;4
345630;The Eden of Grisaia;Casual, Free to Play, RPG, Simulation;0 - 20,000;85;4;81;728;728;1
345630;The Eden of Grisaia;Casual, Indie, Simulation, Early Access;0 - 20,000;85;4;81;728;728;1
345640;Block Legend DX;Action, Indie;50,000 - 100,000;77;55;22;251;251;1
345650;Without Within;Action, Casual, Indie, Strategy;100,000 - 200,000;1776;231;1545;13;17;0
345660;RIDE;Indie, Early Access;100,000 - 200,000;1624;454;1170;1557;1972;6
345690;Crash Dummy;Indie, Simulation, Strategy;0 - 20,000;5;8;-3;0;0;0
345710;Damned Nation Reborn;RPG;0 - 20,000;17;61;-44;7;7;0
345710;Damned Nation Reborn;Indie;0 - 20,000;17;61;-44;7;7;0
345750;Idol Hands;Casual, Free to Play, Indie;20,000 - 50,000;63;90;-27;271;271;2
345790;Bridge Creator 2015;Action, Casual, Indie;0 - 20,000;10;9;1;0;0;0
345820;Shantae and the Pirate's Curse;Action, Adventure, Strategy, Early Access;100,000 - 200,000;2283;159;2124;209;241;5
345860;Super Galaxy Squadron EX Turbo;Adventure, Indie, RPG, Strategy;50,000 - 100,000;356;72;284;127;163;0
345890;NASCAR '15 Victory Edition;Adventure, Indie, RPG;100,000 - 200,000;830;225;605;913;913;34
345990;ABRACA - Imagic Games;Action, Indie, Strategy, Early Access;0 - 20,000;37;12;25;0;0;0
346010;Besiege;Adventure, Indie;2,000,000 - 5,000,000;43016;1986;41030;803;202;288
346040;Joe's Diner;Action, Strategy;20,000 - 50,000;83;137;-54;0;0;0
346060;Disney High School Musical 3: Senior Year Dance;Action, Indie;0 - 20,000;71;9;62;0;0;0
346080;Astro Emporia;Indie, Strategy, Early Access;50,000 - 100,000;36;44;-8;933;1633;7
346090;I Can't Escape: Darkness;Simulation, Sports;0 - 20,000;52;11;41;0;0;0
346110;ARK: Survival Evolved;Action, Adventure;10,000,000 - 20,000,000;507783;103443;404340;10821;750;59245
346120;Boring Man - Online Tactical Stickman Combat;Action, Indie;200,000 - 500,000;4760;663;4097;229;34;16
346130;Rktcr;Action, Adventure, Indie, Simulation, Strategy, Early Access;0 - 20,000;5;1;4;0;0;0
346140;Hidden Object Bundle 5 in 1;Simulation, Strategy;20,000 - 50,000;142;69;73;822;822;9
346150;Martial Law;Adventure, RPG;0 - 20,000;7;15;-8;0;0;0
346160;Barter Empire;Simulation;0 - 20,000;15;13;2;0;0;0
346180;David.;Adventure, RPG, Simulation, Strategy;100,000 - 200,000;572;158;414;83;165;0
346200;Drew and the Floating Labyrinth;Action, Simulation;0 - 20,000;28;22;6;0;0;0
346210;Garden Rescue;Action, Indie;100,000 - 200,000;96;32;64;226;223;1
346220;Lif;Action, Indie;0 - 20,000;77;59;18;0;0;0
346240;Ski Park Tycoon;Action, Adventure, Indie;0 - 20,000;50;27;23;0;0;1
346250;The Old Tree;Animation & Modeling, Design & Illustration, Education, Software Training, Utilities, Video Production, Web Publishing, Game Development;200,000 - 500,000;2935;327;2608;15;21;0
346300;Containment Protocol;Adventure, Casual, Indie;0 - 20,000;5;8;-3;0;0;0
346320;Streets of Chaos;Adventure, Indie;50,000 - 100,000;31;60;-29;234;256;0
346330;BrainBread 2;Action, Indie;1,000,000 - 2,000,000;3554;1305;2249;156;52;30
346340;Gran Vitreous;Indie;0 - 20,000;24;7;17;0;0;1
346370;Into The War;Action, Casual, Indie;50,000 - 100,000;103;373;-270;1;1;0
346390;Diamond;Casual, Strategy;0 - 20,000;0;0;0;0;0;0
346420;The Spatials;Adventure, Indie, RPG, Early Access;20,000 - 50,000;227;95;132;230;267;0
346430;Spectrum: First Light;Action, Indie, Simulation, Strategy;0 - 20,000;4;4;0;0;0;0
346440;Musclecar Online;Casual, Strategy;0 - 20,000;23;11;12;0;0;0
346450;samurai_jazz;Action, Adventure, Indie, RPG, Early Access;0 - 20,000;63;29;34;10;10;0
346460;Vector 36;Casual;20,000 - 50,000;201;43;158;0;0;1
346470;Tennis Elbow 2013;Adventure, Casual, Indie, Simulation;50,000 - 100,000;623;43;580;932;932;25
346490;Toy Wars Invasion;Action, Casual, Free to Play, Indie, Massively Multiplayer, RPG, Strategy;0 - 20,000;4;7;-3;0;0;0
346500;Road Scars: Origins;Action, Indie, Early Access;50,000 - 100,000;154;67;87;360;422;155
346510;Hyphen;Action, Indie, RPG, Sports;0 - 20,000;28;3;25;0;0;0
346510;Hyphen;Action, Indie, Sports;0 - 20,000;28;3;25;0;0;0
346550;Cylne;Adventure, Indie;0 - 20,000;33;37;-4;0;0;0
346560;Hero of the Kingdom II;Action, Simulation;100,000 - 200,000;2112;125;1987;201;261;11
346610;Racecraft;Adventure, Indie;20,000 - 50,000;61;145;-84;10;12;0
346630;Plazma Being;Indie, Simulation, Strategy;100,000 - 200,000;294;93;201;190;244;0
346650;Break the Cube;Action, Indie, Racing;0 - 20,000;10;15;-5;0;0;0
346670;Sky Battles;RPG;50,000 - 100,000;48;37;11;164;197;52
346730;GOCCO OF WAR;Action, Indie;50,000 - 100,000;875;113;762;122;180;8
346750;Merchant;Action, Adventure, Casual, Indie, RPG, Early Access;100,000 - 200,000;393;102;291;3432;3432;14
346760;ProtoMasons;Casual, Free to Play, Indie, Strategy;0 - 20,000;0;2;-2;0;0;0
346770;Quarries of Scred;Action, Adventure, Indie;20,000 - 50,000;52;8;44;0;0;0
346780;Luminosity;Action, Adventure, Indie;20,000 - 50,000;52;8;44;234;266;0
346800;Damnation City of Death;Racing, Simulation, Sports, Strategy;0 - 20,000;28;49;-21;0;0;0
346810;Marble Age;Action, Casual, Indie, Racing;200,000 - 500,000;569;115;454;92;92;4
346820;Crash Drive 3;Adventure, Indie, RPG;20,000 - 50,000;281;29;252;0;0;9
346830;FINAL FANTASY IV: THE AFTER YEARS;Design & Illustration, Utilities, Web Publishing;50,000 - 100,000;294;173;121;21;21;18
346850;Chip's Challenge 1;Action, Casual, Indie;100,000 - 200,000;656;66;590;108;52;23
346900;AdVenture Capitalist;Adventure, Casual, Free to Play, Simulation;5,000,000 - 10,000,000;47642;6417;41225;1900;236;2123
346920;Undead Shadows;Casual, Indie, RPG, Simulation;0 - 20,000;18;45;-27;0;0;0
346930;Deadhold;Action, Indie;0 - 20,000;26;18;8;0;0;0
346940;Shadowrun: Hong Kong - Extended Edition;Simulation;500,000 - 1,000,000;3692;569;3123;1251;1265;61
346950;The Dark Stone from Mebara;Indie;100,000 - 200,000;113;87;26;233;223;0
346970;OBEY;Casual, Indie;20,000 - 50,000;362;64;298;146;258;2
347000;InnerSpace;Casual, Indie, Simulation;20,000 - 50,000;159;96;63;24;24;0
347030;The Bluecoats: North vs South (2012);Adventure, Indie;200,000 - 500,000;153;177;-24;194;225;0
347040;Keebles;Indie, Strategy;20,000 - 50,000;61;21;40;331;331;2
347050;Vol'Talkes - The AI War;Indie;0 - 20,000;0;3;-3;0;0;0
347060;Pro Basketball Manager 2016;Indie;0 - 20,000;39;36;3;0;0;0
347080;Naught Reawakening;Action, Adventure, Indie;0 - 20,000;14;1;13;0;0;0
347160;Steredenn;Action, Indie;100,000 - 200,000;759;105;654;107;120;4
347170;Combat Air Patrol 2: Military Flight Simulator;Action;0 - 20,000;148;160;-12;0;0;0
347230;1942: The Pacific Air War;Action, Indie, Strategy;0 - 20,000;24;21;3;0;0;0
347240;Challenge of the Five Realms: Spellbound in the World of Nhagardia;Casual, Simulation;0 - 20,000;8;5;3;1;1;0
347250;F-19 Stealth Fighter;Action, Adventure, Indie;0 - 20,000;66;7;59;0;0;3
347250;F-19 Stealth Fighter;Adventure, Casual, Indie;0 - 20,000;66;7;59;0;0;3
347260;Hyperspeed;Action;0 - 20,000;15;6;9;0;0;0
347270;Knights of the Sky;Racing, Simulation, Sports;0 - 20,000;16;15;1;4;4;0
347280;A Quiver of Crows;Adventure, Casual, Free to Play, Indie;0 - 20,000;31;15;16;0;0;0
347290;Rise & Shine;Action, Indie;50,000 - 100,000;593;268;325;91;123;1
347330;HeartZ: Co-Hope Puzzles;Action, Adventure, Indie, Massively Multiplayer, RPG;0 - 20,000;17;3;14;260;260;0
347400;001 Game Creator;Action, Free to Play, Indie;0 - 20,000;212;59;153;0;0;8
347430;Frankenstein: Master of Death;Action;100,000 - 200,000;1582;317;1265;326;242;0
347470;Mayan Death Robots;Action, Adventure, Indie, Strategy;0 - 20,000;61;5;56;0;0;0
347480;Super Pixalo;Action, Adventure, Indie, Strategy, Early Access;0 - 20,000;6;10;-4;0;0;0
347510;Rats - Time is running out!;Adventure, Indie;50,000 - 100,000;247;38;209;156;202;0
347520;Legends of Atlantis: Exodus;Action, Adventure, Indie;20,000 - 50,000;68;11;57;5;5;1
347560;Terra Incognita Chapter One: The Descendant;Action, Massively Multiplayer, Simulation;500,000 - 1,000,000;662;359;303;197;212;0
347580;Evolution II: Fighting for Survival;Racing, Simulation, Sports;0 - 20,000;3;22;-19;0;0;0
347590;Heroes of Hellas 3: Athens;Indie, Strategy;100,000 - 200,000;161;11;150;138;181;4
347600;Total Miner;Action, Adventure, Casual, Free to Play, Indie, RPG;20,000 - 50,000;440;157;283;0;0;8
347610;Hidden Object Bundle 4 in 1;Adventure, Casual;50,000 - 100,000;296;24;272;623;720;13
347620;Gaokao.Love.100Days;Adventure, Casual;100,000 - 200,000;6488;375;6113;407;408;33
347630;16 Bit Arena;Indie;50,000 - 100,000;44;26;18;1;1;0
347660;Caromble!;Adventure, Casual;0 - 20,000;47;7;40;0;0;0
347670;Karate Master 2 Knock Down Blow;Action, Adventure, Casual, Indie, Strategy;50,000 - 100,000;542;94;448;0;0;1
347690;Natural Soccer;Action, Casual, Indie;0 - 20,000;49;17;32;0;0;0
347710;Perils of Man;Action, Adventure;20,000 - 50,000;177;46;131;0;0;0
347720;Soda Drinker Pro;Casual, Indie;0 - 20,000;554;34;520;0;0;2
347730;Wait - Extended;Action, Adventure, Indie, RPG;0 - 20,000;44;6;38;0;0;0
347790;Terraform;Adventure, Indie;0 - 20,000;36;9;27;0;0;0
347800;Ghost Song;Action, Indie, Early Access;50,000 - 100,000;637;94;543;33;39;14
347820;Street Arena;Casual, Indie, RPG, Strategy, Early Access;20,000 - 50,000;36;37;-1;0;0;0
347830;Fairy Fencer F;;200,000 - 500,000;2110;235;1875;797;1041;3
347930;Hatland Adventures;Indie, RPG;0 - 20,000;7;16;-9;1;1;0
347940;Forsaken Isle;Action, Indie;20,000 - 50,000;206;164;42;0;0;0
347950;Palace of Cards;Action, Indie;50,000 - 100,000;133;68;65;71;71;33
348000;Datswer;Education, Software Training, Utilities, Early Access;0 - 20,000;2;9;-7;0;0;0
348030;Trackday Manager;Casual, Simulation, Strategy;50,000 - 100,000;183;147;36;0;0;0
348160;RUMP! - It's a Jump and Rump!;Adventure, Indie;0 - 20,000;40;4;36;0;0;0
348180;Starship Traveller;Action, Indie;0 - 20,000;41;27;14;282;282;0
348200;Nimble Writer;Indie, Massively Multiplayer, RPG, Strategy;50,000 - 100,000;486;66;420;2842;2842;36
348240;Gun Wings;Adventure, Casual, Indie, RPG, Strategy;20,000 - 50,000;218;45;173;211;211;0
348250;Google Earth VR;Indie, RPG, Simulation;500,000 - 1,000,000;3280;158;3122;94;42;43
348270;Social Justice Warriors;Action, Indie, Early Access;50,000 - 100,000;60;60;0;0;0;0
348280;ORBIT;Casual, Indie, Sports;0 - 20,000;18;7;11;0;0;0
348290;Hospital Manager;Indie, Simulation, Strategy;20,000 - 50,000;113;129;-16;0;0;1
348290;Hospital Manager;Adventure, Casual, Indie, RPG;20,000 - 50,000;113;129;-16;0;0;1
348300;Chip's Challenge 2;Action, Indie;20,000 - 50,000;99;15;84;0;0;5
348340;Siege Wars;Adventure;20,000 - 50,000;99;47;52;0;0;0
348360;Doodle God;Action, Indie, Simulation, Strategy, Early Access;100,000 - 200,000;859;262;597;387;552;13
348380;The Interview;Action, Indie;0 - 20,000;53;112;-59;0;0;0
348430;Quell Reflect;Action, Indie;0 - 20,000;135;6;129;0;0;0
348430;Quell Reflect;Violent, Action, Free to Play, Indie, Massively Multiplayer;0 - 20,000;135;6;129;0;0;0
348440;Quell Memento;Action, Casual, Indie, Early Access;20,000 - 50,000;173;8;165;0;0;0
348450;Lex Mortis;Casual, Free to Play, Massively Multiplayer;50,000 - 100,000;72;83;-11;232;234;1
348460;Bierzerkers;Indie, RPG, Strategy;100,000 - 200,000;249;277;-28;13;17;0
348470;SAMURAI WARRIORS 4-II;Action, Adventure, Casual, Indie, RPG, Simulation;50,000 - 100,000;978;316;662;1622;2073;11
348490;Beyond Sol;Adventure, Casual, Indie, Simulation;0 - 20,000;143;40;103;1443;1443;0
348510;Autobahn Police Simulator;Indie, RPG;200,000 - 500,000;632;1477;-845;50;50;2
348540;Divine Slice of Life;Indie, Strategy;20,000 - 50,000;194;91;103;196;200;0
348550;GUILTY GEAR XX ACCENT CORE PLUS R;Action, Indie;200,000 - 500,000;5303;187;5116;976;210;171
348570;Monster Minis Extreme Off-Road;Action, Adventure, Indie;0 - 20,000;1;2;-1;0;0;0
348620;Voices from the Sea;Action, Indie;100,000 - 200,000;1146;87;1059;12;21;0
348650;The Asskickers-Steam Edition;Adventure, Casual;0 - 20,000;22;61;-39;0;0;0
348650;The Asskickers-Steam Edition;Action, Free to Play, RPG;0 - 20,000;22;61;-39;0;0;0
348670;Immune - True Survival;Action, Adventure, Indie;100,000 - 200,000;845;601;244;178;225;5
348700;Walkover;Action;50,000 - 100,000;80;50;30;0;0;0
348710;Saint Seiya: Soldiers' Soul;Indie, Simulation, Strategy;50,000 - 100,000;2731;209;2522;908;1308;9
348730;Abyss Raiders: Uncharted;Simulation, Strategy;20,000 - 50,000;57;81;-24;288;281;0
348740;Abyss Cave;Action, Indie, Early Access;20,000 - 50,000;13;3;10;7;7;0
348790;Wooden Floor;Adventure;50,000 - 100,000;102;104;-2;5;5;0
348800;Chester One;Action, Indie, Strategy;0 - 20,000;26;5;21;0;0;0
348810;M4 Tank Brigade;Action, Adventure, Casual, Indie, Simulation, Early Access;0 - 20,000;9;10;-1;0;0;0
348820;FIM Speedway Grand Prix 15;Action;100,000 - 200,000;625;40;585;705;705;0
348840;UFHO2;Casual, Indie;20,000 - 50,000;22;3;19;3;3;0
348860;MyDream;Adventure, Casual, Simulation;20,000 - 50,000;62;33;29;41;41;0
348870;Night Mysteries: The Amphora Prisoner;Adventure, Indie;100,000 - 200,000;90;48;42;275;286;0
348910;Faerie Solitaire Harvest;Casual, Indie;0 - 20,000;147;29;118;1159;1159;1
348950;Ame no Marginal -Rain Marginal-;Action, Indie, Simulation;50,000 - 100,000;324;53;271;148;193;0
348960;Odysseus: Long Way Home;Simulation;50,000 - 100,000;48;26;22;257;273;0
348980;INIT.;Simulation;0 - 20,000;5;13;-8;223;223;0
349040;NARUTO SHIPPUDEN: Ultimate Ninja STORM 4;Adventure, Casual, Indie, Simulation;1,000,000 - 2,000,000;68027;6730;61297;714;514;1424
349060;Fruits Inc. Deluxe Pack;Action, Indie;0 - 20,000;8;15;-7;0;0;0
349100;Notrium;Action, Adventure, Casual, Indie, RPG, Strategy;0 - 20,000;59;3;56;106;106;1
349140;Corrosion: Cold Winter Waiting [Enhanced Edition];Action, Adventure, Indie;50,000 - 100,000;159;75;84;169;201;1
349150;Dead TrailZ;Indie;0 - 20,000;13;1;12;0;0;0
349190;Soul Locus;Action, Adventure;0 - 20,000;23;11;12;0;0;0
349220;The Black Watchmen;Free to Play, Massively Multiplayer, RPG;;;;0;;;
349250;Copy Kitty;Casual, Indie, Strategy;20,000 - 50,000;308;6;302;9;9;1
349260;BlastZone 2;Action, Indie;0 - 20,000;58;28;30;156;156;0
349270;Mosaic;Action, Indie;0 - 20,000;285;109;176;73;73;1
349280;Panda School Browser;Action, Adventure, Indie;0 - 20,000;13;6;7;0;0;0
349300;Littlewitch Romanesque: Editio Regia;Action, Adventure, Indie, Simulation, Strategy, Early Access;0 - 20,000;88;21;67;182;245;0
349320;The Rainy Port Keelung 雨港基隆;Action, Casual, Indie, Simulation, Strategy;0 - 20,000;329;52;277;0;0;2
349440;The Undying Plague;Indie, Strategy;100,000 - 200,000;54;87;-33;317;332;0
349450;Dark Forester;Action, Indie;0 - 20,000;41;22;19;0;0;0
349460;Lord of the Dark Castle;Action, Adventure, Indie;200,000 - 500,000;54;24;30;539;765;4
349470;Drift Stage;Adventure, Free to Play, Indie;0 - 20,000;24;18;6;0;0;0
349500;Cubicle Quest;Casual, Free to Play, Indie;200,000 - 500,000;503;176;327;178;174;0
349510;Hanako: Honor & Blade;Simulation, Sports;50,000 - 100,000;152;48;104;10;10;0
349520;Armillo;Adventure, Indie;50,000 - 100,000;177;21;156;0;0;0
349530;TableTop Cricket;Simulation, Strategy;0 - 20,000;19;10;9;0;0;0
349540;PeriAreion;Casual;0 - 20,000;17;35;-18;320;320;0
349550;Mighty Dungeons;Action, Adventure, Indie, RPG;20,000 - 50,000;52;33;19;0;0;0
349550;Mighty Dungeons;Action, Casual, Free to Play, Indie;20,000 - 50,000;52;33;19;0;0;0
349580;Burstfire;Adventure, Indie;100,000 - 200,000;349;478;-129;277;342;0
349650;Tokyo Hosto;Action, Indie, Strategy, Early Access;0 - 20,000;33;33;0;0;0;0
349670;Solar System Conflict;RPG;0 - 20,000;13;25;-12;0;0;0
349680;Supercharged Robot VULKAISER;Action, Indie, RPG;20,000 - 50,000;265;17;248;147;147;0
349690;ARMED SEVEN;Action, Indie;0 - 20,000;60;3;57;79;79;0
349700;Romero's Aftermath;Action, Indie;1,000,000 - 2,000,000;5493;5819;-326;724;43;1
349720;Audition Online;Action, Adventure, Indie, Massively Multiplayer, Simulation, Early Access;500,000 - 1,000,000;930;591;339;147;135;29
349730;Popup Dungeon;Action, Indie, RPG, Simulation, Strategy;50,000 - 100,000;720;215;505;146;162;8
349760;Snail Bob 2: Tiny Troubles;Adventure, Indie, Strategy;0 - 20,000;165;4;161;497;645;2
349780;Fatty Maze's Adventures;Adventure, Indie, RPG, Strategy;0 - 20,000;6;6;0;0;0;0
349790;Galaxy of Pen & Paper +1;Adventure, Indie;0 - 20,000;276;103;173;0;0;6
349840;Ancestory;Action, Strategy;0 - 20,000;21;16;5;0;0;0
349950;GunWorld;Action, Free to Play, Indie;0 - 20,000;20;48;-28;0;0;0
349980;Gremlin Invasion: Survivor;Action, Casual;0 - 20,000;1;1;0;0;0;0
350000;Exostorm;Action, Casual, Indie;0 - 20,000;5;3;2;0;0;0
350010;Time Mysteries: Inheritance - Remastered;Action, Adventure, Casual, Indie, Strategy;100,000 - 200,000;316;406;-90;186;232;2
350020;The Gate;Indie, RPG, Strategy;50,000 - 100,000;143;92;51;164;242;0
350070;Environmental Station Alpha;Casual, Indie;100,000 - 200,000;967;171;796;512;956;7
350080;Wolfenstein: The Old Blood;Casual, Indie, Strategy;500,000 - 1,000,000;14713;1756;12957;587;359;133
350090;No Pineapple Left Behind;Casual, Free to Play, Indie, Strategy, Early Access;0 - 20,000;23;18;5;0;0;0
350140;Majestic-12;Action, Free to Play, Indie, RPG;0 - 20,000;1;0;1;0;0;0
350150;Scraps: Modular Vehicle Combat;Action, Indie;0 - 20,000;114;36;78;0;0;1
350200;Revolution 60;Indie, RPG, Simulation, Strategy;0 - 20,000;21;48;-27;0;0;0
350210;Mighty Switch Force! Academy;;0 - 20,000;38;9;29;0;0;1
350220;Dead Sea;Casual, Indie, Simulation, Strategy;20,000 - 50,000;65;245;-180;0;0;0
350300;Gang of Four;Adventure, Casual, Indie, Simulation, Strategy;0 - 20,000;98;96;2;2;2;3
350310;BLADESTORM: Nightmare;Adventure, Free to Play, Indie;0 - 20,000;254;141;113;293;407;6
350330;Call of the Ninja!;Adventure, Free to Play, Indie;0 - 20,000;3;5;-2;0;0;0
350380;The Martian VR Experience;Action;0 - 20,000;12;36;-24;0;0;0
350480;Tales of Cosmos;Action;0 - 20,000;42;8;34;7;7;0
350490;Love And Order;Strategy;0 - 20,000;27;34;-7;0;0;1
350500;Fly in the House;Strategy;20,000 - 50,000;96;93;3;196;265;2
350500;Fly in the House;Indie, RPG;20,000 - 50,000;96;93;3;196;265;2
350530;Airport Firefighters - The Simulation;Indie, Simulation, Strategy;20,000 - 50,000;99;109;-10;0;0;0
350540;Helicopter 2015: Natural Disasters;Simulation, Strategy;0 - 20,000;20;102;-82;0;0;1
350550;Area-X;Adventure, Casual, Indie;0 - 20,000;26;0;26;0;0;0
350600;BIOS;RPG;0 - 20,000;113;71;42;0;0;0
350630;Dodge;Casual, Indie, Racing;0 - 20,000;58;17;41;0;0;0
350640;Sherlock Holmes: The Devil's Daughter;Adventure, Casual, Indie;1,000,000 - 2,000,000;9929;2561;7368;318;203;51
350700;Red Stone Online;Action, Adventure, Indie, RPG;50,000 - 100,000;182;111;71;3378;3378;5
350740;The Bug Butcher;Indie, Simulation;100,000 - 200,000;1053;111;942;76;119;1
350770;Giana Sisters 2D;Adventure, Indie, Strategy;20,000 - 50,000;152;91;61;0;0;2
350780;MANOS: The Hands of Fate ~ Director's Cut;Action, Simulation;20,000 - 50,000;159;35;124;0;0;1
350800;Cannibal;Indie, Strategy;0 - 20,000;32;12;20;58;58;0
350810;Pixel Puzzles 2: Anime;Casual, Simulation, Strategy;200,000 - 500,000;708;242;466;262;235;4
350880;Archamon;Action, Free to Play, Indie;0 - 20,000;30;16;14;0;0;0
350910;Streets of Fury EX;Action, Indie, Racing, Simulation;50,000 - 100,000;591;25;566;11;11;3
350970;Planet of the Eyes;Strategy;100,000 - 200,000;438;88;350;208;208;0
350990;Bloodwood Reload;Casual, Indie;100,000 - 200,000;152;237;-85;15;11;0
351030;Pixel Puzzles Ultimate Jigsaw;RPG, Strategy;500,000 - 1,000,000;1758;605;1153;198;155;64
351050;Cricket Captain 2015;Indie, Simulation;0 - 20,000;41;21;20;0;0;2
351060;Outpost 13;Audio Production;0 - 20,000;23;51;-28;131;131;0
351080;The Corporate Machine;Audio Production;20,000 - 50,000;51;34;17;85;114;0
351090;Regency Solitaire;Audio Production;20,000 - 50,000;644;39;605;416;416;7
351100;Niffelheim;Adventure, Indie, Early Access;100,000 - 200,000;1560;601;959;311;405;15
351140;Rustbucket Rumble;Action, Indie, Strategy;200,000 - 500,000;210;163;47;15;15;0
351150;DRAGON: A Game About a Dragon;Audio Production;50,000 - 100,000;402;188;214;141;184;0
351160;Poop Clicker;Action, Adventure;20,000 - 50,000;286;47;239;0;0;8
351170;Pixel: ru²;Indie, Simulation, Strategy;0 - 20,000;15;4;11;0;0;0
351220;Tower of Eglathia;Adventure, Indie, RPG;0 - 20,000;6;4;2;0;0;0
351230;Counter Spell;Action, Adventure, Indie, Strategy;0 - 20,000;119;20;99;0;0;0
351240;Venusian Vengeance;Adventure, Casual, Indie;20,000 - 50,000;74;12;62;5;5;0
351250;Avalanche 2: Super Avalanche;Indie, Racing;50,000 - 100,000;206;34;172;265;371;1
351290;SURVIVAL: Postapocalypse Now;Simulation, Strategy;100,000 - 200,000;5073;3927;1146;522;181;11
351300;Ceres;Adventure, Indie;20,000 - 50,000;78;71;7;0;0;0
351320;DROD: The Second Sky;Violent, Gore, Indie;0 - 20,000;29;2;27;0;0;0
351320;DROD: The Second Sky;Action, Indie;0 - 20,000;29;2;27;0;0;0
351330;DROD RPG: Tendry's Tale;Action, Adventure, Indie, RPG;0 - 20,000;35;7;28;0;0;0
351340;Belladonna;Action, Casual, Free to Play, Massively Multiplayer;50,000 - 100,000;508;195;313;378;378;1
351400;The Defenders: The Second Wave;Indie, Simulation, Strategy, Early Access;20,000 - 50,000;51;39;12;220;231;1
351410;Clean'Em Up;Adventure, Casual, Simulation;20,000 - 50,000;57;4;53;6;6;0
351420;Veteran Combat;Casual, Indie, Simulation, Strategy;20,000 - 50,000;23;25;-2;0;0;0
351450;Scribble Space;Action, Indie, Strategy;20,000 - 50,000;60;39;21;247;247;0
351470;Sometimes: Success Requires Sacrifice;Adventure, Indie;1,000,000 - 2,000,000;412;163;249;242;198;0
351480;Age of Fear: The Undead King;Action, Indie;20,000 - 50,000;313;38;275;0;0;2
351490;Intergalactic Bubbles;Adventure, Indie;200,000 - 500,000;924;235;689;213;188;3
351510;Quiplash;Action, Adventure, Casual, Indie, Strategy;200,000 - 500,000;1723;203;1520;108;25;81
351630;Fire With Fire Tower Attack and Defense;Adventure, Indie, Simulation, Strategy;50,000 - 100,000;108;122;-14;26;26;0
351640;Eternal Senia;Action, Indie, Racing;500,000 - 1,000,000;11481;286;11195;120;123;3
351690;Apple Jack 1&2;Action, Adventure, Indie;0 - 20,000;12;0;12;0;0;0
351700;UnReal World;Action, Indie;50,000 - 100,000;1053;65;988;920;1596;26
351710;Hyperdimension Neptunia Re;Adventure, Casual;;;;0;;;
351720;Zotrix - Solar Division;Adventure, Casual, Indie;20,000 - 50,000;35;16;19;344;435;0
351730;On My Own;Action, Casual, Indie;20,000 - 50,000;90;56;34;0;0;0
351790;Invisible Apartment;Adventure, Casual;100,000 - 200,000;285;119;166;4;4;0
351800;Dev Guy;Action, Free to Play, Indie, Massively Multiplayer, Simulation;100,000 - 200,000;1391;359;1032;38;58;0
351810;MadSpace: To Hell and Beyond;Action, Adventure;0 - 20,000;16;5;11;0;0;0
351820;Z.A.R.;Action, Strategy;0 - 20,000;47;23;24;33;33;0
351860;Cultures - Northland;;100,000 - 200,000;424;89;335;92;78;13
351870;Cultures - 8th Wonder of the World;Casual, Indie;100,000 - 200,000;328;68;260;294;294;14
351900;Pregnancy;Indie;0 - 20,000;199;144;55;0;0;0
351910;Valhalla Hills;Indie;200,000 - 500,000;665;552;113;309;166;10
351920;Crazy Machines 3;Action, Indie;200,000 - 500,000;8735;482;8253;147;98;21
351940;The Descendant;Free to Play, Indie;500,000 - 1,000,000;5219;717;4502;989;252;189
351970;Tales of Zestiria;Indie;500,000 - 1,000,000;6842;1542;5300;1125;690;123
351990;Riff Racer - Race Your Music!;Adventure, Indie;100,000 - 200,000;1726;336;1390;196;238;1
352010;Beach Bounce;Adventure, Casual, Indie;20,000 - 50,000;232;115;117;251;260;0
352030;The World Named Fred;Action, Adventure, Indie;0 - 20,000;30;9;21;0;0;0
352030;The World Named Fred;Adventure, Indie, RPG;0 - 20,000;30;9;21;0;0;0
352050;Chesster;Indie;0 - 20,000;15;5;10;0;0;0
352070;Fort Meow;Indie, Simulation, Strategy;20,000 - 50,000;230;15;215;130;130;0
352120;Fair Strike;Casual, Indie, Simulation, Strategy;20,000 - 50,000;60;17;43;152;200;27
352130;Locoland;Action, Adventure, Indie;20,000 - 50,000;104;29;75;143;225;0
352140;Finders;Adventure;20,000 - 50,000;123;34;89;259;364;1
352160;Curse of Mermos;Sports;100,000 - 200,000;152;112;40;30;30;0
352170;MadOut;Action;0 - 20,000;22;35;-13;0;0;0
352190;Spirit of War;Adventure;0 - 20,000;45;30;15;226;226;0
352210;Little Cells;Action, Adventure, Indie;0 - 20,000;17;4;13;0;0;0
352220;King of Dragon Pass;Action, Adventure, Indie;20,000 - 50,000;357;81;276;399;554;2
352240;The Westport Independent;Action, Casual, Indie, Racing;20,000 - 50,000;154;68;86;221;260;1
352280;Cakewalk Sound Center;Action, Indie, Strategy;0 - 20,000;10;10;0;2;2;0
352290;Rapture Session & Pro;Action, Indie, Simulation;0 - 20,000;17;5;12;0;0;0
352310;CA-2A T-Type Leveling Amplifier;Racing;0 - 20,000;1;0;1;0;0;0
352360;Reflections;Adventure, Indie;0 - 20,000;41;36;5;0;0;0
352360;Reflections;Action, Adventure, Free to Play, Indie, Massively Multiplayer, RPG;0 - 20,000;41;36;5;0;0;0
352370;Defect;Indie, Strategy;0 - 20,000;40;14;26;0;0;0
352380;Cakewalk ProChannel;Casual, Indie;0 - 20,000;2;0;2;0;0;0
352400;LEGO Jurassic World;Action, Casual, Indie, Simulation;500,000 - 1,000,000;6304;603;5701;1807;952;189
352430;Farlight Explorers;Action, Casual, Free to Play, Massively Multiplayer;0 - 20,000;116;87;29;0;0;0
352440;Catacombs of the Undercity;Casual, Strategy;0 - 20,000;19;6;13;0;0;0
352460;Dead Realm;Action, Adventure;200,000 - 500,000;2937;1734;1203;127;144;0
352520;The Silent Age;Action, Adventure, Indie;200,000 - 500,000;6272;448;5824;102;116;3
352530;Poppy Kart;Action, Simulation;0 - 20,000;8;4;4;0;0;0
352550;Urban Empire;Indie, Strategy;200,000 - 500,000;818;1596;-778;977;1450;2
352580;Hidden: On the trail of the Ancients;Simulation, Strategy;0 - 20,000;54;28;26;0;0;0
352610;The Way We All Go;Action, Casual, Indie;0 - 20,000;115;19;96;612;612;1
352620;Porcunipine;Free to Play, Simulation, Strategy;20,000 - 50,000;117;34;83;351;390;0
352640;The Indie Mixtape;Adventure, Indie;20,000 - 50,000;46;19;27;59;59;3
352700;Subspace Continuum;Adventure, Casual, Indie;50,000 - 100,000;486;65;421;4;6;13
352720;The Universim;Adventure, Casual, Indie;200,000 - 500,000;6005;1283;4722;1287;1092;151
352740;Princess Battles;Adventure, Casual, Indie;0 - 20,000;19;7;12;0;0;0
352750;Road Works;Casual, RPG;0 - 20,000;6;13;-7;0;0;0
352760;Kaiju Panic;Indie, RPG;0 - 20,000;23;7;16;0;0;0
352780;An Octave Higher;Adventure, Indie, RPG;20,000 - 50,000;234;50;184;635;635;0
352790;Futuridium EP Deluxe;Indie;20,000 - 50,000;16;6;10;0;0;0
352810;Yukie: A Japanese Winter Fairy Tale;Simulation;0 - 20,000;22;10;12;0;0;0
352850;DGU: Death God University;Adventure, Indie, RPG;0 - 20,000;16;18;-2;11;11;0
352890;Caravan;Indie;100,000 - 200,000;681;191;490;218;268;4
352900;Giana Sisters: Dream Runners;Adventure, Indie;0 - 20,000;25;22;3;181;219;0
352950;Better Late Than DEAD;Adventure, Casual, Indie, Simulation;50,000 - 100,000;256;645;-389;345;513;1
352960;Star Horizon;Action, Adventure, Indie;0 - 20,000;86;59;27;21;21;0
353080;Redrum: Time Lies;Action, Adventure, Indie;0 - 20,000;17;7;10;0;0;0
353090;Chicken Invaders 5;Utilities;50,000 - 100,000;843;29;814;168;202;19
353110;Dreamscapes: Nightmare's Heir - Premium Edition;Indie, Racing, Sports;20,000 - 50,000;108;49;59;1;1;0
353130;Time of Dragons;Action, Adventure, Casual, Strategy;500,000 - 1,000,000;1067;637;430;23;16;0
353190;Bombshell;Action, Indie;50,000 - 100,000;228;164;64;440;638;0
353260;Snails;Racing, Simulation, Sports;20,000 - 50,000;3;3;0;0;0;0
353270;Hyperdimension Neptunia Re;Action, Free to Play, Massively Multiplayer;;;;0;;;
353300;Rooftop Cop;Action, Casual, Indie;0 - 20,000;10;9;1;0;0;0
353330;Love at First Sight;Casual;20,000 - 50,000;1205;51;1154;110;110;2
353340;Dungeon Highway;Indie, RPG, Strategy;0 - 20,000;22;5;17;0;0;0
353360;how do you Do It?;Casual, Indie, Strategy;100,000 - 200,000;2193;407;1786;136;4;2
353380;Steam Link;Racing, Simulation, Sports;500,000 - 1,000,000;5792;1765;4027;0;0;0
353540;Stephen's Sausage Roll;Action, Adventure, Casual, Indie;50,000 - 100,000;1247;61;1186;141;271;5
353550;House of Caravan;Adventure, Indie, Strategy;100,000 - 200,000;519;246;273;316;436;1
353560;Plug & Play;Adventure;200,000 - 500,000;3937;717;3220;22;21;2
353580;Rad Rodgers: World One;Action, Free to Play;0 - 20,000;144;26;118;0;0;0
353600;Spellbind;Action, Indie, Early Access;0 - 20,000;4;16;-12;0;0;0
353610;DEUS EX MACHINA 2;Action, Adventure, Casual, Indie, Racing, Simulation, Early Access;20,000 - 50,000;61;46;15;0;0;0
353610;DEUS EX MACHINA 2;Action, Indie;20,000 - 50,000;61;46;15;0;0;0
353630;Oil Enterprise;Action;0 - 20,000;88;89;-1;0;0;1
353640;Train Valley;Adventure, Indie;200,000 - 500,000;2684;310;2374;338;257;13
353700;The Deadly Tower of Monsters;Casual, Indie;100,000 - 200,000;1142;146;996;153;155;1
353790;Spud!;Action, Indie;0 - 20,000;19;7;12;0;0;0
353890;Casey Powell Lacrosse 16;Simulation;0 - 20,000;78;15;63;0;0;0
353940;Aces of the Luftwaffe;Action, Indie;20,000 - 50,000;72;42;30;0;0;0
353980;Ankh - Anniversary Edition;Adventure, Indie, RPG;20,000 - 50,000;82;22;60;238;238;0
353990;Parvaneh: Legacy of the Light's Guardians;Casual, Indie, Strategy;20,000 - 50,000;41;22;19;247;252;0
354030;VolChaos;Action, Indie, Racing, Early Access;50,000 - 100,000;32;17;15;0;0;0
354040;Hypership Out of Control;Action, Casual, Indie;0 - 20,000;29;4;25;0;0;1
354040;Hypership Out of Control;Adventure, RPG, Strategy, Early Access;0 - 20,000;29;4;25;0;0;1
354050;Starlight Tactics;Action, Adventure, Indie, RPG;0 - 20,000;15;12;3;0;0;1
354050;Starlight Tactics;Adventure, Casual, Indie;0 - 20,000;15;12;3;0;0;1
354140;Five Nights at Freddy's 3;Indie, Strategy, Early Access;500,000 - 1,000,000;6961;836;6125;138;132;26
354160;WRC 5 FIA World Rally Championship;Animation & Modeling, Design & Illustration, Education, Software Training, Utilities, Early Access;50,000 - 100,000;561;294;267;594;1137;10
354180;Bunker - The Underground Game;Casual, Indie;0 - 20,000;45;28;17;535;535;1
354200;Aberoth;Adventure, Indie, RPG;200,000 - 500,000;899;495;404;75;83;14
354230;Devouring Stars;Adventure, Casual, Indie, RPG;0 - 20,000;26;11;15;0;0;0
354240;Please, Don’t Touch Anything;Action, Adventure, Indie, Racing;200,000 - 500,000;3945;537;3408;117;88;12
354280;ChaosTower;Adventure, Indie, RPG;0 - 20,000;16;3;13;0;0;0
354290;LoveBeat;;200,000 - 500,000;1011;339;672;190;219;293
354310;Claws & Feathers;Strategy;20,000 - 50,000;70;5;65;222;222;3
354380;Assassin’s Creed Chronicles: China;Casual;200,000 - 500,000;2341;841;1500;310;281;8
354400;Tadpole Treble;Action, Adventure, Indie;0 - 20,000;267;11;256;0;0;0
354430;STAR WARS - X-Wing Special Edition;Adventure, Casual, Indie;100,000 - 200,000;266;84;182;980;1469;9
354560;We Are Legion;Violent, Action, Adventure;0 - 20,000;42;94;-52;0;0;0
354600;Decisive Campaigns: Case Blue;Indie, Strategy;0 - 20,000;47;6;41;0;0;0
354620;Miner Warfare;Action, Indie, Strategy;20,000 - 50,000;118;26;92;129;153;0
354640;The Settlers Online;Action, Indie, Racing, Sports;200,000 - 500,000;401;675;-274;633;38;0
354650;MISSING: An Interactive Thriller - Episode One;Action, Free to Play, Massively Multiplayer, RPG, Early Access;50,000 - 100,000;533;99;434;0;0;0
354680;Adventures of Bertram Fiddle 1: A Dreadly Business;Action, Adventure, Indie;50,000 - 100,000;406;63;343;0;0;0
354690;The Lost City Of Malathedra;Indie, Simulation;0 - 20,000;3;9;-6;0;0;0
354720;STATIC: Investigator Training;Casual, Indie, Simulation, Strategy;0 - 20,000;19;14;5;0;0;0
354720;STATIC: Investigator Training;Adventure, Indie;0 - 20,000;19;14;5;0;0;0
354730;Deadly Sin;Indie, Strategy;20,000 - 50,000;37;28;9;0;0;0
354740;Echoes of Aetheria;Indie, RPG;0 - 20,000;129;18;111;0;0;2
354770;Trigger Saint;Indie, RPG, Strategy;0 - 20,000;19;3;16;0;0;0
354780;Teknedia;Adventure, Indie;0 - 20,000;6;0;6;0;0;0
354810;Coated;Action, Indie;0 - 20,000;2;5;-3;0;0;0
354860;The Adventures of Tree;Adventure, Indie;50,000 - 100,000;371;105;266;310;323;0
354920;Pester;Casual, Indie, Strategy;100,000 - 200,000;53;49;4;269;241;0
354930;Slinki;Indie;0 - 20,000;13;8;5;0;0;0
354930;Slinki;Free to Play, Indie, Massively Multiplayer, Strategy;0 - 20,000;13;8;5;0;0;0
354950;East Tower - Akio (East Tower Series Vol. 1);Adventure, Casual;0 - 20,000;50;22;28;217;217;0
354960;An Imp? A Fiend!;Action, Adventure, Indie, Racing;20,000 - 50,000;36;32;4;0;0;0
354970;Shin Samurai Jazz;Adventure, Indie, Simulation;0 - 20,000;57;33;24;0;0;0
355000;GlassWire;Action, Adventure, RPG;100,000 - 200,000;308;76;232;175;264;9
355010;Race Arcade;Adventure, Casual;0 - 20,000;57;25;32;0;0;0
355020;Bomb The Monsters!;Adventure, Indie;50,000 - 100,000;96;48;48;266;202;2
355050;Sky Force Anniversary;Strategy;200,000 - 500,000;1741;145;1596;230;230;8
355060;Sébastien Loeb Rally EVO;Strategy;20,000 - 50,000;470;392;78;1742;1742;5
355070;TDP5 Arena 3D;RPG, Strategy;50,000 - 100,000;105;118;-13;4;7;0
355080;Crazy Steam Bros 2;Strategy;0 - 20,000;12;23;-11;0;0;0
355090;Second Coming: Tactical Training;Action, Free to Play;0 - 20,000;5;1;4;0;0;0
355130;MotoGP15;Free to Play, Sports;50,000 - 100,000;675;188;487;230;302;16
355140;Traps N' Gemstones;Adventure, Casual, Indie, Simulation;0 - 20,000;17;5;12;0;0;0
355150;gravilon;Adventure, Indie;200,000 - 500,000;756;495;261;163;185;1
355170;Sam & Max Hit the Road;Action, Indie;100,000 - 200,000;545;21;524;48;74;20
355180;Codename CURE;Indie, Strategy;2,000,000 - 5,000,000;13619;2501;11118;126;35;43
355190;Geocore;Simulation, Strategy;0 - 20,000;22;12;10;0;0;0
355230;Faceted Flight;Sexual Content, Nudity, Gore, Casual, Indie;0 - 20,000;20;6;14;0;0;0
355240;NEO AQUARIUM - The King of Crustaceans -;Action, Indie, Racing;50,000 - 100,000;248;61;187;163;163;1
355250;STAR WARS: TIE Fighter Special Edition;Action, Strategy;100,000 - 200,000;430;94;336;818;526;8
355270;199X;Action, Indie, Sports, Early Access;0 - 20,000;181;40;141;0;0;0
355310;Blood Alloy: Reborn;Adventure, Indie;0 - 20,000;32;17;15;0;0;0
355330;Construction Machines Simulator 2016;Adventure, Indie;0 - 20,000;50;64;-14;0;0;2
355350;Reign of Bullets;Adventure, Casual, Indie, Simulation;0 - 20,000;76;21;55;0;0;0
355350;Reign of Bullets;Adventure, Casual, Indie, Simulation;0 - 20,000;76;21;55;0;0;0
355370;Vidar;Adventure, Casual, Indie, Simulation;0 - 20,000;29;4;25;0;0;0
355380;Perfection of Wisdom;Action, Indie, Strategy;0 - 20,000;1;3;-2;0;0;0
355400;Diesel Guns;Action, Indie;0 - 20,000;211;85;126;0;0;1
355410;Radium;Action, Adventure, Indie, RPG;20,000 - 50,000;119;30;89;252;274;1
355420;FLAMBERGE;Action, Adventure, Free to Play, Indie;0 - 20,000;103;24;79;0;0;0
355430;//SNOWFLAKE TATTOO//;Indie, Strategy;20,000 - 50,000;43;70;-27;256;250;0
355460;Thunderbird: The Legend Begins;Adventure, Casual, Indie, RPG;0 - 20,000;15;21;-6;0;0;0
355490;Stratus: Battle For The Sky;Adventure, Indie, Simulation;0 - 20,000;20;17;3;0;0;0
355500;Leadwerks Game Launcher;Action, Indie;50,000 - 100,000;34;13;21;2;2;0
355510;Crazy Belts;Indie, RPG;0 - 20,000;21;49;-28;0;0;0
355520;The Albino Hunter (Original);Action, Adventure, Indie, RPG;50,000 - 100,000;250;82;168;195;229;0
355530;Last Word;Indie;20,000 - 50,000;317;64;253;98;98;2
355560;Trigger Runners;Action, Casual, Indie;0 - 20,000;49;15;34;56;56;0
355570;ENIGMA : An Illusion Named Family;Action;20,000 - 50,000;25;1;24;0;0;0
355650;Pirates vs Corsairs: Davy Jones's Gold;Audio Production;20,000 - 50,000;18;13;5;0;0;0
355670;Puzzle Expedition;Action, Casual, Racing;0 - 20,000;2;0;2;0;0;0
355680;Overland;Action, Strategy;50,000 - 100,000;323;119;204;471;716;1
355690;Deputy Dangle;Action, Indie;0 - 20,000;17;6;11;0;0;0
355760;Drizzlepath;Action, Indie;20,000 - 50,000;309;271;38;78;138;0
355790;Styx: Shards of Darkness;Action;200,000 - 500,000;3723;776;2947;650;460;45
355800;Space Run Galaxy;Adventure, Indie, RPG;200,000 - 500,000;606;335;271;464;508;8
355810;Centauri Sector;Action, Adventure, Indie;0 - 20,000;27;18;9;237;237;0
355820;FutureGrind;Indie;0 - 20,000;63;4;59;0;0;1
355840;Survarium;Indie, Simulation, Strategy;2,000,000 - 5,000,000;13983;11954;2029;2786;37;4
355860;Albino Lullaby: Episode 1;Action, Massively Multiplayer, Strategy, Early Access;50,000 - 100,000;257;107;150;325;325;0
355910;Piloteer;Action, Indie, Early Access;0 - 20,000;17;5;12;0;0;0
355920;Pixel Puzzles 2: Space;Action, Adventure, Indie;50,000 - 100,000;291;46;245;325;273;2
355970;Home is Where One Starts...;Indie;20,000 - 50,000;465;140;325;103;103;1
355980;Dungeon Warfare;Casual, Free to Play;50,000 - 100,000;1618;68;1550;326;326;15
356000;The Hero of Kendrickstone;Adventure, Indie;0 - 20,000;79;24;55;0;0;0
356030;The Survivor;Action, Free to Play;0 - 20,000;14;13;1;0;0;0
356040;Sheltered;Casual, Indie, Strategy;500,000 - 1,000,000;4637;1078;3559;342;123;30
356050;Beyond Eyes;Action, Adventure, Casual, Indie, Simulation;100,000 - 200,000;1016;495;521;186;239;1
356070;Commander Cool 2;Casual, Indie, Simulation;50,000 - 100,000;888;121;767;345;394;0
356090;Machineers - Episode 1: Tivoli Town;Action, Indie, Strategy;0 - 20,000;26;1;25;0;0;0
356100;Fuego!;Action, Indie, Strategy;0 - 20,000;50;5;45;0;0;0
356110;Box Out!;Action, Casual, Indie;0 - 20,000;12;1;11;0;0;0
356130;Heroes of Scene;Casual, Indie, Racing, Early Access;200,000 - 500,000;331;341;-10;53;20;0
356160;The Emptiness Deluxe Edition;Action, Adventure, Indie;0 - 20,000;35;72;-37;0;0;0
356170;Tile Rider;Action, Adventure, Indie;0 - 20,000;10;4;6;0;0;0
356180;Time Machine VR;Action, Casual, Indie, Strategy;0 - 20,000;72;41;31;0;0;0
356190;Middle-earth: Shadow of War;Action, Indie;2,000,000 - 5,000,000;74171;10387;63784;1647;1101;4838
356210;Tony Tough and the Night of Roasted Moths;Action;0 - 20,000;19;12;7;0;0;0
356260;Stalingrad;Action, Indie;20,000 - 50,000;324;41;283;0;0;6
356270;Cuban Missile Crisis;Adventure, Indie, Simulation;20,000 - 50,000;169;53;116;4;4;8
356280;Desert Law;Action, Adventure, Casual, Indie, RPG, Strategy;20,000 - 50,000;36;32;4;0;0;1
356290;Cuban Missile Crisis: Ice Crusade;Action, Indie, Simulation, Early Access;20,000 - 50,000;49;16;33;0;0;3
356310;METAL SLUG DEFENSE;Casual, Indie, Strategy;500,000 - 1,000,000;992;835;157;52;15;10
356370;Soccer Manager 2015;Indie, RPG, Strategy;100,000 - 200,000;353;158;195;11;12;0
356380;Orbit HD;Action, Adventure, Indie;50,000 - 100,000;48;33;15;174;219;0
356390;The Slaughter: Act One;Indie, RPG;20,000 - 50,000;110;20;90;499;560;0
356400;Thumper;Indie, Simulation;200,000 - 500,000;3374;294;3080;255;210;4
356420;Interloper;Action, Adventure, Indie, RPG, Early Access;20,000 - 50,000;324;58;266;392;471;0
356430;Chris Sawyer's Locomotion;Adventure, Casual, Indie;20,000 - 50,000;451;78;373;73;104;18
356450;Creature Romances: Kokonoe Kokoro;Adventure, Indie, RPG, Simulation, Strategy;20,000 - 50,000;323;115;208;0;0;1
356460;Drive!Drive!Drive!;Action, Adventure;0 - 20,000;37;18;19;0;0;0
356500;STAR WARS Galactic Battlegrounds Saga;Action;500,000 - 1,000,000;3226;301;2925;175;67;222
356510;Soccer Rage;Action;50,000 - 100,000;546;119;427;0;0;0
356520;Port of Call;Adventure;100,000 - 200,000;1038;127;911;43;43;0
356530;The Confines Of The Crown;Action;0 - 20,000;206;26;180;0;0;0
356530;The Confines Of The Crown;Action, Adventure;0 - 20,000;206;26;180;0;0;0
356540;East Tower - Takashi (East Tower Series Vol. 2);Action, Adventure;0 - 20,000;24;16;8;160;160;0
356540;East Tower - Takashi (East Tower Series Vol. 2);Action, Adventure;0 - 20,000;24;16;8;160;160;0
356550;East Tower - Kuon (East Tower Series Vol. 3);Action, Adventure;0 - 20,000;20;9;11;208;208;0
356560;East Tower - Kurenai (East Tower Series Vol. 4);Action;0 - 20,000;24;8;16;404;404;0
356570;Party Hard;Racing;500,000 - 1,000,000;8141;980;7161;432;272;32
356580;Aerannis;Action;20,000 - 50,000;92;40;52;0;0;0
356650;Death's Gambit: Afterlife;Action, Adventure;200,000 - 500,000;3651;804;2847;260;120;41
356670;Spooky's Jump Scare Mansion;Action;1,000,000 - 2,000,000;12486;956;11530;63;38;35
356710;Band of Drones;Action;0 - 20,000;3;0;3;0;0;0
356730;The Hole Story;Action, Adventure;0 - 20,000;10;10;0;0;0;0
356770;Astronaut Simulator;Adventure;0 - 20,000;38;22;16;0;0;0
356790;Galacide;Action, Adventure;20,000 - 50,000;78;12;66;306;306;0
356800;Choice of the Petal Throne;Action;0 - 20,000;9;10;-1;0;0;0
356820;Nemo Dungeon;Action;0 - 20,000;48;7;41;0;0;0
356870;Devoured Time;Action;0 - 20,000;2;7;-5;0;0;0
356880;Eron;Action, Racing;200,000 - 500,000;194;123;71;276;298;0
356890;One More Line;Action, Free to Play;50,000 - 100,000;178;67;111;123;119;1
356910;Battle Fantasia -Revised Edition-;Action;50,000 - 100,000;118;63;55;15;15;1
356940;MAGIX Music Maker Hip Hop 6 Steam Edition;Action;0 - 20,000;30;31;-1;0;0;0
357010;The Collider 2;Action;0 - 20,000;33;11;22;0;0;0
357070;UBERMOSH;Action;100,000 - 200,000;2427;289;2138;138;177;18
357120;Big Action Mega Fight!;Strategy;20,000 - 50,000;203;56;147;136;165;0
357190;ULTIMATE MARVEL VS. CAPCOM 3;Action, Casual, Indie;200,000 - 500,000;4051;400;3651;677;141;133
357200;500 Years Act 1;Action, Indie;0 - 20,000;21;44;-23;226;226;0
357280;Alter World;Simulation;200,000 - 500,000;356;177;179;280;282;0
357290;Red Lake;Sexual Content, Nudity, Indie, RPG, Simulation, Strategy;200,000 - 500,000;394;509;-115;241;237;0
357300;Snakebird;Adventure, Casual, Indie;50,000 - 100,000;926;67;859;94;140;5
357310;Oriental Empires;Casual, Indie;50,000 - 100,000;2262;547;1715;1038;852;44
357320;Break_In;Action, Adventure, Indie;0 - 20,000;25;21;4;0;0;0
357330;Space Beast Terror Fright;Action, Indie, RPG;100,000 - 200,000;1351;120;1231;111;136;14
357340;Cobalt;Action, Indie;20,000 - 50,000;607;53;554;83;83;0
357370;Return NULL - Episode 1;Action, Indie;20,000 - 50,000;59;38;21;269;269;0
357480;Frozen Free Fall: Snowball Fight;Adventure, Indie;200,000 - 500,000;1140;792;348;127;191;2
357490;Astroloco: Worst Contact;Action, Indie, Simulation;0 - 20,000;18;2;16;0;0;0
357500;Rumble Fighter: Unleashed;Action, Indie, Racing;100,000 - 200,000;188;170;18;3;3;0
357600;Unium;Adventure, Casual, Indie;20,000 - 50,000;283;16;267;175;175;0
357650;Project Explore;Action, Indie;50,000 - 100,000;165;74;91;64;81;0
357670;Home Improvisation: Furniture Sandbox;Action, Adventure, Indie;20,000 - 50,000;155;68;87;29;42;0
357690;APT;Action, Adventure, Indie, Strategy;0 - 20,000;23;9;14;0;0;0
357690;APT;Action, Casual, Indie;0 - 20,000;23;9;14;0;0;0
357700;Rogue Continuum;Adventure, Indie;0 - 20,000;19;3;16;0;0;0
357720;Inside My Radio;Racing, Simulation;50,000 - 100,000;398;55;343;75;99;0
357730;VR Karts;Indie, Simulation, Strategy;0 - 20,000;8;6;2;0;0;0
357750;Damn virgins;Adventure, Casual, Indie;0 - 20,000;26;5;21;0;0;0
357780;Defend Your Life: TD;Adventure, Casual, Indie;100,000 - 200,000;845;216;629;259;223;4
357840;Zombie Camp: Last Survivor;Action, Adventure, RPG;0 - 20,000;29;18;11;0;0;0
357890;Vortex Attack: ボルテックスアタック;Action, Adventure, Indie, RPG;20,000 - 50,000;79;15;64;0;0;1
357900;Make it indie!;Action, Adventure, Indie, RPG;500,000 - 1,000,000;572;666;-94;204;217;2
357910;QuestEvent;Action, Adventure, Massively Multiplayer, RPG, Simulation, Strategy;0 - 20,000;5;22;-17;0;0;0
357920;Final Strike;Casual, Indie, Simulation, Sports, Strategy;0 - 20,000;14;24;-10;0;0;0
357930;R.O.O.T.S;Adventure, Indie, Racing;20,000 - 50,000;36;29;7;89;89;0
357940;Telepath Tactics;Simulation, Strategy;0 - 20,000;86;29;57;19;19;1
358000;The Curse of Nordic Cove;Adventure;0 - 20,000;15;15;0;0;0;0
358030;Another Star;Adventure, Indie, RPG;0 - 20,000;42;3;39;0;0;1
358070;Earthtongue;Adventure, Casual, Indie;100,000 - 200,000;176;18;158;0;0;0
358080;No Turning Back: The Pixel Art Action-Adventure Roguelike;Indie, RPG;50,000 - 100,000;128;108;20;234;215;0
358090;D4: Dark Dreams Don’t Die -Season One-;Action, Indie;100,000 - 200,000;1538;370;1168;107;187;3
358130;Curious Expedition;Action;500,000 - 1,000,000;3498;336;3162;590;579;47
358170;Arctic Adventure;Adventure, Indie;0 - 20,000;27;21;6;0;0;0
358190;Blake Stone: Aliens of Gold;Action, Adventure, Indie;20,000 - 50,000;80;9;71;8;13;1
358200;Math Rescue;Action, Adventure;0 - 20,000;45;12;33;21;21;0
358210;Monster Bash;Action, Adventure;50,000 - 100,000;45;8;37;0;0;0
358220;Mystic Towers;Adventure;0 - 20,000;30;14;16;0;0;0
358230;Paganitzu;Action, Simulation;0 - 20,000;36;13;23;2;2;0
358230;Paganitzu;Action, Adventure, Simulation;0 - 20,000;36;13;23;2;2;0
358240;Monuments of Mars;Adventure, Casual, Indie, RPG;20,000 - 50,000;19;13;6;0;0;0
358250;Cosmo's Cosmic Adventure;Free to Play, Racing, Simulation, Sports;50,000 - 100,000;89;16;73;3;3;1
358260;Crystal Caves;Adventure, Indie;0 - 20,000;94;17;77;2;2;1
358270;Death Rally (Classic);Action, Indie;100,000 - 200,000;486;53;433;8;11;13
358280;Alien Carnage / Halloween Harry;RPG;20,000 - 50,000;29;27;2;0;0;0
358290;Hocus Pocus;Action, Adventure, Indie, RPG;20,000 - 50,000;113;18;95;1;1;0
358300;Major Stryker;Indie, RPG, Strategy;20,000 - 50,000;29;9;20;4;4;0
358310;Blake Stone: Planet Strike;Action, Adventure;20,000 - 50,000;32;12;20;0;0;0
358320;Realms of Chaos;Action, Indie, Massively Multiplayer;0 - 20,000;37;9;28;3;3;0
358320;Realms of Chaos;Casual, Indie, RPG;0 - 20,000;37;9;28;3;3;0
358340;Word Rescue;Indie, RPG;0 - 20,000;49;22;27;0;0;0
358350;Secret Agent;Casual, Indie, RPG;0 - 20,000;79;15;64;1;1;0
358360;Raptor: Call of the Shadows (1994 Classic Edition);Action, Adventure, RPG;20,000 - 50,000;149;17;132;8;8;0
358370;Terminal Velocity;Action, Adventure, RPG;20,000 - 50,000;60;8;52;0;0;0
358380;Wacky Wheels;Adventure, Indie, Strategy;20,000 - 50,000;105;27;78;0;0;2
358390;Stargunner;Indie, Strategy;20,000 - 50,000;87;17;70;3;3;0
358390;Stargunner;Casual, Strategy;20,000 - 50,000;87;17;70;3;3;0
358400;Shadow Warrior (Classic);Sexual Content, Nudity, Violent, Gore, Action, Adventure;50,000 - 100,000;21;10;11;0;0;0
358410;Rise of the Triad: Dark War;Action, Indie, Simulation;20,000 - 50,000;92;16;76;8;8;1
358410;Rise of the Triad: Dark War;Action, Adventure, Indie, Simulation, Strategy;20,000 - 50,000;92;16;76;8;8;1
358420;Xenophage: Alien Bloodsport;Action, Casual, Indie;20,000 - 50,000;8;40;-32;1;1;0
358440;Dark Ages;Action, Indie;20,000 - 50,000;18;14;4;0;0;0
358460;Talisman: The Horus Heresy;Indie;50,000 - 100,000;206;80;126;70;70;2
358610;Exowar;Action, Casual, Indie, Simulation;0 - 20,000;19;71;-52;2;2;0
358650;Gryphon Knight Epic;Action, Adventure, Casual, Indie, Massively Multiplayer, RPG, Simulation, Strategy;20,000 - 50,000;221;45;176;210;267;0
358700;3d Bridges;Action, Indie;0 - 20,000;10;16;-6;0;0;0
358750;Sunrider: Liberation Day - Captain's Edition;Action, Free to Play, Indie;100,000 - 200,000;657;129;528;557;749;13
358760;Selenon Rising;Casual, Strategy;0 - 20,000;14;3;11;0;0;0
358770;The Reject Demon: Toko Chapter 0 — Prelude;Casual, Strategy;20,000 - 50,000;155;30;125;215;215;0
358810;Luckslinger;Action, Adventure, Indie;20,000 - 50,000;100;22;78;4;4;1
358830;Good Robot;Casual, Indie, Strategy;20,000 - 50,000;206;39;167;0;0;0
358920;Star Control I and II;Free to Play, Indie, Massively Multiplayer, Strategy;100,000 - 200,000;92;25;67;56;56;6
358930;Star Control III;Action, Adventure, Indie;100,000 - 200,000;15;14;1;3;3;1
358960;Canabalt;Action, Casual, Indie;20,000 - 50,000;223;35;188;35;35;0
359040;The Music Machine;Action, Adventure, Indie;20,000 - 50,000;375;45;330;31;31;1
359050;Shower With Your Dad Simulator 2015: Do You Still Shower With Your Dad;Adventure, Indie;500,000 - 1,000,000;9219;467;8752;86;54;11
359060;Switch Galaxy Ultra;Casual, Indie;0 - 20,000;38;54;-16;119;157;2
359070;Hunter Gatherer;Casual, Free to Play;0 - 20,000;9;8;1;0;0;0
359090;Gare Sapphire Mechs;Adventure, Indie, Simulation;0 - 20,000;31;16;15;0;0;0
359100;Q.U.B.E. 2;Action, Adventure, Casual, Indie, Simulation;100,000 - 200,000;1226;225;1001;162;209;3
359140;Kick Ass Commandos;Action, Indie;20,000 - 50,000;394;24;370;0;0;0
359190;Rituals;Action, Adventure;50,000 - 100,000;164;95;69;0;0;0
359190;Rituals;Indie;50,000 - 100,000;164;95;69;0;0;0
359220;MX vs. ATV Unleashed;Casual, Strategy;20,000 - 50,000;363;137;226;25;25;4
359230;Lethis - Path of Progress;Indie, RPG;100,000 - 200,000;789;349;440;0;0;7
359250;City of Fools;Action, Indie, Early Access;20,000 - 50,000;59;25;34;212;212;1
359260;Green Moon;Action, Adventure, Indie;0 - 20,000;16;12;4;214;214;0
359260;Green Moon;Indie, RPG, Strategy;0 - 20,000;16;12;4;214;214;0
359280;Heroes of Loot;Strategy;20,000 - 50,000;56;27;29;129;129;0
359300;Death Pirate;Action, Casual, Indie, Simulation;0 - 20,000;2;6;-4;0;0;0
359310;Evoland 2;Adventure, Simulation;200,000 - 500,000;3295;468;2827;388;296;5
359320;Elite Dangerous;;2,000,000 - 5,000,000;67244;19380;47864;6030;1369;5559
359340;Pixel Puzzles Mosaics;Action, Indie, Simulation, Early Access;20,000 - 50,000;70;9;61;226;226;263
359350;Defunct;Indie, Simulation, Strategy;100,000 - 200,000;516;114;402;237;327;2
359370;Pirate's Life;Action, Indie;0 - 20,000;23;42;-19;0;0;0
359390;Amnesia: Memories;Simulation, Strategy;100,000 - 200,000;2900;245;2655;250;457;19
359400;Why Am I Dead At Sea;Action, Adventure, Indie, RPG, Early Access;20,000 - 50,000;363;21;342;0;0;1
359420;The Journeyman Project 1: Pegasus Prime;Action, Indie;0 - 20,000;45;2;43;0;0;1
359440;Artifact Adventure;Adventure, Casual;20,000 - 50,000;117;41;76;0;0;1
359450;In Space We Brawl;Violent, Action, Simulation, Sports;0 - 20,000;14;10;4;0;0;0
359510;Tangle Tower;Strategy;200,000 - 500,000;2575;128;2447;408;458;13
359550;Tom Clancy's Rainbow Six Siege;Adventure, Indie;20,000,000 - 50,000,000;964923;150661;814262;12741;2740;58532
359560;Shutter;Indie, Simulation;100,000 - 200,000;153;48;105;111;195;0
359580;Uncanny Valley;Adventure, Indie;50,000 - 100,000;275;219;56;150;137;0
359600;Assassin’s Creed Chronicles: Russia;Action, Indie;100,000 - 200,000;555;368;187;218;306;4
359610;Assassin’s Creed Chronicles: India;Action, Adventure, Indie;100,000 - 200,000;524;283;241;208;268;2
359620;Call of Cthulhu: Prisoner of Ice;Casual, Indie;0 - 20,000;65;19;46;31;39;0
359630;Independence War 2: Edge of Chaos;Action, Indie;0 - 20,000;54;19;35;0;0;2
359650;Star Trek : 25th Anniversary;Action;50,000 - 100,000;106;11;95;21;21;1
359670;Vagrant Hearts 2;Action, Casual, Indie;20,000 - 50,000;16;13;3;0;0;0
359800;Copa Petrobras de Marcas;Action, Simulation;500,000 - 1,000,000;1612;876;736;120;23;17
359810;Hare In The Hat;Indie, Massively Multiplayer, RPG;50,000 - 100,000;258;126;132;209;247;0
359840;Shift Happens;Action, Indie;500,000 - 1,000,000;2102;475;1627;156;74;83
359870;FINAL FANTASY X/X-2 HD Remaster;Adventure, Casual;500,000 - 1,000,000;14026;1436;12590;1856;965;781
359900;The Incredible Adventures of Van Helsing III;Strategy;200,000 - 500,000;720;419;301;343;381;11
359920;Highlands;Casual, Indie, Simulation;20,000 - 50,000;192;43;149;0;0;0
359960;Choice Chamber;Adventure, Casual, Simulation, Strategy;20,000 - 50,000;198;71;127;135;155;2
359970;Alpha Version.0;Casual, Indie, Simulation, Strategy;0 - 20,000;19;1;18;0;0;0
360010;Remnants Of Isolation;Indie;100,000 - 200,000;78;17;61;212;212;39
360030;XLarn;Adventure, Casual, Indie, RPG;0 - 20,000;25;10;15;0;0;0
360040;Our Nation's Miner;Adventure, Casual;0 - 20,000;12;18;-6;61;61;0
360150;How To Survive: Third Person Standalone;Violent, Gore, Adventure;200,000 - 500,000;705;537;168;94;134;2
360170;How to Survive 2;Free to Play, Massively Multiplayer;500,000 - 1,000,000;7343;3198;4145;532;226;54
360380;Tiny Bridge: Ratventure;Indie, RPG;100,000 - 200,000;624;328;296;173;144;1
360390;Nightside;Adventure, Casual, Indie, RPG;20,000 - 50,000;73;46;27;211;211;0
360400;Zombie Quarantine;Adventure, Casual, Indie, RPG;0 - 20,000;8;3;5;0;0;22
360430;Mafia III: Definitive Edition;Adventure, Casual, Indie, RPG;1,000,000 - 2,000,000;25630;19672;5958;1366;775;1097
360450;Kiai Resonance;RPG;20,000 - 50,000;158;41;117;270;270;0
360510;Into the Stars;Adventure, Indie, Simulation, Strategy;50,000 - 100,000;215;301;-86;507;507;0
360520;Hypt;Massively Multiplayer;20,000 - 50,000;32;11;21;0;0;0
360530;WE ARE DOOMED;Action, Indie, RPG;20,000 - 50,000;25;0;25;0;0;0
360550;Cursed Sight;Casual, Indie, Strategy;20,000 - 50,000;172;33;139;0;0;2
360580;Abduction Action! Plus;Action, Casual, Indie;0 - 20,000;30;29;1;0;0;0
360590;Once Bitten, Twice Dead!;Action, Indie, Sports;20,000 - 50,000;16;104;-88;0;0;1
360600;99 Waves to Die;Free to Play, Strategy;0 - 20,000;14;7;7;0;0;0
360600;99 Waves to Die;Adventure, Indie;0 - 20,000;14;7;7;0;0;0
360620;Spellsworn;Action, Adventure, Indie, RPG, Simulation, Early Access;100,000 - 200,000;1204;143;1061;192;148;6
360640;12 Labours of Hercules II: The Cretan Bull;Indie, Racing;200,000 - 500,000;1828;201;1627;312;309;1
360650;12 Labours of Hercules III: Girl Power;Indie, Simulation, Strategy, Early Access;100,000 - 200,000;823;132;691;302;304;4
360680;Drone Zero Gravity;Adventure, Indie, Simulation;0 - 20,000;7;0;7;0;0;0
360720;Soda Star;Adventure, Indie;20,000 - 50,000;4;3;1;0;0;0
360730;Cards and Castles;Adventure;100,000 - 200,000;559;200;359;386;437;5
360740;Downwell;Simulation;200,000 - 500,000;7051;225;6826;609;81;18
360830;Yooka-Laylee;Casual;500,000 - 1,000,000;3590;1147;2443;758;635;26
360840;Lumini;Indie, Early Access;0 - 20,000;132;20;112;1;1;0
360870;Ultimate Tic-Tac-Toe;Action, Indie;200,000 - 500,000;1240;259;981;17;17;6
360880;Nightfall: Escape;Casual, Simulation, Sports;0 - 20,000;23;36;-13;311;311;0
360880;Nightfall: Escape;Adventure, Indie;0 - 20,000;23;36;-13;311;311;0
360890;The Lost Valley;Design & Illustration, Web Publishing;200,000 - 500,000;123;220;-97;376;268;0
360940;The Mean Greens - Plastic Warfare;Action, Adventure, Indie, Early Access;500,000 - 1,000,000;8130;1815;6315;128;70;10
360990;Ongaku;Adventure;0 - 20,000;5;1;4;0;0;0
361020;Luxor HD;Racing;20,000 - 50,000;104;11;93;0;0;7
361040;Doom & Destiny Advanced;Adventure, Indie;0 - 20,000;343;29;314;27;32;2
361100;Dual Souls: The Last Bearer;Adventure, RPG;0 - 20,000;33;2;31;0;0;2
361110;Prometheus - The Fire Thief;Animation & Modeling, Utilities;0 - 20,000;5;2;3;56;56;0
361130;Card Dungeon;Casual;0 - 20,000;30;20;10;130;130;0
361160;Steamalot: Epoch's Journey;Casual;0 - 20,000;9;2;7;0;0;0
361190;Sparkle 3 Genesis;Casual;200,000 - 500,000;310;192;118;315;289;2
361200;COAST GUARD;Strategy;;;;0;;;
361230;Super Daryl Deluxe;Strategy;;;;0;;;
361250;Strange Space;Action;0 - 20,000;1;3;-2;0;0;0
361280;Turmoil;Simulation;1,000,000 - 2,000,000;10284;802;9482;508;413;283
361300;Mother Russia Bleeds;Casual, Indie, Strategy;200,000 - 500,000;4045;600;3445;417;391;12
361320;Casino Inc.;Action, Casual;20,000 - 50,000;205;38;167;449;449;5
361330;Shrooms;Action, Indie;0 - 20,000;15;30;-15;0;0;0
361350;Skyhook;Adventure, Indie, Strategy;20,000 - 50,000;110;20;90;185;224;3
361360;Goosebumps: The Game;Action, Indie, Racing;50,000 - 100,000;200;34;166;132;175;1
361370;Deer Hunter: Reloaded;Adventure, Casual;0 - 20,000;4;16;-12;0;0;0
361380;World War I;Action, Indie, Simulation, Early Access;50,000 - 100,000;168;55;113;0;0;2
361420;ASTRONEER;Adventure, Casual, Indie;2,000,000 - 5,000,000;95194;8607;86587;2189;1000;2765
361430;The Little Crane That Could;;0 - 20,000;20;15;5;0;0;0
361550;Cradle;Action, Casual, Indie, Racing, Simulation, Sports;100,000 - 200,000;1252;534;718;421;452;1
361560;Ice Cream Surfer;Action;0 - 20,000;11;36;-25;0;0;0
361600;Luna Sky;Action, Indie, Racing;50,000 - 100,000;69;88;-19;215;259;0
361620;True Bliss;Action, Adventure, Indie, RPG, Strategy, Early Access;20,000 - 50,000;37;49;-12;2;4;0
361630;404Sight;Adventure, Indie;200,000 - 500,000;1383;247;1136;25;22;0
361670;STAR WARS - X-Wing Alliance;Action, Adventure, Casual, Indie, RPG, Simulation;100,000 - 200,000;345;67;278;245;88;4
361680;Knight & Damsel;Action, Adventure, Indie, RPG;0 - 20,000;5;1;4;0;0;0
361690;STAR WARS X-Wing vs TIE Fighter - Balance of Power Campaigns;Simulation, Sports;100,000 - 200,000;184;56;128;492;884;3
361790;Winged Sakura: Mindy's Arc 2;Design & Illustration;0 - 20,000;11;4;7;0;0;0
361800;Tree of Life;Indie;200,000 - 500,000;4429;2348;2081;848;506;2
361830;in Space;Indie, Simulation;0 - 20,000;83;19;64;0;0;0
361850;Portal of Evil: Stolen Runes Collector's Edition;Action, Indie;100,000 - 200,000;401;35;366;160;235;1
361890;Chronostorm: Siberian Border;Action, Indie, Simulation;100,000 - 200,000;50;38;12;189;239;15
361930;Farm Frenzy: Hurricane Season;Casual, Indie;0 - 20,000;89;8;81;1;1;0
361950;MOAI 2: Path to Another World;Simulation;0 - 20,000;49;13;36;0;0;2
361970;Weather Lord: The Successor's Path;Indie;0 - 20,000;24;9;15;69;69;0
361990;Lakeview Cabin Collection;Strategy;200,000 - 500,000;1580;113;1467;427;386;5
362020;Queen At Arms;Indie;0 - 20,000;15;2;13;0;0;0
362030;Mysteries & Nightmares: Morgiana;Strategy;0 - 20,000;6;1;5;0;0;0
362060;Construct: Embers of Life;Design & Illustration, Web Publishing;0 - 20,000;11;14;-3;0;0;0
362070;Metal Reaper Online;Casual, Indie;100,000 - 200,000;346;140;206;20;23;0
362090;Siralim;Action, Indie;50,000 - 100,000;216;33;183;8;8;0
362130;Ashes of Immortality;Action, Adventure, Casual, Indie, RPG, Simulation, Strategy;100,000 - 200,000;69;20;49;293;293;0
362140;Ashes of Immortality II;Action, Indie;50,000 - 100,000;21;22;-1;204;209;3
362150;Ashes of Immortality II - Bad Blood;Action, Adventure, Indie, RPG;20,000 - 50,000;15;17;-2;213;232;7
362290;The Living Dungeon;RPG, Strategy;0 - 20,000;45;11;34;224;224;0
362300;Just Survive Test Server;Adventure, Casual, Free to Play, Indie, RPG, Simulation, Strategy;100,000 - 200,000;275;118;157;325;11;1
362310;Dungeon League;Indie, Simulation;0 - 20,000;46;12;34;0;0;0
362350;Boss Monster;Casual, Indie, Simulation;20,000 - 50,000;223;135;88;100;100;0
362370;Dog Fight;Action, Adventure, Indie;0 - 20,000;6;4;2;0;0;0
362380;Push Me Pull You;Action, Indie;0 - 20,000;24;9;15;0;0;0
362400;Regimental Chess;Action, Indie;50,000 - 100,000;105;84;21;131;220;11
362410;Adam's Venture Chronicles;Action, Indie;20,000 - 50,000;178;82;96;304;370;1
362490;Exanima;Indie;500,000 - 1,000,000;7742;1685;6057;1963;2382;130
362610;High On Racing;Adventure, Indie, RPG, Strategy;200,000 - 500,000;125;134;-9;345;335;0
362620;Software Inc.;Action, Adventure, Casual, Indie;200,000 - 500,000;5472;335;5137;2067;1402;241
362660;Blue Rose Reprise;Photo Editing, Utilities, Video Production;20,000 - 50,000;84;52;32;141;190;0
362670;Curse of the Deadwood;Action;0 - 20,000;17;9;8;0;0;1
362680;Fran Bow;Adventure, Casual, Indie, RPG;500,000 - 1,000,000;12653;375;12278;504;485;100
362780;18 Wheels of Steel: Extreme Trucker 2;Indie, RPG, Strategy;0 - 20,000;102;33;69;17;17;1
362790;Word Wonders: The Tower of Babel;Indie, Simulation, Strategy;0 - 20,000;15;0;15;0;0;0
362800;Cadence;Adventure, Indie;0 - 20,000;0;0;0;0;0;0
362810;Fighties;Action, Strategy;50,000 - 100,000;223;43;180;0;0;2
362830;3D MiniGolf;Action, Adventure, Indie;0 - 20,000;29;44;-15;138;138;0
362860;Sylvio;Simulation;0 - 20,000;110;30;80;2;2;0
362870;RPG Maker 2003;Adventure, Indie;100,000 - 200,000;542;42;500;1373;813;58
362890;Black Mesa;Action, Adventure, Indie, RPG;2,000,000 - 5,000,000;88484;4200;84284;709;458;978
362930;Garfield Kart;Indie;500,000 - 1,000,000;11740;1561;10179;210;30;65
362940;Courier of the Crypts;Free to Play;0 - 20,000;55;3;52;0;0;0
362960;Tyranny;Casual, Indie;500,000 - 1,000,000;9902;1502;8400;910;517;128
363020;IPackThat;Action, Indie, RPG;;;;0;;;
363050;Let's Explore the Airport (Junior Field Trips);Action, Indie, Strategy;0 - 20,000;56;6;50;0;0;1
363060;Let's Explore the Farm (Junior Field Trips);Casual, Indie, RPG, Strategy;0 - 20,000;37;3;34;0;0;3
363070;Let's Explore the Jungle (Junior Field Trips);Casual, Indie;0 - 20,000;28;5;23;0;0;2
363090;NOBUNAGA'S AMBITION: Kakushin with Power Up Kit;Action, Adventure, Casual, Indie, RPG, Strategy, Early Access;50,000 - 100,000;180;43;137;0;0;171
363110;NOBUNAGA'S AMBITION: Tendou with Power Up Kit;Action, Adventure, Indie;50,000 - 100,000;121;34;87;0;0;73
363130;Toukiden: Kiwami;Action, Indie;50,000 - 100,000;843;398;445;64;64;14
363130;Toukiden: Kiwami;Action, Indie;50,000 - 100,000;843;398;445;64;64;14
363150;Romance of the Three Kingdoms XIII;Action, Adventure, Indie;200,000 - 500,000;3589;2983;606;3668;5511;768
363180;Tenshu General;Indie, RPG, Strategy;0 - 20,000;20;11;9;0;0;0
363200;Virus Jigglin' Fever;Indie;0 - 20,000;3;3;0;0;0;0
363220;Ghost in the Machine;Action, Adventure, Indie;0 - 20,000;13;7;6;8;8;0
363240;Caveman Craig;Adventure, Indie, RPG;0 - 20,000;90;24;66;15;15;0
363240;Caveman Craig;Action, Adventure, Simulation;0 - 20,000;90;24;66;15;15;0
363330;Mind Snares: Alice's Journey;Action, Adventure, Simulation;50,000 - 100,000;651;89;562;201;213;2
363360;Interstellar Rift;Action, Simulation, Strategy;50,000 - 100,000;1074;435;639;829;1215;27
363410;Always The Same Blue Sky...;Action, Indie;20,000 - 50,000;171;57;114;181;181;0
363420;Leap of Fate;Action, Racing;20,000 - 50,000;390;52;338;0;0;3
363430;D Series OFF ROAD Driving Simulation;Adventure, Casual, Indie, Strategy;0 - 20,000;23;39;-16;0;0;1
363440;Mega Man Legacy Collection;Action, Casual, Indie;200,000 - 500,000;3205;517;2688;315;128;35
363460;Spermination;Action, Casual, Indie;20,000 - 50,000;371;61;310;8;10;0
363490;Escape Machines;Action, Indie;500,000 - 1,000,000;278;389;-111;232;209;0
363500;Ossuary;Nudity, Violent, Gore, Action;0 - 20,000;35;3;32;0;0;0
363510;STAR-BOX: RPG Adventures in Space;Casual;50,000 - 100,000;41;43;-2;246;294;0
363520;Goliath;Casual, Indie;0 - 20,000;185;84;101;41;41;0
363550;Kenney Game Assets;Animation & Modeling, Design & Illustration, Education, Software Training, Utilities;0 - 20,000;32;2;30;0;0;0
363580;PING 1.5+;Casual, Simulation, Strategy;0 - 20,000;18;5;13;209;209;0
363600;Holy Potatoes! A Weapon Shop?!;Action, Adventure, Indie;200,000 - 500,000;1396;537;859;239;225;11
363610;Botology;Free to Play, Indie, Strategy;100,000 - 200,000;125;228;-103;225;264;1
363620;Tea Party Simulator 2015;Action, Adventure, Indie, RPG;50,000 - 100,000;462;210;252;225;250;1
363650;Hacker's Beat;Adventure, Casual, Free to Play, Indie, Simulation;20,000 - 50,000;30;30;0;0;0;0
363660;Island Flight Simulator;Indie, RPG;0 - 20,000;7;35;-28;0;0;0
363670;Seeders;Action, Indie;20,000 - 50,000;31;21;10;106;106;1
363680;Battlefleet Gothic: Armada;Indie, RPG;200,000 - 500,000;3735;1724;2011;1037;866;35
363790;Egg Returns Home;Action, Adventure, Indie;100,000 - 200,000;386;107;279;234;249;0
363840;Ancient Battle: Rome;Adventure, Simulation;20,000 - 50,000;11;4;7;0;0;0
363890;RPG Maker MV;Adventure;200,000 - 500,000;6155;560;5595;8320;414;1066
363900;Super Goo Goo;Adventure, Indie;0 - 20,000;9;6;3;0;0;0
363920;SWR JST DX Selective Memory Erase Effect;Indie, Strategy;0 - 20,000;19;12;7;0;0;0
363930;Dead Age;Action, Casual, Indie;200,000 - 500,000;4221;924;3297;335;320;17
363940;Solar Shifter EX;Indie, RPG;20,000 - 50,000;41;50;-9;0;0;0
363950;Windscape;Strategy;20,000 - 50,000;203;109;94;904;904;0
363960;Devils & Demons;Simulation, Strategy;50,000 - 100,000;42;63;-21;0;0;0
363970;Clicker Heroes;Free to Play, Indie, RPG, Strategy;5,000,000 - 10,000,000;52630;5908;46722;4837;453;2745
363980;Forget Me Not: My Organic Garden;Adventure, Casual, Indie;20,000 - 50,000;329;63;266;0;0;1
364000;Culina: Hands in the Kitchen;Indie, Early Access;0 - 20,000;7;6;1;0;0;0
364050;Face It - A game to fight inner demons;Action, Free to Play, Indie;500,000 - 1,000,000;919;293;626;191;207;19
364060;Capsule Force;Action, Casual, Indie, Racing;0 - 20,000;27;10;17;3;3;0
364100;Space Robot Samurai Zombie Slayer;Indie;0 - 20,000;15;7;8;4;4;0
364130;Ride the Bullet;Action, Indie;0 - 20,000;12;9;3;0;0;0
364190;ASDAD: All-Stars Dungeons and Diamonds;Action, Adventure, Indie;0 - 20,000;19;7;12;0;0;0
364200;Farabel;Adventure, Casual, Indie, Simulation;20,000 - 50,000;80;30;50;0;0;0
364210;Sierra Ops - Space Strategy Visual Novel;Indie, RPG, Strategy;100,000 - 200,000;190;37;153;963;1171;20
364230;Lucius Demake;Action, Adventure, Casual, Indie, RPG;20,000 - 50,000;425;29;396;218;232;0
364240;liquivid Video Improve 2;Action, Adventure, Casual, Indie, RPG, Simulation, Strategy;0 - 20,000;37;15;22;0;0;1
364250;XIIZEAL;Indie;0 - 20,000;41;7;34;0;0;0
364260;Warlock's Citadel;Animation & Modeling, Design & Illustration, Education;0 - 20,000;7;1;6;0;0;0
364270;Lilly and Sasha: Curse of the Immortals;Indie, Simulation;100,000 - 200,000;314;77;237;192;224;0
364300;Space Rogue;Racing;20,000 - 50,000;289;157;132;0;0;0
364350;The Apotheosis Project;RPG, Strategy;50,000 - 100,000;65;39;26;459;469;1
364360;Total War: WARHAMMER;Indie;2,000,000 - 5,000,000;39279;11037;28242;3114;1297;660
364370;The Sheltered;Casual, Indie;0 - 20,000;9;9;0;0;0;0
364380;CINEVEO - VR Cinema;Strategy;20,000 - 50,000;75;47;28;0;0;0
364390;Downfall;Indie;50,000 - 100,000;1050;70;980;573;791;2
364420;Roguelands;Action, Adventure, RPG;200,000 - 500,000;2942;720;2222;1260;1371;17
364450;Freshman Year;Action, Adventure, Massively Multiplayer, Simulation;20,000 - 50,000;126;82;44;0;0;0
364470;The Elder Scrolls: Legends;Action, Indie, Sports;1,000,000 - 2,000,000;7605;2629;4976;931;175;386
364480;Red Goblin: Cursed Forest;Animation & Modeling, Design & Illustration, Video Production;20,000 - 50,000;13;17;-4;0;0;4
364510;Transcendence;Action, Indie;20,000 - 50,000;154;14;140;0;0;5
364640;FreeCell Quest;Adventure, Indie;50,000 - 100,000;328;136;192;493;493;9
364660;Luminoso;Sports;0 - 20,000;2;3;-1;0;0;0
364670;Skyflower;Action, Indie;20,000 - 50,000;25;16;9;0;0;0
364690;SUPER DISTRO;Action, Indie;200,000 - 500,000;403;695;-292;227;253;0
364700;Dawn of the Plow;Indie, Simulation, Strategy;0 - 20,000;8;1;7;0;0;0
364710;Wonky Pigeon!;Action, Adventure, Casual, Indie, Simulation;0 - 20,000;16;81;-65;0;0;0
364710;Wonky Pigeon!;Action, Indie;0 - 20,000;16;81;-65;0;0;0
364720;Reagan Gorbachev;Action;0 - 20,000;20;3;17;0;0;0
364740;Magi;Action, Adventure, Indie, RPG;0 - 20,000;18;2;16;0;0;0
364750;Hacker Evolution Source Code;Adventure, Indie;0 - 20,000;19;6;13;404;404;0
364770;Super Furball;Strategy;0 - 20,000;47;9;38;32;32;0
364790;Voyage to Farland;Adventure, Casual, Indie, RPG;0 - 20,000;14;6;8;0;0;0
364800;Star Trek: Judgment Rites;Action, Indie;20,000 - 50,000;45;1;44;0;0;0
364810;Star Trek: Starfleet Academy;Racing, Simulation, Sports;50,000 - 100,000;87;18;69;0;0;1
364820;Star Trek: Starfleet Command Gold Edition;Casual, Indie, Simulation;0 - 20,000;99;69;30;3;3;2
364830;BLEAK: Welcome to Glimmer;Simulation, Early Access;0 - 20,000;59;7;52;0;0;0
364840;N2O: Nitrous Oxide;Action, Indie;0 - 20,000;28;7;21;0;0;0
364850;StartBolita;Action, Adventure, Indie;20,000 - 50,000;7;4;3;0;0;0
364850;StartBolita;Adventure, Casual, Indie, Sports;20,000 - 50,000;7;4;3;0;0;0
364880;Genesis of Drones;Action, Adventure, Indie, RPG, Early Access;0 - 20,000;20;14;6;0;0;0
364890;The Lost Battalion: All Out Warfare;Action, Adventure, Indie, Strategy, Early Access;20,000 - 50,000;51;48;3;271;282;0
364900;Red Bit Ninja;Casual, Indie, RPG, Strategy;0 - 20,000;7;22;-15;2;2;0
364910;Redemption: Saints And Sinners;Action, Adventure, Casual, Indie;50,000 - 100,000;131;129;2;330;356;765
364930;Koi-Koi Japan [Hanafuda playing cards];Casual, Indie, Strategy;50,000 - 100,000;1010;76;934;362;486;1
364940;Pony World 3;Adventure, Indie, RPG;20,000 - 50,000;235;103;132;0;0;0
364970;CopperCube 5 Game Engine;Sports;0 - 20,000;37;19;18;147;147;0
364980;Bunker Constructor;Action;0 - 20,000;14;9;5;0;0;0
365020;Gynophobia;Action;50,000 - 100,000;468;228;240;5;5;0
365050;Escape;Action;100,000 - 200,000;171;109;62;5;5;0
365060;Titanis;Action;0 - 20,000;13;4;9;0;0;0
365070;One Manga Day;Action;100,000 - 200,000;544;369;175;160;55;0
365080;Unheard Screams - King Leopold II's Rule Over The Congo;Simulation, Sports, Early Access;0 - 20,000;8;8;0;0;0;0
365090;Super Snow Fight;Adventure, Indie;0 - 20,000;22;2;20;0;0;0
365110;After All;Indie;50,000 - 100,000;22;19;3;144;215;7
365120;Curse of the Crescent Isle DX;Adventure, Indie;20,000 - 50,000;67;27;40;2;2;0
365140;DREAMFLIGHT VR;Casual, Indie;0 - 20,000;5;7;-2;0;0;0
365150;Go Home - Rage incoming;Action, RPG, Strategy;20,000 - 50,000;18;20;-2;0;0;0
365160;Kona;Action, Indie;100,000 - 200,000;2430;497;1933;253;270;9
365190;TASTEE: Lethal Tactics;RPG;20,000 - 50,000;188;43;145;66;127;0
365200;LOUD on Planet X;Animation & Modeling, Design & Illustration, Education, Software Training, Utilities;0 - 20,000;5;10;-5;0;0;0
365210;Hollywood Visionary;Design & Illustration;0 - 20,000;74;9;65;0;0;0
365240;Galaxy Union;Adventure;20,000 - 50,000;9;9;0;0;0;0
365260;Crash Dive;Adventure, Indie, Strategy, Early Access;50,000 - 100,000;149;19;130;0;0;3
365280;Alexia Crow and the Cave of Heroes;Indie;0 - 20,000;28;33;-5;214;214;0
365290;House of Nightmares B-Movie Edition;Action, Adventure, Indie;0 - 20,000;3;1;2;0;0;0
365300;Transmissions: Element 120;Action, Adventure, Casual, Indie;500,000 - 1,000,000;8828;527;8301;48;46;4
365320;Quadrant;Action, Indie;0 - 20,000;84;40;44;0;0;0
365330;iaidoka_interlude;Action, Adventure, Indie, RPG;0 - 20,000;45;25;20;8;8;0
365340;The Way of the Pixelated Fist;Adventure, Casual, Indie;0 - 20,000;18;17;1;0;0;0
365340;The Way of the Pixelated Fist;Action, Casual, Indie, Simulation, Sports, Strategy;0 - 20,000;18;17;1;0;0;0
365350;How to Take Off Your Mask;Action, Casual, Indie;0 - 20,000;141;28;113;262;302;0
365360;Battle Brothers;Casual, Indie, Sports, Strategy;500,000 - 1,000,000;16467;2210;14257;2735;900;2819
365400;Spoko and Poko;Adventure, Indie;0 - 20,000;17;12;5;139;202;0
365400;Spoko and Poko;Adventure, Free to Play, Indie;0 - 20,000;17;12;5;139;202;0
365420;Apollo4x;Action, Adventure, Casual, Indie, RPG;0 - 20,000;15;36;-21;1541;1541;0
365430;Everything is Black and White;Action, Massively Multiplayer, Early Access;0 - 20,000;9;3;6;0;0;0
365450;Hacknet;Adventure, Indie;1,000,000 - 2,000,000;20861;1439;19422;330;262;73
365460;CHARIOT WARS;Action, Adventure, Casual, Indie;0 - 20,000;1;12;-11;0;0;0
365480;Ravenmark: Scourge of Estellion;Indie, RPG, Simulation, Strategy;20,000 - 50,000;58;34;24;0;0;1
365500;quadrant;Casual, Indie, Simulation;0 - 20,000;30;5;25;0;0;0
365510;Flip;Action, Indie;0 - 20,000;21;2;19;0;0;0
365560;Battle of the Bulge;Action, Indie;20,000 - 50,000;106;41;65;0;0;0
365580;Beeswing;Casual, Indie;50,000 - 100,000;108;11;97;0;0;0
365590;Tom Clancy’s The Division;Casual, Indie;5,000,000 - 10,000,000;60912;26783;34129;4653;2384;718
365620;WarBirds - World War II Combat Aviation;Adventure, Indie;0 - 20,000;31;31;0;0;0;0
365660;OlliOlli2: Welcome to Olliwood;Sexual Content, Nudity, Adventure, Indie, Simulation;50,000 - 100,000;480;93;387;149;240;0
365670;Blender;Casual, Indie, Early Access;5,000,000 - 10,000,000;40113;1222;38891;2676;92;7335
365680;BRAWL;Action, Indie;0 - 20,000;52;24;28;11;11;0
365730;Gilbert Goodmate and the Mushroom of Phungoria;Action, Casual, Indie;0 - 20,000;15;0;15;0;0;0
365760;Vektor Wars;Action, Indie;0 - 20,000;48;21;27;0;0;0
365770;Volume;Action, Adventure, Indie, RPG;100,000 - 200,000;515;157;358;145;189;1
365800;AdvertCity;Adventure, Indie, RPG;0 - 20,000;47;36;11;307;307;2
365810;Flying Tigers: Shadows Over China;Casual, Simulation;100,000 - 200,000;625;255;370;136;136;1
365820;Company of Heroes 2 - The British Forces;Action, Indie;100,000 - 200,000;281;99;182;0;0;0
365850;Starchaser: Priestess of the Night Sky;Casual, Simulation, Strategy;0 - 20,000;36;9;27;333;333;0
365860;Spaceman Sparkles 2;Action, Adventure, RPG;20,000 - 50,000;53;16;37;182;182;0
365870;Below Kryll;Action, Casual, Indie;0 - 20,000;92;11;81;59;59;0
365870;Below Kryll;Action, Simulation, Early Access;0 - 20,000;92;11;81;59;59;0
365880;Mirrored - Chapter 1;Action, Indie;20,000 - 50,000;71;41;30;0;0;0
365890;Heroes of Normandie;Action, Indie, Strategy;20,000 - 50,000;158;60;98;0;0;1
365900;Pixel Dungeon;Action, Indie;20,000 - 50,000;357;40;317;0;0;1
365930;STOORM - Full Edition.;Action, Casual, Indie, Sports;0 - 20,000;4;12;-8;0;0;0
365960;rFactor 2;Indie, Simulation;200,000 - 500,000;5361;1308;4053;4315;3036;975
365980;Useless Box;Action, Adventure, RPG;0 - 20,000;11;12;-1;0;0;0
366000;Rogue System;Action, Adventure, Indie;0 - 20,000;173;78;95;119;119;0
366010;Generic Space Shooter;Action, Casual, Simulation, Sports, Strategy;0 - 20,000;31;11;20;0;0;0
366040;Iggy's Egg Adventure;Action, Indie;20,000 - 50,000;206;27;179;0;0;1
366050;Star Balls;Casual, Indie;0 - 20,000;4;1;3;0;0;0
366060;Teddy Terror;Action, Indie, Strategy;0 - 20,000;32;11;21;0;0;0
366090;Colony Survival;Action, Indie;200,000 - 500,000;5957;559;5398;1174;825;351
366100;Champions Of Chaos 2;Utilities;20,000 - 50,000;25;1;24;0;0;0
366180;Disposable Heroes;Indie, Racing, Simulation, Sports;20,000 - 50,000;49;28;21;146;175;1
366210;Sleep Attack;Casual, Indie, Strategy;0 - 20,000;47;16;31;284;284;0
366220;Wurm Unlimited;Action, Indie;200,000 - 500,000;2080;842;1238;3757;275;227
366230;BASEBALL STARS 2;Action, Casual, Indie;20,000 - 50,000;61;22;39;0;0;1
366240;GAROU: MARK OF THE WOLVES;RPG, Early Access;50,000 - 100,000;736;41;695;0;0;4
366250;METAL SLUG;Action, Simulation, Sports;200,000 - 500,000;2731;331;2400;71;56;71
366260;METAL SLUG 2;Action, Indie, Sports;100,000 - 200,000;650;95;555;79;109;4
366270;SHOCK TROOPERS;Action, Indie, Strategy;20,000 - 50,000;126;33;93;0;0;1
366280;TWINKLE STAR SPRITES;Violent, Action;20,000 - 50,000;139;51;88;11;11;3
366290;Carp Fishing Simulator;Action, Adventure, Indie, RPG;0 - 20,000;121;82;39;10;10;0
366320;Seasons after Fall;Adventure, Indie;100,000 - 200,000;2222;525;1697;208;286;4
366350;ROGUS - Kingdom of The Lost Souls;Adventure, Casual, Indie;0 - 20,000;14;20;-6;0;0;0
366380;MYTH - Steam Edition;Casual, Indie;0 - 20,000;84;12;72;0;0;1
366410;Ludoku;Action, Casual, Indie, Racing, Simulation;0 - 20,000;18;2;16;1;1;0
366440;Savage Resurrection;Simulation, Strategy;50,000 - 100,000;815;622;193;215;241;0
366460;Pavel Quest;Indie, Simulation, Strategy;0 - 20,000;12;3;9;0;0;0
366530;Esenthel Engine;Adventure, Casual, Indie, RPG;50,000 - 100,000;25;18;7;2;2;0
366550;Zeuxis : procedural texture generator;Free to Play, Indie;0 - 20,000;22;5;17;0;0;1
366570;CastleAbra;Casual, Indie, Simulation;20,000 - 50,000;6;5;1;0;0;0
366590;Prompt;RPG;0 - 20,000;43;4;39;2;2;0
366600;Withstand: Apotheosis;Adventure, Casual, Indie, Simulation, Strategy;0 - 20,000;4;7;-3;0;0;0
366610;Not without my donuts;Adventure, Indie, Simulation;0 - 20,000;23;25;-2;327;376;0
366610;Not without my donuts;Adventure, Casual, Indie;0 - 20,000;23;25;-2;327;376;0
366620;Broken Bots;Adventure, Indie;0 - 20,000;33;10;23;0;0;0
366640;Shiness: The Lightning Kingdom;Adventure, Indie;20,000 - 50,000;267;193;74;22;22;5
366670;The Travels of Marco Polo;Animation & Modeling, Design & Illustration, Education, Photo Editing, Software Training, Utilities, Video Production;0 - 20,000;32;14;18;1;1;0
366690;Cue Club 2: Pool & Snooker;Action, Adventure;100,000 - 200,000;467;64;403;127;127;15
366700;Breakout Invaders;Indie;20,000 - 50,000;32;34;-2;0;0;0
366780;Magical Eyes - Red is for Anguish;Indie;0 - 20,000;53;11;42;0;0;0
366800;Mainland;Action, Simulation;100,000 - 200,000;196;42;154;0;0;0
366810;Dungeon Hero;Indie, RPG;20,000 - 50,000;50;54;-4;17;17;0
366860;Spy Bugs;Action, Adventure, Indie, RPG;0 - 20,000;23;14;9;0;0;0
366870;Narcosis;Adventure, Strategy;100,000 - 200,000;844;280;564;177;267;4
366910;The Long Journey Home;Adventure, Indie;100,000 - 200,000;1082;705;377;66;93;6
366920;Ruler by Default;Software Training;0 - 20,000;26;1;25;0;0;0
366960;SECTOR;Action, Indie;20,000 - 50,000;29;96;-67;0;0;0
366970;Mighty Switch Force! Hyper Drive Edition;Action, Indie;20,000 - 50,000;230;17;213;0;0;0
366990;Puzzle Station 15th Anniversary Retro Release;Action, Indie;0 - 20,000;22;14;8;0;0;0
367000;Fine Sweeper;Casual, Indie, Strategy;0 - 20,000;386;53;333;414;414;0
367010;Vernon's Legacy;Action, Adventure, Indie, Simulation, Early Access;0 - 20,000;64;48;16;7;7;0
367020;No One But You;Action, Adventure, Casual, Indie;0 - 20,000;138;31;107;0;0;0
367030;Lootfest;Action, Indie, Racing;0 - 20,000;36;19;17;0;0;0
367040;InsanZ - Retro Survival Horror;Adventure, Indie, RPG;20,000 - 50,000;3;7;-4;0;0;0
367050;Vindicator: Uprising;Casual, Indie, Strategy;0 - 20,000;13;1;12;0;0;0
367060;Helena The 3rd;Casual, Indie, Strategy;0 - 20,000;12;6;6;0;0;0
367080;Songbringer;Action, Indie;20,000 - 50,000;193;53;140;212;309;2
367110;Dustbowl;Action, Adventure, Indie;0 - 20,000;92;27;65;0;0;1
367120;Seduce Me the Otome;Action, Indie, Early Access;200,000 - 500,000;1865;286;1579;29;43;3
367140;Wish Project;Adventure, Casual;0 - 20,000;46;2;44;0;0;0
367220;Egyptian Settlement Gold;Adventure, Indie;0 - 20,000;1;5;-4;0;0;0
367240;Avenging Angel;Free to Play, Indie;0 - 20,000;21;34;-13;158;158;0
367260;Dwarven Brawl Bros;Adventure, Indie;0 - 20,000;30;6;24;228;228;0
367270;Angels Fall First;Action, Free to Play, Indie, Strategy, Early Access;50,000 - 100,000;2018;453;1565;573;660;4
367300;Pixel Star;Action, Adventure, Indie;20,000 - 50,000;103;16;87;153;153;0
367350;Demon Hearts;Action, Adventure, Casual, Indie, Strategy;0 - 20,000;54;15;39;185;185;0
367430;One Ship Two Ship Redshift Blueshift;Action, Casual, Free to Play, Indie;0 - 20,000;46;6;40;0;0;0
367450;Poly Bridge;Action, Adventure, Indie;1,000,000 - 2,000,000;14163;1299;12864;337;152;99
367500;Dragon's Dogma: Dark Arisen;Action, Indie;1,000,000 - 2,000,000;28728;3234;25494;1893;628;908
367520;Hollow Knight;Action, Adventure, Indie, Simulation, Early Access;10,000,000 - 20,000,000;268752;7758;260994;1838;662;5924
367550;Rugby League Team Manager 2015;Action, Adventure, Indie, Simulation;0 - 20,000;33;16;17;489;489;3
367570;oO;Action, Indie, RPG;100,000 - 200,000;827;91;736;81;82;3
367580;Hook;Adventure;200,000 - 500,000;8317;252;8065;119;131;3
367600;Skyshine's BEDLAM;Action, Casual, Indie, RPG;100,000 - 200,000;518;359;159;3;3;1
367660;UfoPilot : Astro-Creeps Elite;Animation & Modeling, Design & Illustration, Education, Utilities, Early Access;0 - 20,000;2;1;1;0;0;0
367670;Controller Companion;Action;200,000 - 500,000;2214;223;1991;1526;37;129
367700;SHOFER Race Driver;Action, Casual, Indie, Simulation, Sports, Early Access;0 - 20,000;22;71;-49;2;2;0
367710;Afterlife Empire;Casual;0 - 20,000;44;42;2;19;19;0
367780;Aero's Quest;Adventure;20,000 - 50,000;57;38;19;1568;1568;0
367800;Diamond Deeps;Casual, Indie, Strategy;0 - 20,000;10;5;5;0;0;0
367820;Decromancer;Action, Casual, Indie;0 - 20,000;11;3;8;0;0;0
367990;3D Paraglider;Strategy;0 - 20,000;10;24;-14;0;0;0
367990;3D Paraglider;Simulation, Strategy;0 - 20,000;10;24;-14;0;0;0
368000;100ft Robot Golf;Casual, Free to Play, Indie, Strategy;20,000 - 50,000;119;47;72;4;4;0
368040;ExoCorps;Adventure, Casual;0 - 20,000;38;3;35;0;0;0
368050;Almightree: The Last Dreamer;Action, Adventure, RPG;50,000 - 100,000;116;33;83;221;221;9
368070;Sniper Ghost Warrior 3;Indie, Simulation, Early Access;1,000,000 - 2,000,000;10700;5593;5107;992;537;368
368080;Aurion: Legacy of the Kori-Odan;Action, Adventure, Indie, RPG, Simulation, Strategy, Early Access;20,000 - 50,000;215;98;117;81;120;2
368140;Tobari and the Night of the Curious Moon;Action, Indie;0 - 20,000;62;16;46;0;0;0
368150;Rising Angels: Hope;Action, Adventure, Casual, Indie;0 - 20,000;19;4;15;0;0;1
368160;WORLD END ECONOMiCA episode.02;Indie, Racing;20,000 - 50,000;221;11;210;399;409;1
368180;Polyball;Casual;200,000 - 500,000;767;349;418;63;9;2
368220;Close Combat - Panthers in the Fog;Adventure, Indie;20,000 - 50,000;117;51;66;0;0;13
368230;Kingdom: Classic;Action, Adventure, Indie, RPG;2,000,000 - 5,000,000;18014;1879;16135;225;184;82
368250;Valiant: Resurrection;Adventure;20,000 - 50,000;40;15;25;228;228;0
368260;Marvel's Midnight Suns;Action, Adventure, Indie;200,000 - 500,000;6948;1961;4987;1500;1842;4524
368290;Visibility;Action, Casual, Indie;20,000 - 50,000;50;33;17;15;15;0
368310;Marble Muse;Action, Adventure, Indie, RPG;0 - 20,000;9;2;7;0;0;0
368340;CrossCode;Indie, Strategy;500,000 - 1,000,000;12804;816;11988;2332;2314;182
368360;60 Seconds!;Action, Indie, RPG, Strategy;500,000 - 1,000,000;9259;1749;7510;315;187;43
368370;Her Story;Indie, RPG, Strategy;1,000,000 - 2,000,000;7443;861;6582;258;207;12
368390;The Darkside Detective;Casual, Indie, Strategy;200,000 - 500,000;3358;175;3183;262;263;11
368430;Through the Woods;Casual, Indie, Simulation, Strategy, Early Access;100,000 - 200,000;965;381;584;142;187;0
368450;Rememoried;Adventure, Indie, Strategy;20,000 - 50,000;126;93;33;91;91;0
368470;GeoVox;Casual, Indie, Strategy;0 - 20,000;26;25;1;0;0;0
368500;Assassin's Creed Syndicate;Sports;1,000,000 - 2,000,000;18916;4625;14291;1533;1092;288
368570;Beat Da Beat;Adventure, Indie, RPG, Strategy;20,000 - 50,000;423;33;390;973;973;1
368590;Albert and Otto;Action, Adventure, Indie;200,000 - 500,000;412;218;194;360;327;0
368600;Terra Nova: Strike Force Centauri;Casual, Indie;0 - 20,000;66;3;63;0;0;0
368610;The Enchanted Cave 2;Casual, Indie;20,000 - 50,000;581;69;512;0;0;10
368620;Timespinner;Indie, Strategy;100,000 - 200,000;1980;312;1668;827;1314;9
368640;htoL#NiQ: The Firefly Diary;Casual, Indie;20,000 - 50,000;392;152;240;14;14;5
368650;Dark Echo;Action, Casual, Indie;20,000 - 50,000;709;61;648;127;177;1
368670;Professor Teaches Windows 8.1;Casual, Indie;0 - 20,000;3;2;1;0;0;0
368680;Super Mutant Alien Assault;Action, Adventure, Indie, Simulation;20,000 - 50,000;128;19;109;172;172;1
368690;Chronoclysm;Action, Adventure, Indie;0 - 20,000;6;8;-2;0;0;0
368700;Mysterious Space;Sports;0 - 20,000;20;5;15;271;271;0
368710;Power of Love;Action, Adventure;20,000 - 50,000;78;37;41;248;238;18
368720;Sirius;Adventure, Casual, Indie;100,000 - 200,000;100;102;-2;155;209;0
368730;No Time To Explain Remastered;Adventure, Indie, RPG;200,000 - 500,000;1889;502;1387;164;91;5
368740;Obliteracers;Action, Adventure, Casual, Indie;20,000 - 50,000;169;62;107;0;0;0
368760;Playing History: Vikings;Adventure, Indie;20,000 - 50,000;19;23;-4;0;0;0
368770;President for a Day - Floodings;Simulation, Early Access;20,000 - 50,000;27;24;3;0;0;0
368780;President for a Day - Corruption;Indie, Simulation;0 - 20,000;25;33;-8;0;0;0
368800;Apocalypse: Party's Over;Action, Adventure, Indie, RPG, Early Access;20,000 - 50,000;140;22;118;14;14;1
368830;Adventure in the Tower of Flight;Adventure, Indie;0 - 20,000;75;16;59;275;333;0
368860;Garbage Day;Action;20,000 - 50,000;359;713;-354;36;65;0
368880;Mystery Maze Of Balthasar Castle;Action, Indie;0 - 20,000;7;9;-2;258;258;0
368890;AR-K: The Great Escape;Action, Indie;0 - 20,000;101;11;90;0;0;0
368950;Jigoku Kisetsukan: Sense of the Seasons;Action, Adventure, Casual, Indie, Racing, RPG, Simulation, Sports, Strategy;100,000 - 200,000;1629;117;1512;76;80;1
368970;Haywire on Fuel Station Zeta;Simulation, Strategy;20,000 - 50,000;17;8;9;227;256;0
368980;Force of Elements;Action, Adventure, Casual, Indie;20,000 - 50,000;52;48;4;0;0;0
368990;Despair;Casual, Simulation;500,000 - 1,000,000;643;1235;-592;5213;231;2
369000;Pongo;Casual, Indie;100,000 - 200,000;364;156;208;141;160;1
369030;Vinyl;Action, Casual, Indie;50,000 - 100,000;165;118;47;0;0;1
369040;Yargis - Space Melee;Casual, Racing, Sports;50,000 - 100,000;111;80;31;296;318;3
369060;Amygdala;Adventure, Casual, Indie, RPG;0 - 20,000;11;24;-13;211;211;0
369070;Slain: Back from Hell;Adventure, Casual, Indie, RPG;200,000 - 500,000;1491;582;909;93;108;7
369080;Age of Survival;Adventure, Casual, Indie, RPG;0 - 20,000;25;208;-183;311;329;0
369100;Predator Simulator;Adventure, Casual, Indie, RPG;20,000 - 50,000;34;51;-17;0;0;0
369110;The Swindle;Adventure, Casual, Indie, RPG;50,000 - 100,000;367;212;155;2522;383;3
369120;Invisible Apartment Zero;Adventure, Casual, Indie, RPG;0 - 20,000;10;7;3;0;0;0
369180;SoulCraft;Strategy;20,000 - 50,000;62;66;-4;0;0;1
369180;SoulCraft;Indie, RPG, Strategy, Early Access;20,000 - 50,000;62;66;-4;0;0;1
369190;Shoot 'Em Up Kit;Action, Free to Play, Indie, Early Access;0 - 20,000;21;13;8;0;0;0
369230;Kung Fu Panda Showdown of Legendary Legends;Adventure, Casual, Indie, RPG;0 - 20,000;57;33;24;0;0;0
369270;Megatect;Action, Sports;0 - 20,000;26;6;20;0;0;0
369280;Hidden Mysteries: Titanic;Sports;0 - 20,000;28;10;18;0;0;1
369280;Hidden Mysteries: Titanic;Indie, Strategy;0 - 20,000;28;10;18;0;0;1
369290;Airport Madness: World Edition;Adventure, Indie;20,000 - 50,000;249;72;177;85;136;9
369310;Monstro: Battle Tactics;Action, Indie;0 - 20,000;24;2;22;212;298;0
369360;Car Washer: Summer of the Ninja;Action, Indie;0 - 20,000;14;30;-16;883;883;0
369370;Crossfire: Dungeons;Action, Casual, Indie;20,000 - 50,000;37;41;-4;0;0;0
369390;Scourge of War: Waterloo;Casual, Indie;20,000 - 50,000;180;47;133;1380;1380;2
369400;Let the Cat in;Indie, Strategy;200,000 - 500,000;787;234;553;18;25;0
369440;Immortal: Unchained;Action, Adventure, Indie, RPG, Simulation, Strategy;50,000 - 100,000;521;241;280;244;328;0
369460;Professor Why: The Quantum Eye;Adventure, Indie;0 - 20,000;8;8;0;0;0;0
369530;Void Destroyer 2;Action, Adventure, Indie, RPG, Strategy;20,000 - 50,000;474;93;381;940;940;8
369550;Blacksea Odyssey;Action;20,000 - 50,000;163;37;126;0;0;1
369560;The Story Goes On;Simulation, Strategy;0 - 20,000;102;20;82;269;269;0
369570;Spectra;Indie, RPG, Simulation, Strategy;0 - 20,000;32;12;20;0;0;0
369580;NotTheNameWeWanted;Action, Adventure, Indie;100,000 - 200,000;2311;342;1969;101;145;0
369640;Treeker: The Lost Glasses Remake;Adventure, Indie, RPG;0 - 20,000;38;26;12;42;42;0
369700;Tanzia;Indie;0 - 20,000;56;5;51;0;0;0
369830;Toonstruck;Adventure, Indie;20,000 - 50,000;190;7;183;0;0;2
369840;Holobunnies: The Bittersweet Adventure;Free to Play, Massively Multiplayer, RPG;0 - 20,000;0;0;0;0;0;0
369860;Brain Guzzler: The End Is Nigh;Adventure, Indie, RPG;0 - 20,000;7;4;3;0;0;0
369890;Riddled Corpses;Casual, Indie;20,000 - 50,000;148;74;74;125;154;0
369990;Gremlins, Inc.;Indie, RPG, Strategy;500,000 - 1,000,000;6242;1152;5090;686;324;339
370020;Templar Battleforce;RPG;100,000 - 200,000;826;54;772;1098;1098;6
370040;Lilly and Sasha: Nexus of Souls;Action, Indie, Early Access;20,000 - 50,000;40;22;18;125;125;0
370050;Scarab Tales;Action, Indie;20,000 - 50,000;40;4;36;214;266;0
370060;Coffee Shop Tycoon;Action, Indie, Simulation;0 - 20,000;448;73;375;0;0;7
370070;Wyrmsun;Action, Indie;100,000 - 200,000;198;51;147;24;43;3
370080;Breezeblox;Indie, Racing, Simulation, Sports;20,000 - 50,000;76;10;66;0;0;0
370090;Axis Football 2015;Action, Indie, RPG, Strategy;100,000 - 200,000;263;116;147;308;365;0
370120;Pirate Code;Casual, Indie;0 - 20,000;15;3;12;121;121;0
370130;Lion Quest;Casual, Strategy;0 - 20,000;27;26;1;182;182;0
370140;Nebulous;Action, Casual, Indie;0 - 20,000;5;3;2;0;0;0
370150;LOOP: A Tranquil Puzzle Game;Action, Indie;0 - 20,000;121;4;117;0;0;1
370150;LOOP: A Tranquil Puzzle Game;Indie, Simulation, Strategy;0 - 20,000;121;4;117;0;0;1
370160;Front Wars;Action, Indie, RPG;0 - 20,000;31;27;4;12;12;0
370170;Dale Hardshovel HD;Action, Adventure, Indie;20,000 - 50,000;19;17;2;225;256;0
370190;Ruzh Delta Z;Action, Adventure, Casual, Indie, RPG;50,000 - 100,000;313;195;118;0;0;0
370200;Two Steps Back;Action, Indie, Strategy;0 - 20,000;8;13;-5;0;0;0
370210;FIRMA;Action, Adventure, Indie;0 - 20,000;13;2;11;0;0;0
370220;Animal Gods;Action, Adventure;0 - 20,000;18;28;-10;0;0;0
370240;NBA 2K16;Adventure, Indie, Strategy;500,000 - 1,000,000;3798;3568;230;7135;6369;42
370270;Jim Power -The Lost Dimension;Action, Casual, Indie, RPG;0 - 20,000;40;22;18;155;155;0
370300;8-Bit Adventures 1: The Forgotten Journey Remastered Edition;Action, Casual, Indie, Racing;20,000 - 50,000;101;20;81;0;0;1
370310;Tompi Jones;Casual, Indie, Simulation, Strategy;20,000 - 50,000;36;72;-36;0;0;0
370330;Welcome To The Untitled Game;Adventure, Indie, Strategy;0 - 20,000;0;0;0;0;0;0
370350;LOTUS-Simulator;Casual, Simulation, Sports, Strategy;0 - 20,000;309;295;14;62;62;1
370360;TIS-100;Action, Casual, Indie;200,000 - 500,000;3442;113;3329;295;258;16
370390;Path to the Sky;Action, Indie;0 - 20,000;43;15;28;0;0;0
370440;No70: Eye of Basir;Adventure, Indie;20,000 - 50,000;199;145;54;235;235;1
370460;Arcana Heart 3 LOVE MAX!!!!!;Action, Adventure, Indie, RPG;50,000 - 100,000;362;78;284;308;465;1
370480;Pixel Galaxy;Free to Play, Massively Multiplayer, RPG;20,000 - 50,000;153;22;131;360;360;1
370490;ASCII Attack;Action, Indie;0 - 20,000;31;8;23;0;0;0
370510;Marble Mayhem: Fragile Ball;Utilities;200,000 - 500,000;711;346;365;212;215;0
370540;Gary Grigsby's War in the East;Indie, RPG, Strategy;20,000 - 50,000;493;53;440;100;100;36
370550;Sparkle 2;Action, Adventure, Indie;20,000 - 50,000;171;18;153;235;352;3
370560;Geek Resort;Simulation, Strategy;0 - 20,000;7;6;1;0;0;0
370570;Color Assembler;Free to Play;0 - 20,000;26;8;18;0;0;0
370590;Gem Wars: Attack of the Jiblets;Action, Casual, Indie;20,000 - 50,000;42;28;14;136;136;0
370600;Hello Kitty and Sanrio Friends Racing;Action, Adventure, Indie;0 - 20,000;67;35;32;0;0;1
370620;Onyx;Adventure, Casual, Indie;50,000 - 100,000;18;10;8;263;263;0
370640;Midnight's Blessing;Action, Adventure, Indie, RPG, Early Access;50,000 - 100,000;25;20;5;218;222;0
370660;Opaline;Action, Adventure, Indie;20,000 - 50,000;40;15;25;165;165;1
370670;The Tale of a Common Man;RPG;20,000 - 50,000;120;6;114;0;0;2
370690;Elendia Ceus;Action, Indie, Early Access;50,000 - 100,000;16;6;10;0;0;26
370700;Black Home;Audio Production, Software Training, Utilities, Video Production;100,000 - 200,000;50;20;30;151;157;1
370710;Last Heroes;Casual, Indie, Strategy;50,000 - 100,000;64;29;35;295;295;0
370730;NOBUNAGA'S AMBITION: Tenshouki with Power Up Kit HD Version;RPG, Simulation;50,000 - 100,000;28;23;5;0;0;89
370750;Dungeoncraft;Action, Adventure, Indie, Racing, Sports, Strategy;0 - 20,000;2;2;0;0;0;0
370770;Holodrive;Action, Free to Play;200,000 - 500,000;982;260;722;167;124;0
370780;Fated Souls;Adventure;50,000 - 100,000;35;25;10;206;213;0
370800;Fields of Battle;Adventure;20,000 - 50,000;131;60;71;103;199;1
370840;Rugby Challenge 3;Animation & Modeling, Design & Illustration, Video Production;0 - 20,000;74;41;33;0;0;0
370870;Dark Future: Blood Red States;RPG;20,000 - 50,000;261;150;111;275;348;2
370910;Kathy Rain;Casual, Indie;5,000,000 - 10,000,000;3277;266;3011;1401;266;5
370920;Cosmophony;Indie;20,000 - 50,000;86;15;71;0;0;0
370940;Demons with Shotguns;Action, Adventure, Indie, Early Access;20,000 - 50,000;54;4;50;0;0;0
370970;Unlimited Escape 3 & 4 Double Pack;Action, Adventure, Indie, Simulation, Early Access;0 - 20,000;1;3;-2;0;0;0
371000;Cave Coaster;Action, Indie, RPG;20,000 - 50,000;36;27;9;0;0;0
371100;Waste Walkers;Adventure, Indie;20,000 - 50,000;157;37;120;190;190;0
371120;Discouraged Workers;Adventure, Free to Play, Indie, Massively Multiplayer, RPG, Early Access;0 - 20,000;61;38;23;0;0;1
371140;Aegis Defenders;Action, Free to Play, Indie, Early Access;200,000 - 500,000;1209;319;890;56;26;11
371180;Super 3-D Noah's Ark;Action, Adventure, Indie;50,000 - 100,000;702;90;612;89;167;1
371190;Making History: The Calm and the Storm Gold Edition;Adventure, Casual;50,000 - 100,000;140;23;117;0;0;15
371200;Halcyon 6: Starbase Commander;Adventure, Casual;100,000 - 200,000;1095;209;886;354;364;2
371220;VERLIES II;Adventure, Casual;0 - 20,000;65;52;13;0;0;38
371300;Knee Deep;Indie, Simulation;0 - 20,000;131;36;95;189;189;0
371310;Karos Returns;Action, Casual, Indie;100,000 - 200,000;361;136;225;47;46;0
371320;Samsa and the Knights of Light;Action, Early Access;20,000 - 50,000;33;8;25;0;0;0
371330;Two Digits;Education;200,000 - 500,000;272;108;164;281;289;1
371360;Orc Assault;Education;20,000 - 50,000;6;15;-9;0;0;0
371370;Advent;Action, Adventure, Casual, Indie, Early Access;0 - 20,000;17;12;5;0;0;0
371380;Dr. Spacezoo;Adventure, Casual, Indie;0 - 20,000;10;0;10;0;0;0
371390;Flix The Flea;Action;50,000 - 100,000;78;123;-45;279;282;0
371400;Downpour;Adventure;0 - 20,000;8;6;2;0;0;0
371410;Hostile Dimension;Action, Indie, RPG;0 - 20,000;12;13;-1;0;0;0
371420;Teddy Floppy Ear - The Race;Adventure, Free to Play;200,000 - 500,000;788;228;560;312;353;2
371430;Space Grunts;Action, Adventure, Indie;50,000 - 100,000;58;14;44;0;0;0
371450;Awe;Adventure, RPG, Strategy;20,000 - 50,000;190;60;130;214;214;0
371460;Gnumz: Masters of Defense;Adventure, Indie, RPG, Strategy;200,000 - 500,000;119;46;73;270;302;0
371500;Grey Cubes;RPG;50,000 - 100,000;410;54;356;0;0;0
371510;Gunnheim;Action, Casual;100,000 - 200,000;130;190;-60;145;249;1
371520;Bounty Train;Action, Indie, RPG, Early Access;200,000 - 500,000;1031;448;583;137;201;16
371530;Legends of Pixelia;Action, Indie;0 - 20,000;25;1;24;0;0;0
371550;A Bastard's Tale;Action, Indie;20,000 - 50,000;273;60;213;249;251;0
371570;Tap Heroes;Action, Indie;100,000 - 200,000;938;326;612;655;294;2
371620;SBX: Invasion;Action, Indie;20,000 - 50,000;4;6;-2;0;0;0
371650;COLINA: Legacy;Action, Indie;100,000 - 200,000;148;34;114;0;0;0
371660;Far Cry Primal;Casual, Indie;1,000,000 - 2,000,000;21902;4014;17888;997;562;325
371670;Rolling Sun;Adventure, Indie;100,000 - 200,000;390;421;-31;160;202;1
371700;Hypership Out of Control 2;Action, Casual, Indie;0 - 20,000;3;0;3;0;0;0
371710;Age of Castles: Warlords;Free to Play, Indie, Massively Multiplayer, RPG;0 - 20,000;20;42;-22;0;0;0
371790;Ramayana;Indie, Strategy;0 - 20,000;7;6;1;0;0;0
371850;Football Mogul 2014;Action, Indie, RPG, Simulation, Early Access;0 - 20,000;29;15;14;0;0;0
371880;Collider;Indie, RPG;20,000 - 50,000;46;18;28;2;2;0
371890;Gunslugs;Casual, Simulation, Sports;20,000 - 50,000;85;28;57;129;129;0
371900;Pillar;Casual, Simulation, Sports;20,000 - 50,000;34;16;18;281;346;0
371970;Barony;Casual, Simulation, Sports;200,000 - 500,000;4062;353;3709;601;323;425
372000;Tree of Savior (English Ver.);Adventure, Casual;2,000,000 - 5,000,000;12753;7043;5710;2796;248;381
372030;Starship Rubicon;Adventure, Casual;0 - 20,000;37;6;31;0;0;1
372060;DigiFish Aqua Real 2;Action, Indie;0 - 20,000;35;17;18;0;0;0
372080;Ananias Roguelike;Action, Adventure;0 - 20,000;40;10;30;0;0;0
372150;Yasai Ninja;Strategy;0 - 20,000;17;35;-18;303;303;0
372150;Yasai Ninja;Casual, Indie;0 - 20,000;17;35;-18;303;303;0
372160;Soviet Monsters: Ekranoplans;Adventure, Indie;0 - 20,000;13;20;-7;0;0;0
372190;Astro Lords: Oort Cloud;Adventure;20,000 - 50,000;28;28;0;0;0;0
372210;Spooky Cats;Adventure, Casual, Indie;20,000 - 50,000;350;66;284;160;215;0
372250;Turnover;Action, Adventure, RPG;0 - 20,000;29;7;22;73;73;0
372320;LOST ORBIT: Terminal Velocity;Action, Casual, Indie, Strategy;0 - 20,000;24;3;21;0;0;0
372330;Beauty Bounce;Action, Adventure, Indie;0 - 20,000;72;34;38;104;104;0
372340;SnarfQuest Tales;Simulation;0 - 20,000;5;7;-2;0;0;1
372350;Tumbleweed Express;Indie, Simulation, Early Access;0 - 20,000;100;13;87;0;0;0
372360;Tales of Symphonia;Indie, Simulation, Strategy;500,000 - 1,000,000;3685;612;3073;83;69;106
372380;Warriors & Castles;Action, Casual, Indie, Early Access;20,000 - 50,000;48;20;28;69;69;0
372390;D3DGear - Game Recording and Streaming Software;Action, Adventure, Indie, RPG;0 - 20,000;364;98;266;0;0;5
372430;World Defense : A Fragmented Reality Game;Action, Early Access;0 - 20,000;5;11;-6;0;0;0
372480;Spaceforce Rogue Universe HD;Action;0 - 20,000;29;19;10;0;0;0
372490;GROOVY;Simulation, Strategy;50,000 - 100,000;73;49;24;196;200;0
372540;The Lost Mythologies;Utilities;200,000 - 500,000;1107;563;544;49;59;0
372560;Tanita: A Plasticine Dream;Casual, Indie, Strategy;0 - 20,000;7;1;6;0;0;1
372570;A Stroke of Fate: Operation Bunker;Action, Adventure, Indie;0 - 20,000;6;9;-3;0;0;0
372590;Grand Designer;Strategy;0 - 20,000;56;6;50;0;0;1
372670;Eternal Realm;Action, Casual, Indie, Sports;0 - 20,000;9;18;-9;0;0;0
372690;Chiptune Champion;Adventure, Indie;20,000 - 50,000;170;34;136;54;54;0
372720;The Language Game;RPG, Strategy;0 - 20,000;14;10;4;0;0;0
372740;Second Warfare;Adventure, Indie, Simulation;0 - 20,000;24;73;-49;170;170;1
372740;Second Warfare;Action, Indie;0 - 20,000;24;73;-49;170;170;1
372750;Girl Amazon Survival;Indie, Simulation, Strategy;50,000 - 100,000;100;133;-33;409;459;0
372770;Floors of Discomfort;Action, Free to Play, Indie, Early Access;0 - 20,000;5;2;3;0;0;0
372780;Pulse;Action, Casual, Indie;0 - 20,000;37;33;4;0;0;0
372800;RPG MO;Animation & Modeling, Utilities;500,000 - 1,000,000;2143;571;1572;196;12;95
372820;Shot In The Dark;Indie, Strategy;20,000 - 50,000;78;88;-10;188;221;0
372830;Fitz the Fox;Adventure;20,000 - 50,000;99;23;76;214;214;0
372890;Red Crow Mysteries: Legion;Strategy;20,000 - 50,000;11;27;-16;0;0;0
372930;New York Mysteries: Secrets of the Mafia;Adventure, Indie;20,000 - 50,000;262;21;241;0;0;7
372940;Lost Lands: The Four Horsemen;Strategy;20,000 - 50,000;243;16;227;156;156;0
372950;Professor Why Chemistry 1;Casual, Indie, Simulation, Sports;0 - 20,000;11;2;9;0;0;0
372960;Robbery Bob: Man of Steal;Action;0 - 20,000;89;2;87;0;0;0
372970;Cash_Out;Action, Indie, RPG;0 - 20,000;34;8;26;0;0;0
372980;MasterCook 15;Casual, Indie;0 - 20,000;0;1;-1;0;0;0
373000;Family Tree Heritage Platinum 9;Adventure, Casual, Indie;0 - 20,000;1;2;-1;0;0;0
373120;Bernie Needs Love;Action, Indie;0 - 20,000;11;13;-2;0;0;0
373140;Grail to the Thief;Action, Casual, Indie, Simulation;0 - 20,000;21;15;6;0;0;0
373180;Kung Fury: Street Rage;Action, Adventure, Indie;200,000 - 500,000;2189;239;1950;46;28;0
373240;Black Sails - The Ghost Ship;Action, Adventure, Indie;50,000 - 100,000;175;80;95;249;249;0
373290;Stones of Sorrow;Indie, RPG;50,000 - 100,000;53;44;9;348;372;0
373330;All Is Dust;Action, Casual, Indie;200,000 - 500,000;579;726;-147;22;30;0
373360;Cast of the Seven Godsends - Redux;Indie, Simulation;20,000 - 50,000;94;63;31;8;8;0
373390;Contradiction: Spot The Liar;Action, Adventure, Casual, Indie;200,000 - 500,000;2655;126;2529;1410;2474;4
373420;Divinity: Original Sin - Enhanced Edition;Sexual Content, Nudity, Casual, Indie;1,000,000 - 2,000,000;20892;2256;18636;1961;783;838
373440;Stargazer;Indie, Simulation;50,000 - 100,000;76;31;45;254;264;2
373460;Fury Of The Gods;Casual, Free to Play;0 - 20,000;10;7;3;0;0;0
373470;A Wizard's Lizard: Soul Thief;Violent, Action, Adventure, Free to Play, Massively Multiplayer;0 - 20,000;40;13;27;0;0;0
373480;1993 Space Machine;Casual, Indie, RPG, Simulation, Strategy;20,000 - 50,000;199;93;106;219;304;3
373600;Weapon of Choice;Action, Indie;20,000 - 50,000;57;9;48;0;0;0
373610;Shoot 1UP;Action, Casual, Indie, Strategy;20,000 - 50,000;103;23;80;0;0;0
373620;Explosionade;Adventure, Indie;20,000 - 50,000;53;17;36;0;0;0
373630;Game Type;Action, Indie;20,000 - 50,000;33;10;23;0;0;1
373640;Splotches;Casual, Indie, Strategy;0 - 20,000;7;8;-1;0;0;0
373650;The Assembly;Indie;0 - 20,000;105;45;60;852;852;0
373670;Arkhelom 3D;Adventure, Indie, RPG;0 - 20,000;18;24;-6;0;0;0
373720;Ryzom;Adventure, RPG;200,000 - 500,000;304;131;173;20;34;4
373730;Way of Gold and Steel;Strategy;20,000 - 50,000;71;42;29;1;1;0
373750;DinoSystem;Adventure, Casual, Indie, RPG, Simulation, Strategy;20,000 - 50,000;226;30;196;0;0;0
373770;LiEat;Action, Adventure, Indie, RPG, Early Access;200,000 - 500,000;3928;164;3764;102;61;7
373800;Fantastic Pinball Thrills;RPG;0 - 20,000;12;24;-12;0;0;0
373820;Soccer Pinball Thrills;Adventure, Indie, RPG, Early Access;0 - 20,000;6;13;-7;0;0;0
373860;Apothecarium: The Renaissance of Evil - Premium Edition;Action, Adventure, Indie;20,000 - 50,000;43;44;-1;0;0;1
373870;Sister’s Secrecy: Arcanum Bloodlines - Premium Edition;Indie, Simulation, Sports, Strategy;20,000 - 50,000;34;22;12;2;2;1
373870;Sister’s Secrecy: Arcanum Bloodlines - Premium Edition;Action, Casual, Indie, RPG, Early Access;20,000 - 50,000;34;22;12;2;2;1
373880;Fleeting Ages;Action, Adventure, RPG;;;;0;;;
373920;Eisenhorn: XENOS;Adventure, Casual, Indie, RPG, Simulation, Strategy;0 - 20,000;153;138;15;321;321;0
373920;Eisenhorn: XENOS;Action, Indie;0 - 20,000;153;138;15;321;321;0
373930;Sudden Strike 4;Action, Adventure, Indie, Strategy;200,000 - 500,000;5302;1591;3711;531;230;231
373970;Letter Quest: Grimm's Journey Remastered;Action, Adventure, Indie;20,000 - 50,000;429;36;393;302;341;3
374010;Sherlock Holmes Consulting Detective: The Case of the Mummy's Curse;Adventure, Indie;20,000 - 50,000;40;20;20;534;534;0
374030;Virginia;Action, Casual, Free to Play, Indie, Strategy;100,000 - 200,000;2026;1094;932;3306;4813;4
374040;Portal Knights;Indie, Simulation, Strategy;1,000,000 - 2,000,000;16910;3430;13480;1016;582;190
374050;Infinium Strike;Adventure;0 - 20,000;39;30;9;0;0;0
374060;Stairs;Action, Casual, Indie;20,000 - 50,000;234;95;139;38;38;0
374080;Falcon;Action, Adventure, Indie, RPG;0 - 20,000;11;4;7;2;2;0
374120;Fork Truck Challenge;Casual, Indie;0 - 20,000;4;8;-4;10;10;0
374170;Sniper Tactical;Audio Production, Utilities;0 - 20,000;16;15;1;0;0;0
374190;Infernax;Action, Casual, Indie, Strategy;50,000 - 100,000;1187;85;1102;504;504;15
374240;Eternal Step;Indie, Early Access;20,000 - 50,000;39;21;18;221;221;1
374280;Hired Ops;Massively Multiplayer, Racing;500,000 - 1,000,000;8759;4432;4327;342;68;356
374320;DARK SOULS III;Simulation, Strategy;5,000,000 - 10,000,000;324886;20524;304362;5162;2280;5513
374380;Revolution Under Siege Gold;Action, Adventure, Casual, Indie, Strategy;20,000 - 50,000;101;33;68;1030;1030;2
374400;VoiceBot;Casual, Free to Play, Indie, Simulation;20,000 - 50,000;158;84;74;17;17;0
374410;TransPlan;Adventure, Indie;0 - 20,000;247;19;228;25;25;0
374420;Questria: Rise of the Robot Skullfaces;Action, Adventure, Casual, Indie, Massively Multiplayer, Racing, RPG, Simulation, Sports, Strategy;0 - 20,000;3;0;3;0;0;0
374450;Cheats 4 Hire;Action, Indie;0 - 20,000;17;5;12;0;0;0
374460;Impossiball;Free to Play, Indie, Massively Multiplayer, Strategy;0 - 20,000;49;8;41;200;212;0
374510;The Last Dogma - Wilder Wein Edition;Simulation, Strategy, Early Access;0 - 20,000;14;19;-5;372;372;0
374520;Champions of Anteria;Action, Adventure, Indie;0 - 20,000;76;80;-4;699;699;0
374620;S.O.R.S;Action, Adventure, Indie, Massively Multiplayer, Simulation, Early Access;0 - 20,000;7;4;3;0;0;0
374630;Mactabilis;Adventure, Indie;0 - 20,000;6;0;6;0;0;0
374640;March of Industry: Very Capitalist Factory Simulator Entertainments;Indie, Strategy;0 - 20,000;24;52;-28;0;0;0
374670;Ember Strike;Action;100,000 - 200,000;815;211;604;15;23;0
374680;Tiki Galore;Indie, Massively Multiplayer, RPG;0 - 20,000;8;4;4;0;0;0
374690;RigIT;Action, Casual;0 - 20,000;1;9;-8;0;0;0
374830;Defend The Highlands;Adventure, Indie, RPG, Strategy;200,000 - 500,000;271;73;198;248;282;1
374900;Agatha Christie - The ABC Murders;Strategy;200,000 - 500,000;1942;437;1505;408;318;15
374940;Tank Battle: Normandy;Adventure, Indie, RPG;0 - 20,000;13;3;10;0;0;0
374950;ADventure Lib;Adventure, Casual, Indie;0 - 20,000;43;59;-16;0;0;0
374960;Civil War: Bull Run 1861;Adventure, Indie;0 - 20,000;13;8;5;0;0;0
374970;Golf Masters;Adventure, Casual, Indie;0 - 20,000;0;6;-6;0;0;0
374990;Orc Slayer;Free to Play, Massively Multiplayer, RPG;0 - 20,000;9;11;-2;0;0;0
375000;Icarus-X: Tides of Fire;Casual, Strategy;0 - 20,000;10;6;4;0;0;0
375010;Energy Balance;Action, Indie;200,000 - 500,000;195;88;107;290;291;23
375020;Al Emmo's Postcards from Anozira;Action;0 - 20,000;20;16;4;0;0;0
375030;Korwin The Game;Casual;0 - 20,000;179;48;131;141;143;0
375040;Death Tractor;Casual;0 - 20,000;51;24;27;148;148;0
375090;The Eigengrau Menagerie;Adventure;0 - 20,000;12;4;8;0;0;0
375120;Super Star Path;Adventure;50,000 - 100,000;269;62;207;0;0;0
375130;Tin Star;Adventure;0 - 20,000;274;14;260;0;0;1
375170;Gunpowder;Action, Indie, Simulation, Early Access;20,000 - 50,000;31;7;24;0;0;0
375180;Lunch Truck Tycoon;Action, Casual, Indie;0 - 20,000;169;91;78;0;0;0
375190;VROOM: Aerie;Software Training;0 - 20,000;17;4;13;0;0;0
375200;Sakura Fantasy;Education;100,000 - 200,000;938;130;808;186;291;0
375210;Unveil;Education;0 - 20,000;49;10;39;0;0;0
375220;Bitweb;Education;50,000 - 100,000;50;83;-33;1;1;0
375230;Warhammer 40,000: Eternal Crusade;Software Training;500,000 - 1,000,000;6285;6346;-61;310;59;0
375250;Pizza Express;Action, Indie, Simulation, Sports, Early Access;20,000 - 50,000;189;40;149;226;415;0
375290;Superstatic;Adventure;0 - 20,000;21;13;8;272;272;0
375310;Mighty Switch Force! Hose It Down!;Adventure, Indie;0 - 20,000;56;6;50;0;0;0
375320;Colortone;Adventure, Indie;50,000 - 100,000;176;74;102;257;287;1
375330;Butsbal;Adventure, Casual;20,000 - 50,000;34;35;-1;0;0;0
375330;Butsbal;Action, Adventure, Indie, Massively Multiplayer, Simulation, Early Access;20,000 - 50,000;34;35;-1;0;0;0
375420;The Architect;Free to Play, Indie, Strategy;0 - 20,000;21;11;10;145;145;0
375430;The Logomancer;RPG;0 - 20,000;6;5;1;0;0;0
375440;Hero-U: Rogue to Redemption;Indie, RPG;20,000 - 50,000;450;34;416;0;0;1
375450;NOBUNAGA'S AMBITION: Sphere of Influence - Ascension;Action, Adventure, Indie;1,000,000 - 2,000,000;627;292;335;912;912;426
375460;16bit Trader;Action, Adventure, Indie;200,000 - 500,000;709;980;-271;280;317;2
375480;Chronicon;Action, Free to Play, Indie;500,000 - 1,000,000;7697;379;7318;1297;1248;281
375500;The Deep Paths: Labyrinth Of Andokost;Indie, Strategy;20,000 - 50,000;70;51;19;25;25;0
375510;New kind of adventure;Action, Indie;500,000 - 1,000,000;613;880;-267;235;231;1
375520;Taimumari: Definitive Edition;Action, Indie, Simulation, Strategy;50,000 - 100,000;222;57;165;298;283;0
375530;Football, Tactics & Glory;Action, Indie;0 - 20,000;3143;388;2755;1874;1876;96
375550;DungeonRift;Action, Adventure, Indie, Simulation, Strategy, Early Access;0 - 20,000;32;4;28;0;0;0
375570;Goblin Quest: Escape!;Sexual Content, Violent, Gore, Adventure, Free to Play, Indie;0 - 20,000;1;0;1;0;0;0
375580;Three Days;;100,000 - 200,000;50;24;26;232;262;30
375600;Air Brawl;;100,000 - 200,000;1116;330;786;63;40;0
375620;CortexGear: AngryDroids;Action, Indie;50,000 - 100,000;23;90;-67;292;267;0
375680;Apartment 666;Casual, Indie, RPG, Simulation;100,000 - 200,000;145;286;-141;246;247;0
375710;The Adventures of Mr. Bobley;Adventure, Casual;50,000 - 100,000;247;133;114;165;196;0
375750;Invisigun Reloaded;Action, Casual, Indie;50,000 - 100,000;437;63;374;27;34;1
375770;Quantum Conscience;Adventure, Indie;0 - 20,000;37;16;21;244;244;0
375790;Build 'n Bump;Adventure, Indie;20,000 - 50,000;19;11;8;210;210;0
375790;Build 'n Bump;Casual, Indie, Strategy;20,000 - 50,000;19;11;8;210;210;0
375810;The Forgettable Dungeon;Strategy;0 - 20,000;17;5;12;0;0;0
375820;Human Resource Machine;Adventure, Casual, RPG, Simulation, Strategy;500,000 - 1,000,000;3575;232;3343;266;187;16
375840;Rytmik Ultimate;Casual, Indie, Sports;20,000 - 50,000;324;45;279;376;401;1
375850;Island Defense;Indie;100,000 - 200,000;58;53;5;289;299;0
375870;SLIDE: platformer;Animation & Modeling, Video Production;0 - 20,000;7;0;7;0;0;0
375900;Trackmania Turbo;Action, Indie;100,000 - 200,000;940;483;457;504;792;9
375910;Anno 2205;Casual, Indie;500,000 - 1,000,000;3639;1580;2059;2114;1594;106
375930;Trap Them;Adventure, Casual, Simulation;0 - 20,000;41;9;32;0;0;1
375950;Viridi;Sexual Content, Nudity, Indie, Simulation;500,000 - 1,000,000;7758;675;7083;388;28;31
376110;Black Island;Sexual Content, Nudity, Casual, Indie;0 - 20,000;42;28;14;51;51;0
376120;Assault Corps 2;Adventure, Casual;0 - 20,000;15;28;-13;0;0;0
376130;Illuminascii;Adventure, Casual;0 - 20,000;24;20;4;0;0;0
376140;SAGA;Casual, Indie;50,000 - 100,000;69;58;11;1;1;3
376150;Industry Transporters;RPG;0 - 20,000;12;35;-23;0;0;0
376160;DNO Rasa's Journey;Action;0 - 20,000;3;0;3;0;0;0
376210;The Isle;Action;2,000,000 - 5,000,000;50349;10204;40145;7496;1747;5504
376240;Hadean Lands;Strategy;0 - 20,000;37;1;36;0;0;1
376250;Ground Breakers;Action, Indie, Strategy;20,000 - 50,000;37;15;22;0;0;0
376300;GUILTY GEAR Xrd -SIGN-;Casual, Indie, Simulation, Strategy;200,000 - 500,000;2134;212;1922;1250;287;6
376310;Otherland MMO;Casual, Indie, Strategy;50,000 - 100,000;277;408;-131;7;7;0
376350;OVERGRAVITY;Adventure, Indie;0 - 20,000;2;3;-1;0;0;0
376410;Acaratus;Nudity, Violent, Gore, Action, Casual, Indie;0 - 20,000;29;26;3;0;0;0
376450;Last Days of Old Earth;Indie, RPG;0 - 20,000;34;22;12;0;0;0
376480;Ohr: אור;Action, Indie, Sports;0 - 20,000;17;14;3;329;344;0
376490;The Great Gatsby: Secret Treasure;Action, Adventure, Indie, RPG;0 - 20,000;32;10;22;463;463;0
376520;Kelvin and the Infamous Machine;Action, Casual, Indie;20,000 - 50,000;771;83;688;153;262;6
376520;Kelvin and the Infamous Machine;Adventure, Indie;20,000 - 50,000;771;83;688;153;262;6
376560;Big Fish Legend;Adventure, Simulation, Strategy;0 - 20,000;103;24;79;0;0;0
376560;Big Fish Legend;Violent, Gore, Adventure, Indie;0 - 20,000;103;24;79;0;0;0
376570;WildStar;Action, Indie, Strategy;1,000,000 - 2,000,000;3718;1286;2432;620;79;1
376680;Splendor;Action, Indie;50,000 - 100,000;800;174;626;136;191;80
376730;Monument;Early Access;200,000 - 500,000;619;179;440;211;251;0
376750;World War II GI;Adventure, Free to Play, Indie;0 - 20,000;28;36;-8;12;12;0
376760;Big Thinkers Kindergarten;Action, Racing;20,000 - 50,000;50;10;40;0;0;3
376770;Big Thinkers 1st Grade;Indie, Simulation, Strategy, Early Access;20,000 - 50,000;55;8;47;0;0;2
376780;Sherlock Holmes Consulting Detective: The Case of the Tin Soldier;Action, Adventure, Free to Play, Indie, Massively Multiplayer, RPG, Early Access;20,000 - 50,000;21;13;8;0;0;0
376790;Sherlock Holmes Consulting Detective: The Case of the Mystified Murderess;Casual, Indie, Simulation, Early Access;20,000 - 50,000;25;11;14;0;0;0
376870;Minecraft: Story Mode - A Telltale Games Series;Action, Adventure, Indie;200,000 - 500,000;6146;1945;4201;1942;441;15
376880;ASTROKILL;Strategy;0 - 20,000;48;25;23;2;2;0
376990;Professor Teaches Windows 10;Action;0 - 20,000;4;2;2;0;0;0
377000;AnyTime Organizer Deluxe 15;Action, Massively Multiplayer, Racing, RPG, Simulation, Early Access;0 - 20,000;0;1;-1;0;0;0
377010;Easy Spanish Platinum;Casual, Racing;0 - 20,000;0;1;-1;0;0;0
377030;Easy English Platinum;Action, Adventure, Casual, Indie, RPG, Strategy;0 - 20,000;2;2;0;0;0;0
377040;Professor Teaches Excel 2013 & 365;Action, Casual, Indie, Early Access;0 - 20,000;0;1;-1;0;0;0
377060;On a Roll;Action, RPG;20,000 - 50,000;244;144;100;31;31;0
377070;Noctropolis;Casual, Indie;50,000 - 100,000;50;9;41;2;2;0
377080;Hatoful Boyfriend: Holiday Star;Action, Adventure, Casual, Indie, Simulation;20,000 - 50,000;466;32;434;194;207;2
377100;UnderEarth;Action, Adventure, Indie, Early Access;0 - 20,000;9;4;5;0;0;0
377120;Chronicle Keepers: The Dreaming Garden;Action, Adventure, Indie;20,000 - 50,000;77;53;24;0;0;2
377140;Hide & Hold Out - H2o;Adventure, Indie;20,000 - 50,000;346;293;53;54;54;1
377150;Tactical Genius Online;Adventure;50,000 - 100,000;159;72;87;0;0;0
377160;Fallout 4;Adventure, Indie;5,000,000 - 10,000,000;247887;54191;193696;5809;2068;18496
377190;Pale Echoes;Indie, RPG, Strategy;0 - 20,000;46;9;37;227;227;0
377200;Daemon Detective Gaiden;Action, Indie;0 - 20,000;22;4;18;0;0;0
377250;Subaeria;Action;0 - 20,000;17;3;14;0;0;0
377260;Unearned Bounty;RPG;100,000 - 200,000;215;102;113;206;35;0
377280;Alarameth TD;Simulation, Strategy;0 - 20,000;28;13;15;0;0;0
377290;Biodrone Battle;Adventure, Indie;100,000 - 200,000;142;131;11;206;302;0
377300;Thunder Tier One;Adventure, Indie, RPG;500,000 - 1,000,000;2776;1150;1626;248;256;12
377310;The Tower Of Elements;Action, Casual, Indie, Early Access;200,000 - 500,000;185;140;45;267;268;0
377320;Hexters;Racing;0 - 20,000;21;4;17;0;0;0
377330;Close Your Eyes [Old Version];Action, Adventure, Indie;50,000 - 100,000;667;99;568;14;17;0
377340;ChessBase 13 Academy;Adventure, Indie, RPG, Simulation, Early Access;0 - 20,000;13;1;12;0;0;1
377350;ChessBase 13 Pro;Casual;0 - 20,000;5;3;2;0;0;3
377360;Western Press;Action, Casual, Indie;20,000 - 50,000;156;84;72;151;151;1
377430;Who Is Mike - A Visual Novel;Action, Indie;50,000 - 100,000;395;40;355;34;34;0
377450;Lost Lands: Dark Overlord;Racing;20,000 - 50,000;200;11;189;0;0;2
377460;Chicken Invaders 3;Action, Adventure, RPG;0 - 20,000;256;17;239;0;0;5
377470;ENKI;Casual;20,000 - 50,000;97;64;33;146;174;0
377480;N.E.R.O.: Nothing Ever Remains Obscure;Action, Indie, Simulation, Early Access;0 - 20,000;120;58;62;289;289;1
377500;Prismatica;Action, Adventure, RPG;0 - 20,000;34;5;29;0;0;0
377520;Pike and Shot : Campaigns;Action;20,000 - 50,000;224;73;151;0;0;17
377530;侠客风云传(Tale of Wuxia);Indie, Simulation, Strategy;200,000 - 500,000;4781;1531;3250;2213;2626;180
377550;Unfair Jousting Fair;Casual;0 - 20,000;20;5;15;0;0;0
377570;Space Drifters 2D;Casual, Indie;0 - 20,000;27;12;15;248;248;1
377590;IRFaceRig;Action, Indie;50,000 - 100,000;20;20;0;1;1;0
377600;Tcheco in the Castle of Lucio;Audio Production;100,000 - 200,000;868;94;774;311;320;1
377660;Blockwick 2;Action;20,000 - 50,000;167;3;164;30;30;0
377670;G-senjou no Maou - The Devil on G-String;Indie;20,000 - 50,000;553;42;511;253;253;2
377680;Sakura Beach;Free to Play, Indie, Strategy;50,000 - 100,000;1132;291;841;288;308;10
377690;Starlight Vega;Casual;0 - 20,000;217;14;203;0;0;0
377710;Idol Magical Girl Chiru Chiru Michiru Part 1;Adventure, Casual, Indie, RPG, Simulation;0 - 20,000;153;19;134;209;249;0
377720;Idol Magical Girl Chiru Chiru Michiru Part 2;Action, Adventure, Indie, RPG;0 - 20,000;67;12;55;169;169;0
377760;Fox & Flock;Casual, Indie, Racing;100,000 - 200,000;162;26;136;122;122;0
377840;FINAL FANTASY IX;Action, Adventure, Indie;500,000 - 1,000,000;8541;521;8020;954;767;270
377860;Mushihimesama;Audio Production;50,000 - 100,000;1145;39;1106;650;1157;11
377870;DARIUSBURST Chronicle Saviours;Indie;100,000 - 200,000;572;110;462;74;74;4
377890;Blue Libra;Adventure, Indie, RPG;0 - 20,000;8;3;5;0;0;0
377900;Empire TV Tycoon;Adventure, Casual, Free to Play, Indie;100,000 - 200,000;659;181;478;675;915;5
377940;Slam;Adventure;0 - 20,000;14;4;10;0;0;0
377950;Jamestown+;Action, Indie;50,000 - 100,000;163;17;146;0;0;2
377970;Void And Meddler;Action, Adventure, Indie;100,000 - 200,000;180;98;82;21;21;0
377980;Mortos;Action, Casual, Free to Play, Indie, RPG;20,000 - 50,000;42;45;-3;541;603;0
378030;Cardinal Quest 2;Action, Adventure, Indie;0 - 20,000;92;10;82;0;0;0
378070;Energy Hook;Action, Indie;0 - 20,000;39;13;26;0;0;0
378080;Rack N Ruin;Casual, Indie, RPG;0 - 20,000;58;18;40;41;41;0
378080;Rack N Ruin;Action, Indie, RPG;0 - 20,000;58;18;40;41;41;0
378090;Rebel Wings;Action, Adventure, Indie;0 - 20,000;14;6;8;0;0;0
378100;Nyctophobia;Free to Play, Massively Multiplayer, Simulation, Sports;200,000 - 500,000;264;329;-65;228;216;0
378110;Hack RUN;Adventure, Indie;20,000 - 50,000;165;33;132;23;23;1
378240;The Mors;Action, Casual, Indie, Simulation, Strategy;0 - 20,000;9;5;4;0;0;0
378260;Fortify;Action, Indie;20,000 - 50,000;70;24;46;0;0;0
378270;Putrefaction;Action, Adventure, Casual, Indie;100,000 - 200,000;301;133;168;222;237;2
378280;Pump-Action Captain;Action, Adventure, RPG;0 - 20,000;18;20;-2;0;0;0
378300;The Knobbly Crook;Casual, Indie, Massively Multiplayer, Strategy;50,000 - 100,000;184;16;168;0;0;0
378350;Chromadrome 2;Adventure, Indie;0 - 20,000;26;4;22;0;0;0
378360;Ymir;Action, Free to Play, Indie;50,000 - 100,000;730;246;484;166;166;87
378370;Nomad;Action, Indie;500,000 - 1,000,000;2767;1846;921;228;50;30
378390;Production Inc.;Action, Adventure, Indie;0 - 20,000;1;6;-5;0;0;0
378410;Patchman vs. Red Circles;Simulation, Sports;0 - 20,000;19;1;18;0;0;0
378420;Jurassic Island: The Dinosaur Zoo;Action, Indie;0 - 20,000;10;85;-75;0;0;0
378450;Robot Tsunami;Casual, Indie, Simulation;0 - 20,000;1;3;-2;0;0;0
378480;Badland Bandits;Adventure, Casual, Simulation;20,000 - 50,000;65;86;-21;3;3;0
378490;Sunny Hillride;Action, Indie, Simulation;50,000 - 100,000;60;37;23;11;11;0
378510;Witches, Heroes and Magic;Action, Adventure, Indie;0 - 20,000;6;20;-14;0;0;0
378530;Nature's Zombie Apocalypse;Action, Adventure, Indie;0 - 20,000;35;6;29;0;0;0
378540;The Surge;Adventure;1,000,000 - 2,000,000;6553;2145;4408;664;174;56
378570;Robo Miner;Adventure, Indie, RPG, Simulation;0 - 20,000;32;10;22;0;0;0
378580;Untamed: Life Of A Cougar;Indie, Simulation, Strategy;0 - 20,000;77;51;26;0;0;0
378590;Forest Warrior;Violent, Gore, Action;0 - 20,000;22;29;-7;0;0;0
378610;Valley;Action, Adventure, Indie;200,000 - 500,000;5798;534;5264;169;153;5
378630;Shadows on the Vatican Act II: Wrath;Massively Multiplayer, RPG, Early Access;20,000 - 50,000;85;22;63;0;0;0
378660;Blues and Bullets;Action;100,000 - 200,000;849;511;338;136;136;0
378700;Neptune Flux;Action, Casual, Indie, RPG, Simulation, Strategy;0 - 20,000;26;12;14;0;0;0
378720;Thea: The Awakening;Action, Indie, Strategy;200,000 - 500,000;3147;469;2678;1106;1429;26
378750;Sayonara Umihara Kawase;Adventure, Indie;0 - 20,000;135;7;128;0;0;1
378760;Pixel Starships;Action, Simulation, Early Access;200,000 - 500,000;1191;456;735;0;0;161
378790;Kagura Douchuuki;Indie;0 - 20,000;14;1;13;0;0;0
378800;Police Tactics: Imperio;Action, Indie;20,000 - 50,000;254;158;96;0;0;2
378810;Steamroll;Casual, Indie;0 - 20,000;46;17;29;306;306;0
378830;The Princess' Heart;Action;0 - 20,000;32;20;12;0;0;0
378850;Galagan's Island: Reprymian Rising;Casual, Free to Play, Strategy;20,000 - 50,000;62;16;46;0;0;162
378860;Project CARS 2;Action, Casual, Indie, Racing, Sports;1,000,000 - 2,000,000;14266;3394;10872;3859;542;410
378930;Pesadelo - Regressão;Action, Indie;20,000 - 50,000;91;43;48;210;210;0
379210;Wayward;Free to Play, Massively Multiplayer, RPG;50,000 - 100,000;953;166;787;64;65;20
379260;Atlantic Quest Solitaire;Action, Indie, Racing, Simulation, Sports;0 - 20,000;9;7;2;0;0;0
379290;Sumo Revise;Adventure, Indie, Strategy;50,000 - 100,000;68;71;-3;270;272;0
379320;Clandestinity of Elsie;Racing, Early Access;20,000 - 50,000;109;30;79;171;187;0
379340;Buggy;Adventure, Casual, Racing;0 - 20,000;13;6;7;0;0;0
379380;ReLoaded;Indie;0 - 20,000;7;7;0;0;0;0
379390;Superstar Dance Club;Action, Adventure, Indie;0 - 20,000;13;6;7;0;0;0
379430;Kingdom Come: Deliverance;Indie;2,000,000 - 5,000,000;87085;18245;68840;2312;1133;6302
379520;DELTAZEAL;Indie;0 - 20,000;46;14;32;5;5;0
379520;DELTAZEAL;Action, Indie;0 - 20,000;46;14;32;5;5;0
379530;Fate Tectonics;Action;20,000 - 50,000;147;49;98;251;281;1
379600;Diner Mania;Action, Adventure, Casual, Free to Play, Massively Multiplayer, Racing, RPG;20,000 - 50,000;89;41;48;1;1;0
379610;Animated Puzzles;Casual, Free to Play, Simulation, Animation & Modeling, Early Access;0 - 20,000;70;5;65;0;0;1
379640;Bloo Kid 2;Action, Adventure, Indie, RPG;20,000 - 50,000;237;25;212;18;18;0
379660;Cakewalk L-Phase Series Plug-ins;Adventure, Indie;0 - 20,000;0;0;0;0;0;0
379720;DOOM;Action, Adventure, Casual, Indie;2,000,000 - 5,000,000;167572;8290;159282;870;552;859
379760;Gravity Error;Action, Adventure, Indie;20,000 - 50,000;49;7;42;0;0;0
379760;Gravity Error;Utilities;20,000 - 50,000;49;7;42;0;0;0
379870;Alteil: Horizons;Adventure, Casual, Free to Play, Indie;50,000 - 100,000;48;55;-7;0;0;0
379960;Mahjong Pretty Girls Battle : School Girls Edition;Action;0 - 20,000;158;93;65;379;523;0
379980;Panzermadels: Tank Dating Simulator;Adventure, Indie, Simulation;20,000 - 50,000;1350;117;1233;66;66;2
379990;Hush;Action, Adventure, Indie;0 - 20,000;13;33;-20;0;0;0
380000;MiniOne Racing;Action, Indie;0 - 20,000;27;17;10;159;166;2
380020;Three Heroes;Action, Indie;100,000 - 200,000;655;295;360;241;233;1
380080;SONAR Steam Editions;Action, Casual, Free to Play, Indie;0 - 20,000;80;20;60;0;0;3
380100;Flute Master;Casual, Indie;0 - 20,000;20;3;17;0;0;0
380120;Celia's Quest;Action, Adventure, Indie;20,000 - 50,000;42;13;29;318;423;17
380130;Warhawks;Indie, Simulation, Early Access;0 - 20,000;0;1;-1;0;0;0
380140;The Secret of Tremendous Corporation;Casual, Indie, RPG;100,000 - 200,000;271;61;210;1;1;0
380150;STASIS;Action, Indie, RPG, Simulation, Strategy;200,000 - 500,000;1396;318;1078;377;484;2
380210;Signal to Noise;Action, Adventure, Indie;0 - 20,000;12;11;1;0;0;0
380220;Hover Junkers;Action;20,000 - 50,000;514;301;213;77;112;0
380360;Tap Tap Infinity;Adventure, Casual, Indie, RPG;200,000 - 500,000;686;230;456;502;510;14
380540;Inevitability;Action;0 - 20,000;28;20;8;0;0;0
380550;Incandescent;Action, Adventure, Indie, RPG, Early Access;100,000 - 200,000;96;43;53;233;243;26
380560;Spandex Force: Champion Rising;Action, Free to Play, Indie;20,000 - 50,000;45;24;21;238;261;0
380570;Axion;Action, Adventure, Indie;0 - 20,000;34;79;-45;211;211;0
380580;SpaceCorn;Strategy;50,000 - 100,000;241;149;92;266;276;0
380600;Fishing Planet;RPG;2,000,000 - 5,000,000;35788;6091;29697;966;55;3132
380650;Hard Lander;RPG;0 - 20,000;3;0;3;0;0;0
380660;Killing Time at Lightspeed: Enhanced Edition;Action, Indie;0 - 20,000;114;22;92;0;0;0
380670;Final Approach;Action, Casual, Indie, Early Access;0 - 20,000;330;21;309;35;35;0
380670;Final Approach;Action, Adventure, Casual, Indie, RPG, Strategy, Early Access;0 - 20,000;330;21;309;35;35;0
380680;Gwan Moon High School : The Ghost Gate;Action, Indie, Strategy;0 - 20,000;46;10;36;0;0;0
380690;Don'Yoku;Sexual Content, Nudity, Casual, Free to Play, Indie;0 - 20,000;18;18;0;280;280;0
380700;Zombie Killtime;Strategy;0 - 20,000;23;19;4;0;0;0
380750;Anima: Gate of Memories;Adventure, Indie, Simulation, Strategy, Early Access;100,000 - 200,000;455;217;238;161;222;1
380810;Herald: An Interactive Period Drama - Book I & II;Action;0 - 20,000;125;12;113;0;0;0
380840;Teeworlds;Action;1,000,000 - 2,000,000;3794;479;3315;280;48;14
380860;Barbara-ian;Casual, Indie;0 - 20,000;21;5;16;0;0;0
380920;Boss 101;Action, Adventure, Indie, RPG;0 - 20,000;57;10;47;0;0;0
380950;Bocce Revolution;Adventure, Casual, Indie;0 - 20,000;19;2;17;0;0;0
380950;Bocce Revolution;Adventure, Indie;0 - 20,000;19;2;17;0;0;0
380990;B.A.D Battle Armor Division;Indie, Strategy;0 - 20,000;31;27;4;0;0;0
380990;B.A.D Battle Armor Division;Adventure, Indie;0 - 20,000;31;27;4;0;0;0
381000;6 Nights;Indie, RPG, Strategy;0 - 20,000;1;2;-1;0;0;0
381010;Orion: A Sci-Fi Visual Novel;Action, Indie;20,000 - 50,000;43;34;9;0;0;0
381020;Sky Rogue;Casual, Indie, Strategy;50,000 - 100,000;919;67;852;968;1076;7
381050;The Ritual on Weylyn Island;Adventure, Indie;0 - 20,000;45;23;22;0;0;0
381090;Ted by Dawn;Action, Adventure, Indie, RPG, Simulation;0 - 20,000;26;24;2;31;31;0
381100;The Men of Yoshiwara: Kikuya;Simulation;20,000 - 50,000;348;115;233;464;464;1
381120;Shoppe Keep;Racing, Simulation;200,000 - 500,000;1729;1055;674;605;404;6
381130;Karma;Action, Adventure, Indie;0 - 20,000;11;35;-24;0;0;0
381140;Cruel Arena;Casual, Indie;200,000 - 500,000;207;108;99;221;231;0
381170;Lost in Paradise;Adventure, Indie;100,000 - 200,000;40;36;4;224;224;0
381210;Dead by Daylight;Action, Casual;10,000,000 - 20,000,000;525661;118906;406755;8924;939;37517
381220;Hydraulic Empire;Action;0 - 20,000;36;32;4;0;0;0
381250;Stardrift Nomads;Adventure, RPG, Simulation, Strategy;0 - 20,000;9;0;9;0;0;0
381260;Orion Trail;Web Publishing;0 - 20,000;136;57;79;0;0;0
381290;Dragon Rider;Action, Adventure, Casual;0 - 20,000;0;1;-1;0;0;0
381310;Proton Pulse;Adventure;0 - 20,000;16;3;13;0;0;0
381320;Bezier;Action, Indie;20,000 - 50,000;80;24;56;25;46;0
381340;Mallow Drops;Action, Indie;0 - 20,000;22;3;19;0;0;0
381550;The Arcslinger;Action, Indie;0 - 20,000;3;1;2;0;0;0
381560;Epic Cards Battle(TCG);Action, Indie, Simulation, Early Access;100,000 - 200,000;382;374;8;10;14;1
381590;Shred! Remastered;Adventure, Indie;0 - 20,000;68;44;24;0;0;0
381610;Dandy: Or a Brief Glimpse Into the Life of the Candy Alchemist;Action, Adventure, Indie;0 - 20,000;37;12;25;0;0;0
381640;Allods Online RU;Casual, Indie;200,000 - 500,000;1023;543;480;936;91;126
381750;RC Simulation 2.0;Indie, RPG;0 - 20,000;146;88;58;66;66;1
381780;80 Days;Indie;100,000 - 200,000;1633;158;1475;296;249;7
381800;DRIFT 84;Action, Adventure, Indie;0 - 20,000;19;18;1;0;0;0
381850;My Paper Boat;Action, Casual, Indie;0 - 20,000;34;12;22;0;0;1
381870;Koala Kids;Adventure, Free to Play, Massively Multiplayer, RPG;0 - 20,000;213;20;193;285;279;1
381870;Koala Kids;Casual, Indie, Racing;0 - 20,000;213;20;193;285;279;1
381880;Red Rope: Don't Fall Behind;Simulation;0 - 20,000;87;14;73;1;1;3
381890;Induction;Action, Adventure, Indie, RPG, Early Access;0 - 20,000;116;14;102;0;0;0
381890;Induction;Action, Indie;0 - 20,000;116;14;102;0;0;0
381900;Bard's Gold;Action, Adventure, Indie, RPG;0 - 20,000;104;27;77;240;240;0
381910;Xenocide;Action, Casual, Indie;0 - 20,000;24;6;18;0;0;0
381940;Trials on Tatooine;Action, Casual, Indie;200,000 - 500,000;1053;272;781;18;21;0
381990;Dragon Saga;Free to Play, Massively Multiplayer, Simulation, Strategy;200,000 - 500,000;849;418;431;187;165;43
382050;Eon Altar;Action, Adventure, Casual, Indie, Simulation;200,000 - 500,000;632;103;529;378;514;1
382070;Neoncube;Action, Indie;0 - 20,000;68;18;50;20;33;0
382080;Action Alien;Casual, Strategy;100,000 - 200,000;178;167;11;276;221;1
382110;Virtual Desktop;Casual, Indie, Sports;500,000 - 1,000,000;1298;566;732;847;421;98
382120;Journey To The Center Of The Earth;Action, Indie;500,000 - 1,000,000;424;222;202;268;254;0
382130;Exile's End;Action, Adventure, Indie;0 - 20,000;33;13;20;0;0;0
382140;SKYHILL;Utilities;200,000 - 500,000;3205;944;2261;279;175;35
382160;Dark Years;Adventure, Indie, RPG, Simulation, Strategy;20,000 - 50,000;27;82;-55;1;1;0
382250;Lightrise;Sports;0 - 20,000;20;20;0;0;0;0
382260;8Bit Fiesta - Party Game;Indie, Racing;50,000 - 100,000;516;45;471;166;245;1
382270;Space Xonix;Casual, Indie;0 - 20,000;15;2;13;0;0;0
382300;Kidnapped;Action, Adventure, Casual, Indie;100,000 - 200,000;297;240;57;232;266;0
382310;Eco;Action, Adventure, Indie;200,000 - 500,000;8770;1889;6881;5131;780;1778
382320;Heart of Ember CH1;Action, Adventure, Indie, RPG;0 - 20,000;7;5;2;0;0;0
382330;Killers and Thieves;Casual, Indie, Simulation, Strategy;0 - 20,000;72;76;-4;0;0;0
382330;Killers and Thieves;Action, Adventure, RPG;0 - 20,000;72;76;-4;0;0;0
382350;Devil's Bluff;Action, Indie;20,000 - 50,000;113;75;38;32;49;0
382360;John Wick Chronicles;Adventure, Indie;0 - 20,000;170;92;78;0;0;1
382360;John Wick Chronicles;Indie, Strategy;0 - 20,000;170;92;78;0;0;1
382420;E.T. Armies;Adventure, Indie;100,000 - 200,000;142;156;-14;0;0;0
382480;Super Dungeon Run;Action, Indie;0 - 20,000;85;50;35;0;0;0
382490;Relic Hunters Zero: Remix;Action, Indie;1,000,000 - 2,000,000;6336;437;5899;140;40;34
382560;Hot Lava;Adventure, Indie;200,000 - 500,000;4604;320;4284;254;217;29
382880;Feudalism;Simulation;0 - 20,000;15;28;-13;0;0;0
382880;Feudalism;Adventure, Indie, Simulation;0 - 20,000;15;28;-13;0;0;0
382890;FINAL FANTASY V;Casual, Simulation;100,000 - 200,000;1048;312;736;255;411;10
382900;FINAL FANTASY VI;Adventure, Indie, Simulation, Strategy;200,000 - 500,000;2000;439;1561;800;390;22
382920;RETSNOM;Action, Simulation, Strategy, Early Access;0 - 20,000;65;21;44;3;3;0
382920;RETSNOM;Adventure, Casual, Indie;0 - 20,000;65;21;44;3;3;0
383010;JamG;Indie, Massively Multiplayer, Strategy, Early Access;0 - 20,000;13;2;11;0;0;0
383020;a Family of Grave Diggers;Action, Indie;0 - 20,000;7;11;-4;0;0;0
383070;The Fleets of Sol;Action, Casual, Indie;0 - 20,000;16;21;-5;0;0;0
383080;Sakura Clicker;Indie, RPG;1,000,000 - 2,000,000;12448;2396;10052;7097;48;85
383100;Fragile Allegiance;Action, Indie, Strategy, Early Access;20,000 - 50,000;83;4;79;29;29;3
383120;Empyrion - Galactic Survival;Action, Indie, Simulation, Early Access;1,000,000 - 2,000,000;23640;5616;18024;3572;991;2596
383150;Dead Island Definitive Edition;Casual, Free to Play, Indie, Strategy;1,000,000 - 2,000,000;14379;3156;11223;475;256;485
383180;Dead Island: Riptide Definitive Edition;Action, Indie, Simulation;200,000 - 500,000;3419;1128;2291;364;307;123
383190;SUMICO - The Numbers Game;Casual, Indie, Massively Multiplayer, Strategy;0 - 20,000;15;1;14;0;0;0
383230;Dungeon Souls;RPG;200,000 - 500,000;1641;567;1074;493;482;5
383240;Angels That Kill - The Final Cut;Indie, RPG, Strategy;0 - 20,000;11;16;-5;0;0;0
383270;Hue;Adventure, Indie, RPG;100,000 - 200,000;1813;114;1699;95;134;4
383330;Star Chronicles: Delta Quadrant;Casual;200,000 - 500,000;169;116;53;264;231;2
383460;Sound of Drop - fall into poison -;Action, Casual, Indie, RPG;50,000 - 100,000;407;58;349;584;599;2
383520;Lilly and Sasha: Guardian Angels;Casual, Indie, Simulation, Sports;50,000 - 100,000;40;32;8;193;193;0
383530;Vortex;Adventure, Casual, Indie;0 - 20,000;2;8;-6;0;0;0
383540;Metro Warp;Indie, RPG;20,000 - 50,000;20;7;13;85;85;0
383560;Squarelands;Action, Adventure, Indie;20,000 - 50,000;83;78;5;281;303;0
383580;Flesh Eaters;Action, Adventure, Indie;500,000 - 1,000,000;954;384;570;225;216;1
383590;Expert Rifleman - Reloaded;Simulation;0 - 20,000;18;11;7;96;96;0
383620;Flight Unlimited Las Vegas;Casual;0 - 20,000;6;19;-13;32;32;0
383630;SEEP Universe;Free to Play, RPG;20,000 - 50,000;48;17;31;63;103;4
383670;Deadlands Noir - That Old Time Religion;Action, Indie, Racing, Simulation, Sports;0 - 20,000;26;9;17;0;0;0
383690;Mu Complex;Adventure, Indie;0 - 20,000;156;36;120;0;0;0
383700;Boneless Zombie;Adventure, Indie;0 - 20,000;47;21;26;0;0;0
383720;Swords & Crossbones: An Epic Pirate Story;Action, Indie, Strategy;0 - 20,000;51;26;25;61;61;0
383730;RPG Maker 2000;Indie, Strategy;20,000 - 50,000;103;13;90;13;13;6
383740;Marble Age: Remastered;Sexual Content, Nudity, Action, Casual, Free to Play, Indie, Simulation;20,000 - 50,000;210;36;174;0;0;7
383750;Funk of Titans;Action, Adventure, Indie, RPG, Early Access;0 - 20,000;83;27;56;171;171;0
383780;Judgement;Casual;0 - 20,000;9;10;-1;0;0;0
383790;The Ship: Remasted;Action, Casual, Indie, Simulation;100,000 - 200,000;382;283;99;138;160;2
383800;Close Order;Adventure, Casual, Indie;20,000 - 50,000;34;33;1;0;0;0
383810;Doomed'n Damned;Action, Casual, Indie, RPG;0 - 20,000;6;12;-6;0;0;0
383840;Nimbatus - The Space Drone Constructor;Indie, Racing, Simulation, Sports;100,000 - 200,000;1535;373;1162;276;259;21
383870;Firewatch;Free to Play, Indie, Massively Multiplayer, Strategy;1,000,000 - 2,000,000;53041;6698;46343;315;258;60
383930;Doorways: Holy Mountains of Flesh;Action;100,000 - 200,000;358;82;276;216;227;0
383940;Steam Marines 2;Indie;0 - 20,000;6;2;4;0;0;0
383950;League of Mermaids;Indie, RPG;0 - 20,000;39;16;23;3;3;2
383960;Machina of the Planet Tree -Planet Ruler-;Action;20,000 - 50,000;145;35;110;154;193;0
383980;Rivals of Aether;Action, Indie;1,000,000 - 2,000,000;25899;1235;24664;868;146;790
384000;Cross of the Dutchman;Casual, Indie, Strategy;20,000 - 50,000;266;91;175;0;0;0
384010;Castles;Action, Indie;20,000 - 50,000;28;15;13;0;0;0
384030;Florensia;Action, Adventure, Indie;200,000 - 500,000;415;218;197;441;443;33
384040;Impulse Revolution;Simulation, Sports;0 - 20,000;11;2;9;0;0;0
384080;Industry Manager: Future Technologies;Sports;20,000 - 50,000;175;124;51;60;60;0
384090;Sketch Tales;Action, Casual, Free to Play, Indie;0 - 20,000;98;48;50;0;0;0
384100;Slybots: Frantic Zone;Sexual Content, Nudity, Casual, Indie;0 - 20,000;30;7;23;0;0;0
384110;Pathologic Classic HD;Strategy;100,000 - 200,000;2660;393;2267;164;118;43
384120;WonderCat Adventures;Action, Adventure, Indie, RPG;0 - 20,000;37;15;22;0;0;0
384150;TeraBlaster;Adventure, Indie;50,000 - 100,000;725;317;408;468;640;0
384180;Prominence Poker;Adventure, Indie;500,000 - 1,000,000;5567;958;4609;546;243;275
384190;ABZU;Action, Indie;500,000 - 1,000,000;21412;1616;19796;142;96;11
384200;Raging Justice;Action, Free to Play, Massively Multiplayer, RPG, Strategy, Early Access;20,000 - 50,000;93;34;59;0;0;0
384230;Block Party Sports;Adventure, Casual, Indie, RPG;0 - 20,000;15;0;15;0;0;0
384250;Super Rude Bear Resurrection;Strategy;20,000 - 50,000;98;63;35;56;56;2
384280;Mute Crimson+;Casual, Strategy;0 - 20,000;136;14;122;0;0;0
384280;Mute Crimson+;Strategy;0 - 20,000;136;14;122;0;0;0
384300;CPUCores :: Maximize Your FPS;Action, Adventure, Casual, Indie;500,000 - 1,000,000;8477;3359;5118;22844;7429;318
384310;Dead In Bermuda;Action, Free to Play, Indie, Massively Multiplayer, RPG;20,000 - 50,000;373;129;244;511;511;2
384320;Handball 16;Action, Indie;0 - 20,000;38;44;-6;298;298;0
384330;PolyRace;Strategy;0 - 20,000;39;19;20;0;0;0
384360;Fingered;Action, Adventure, Indie, RPG;100,000 - 200,000;673;224;449;138;145;2
384480;Six Sides of the World;Action, Indie;20,000 - 50,000;83;9;74;195;198;0
384490;NECROPOLIS: BRUTAL EDITION;Action, Indie, RPG;200,000 - 500,000;2959;1594;1365;691;598;15
384500;Zombie Party;Adventure, RPG;100,000 - 200,000;559;93;466;250;250;0
384550;Painters Guild;Action, Adventure, Indie, RPG;20,000 - 50,000;341;174;167;141;154;1
384570;Zanzarah: The Hidden Portal;Action;200,000 - 500,000;630;267;363;821;821;13
384590;Polychromatic;Action, Free to Play, Massively Multiplayer, Racing;0 - 20,000;27;1;26;0;0;0
384630;Aviary Attorney;Action, Adventure, Casual, Indie, Strategy;20,000 - 50,000;1837;101;1736;194;170;4
384660;RED Fuse: Rolling Explosive Device;Action, Casual, Indie, RPG, Simulation, Strategy;0 - 20,000;10;2;8;0;0;0
384680;MechaNika;Action, Indie, RPG;20,000 - 50,000;667;68;599;316;316;1
384690;Umihara Kawase;Action, Casual, Indie, Simulation;20,000 - 50,000;155;6;149;0;0;1
384700;Umihara Kawase Shun;Action, Indie, Strategy;0 - 20,000;56;8;48;0;0;3
384740;CAT Interstellar;Action, Adventure, RPG, Strategy;200,000 - 500,000;743;293;450;153;184;0
384750;EVEREST VR;Action, Adventure, Indie, Early Access;0 - 20,000;160;155;5;73;73;0
384840;Dead But Alive! Southern England;Indie, Strategy;20,000 - 50,000;38;39;-1;249;249;0
384880;Judged: A Court Simulator;Action, Free to Play;0 - 20,000;1;11;-10;0;0;0
384890;Hack Run ZERO;Action;0 - 20,000;28;3;25;0;0;0
384900;Temporal Shift;Casual, Indie, Sports;0 - 20,000;0;2;-2;0;0;0
384910;Last Half of Darkness - Society of the Serpent Moon;Casual, Indie;0 - 20,000;27;7;20;162;162;0
384920;ABD: A Beautiful Day;Indie, Sports;0 - 20,000;10;37;-27;0;0;0
384930;Pilot Crusader;Action, Adventure, Indie;0 - 20,000;15;40;-25;0;0;0
384940;Magical Brickout;Adventure, Casual, Indie, Simulation, Strategy;0 - 20,000;23;7;16;0;0;0
384940;Magical Brickout;Casual, Indie, RPG;0 - 20,000;23;7;16;0;0;0
384950;Macabre;Action, Casual, Indie;20,000 - 50,000;16;12;4;382;398;0
384960;Vengeance;Indie, RPG;50,000 - 100,000;299;69;230;651;687;0
384970;Soldiers of Heaven VR;Action, Indie, Simulation, Strategy;0 - 20,000;1;3;-2;0;0;0
384980;Battle for Blood - Epic battles within 30 seconds!;Audio Production;200,000 - 500,000;565;204;361;17;21;3
384990;Gon' E-Choo!;Action, Indie;0 - 20,000;74;17;57;0;0;0
385020;none;Adventure, Indie, RPG, Simulation, Early Access;20,000 - 50,000;13;33;-20;291;293;1
385030;C. Kane;Action, Free to Play, Indie, Early Access;100,000 - 200,000;41;4;37;241;241;0
385060;The Last Warlock;Action, Indie, Simulation, Strategy;0 - 20,000;52;7;45;0;0;1
385070;Atonement: Scourge of Time;Action;500,000 - 1,000,000;261;108;153;303;309;1
385080;Guardians of Victoria;Free to Play, Massively Multiplayer, Strategy;200,000 - 500,000;60;179;-119;309;331;1
385100;Space - The Return Of The Pixxelfrazzer;Action, Indie, RPG, Early Access;0 - 20,000;32;1;31;0;0;0
385130;DvDrum, Ultimate Drum Simulator!;Indie, Simulation;0 - 20,000;88;15;73;13;13;4
385150;Stranded In Time;Indie, Simulation, Strategy;100,000 - 200,000;135;38;97;260;261;96
385190;Celestial Tear: Demon's Revenge;Adventure, Casual, Indie, RPG;0 - 20,000;12;4;8;0;0;0
385220;Pulut Adventure;Indie, Strategy;20,000 - 50,000;57;34;23;0;0;0
385230;Ninjahtic;Action, Indie;20,000 - 50,000;62;17;45;322;322;1
385240;Ultimate Arena;Sexual Content, Action;100,000 - 200,000;758;167;591;236;232;2
385250;Paint it Back;Indie, Strategy;50,000 - 100,000;470;9;461;0;0;5
385260;Lamia Must Die;Adventure, Casual, Indie;20,000 - 50,000;115;76;39;0;0;0
385270;Jet Racing Extreme: The First Encounter;Action, Adventure, Indie, Simulation;200,000 - 500,000;825;390;435;379;395;0
385310;The Land Of Lamia;Indie, Strategy;0 - 20,000;35;31;4;149;165;0
385310;The Land Of Lamia;Action, Indie, Simulation;0 - 20,000;35;31;4;149;165;0
385330;Stray Cat Crossing;Action, Casual, Indie;20,000 - 50,000;545;40;505;22;22;0
385350;Deadweight;Sexual Content, Nudity, Casual, Indie;0 - 20,000;15;3;12;0;0;0
385360;Super Trench Attack 2;Adventure, Casual, Indie;20,000 - 50,000;71;47;24;207;207;0
385370;Radiator 2: Anniversary Edition;Indie, Simulation;200,000 - 500,000;2431;397;2034;24;25;1
385380;Planet Centauri;Action, Adventure, RPG;200,000 - 500,000;1494;345;1149;306;438;22
385390;Hidden Mysteries: Civil War;Action, Adventure, Indie;0 - 20,000;14;20;-6;0;0;0
385400;Weapons Genius;Action, Adventure, Indie, Simulation;200,000 - 500,000;472;601;-129;0;0;100
385410;The Journey: Bob's Story;Adventure, Indie, RPG, Simulation, Strategy;20,000 - 50,000;17;12;5;349;386;0
385440;Buff Knight Advanced;Indie;0 - 20,000;39;15;24;0;0;0
385490;MiniDrivers;Action, Casual, Indie;50,000 - 100,000;69;55;14;238;238;0
385530;Астролорды: Облако Оорта;Action, Indie, Early Access;100,000 - 200,000;129;59;70;2;3;0
385560;Shadow Complex Remastered;Action, Indie, RPG, Strategy;100,000 - 200,000;715;134;581;314;402;1
385580;The Empty Inn;Casual, Indie, Strategy;0 - 20,000;3;8;-5;0;0;0
385590;Lethal RPG: War;Action, Adventure, Indie, RPG;20,000 - 50,000;159;43;116;0;0;1
385600;Heavy Fire: Shattered Spear;Action;0 - 20,000;43;34;9;0;0;0
385700;Battle For The Sun;Action, RPG;0 - 20,000;24;40;-16;0;0;0
385710;INK;Indie, Simulation, Strategy;200,000 - 500,000;1272;293;979;134;149;2
385730;WWE 2K16;Action, Indie, Strategy;200,000 - 500,000;1822;996;826;3148;3044;14
385760;NBA 2K17;Indie, Simulation, Strategy;500,000 - 1,000,000;4728;4116;612;9283;4312;107
385770;Time Clickers;Free to Play, Strategy;500,000 - 1,000,000;4352;570;3782;2280;145;223
385800;NEKOPARA Vol. 0;Software Training;500,000 - 1,000,000;16087;1026;15061;1415;60;21
385810;Retaliation: Enemy Mine;Software Training;20,000 - 50,000;4;4;0;0;0;0
385810;Retaliation: Enemy Mine;Action, Adventure, Casual, Free to Play, Indie, Early Access;20,000 - 50,000;4;4;0;0;0;0
385830;Burgers;Adventure, Casual, Indie;100,000 - 200,000;299;352;-53;322;312;0
385840;The Beard in the Mirror;Adventure;0 - 20,000;19;3;16;0;0;0
385850;Life in the Dorms;Adventure, Free to Play, Indie, RPG;0 - 20,000;9;2;7;0;0;0
385860;Tachyon Project;Action, Casual, Indie, Strategy;0 - 20,000;43;17;26;0;0;0
385890;Golden Rush;Action, Adventure, Indie;100,000 - 200,000;230;282;-52;18;19;0
385900;Arevan;Casual, Indie;50,000 - 100,000;22;23;-1;211;212;2
385940;Battles of the Ancient World;Indie;0 - 20,000;14;9;5;0;0;0
385940;Battles of the Ancient World;Action, Free to Play, Indie;0 - 20,000;14;9;5;0;0;0
385950;Infection: Humanity's Last Gasp;Action, Adventure, Indie, Simulation, Early Access;0 - 20,000;18;28;-10;242;242;0
385950;Infection: Humanity's Last Gasp;Casual, Indie, Strategy;0 - 20,000;18;28;-10;242;242;0
385960;Russian Front;Casual, Indie;20,000 - 50,000;7;28;-21;0;0;0
385980;Scott in Space;Indie, Strategy;20,000 - 50,000;25;30;-5;106;106;0
386010;Steambirds Alliance;Utilities;200,000 - 500,000;940;297;643;69;43;0
386050;Proto Raider;Action, Indie, Strategy;20,000 - 50,000;80;22;58;0;0;0
386070;Planetary Annihilation: TITANS;Adventure, Casual;500,000 - 1,000,000;10851;1959;8892;1508;939;278
386080;Pharaonic;Simulation, Strategy;50,000 - 100,000;205;44;161;0;0;0
386090;Nandeyanen!? - The 1st Sûtra;Casual, Indie;0 - 20,000;18;8;10;0;0;0
386100;Pylon: Rogue;Adventure;0 - 20,000;16;7;9;0;0;0
386110;Raywin;Action, Indie, Sports;20,000 - 50,000;28;56;-28;244;287;102
386140;After The End: The Harvest;Casual, Simulation, Sports, Strategy;;;;0;;;
386160;Vampire of the Sands;Photo Editing, Software Training, Utilities;0 - 20,000;61;27;34;190;242;0
386160;Vampire of the Sands;Adventure, Indie;0 - 20,000;61;27;34;190;242;0
386180;Crossout;Adventure, Indie;2,000,000 - 5,000,000;41240;12212;29028;1120;223;10851
386200;STLD Redux: Episode 02;Indie;0 - 20,000;37;3;34;0;0;0
386260;Microcosmum: survival of cells;Casual, Indie, Simulation;200,000 - 500,000;1094;203;891;360;415;5
386280;Vendetta - Curse of Raven's Cry;Action, Free to Play, Indie, Massively Multiplayer, Strategy;200,000 - 500,000;292;296;-4;249;288;5
386290;Kumoon : Ballistic Physics Puzzle;Casual, Indie, Sports, Strategy;20,000 - 50,000;55;22;33;17;17;0
386340;MegaSphere;Action, Adventure, RPG;0 - 20,000;81;35;46;0;0;0
386350;Rise: Battle Lines;Indie;20,000 - 50,000;57;28;29;0;0;0
386360;SMITE;Action, Indie;10,000,000 - 20,000,000;85463;21681;63782;5454;218;18686
386390;Dad Beat Dads;Indie, RPG, Strategy;0 - 20,000;6;0;6;0;0;0
386400;Foosball: World Tour;Casual;0 - 20,000;73;20;53;47;47;0
386420;Job the Leprechaun;Adventure, Free to Play;50,000 - 100,000;142;36;106;176;192;1
386430;Crystal Flux;Action, Casual, Indie;0 - 20,000;0;0;0;0;0;0
386460;Baxter's Venture: Director's Cut;Casual, Indie;0 - 20,000;0;0;0;0;0;0
386480;Blood Code;Action, Casual, Indie, Strategy;100,000 - 200,000;1490;541;949;218;295;1
386490;Wanda - A Beautiful Apocalypse;Design & Illustration, Education, Utilities;100,000 - 200,000;109;71;38;140;159;0
386510;Pyramid Raid;Adventure, Indie, Strategy;20,000 - 50,000;96;66;30;16;16;0
386520;Champion of the Gods;Indie, Simulation, Strategy;0 - 20,000;148;23;125;0;0;0
386540;A.I. Invasion;Adventure, Indie;0 - 20,000;23;43;-20;2;2;0
386550;MAGIX Music Maker 2016 Live Steam Edition;Action, Indie, Racing;0 - 20,000;12;16;-4;0;0;0
386560;Psycho Starship Rampage;Adventure, Indie;0 - 20,000;122;18;104;0;0;1
386590;Novus Inceptio;Action;20,000 - 50,000;688;531;157;12;12;1
386600;Pixel Fodder;Action, Indie;20,000 - 50,000;115;28;87;38;38;0
386620;Cook, Serve, Delicious! 2!!;Casual, Indie, Early Access;200,000 - 500,000;2429;290;2139;759;384;41
386630;Nirvana: The First Travel;Action, Adventure, Casual, Indie, Simulation, Strategy;0 - 20,000;4;4;0;0;0;0
386640;Affected Zone Tactics;Adventure, Indie;100,000 - 200,000;170;134;36;38;38;0
386650;Dungeons and Robots;Indie, Strategy;100,000 - 200,000;74;91;-17;13;13;0
386690;Fantastic Contraption;Action, Indie, Strategy, Early Access;0 - 20,000;211;60;151;20;31;0
386700;The Oil Blue: Steam Legacy Edition;Adventure, Indie, RPG;20,000 - 50,000;121;46;75;269;285;0
386710;C:\raft;Action, Indie;0 - 20,000;18;14;4;0;0;0
386740;Puzzle Strike;Animation & Modeling;0 - 20,000;43;7;36;0;0;0
386750;Cashtronauts;Action, Indie;0 - 20,000;45;17;28;0;0;0
386770;Caladrius Blaze;Action, Indie, Massively Multiplayer, RPG, Early Access;20,000 - 50,000;271;57;214;226;226;0
386840;Sentinel 4: Dark Star;Action, Indie, Early Access;0 - 20,000;45;12;33;0;0;0
386870;Playing History 2 - Slave Trade;Casual, Indie, Strategy;20,000 - 50,000;80;67;13;0;0;0
386880;Rake;Action, Casual, Indie, Racing, Sports;200,000 - 500,000;2976;1259;1717;104;81;2
386900;The Cat Machine;Action, Adventure, Casual, Indie, Strategy;0 - 20,000;130;10;120;12;12;0
386930;Dragonflight;Adventure, Casual, Indie;0 - 20,000;57;62;-5;0;0;0
386940;Ultimate Chicken Horse;Action, Adventure, Casual, Indie;2,000,000 - 5,000,000;30622;1174;29448;518;357;417
386960;Order of Ataxia: Initial Effects;Action, Casual, Indie, Simulation;0 - 20,000;6;1;5;0;0;0
386970;Memory's Dogma CODE:01;Casual, Indie, Sports, Strategy;20,000 - 50,000;276;69;207;194;194;3
386990;Asphyxia;Adventure, RPG;20,000 - 50,000;179;59;120;277;337;0
386990;Asphyxia;Adventure, Indie, Early Access;20,000 - 50,000;179;59;120;277;337;0
387010;FIVE: Guardians of David;Adventure, Indie;50,000 - 100,000;129;58;71;402;402;0
387060;Earth Overclocked;Action, Adventure, Indie;20,000 - 50,000;153;30;123;116;118;0
387070;One Final Breath;Casual;0 - 20,000;21;95;-74;0;0;0
387090;Revolution : Virtual Playspace;Casual;0 - 20,000;17;17;0;0;0;0
387100;Walkerman;Action, Adventure, Free to Play, Massively Multiplayer, RPG;0 - 20,000;29;8;21;0;0;0
387110;Shmup Love Boom;Action, Casual, Indie, Simulation;0 - 20,000;3;17;-14;0;0;0
387130;Zombie Hunter, Inc.;Adventure;0 - 20,000;12;5;7;0;0;0
387240;Steel Rain;Action, Casual, Indie, Racing, Simulation, Sports;20,000 - 50,000;86;15;71;106;106;0
387240;Steel Rain;Action, Free to Play, Indie, Massively Multiplayer, Strategy, Early Access;20,000 - 50,000;86;15;71;106;106;0
387270;Mystical;Free to Play, Simulation;0 - 20,000;11;8;3;0;0;0
387280;Inferno 2;Action, Adventure, Indie;0 - 20,000;42;7;35;0;0;0
387290;Ori and the Blind Forest: Definitive Edition;Action, Indie, Racing, Simulation, Sports;2,000,000 - 5,000,000;54007;2433;51574;528;432;369
387340;Hyperdimension Neptunia U: Action Unleashed;Simulation, Strategy;200,000 - 500,000;2719;231;2488;299;178;8
387370;Sol 0: Mars Colonization;Simulation, Strategy;50,000 - 100,000;275;116;159;220;220;5
387400;C.R.E.E.P.S;Gore, Adventure, Indie;0 - 20,000;3;20;-17;21;21;0
387430;The Viceroy;Action, Sports;0 - 20,000;22;10;12;0;0;0
387450;Shadow of Kingdoms;Adventure;50,000 - 100,000;31;75;-44;1;1;0
387770;Professor Teaches PowerPoint 2013 & 365;Action, Adventure, Indie, Massively Multiplayer, RPG, Sports, Early Access;0 - 20,000;2;0;2;0;0;0
387780;Professor Teaches Access 2013 & 365;Action, Indie, RPG;0 - 20,000;1;0;1;0;0;0
387820;Build a Game Universe;Action, Indie, Racing, Simulation;0 - 20,000;0;0;0;0;0;0
387840;Alpha Runner;Adventure, RPG;100,000 - 200,000;329;92;237;371;637;0
387850;Airport Madness 4;Adventure, RPG, Strategy;20,000 - 50,000;111;38;73;30;30;1
387860;the static speaks my name;Action, Strategy;200,000 - 500,000;4394;997;3397;14;17;2
387870;Mold on Pizza ;Strategy;20,000 - 50,000;113;25;88;151;151;0
387880;Ninjahtic Mind Tricks;Adventure, Casual;0 - 20,000;21;14;7;183;183;0
387890;Radial Impact;Utilities, Early Access;0 - 20,000;0;7;-7;0;0;0
387930;The Tape;Action, Indie;50,000 - 100,000;234;187;47;181;226;0
387970;Clown House (Palyaço Evi);Adventure, Indie;200,000 - 500,000;549;576;-27;13;15;0
387990;Scrap Mechanic;Free to Play, Massively Multiplayer, Sports;5,000,000 - 10,000,000;88744;6786;81958;3238;806;2893
388000;Wellington's Victory;Free to Play, Massively Multiplayer, RPG;0 - 20,000;15;0;15;0;0;0
388010;Tick: The Time Based Puzzle Game;Adventure, Casual;0 - 20,000;4;3;1;0;0;0
388050;Snik;Action, Adventure, Indie;50,000 - 100,000;62;47;15;356;358;0
388060;The Escapists: The Walking Dead;Indie, Simulation;50,000 - 100,000;470;247;223;41;65;1
388080;Borderless Gaming;Adventure, Indie;200,000 - 500,000;2603;346;2257;15569;7274;546
388090;Five Nights at Freddy's 4;RPG, Simulation, Strategy;500,000 - 1,000,000;10063;804;9259;111;85;30
388140;Strategic Command Classic: WWI;Action, Adventure, Casual, Indie;0 - 20,000;21;5;16;0;0;3
388160;Project Druid - 2D Labyrinth Explorer-;Action;20,000 - 50,000;29;101;-72;86;171;0
388210;Day of the Tentacle Remastered;Action, Casual, Indie;200,000 - 500,000;3705;115;3590;301;281;16
388260;Super Slam Dunk Touchdown;;20,000 - 50,000;32;9;23;0;0;0
388270;Baseball Mogul 2015;Indie, Strategy;0 - 20,000;35;12;23;0;0;4
388280;Snapshot - DSLR Camera Control;Action, Adventure, Indie;0 - 20,000;4;3;1;0;0;0
388300;Just Alone;Free to Play, Massively Multiplayer, Early Access;0 - 20,000;21;36;-15;0;0;0
388320;1979 Revolution: Black Friday;Action, Indie, Early Access;50,000 - 100,000;804;244;560;16;29;0
388340;Super Hipster Lumberjack;Casual, Indie;20,000 - 50,000;337;103;234;16;18;0
388360;Shoppy Mart: Steam Edition;Action, Indie;0 - 20,000;56;24;32;0;0;0
388360;Shoppy Mart: Steam Edition;Adventure, Casual, Indie;0 - 20,000;56;24;32;0;0;0
388370;Nova Blitz;English;20,000 - 50,000;118;44;74;0;0;0
388390;"""Glow Ball"" - The billiard puzzle game";Free to Play, Massively Multiplayer, Simulation;100,000 - 200,000;33;99;-66;184;202;3
388410;Darksiders II Deathinitive Edition;Action, Indie;2,000,000 - 5,000,000;11646;3358;8288;1060;499;150
388420;In Between;Action, Indie;50,000 - 100,000;334;56;278;214;221;2
388430;TankZone Battle;Action, Indie;0 - 20,000;62;20;42;28;28;0
388440;Big Journey to Home;Action, Indie;20,000 - 50,000;18;26;-8;359;421;0
388450;Spooky Bonus;Action;0 - 20,000;266;9;257;14290;14290;1
388490;One Way To Die;Casual, Indie, RPG, Strategy;50,000 - 100,000;181;147;34;2;2;0
388540;Dr. Bulbaceous;Action, Adventure, Indie;0 - 20,000;6;1;5;0;0;0
388550;Galactic Missile Defense;Action, Casual, Indie;20,000 - 50,000;26;20;6;250;250;0
388600;articy:draft 3 - Flex License;Indie, Strategy;0 - 20,000;18;3;15;0;0;2
388620;DungeonUp;Action, Indie;100,000 - 200,000;362;74;288;173;206;2
388660;Project Tarvotan;Adventure, Casual, Indie, Simulation, Strategy;20,000 - 50,000;20;22;-2;206;259;14
388680;Unfinished - An Artist's Lament;Adventure, Casual;20,000 - 50,000;22;11;11;0;0;0
388720;Link: The Unleashed Nexus;Adventure, Casual, Indie, Simulation, Strategy;0 - 20,000;43;9;34;0;0;0
388730;Brighter Day;RPG;0 - 20,000;70;8;62;0;0;0
388750;BlazBlue: Chronophantasma Extend;Racing, Simulation, Sports;200,000 - 500,000;2483;242;2241;519;281;9
388800;Azure Striker Gunvolt;Utilities;50,000 - 100,000;1268;209;1059;458;638;6
388830;TribeQuest: Red Killer;Action, Casual, Indie;0 - 20,000;0;3;-3;0;0;0
388840;CATS!;Action, Adventure, Indie;0 - 20,000;28;62;-34;8;10;0
388880;Oxenfree;Adventure;500,000 - 1,000,000;9753;788;8965;259;240;18
388900;Fracture the Flag;Action, Indie;20,000 - 50,000;83;29;54;48;94;0
388910;Sentinels;Action, Indie;0 - 20,000;28;3;25;0;0;0
388960;Torn Tales;Action, Casual, Indie;20,000 - 50,000;31;22;9;311;386;0
388970;iZBOT;Action, Indie;0 - 20,000;215;44;171;381;381;0
388980;Race Track Builder;Action, Adventure, Indie;20,000 - 50,000;98;62;36;1188;1188;4
389010;Unnamed Fiasco;Indie, Early Access;0 - 20,000;4;5;-1;0;0;0
389040;Project Genom;Action, Indie;200,000 - 500,000;914;964;-50;892;377;0
389050;Pocket Rumble;Action, Adventure;0 - 20,000;154;43;111;0;0;0
389120;10 Minute Barbarian;Casual, Indie, Massively Multiplayer, Strategy;0 - 20,000;18;5;13;0;0;0
389140;Horizon Chase Turbo;Action, Indie, Strategy;200,000 - 500,000;4441;281;4160;294;328;69
389160;Shadow Ninja: Apocalypse;Action, Adventure, Indie, RPG;100,000 - 200,000;100;68;32;137;212;0
389170;Songs for a Hero - Definitive Edition;Adventure, Free to Play, Indie;200,000 - 500,000;3040;112;2928;732;1104;34
389190;Goblins and Grottos;Adventure, Indie, RPG, Simulation, Strategy;20,000 - 50,000;56;26;30;0;0;0
389220;Maximum Override;Action, Indie, Racing, Early Access;20,000 - 50,000;198;97;101;36;58;1
389230;Fish or Die;Action, Adventure, Indie, Simulation;0 - 20,000;4;3;1;0;0;0
389250;Planet Alcatraz 2;Action, Adventure, Casual, Indie, Simulation;0 - 20,000;221;17;204;113;113;7
389260;Lucid Trips;Adventure, Casual, Indie;0 - 20,000;66;13;53;0;0;0
389270;Through Abandoned: The Underground City;Action, Adventure, Casual, Indie, RPG;100,000 - 200,000;353;85;268;328;320;15
389310;Tic-Toc-Tower;Action, Adventure, Indie;20,000 - 50,000;49;29;20;126;138;0
389330;Vegas Party;Indie, RPG, Strategy, Early Access;0 - 20,000;1;10;-9;0;0;0
389400;The chronicles of Emerland. Solitaire.;Action, Casual, Indie, Strategy;50,000 - 100,000;112;33;79;227;236;4
389430;Knight Online;Adventure, Casual, Indie;2,000,000 - 5,000,000;5051;5092;-41;1367;53;1452
389460;Robot vs Birds Zombies;Casual, Indie, Simulation, Strategy;500,000 - 1,000,000;35;79;-44;253;253;0
389470;Call of Cthulhu: Shadow of the Comet;Action, Free to Play, Early Access;20,000 - 50,000;52;12;40;1722;1722;0
389510;Wild Animal Racing;Casual, Indie, Early Access;50,000 - 100,000;2352;184;2168;38;52;2
389530;Garlock Online;Adventure, Casual, Indie, RPG, Strategy;50,000 - 100,000;33;94;-61;8;8;0
389570;Mitos.is: The Game;Adventure;2,000,000 - 5,000,000;9485;2250;7235;703;49;53
389650;Stardust Galaxy Warriors: Stellar Climax;Indie, Simulation, Early Access;50,000 - 100,000;197;10;187;18;18;1
389670;Pacer;Action, Early Access;0 - 20,000;555;205;350;169;169;2
389690;Nightclub Emporium;Indie, RPG;20,000 - 50,000;1;10;-9;0;0;0
389700;My Bones;Action, Adventure, Casual, Indie, Simulation, Strategy, Early Access;100,000 - 200,000;174;195;-21;264;276;0
389710;Catapult King;Action, Adventure, Casual, Indie;0 - 20,000;6;0;6;0;0;0
389730;TEKKEN 7;Casual, Indie, Simulation, Sports, Strategy;2,000,000 - 5,000,000;64779;13955;50824;3677;399;5826
389740;D/Generation HD;Adventure;0 - 20,000;11;41;-30;0;0;0
389800;AlterVerse: Disruption;Action, Adventure, Indie;20,000 - 50,000;12;3;9;0;0;1
389810;Rubber and Lead;Action;50,000 - 100,000;48;47;1;464;464;0
389840;Deserter Simulator;Casual, Indie, Simulation;0 - 20,000;35;29;6;0;0;0
389850;Legacy of Dorn: Herald of Oblivion;Action, Adventure, Indie;20,000 - 50,000;144;22;122;604;609;0
389870;Mugen Souls;Adventure, Indie, RPG;50,000 - 100,000;195;81;114;1063;1063;1
389900;Hogs of War;Adventure, Indie;0 - 20,000;212;167;45;0;0;2
389940;MoonStrike;Action, Adventure, Indie, RPG;0 - 20,000;8;0;8;0;0;0
389970;Blues and Bullets - Digital Comic;Action, Adventure, Indie;0 - 20,000;4;3;1;0;0;0
389980;Pluto;Action, Casual, Free to Play, Indie;50,000 - 100,000;27;42;-15;0;0;8
390030;DESYNC;Free to Play, Indie, Simulation;100,000 - 200,000;384;94;290;95;96;0
390040;Small Radios Big Televisions;Action, Adventure, Indie;20,000 - 50,000;243;100;143;11;11;0
390090;Shot Online;;20,000 - 50,000;63;39;24;0;0;0
390100;9Dragons;Action, Adventure, Indie;100,000 - 200,000;295;140;155;0;0;27
390200;Queen's Quest: Tower of Darkness;Action, Racing;50,000 - 100,000;190;103;87;213;213;2
390210;FreezeME;Action, Casual, Indie;0 - 20,000;50;28;22;0;0;0
390220;Toilet Tycoon;Action, Indie;0 - 20,000;114;48;66;0;0;0
390290;Bulb Boy;Action, Adventure, Massively Multiplayer, Early Access;100,000 - 200,000;900;108;792;138;191;2
390310;Little King's Story;Indie, Sports;50,000 - 100,000;223;137;86;669;669;1
390330;Mekazoo;Indie, RPG, Simulation, Early Access;0 - 20,000;50;13;37;0;0;0
390340;Umbrella Corps;Action, Casual, Indie, RPG;100,000 - 200,000;814;1976;-1162;215;285;8
390460;Tyler;Strategy;0 - 20,000;19;13;6;210;210;0
390460;Tyler;Action, Indie;0 - 20,000;19;13;6;210;210;0
390500;Arma 3 Samples;Indie, Racing, Sports;0 - 20,000;3;1;2;0;0;0
390510;Sim Junta;Action, Simulation;0 - 20,000;22;41;-19;0;0;0
390520;PewDiePie: Legend of the Brofist;Indie, Sports;50,000 - 100,000;1357;151;1206;280;280;2
390540;High Fidelity;Utilities;20,000 - 50,000;66;48;18;0;0;0
390560;Fantasy Strike;Indie, RPG;200,000 - 500,000;1201;692;509;462;724;5
390570;Three Digits;Adventure, Indie;200,000 - 500,000;76;75;1;294;280;1
390610;Circa Infinity;Action, Casual, Indie, Early Access;20,000 - 50,000;248;18;230;0;0;1
390620;An Alien with a Magnet;Indie, Simulation, Strategy;0 - 20,000;44;4;40;143;266;0
390660;Call of Tomsk-7;Adventure, Casual, Indie;20,000 - 50,000;371;83;288;0;0;0
390670;Steel Ocean;Action, Adventure, Indie;500,000 - 1,000,000;3103;1390;1713;595;45;1
390680;Spacejacked;Adventure, Free to Play, Indie;0 - 20,000;43;1;42;0;0;0
390710;Acceleration of SUGURI 2;Strategy;100,000 - 200,000;887;249;638;545;81;2
390720;Anarcute;Action, Indie, RPG, Strategy;20,000 - 50,000;518;33;485;176;176;4
390870;Circuit Breakers;Indie;50,000 - 100,000;63;45;18;467;467;1
390880;Redemption: Eternal Quest;Indie;100,000 - 200,000;63;65;-2;247;218;2
390890;Angry Arrows;Indie, RPG, Strategy;20,000 - 50,000;146;12;134;0;0;0
390920;Army of Pixels;Action, Indie;0 - 20,000;43;11;32;0;0;0
390930;AIPD - Artificial Intelligence Police Department;Adventure, Indie, Strategy, Early Access;20,000 - 50,000;40;7;33;0;0;0
390940;The Musketeers: Victoria's Quest;Action, Indie;20,000 - 50,000;38;15;23;287;362;57
390960;The Last Sunshine (Deprecated);Adventure, Indie;0 - 20,000;2;0;2;0;0;0
391000;Farm Frenzy Collection;Casual, Indie;20,000 - 50,000;272;10;262;896;940;51
391030;Hard to Be a God;Adventure, Indie;20,000 - 50,000;78;16;62;0;0;1
391040;F1 2016;Racing, Simulation;200,000 - 500,000;3815;643;3172;1839;1072;25
391050;AquaSnap Window Manager;Adventure, Casual, Indie, RPG;0 - 20,000;58;19;39;10;10;0
391070;Stellar 2D;Action, Adventure, Casual, Indie, RPG, Simulation, Strategy;500,000 - 1,000,000;379;577;-198;235;232;2
391100;Frizzy;Adventure, Casual, Indie, RPG, Strategy;0 - 20,000;13;8;5;0;0;0
391100;Frizzy;Adventure, Casual, Free to Play;0 - 20,000;13;8;5;0;0;0
391120;The Archetype;Adventure, Casual;20,000 - 50,000;32;46;-14;209;209;281
391140;Blast-off;Action;50,000 - 100,000;322;41;281;166;199;1
391140;Blast-off;Adventure, Casual;50,000 - 100,000;322;41;281;166;199;1
391160;The Deletion;Action, Indie, Strategy, Early Access;20,000 - 50,000;160;52;108;128;128;3
391170;Void Invaders;Adventure, Casual, Indie;50,000 - 100,000;305;49;256;132;154;0
391180;Ladra;Action, Casual, Indie, Simulation, Strategy;20,000 - 50,000;37;14;23;138;138;0
391190;Dolguth;Action, Adventure, Indie;0 - 20,000;3;0;3;0;0;0
391210;Arclight Cascade;Adventure, Casual, Indie;0 - 20,000;35;8;27;1;1;0
391220;Rise of the Tomb Raider;Action, Indie;2,000,000 - 5,000,000;108889;6997;101892;1328;774;918
391250;Alien Robot Monsters;Racing;0 - 20,000;99;16;83;0;0;0
391260;Labyronia RPG;Education;200,000 - 500,000;899;320;579;206;173;2
391270;Fingerbones;Education, Software Training;200,000 - 500,000;2602;699;1903;18;19;0
391280;Epic Manager - Create Your Own Adventuring Agency!;Software Training;50,000 - 100,000;157;72;85;130;130;0
391290;DeathCrank;Casual, Indie, Simulation;0 - 20,000;5;2;3;0;0;0
391310;Alien Attack;Action, Indie, Strategy, Early Access;50,000 - 100,000;168;50;118;267;273;0
391340;Ferrum's Secrets: Where Is Grandpa?;Action, Adventure, Casual, Indie, Simulation, Strategy, Early Access;0 - 20,000;48;68;-20;151;151;1
391340;Ferrum's Secrets: Where Is Grandpa?;Action, Free to Play, Indie, Massively Multiplayer, Sports;0 - 20,000;48;68;-20;151;151;1
391380;Tormented 12;Action, Adventure, Simulation, Early Access;0 - 20,000;2;2;0;0;0;0
391400;Game of Dragons;Indie, Simulation, Sports;0 - 20,000;1;3;-2;335;335;0
391410;Rock, the Tree Hugger;Action, Indie, Sports;20,000 - 50,000;3;10;-7;0;0;0
391420;Gun Rocket;Action, Adventure, Indie;100,000 - 200,000;505;187;318;183;181;0
391440;XenoBloom;Adventure, Casual, Free to Play, Indie, RPG, Simulation, Strategy;0 - 20,000;25;16;9;0;0;0
391460;WARMODE;Racing, Sports;2,000,000 - 5,000,000;10455;6460;3995;118;50;17
391480;Mutato Match;Adventure, Casual, Indie;0 - 20,000;0;0;0;0;0;0
391490;Braveland Pirate;Action, Adventure, Indie;50,000 - 100,000;323;45;278;103;103;0
391510;RHEM IV: The Golden Fragments SE;Action, Indie;0 - 20,000;35;1;34;0;0;0
391520;Labyrinth Simulator;Action, Casual, Indie, Strategy;0 - 20,000;71;58;13;18;18;0
391530;Blast Out;Adventure, Indie;0 - 20,000;29;17;12;0;0;0
391540;Undertale;Action, Adventure;2,000,000 - 5,000,000;185205;6386;178819;925;420;915
391550;Beyond Flesh and Blood;Action, Casual, Free to Play, Indie, Early Access;0 - 20,000;13;8;5;0;0;0
391580;Egyptian Senet;Action, Adventure, Indie, Early Access;0 - 20,000;248;68;180;0;0;0
391590;Dream Chamber;Casual, Indie, Sports;50,000 - 100,000;30;22;8;0;0;0
391600;King Lucas;Indie, Simulation;20,000 - 50,000;98;46;52;312;337;0
391630;Necromonads;Action, Casual, Free to Play, Indie, RPG, Sports, Early Access;0 - 20,000;21;21;0;2;2;0
391640;Stage Presence;Action, Indie;0 - 20,000;23;16;7;0;0;0
391640;Stage Presence;Casual;0 - 20,000;23;16;7;0;0;0
391650;Escape From BioStation;Action, Indie, RPG, Simulation, Early Access;0 - 20,000;16;7;9;0;0;0
391660;Incitement 3;Action, Indie;100,000 - 200,000;95;51;44;297;305;1
391720;Layers of Fear (2016);Casual, Free to Play, Massively Multiplayer;2,000,000 - 5,000,000;22235;2745;19490;386;233;50
391730;Crashlands;Casual, Indie;200,000 - 500,000;3426;451;2975;423;248;92
391740;Blaster Shooter GunGuy!;Action, Casual, Indie;100,000 - 200,000;179;228;-49;223;257;0
391780;Uebergame;Action;200,000 - 500,000;255;231;24;13;14;0
391820;Evolution;Action, Indie;20,000 - 50,000;39;43;-4;46;46;0
391910;All Fall Down;Action;0 - 20,000;8;4;4;0;0;0
391920;Ether One Redux;Action, Casual, Indie;0 - 20,000;0;0;0;260;483;7
391960;Super Mega Bob;Casual;0 - 20,000;14;4;10;275;275;0
392000;TRON RUN/r;Adventure, Casual;20,000 - 50,000;288;76;212;52;83;7
392020;RFLEX;Action, Casual, Indie, Sports;0 - 20,000;181;16;165;6;6;0
392030;Murasaki;Indie, RPG, Strategy;0 - 20,000;93;9;84;0;0;2
392040;War Blade;Simulation, Strategy;50,000 - 100,000;252;205;47;0;0;0
392070;Pumped BMX +;Action, Casual, Free to Play, Indie, Massively Multiplayer;50,000 - 100,000;244;57;187;1;1;0
392080;Wayward Terran Frontier: Zero Falls;Action, Indie;20,000 - 50,000;280;120;160;0;0;3
392100;Fatal Theory;Action, Indie;0 - 20,000;6;3;3;0;0;0
392110;ENDLESS Space 2;Action, Adventure, RPG, Strategy;1,000,000 - 2,000,000;16814;3352;13462;1686;625;852
392120;City Z;Casual;0 - 20,000;12;14;-2;272;272;0
392150;#SkiJump;Casual, Indie, Simulation, Early Access;0 - 20,000;7;3;4;0;0;0
392160;X4: Foundations;Action;1,000,000 - 2,000,000;11813;3633;8180;10600;2119;2851
392190;#SelfieTennis;Action, Adventure, Indie;0 - 20,000;79;25;54;0;0;0
392230;Littlstar VR Cinema;Action, Indie;0 - 20,000;17;12;5;0;0;0
392260;Rogue Wizards;Action, Indie;20,000 - 50,000;187;54;133;0;0;1
392280;The Franz Kafka Videogame;Adventure, Casual;100,000 - 200,000;446;232;214;165;194;2
392290;Macroboy Y;Action, Adventure, Casual, Indie, Massively Multiplayer, Early Access;0 - 20,000;2;1;1;0;0;0
392330;Take Command - 2nd Manassas;Adventure, Casual, Indie;0 - 20,000;59;4;55;0;0;2
392370;Wish -tale of the sixteenth night of lunar month-;Adventure, Indie, RPG;0 - 20,000;18;4;14;0;0;0
392410;Toy Odyssey: The Lost and Found;Action, Indie, RPG;20,000 - 50,000;213;107;106;138;138;1
392450;Silver Creek Falls: Chapter 1;Indie;50,000 - 100,000;521;79;442;102;102;0
392470;NOBUNAGA'S AMBITION: Sphere of Influence;Adventure, Indie, RPG, Simulation;50,000 - 100,000;463;93;370;636;636;10
392580;WARSHIFT;Action, Indie;20,000 - 50,000;478;190;288;200;308;1
392600;Volvox;Violent, Action, Indie;0 - 20,000;24;2;22;0;0;0
392610;Tricone Lab;Action, Adventure, Indie;0 - 20,000;75;6;69;0;0;0
392610;Tricone Lab;Action, Adventure, Early Access;0 - 20,000;75;6;69;0;0;0
392620;Lucadian Chronicles;Action, Indie;0 - 20,000;21;6;15;0;0;1
392680;Jeeboman;Action, Indie;0 - 20,000;28;11;17;0;0;0
392690;Erwin's Timewarp;Action, Adventure, Indie;0 - 20,000;13;3;10;0;0;0
392720;Daily Espada;Action, Indie;0 - 20,000;11;1;10;0;0;0
392780;Mondrian - Abstraction in Beauty;Action, Adventure, Indie, Strategy, Early Access;0 - 20,000;19;8;11;274;276;0
392820;Wild Island Quest;Adventure, Indie;50,000 - 100,000;160;149;11;175;197;1
392890;Trucker 2;Adventure, Casual, Indie;0 - 20,000;5;15;-10;0;0;0
392920;Arvale;Strategy;50,000 - 100,000;76;22;54;221;244;0
392930;A Sirius Game;Action, Adventure, Indie;20,000 - 50,000;33;29;4;173;175;472
392940;Epic Quest of the 4 Crystals;Adventure, Indie;50,000 - 100,000;118;32;86;176;200;460
392950;Lost Lands: A Hidden Object Adventure;Adventure, Indie;200,000 - 500,000;4576;575;4001;1465;2199;31
392970;New York Mysteries: High Voltage;Action, Indie;20,000 - 50,000;233;23;210;9;9;4
393080;Call of Duty: Modern Warfare Remastered;Adventure, Indie, Strategy;500,000 - 1,000,000;5249;2787;2462;578;474;84
393150;The Dreamatorium of Dr. Magnus 2;Action, Adventure, Casual, Indie;20,000 - 50,000;58;22;36;219;231;0
393170;Bit Shifter;Adventure, Casual, Indie, RPG;0 - 20,000;25;1;24;0;0;0
393190;TSIOQUE;Adventure, Indie, RPG;50,000 - 100,000;1464;69;1395;243;465;4
393200;Bad Rats Show;Action, Indie;20,000 - 50,000;681;168;513;375;375;2
393220;Super Man Or Monster;Action, Adventure, Casual, Indie, Early Access;0 - 20,000;103;9;94;395;395;0
393230;The Youthdrainers;Action, Adventure, Indie;20,000 - 50,000;9;41;-32;314;434;0
393240;Sir! I'd Like To Report A Bug!;Adventure, Casual, Free to Play, Indie;0 - 20,000;20;14;6;211;214;3
393290;Motorhead;Action, Adventure, Indie;0 - 20,000;6;24;-18;0;0;0
393320;Typing Instructor Platinum 21;Adventure;0 - 20,000;11;3;8;0;0;0
393330;Typing Instructor for Kids Platinum 5;Action, Adventure, Indie;0 - 20,000;9;2;7;0;0;0
393340;Professor Teaches Photoshop Creative Cloud;Casual;0 - 20,000;2;11;-9;0;0;0
393350;Shu's Garden;Indie, Simulation, Strategy;0 - 20,000;27;7;20;0;0;0
393380;Squad;Action, Adventure, Indie, RPG;1,000,000 - 2,000,000;111701;17638;94063;4137;815;11390
393390;Cat Simulator;Racing;50,000 - 100,000;153;196;-43;1;1;1
393410;World of Soccer;Design & Illustration, Utilities;200,000 - 500,000;692;412;280;10;13;0
393420;Hurtworld;Action, Adventure, Indie, Simulation;500,000 - 1,000,000;23652;7370;16282;2486;633;176
393430;Ice Lakes;Adventure, Casual, Indie;200,000 - 500,000;1247;211;1036;313;183;3
393460;Crazy Pixel Streaker;Casual, Indie, Simulation;20,000 - 50,000;53;36;17;218;218;0
393520;Iconoclasts;Casual;200,000 - 500,000;3463;509;2954;351;265;21
393530;Insanity Clicker;Casual;500,000 - 1,000,000;1872;878;994;1288;196;58
393540;TNN Motorsports Hardcore TR;Adventure;0 - 20,000;3;2;1;0;0;0
393550;The Journey Back;Adventure, Casual, Indie;0 - 20,000;22;12;10;0;0;0
393600;Robot Exploration Squad;Casual, Indie, Simulation, Strategy;0 - 20,000;17;8;9;0;0;0
393610;ROOT;Action, Indie, Massively Multiplayer, Early Access;20,000 - 50,000;146;46;100;289;297;0
393660;Streamline;RPG;20,000 - 50,000;32;23;9;0;0;0
393750;P·O·L·L·E·N;Action, Indie;20,000 - 50,000;126;66;60;0;0;0
393770;Benji Challenges;Free to Play, Indie, Racing, Strategy;0 - 20,000;3;5;-2;0;0;0
393790;Rogue Operatives Hide and Seek;Casual, Indie;20,000 - 50,000;96;39;57;169;211;0
393800;GearStorm - Armored Survival;Indie, Simulation, Strategy;0 - 20,000;46;27;19;22;22;0
393820;At the Mountains of Madness;;0 - 20,000;22;40;-18;0;0;0
393860;Smoots World Cup Tennis;Indie, RPG;0 - 20,000;19;18;1;0;0;0
393920;Auto Dealership Tycoon;Action, Indie, Simulation;0 - 20,000;94;92;2;0;0;0
393930;RoShamBo;Action, Adventure, Free to Play, Massively Multiplayer, RPG, Strategy;100,000 - 200,000;281;157;124;32;30;0
393950;Get Over Here;Indie;0 - 20,000;14;19;-5;0;0;0
393980;Pretty Girls Mahjong Solitaire;Strategy;50,000 - 100,000;551;167;384;225;323;1
394010;The Contact;Action, Indie;0 - 20,000;2;6;-4;0;0;0
394030;Trigonarium;Indie, Sports, Strategy;0 - 20,000;31;4;27;0;0;10
394030;Trigonarium;;0 - 20,000;31;4;27;0;0;10
394120;Atom Universe;Action, Indie, Simulation, Strategy;100,000 - 200,000;167;267;-100;6;8;1
394130;Water Bears VR;Adventure, Indie;50,000 - 100,000;163;13;150;0;0;0
394140;Sound Shift;Violent, Action;20,000 - 50,000;116;24;92;1;1;0
394160;ARCADE GAME SERIES: PAC-MAN;Action, Indie;100,000 - 200,000;653;88;565;36;52;12
394220;Last Horizon;Action, Indie;50,000 - 100,000;186;48;138;49;49;0
394230;Battleborn;Action, Adventure, Indie, RPG;500,000 - 1,000,000;5959;3702;2257;443;192;0
394260;Dance Magic;Action, Adventure, Indie, RPG, Simulation, Sports;0 - 20,000;32;20;12;249;249;0
394270;Country Tales;Adventure, Indie, RPG, Strategy;0 - 20,000;18;3;15;0;0;0
394280;Dark Heritage: Guardians of Hope;Indie, RPG, Simulation;50,000 - 100,000;185;146;39;246;246;1
394290;Tennis in the Face;Action, Casual, Indie, Sports, Early Access;0 - 20,000;93;10;83;107;211;1
394310;Punch Club;Action, Adventure, Indie, RPG;1,000,000 - 2,000,000;9353;2231;7122;520;312;184
394360;Hearts of Iron IV;Adventure, Casual, Indie;5,000,000 - 10,000,000;202318;17847;184471;12430;2882;39687
394380;BattleStick;;100,000 - 200,000;358;459;-101;23;12;0
394390;Daydreamer: Awakened Edition;Action, Indie;0 - 20,000;18;2;16;0;0;0
394430;Dimension Drive;Casual, Indie;20,000 - 50,000;70;13;57;0;0;2
394450;Warhammer 40,000: Deathwatch - Enhanced Edition;Casual, Indie, Strategy;100,000 - 200,000;562;253;309;753;891;6
394480;Ringies;Action;20,000 - 50,000;25;21;4;0;0;0
394490;Buildanauts;Adventure, Casual;0 - 20,000;13;49;-36;0;0;0
394510;HELLDIVERS Dive Harder Edition;Casual, Indie;1,000,000 - 2,000,000;21492;2012;19480;855;384;341
394540;Spaceport Hope;Adventure, Indie;100,000 - 200,000;356;107;249;228;257;0
394550;Gunman Clive 2;Indie, Simulation;0 - 20,000;96;13;83;6;7;0
394600;Mighty Gunvolt;Action, Indie, Racing;20,000 - 50,000;245;85;160;61;99;0
394680;Mountain Crime: Requital;Action, Adventure, Indie, Strategy;50,000 - 100,000;341;48;293;226;255;3
394690;Tower Unite;Action, Casual, Indie, Early Access;500,000 - 1,000,000;15988;1745;14243;3861;624;573
394700;Karma. Incarnation 1;Action, Free to Play, Massively Multiplayer, RPG;20,000 - 50,000;294;57;237;299;299;0
394720;The Legend of Tango;Adventure, Indie, Massively Multiplayer, RPG, Strategy;20,000 - 50,000;11;12;-1;0;0;0
394760;Dead Effect 2;Adventure, Casual, Indie, RPG;100,000 - 200,000;1531;578;953;402;573;9
394770;Owys;Free to Play, Indie, Simulation, Early Access;0 - 20,000;15;23;-8;0;0;0
394840;Mars Colony: Frontier;Adventure, Indie, RPG, Early Access;0 - 20,000;22;34;-12;0;0;0
394850;Square Brawl;Indie, RPG, Strategy;0 - 20,000;126;36;90;0;0;0
394870;Office Battle;Simulation, Strategy;200,000 - 500,000;686;241;445;183;227;0
394950;Mystery Castle;Strategy;0 - 20,000;16;0;16;0;0;0
394960;The Facility;Action, Casual, Indie;0 - 20,000;3;1;2;0;0;0
394970;DEADBOLT;Casual;200,000 - 500,000;4437;184;4253;333;333;16
394990;Habitus;Action, Adventure, Indie;0 - 20,000;4;6;-2;0;0;0
395100;Systematic Immunity;Adventure;0 - 20,000;18;4;14;182;182;0
395140;Miracle Fly;Action, Indie, RPG;20,000 - 50,000;81;12;69;405;405;0
395150;Dark Storm: VR Missions;Action, Strategy;0 - 20,000;11;14;-3;46;46;0
395160;Toby: The Secret Mine;Action, Adventure, RPG;50,000 - 100,000;428;181;247;124;154;2
395170;DISTRAINT: Deluxe Edition;Indie, Simulation;2,000,000 - 5,000,000;10249;738;9511;261;247;4
395190;Reiner Knizia's The Confrontation;RPG, Strategy;0 - 20,000;12;0;12;0;0;0
395200;Ben and Ed;Action, Indie, RPG, Early Access;200,000 - 500,000;2277;480;1797;163;291;15
395250;The Adventures of Fatman;Indie, Strategy;20,000 - 50,000;104;37;67;132;193;7
395270;A Wolf in Autumn;Casual, Free to Play, Indie, Strategy;20,000 - 50,000;253;88;165;119;119;0
395300;Voxel Blast;Casual;0 - 20,000;2;2;0;0;0;0
395350;Doors;Adventure, Casual;20,000 - 50,000;191;113;78;200;200;0
395380;ANKI;Adventure, Casual;50,000 - 100,000;91;48;43;363;408;3
395400;Freedom Cry;Casual, Indie, Strategy;50,000 - 100,000;35;29;6;401;404;0
395420;The Dwarf Run;Action, Adventure, Indie, RPG;20,000 - 50,000;109;41;68;270;270;0
395470;ICARUS.1;Action, Indie;20,000 - 50,000;44;21;23;0;0;0
395480;The Makeshifter;Action, Indie;0 - 20,000;3;2;1;0;0;0
395500;Rot Gut;Action, Indie;50,000 - 100,000;240;41;199;8;8;0
395520;Missing Translation;Racing;200,000 - 500,000;2702;377;2325;38;30;1
395550;Operation Hardcore;Nudity, Violent, Gore, Action, Adventure, Indie;20,000 - 50,000;24;3;21;0;0;0
395570;We Are The Dwarves;Casual, Indie;100,000 - 200,000;759;369;390;157;224;1
395580;Inventioneers;Action, Indie;0 - 20,000;18;4;14;0;0;0
395600;Armor Clash;Action, Adventure, Indie;0 - 20,000;59;24;35;0;0;0
395620;Ittle Dew 2+;Simulation;20,000 - 50,000;301;47;254;0;0;12
395640;Velocity Stream;Violent, Gore, Action, Adventure, Indie, Early Access;0 - 20,000;6;3;3;0;0;0
395760;Decent Icons;Indie, RPG;0 - 20,000;197;45;152;689;1377;3
395850;Bear Simulator;Casual, Indie, Early Access;20,000 - 50,000;511;83;428;19;19;2
395860;The Last Dream: Developer's Edition;Strategy, Early Access;20,000 - 50,000;265;73;192;216;242;1
395880;Sky Tower;Casual;0 - 20,000;8;4;4;0;0;0
395890;Lapland Solitaire;Indie, RPG;0 - 20,000;16;4;12;0;0;1
395900;Backgammon Blitz;Casual, Indie;20,000 - 50,000;115;80;35;0;0;4
395910;Get Rich or Die Gaming;Action, Adventure, Casual, Indie, Strategy;0 - 20,000;6;26;-20;0;0;0
395920;Playing History - The Plague;Casual;0 - 20,000;28;19;9;0;0;0
395930;Farm Frenzy: Heave Ho;Adventure, Indie, RPG, Early Access;20,000 - 50,000;85;10;75;91;96;4
395940;Scribbled Arena;Casual, Indie;0 - 20,000;2;3;-1;0;0;0
395960;عالم أريب;Adventure, Indie, Simulation, Early Access;0 - 20,000;8;3;5;0;0;0
396010;The Rise of Chubtan;Action, Indie;0 - 20,000;3;2;1;0;0;0
396030;InCell VR;Indie, Strategy;100,000 - 200,000;179;87;92;10;10;0
396060;The Rose and I;Casual, Free to Play, Indie, Massively Multiplayer, Strategy;20,000 - 50,000;158;20;138;6;8;0
396160;Secret Of Magia;Adventure, Casual, Indie, Simulation;500,000 - 1,000,000;416;422;-6;247;239;1
396230;VERSUS: The Lost Ones;Action, Indie;0 - 20,000;141;30;111;733;733;1
396260;World's Fastest Pizza;Adventure, Casual;0 - 20,000;44;3;41;0;0;0
396280;Anarchy Online;Adventure, Casual;100,000 - 200,000;180;40;140;1;1;1
396310;Masochisia;Action, Indie;20,000 - 50,000;331;56;275;52;78;1
396320;Tank Battle: 1944;Action, Indie;50,000 - 100,000;33;20;13;330;331;0
396350;Bleed 2;Action, Adventure, RPG;50,000 - 100,000;743;32;711;196;232;0
396360;LocoSoccer Classic;Action, Adventure, Indie, Simulation;100,000 - 200,000;167;93;74;328;411;0
396480;Battlevoid: Harbinger;Action, Adventure, Indie;100,000 - 200,000;751;190;561;390;390;11
396530;Fireflies;Action, Indie;50,000 - 100,000;19;38;-19;639;675;0
396590;CMYW;Casual, Indie;0 - 20,000;30;10;20;0;0;0
396610;Quantum Flux;Casual, Indie, Simulation, Strategy;0 - 20,000;3;11;-8;0;0;0
396650;ACE Academy;Violent, Gore, Action, Indie, RPG, Simulation, Early Access;100,000 - 200,000;1392;70;1322;0;0;1
396660;Tahira: Echoes of the Astral Empire;Violent, Gore, Adventure, Indie, RPG;20,000 - 50,000;87;25;62;0;0;0
396680;Sol Trader;Action, Adventure, Indie, RPG;0 - 20,000;45;21;24;0;0;1
396700;Hover Cubes: Arena;Action, Indie;0 - 20,000;19;1;18;0;0;0
396710;The Adventure Pals;Indie, Simulation;200,000 - 500,000;1483;118;1365;323;334;14
396740;Blood Bowl 2 - Preview;Action, Casual, Indie;0 - 20,000;0;0;0;0;0;0
396750;EVERSPACE;Adventure, Indie;500,000 - 1,000,000;7997;2113;5884;549;177;67
396790;Dracula's Legacy;Audio Production, Education;100,000 - 200,000;556;142;414;220;231;0
396800;12 Labours of Hercules IV: Mother Nature (Platinum Edition);Action, Adventure, Indie, Early Access;20,000 - 50,000;451;56;395;671;706;4
396820;Mass Destruction;Action, Indie, Simulation;0 - 20,000;6;4;2;0;0;0
396820;Mass Destruction;Adventure, Free to Play;0 - 20,000;6;4;2;0;0;0
396850;Chronicles of the Witches and Warlocks;Adventure, Casual, Indie;50,000 - 100,000;119;75;44;319;373;1
396860;Over The Hills And Far Away;Casual, Indie;20,000 - 50,000;176;27;149;287;287;0
396870;Catyph: The Kunci Experiment;Casual, Indie;0 - 20,000;18;6;12;0;0;0
396890;Gridworld;Adventure, Casual;0 - 20,000;183;32;151;318;568;3
396890;Gridworld;Simulation, Sports, Strategy;0 - 20,000;183;32;151;318;568;3
396900;GRIP: Combat Racing;Action, Indie, Strategy;200,000 - 500,000;3449;589;2860;321;221;17
396930;Tidal Affair: Before The Storm;Casual, Indie;0 - 20,000;13;7;6;0;0;0
397020;Ironkraft - Road to Hell;Action, Casual, Indie;0 - 20,000;2;6;-4;0;0;0
397040;Sphere III: Rage of the Devastator;Design & Illustration, Photo Editing;100,000 - 200,000;205;203;2;1229;2405;11
397060;Faeria;Action, Adventure, Casual, Indie, Racing;500,000 - 1,000,000;5749;1114;4635;768;147;47
397090;Wind Child;Action, Free to Play, Simulation, Strategy;20,000 - 50,000;75;18;57;219;219;2
397100;MachineCraft;Action, Adventure, Indie;200,000 - 500,000;687;207;480;25;9;10
397150;Stellar Overload;Casual, Indie, Simulation, Early Access;50,000 - 100,000;427;185;242;1311;1614;0
397160;Aurora Dusk: Steam Age;Action, Casual, Indie;20,000 - 50,000;242;45;197;2846;2846;7
397180;Command: Northern Inferno;Casual, Indie;0 - 20,000;33;11;22;0;0;0
397180;Command: Northern Inferno;Action, Adventure, Indie;0 - 20,000;33;11;22;0;0;0
397190;Sengoku Jidai: Shadow of the Shogun;Action, Indie;20,000 - 50,000;120;36;84;0;0;4
397200;Deliverance;Adventure, Casual, Indie, RPG;0 - 20,000;12;14;-2;0;0;0
397210;Kanji Training Game;Adventure, Indie, Massively Multiplayer, RPG, Strategy;0 - 20,000;76;20;56;0;0;2
397210;Kanji Training Game;Indie;0 - 20,000;76;20;56;0;0;2
397240;Troubles Land;Action, Indie;0 - 20,000;8;7;1;0;0;0
397270;A Kiss For The Petals - Remembering How We Met;Casual, Indie;100,000 - 200,000;1418;103;1315;439;788;3
397310;Looterkings;Action, Adventure, Indie;0 - 20,000;321;113;208;56;56;2
397320;CTU: Counter Terrorism Unit;Action, Adventure, Casual, Indie, RPG;20,000 - 50,000;33;69;-36;0;0;0
397330;Twinsen's Little Big Adventure Classic;Action, Indie;50,000 - 100,000;292;49;243;120;120;6
397340;SimplePlanes;Action;500,000 - 1,000,000;8548;651;7897;858;269;177
397350;Lords of the Realm II;Action, Casual, Indie;50,000 - 100,000;1114;47;1067;603;1133;174
397360;Magician's Apprentice;Action, Indie;0 - 20,000;5;8;-3;0;0;0
397390;Space Food Truck;Sports;20,000 - 50,000;193;75;118;613;613;1
397400;HueBots;Action, Adventure, Casual, Simulation, Strategy;0 - 20,000;42;3;39;0;0;0
397430;Zoombinis;Action, Indie;50,000 - 100,000;881;63;818;1435;2242;34
397440;Lost Legends: The Weeping Woman Collector's Edition;Action, Adventure, Indie;0 - 20,000;61;15;46;0;0;0
397460;The Jackbox Party Pack 2;Action, Indie, RPG;200,000 - 500,000;1742;74;1668;655;198;160
397500;Labyronia RPG 2;Adventure, Indie, Strategy;200,000 - 500,000;469;152;317;219;193;1
397540;Borderlands 3;Casual, Indie;2,000,000 - 5,000,000;94422;17250;77172;2926;1587;17582
397570;Shmadow;Adventure, Casual, Free to Play, Indie;20,000 - 50,000;159;38;121;155;155;0
397580;Moonbase 332;Casual, Indie, Strategy;20,000 - 50,000;37;93;-56;328;332;0
397600;Viral EX;Action, Indie;0 - 20,000;18;0;18;0;0;0
397640;Nulldrifters;Action, Indie, RPG;0 - 20,000;8;3;5;0;0;0
397660;Behind You;Indie, Simulation;0 - 20,000;12;8;4;0;0;0
397670;Run Run And Die;Adventure, Indie;0 - 20,000;14;25;-11;0;0;0
397690;Hyperspace Invaders II: Pixel Edition;Adventure, Indie, RPG;50,000 - 100,000;308;73;235;0;0;0
397720;Romance of the Three Kingdoms Maker;Adventure, RPG;500,000 - 1,000,000;191;104;87;581;28;8
397730;Rescue Love Revenge;Action, Indie, Sports;0 - 20,000;32;34;-2;0;0;0
397740;Hylics;Casual;100,000 - 200,000;3346;75;3271;156;241;13
397750;Guided Meditation VR;Adventure, Casual;0 - 20,000;91;23;68;0;0;0
397760;Urban War Defense;Indie, Racing, Sports;0 - 20,000;3;78;-75;0;0;0
397770;Meridian: Age of Invention;Action, Casual, Indie;20,000 - 50,000;63;26;37;242;248;1
397780;A Wise Use of Time;Action, Casual;0 - 20,000;95;23;72;0;0;0
397800;BattleQuiz;Action, Adventure, Casual, Racing, RPG, Sports, Strategy;0 - 20,000;10;20;-10;0;0;0
397810;Super Bomb Rush!;Casual, Free to Play, Indie;0 - 20,000;6;18;-12;0;0;0
397820;Let's Sing 2016;Audio Production, Design & Illustration, Photo Editing, Utilities, Video Production, Web Publishing;20,000 - 50,000;30;27;3;0;0;1
397830;Zxill: A Legend of Time;Indie, Strategy, Early Access;0 - 20,000;1;7;-6;0;0;0
397840;Car Mechanic Manager;Adventure, Indie, RPG;20,000 - 50,000;56;50;6;0;0;0
397850;Sonder. Episode ONE;Indie;0 - 20,000;10;3;7;0;0;0
397860;Carnivore Land;Indie, Strategy;0 - 20,000;17;2;15;0;0;0
397870;Arcane Sorcery;Action, Adventure, Indie, RPG;200,000 - 500,000;32;24;8;245;245;1
397900;Business Tour - Board Game with Online Multiplayer;Action, Indie, Strategy;5,000,000 - 10,000,000;40224;25287;14937;526;248;1975
397940;No Time To Live;Adventure, Casual;20,000 - 50,000;108;40;68;202;230;0
397950;Clustertruck;Action, Adventure, Indie, RPG;200,000 - 500,000;12282;902;11380;286;210;75
397960;Mystery Expedition: Prisoners of Ice;Casual, Indie, Strategy;0 - 20,000;11;3;8;0;0;0
397970;Abandoned: Chestnut Lodge Asylum;Adventure, Indie;0 - 20,000;22;7;15;0;0;0
397990;Woof Blaster;Adventure, Indie, Massively Multiplayer;20,000 - 50,000;112;25;87;33;43;0
398000;Twinsen's Little Big Adventure 2 Classic;Action, Adventure, Indie;0 - 20,000;667;15;652;1521;1521;5
398020;Colony Assault;Action, Simulation, Strategy;0 - 20,000;10;9;1;0;0;0
398030;Old School Musical;Adventure, Indie;50,000 - 100,000;672;63;609;94;156;2
398100;Highschool Romance;Action, Adventure;20,000 - 50,000;455;119;336;161;161;0
398110;Reigning Cats;Indie, Simulation, Sports, Strategy;0 - 20,000;13;11;2;0;0;0
398120;Advanced Gaming Platform::Epica;Adventure, Casual, Indie, Simulation;20,000 - 50,000;18;46;-28;0;0;0
398140;Ino;Action, Indie, RPG;0 - 20,000;31;13;18;0;0;0
398150;Ace of Protectors;Strategy;20,000 - 50,000;53;33;20;350;371;0
398170;Evochron Legacy SE;Action, Indie, Racing, Simulation;0 - 20,000;314;67;247;55;55;3
398180;Euclidean;Adventure, Indie;20,000 - 50,000;159;84;75;18;25;0
398210;BlackShadows;Action, Indie, Sports, Early Access;20,000 - 50,000;28;136;-108;1;1;0
398240;eMedia Interactive Rock Guitar;Indie, RPG, Simulation, Strategy;0 - 20,000;5;3;2;0;0;0
398250;Moonstrider;Action, Adventure, Indie, RPG;0 - 20,000;17;0;17;0;0;0
398260;Eyestorm;Education;0 - 20,000;3;1;2;0;0;0
398450;Absent;Indie, RPG, Strategy;50,000 - 100,000;275;63;212;0;0;0
398460;Mooch;Action, Indie;0 - 20,000;110;11;99;0;0;0
398480;Louie Cooks;Gore, Action, Adventure, Indie;0 - 20,000;8;4;4;0;0;0
398530;Ghost Cleaner;Action, Indie;0 - 20,000;16;12;4;0;0;0
398620;Living Legends: The Frozen Fear Collection;Racing, Simulation, Sports;50,000 - 100,000;74;11;63;0;0;1
398640;Bowl Bound College Football;Indie, Racing, Simulation, Sports;20,000 - 50,000;62;53;9;0;0;1
398670;Shadow Heroes: Vengeance In Flames;Action, Adventure, Casual, Indie;0 - 20,000;6;8;-2;0;0;0
398680;Ace Of Words;Action, Adventure, Indie;100,000 - 200,000;537;285;252;350;377;0
398710;Timberman;Animation & Modeling, Design & Illustration, Game Development;500,000 - 1,000,000;10390;697;9693;200;167;19
398810;openCanvas 7;Action, Casual, Indie;20,000 - 50,000;372;106;266;20;20;64
398830;Goggles - World of Vaporia;Action, Indie, RPG, Strategy;20,000 - 50,000;7;5;2;300;303;0
398840;War of Beach;Action, Adventure, Indie, Simulation;100,000 - 200,000;276;239;37;85;156;1
398850;Epistory - Typing Chronicles;Adventure, Indie;500,000 - 1,000,000;5727;304;5423;207;164;21
398890;Zombie Gotchi;RPG, Strategy;0 - 20,000;15;4;11;0;0;0
398900;Fjall;Action, Indie, Simulation, Strategy;0 - 20,000;1;0;1;0;0;0
398920;Tisnart Tiles;Action, Adventure, Indie;0 - 20,000;20;9;11;232;233;0
398930;MacGuffin;Adventure, Indie, RPG;0 - 20,000;22;12;10;0;0;0
398940;Respawn Man;Action, Adventure, Casual, Indie;0 - 20,000;32;8;24;281;281;0
398960;Hoven the Sages Spinel;Action, Adventure, Indie;20,000 - 50,000;18;9;9;0;0;0
398970;none;Action, Casual, Indie;50,000 - 100,000;8;23;-15;308;312;0
398980;Without Within 2;Action, Indie;0 - 20,000;208;28;180;0;0;2
398990;The Last Taxi;Indie, RPG;0 - 20,000;8;4;4;0;0;1
399000;Porradaria Upgrade;Action, Adventure, Indie;20,000 - 50,000;41;19;22;218;250;0
399040;Legends of Solitaire: Curse of the Dragons;Action, Indie;0 - 20,000;101;15;86;0;0;1
399040;Legends of Solitaire: Curse of the Dragons;Indie, Simulation, Strategy;0 - 20,000;101;15;86;0;0;1
399070;Dragon's Wake;Action, Adventure, Indie;20,000 - 50,000;362;46;316;7;7;1
399090;It's time to get out from the solar system;Action, Indie;100,000 - 200,000;14;44;-30;241;252;0
399100;Spheroid;Free to Play, Indie;20,000 - 50,000;38;71;-33;1;1;0
399120;Prospekt;Action, Adventure, Indie;100,000 - 200,000;935;573;362;336;477;1
399130;Massive Cleavage vs Zombies: Awesome Edition;Adventure;100,000 - 200,000;86;92;-6;323;342;0
399140;Straima;Action, Indie;0 - 20,000;55;7;48;0;0;0
399140;Straima;Action;0 - 20,000;55;7;48;0;0;0
399180;Actua Golf 3;Indie, Strategy;0 - 20,000;4;4;0;0;0;0
399230;Kitchen Simulator 2015;Action, Adventure, Casual, Free to Play, Massively Multiplayer;20,000 - 50,000;58;122;-64;222;259;0
399240;XNemesis;Adventure;0 - 20,000;15;3;12;302;302;0
399260;Alice's Mom's Rescue;Action;0 - 20,000;32;14;18;34;34;0
399420;The Prism;Adventure, Indie;100,000 - 200,000;153;70;83;282;359;4
399430;Tinboy;Adventure, Indie;0 - 20,000;304;180;124;234;208;4
399520;Comedy Quest;Action, Casual, Indie;50,000 - 100,000;249;44;205;27;30;1
399530;Hyspherical 2;Action, Adventure, Indie, RPG;0 - 20,000;10;3;7;0;0;0
399600;I and Me;Racing;20,000 - 50,000;338;15;323;260;260;0
399640;Flamebreak;Casual;0 - 20,000;469;29;440;448;448;1
399670;Game Corp DX;Indie, Simulation, Strategy, Early Access;200,000 - 500,000;2680;371;2309;319;344;3
399720;XO;Casual, Indie;0 - 20,000;76;11;65;0;0;3
399780;Expand;Sexual Content, Nudity, Casual, Indie;20,000 - 50,000;368;49;319;63;63;0
399790;Destiny Warriors RPG;Action, Indie, Simulation;500,000 - 1,000,000;534;528;6;254;239;1
399810;Call of Cthulhu;Adventure;500,000 - 1,000,000;7648;2067;5581;416;155;48
399820;Kopanito All-Stars Soccer;Action, Adventure, Casual, Indie, Simulation, Sports;200,000 - 500,000;2219;409;1810;288;265;11
399880;Amos From Outer Space;Adventure, Indie;0 - 20,000;7;1;6;2841;2841;0
399890;The Secret Order 2: Masked Intent;Simulation, Strategy;50,000 - 100,000;329;81;248;249;299;6
399900;Mad Snowboarding;Indie, RPG, Strategy;0 - 20,000;16;15;1;0;0;0
399910;Ookibloks;Action, Indie;;;;0;;;
399920;Blowy Fish;Action, Indie;20,000 - 50,000;24;20;4;0;0;0
400020;Atari Vault;Action, Casual, Indie;100,000 - 200,000;715;140;575;78;115;5
400040;ShareX;Indie, Simulation, Sports, Strategy;500,000 - 1,000,000;4903;213;4690;1734;231;2392
400080;Out of Space;Adventure;100,000 - 200,000;1682;453;1229;187;230;129
400110;Else Heart.Break();Casual, Free to Play, Indie, RPG, Simulation, Strategy;200,000 - 500,000;487;237;250;282;44;2
400130;Freedom Poopie;Free to Play, Strategy;0 - 20,000;9;4;5;0;0;0
400160;Concrete Jungle;Adventure;100,000 - 200,000;518;75;443;236;345;8
400170;The Incredible Adventures of Van Helsing: Final Cut;Adventure, Indie;500,000 - 1,000,000;2499;783;1716;892;438;45
400180;Okhlos: Omega;Action, Indie, Simulation;100,000 - 200,000;641;187;454;67;70;3
400200;The Mystery of a Lost Planet;Action, Adventure, Indie, RPG, Early Access;0 - 20,000;56;37;19;0;0;1
400220;Bass Blocks;Indie, Simulation;0 - 20,000;10;3;7;0;0;0
400230;StarForce 2193: The Hotep Controversy;Indie, Simulation, Early Access;0 - 20,000;4;5;-1;0;0;0
400280;Lizard;Casual, Free to Play, Indie;0 - 20,000;25;2;23;0;0;0
400350;Battle Fleet: Ground Assault;Action, Casual, Indie;0 - 20,000;34;14;20;0;0;0
400360;Adam's Venture: Origins;Action, Adventure, Indie, RPG;50,000 - 100,000;258;138;120;116;116;0
400370;Normality;Adventure, Free to Play, Indie;200,000 - 500,000;251;118;133;255;221;1
400380;Tactical Soccer The New Season;Violent, Gore, Action, Indie;0 - 20,000;10;16;-6;407;421;0
400410;OASE - Other Age Second Encounter;Adventure, Indie, RPG, Early Access;0 - 20,000;8;9;-1;0;0;0
400450;NeuroVoider;Action, Adventure, Casual, Indie, RPG, Early Access;50,000 - 100,000;521;153;368;242;261;2
400470;The Seven Years War (1756-1763);Action, Adventure, Casual, Indie;20,000 - 50,000;80;46;34;29;29;2
400500;MadOut Ice Storm;Action, Indie, Simulation;0 - 20,000;19;28;-9;0;0;0
400510;The Final Take;Design & Illustration;50,000 - 100,000;195;164;31;215;234;0
400570;WarpBall;Utilities;0 - 20,000;4;0;4;17;17;0
400580;Black Closet;Adventure, Indie;0 - 20,000;226;19;207;0;0;1
400580;Black Closet;Casual, Simulation, Strategy;0 - 20,000;226;19;207;0;0;1
400630;Wuppo: Definitive Edition;Casual, Simulation, Strategy;;;;0;;;
400650;eMedia Guitar Method;Adventure, Casual, Simulation;0 - 20,000;6;2;4;0;0;0
400660;Reverse Crawl;Adventure, Casual, Indie;50,000 - 100,000;472;57;415;0;0;2
400710;Bleeding Blocks;Indie, Simulation, Strategy;0 - 20,000;12;2;10;0;0;0
400740;VERGE:Lost chapter;Action, Adventure, Indie, RPG;20,000 - 50,000;137;175;-38;264;275;1
400750;Call to Arms - Gates of Hell: Ostfront;Action, Adventure, Indie;200,000 - 500,000;6320;1484;4836;2483;2288;1403
400790;The Juicer;Action, Casual, Indie;100,000 - 200,000;258;34;224;241;254;0
400800;MXGP2 - The Official Motocross Videogame;Adventure, Casual, Indie;20,000 - 50,000;432;152;280;1290;2216;4
400880;Ultimate Rock Crawler;Casual, Indie;0 - 20,000;7;23;-16;0;0;0
400910;Rabi-Ribi;Adventure;200,000 - 500,000;10226;322;9904;736;730;112
400940;Budget Cuts;Action;200,000 - 500,000;1351;330;1021;143;141;10
401090;MODO indie;Action;0 - 20,000;81;27;54;0;0;6
401120;Anode;Action;20,000 - 50,000;86;11;75;225;234;1
401170;Birth of Shadows;Action, Indie, RPG;0 - 20,000;4;2;2;0;0;0
401190;Dinosaur Hunt;Action;200,000 - 500,000;2438;1221;1217;117;107;2
401200;Invisible Apartment 2;Adventure, RPG;0 - 20,000;8;0;8;0;0;0
401210;Puzzle Sages;Adventure, Casual;0 - 20,000;2;3;-1;0;0;0
401250;Zulu Response;Indie;0 - 20,000;24;26;-2;0;0;0
401280;Nubs' Adventure;Adventure, Indie;0 - 20,000;30;1;29;0;0;0
401290;Nusakana;Action, Indie, Simulation, Early Access;0 - 20,000;69;8;61;32;32;0
401330;Akuatica;Action;0 - 20,000;43;28;15;0;0;0
401360;The Aquatic Adventure of the Last Human;Indie, Strategy;50,000 - 100,000;326;91;235;0;0;1
401420;Match 3 Revolution;Adventure;20,000 - 50,000;25;20;5;0;0;0
401510;Lavapools - Arcade Frenzy;Action, Indie, Racing;0 - 20,000;17;1;16;0;0;0
401680;POSTAL Redux;Action, Free to Play, Indie;200,000 - 500,000;3697;300;3397;136;134;20
401690;Life in Bunker;Action;50,000 - 100,000;195;126;69;1288;1288;3
401710;Flinthook;Casual, RPG;100,000 - 200,000;597;200;397;86;125;3
401760;Drone Swarm;Action, Indie;0 - 20,000;164;83;81;0;0;0
401780;Driveby Gangster;Adventure;0 - 20,000;6;7;-1;0;0;0
401800;Bitku;Action, Adventure, Indie, Racing, Simulation, Sports;20,000 - 50,000;47;12;35;0;0;0
401810;Poi;Action, Adventure, Indie;20,000 - 50,000;626;61;565;239;364;1
401820;FATED: The Silent Oath;Racing, Simulation, Sports;20,000 - 50,000;93;41;52;0;0;0
401840;ChargeShot;Action, Indie;20,000 - 50,000;67;21;46;0;0;0
401890;ARSLAN: THE WARRIORS OF LEGEND;Action, Indie, RPG;0 - 20,000;132;55;77;0;0;0
401910;Darknet;Indie, Strategy;0 - 20,000;101;7;94;202;202;0
401970;Hypatia;RPG;0 - 20,000;33;15;18;25;25;0
402020;The Park;Simulation;100,000 - 200,000;1987;850;1137;144;176;2
402030;Zenohell;Casual, Indie, Simulation;20,000 - 50,000;60;23;37;272;541;0
402040;The Guest;RPG, Strategy;50,000 - 100,000;566;180;386;166;166;1
402060;Californium;Action;50,000 - 100,000;231;94;137;522;916;0
402080;JumpHead: Battle4Fun!;Casual, Indie, RPG, Early Access;0 - 20,000;2;0;2;0;0;0
402120;Deathstate: Abyssal Edition;Adventure, Indie;20,000 - 50,000;298;52;246;161;161;2
402130;FlatOut 4: Total Insanity;Action, Indie;200,000 - 500,000;910;831;79;147;238;13
402150;String Theory;Casual, Indie, RPG, Simulation;0 - 20,000;39;12;27;206;206;0
402160;Star Command Galaxies;Adventure, Casual, Indie;0 - 20,000;185;244;-59;0;0;0
402170;Puzzle Ball;Adventure, Casual, Indie;20,000 - 50,000;29;35;-6;355;355;0
402180;Sakura Swim Club;Indie, RPG, Strategy;500,000 - 1,000,000;2419;411;2008;187;181;7
402190;Gamer Simulator;Adventure, Casual, Simulation, Strategy;0 - 20,000;17;15;2;0;0;0
402210;Airport Madness: Time Machine;Action, Casual, Indie, Strategy;20,000 - 50,000;84;26;58;223;243;0
402220;Lift It;Casual, Indie, Sports;50,000 - 100,000;61;54;7;415;455;0
402300;Dungeon Manager ZV;Action, Adventure, Free to Play, RPG, Simulation;0 - 20,000;49;24;25;0;0;1
402310;Overfall;Adventure, Casual, Indie;20,000 - 50,000;396;466;-70;285;285;4
402330;Press X to Not Die;Action, Adventure, Casual, Indie;100,000 - 200,000;3132;344;2788;100;111;7
402340;Blue Rider;Adventure, Casual, Free to Play, Indie, RPG, Simulation;0 - 20,000;89;11;78;0;0;0
402390;Hyperdrive Massacre;Adventure;500,000 - 1,000,000;193;156;37;304;241;1
402430;Out of the Park Baseball 17;Action, Indie, Simulation, Strategy;20,000 - 50,000;590;55;535;4439;4439;4
402530;The Last Door: Season 2 - Collector's Edition;Action, Indie;50,000 - 100,000;737;46;691;483;756;2
402560;Tabletopia;Action, Adventure, Casual, Indie, Strategy, Early Access;200,000 - 500,000;953;568;385;136;35;48
402570;Atlas Reactor;Adventure, Free to Play, Indie;500,000 - 1,000,000;4368;897;3471;359;56;2
402620;Kindred Spirits on the Roof;Nudity, Violent, Gore, Action, RPG;20,000 - 50,000;1125;30;1095;14;14;14
402630;The Coma: Cutting Class;Indie, Strategy;0 - 20,000;264;29;235;0;0;1
402710;Osiris: New Dawn;Casual, Indie, Strategy;200,000 - 500,000;8129;6088;2041;683;456;102
402750;Giant Machines 2017;Indie, Simulation, Strategy;50,000 - 100,000;348;135;213;105;145;1
402800;Chunks;Action, Indie;0 - 20,000;21;26;-5;0;0;0
402840;Crusaders of the Lost Idols;Action, Adventure, Indie;500,000 - 1,000,000;2367;468;1899;501;187;489
402850;Miner Mayhem;Adventure, Indie;50,000 - 100,000;72;42;30;65;65;0
402880;Age of Barbarian Extended Cut;Casual, Indie;20,000 - 50,000;572;155;417;30;30;2
402890;Nyctophilia;Action, Indie, Early Access;100,000 - 200,000;193;109;84;308;327;0
402910;Undead Blackout: Reanimated Edition;Casual, Indie, Strategy;0 - 20,000;1;4;-3;0;0;0
402940;Dungeons of Betrayal;Utilities;20,000 - 50,000;33;8;25;126;164;0
402970;Fringes of the Empire;Indie, Simulation, Sports;0 - 20,000;1;0;1;0;0;0
402980;Osteya;Casual, Indie;100,000 - 200,000;60;43;17;300;327;1
403010;The Ultimate Showdown;Action, Indie;0 - 20,000;4;4;0;0;0;0
403030;mdiapp+ SE;Action, Indie;0 - 20,000;14;1;13;0;0;0
403040;Driver Booster 3 for STEAM;Indie;100,000 - 200,000;455;142;313;823;1476;2
403070;Silver Creek Falls: Chapter 2;Action, Indie;0 - 20,000;41;8;33;0;0;0
403090;Rescue Team 2;Action, Adventure, Indie, Early Access;0 - 20,000;38;2;36;0;0;1
403100;Rescue Team 3;Casual;0 - 20,000;44;10;34;338;338;0
403120;THE GAME OF LIFE;Casual, Indie;200,000 - 500,000;1580;529;1051;173;161;17
403180;Draw a Stickman: EPIC 2;Action, Indie;50,000 - 100,000;590;94;496;162;173;7
403190;Planetbase;Action, Indie, Strategy;500,000 - 1,000,000;6908;1816;5092;1406;805;253
403200;Legends of Dawn Reborn;Sexual Content, Nudity, Violent, Indie, Simulation;20,000 - 50,000;22;58;-36;0;0;0
403230;ZombieZoid Zenith;Action, Adventure, Indie, RPG;0 - 20,000;20;4;16;0;0;0
403270;Cloudrift;Action, Adventure;0 - 20,000;24;0;24;0;0;0
403290;Burly Men at Sea;Action, Strategy;;;;0;;;
403300;GravBlocks;Action, Adventure, Indie, RPG;0 - 20,000;6;6;0;0;0;0
403390;Undercover Missions: Operation Kursk K-141;Action, Indie, RPG;0 - 20,000;20;24;-4;0;0;0
403400;ARCADE GAME SERIES: DIG DUG;Adventure;100,000 - 200,000;384;61;323;36;46;3
403410;ARCADE GAME SERIES: Ms. PAC-MAN;Action, Indie, Sports;20,000 - 50,000;187;30;157;0;0;4
403430;ARCADE GAME SERIES: GALAGA;Indie, Early Access;100,000 - 200,000;601;69;532;45;46;8
403440;Evil Hazard;Action, Indie;20,000 - 50,000;17;11;6;0;0;0
403460;SkyScrappers;Action, Indie;0 - 20,000;10;12;-2;0;0;0
403490;Lands of Hope Redemption;Adventure, Indie;0 - 20,000;6;3;3;0;0;0
403510;Fairy Tale Mysteries 2: The Beanstalk;Action, Adventure, Casual, Indie;50,000 - 100,000;244;78;166;243;243;1
403560;Eaten Alive;Indie;200,000 - 500,000;176;323;-147;236;219;1
403590;Klepto;Action, Indie;0 - 20,000;59;160;-101;0;0;0
403590;Klepto;Action, Indie;0 - 20,000;59;160;-101;0;0;0
403640;Dishonored 2;Free to Play, Indie, Massively Multiplayer, RPG, Early Access;2,000,000 - 5,000,000;46448;6141;40307;1071;584;759
403660;Omnipresent;Indie, RPG, Simulation;0 - 20,000;15;13;2;319;319;0
403670;Lumber Island - That Special Place;Action, Indie;20,000 - 50,000;75;26;49;0;0;0
403680;Dexterity Ball 3D;Action, Indie, Simulation;0 - 20,000;8;8;0;0;0;0
403690;Codename: Rogue Fleet;Adventure, Indie;50,000 - 100,000;186;127;59;58;112;0
403700;Zero Punctuation: Hatfall - Hatters Gonna Hat Edition;Action, Adventure, Indie;0 - 20,000;239;42;197;6;6;1
403740;GabeN: The Final Decision;Action, Adventure;100,000 - 200,000;428;261;167;196;221;1
403780;Color Symphony 2;Action, Adventure;0 - 20,000;46;6;40;0;0;0
403780;Color Symphony 2;Action, Adventure, Indie;0 - 20,000;46;6;40;0;0;0
403830;The Consuming Shadow;RPG;20,000 - 50,000;324;17;307;0;0;0
403840;Stacks TNT;Adventure, Casual, Indie;0 - 20,000;14;10;4;0;0;0
403860;ALPAGES : THE FIVE BOOKS;Action, Indie, RPG;20,000 - 50,000;83;139;-56;0;0;0
403880;MotoGP15 Compact;Action, Adventure, Indie;50,000 - 100,000;100;53;47;0;0;0
403900;Clergy Splode;Casual, Free to Play, Indie, Massively Multiplayer, RPG, Early Access;500,000 - 1,000,000;208;282;-74;202;208;0
403940;Dungelot: Shattered Lands;Software Training;50,000 - 100,000;419;119;300;188;188;1
403950;Conquest of Elysium 4;Software Training;100,000 - 200,000;493;59;434;2372;2372;3
403970;The Dwarves;Software Training;200,000 - 500,000;1353;481;872;3201;4742;4
403980;World Ship Simulator;Software Training;50,000 - 100,000;53;199;-146;0;0;1
404030;Lucky Rabbit Reflex!;Casual, Indie, Simulation, Strategy;0 - 20,000;28;4;24;0;0;0
404040;Lords of Magic: Special Edition;Indie, Early Access;50,000 - 100,000;368;32;336;32;60;24
404050;Black & White Bushido;Adventure, Casual, Indie, RPG;20,000 - 50,000;114;53;61;18;18;0
404070;Lords of New York;Action, Casual, Indie;0 - 20,000;28;24;4;193;252;0
404080;Murder;Action, Indie, RPG;20,000 - 50,000;185;191;-6;13;13;0
404080;Murder;Adventure, Casual, Indie;20,000 - 50,000;185;191;-6;13;13;0
404100;STEEL STRIDER;Action, Adventure, Indie;20,000 - 50,000;50;12;38;0;0;0
404150;Lovely Weather We're Having;Action, Adventure, Casual, Indie, RPG;0 - 20,000;44;30;14;0;0;0
404170;Battle Girls;Action, Indie;20,000 - 50,000;76;13;63;0;0;0
404180;Club Life;Simulation, Strategy;20,000 - 50,000;102;24;78;0;0;0
404200;WARTILE;Action, Casual, Indie, Sports;50,000 - 100,000;502;156;346;31;48;3
404270;All My Gods;Casual, Indie;0 - 20,000;84;13;71;0;0;1
404390;Evil Robot Traffic Jam HD;Indie, Racing, Simulation, Sports, Early Access;0 - 20,000;19;5;14;0;0;0
404400;BADBLOOD;Action, Indie, Early Access;0 - 20,000;14;3;11;0;0;0
404410;Endless Sky;Casual, Indie, Sports, Early Access;500,000 - 1,000,000;5305;461;4844;277;31;161
404420;Sun Dogs;Adventure;0 - 20,000;11;5;6;0;0;0
404460;Melter Man;Indie, RPG;0 - 20,000;21;1;20;0;0;0
404480;SC2VN - The eSports Visual Novel;Adventure, Casual, Indie;100,000 - 200,000;817;64;753;71;98;0
404510;Heaven's Hope - Special Edition;Action, Indie;20,000 - 50,000;96;17;79;0;0;1
404540;Nex Machina;Action, Adventure;200,000 - 500,000;1698;242;1456;180;194;5
404550;Farmocalypse;Indie;20,000 - 50,000;87;39;48;104;104;0
404580;Relive;Action, Adventure, Indie;50,000 - 100,000;108;48;60;126;126;0
404590;Vikings - Wolves of Midgard;Indie, Simulation;200,000 - 500,000;2500;1682;818;583;521;8
404620;The Political Machine 2016;Software Training;50,000 - 100,000;546;172;374;973;1285;0
404630;One Hundred Ways;Software Training;20,000 - 50,000;35;28;7;245;295;0
404640;Game Tycoon 2;Action, Indie, Strategy;50,000 - 100,000;126;122;4;824;1400;1
404660;Vicky Saves the Big Dumb World;Adventure, Indie;0 - 20,000;22;14;8;244;291;0
404680;Hob;Adventure, Casual;200,000 - 500,000;4075;504;3571;534;635;14
404690;This Book Is A Dungeon;Casual, Indie, Sports;100,000 - 200,000;189;75;114;177;188;0
404700;Curvatron;Action, Adventure, Indie;50,000 - 100,000;139;31;108;193;156;0
404750;Carrotting Brain;Action, Casual, Indie;0 - 20,000;9;4;5;0;0;0
404770;SUPERFIGHT;Action, Indie, Racing;100,000 - 200,000;229;144;85;558;752;1
404790;Godot Engine;Adventure, Indie;500,000 - 1,000,000;2348;66;2282;461;3;126
404820;Ragdoll Runners;Action, Adventure, RPG;0 - 20,000;257;25;232;515;515;1
404850;DARTHY;Adventure, Casual, Indie;;;;0;;;
404860;Inside Me;Adventure, Indie, Early Access;0 - 20,000;29;10;19;333;333;0
404920;Emergency 2016;Casual, Free to Play, Massively Multiplayer, Simulation;50,000 - 100,000;119;148;-29;376;376;2
404960;The Way of Life: DEFINITIVE EDITION;Action, Indie, Simulation, Strategy;0 - 20,000;70;32;38;0;0;0
404960;The Way of Life: DEFINITIVE EDITION;Action, Indie;0 - 20,000;70;32;38;0;0;0
405000;UTOPIA 9 - A Volatile Vacation;Free to Play, Indie, Sports, Strategy;50,000 - 100,000;112;22;90;135;135;0
405010;Bitardia;Action, Adventure, Casual, Indie, Simulation;0 - 20,000;722;94;628;1001;1001;2
405050;Fill Up!;Action, Adventure, Casual, Indie, Strategy;20,000 - 50,000;9;23;-14;0;0;0
405070;The Worm;Simulation, Sports, Strategy;0 - 20,000;6;6;0;0;0;0
405180;123 Slaughter Me Street;Action, Adventure, Indie, RPG;20,000 - 50,000;221;103;118;0;0;0
405190;MEG 9: Lost Echoes;Indie;0 - 20,000;4;14;-10;0;0;0
405240;Hairy Little Buggers;Indie;0 - 20,000;18;9;9;0;0;0
405290;Charlie Murder;Action, Casual, Indie, Simulation;50,000 - 100,000;1473;78;1395;188;288;14
405310;LEGO MARVEL's Avengers;Casual, Indie;500,000 - 1,000,000;5285;713;4572;893;708;136
405340;Siegecraft Commander;Sexual Content, Nudity, Adventure, Indie, RPG;0 - 20,000;30;18;12;12;12;0
405370;Sky Break;Adventure, Casual, Indie;20,000 - 50,000;353;184;169;30;55;0
405440;Ares Omega;Action;50,000 - 100,000;10;9;1;314;319;0
405480;Tomorrow;Action, Adventure, Casual, Indie, Simulation;0 - 20,000;17;11;6;0;0;0
405500;Dangerous Golf;Action, Adventure, Indie, Massively Multiplayer, RPG, Strategy;100,000 - 200,000;301;329;-28;72;87;1
405530;Veer;Action, Indie, RPG;0 - 20,000;36;2;34;0;0;0
405540;Ninja Senki DX;Action, Adventure, Indie;20,000 - 50,000;62;25;37;266;266;0
405550;Jet Set Knights;Action;20,000 - 50,000;61;12;49;0;0;0
405550;Jet Set Knights;Action, Indie, Early Access;20,000 - 50,000;61;12;49;0;0;0
405590;Stone Tales;Action, Casual, Indie;0 - 20,000;26;12;14;0;0;0
405610;Flight of the Paladin;Casual, Indie, Simulation;100,000 - 200,000;193;179;14;252;210;0
405640;Pony Island;Sports;500,000 - 1,000,000;13024;634;12390;217;159;10
405650;Zero Reflex : Black Eye Edition;Action, Adventure, Indie, Massively Multiplayer, RPG, Early Access;20,000 - 50,000;185;51;134;15;15;0
405670;Combat Core;Adventure, Casual, Indie, Simulation;0 - 20,000;48;15;33;17;17;0
405680;Sentou Gakuen: Revival;Casual;0 - 20,000;0;0;0;0;0;0
405710;Staxel;Action, Adventure, Indie;200,000 - 500,000;3504;892;2612;257;133;89
405720;Perfect Universe - Play with Gravity;Action, Adventure;20,000 - 50,000;92;31;61;3;5;0
405760;Robot Squad Simulator 2017;Action, Adventure, Indie;0 - 20,000;95;58;37;3;3;0
405780;Alpha Polaris : A Horror Adventure Game;Action, Indie, RPG;50,000 - 100,000;347;92;255;143;282;1
405810;Valzar;Adventure, Indie, RPG;0 - 20,000;1;4;-3;0;0;0
405820;Turok;Action, Adventure, Indie;100,000 - 200,000;2796;176;2620;276;213;15
405830;Turok 2: Seeds of Evil;Action, Indie;100,000 - 200,000;1872;159;1713;343;528;18
405860;Super Ubie Island REMIX;Sexual Content, Nudity, Casual, Indie;0 - 20,000;37;12;25;336;336;0
405900;Disgaea PC;Indie;500,000 - 1,000,000;3601;514;3087;429;289;98
405950;Lowglow;Action, Indie, Sports;50,000 - 100,000;411;38;373;221;238;1
405960;Sunken;Action, Adventure, Indie, RPG;0 - 20,000;22;21;1;0;0;0
405970;Flat Kingdom Paper's Cut Edition;Action, Adventure, Indie, Strategy;20,000 - 50,000;142;49;93;188;334;0
405980;Legend of Dungeon: Masters;Indie;100,000 - 200,000;115;77;38;1;1;0
406030;Professor Teaches Word 2016;Action, Indie;0 - 20,000;1;2;-1;0;0;0
406040;Professor Teaches Access 2016;Casual, Indie;0 - 20,000;2;2;0;0;0;0
406050;Professor Teaches Excel 2016;Action, Simulation;0 - 20,000;1;1;0;0;0;0
406060;Professor Teaches PowerPoint 2016;Adventure;0 - 20,000;0;1;-1;0;0;0
406080;Ant War: Domination;Indie;20,000 - 50,000;131;88;43;250;250;1
406090;Enigmoon;Adventure, Indie, RPG;200,000 - 500,000;563;190;373;326;337;1
406110;Asdivine Hearts;Action, Indie, Strategy;0 - 20,000;62;22;40;0;0;0
406120;Astral Breakers;Indie, Simulation, Strategy, Early Access;0 - 20,000;9;8;1;0;0;0
406130;DarkMaus;Adventure, Casual, Indie;20,000 - 50,000;337;79;258;369;369;0
406150;Refunct;Action, Adventure, RPG;200,000 - 500,000;16168;709;15459;224;56;10
406220;Gnomes Vs. Fairies: Greckel's Quest;Action, Adventure, Indie;0 - 20,000;50;10;40;0;0;0
406290;Twilight Struggle;Casual, Indie, Simulation, Sports;200,000 - 500,000;2062;304;1758;528;258;91
406300;Lighthockey;Casual, Indie;0 - 20,000;8;3;5;0;0;0
406310;Stop Online - Battle of Words;Simulation, Sports;50,000 - 100,000;102;66;36;211;211;0
406350;KartKraft;Adventure, Indie;200,000 - 500,000;2207;559;1648;138;107;32
406400;Axes and Arrows;Casual, Strategy;20,000 - 50,000;4;2;2;0;0;0
406410;Minigolf VR;Casual, Strategy;0 - 20,000;12;12;0;0;0;0
406550;Umineko When They Cry - Question Arcs;Action, Indie, Early Access;0 - 20,000;1456;64;1392;2766;2766;29
406650;Ratings War;Adventure, Indie, RPG;0 - 20,000;39;11;28;166;166;0
406690;Roses and Gems;Animation & Modeling, Design & Illustration, Photo Editing, Utilities, Web Publishing, Game Development;0 - 20,000;5;2;3;0;0;0
406710;Eclipse: Edge of Light;Action, Indie, RPG;0 - 20,000;20;9;11;0;0;0
406720;Alekhine's Gun;Indie, Strategy, Early Access;100,000 - 200,000;247;152;95;196;196;2
406730;1,000 Heads Among the Trees;RPG;100,000 - 200,000;66;54;12;285;307;0
406760;"FL337 - ""Fleet""";Education;0 - 20,000;2;1;1;0;0;0
406780;Welcome to Boon Hill;Action, Indie, RPG;0 - 20,000;34;4;30;0;0;0
406830;Professor Teaches OneNote 2016;Action, Indie;0 - 20,000;1;1;0;0;0;0
406840;Professor Teaches Outlook 2016;Adventure, Casual;0 - 20,000;0;0;0;0;0;0
406850;Crush Your Enemies;Indie;20,000 - 50,000;321;64;257;0;0;2
406860;Blind;Adventure, Casual, Simulation;0 - 20,000;81;36;45;0;0;1
406870;Eventide: Slavic Fable;Free to Play, Indie;50,000 - 100,000;678;45;633;149;204;1
406890;Fruit Golf;Indie;0 - 20,000;0;0;0;0;0;0
406920;Monsterland;Action, Adventure, Indie;20,000 - 50,000;35;2;33;0;0;0
406930;Epic Showdown;Casual, Indie, Simulation, Strategy;0 - 20,000;16;27;-11;0;0;0
406930;Epic Showdown;Action, Adventure;0 - 20,000;16;27;-11;0;0;0
406940;Dub Dash;Action, Indie, Early Access;20,000 - 50,000;197;76;121;0;0;0
406970;The Uncertain: Last Quiet Day;Action, Adventure, Indie, RPG, Early Access;200,000 - 500,000;4180;1198;2982;237;94;4
407000;Survival Is Not Enough;Action, Indie, RPG;20,000 - 50,000;18;34;-16;284;300;1
407020;Star Sky;Indie, RPG;20,000 - 50,000;203;61;142;116;213;1
407020;Star Sky;Casual, Simulation;20,000 - 50,000;203;61;142;116;213;1
407050;Mussoumano: Ataque dos Haters;Action, Adventure, Casual, Indie;100,000 - 200,000;27;7;20;0;0;0
407060;AltspaceVR;Action, Adventure, Casual, Indie, Racing, Simulation, Sports;200,000 - 500,000;423;168;255;128;97;15
407100;Gulf of Aden - Task Force Somalia;Action, Adventure, Indie;0 - 20,000;21;1;20;0;0;0
407110;Swarm Universe;Adventure, Casual, Indie;20,000 - 50,000;24;3;21;0;0;0
407120;Soccer Manager 2016;Indie, RPG, Strategy;200,000 - 500,000;475;212;263;1029;113;0
407130;Tank Mechanic Simulator;Action, Indie, RPG;200,000 - 500,000;6158;813;5345;1056;1091;101
407150;Trap Them - Sniper Edition;Action, Adventure, Indie, RPG, Strategy;0 - 20,000;17;14;3;124;124;0
407190;Club Manager 2016;Action, Free to Play;20,000 - 50,000;52;42;10;13;13;6
407190;Club Manager 2016;Adventure, Indie;20,000 - 50,000;52;42;10;13;13;6
407230;Legend of Mysteria RPG;Action, Adventure, Indie, Simulation;200,000 - 500,000;532;222;310;283;261;3
407290;There Was A Caveman;Action, Indie, RPG, Early Access;100,000 - 200,000;98;43;55;43;43;0
407300;The Last NightMary - A Lenda do Cabeça de Cuia;Action, Adventure, Indie, RPG, Simulation, Early Access;50,000 - 100,000;566;132;434;197;216;2
407310;NEKO-NIN exHeart;Adventure, Casual;50,000 - 100,000;926;44;882;356;338;1
407320;My Little Kitties;Action, Indie;0 - 20,000;62;2;60;95;95;0
407330;Sakura Dungeon;Action, Indie;200,000 - 500,000;1655;149;1506;487;581;35
407340;Strawberry Vinegar;Action, Adventure, Indie;0 - 20,000;127;18;109;0;0;0
407380;Strania - The Stella Machina -;Action, Free to Play, Indie;0 - 20,000;45;4;41;0;0;0
407420;Gabe Newell Simulator;Action, Free to Play, Indie;20,000 - 50,000;320;317;3;24;32;1
407530;ARK: Survival Of The Fittest;Action, RPG;2,000,000 - 5,000,000;7126;3802;3324;137;16;330
407560;Killing Room;Action, RPG;100,000 - 200,000;918;403;515;125;195;10
407600;Raiden Legacy - Steam Edition;Action, Indie, Strategy;20,000 - 50,000;134;103;31;0;0;0
407620;Indie Game Battle;Sexual Content, Nudity, Violent, RPG, Strategy;50,000 - 100,000;77;103;-26;5;8;0
407630;Skein;RPG;0 - 20,000;18;5;13;12;12;0
407680;Last Days of Spring Visual Novel;RPG;20,000 - 50,000;72;50;22;228;258;0
407690;R.B.I. Baseball 16;Action, Adventure, Indie, RPG, Strategy;0 - 20,000;45;58;-13;0;0;0
407700;Lonath Online;Adventure, Casual, Simulation;0 - 20,000;9;26;-17;0;0;0
407710;The Grand Canyon VR Experience;Indie, Racing, Sports, Strategy, Early Access;0 - 20,000;48;23;25;49;49;0
407720;Poker Pretty Girls Battle: Texas Hold'em;Action, Adventure, Casual, Indie;20,000 - 50,000;95;99;-4;206;257;0
407720;Poker Pretty Girls Battle: Texas Hold'em;Adventure, Indie;20,000 - 50,000;95;99;-4;206;257;0
407810;Hard Reset Redux;Action, Indie;100,000 - 200,000;1589;364;1225;186;190;7
407830;Space Overlords;Adventure;0 - 20,000;6;21;-15;0;0;0
407840;Guardians of Orion (Phase 2);Adventure;200,000 - 500,000;1970;1685;285;110;71;1
407880;Mad Nords: Probably an Epic Quest;Casual, Indie;0 - 20,000;108;7;101;0;0;0
407900;Princess Remedy in a World of Hurt;Indie, Racing;200,000 - 500,000;2697;63;2634;73;103;2
407940;Hyper Bounce Blast;Casual, Indie, Strategy;20,000 - 50,000;76;5;71;328;330;0
407980;Sakura Beach 2;Action;50,000 - 100,000;455;138;317;232;323;3
408000;Cinderella Escape! R12;Indie, Strategy;20,000 - 50,000;301;85;216;0;0;1
408030;UniBall;Indie, Racing, Simulation, Sports;20,000 - 50,000;157;16;141;0;0;2
408030;UniBall;Action, Casual, Indie;20,000 - 50,000;157;16;141;0;0;2
408060;SAVAGE: The Shard of Gosen;Adventure, Free to Play, RPG, Strategy;0 - 20,000;57;6;51;0;0;0
408110;Planet R-12;Violent, Gore, Action, Free to Play;50,000 - 100,000;191;36;155;319;279;220
408120;Cibele;Adventure, Indie;50,000 - 100,000;644;637;7;34;34;0
408170;Networm;Casual, Indie;0 - 20,000;21;2;19;0;0;0
408240;Slime Jumper;Action, Indie;0 - 20,000;9;3;6;0;0;0
408250;Eagle Flight;Action, Massively Multiplayer, RPG;20,000 - 50,000;220;145;75;27;27;5
408280;Message Quest;Action, Simulation;50,000 - 100,000;736;112;624;0;0;0
408340;Gravity Lab;Simulation;0 - 20,000;32;7;25;0;0;0
408400;Swords and Sorcery - Underworld - Definitive Edition;Action, Casual;50,000 - 100,000;77;21;56;0;0;0
408410;X-Morph: Defense;Action, Adventure, Indie, RPG;200,000 - 500,000;2725;240;2485;431;294;22
408440;Dream Factory;Action, Adventure, RPG;20,000 - 50,000;17;69;-52;209;209;0
408520;FORM;Adventure, Casual, Simulation, Strategy;20,000 - 50,000;873;84;789;1;1;0
408640;Code of Princess;Action, Indie;50,000 - 100,000;164;128;36;54;54;0
408650;ChromaGun;Action, Indie, Sports, Early Access;20,000 - 50,000;431;78;353;463;463;1
408740;Pro Gamer Manager;Casual, Indie, Simulation;50,000 - 100,000;349;347;2;314;346;1
408750;Starsphere;Action, RPG;0 - 20,000;32;7;25;243;243;0
408750;Starsphere;Adventure;0 - 20,000;32;7;25;243;243;0
408760;Pro Cycling Manager 2016;Action, Strategy;50,000 - 100,000;251;131;120;0;0;15
408770;Highschool Possession;Indie, RPG;20,000 - 50,000;117;54;63;0;0;1
408860;Dead Stop;Strategy;0 - 20,000;4;3;1;0;0;0
408880;Heal Them All;Strategy;0 - 20,000;3;2;1;0;0;0
408900;Unfortunate Spacemen;Strategy;200,000 - 500,000;6167;919;5248;268;99;33
408920;Krai Mira: Extended Cut;Adventure, Indie, RPG;20,000 - 50,000;145;96;49;7;7;0
408930;ePic Character Generator;Adventure, Casual, Simulation, Strategy;200,000 - 500,000;861;162;699;53;76;1
408960;Zombasite;Casual, Indie;20,000 - 50,000;146;45;101;0;0;1
408990;Timber and Stone;Action, Indie;50,000 - 100,000;413;427;-14;188;188;1
409000;Mystery Chronicle: One Way Heroics;Strategy;50,000 - 100,000;230;140;90;36;36;15
409040;Herolike;Action, Adventure, Indie, Early Access;0 - 20,000;31;22;9;0;0;0
409070;Fist Slash: Of Ultimate Fury;Action, Adventure, RPG;20,000 - 50,000;51;24;27;117;117;0
409090;The Big Secret of a Small Town;Simulation, Strategy;20,000 - 50,000;73;39;34;0;0;0
409100;The Purring Quest;Simulation, Strategy;100,000 - 200,000;1222;239;983;31;55;3
409130;Demigods;Action;0 - 20,000;16;12;4;0;0;0
409160;Dr. Langeskov, The Tiger, and The Terribly Cursed Emerald: A Whirlwind Heist;Accounting;500,000 - 1,000,000;8656;605;8051;49;27;2
409170;Contract;Action;0 - 20,000;31;26;5;0;0;0
409280;Blue Sheep;Adventure;0 - 20,000;20;21;-1;0;0;1
409320;Syndrome;Action, Free to Play, Indie;20,000 - 50,000;191;109;82;307;307;1
409360;Faron's Fate;Violent, Gore, Action, Adventure, Indie, RPG, Early Access;0 - 20,000;28;13;15;0;0;1
409370;Monster RPG 2;Adventure, Casual, Simulation, Strategy;20,000 - 50,000;19;17;2;0;0;0
409380;Among the Heavens;Action;20,000 - 50,000;243;43;200;298;276;0
409390;Marble Mountain;Adventure, Casual, Simulation, Strategy;0 - 20,000;45;16;29;457;457;0
409410;Clumsy Moose Season;Casual, Indie;0 - 20,000;27;18;9;0;0;0
409420;Knight Adventure;Indie, RPG;20,000 - 50,000;24;32;-8;262;303;0
409450;The Fall of the Dungeon Guardians - Enhanced Edition;Adventure, Indie;50,000 - 100,000;486;91;395;20;20;10
409460;Blackfaun;Indie, RPG, Simulation, Strategy, Early Access;0 - 20,000;18;11;7;0;0;0
409490;Rogue Harvest;Adventure;0 - 20,000;39;28;11;0;0;0
409510;Genesis Online;Action, Casual, Simulation;200,000 - 500,000;610;1312;-702;37;51;0
409560;Run Rabbit Run;Action, Adventure, Indie;0 - 20,000;69;16;53;424;424;0
409580;No1Left;Casual, Indie, Simulation, Strategy;0 - 20,000;3;5;-2;0;0;0
409590;KINGDOMS;Adventure, Casual, Indie;100,000 - 200,000;2954;800;2154;466;561;6
409600;Contract With The Devil;Action, Indie;100,000 - 200,000;201;79;122;293;318;1
409610;One Final Chaos;Action, Adventure, Indie;0 - 20,000;11;0;11;0;0;0
409630;Rumble;Indie, Simulation;20,000 - 50,000;17;17;0;0;0;0
409660;Angry Video Game Nerd II: ASSimilation;Adventure, Indie;20,000 - 50,000;672;79;593;477;621;2
409670;Pink Hour;Simulation, Early Access;100,000 - 200,000;907;68;839;32;48;0
409690;Pink Heaven;Action;100,000 - 200,000;649;73;576;34;47;0
409710;BioShock Remastered;Adventure, Casual, Indie, Strategy;2,000,000 - 5,000,000;36697;9642;27055;373;186;734
409720;BioShock 2 Remastered;Casual;1,000,000 - 2,000,000;13913;6571;7342;432;177;283
409730;Death by Game Show;Adventure, Indie;0 - 20,000;90;28;62;3;3;0
409850;Criminal Girls: Invite Only;Action, Adventure, Indie;20,000 - 50,000;428;117;311;82;82;9
409870;Phantom Brave PC;Action, Adventure, Indie;50,000 - 100,000;448;67;381;180;207;7
409910;The Storm Guard: Darkness is Coming;Action, Adventure, Indie;50,000 - 100,000;128;35;93;0;0;2
409920;Brilliant Shadows - Part One of the Book of Gray Magic;Action, Adventure, Indie;20,000 - 50,000;183;9;174;62;62;0
410000;Chalo Chalo;Action;0 - 20,000;15;4;11;0;0;0
410040;Hope in Hell;Action, Indie;0 - 20,000;1;9;-8;0;0;0
410050;The Forgotten Forest;Indie, RPG, Strategy, Early Access;0 - 20,000;10;4;6;0;0;0
410110;12 is Better Than 6;Adventure, Free to Play, Indie;500,000 - 1,000,000;4920;917;4003;608;298;13
410120;AGON - The Mysterious Codex (Trilogy);Adventure, Casual;20,000 - 50,000;50;23;27;145;145;0
410130;AGON - The Lost Sword of Toledo;Adventure, Indie, RPG, Strategy;20,000 - 50,000;48;19;29;258;258;0
410150;Swapperoo;Action, Indie, Strategy, Early Access;0 - 20,000;61;3;58;0;0;1
410150;Swapperoo;Action, Adventure, Casual, Indie;0 - 20,000;61;3;58;0;0;1
410210;Ampersand;Action, Indie, Simulation, Early Access;500,000 - 1,000,000;337;695;-358;231;220;1
410290;Acorn Assault: Rodent Revolution;Action, Adventure, Indie, RPG;0 - 20,000;58;21;37;0;0;0
410290;Acorn Assault: Rodent Revolution;Adventure, Casual, Indie;0 - 20,000;58;21;37;0;0;0
410320;EARTH DEFENSE FORCE 4.1 The Shadow of New Despair;Free to Play, Indie, RPG, Strategy, Early Access;1,000,000 - 2,000,000;8030;425;7605;1522;715;192
410330;TurretCraft;Action, Adventure;0 - 20,000;7;3;4;0;0;0
410340;Liftoff: FPV Drone Racing;Action, Adventure, Casual, Indie;200,000 - 500,000;6169;420;5749;428;608;304
410370;Huenison;Action;0 - 20,000;9;1;8;0;0;0
410380;HEX: Shards of Fate;Action, Casual, Free to Play, Indie, Simulation, Strategy;200,000 - 500,000;1100;645;455;287;298;0
410390;Warhammer: Vermintide VR - Hero Trials;Action, Indie, Strategy;50,000 - 100,000;117;80;37;13;22;0
410430;Morphine;Adventure, Casual, Simulation, Strategy;50,000 - 100,000;480;179;301;171;184;0
410440;Vertigo Void;Action, Adventure, RPG, Early Access;0 - 20,000;36;8;28;0;0;1
410470;Expander;Indie, Simulation, Strategy;0 - 20,000;15;3;12;0;0;0
410490;Elements: Epic Heroes;Action, Free to Play, Massively Multiplayer, Racing, Early Access;0 - 20,000;17;19;-2;17;17;0
410540;Starlord;Action, Adventure, Casual;0 - 20,000;7;6;1;0;0;0
410550;Tank: M1A1 Abrams Battle Simulation;Indie, Strategy;0 - 20,000;10;4;6;1;1;0
410570;Gunjack;Casual, Indie, Strategy;0 - 20,000;179;47;132;45;45;0
410670;Suits: A Business RPG;Casual;100,000 - 200,000;783;103;680;184;262;2
410710;System Shock: Enhanced Edition;Action, Indie;200,000 - 500,000;1564;173;1391;275;186;14
410740;Flying Neko Delivery;Sports;0 - 20,000;11;5;6;0;0;2
410770;Roads of Rome;Action, Indie;0 - 20,000;65;12;53;0;0;2
410770;Roads of Rome;Action, Casual, Indie;0 - 20,000;65;12;53;0;0;2
410820;Starward Rogue;Casual, Early Access;50,000 - 100,000;430;38;392;828;1649;2
410830;ARENA GODS;Action, Indie;0 - 20,000;93;23;70;0;0;1
410840;Rock God Tycoon;Action, Indie;20,000 - 50,000;212;79;133;3448;3448;1
410840;Rock God Tycoon;Adventure, Indie;20,000 - 50,000;212;79;133;3448;3448;1
410850;DRAGON QUEST HEROES Slime Edition;Indie;100,000 - 200,000;856;410;446;659;818;3
410890;Higurashi When They Cry Hou - Ch.2 Watanagashi;Action, Indie;50,000 - 100,000;978;34;944;448;448;14
410900;Forts;Action, Indie, Strategy;500,000 - 1,000,000;13380;1227;12153;699;297;714
410910;Deathless: The City's Thirst;Action, Adventure;0 - 20,000;23;7;16;0;0;0
410970;Master of Orion 1;;100,000 - 200,000;266;26;240;0;0;77
410980;Master of Orion 2;;200,000 - 500,000;1144;45;1099;0;0;236
410990;Master of Orion 3;Action, Indie, Massively Multiplayer, Racing, Simulation, Sports;50,000 - 100,000;71;67;4;97;97;15
411000;Sorcery! Parts 1 and 2;Adventure, Casual, Simulation, Strategy;100,000 - 200,000;524;67;457;98;98;5
411060;Roads of Rome 2;Action, Casual, Indie;0 - 20,000;42;2;40;0;0;3
411070;Mass Vector;;0 - 20,000;2;2;0;0;0;0
411080;SHOWTIME 2073;Action, Adventure, RPG;50,000 - 100,000;214;78;136;4;4;0
411120;Galaxy Admirals;Action, Adventure;100,000 - 200,000;181;41;140;371;396;1
411130;Leviathan: the Cargo — Ongoing series;Action, RPG, Simulation, Early Access;0 - 20,000;36;27;9;0;0;0
411130;Leviathan: the Cargo — Ongoing series;Indie, RPG, Simulation;0 - 20,000;36;27;9;0;0;0
411300;ELEX;Action, Adventure, Casual, Free to Play, RPG;500,000 - 1,000,000;13153;4522;8631;1711;1332;286
411310;Codename: Panzers, Phase One;Adventure, Casual, Indie;50,000 - 100,000;312;31;281;0;0;6
411320;Codename: Panzers, Phase Two;Adventure;20,000 - 50,000;179;18;161;0;0;19
411330;Men of Valor;Adventure;100,000 - 200,000;351;158;193;370;477;7
411340;Quicken WillMaker Plus 2016;Adventure;0 - 20,000;1;0;1;0;0;0
411370;Melty Blood Actress Again Current Code;Action, Casual, Indie, Strategy;200,000 - 500,000;3468;265;3203;227;295;20
411390;Getsuei Gakuen -kou-;Adventure, Indie, Early Access;0 - 20,000;20;4;16;0;0;0
411480;BATTLECREW Space Pirates;Action, Indie;100,000 - 200,000;105;85;20;26;47;0
411520;State of Extinction;Action, Indie, Early Access;0 - 20,000;8;7;1;0;0;0
411530;Roads of Rome 3;Adventure, Casual, Indie;0 - 20,000;28;9;19;0;0;1
411540;Hybrid Wars;Action, Indie;20,000 - 50,000;148;71;77;11;11;0
411550;Island Tribe;Adventure, Casual, Free to Play;0 - 20,000;29;9;20;0;0;1
411560;Reveal The Deep;Action, Adventure, Indie;100,000 - 200,000;1201;231;970;10;19;1
411570;Zombie Exodus;Casual, Indie;0 - 20,000;135;20;115;0;0;2
411590;The Rivers of Alice - Extended Version;Action, Adventure, Indie, RPG, Strategy;0 - 20,000;76;19;57;0;0;0
411600;The Sentient;Indie;20,000 - 50,000;33;46;-13;0;0;0
411610;Tick's Tales;Action, Casual, Indie;0 - 20,000;56;11;45;0;0;0
411620;Pane In The Glass;Action, Adventure, Indie;0 - 20,000;21;13;8;0;0;0
411630;Wicked Witches;Violent, Action, Adventure, Indie, Simulation;0 - 20,000;8;7;1;0;0;0
411680;Loot Hound;Casual, Indie;0 - 20,000;70;11;59;0;0;1
411690;VROOM: Galleon;Action, Adventure, Indie, Early Access;0 - 20,000;22;12;10;0;0;0
411720;Quantum Lock;Adventure, Indie, Simulation, Strategy, Early Access;0 - 20,000;7;1;6;0;0;0
411740;Yet Another World;Adventure, Indie;50,000 - 100,000;53;16;37;413;400;2
411750;Brick Inventions;Casual, Indie, Simulation, Early Access;0 - 20,000;36;12;24;0;0;0
411760;Swordbreaker The Game;Adventure, Casual, Indie;50,000 - 100,000;334;61;273;132;132;0
411760;Swordbreaker The Game;Action, Adventure, Indie;50,000 - 100,000;334;61;273;132;132;0
411820;The FOO Show featuring Will Smith;Simulation, Strategy;20,000 - 50,000;134;21;113;22;22;0
411830;SENRAN KAGURA SHINOVI VERSUS;Action, Adventure, Indie, RPG;100,000 - 200,000;3492;195;3297;322;286;7
411860;Save the Creatures;Adventure, Indie, Simulation;20,000 - 50,000;1;0;1;0;0;0
411870;Discovering Colors - Animals;Action, Adventure, Indie;0 - 20,000;38;3;35;961;961;1
411880;Once';Indie, Strategy;0 - 20,000;103;9;94;0;0;0
411960;TY the Tasmanian Tiger;Action, Adventure, Indie;100,000 - 200,000;2307;45;2262;994;1317;16
411970;TY the Tasmanian Tiger 2;Action, Indie, Early Access;20,000 - 50,000;601;24;577;156;218;11
411980;TY the Tasmanian Tiger 3;Action, Adventure, Casual, Indie;0 - 20,000;147;20;127;1993;3457;1
412010;Crossbow Warrior - The Legend of William Tell;Action, Indie, RPG;0 - 20,000;21;14;7;0;0;0
412020;Metro Exodus;Free to Play, Massively Multiplayer, RPG;2,000,000 - 5,000,000;75371;9355;66016;1189;755;1386
412050;HordeZ;Violent, Gore, Action, Indie;20,000 - 50,000;333;64;269;0;0;0
412050;HordeZ;Action, Adventure, Indie;20,000 - 50,000;333;64;269;0;0;0
412170;City of Chains;Adventure, Casual;200,000 - 500,000;233;89;144;292;281;2
412210;Warfront Defenders;Sexual Content, Nudity, Violent, Gore, Action, Adventure, Indie;200,000 - 500,000;22;23;-1;244;259;0
412220;DDraceNetwork;Adventure, Indie, Simulation;500,000 - 1,000,000;10309;675;9634;0;0;1804
412230;Infinitrap Classic: Ohio Jack and The Cup Of Eternity;Adventure, Casual, Free to Play, Indie;20,000 - 50,000;55;17;38;211;211;0
412250;Empires Of Creation;Violent, Gore, Action, Adventure, RPG;0 - 20,000;15;16;-1;125;125;0
412250;Empires Of Creation;Casual, Indie, Racing, Simulation;0 - 20,000;15;16;-1;125;125;0
412270;Stories of Bethem: Full Moon;Action, Indie, Simulation, Strategy, Early Access;0 - 20,000;84;16;68;9;9;0
412290;The Dreamlord;Adventure, Indie, Racing, Early Access;200,000 - 500,000;72;111;-39;244;257;1
412310;Labyrinth;Indie, Simulation, Sports;50,000 - 100,000;184;91;93;11;11;0
412360;SightLineVR;Action, Adventure, Indie;0 - 20,000;35;4;31;14;14;0
412370;Parallels;Indie, RPG, Simulation, Strategy;0 - 20,000;11;8;3;210;210;0
412380;Legend (1994);Education, Software Training;0 - 20,000;47;25;22;202;202;1
412400;GASP;Violent, Action, Indie, Early Access;200,000 - 500,000;370;1271;-901;11;12;1
412410;Castle Chaos;Action, Indie, RPG;0 - 20,000;32;26;6;0;0;0
412440;Jane's Realty;English;0 - 20,000;9;5;4;0;0;0
412450;The Black Death;Action, Casual, Indie;20,000 - 50,000;1187;1018;169;374;167;1
412460;Villagers;Animation & Modeling, Design & Illustration, Education, Photo Editing, Software Training, Utilities, Video Production;50,000 - 100,000;163;153;10;0;0;5
412460;Villagers;Action;50,000 - 100,000;163;153;10;0;0;5
412470;Metal War Online: Retribution;Indie;200,000 - 500,000;563;425;138;42;24;2
412490;Yrminsul;Action, Indie, RPG;0 - 20,000;22;13;9;0;0;0
412520;Evil Defenders;Racing, Simulation, Sports, Strategy;100,000 - 200,000;294;71;223;258;365;3
412530;Atlantic Quest 2 - New Adventure -;Action, Casual, Indie;0 - 20,000;17;4;13;0;0;2
412540;The Minotaur;Casual, Free to Play, Massively Multiplayer, Strategy;20,000 - 50,000;36;17;19;242;242;0
412560;Pro Basketball Manager 2016 - US Edition;Sexual Content, Strategy;0 - 20,000;1;3;-2;0;0;0
412600;Lup;Adventure, Casual, Simulation, Strategy;200,000 - 500,000;156;195;-39;233;229;0
412620;CropDuster Supreme;Action, Indie;50,000 - 100,000;161;11;150;70;116;0
412640;Immerse Creator;Adventure, Casual, Simulation, Strategy;0 - 20,000;2;1;1;0;0;0
412660;Klang;Casual, Indie;0 - 20,000;87;31;56;0;0;0
412670;Bullet Heaven 2;Action, Casual;20,000 - 50,000;404;6;398;241;241;1
412730;Days Under Custody;RPG, Strategy;20,000 - 50,000;51;96;-45;198;198;0
412740;Audioshield;Casual, Indie;100,000 - 200,000;2216;532;1684;318;446;1
412760;Revolve;Action;0 - 20,000;10;0;10;39;39;0
412770;Boogeyman;Racing, Simulation, Sports;50,000 - 100,000;460;108;352;56;56;0
412790;Adventure Time: Magic Man's Head Games;Adventure;50,000 - 100,000;156;54;102;0;0;0
412830;STEINS;Violent, Action, Free to Play, Massively Multiplayer, Strategy;;;;0;;;
412880;Drift Streets Japan;Adventure, Indie, Strategy;500,000 - 1,000,000;2207;1235;972;407;169;4
412930;Farm Mania: Hot Vacation;Action, Adventure, Casual, Indie, Racing, Simulation;0 - 20,000;52;4;48;246;246;2
412970;Beatbuddy: On Tour;Casual, Strategy;0 - 20,000;15;9;6;0;0;0
412970;Beatbuddy: On Tour;Adventure, Casual;0 - 20,000;15;9;6;0;0;0
413010;Conflicks - Revolutionary Space Battles Demo;Indie;0 - 20,000;0;0;0;0;0;0
413030;Mytheon;Free to Play, Indie, Massively Multiplayer, RPG, Strategy, Early Access;0 - 20,000;60;57;3;289;289;0
413040;Eekeemoo - Splinters of the Dark Shard;Action, Indie, Sports;0 - 20,000;4;2;2;0;0;0
413110;Hero's Song;Action, Indie, RPG;0 - 20,000;112;76;36;0;0;0
413150;Stardew Valley;Action, Indie;10,000,000 - 20,000,000;533848;9732;524116;3386;1455;42392
413170;Metal Assault;Casual, Indie, Strategy;100,000 - 200,000;173;128;45;27;32;0
413350;Daydream Blue;Indie, RPG, Strategy;0 - 20,000;0;2;-2;0;0;0
413410;Danganronpa: Trigger Happy Havoc;Action, Adventure, Casual, Indie, Simulation;500,000 - 1,000,000;23966;936;23030;1214;1036;1023
413420;Danganronpa 2: Goodbye Despair;Casual, Indie;500,000 - 1,000,000;20881;773;20108;1551;1241;736
413470;Where Angels Cry 2: Tears of the Fallen Collector's Edition;Adventure, Indie;0 - 20,000;24;6;18;0;0;0
413480;101 Ways to Die;Casual, Indie;0 - 20,000;30;9;21;272;272;0
413490;Rothschild: The Sheep Will Wake;Casual, Indie, RPG, Simulation, Early Access;0 - 20,000;6;4;2;0;0;0
413500;Rocket Fist;Action, Indie, Simulation, Early Access;0 - 20,000;61;9;52;0;0;0
413540;Recourse;Casual, Free to Play, Indie, RPG, Simulation, Strategy;0 - 20,000;15;0;15;0;0;0
413580;Reverse x Reverse;Action, Free to Play, Indie, Strategy;0 - 20,000;22;1;21;0;0;0
413620;Space Needle VR;Action, Adventure, Indie, RPG;0 - 20,000;12;14;-2;0;0;0
413650;The Invasion of Area 51;Action, Adventure, Casual, Indie, RPG, Simulation, Strategy;0 - 20,000;1;0;1;0;0;0
413680;Statues;Action, Adventure, Indie, Simulation, Strategy;20,000 - 50,000;176;84;92;296;296;1
413700;Run Turn Die;Action, Indie, Simulation;0 - 20,000;19;3;16;0;0;0
413710;Blood and Gold: Caribbean!;Action, Indie;100,000 - 200,000;728;480;248;1077;1458;5
413740;Mines of Mars;Indie;0 - 20,000;31;25;6;10;10;0
413750;Turtle VR;Action, Adventure, Indie, Simulation;0 - 20,000;1;0;1;0;0;0
413760;Go To Bed: Survive The Night;Action, Adventure, Massively Multiplayer, Simulation, Early Access;0 - 20,000;14;23;-9;0;0;0
413830;Overdosed - A Trip To Hell;Indie, RPG, Strategy, Early Access;0 - 20,000;10;6;4;0;0;0
413870;Sickness;Action, Adventure;0 - 20,000;117;11;106;0;0;0
414060;iso-Sphere;Action, Indie;0 - 20,000;10;13;-3;0;0;0
414060;iso-Sphere;Indie, Simulation;0 - 20,000;10;13;-3;0;0;0
414080;Life is Hard;Adventure, Casual, Indie;100,000 - 200,000;368;193;175;298;352;1
414090;The Warden;Indie, Simulation, Strategy;0 - 20,000;11;8;3;0;0;0
414120;Modbox;Indie, RPG, Simulation;200,000 - 500,000;188;28;160;156;199;0
414140;Jewel bits;Action, Adventure, Indie, Early Access;0 - 20,000;1;4;-3;0;0;0
414160;Nubarron: The adventure of an unlucky gnome;Adventure, Indie;50,000 - 100,000;434;253;181;0;0;2
414190;Junk Jack;Adventure, Early Access;20,000 - 50,000;345;97;248;258;258;2
414260;Ironclads 2: American Civil War;Action, Indie;0 - 20,000;34;14;20;0;0;0
414330;We Are Chicago;Adventure, Casual, Strategy;0 - 20,000;11;17;-6;0;0;0
414340;Hellblade: Senua's Sacrifice;Adventure, Casual, Strategy;1,000,000 - 2,000,000;49673;4767;44906;286;171;86
414370;Raining Blobs;Action;0 - 20,000;76;12;64;355;387;0
414470;Nightmare on Azathoth;Adventure, Casual, Simulation, Strategy;0 - 20,000;16;14;2;101;101;0
414490;Crashnauts;Indie, Racing, Sports;0 - 20,000;30;3;27;0;0;1
414500;Caribbean Odyssey;Adventure, Indie, Simulation;0 - 20,000;1;14;-13;0;0;0
414510;5089: The Action RPG;Adventure, Casual;20,000 - 50,000;264;52;212;289;360;1
414530;Skyforge;Action, Indie;500,000 - 1,000,000;2444;1669;775;587;183;86
414550;Death Toll;Action, Indie, Early Access;100,000 - 200,000;199;80;119;196;385;0
414580;Uriel's Chasm 2: את;Indie, Strategy;200,000 - 500,000;122;237;-115;197;203;0
414660;Vampire Legends: The True Story of Kisilova;Free to Play, Indie, Massively Multiplayer, RPG, Strategy;50,000 - 100,000;497;81;416;172;217;3
414660;Vampire Legends: The True Story of Kisilova;Action, Indie, Racing;50,000 - 100,000;497;81;416;172;217;3
414700;Outlast 2;Action, Indie;1,000,000 - 2,000,000;37584;3693;33891;299;193;276
414720;Astrox: Hostile Space Excavation;Action, Adventure, Casual, Indie, Simulation, Strategy;20,000 - 50,000;362;67;295;0;0;0
414730;Epic Clicker Journey;Action, Adventure, Indie, RPG;100,000 - 200,000;453;220;233;24;32;0
414740;RAID: World War II;Action, Adventure, Indie;100,000 - 200,000;1102;978;124;327;371;5
414760;Blue-Collar Astronaut;Casual, Indie, Simulation;0 - 20,000;17;4;13;0;0;0
414770;Bionite: Origins;Indie, RPG;0 - 20,000;1;6;-5;0;0;0
414810;Observatory: A VR Variety Pack;Free to Play, Strategy, Early Access;0 - 20,000;8;1;7;0;0;0
414870;Super Mega Baseball 2;Action, Indie, Strategy;100,000 - 200,000;910;117;793;3578;3735;4
414920;Corgi Warlock;Indie;20,000 - 50,000;273;69;204;277;268;1
414950;Star Nomad 2;Action, Indie, Sports;50,000 - 100,000;109;45;64;0;0;0
415000;Gamer To Game Developer Series 3: Make A Game;Action, Indie, Simulation, Sports;0 - 20,000;44;0;44;26;26;0
415010;The Other 99;Adventure, Casual, Indie, RPG, Simulation;0 - 20,000;42;49;-7;0;0;0
415030;One More Dungeon;Casual, Indie;50,000 - 100,000;490;146;344;130;250;0
415080;Cyber Team Manager;Action, Indie, RPG;0 - 20,000;29;53;-24;0;0;0
415090;KByte;Action, Casual, Strategy;0 - 20,000;27;2;25;0;0;1
415140;PD Howler 10;Action, Adventure, Indie;0 - 20,000;15;1;14;2;2;0
415150;Pang Adventures;Indie;50,000 - 100,000;288;72;216;225;268;2
415170;Engare;Action, Casual, Indie;20,000 - 50,000;374;18;356;111;111;0
415180;Fort Zombie;Casual, Indie, Simulation;0 - 20,000;82;20;62;0;0;1
415200;Motorsport Manager;Adventure, Indie;500,000 - 1,000,000;11149;1010;10139;4031;2325;480
415240;Feesh;Action, Casual, Indie;0 - 20,000;103;30;73;45;66;0
415270;Star Crusade CCG;Adventure, Indie;100,000 - 200,000;1514;366;1148;54;60;0
415300;Monster Monpiece;Adventure, Indie;50,000 - 100,000;267;99;168;237;237;1
415330;When In Rome;Action, Adventure, Indie, Simulation, Early Access;0 - 20,000;12;4;8;0;0;0
415350;Shooting Stars!;Action, Adventure, Indie, RPG;50,000 - 100,000;745;131;614;377;204;3
415390;Viking Saga: The Cursed Ring;Casual, Indie;0 - 20,000;41;9;32;0;0;0
415400;Cross Set;Action, Adventure, Indie, RPG, Strategy;0 - 20,000;160;36;124;923;923;0
415420;Nyan Cat: Lost In Space;Adventure, Indie;20,000 - 50,000;1577;125;1452;328;486;4
415480;Hyperdevotion Noire: Goddess Black Heart (Neptunia);Adventure, Casual, Simulation, Strategy;100,000 - 200,000;726;177;549;441;655;3
415530;Fly, Glowfly!;Racing;0 - 20,000;14;4;10;0;0;0
415590;Earthfall;Action, Adventure, Casual;50,000 - 100,000;1455;781;674;210;321;3
415600;Kart Racing Pro;Utilities;0 - 20,000;277;47;230;0;0;81
415610;Red Comrades Save the Galaxy: Reloaded;Action, Adventure, Indie;50,000 - 100,000;619;44;575;31;46;4
415670;Highrise Heroes: Word Challenge;Adventure, Casual;0 - 20,000;100;10;90;500;719;2
415740;OmniBus;Adventure, Casual, Free to Play, Indie, Simulation;20,000 - 50,000;383;88;295;404;569;2
415830;Gnomes Garden;Adventure, Casual, Indie;20,000 - 50,000;260;34;226;291;319;2
415840;Mystic Saga;Action, Free to Play, Indie;100,000 - 200,000;137;90;47;214;279;0
415850;BAD END;Adventure, Casual, Indie;20,000 - 50,000;301;60;241;228;228;1
415850;BAD END;Violent, Action, Massively Multiplayer, Simulation, Sports;20,000 - 50,000;301;60;241;228;228;1
415860;Tactical Craft Online;Violent, Action, Adventure, Indie;200,000 - 500,000;557;600;-43;22;27;0
415880;Disc Jam;Action, Indie;200,000 - 500,000;1195;366;829;235;299;0
415890;Crystal Picnic;Adventure, Indie, RPG, Simulation;0 - 20,000;15;11;4;0;0;0
415900;Bugspeed Collider;Indie, Early Access;0 - 20,000;4;1;3;0;0;0
415910;Gigachess;Action, Early Access;0 - 20,000;74;12;62;0;0;0
415920;Voidspire Tactics;Casual, Indie;20,000 - 50,000;222;7;215;145;145;0
415950;Yohjo Simulator;Action;0 - 20,000;143;119;24;0;0;0
415960;Energy Cycle;Action, Casual, Indie, Racing, Simulation;200,000 - 500,000;186;81;105;218;231;7
415980;Quatro Luzes;Casual, Indie;0 - 20,000;8;3;5;0;0;0
415990;Lightbender;Casual, Free to Play, Indie, Strategy, Early Access;0 - 20,000;19;4;15;0;0;0
416000;Orange Season;Action, Adventure, Indie, RPG;0 - 20,000;251;44;207;0;0;0
416020;Heavy Gear Assault;Action, Indie;20,000 - 50,000;83;159;-76;170;170;0
416030;Your Quest;Casual, Strategy;50,000 - 100,000;89;62;27;236;236;0
416030;Your Quest;Indie, Racing, Simulation, Sports;50,000 - 100,000;89;62;27;236;236;0
416060;Westboro;Action, Indie, RPG;50,000 - 100,000;187;81;106;328;328;1
416080;The Odyssey: Winds of Athena;Casual, Indie, RPG;100,000 - 200,000;338;196;142;186;186;1
416090;Caretaker Retribution;Action, Adventure, Indie;0 - 20,000;4;2;2;0;0;0
416110;Blitz Breaker;Indie, Strategy;0 - 20,000;119;14;105;157;182;0
416120;InterSection;Simulation, Strategy;0 - 20,000;6;2;4;0;0;0
416130;Written in the Sky;Action, Racing, Sports;100,000 - 200,000;1655;469;1186;39;66;0
416160;Heresy;Action, Adventure, Indie;0 - 20,000;1;2;-1;0;0;0
416180;Gun Bombers;Action, Adventure, Indie;0 - 20,000;39;5;34;59;59;0
416190;Vehicle Simulator;Software Training;0 - 20,000;212;30;182;0;0;15
416200;Door To Door;Action, Adventure, Indie;20,000 - 50,000;23;21;2;99;152;0
416210;Block'hood;Casual, Indie, RPG;100,000 - 200,000;919;325;594;100;163;2
416220;The Light Empire;Action, Adventure, Indie;0 - 20,000;1;11;-10;0;0;0
416240;Space Impossible;Action, Indie;0 - 20,000;118;7;111;0;0;2
416250;Tales [PC];Action, Adventure;20,000 - 50,000;57;14;43;156;156;0
416260;The Lost Island;Action, Adventure, Indie, RPG, Strategy, Early Access;50,000 - 100,000;18;47;-29;2;2;0
416290;Bleeding Border;Adventure, Casual, Indie;100,000 - 200,000;61;85;-24;322;360;0
416310;Goblin Defenders: Steel‘n’ Wood;Action, Massively Multiplayer, Simulation, Strategy;50,000 - 100,000;72;42;30;179;179;4
416330;Revolt;Indie;0 - 20,000;6;6;0;0;0;0
416340;Viking Saga: New World;Action, Indie;0 - 20,000;26;5;21;0;0;0
416360;Max's Big Bust - A Captain Nekorai Tale;Action, Indie, Early Access;20,000 - 50,000;112;4;108;0;0;0
416370;Showing Tonight: Mindhunters Incident;Action;20,000 - 50,000;48;35;13;360;379;0
416380;The Hurricane of the Varstray -Collateral hazard-;Action;50,000 - 100,000;144;48;96;0;0;0
416390;Magnetron;Action, Adventure, Indie;0 - 20,000;3;4;-1;0;0;0
416430;In The Dead Of Night - Urszula's Revenge;Indie, RPG, Simulation, Strategy, Early Access;0 - 20,000;4;4;0;0;0;0
416450;Emporea: Realms of War and Magic;Casual, Indie, Simulation, Early Access;100,000 - 200,000;312;158;154;36;52;73
416530;Tacopocalypse;Nudity, Violent, Gore, Adventure, Indie;0 - 20,000;61;8;53;0;0;0
416550;Rubber Ducky and the Rainbow Gun;Action, Adventure, Casual, Indie;20,000 - 50,000;155;12;143;201;208;2
416590;Emily Wants To Play;Action, Casual;100,000 - 200,000;1431;384;1047;35;55;11
416600;Full Metal Furies;Action, Indie;200,000 - 500,000;2295;215;2080;719;1070;143
416610;The Growth Journey;Simulation;0 - 20,000;38;23;15;266;233;0
416630;True Lover's Knot;Action, Indie;20,000 - 50,000;48;72;-24;238;247;2
416640;Diabolical;Action, Indie, RPG, Early Access;0 - 20,000;94;26;68;14;14;0
416670;Gunslingers;Education;50,000 - 100,000;182;165;17;0;0;0
416680;Zombie Night Terror;Adventure, Indie;200,000 - 500,000;2820;215;2605;550;188;24
416690;Oh...Sir! Prototype;Action, RPG, Simulation, Strategy;100,000 - 200,000;768;75;693;30;36;1
416700;5 Minutes Rage - Hatred Edition;Action, Indie;50,000 - 100,000;19;9;10;0;0;0
416720;Toro;Action, Adventure, Indie, Strategy;0 - 20,000;38;17;21;0;0;0
416720;Toro;Action, Casual, Indie;0 - 20,000;38;17;21;0;0;0
416760;Pay2Win: The Tricks Exposed;Action, Indie, Early Access;0 - 20,000;78;51;27;0;0;0
416770;SquareCells;Adventure, Indie, RPG;50,000 - 100,000;895;82;813;228;378;3
416790;The Metronomicon: Slay The Dance Floor;RPG, Sports, Strategy;20,000 - 50,000;315;53;262;153;178;2
416800;Cluck Yegger in Escape From The Planet of The Poultroid;Simulation;0 - 20,000;42;19;23;0;0;0
416800;Cluck Yegger in Escape From The Planet of The Poultroid;Simulation, Early Access;0 - 20,000;42;19;23;0;0;0
416830;Light Fall;Adventure, Indie;0 - 20,000;99;14;85;0;0;0
416840;Color By;Action, Adventure, Indie;0 - 20,000;5;1;4;0;0;0
416850;Astral Gun;Casual;0 - 20,000;12;2;10;0;0;0
416870;Kitty Powers' Love Life;Casual, Indie;0 - 20,000;158;19;139;272;272;5
417020;REalM: Walk of Soul;Education;0 - 20,000;6;1;5;0;0;0
417060;UnSummoning: the Spectral Horde;Action, Indie;0 - 20,000;21;8;13;0;0;0
417060;UnSummoning: the Spectral Horde;Action, Casual, Indie;0 - 20,000;21;8;13;0;0;0
417110;Mayjasmine Episode01 - What is God?;Adventure, Indie;20,000 - 50,000;226;98;128;225;225;0
417150;Pavilion;Adventure;0 - 20,000;89;40;49;0;0;1
417200;Make Sail;Action, Adventure, Indie, RPG;0 - 20,000;56;45;11;0;0;0
417290;Ghost of a Tale;Adventure, Indie, RPG, Strategy;200,000 - 500,000;3888;323;3565;276;417;25
417310;Hiragana Pixel Party;Action, Casual, Indie, Strategy, Early Access;0 - 20,000;16;8;8;0;0;0
417350;Monkey King Saga;Action, Adventure, Indie;0 - 20,000;1;8;-7;0;0;0
417400;LeftWay;Adventure, Indie;0 - 20,000;26;9;17;0;0;0
417410;Northern Tale;Adventure, Casual, Indie;0 - 20,000;48;2;46;0;0;0
417430;Moto Racer  4;Simulation, Sports;200,000 - 500,000;656;405;251;384;436;2
417480;Marcus Level;Simulation, Strategy;0 - 20,000;21;14;7;35;35;0
417540;Gamefuel Driver Control;Action, Adventure, Indie;20,000 - 50,000;8;6;2;0;0;0
417750;Left Alone;Indie, Simulation;50,000 - 100,000;453;150;303;239;269;3
417840;Mysterious Castle;Adventure, Casual, Indie;0 - 20,000;2;12;-10;0;0;0
417860;Emily is Away;Action, Indie, Sports, Early Access;1,000,000 - 2,000,000;27318;3502;23816;96;44;14
417880;Everybody's Gone to the Rapture;Action, Indie;50,000 - 100,000;1013;442;571;770;1471;1
417890;Apotheon Arena;Action, Indie, Racing;200,000 - 500,000;873;178;695;136;155;3
417900;Upwards, Lonely Robot;Violent, Action, Indie;0 - 20,000;29;2;27;0;0;0
417910;Street Warriors Online;Adventure, RPG;10,000,000 - 20,000,000;960;703;257;172;31;1
417920;Mistfal;Action, Casual, Indie, Simulation, Sports, Early Access;20,000 - 50,000;27;30;-3;0;0;0
417980;Planet Diver;Action, Adventure, Casual, Indie;0 - 20,000;46;11;35;0;0;0
417990;Major\Minor;Action, Free to Play, Indie, Massively Multiplayer;20,000 - 50,000;335;82;253;291;421;1
418000;Demented;Casual, Indie;20,000 - 50,000;62;21;41;215;229;17
418030;Subsistence;Action, Indie;200,000 - 500,000;8218;2980;5238;823;311;614
418040;hocus;Adventure, Free to Play, Indie, Early Access;20,000 - 50,000;654;62;592;135;201;0
418050;FALL;Action, Indie, Early Access;0 - 20,000;7;2;5;0;0;0
418060;Battle Riders;Indie, Simulation, Strategy;20,000 - 50,000;119;55;64;45;45;2
418070;Turbo Pug;Adventure, Casual, Indie, RPG;1,000,000 - 2,000,000;3071;311;2760;237;229;3
418110;March of War: FaceOff - XL;Adventure, Casual, Indie, Early Access;50,000 - 100,000;117;46;71;0;0;0
418120;Cally's Caves 3;Adventure, Indie, Simulation;20,000 - 50,000;414;100;314;304;336;2
418150;The Madness of Little Emma;Indie, Strategy;20,000 - 50,000;116;28;88;0;0;0
418160;Garden Rescue: Christmas Edition;Adventure, Casual, Indie;20,000 - 50,000;54;12;42;221;213;0
418170;MicroRC Simulation;Racing, Simulation, Sports;0 - 20,000;7;2;5;0;0;0
418180;Tempest: Pirate Action RPG;Strategy;200,000 - 500,000;1668;709;959;96;82;15
418190;Helen's Mysterious Castle;Casual, Indie, Simulation;20,000 - 50,000;700;53;647;296;296;2
418240;Shadow Tactics: Blades of the Shogun;Adventure, Indie;1,000,000 - 2,000,000;32014;1270;30744;558;130;312
418260;Gumball Drift;Action, Casual, Indie, Strategy;0 - 20,000;11;9;2;0;0;0
418270;Draw Slasher;Adventure, Indie, Early Access;100,000 - 200,000;418;406;12;39;26;581
418280;Retaliation;Adventure, Casual, Indie;0 - 20,000;31;63;-32;0;0;0
418290;Professor Teaches QuickBooks 2016;Casual, Indie, Strategy;0 - 20,000;1;1;0;0;0;0
418300;Wick;Action, Indie, RPG;50,000 - 100,000;520;93;427;3549;6938;1
418310;Chronicles of a Dark Lord: Rhapsody Clash;Action, Indie;0 - 20,000;18;12;6;277;284;0
418340;RWBY: Grimm Eclipse;Strategy;500,000 - 1,000,000;9326;2168;7158;499;241;7
418360;Gurgamoth;Adventure, RPG;0 - 20,000;75;16;59;270;270;1
418370;Resident Evil 7 Biohazard;Adventure;2,000,000 - 5,000,000;64660;3457;61203;1386;592;700
418440;Tick Tock Isle;Indie;50,000 - 100,000;261;37;224;272;272;2
418460;Rising Storm 2: Vietnam;Indie, RPG;1,000,000 - 2,000,000;44794;7121;37673;1783;738;650
418520;SculptrVR;Action, RPG, Early Access;0 - 20,000;88;8;80;0;0;0
418530;Spelunky 2;Adventure, Casual, Simulation;500,000 - 1,000,000;15397;1110;14287;2462;1015;604
418610;Swiftly;Free to Play, Indie, RPG, Simulation;20,000 - 50,000;70;65;5;351;328;0
418620;The TakeOver;Sexual Content, Nudity, Adventure, Casual;20,000 - 50,000;725;122;603;108;208;3
418640;Iron Commando - Koutetsu no Senshi;Nudity, Casual;0 - 20,000;29;22;7;6;6;0
418650;Space Pirate Trainer;;200,000 - 500,000;2598;151;2447;166;212;8
418670;Pankapu;Adventure, Indie;50,000 - 100,000;262;77;185;0;0;0
418910;Idle Civilization;Adventure, Casual, Indie;0 - 20,000;92;86;6;0;0;1
418940;Waba;Adventure, Casual, Indie, RPG, Strategy;0 - 20,000;12;6;6;0;0;0
418950;DreadOut: Keepers of The Dark;Casual, Indie;100,000 - 200,000;767;200;567;106;165;3
418960;Catorize;Action, Adventure, Casual, Indie, Strategy;0 - 20,000;5;15;-10;372;396;0
419000;Relic Alone;Action, Casual, Simulation;0 - 20,000;3;2;1;0;0;0
419020;Wishmere;Indie, RPG, Strategy;0 - 20,000;20;8;12;0;0;0
419080;Bridge Constructor Stunts;Adventure, Indie;20,000 - 50,000;85;49;36;33;49;0
419090;Vector Strain;Action, Indie;20,000 - 50,000;47;16;31;210;210;0
419130;Strength of the Sword ULTIMATE;Action, Indie, RPG;0 - 20,000;90;18;72;0;0;1
419450;Resume Maker for Windows;Indie, Simulation;0 - 20,000;1;8;-7;0;0;0
419460;That Dragon, Cancer;Action, Indie, Sports;50,000 - 100,000;1218;127;1091;0;0;1
419480;Starpoint Gemini Warlords;RPG, Simulation;200,000 - 500,000;2445;873;1572;705;638;22
419500;Red Game Without A Great Name;Simulation, Sports;20,000 - 50,000;69;9;60;384;472;0
419700;AT SUNDOWN: Shots in the Dark;Indie, RPG, Strategy, Early Access;20,000 - 50,000;28;15;13;0;0;0
419710;Rogue Singularity;Action, Adventure, Casual, Indie;0 - 20,000;14;1;13;0;0;0
419810;House of Hell (Standalone);Indie, Simulation, Strategy;0 - 20,000;43;4;39;0;0;0
419990;Ganbare! Super Strikers;Action, Indie, Strategy;0 - 20,000;60;11;49;0;0;0
420000;Home Design 3D;Casual, Indie, Simulation, Strategy, Early Access;100,000 - 200,000;1678;455;1223;202;343;95
420020;Eye of the Owl - Bosch VR;Action, Adventure, Indie, RPG;20,000 - 50,000;71;6;65;0;0;0
420060;Candle;Action, Indie, Early Access;100,000 - 200,000;774;214;560;1;1;3
420070;Kill The Plumber;Indie, Racing;0 - 20,000;69;33;36;0;0;0
420100;CLANNAD Side Stories;Strategy;20,000 - 50,000;247;31;216;191;381;0
420110;NEKOPARA Vol. 2;Casual, Free to Play, Indie, Simulation;500,000 - 1,000,000;11955;356;11599;2243;153;19
420130;AnyTime Organizer Standard 15;Casual, Indie, Racing;0 - 20,000;1;0;1;0;0;0
420140;Stack Gun Heroes;Action, Adventure, Indie, RPG, Strategy;0 - 20,000;0;0;0;0;0;0
420160;Alphabeats: Master Edition;Adventure, Casual, Indie;0 - 20,000;9;5;4;0;0;0
420170;Shrug Island - The Meeting;Action, Indie, RPG;0 - 20,000;15;4;11;0;0;0
420180;Chronicle of Innsmouth;Casual, Indie, Sports, Early Access;20,000 - 50,000;146;38;108;3809;3809;0
420210;KRUM - Edge Of Darkness;Violent, Action, Adventure, Indie, Simulation;50,000 - 100,000;79;95;-16;209;335;33
420270;Into the Void;Indie, Simulation, Strategy;20,000 - 50,000;80;49;31;218;218;2
420290;Blackwake;Indie, Simulation, Strategy;200,000 - 500,000;19790;4336;15454;385;132;21
420330;HEIST;Indie, Simulation, Strategy;0 - 20,000;18;6;12;0;0;0
420360;Spectrum;Action, Indie, Massively Multiplayer, RPG, Early Access;20,000 - 50,000;52;11;41;293;293;0
420370;Gravity Island;Action, Indie;0 - 20,000;12;2;10;0;0;0
420380;The Strike;Action, Adventure, Indie;0 - 20,000;24;4;20;0;0;0
420440;Atlantic Fleet;Indie, RPG;50,000 - 100,000;1128;193;935;23415;23415;50
420500;Rynn's Adventure: Trouble in the Enchanted Forest;Action, Casual, Indie, Simulation, Strategy;0 - 20,000;13;4;9;0;0;0
420520;Lost Technology;Casual, Indie;20,000 - 50,000;425;68;357;200;200;4
420530;OneShot;Action;500,000 - 1,000,000;33398;604;32794;292;278;78
420550;Super Arcade Football;Action, Indie;0 - 20,000;131;54;77;8;8;1
420560;Firefighting Simulator - The Squad;Indie, RPG;200,000 - 500,000;3282;758;2524;411;435;74
420570;Cubixx HD;Indie, RPG;0 - 20,000;30;3;27;0;0;0
420660;Burnin' Rubber 5 HD;Action, Casual, Indie, Simulation;20,000 - 50,000;227;29;198;0;0;2
420670;Elite vs. Freedom;Casual, Indie, Strategy;0 - 20,000;31;49;-18;52;76;0
420740;The Deed;Simulation, Strategy;200,000 - 500,000;2416;260;2156;239;174;7
420770;The Legend of Dark Witch;Adventure, Indie;20,000 - 50,000;173;61;112;184;184;1
420790;StarBreak;Adventure, Casual, Simulation, Strategy;200,000 - 500,000;951;262;689;308;16;75
420840;BLARP!;Action, Adventure, Casual, Indie, Racing, Simulation;20,000 - 50,000;165;9;156;0;0;0
420850;Cosmic Leap;Action, Indie, RPG, Strategy;50,000 - 100,000;90;38;52;211;219;8
420880;I must kill...: Fresh Meat;Casual, Indie;50,000 - 100,000;72;181;-109;0;0;0
420900;Mech Anarchy;Casual, Indie, RPG, Simulation;0 - 20,000;13;4;9;0;0;0
420910;Store Manager: Cellular Edition;Action, Adventure, Casual, Indie, RPG, Simulation, Strategy;0 - 20,000;21;52;-31;0;0;0
420920;Lost Labyrinth Extended Version;Action, Casual, Indie;0 - 20,000;36;23;13;53;53;1
420930;CHKN;Action, Indie, Early Access;0 - 20,000;963;262;701;425;491;11
420950;Time Tenshi (2015);Action, RPG;0 - 20,000;85;28;57;2;2;0
420970;RoBoRumble;Casual, Indie;500,000 - 1,000,000;115;80;35;337;353;1
420980;Army Gals;Action, Adventure, Casual, Indie, Strategy;0 - 20,000;205;22;183;0;0;0
421020;DiRT 4;Adventure, Indie, RPG, Simulation;500,000 - 1,000,000;12367;3131;9236;683;257;133
421040;Plantera;Action, Adventure, Indie, RPG, Strategy, Early Access;200,000 - 500,000;4571;590;3981;232;251;18
421050;Deponia Doomsday;Indie, Simulation, Strategy;200,000 - 500,000;2952;467;2485;327;345;28
421060;Age of Steel: Recharge;Action, Casual, Indie;100,000 - 200,000;173;76;97;313;248;0
421110;AWAKE;Action, Casual, Indie;0 - 20,000;13;27;-14;0;0;0
421120;Samorost 3;Casual, Free to Play, Indie;200,000 - 500,000;3777;211;3566;144;178;12
421140;Blades of the Righteous;Free to Play, Massively Multiplayer, RPG, Strategy, Early Access;0 - 20,000;16;9;7;0;0;0
421170;Indivisible;Action, Adventure, Casual, Indie, RPG;100,000 - 200,000;2149;815;1334;606;914;16
421180;Umbra: Shadow of Death;Action, Adventure;0 - 20,000;7;6;1;0;0;0
421190;Larcenauts;Action, Adventure;0 - 20,000;145;57;88;63;63;0
421260;Militia;Adventure, Casual, Indie, RPG;0 - 20,000;129;5;124;0;0;0
421600;Ray Gigant;Action, Indie, Simulation, Early Access;0 - 20,000;57;46;11;0;0;0
421610;XBlaze Code: Embryo;Action, Indie;0 - 20,000;70;23;47;215;215;0
421620;Dissonance: An Interactive Novelette;RPG, Strategy;0 - 20,000;7;4;3;0;0;0
421630;A Study in Steampunk: Choice by Gaslight;Simulation;0 - 20,000;161;6;155;0;0;2
421660;Harmonia;Action, Adventure, Indie, RPG, Strategy;0 - 20,000;530;23;507;407;407;1
421660;Harmonia;Casual, Indie;0 - 20,000;530;23;507;407;407;1
421670;CUPID - A free to play Visual Novel;Action, Indie;100,000 - 200,000;1085;161;924;221;221;2
421670;CUPID - A free to play Visual Novel;Adventure, Indie, RPG, Strategy;100,000 - 200,000;1085;161;924;221;221;2
421700;Sakura Santa;Indie;100,000 - 200,000;545;88;457;361;375;0
421710;Space Live - Advent of the Net Idols;Action, Free to Play, Indie;0 - 20,000;50;10;40;0;0;0
421730;Block N Load PTR;Indie, RPG, Early Access;0 - 20,000;0;0;0;0;0;0
421740;Goetia;Adventure, Casual, Indie;100,000 - 200,000;517;149;368;147;192;1
421790;The Bradwell Conspiracy;Action, Adventure, Indie, RPG, Early Access;0 - 20,000;52;28;24;0;0;0
421810;OH! RPG!;Action, Casual, Indie;100,000 - 200,000;272;97;175;277;219;80
421870;Quatros Origins;Action, Adventure, Indie;0 - 20,000;20;7;13;0;0;0
421880;Plastiland;Casual, Indie;0 - 20,000;63;28;35;261;261;0
421890;Avaris 2: The Return of the Empress;Action;0 - 20,000;31;24;7;0;0;0
421900;Shadowrun Chronicles: INFECTED Director's Cut;Free to Play, Massively Multiplayer, Simulation, Strategy;0 - 20,000;29;27;2;2517;2517;0
421900;Shadowrun Chronicles: INFECTED Director's Cut;Action, Indie;0 - 20,000;29;27;2;2517;2517;0
422010;Eczema Angel Orifice;Adventure;0 - 20,000;11;0;11;0;0;0
422020;Dark Days;Adventure, Indie, Simulation, Strategy;20,000 - 50,000;35;14;21;0;0;0
422030;ReVeN: XBridge;Adventure, Casual, Indie, RPG, Strategy;0 - 20,000;8;6;2;0;0;0
422110;Wand Wars;Action;20,000 - 50,000;195;11;184;22;38;0
422110;Wand Wars;Adventure, Indie;20,000 - 50,000;195;11;184;22;38;0
422130;Comic Book Hero: The Greatest Cape;Casual, Indie;100,000 - 200,000;60;71;-11;0;0;1
422140;Wrestling Spirit 3;Action, Casual, Indie;0 - 20,000;35;42;-7;0;0;0
422140;Wrestling Spirit 3;Action, Casual, Indie;0 - 20,000;35;42;-7;0;0;0
422210;Rise of Keepers;Action, Adventure;0 - 20,000;16;16;0;0;0;0
422250;ShipLord;Action;500,000 - 1,000,000;360;300;60;246;268;1
422270;City Play;Action, Adventure, Indie, RPG, Early Access;0 - 20,000;8;24;-16;0;0;0
422300;Element;Action, Indie;0 - 20,000;28;11;17;16;16;1
422420;Godus Wars;Action, Indie, Strategy, Early Access;50,000 - 100,000;86;482;-396;2609;2609;1
422500;Emmerholt: Prologue;Sports;20,000 - 50,000;76;22;54;12;12;0
422510;DEMON'S TILT;Action, Adventure;50,000 - 100,000;662;37;625;0;0;4
422590;Wacky Wheels HD;Action, Indie;0 - 20,000;12;64;-52;0;0;0
422610;1775: Rebellion;Casual, Indie, Simulation, Early Access;20,000 - 50,000;59;50;9;355;355;1
422630;Metaverse Construction Kit;Action, Adventure, Indie, Racing;100,000 - 200,000;152;72;80;143;143;0
422640;VR Karts SteamVR;Action, Indie;0 - 20,000;17;29;-12;0;0;0
422650;Megamagic: Wizards of the Neon Age;Adventure, RPG, Strategy;20,000 - 50,000;69;20;49;113;159;0
422760;Ocean Rift;Utilities;20,000 - 50,000;95;26;69;0;0;5
422810;River City Ransom: Underground;Adventure, Indie;100,000 - 200,000;1769;568;1201;223;250;4
422860;Holodance;Adventure, Indie;0 - 20,000;186;30;156;0;0;0
422890;22 Racing Series | RTS-Racing;Action, Indie;0 - 20,000;12;5;7;0;0;1
422900;Particle Fleet: Emergence;Action;50,000 - 100,000;966;76;890;452;457;63
422910;Creeper World: Anniversary Edition;Casual, Sports;20,000 - 50,000;646;20;626;408;408;27
422920;Creeper World 2: Anniversary Edition;Casual, Indie;20,000 - 50,000;317;30;287;365;365;34
422940;Divergence: Online;Casual, Indie;0 - 20,000;70;56;14;0;0;0
422970;Devil Daggers;Action, Indie, RPG;200,000 - 500,000;7608;356;7252;93;54;32
422980;Super Robot Jump Jump;Action, Casual, Indie;0 - 20,000;23;6;17;0;0;0
423120;Community College Hero: Trial by Fire;Action, Indie, Sports, Early Access;0 - 20,000;214;33;181;0;0;1
423180;A.I. Space Corps;Indie;0 - 20,000;6;15;-9;0;0;0
423220;T-Kara Puzzles;Action, Indie;0 - 20,000;20;2;18;0;0;2
423230;Furi;Indie, Simulation;200,000 - 500,000;9505;957;8548;450;286;34
423270;ZHEROS;Simulation;0 - 20,000;31;11;20;0;0;0
423320;Pendragon Rising;Indie;0 - 20,000;75;20;55;0;0;0
423440;Choice of Kung Fu;Adventure, Indie, RPG;0 - 20,000;41;3;38;0;0;0
423490;Air Missions: HIND;Action, Indie, RPG;20,000 - 50,000;442;112;330;0;0;4
423550;Day D: Tower Rush;Action, Indie;100,000 - 200,000;178;59;119;270;297;2
423580;Project Highrise;Action, Indie, RPG, Strategy, Early Access;200,000 - 500,000;3299;609;2690;485;466;55
423590;The Little Acre;Action, Adventure, Indie, Early Access;50,000 - 100,000;693;92;601;0;0;2
423600;Adelantado Trilogy. Book one;Adventure, Indie, Simulation;0 - 20,000;43;3;40;0;0;2
423610;Where's My Mommy?;Adventure, Indie;0 - 20,000;129;38;91;0;0;0
423620;HERO DEFENSE;Indie, RPG;50,000 - 100,000;444;245;199;316;457;1
423650;Summer Fling;Casual, Free to Play, Massively Multiplayer, Sports, Strategy;0 - 20,000;64;37;27;99;99;0
423700;Apocalypse Hotel - The Post-Apocalyptic Hotel Simulator!;Adventure, Indie, RPG, Simulation, Strategy, Early Access;50,000 - 100,000;27;49;-22;1;1;0
423710;Invasion: Brain Craving;Action, Adventure;500,000 - 1,000,000;129;175;-46;259;244;0
423720;Color Chaos;Casual, Indie;0 - 20,000;25;5;20;199;199;0
423730;Hyper Gods;Adventure, Casual, Indie;0 - 20,000;11;1;10;0;0;0
423740;Save Your Mother;Action, Indie, Early Access;20,000 - 50,000;34;16;18;240;262;0
423750;Gardenarium;Casual, Indie, Simulation, Sports;0 - 20,000;31;10;21;0;0;0
423760;Hit Tank PRO;Indie, Strategy;0 - 20,000;75;45;30;224;321;0
423770;Our Love Will Grow;Simulation;20,000 - 50,000;102;47;55;207;228;0
423780;Zero Gravity;Action, Adventure;0 - 20,000;10;6;4;0;0;0
423800;Automata Empire;Action, Adventure, Strategy;0 - 20,000;38;15;23;64;64;0
423810;Marooners;Indie, Simulation, Strategy;100,000 - 200,000;430;232;198;156;249;0
423870;Astervoid 2000;Action, Free to Play, Strategy;0 - 20,000;39;11;28;0;0;0
423880;Carpe Diem;Action, RPG;200,000 - 500,000;7422;880;6542;14;15;3
423890;Gods and Idols;Indie, Simulation, Strategy;100,000 - 200,000;518;212;306;37;69;0
423900;Dinocide;Strategy;20,000 - 50,000;115;102;13;5;5;1
423910;Mangavania;Indie, RPG, Strategy;0 - 20,000;4;3;1;0;0;0
423950;Deadlight: Director's Cut;Action, Adventure;100,000 - 200,000;870;350;520;70;90;3
424000;Project Pulsation;Casual, Indie, Simulation, Strategy, Early Access;50,000 - 100,000;72;100;-28;357;390;7
424010;Crudelis;Adventure, Casual;0 - 20,000;20;6;14;0;0;5
424030;War of Rights;Indie, Strategy;500,000 - 1,000,000;7925;1206;6719;1254;838;845
424040;Fragmental;Action, Adventure, Indie, Strategy;0 - 20,000;22;4;18;0;0;0
424060;The Glow;Action, Adventure;0 - 20,000;8;16;-8;0;0;0
424100;Celestrion;Adventure, Indie;0 - 20,000;7;2;5;0;0;0
424170;The fall of gods;Action, RPG;20,000 - 50,000;41;11;30;314;321;0
424210;SodaCity;Action, RPG;0 - 20,000;13;3;10;0;0;0
424250;Balrum;Action, Casual, Indie;20,000 - 50,000;414;116;298;47;47;2
424260;Feelings Adrift;;0 - 20,000;53;31;22;0;0;0
424280;Iron Snout;Action, Indie;2,000,000 - 5,000,000;16623;374;16249;133;53;27
424310;Blessed Ones: The Magic Wolves;Adventure, Casual, Indie, Strategy;0 - 20,000;1;0;1;0;0;0
424320;Anomaly 1729;Indie;0 - 20,000;29;6;23;0;0;0
424370;Wolcen: Lords of Mayhem;Strategy;2,000,000 - 5,000,000;36031;27831;8200;2558;1543;418
424590;Farm Expert 2017;Adventure, Casual, Indie;100,000 - 200,000;313;369;-56;2418;2452;1
424610;Peasant Knight;Action, Adventure, Indie, Early Access;0 - 20,000;3;1;2;0;0;0
424640;Karaski: What Goes Up...;Action, Casual, Indie;50,000 - 100,000;47;7;40;16;16;0
424750;The BoX;Adventure, Casual, Indie, RPG, Strategy;0 - 20,000;11;1;10;0;0;0
424760;Bladestar;Adventure, Indie, RPG;20,000 - 50,000;62;25;37;203;228;0
424780;Imperia Online;Action, Adventure, Indie, RPG, Simulation, Strategy, Early Access;100,000 - 200,000;142;112;30;0;0;9
424830;Bell Ringer;Action, Indie, Strategy;100,000 - 200,000;98;313;-215;223;267;0
424840;Little Nightmares;Adventure, Indie;2,000,000 - 5,000,000;82177;4564;77613;180;79;372
424850;Galactineers;Indie, RPG;0 - 20,000;11;13;-2;0;0;0
424870;Threads of Destiny;Indie, RPG;20,000 - 50,000;20;11;9;101;105;4
425010;ScudBuster;Indie;0 - 20,000;1;1;0;0;0;0
425040;ComixPlay #1: The Endless Incident;Action, Indie, Sports;0 - 20,000;18;0;18;332;332;0
425070;Asteroids Minesweeper;Action, Adventure, Casual, Indie, RPG, Strategy;0 - 20,000;49;11;38;0;0;0
425150;Assassins vs Pirates;Adventure, Casual;0 - 20,000;59;21;38;3;3;0
425160;Recursion Deluxe;Adventure, Indie;20,000 - 50,000;68;11;57;147;147;0
425210;Shadwen;Indie, Massively Multiplayer, RPG;100,000 - 200,000;919;288;631;348;348;2
425220;One Piece Burning Blood;Action, Indie, Racing, Simulation, Sports;100,000 - 200,000;3005;753;2252;531;248;42
425230;Sword 'N' Board;Adventure, Indie, RPG, Strategy;0 - 20,000;14;17;-3;0;0;0
425240;Pressure Overdrive;Action, Adventure, Indie;20,000 - 50,000;97;37;60;211;211;1
425260;Soul Harvest;Action, Adventure, Casual, Indie;0 - 20,000;12;3;9;0;0;0
425300;Super Button Soccer;Action, Indie;0 - 20,000;67;30;37;0;0;0
425310;Ghostbusters;Action, Indie;0 - 20,000;20;23;-3;0;0;0
425340;Space Moth DX;Adventure, Casual;20,000 - 50,000;102;19;83;0;0;0
425400;Block Rocking Beats;Adventure, Casual;0 - 20,000;4;3;1;0;0;0
425410;Road to Ballhalla;Adventure, Casual;20,000 - 50,000;343;47;296;20;36;0
425450;GoatPunks;Adventure, Casual;0 - 20,000;20;11;9;0;0;0
425460;Tokyo Twilight Ghost Hunters Daybreak: Special Gigs;Animation & Modeling, Design & Illustration, Video Production;20,000 - 50,000;46;34;12;0;0;1
425560;CyberLink Power2Go 10 Platinum;Indie, RPG, Simulation, Strategy;0 - 20,000;3;0;3;0;0;0
425580;The Room Two;Adventure, Indie;200,000 - 500,000;15523;349;15174;234;205;58
425600;The Order of the Thorne - The King's Challenge;Action, Adventure, Indie;20,000 - 50,000;111;15;96;0;0;0
425650;Halloween Forever;Action, Adventure, Indie;0 - 20,000;150;12;138;0;0;0
425670;Seraph;Casual, Indie, Strategy;50,000 - 100,000;430;109;321;231;245;1
425720;Cloudlands : VR Minigolf;Action, Indie;0 - 20,000;255;49;206;98;101;0
425760;EGO Protocol;Casual;0 - 20,000;9;4;5;0;0;0
425770;Answer The Question;Action, Indie;0 - 20,000;137;3;134;0;0;0
425820;Dragonpath;Casual, Indie;0 - 20,000;79;20;59;14;14;0
425860;Vector Assault;Action, Adventure, Indie;0 - 20,000;5;6;-1;0;0;0
425870;Gyrodisc Super League;Action, Adventure, Indie;0 - 20,000;7;5;2;0;0;0
425900;Adventure Lamp;Indie, Strategy, Early Access;0 - 20,000;20;3;17;0;0;0
425990;Space Junk Patrol;Gore, Indie;0 - 20,000;2;0;2;0;0;0
426000;HunieCam Studio;Action, Adventure, Indie;200,000 - 500,000;5198;776;4422;289;231;77
426010;Womb Room;Indie, Simulation, Strategy;0 - 20,000;19;34;-15;0;0;0
426040;Goodnight Butcher;Action, Indie;0 - 20,000;28;26;2;212;212;0
426050;LEGIE;Action, Adventure, Indie, RPG;0 - 20,000;76;5;71;0;0;0
426170;Defragmented;Action, Casual, Indie;0 - 20,000;28;15;13;0;0;0
426190;Miner Meltdown;Audio Production, Education, Software Training, Video Production, Web Publishing;20,000 - 50,000;102;33;69;25;42;0
426210;Tyran;Casual, Indie;0 - 20,000;28;28;0;0;0;0
426240;Caretaker Sacrifice;Adventure, Indie;0 - 20,000;18;2;16;0;0;0
426290;The Away Team: Lost Exodus;Sexual Content, Nudity, Violent, Gore, Adventure, Free to Play, Indie, RPG;20,000 - 50,000;65;20;45;290;290;0
426310;Perception;Adventure, Indie, RPG;20,000 - 50,000;395;152;243;336;542;0
426330;MetaHuman Inc.;Action, Casual, Indie;0 - 20,000;136;15;121;0;0;1
426560;Full Tilt Poker;Action;50,000 - 100,000;42;50;-8;1;1;0
426590;Blood of Magic;Action, Adventure, Casual, Indie;50,000 - 100,000;32;45;-13;0;0;0
426630;Bubsy Two-Fur;Action, Indie, Massively Multiplayer;0 - 20,000;295;126;169;178;243;0
426690;Narcissu 10th Anniversary Anthology Project;Action, Adventure, Casual, Indie;50,000 - 100,000;511;13;498;677;841;1
426790;Grow Up;Action, Adventure, Indie, RPG;100,000 - 200,000;1432;134;1298;328;460;8
426930;Moonshot;Action, Adventure, Casual, Indie, RPG, Strategy, Early Access;0 - 20,000;85;11;74;0;0;0
427030;Xuan-Yuan Sword: The Gate of Firmament;Action, Indie;20,000 - 50,000;1011;378;633;318;318;16
427040;Pitstop Challenge;Action, Indie, Simulation, Early Access;0 - 20,000;4;22;-18;0;0;0
427050;Siege - the card game;Casual, Indie, Strategy;0 - 20,000;8;5;3;0;0;0
427100;Fernbus Simulator;Action, Indie;500,000 - 1,000,000;6194;2291;3903;978;812;237
427190;DEAD RISING;Action, Indie;200,000 - 500,000;4026;522;3504;339;183;57
427240;Cosmic Trip;Racing, Simulation, Sports;20,000 - 50,000;436;76;360;49;96;0
427250;8-Bit Armies;Action, Indie;200,000 - 500,000;1823;401;1422;252;250;11
427270;Orcs Must Die! Unchained;Action, Casual, Indie;1,000,000 - 2,000,000;4200;1935;2265;293;76;2
427290;Vampyr;Action, Adventure, Indie;500,000 - 1,000,000;13994;4264;9730;875;590;122
427470;Democracy 3 Africa;Action, Casual, Indie;50,000 - 100,000;284;101;183;532;532;3
427480;FritzChess 15;Casual, Indie;0 - 20,000;48;32;16;0;0;7
427490;Shadowhand: RPG Card Game;Casual;0 - 20,000;603;120;483;692;989;13
427510;Way of the Samurai 3;Casual, Free to Play, Indie, Simulation;50,000 - 100,000;410;107;303;128;128;26
427520;Factorio;Action, Indie, Sports;5,000,000 - 10,000,000;156545;5889;150656;7711;3415;15441
427550;Tibetan Quest: Beyond the World's End;Action, Indie;50,000 - 100,000;133;74;59;0;0;1
427570;Dawn of Andromeda;Action, Casual, Indie, Sports, Strategy;0 - 20,000;104;123;-19;34;34;0
427640;The Ables: Freepoint High;Casual, Indie, Strategy;0 - 20,000;18;6;12;0;0;0
427660;NightCry;Action, Adventure, Indie, Early Access;100,000 - 200,000;158;107;51;225;225;0
427680;Zwei: The Arges Adventure;Adventure, Indie;20,000 - 50,000;283;61;222;416;481;3
427700;Zwei: The Ilvard Insurrection;Indie, Early Access;0 - 20,000;512;35;477;730;730;4
427730;Who's Your Daddy?!;Action, Adventure, Casual, Indie;2,000,000 - 5,000,000;20903;5339;15564;164;92;199
427760;A Chair in a Room : Greenwater;Simulation;;;;0;;;
427770;Pills4Skills;Simulation;0 - 20,000;48;4;44;224;224;0
427780;PERFECT ANGLE: The puzzle game based on optical illusions;Free to Play, Massively Multiplayer, Strategy;100,000 - 200,000;255;76;179;243;304;0
427810;CALENDULA;Adventure;20,000 - 50,000;269;80;189;42;42;0
427820;Hitman GO: Definitive Edition;Adventure;200,000 - 500,000;1656;293;1363;79;63;2
427830;Hybrid Beasts;Adventure, Casual;0 - 20,000;4;2;2;0;0;0
427860;The Next World;Adventure, Casual;20,000 - 50,000;78;30;48;0;0;0
427880;P.A.M.E.L.A.;Indie, RPG, Strategy;20,000 - 50,000;529;343;186;178;178;1
427890;Felt Tip Circus;Action, RPG;0 - 20,000;20;8;12;0;0;0
427910;Zavix Tower;Free to Play, Indie, Massively Multiplayer, Strategy;50,000 - 100,000;253;89;164;32;32;2
427930;Army of Tentacles: (Not) A Cthulhu Dating Sim;Action, Indie;200,000 - 500,000;46;39;7;245;227;0
427940;Industries of Titan;Action, Adventure, Indie;50,000 - 100,000;901;385;516;374;503;104
427950;The Withering;Adventure, Indie;20,000 - 50,000;183;176;7;0;0;1
427950;The Withering;Indie, Sports;20,000 - 50,000;183;176;7;0;0;1
427970;Heathen Engineering's Terran;Action, Adventure, Free to Play, Indie, Massively Multiplayer, RPG, Early Access;0 - 20,000;5;10;-5;0;0;0
427980;Aozora Meikyuu;Action, Indie, Simulation;100,000 - 200,000;418;110;308;337;387;0
428020;The ORPHEUS Ruse;Adventure, Casual, Indie;0 - 20,000;5;3;2;0;0;0
428040;Sixth Grade Detective;Action, Adventure, Indie;0 - 20,000;30;2;28;9;9;1
428060;Millia -The ending-;Adventure;0 - 20,000;29;4;25;0;0;0
428080;Racket: Nx;Adventure, Indie, Early Access;20,000 - 50,000;473;18;455;148;235;2
428100;Beyond Reality;Casual, Indie, Simulation, Sports, Strategy;50,000 - 100,000;124;24;100;215;215;9
428110;Save Halloween: City of Witches;Casual, Indie, Simulation, Strategy;20,000 - 50,000;26;14;12;0;0;0
428130;Walk The Light;Action, Indie;0 - 20,000;3;0;3;0;0;0
428170;Little Reaper;Indie;0 - 20,000;13;2;11;0;0;0
428180;Islet Online;Violent, Action, Indie;20,000 - 50,000;369;103;266;258;258;20
428190;MadOut Open City;Action, Indie, Racing;20,000 - 50,000;94;156;-62;0;0;0
428200;Attack Heroes;Indie;0 - 20,000;158;69;89;0;0;0
428200;Attack Heroes;Casual, Indie, Strategy;0 - 20,000;158;69;89;0;0;0
428210;Horror in the Asylum;Action;0 - 20,000;19;30;-11;0;0;0
428220;TurnOn;Action;20,000 - 50,000;287;58;229;307;307;0
428230;Swift;Adventure, Indie;0 - 20,000;5;1;4;0;0;0
428240;Hauntsters;Audio Production;0 - 20,000;2;0;2;0;0;0
428250;Mystery Castle: The Mirror's Secret;Violent, Gore, Indie, Strategy;20,000 - 50,000;42;24;18;0;0;0
428270;Twilight City: Love as a Cure;Casual, Indie, Simulation;20,000 - 50,000;54;29;25;2;2;0
428280;Mystery of Unicorn Castle: The Beastmaster;Audio Production;20,000 - 50,000;71;12;59;0;0;0
428350;Fear Equation;Indie, Strategy;20,000 - 50,000;65;20;45;0;0;0
428370;Windlands;Indie, RPG, Simulation;50,000 - 100,000;657;190;467;194;301;1
428410;PRiO;Action, Indie;0 - 20,000;27;2;25;0;0;0
428430;Endorlight;Action, Adventure, Indie;500,000 - 1,000,000;827;530;297;238;263;38
428440;Chasing Dead;Adventure, Indie, Strategy;20,000 - 50,000;139;85;54;0;0;0
428460;Kings of Israel;Casual, Indie, Sports, Early Access;0 - 20,000;73;10;63;0;0;2
428460;Kings of Israel;Action, Indie, Strategy;0 - 20,000;73;10;63;0;0;2
428490;Germination;Adventure, Indie;;;;0;;;
428510;Solitaire Christmas. Match 2 Cards;Adventure, Indie;100,000 - 200,000;83;30;53;189;265;94
428530;Machine Gun Train Run;Action, Indie;0 - 20,000;22;11;11;137;272;0
428540;Fragments of Him;Casual;0 - 20,000;111;20;91;0;0;0
428550;Momodora: Reverie Under The Moonlight;Action, Indie, RPG;500,000 - 1,000,000;9284;602;8682;271;169;17
428590;Unearthing Colossal;Action, Adventure, Indie, Early Access;0 - 20,000;10;18;-8;7;7;0
428610;Longsword - Tabletop Tactics;Casual, Indie, Simulation;0 - 20,000;76;63;13;0;0;0
428630;White Mirror;Casual, Indie, Simulation;20,000 - 50,000;190;156;34;264;272;2
428660;Deliver Us The Moon;Action, Casual, Indie;200,000 - 500,000;5300;648;4652;318;357;44
428690;Youtubers Life;Action, Indie, Early Access;500,000 - 1,000,000;9734;3093;6641;1485;716;79
428740;Nordenfelt;Adventure, Casual, Indie;0 - 20,000;7;14;-7;0;0;0
428740;Nordenfelt;Adventure, RPG, Strategy, Early Access;0 - 20,000;7;14;-7;0;0;0
428750;Neon Chrome;Action, Free to Play, Indie;200,000 - 500,000;1009;88;921;313;369;4
428760;Hatch and Slay;Adventure, Casual, Indie, Simulation;20,000 - 50,000;25;22;3;211;211;0
428800;liteCam Game 5:  120 FPS Game Capture + Streamer;Adventure, Casual, Free to Play, Indie;0 - 20,000;37;54;-17;952;952;0
428830;Save the Dodos;Action, Indie;20,000 - 50,000;146;19;127;259;259;0
428860;Red Haze;Utilities, Early Access;20,000 - 50,000;144;25;119;0;0;0
428870;Take the Dream IX;Action, Indie, Racing;50,000 - 100,000;131;38;93;0;0;0
428880;The Quest;Racing, Simulation, Sports;20,000 - 50,000;377;57;320;0;0;4
428900;Linea, the Game;Action, Adventure, Indie;100,000 - 200,000;843;129;714;191;225;6
428910;Red Fox and the Four Seasons;Action, Indie;0 - 20,000;10;5;5;0;0;0
428920;WinKings;Action, Casual, Indie, Simulation;0 - 20,000;12;5;7;0;0;0
428930;Into the Belly of the Beast;Action, Adventure, Indie;0 - 20,000;8;0;8;0;0;0
428940;CONTASION 2;Strategy;0 - 20,000;3;7;-4;0;0;0
428950;Kivi, Toilet and Shotgun;Indie, RPG, Strategy;500,000 - 1,000,000;249;240;9;229;231;0
428980;Ethereal Legends;Adventure, Indie;0 - 20,000;5;15;-10;0;0;0
429020;LONE WOLF: Horizon;Animation & Modeling, Design & Illustration, Game Development;20,000 - 50,000;21;58;-37;25;25;0
429020;LONE WOLF: Horizon;Action, Adventure, Indie;20,000 - 50,000;21;58;-37;25;25;0
429040;Furfly;Casual, Indie, Strategy;0 - 20,000;16;4;12;0;0;0
429050;Feed and Grow: Fish;Casual, Indie, Simulation, Strategy, Early Access;500,000 - 1,000,000;9628;2605;7023;1190;986;357
429060;Zombie Wars: Invasion;Indie, RPG, Strategy;50,000 - 100,000;70;57;13;224;234;0
429120;Zamarian;Action, Adventure, Indie;0 - 20,000;24;10;14;622;622;0
429160;Cyborg Rage;Adventure, Indie, RPG;0 - 20,000;13;8;5;0;0;0
429160;Cyborg Rage;Adventure, Casual, Indie;0 - 20,000;13;8;5;0;0;0
429180;Project CARS - Pagani Edition;Casual, Indie, Strategy;200,000 - 500,000;939;527;412;32;19;10
429200;Super Helmets on Fire DX Ultra Edition Plus Alpha;Action, Adventure, Indie, RPG;0 - 20,000;31;18;13;174;174;0
429220;FullBlast;Action, Casual, Indie;20,000 - 50,000;56;20;36;0;0;0
429250;Beyond Dimensions;Action, Indie, Sports;0 - 20,000;18;6;12;300;300;0
429260;Super Intergalactic Gang;Indie;0 - 20,000;22;2;20;0;0;0
429270;Didgery;Animation & Modeling, Design & Illustration, Utilities;0 - 20,000;9;1;8;0;0;0
429280;Gems of the Aztecs;Action, Indie;100,000 - 200,000;123;50;73;276;307;112
429300;Sepia Tears;Casual, Indie, RPG, Simulation;100,000 - 200,000;785;101;684;88;93;0
429330;Stikbold! A Dodgeball Adventure;Simulation;50,000 - 100,000;371;51;320;99;145;1
429350;Satellite Rush;Animation & Modeling, Design & Illustration, Utilities, Early Access;20,000 - 50,000;45;10;35;166;166;0
429390;XenoShyft;Adventure, Casual, Indie;20,000 - 50,000;71;32;39;0;0;0
429430;Tyrfing  Cycle |Vanilla|;Adventure, Indie;0 - 20,000;9;27;-18;0;0;0
429470;Space Pilgrim Episode I: Alpha Centauri;Action, Adventure, Casual, Indie, RPG, Early Access;200,000 - 500,000;1029;142;887;226;212;1
429480;Vision Runner;Adventure, Indie;0 - 20,000;4;7;-3;0;0;0
429490;Resilience Wave Survival;Casual, Indie;20,000 - 50,000;112;71;41;0;0;1
429520;Falcon Gold;Action, Indie, RPG;0 - 20,000;21;5;16;115;155;0
429530;Falcon 4.0;Adventure, Indie;20,000 - 50,000;146;27;119;161;161;2
429530;Falcon 4.0;Indie, Simulation, Strategy, Early Access;20,000 - 50,000;146;27;119;161;161;2
429540;Prime World: Defenders 2;Action, Casual, Indie;200,000 - 500,000;1550;399;1151;194;194;41
429570;The Walking Dead: Michonne - A Telltale Miniseries;Indie, Simulation, Sports;500,000 - 1,000,000;5046;1339;3707;409;188;10
429580;A Wild Catgirl Appears!;Action, Casual, Indie;50,000 - 100,000;152;121;31;288;256;0
429600;Fairy Tale Mysteries: The Puppet Thief;Free to Play, Indie, Massively Multiplayer, RPG, Strategy;50,000 - 100,000;203;115;88;208;230;1
429610;The Emerald Maiden: Symphony of Dreams;Sports;50,000 - 100,000;367;68;299;153;153;2
429620;Dungeon Rushers;Audio Production;20,000 - 50,000;734;431;303;356;359;1
429660;Tales of Berseria;Adventure, RPG, Strategy;1,000,000 - 2,000,000;14829;1274;13555;2238;1069;199
429680;Spellweaver;Indie;200,000 - 500,000;1004;342;662;72;98;5
429690;Astro Duel;RPG, Strategy;0 - 20,000;66;3;63;0;0;0
429700;Squirbs;Action, Indie, Early Access;50,000 - 100,000;280;143;137;172;196;0
429720;IMSCARED;Action, Adventure, Indie, RPG, Early Access;100,000 - 200,000;1601;126;1475;32;46;6
429780;Bunny Hop League;Adventure, Indie, RPG, Early Access;50,000 - 100,000;522;189;333;181;348;1
429790;AdventureQuest 3D;Adventure, Indie;200,000 - 500,000;6546;1594;4952;247;87;317
429830;Unseen Diplomacy;Action, Indie, Early Access;20,000 - 50,000;139;17;122;74;74;0
429940;The Sad Story of Emmeline Burns;Casual, Indie;100,000 - 200,000;678;66;612;71;84;0
429950;ABO MANDO;Indie, Strategy, Early Access;50,000 - 100,000;25;52;-27;292;319;0
430020;Dance of Death;Action, Adventure, Indie, RPG;20,000 - 50,000;196;110;86;221;221;1
430070;Never Again;Action, Adventure, Indie;20,000 - 50,000;559;132;427;125;125;0
430070;Never Again;Action, Casual, Indie;20,000 - 50,000;559;132;427;125;125;0
430080;Elysium: Blood Games;Action, Adventure, Indie, RPG, Strategy;50,000 - 100,000;75;51;24;210;211;1
430100;darkcase : the basement;Action, Adventure, Indie, Early Access;0 - 20,000;19;10;9;34;34;0
430170;Babel: Choice;Adventure, Casual;20,000 - 50,000;73;36;37;124;124;0
430190;Wondershot;Adventure, Casual;0 - 20,000;19;3;16;0;0;0
430210;Megaton Rainfall;Action, Indie;100,000 - 200,000;1173;462;711;132;209;11
430230;Grass Max;Adventure, Indie;0 - 20,000;14;4;10;0;0;0
430240;Duplexer;Action, Indie, Strategy;0 - 20,000;8;5;3;0;0;0
430280;Nature Defenders;Action, Adventure, Indie, RPG, Early Access;0 - 20,000;5;4;1;0;0;0
430290;Shmups Skill Test シューティング技能検定;Action, Racing;0 - 20,000;46;3;43;0;0;0
430300;MINUS ZERO;Action, Adventure, Indie, RPG;0 - 20,000;7;8;-1;0;0;0
430410;Memoranda;Action, Casual, Indie, Strategy;20,000 - 50,000;110;38;72;272;272;1
430890;Rytmik Player;Action, Indie;20,000 - 50,000;43;10;33;0;0;0
430930;Z. Year One;Adventure, Casual;0 - 20,000;30;11;19;0;0;0
430960;Lucy -The Eternity She Wished For-;Sexual Content, Nudity, Adventure, Indie;200,000 - 500,000;7133;364;6769;230;258;8
431030;The Music Room;Indie;0 - 20,000;0;2;-2;0;0;0
431120;Tethered;Indie;0 - 20,000;168;34;134;32;32;2
431180;WolfQuest: Classic;Action, Massively Multiplayer, Simulation;50,000 - 100,000;1443;134;1309;37;37;13
431200;Disastr_Blastr;Action, Adventure, Indie, Simulation, Early Access;20,000 - 50,000;41;5;36;543;610;0
431220;Porradaria 2: Pagode of the Night;Action, Adventure, Casual, Indie, Simulation;50,000 - 100,000;107;87;20;107;118;0
431230;Tiny Guardians;Indie, RPG, Strategy;0 - 20,000;126;28;98;0;0;0
431240;Golf With Your Friends;Strategy;2,000,000 - 5,000,000;49303;5915;43388;719;396;992
431250;Mushroom Wars;Strategy;200,000 - 500,000;410;118;292;504;985;2
431260;Cursed;Action, Adventure, RPG;50,000 - 100,000;503;123;380;451;458;0
431280;tiny & Tall: Gleipnir;Action, Adventure, RPG;0 - 20,000;160;6;154;0;0;0
431290;Level 22: Gary’s Misadventures - 2016 Edition;Action, Adventure, Indie, Simulation;0 - 20,000;33;16;17;0;0;0
431300;Classic Fun Collection 5 in 1;Action, Casual, Free to Play;0 - 20,000;11;7;4;0;0;0
431300;Classic Fun Collection 5 in 1;Adventure, Casual;0 - 20,000;11;7;4;0;0;0
431330;Dungeons Are Random;Action, Adventure, Indie;0 - 20,000;10;16;-6;0;0;0
431330;Dungeons Are Random;Adventure, Indie, RPG;0 - 20,000;10;16;-6;0;0;0
431360;The Legend: A University Story;Action, RPG;0 - 20,000;10;7;3;0;0;0
431370;Diorama No.3 : The Marchland;Adventure, Strategy;0 - 20,000;12;4;8;0;0;0
431390;Diorama No.1 : Blocked In;Action, Casual, Indie;0 - 20,000;23;10;13;0;0;0
431410;Mazement;Action, Indie, Massively Multiplayer;0 - 20,000;27;6;21;0;0;0
431460;Midnight;Action, Adventure, Indie;0 - 20,000;48;20;28;0;0;0
431500;Clash of the Monsters;Adventure;100,000 - 200,000;186;181;5;26;26;0
431510;Mystic Destinies: Serendipity of Aeons;Adventure, Indie;50,000 - 100,000;317;68;249;175;255;0
431540;Frosty Kiss;Action, Adventure, Indie;100,000 - 200,000;1288;138;1150;35;40;0
431570;Breakroom;Casual, Indie, Early Access;0 - 20,000;3;7;-4;0;0;0
431590;Earn to Die 2;Simulation;50,000 - 100,000;681;60;621;329;329;7
431600;Automobilista;Action, Casual, Indie, Early Access;200,000 - 500,000;1932;218;1714;934;1574;65
431610;Hubert's Island Adventure: Mouse o' War;Simulation;0 - 20,000;5;1;4;0;0;0
431630;Action Legion;Casual, Indie, Strategy;0 - 20,000;21;5;16;0;0;0
431640;Doodle Kingdom;Adventure, Indie;20,000 - 50,000;80;102;-22;247;256;0
431650;Phoning Home;Adventure, Indie;100,000 - 200,000;660;297;363;263;395;2
431680;Nuts!: The Battle of the Bulge;Action, Adventure, Indie, RPG, Strategy;0 - 20,000;18;27;-9;247;247;0
431700;Age of Fear 3: The Legend;Indie, RPG, Strategy;0 - 20,000;160;11;149;0;0;1
431710;Space Pilgrim Episode II: Epsilon Indi;Action, Adventure, Free to Play, Massively Multiplayer;200,000 - 500,000;418;65;353;246;238;0
431730;Aseprite;Indie, Simulation, Strategy;500,000 - 1,000,000;12759;91;12668;8335;1698;3333
431740;Chowderchu;Action, Adventure, Indie;20,000 - 50,000;33;23;10;149;211;0
431750;Iron Sea Defenders;Action, Indie;50,000 - 100,000;235;55;180;254;304;4
431770;Rivalry;Adventure, Indie, RPG;0 - 20,000;267;21;246;109;157;2
431810;Rencounter;Animation & Modeling, Design & Illustration, Education, Photo Editing, Software Training;100,000 - 200,000;228;91;137;240;269;0
431830;Drift Into Eternity;Action, Casual, Indie;0 - 20,000;30;8;22;0;0;0
431840;3DRPG;Adventure, Indie, Early Access;100,000 - 200,000;135;83;52;419;513;0
431850;Projector Face;Adventure, Casual, Indie;0 - 20,000;66;11;55;0;0;0
431870;Castle Torgeath: Descent into Darkness;;0 - 20,000;54;29;25;188;188;0
431910;Psychocat: The Answer;Adventure, Indie, Strategy;0 - 20,000;182;42;140;3;3;0
431930;Kabounce;Indie, Simulation;200,000 - 500,000;2304;220;2084;72;29;1
431940;Wildfire;Action, Adventure;100,000 - 200,000;574;113;461;148;144;5
431950;Age of Fear 4: The Iron Killer;Indie;0 - 20,000;38;8;30;0;0;0
431960;Wallpaper Engine;Simulation, Strategy;20,000,000 - 50,000,000;609973;11690;598283;3670;872;105494
432010;World's Dawn;Action, Adventure, Indie, RPG;100,000 - 200,000;665;168;497;218;262;1
432030;Swanky Paint;Violent, Gore, Action, Adventure, Indie, Early Access;0 - 20,000;7;3;4;0;0;0
432100;Negligee;Adventure, Indie;100,000 - 200,000;564;141;423;90;134;2
432130;Break Chance Memento;Action, Indie;0 - 20,000;27;4;23;0;0;0
432170;Silver Knight;Casual, Indie, Strategy;50,000 - 100,000;45;41;4;378;400;1
432180;Discouraged Workers TEEN;Casual, Indie;0 - 20,000;49;24;25;0;0;0
432190;Chef Solitaire: USA;Action, Adventure, Indie, Strategy;20,000 - 50,000;129;16;113;0;0;3
432210;The Revenant Prince;Action, Casual, Indie, Strategy;0 - 20,000;14;3;11;0;0;0
432230;Axe, Bow & Staff;Action, Indie;0 - 20,000;24;5;19;0;0;0
432240;UnderDread;Action, Indie;0 - 20,000;77;56;21;206;228;1
432250;Soviet City;Casual, Simulation;0 - 20,000;66;44;22;0;0;0
432260;Tiltagon;Action, Adventure, Indie;20,000 - 50,000;81;29;52;207;238;0
432270;No Seat?;Indie;0 - 20,000;2;5;-3;0;0;0
432290;Elemental Heroes;Action, Adventure, Indie;50,000 - 100,000;99;68;31;72;101;5
432310;Virtual Pool 4 Multiplayer;Adventure, Casual, Indie;20,000 - 50,000;80;44;36;13;26;11
432330;Rytmik Lite Chiptune Synthesizer;Casual, Indie;0 - 20,000;51;19;32;117;117;0
432350;Epic Battle Fantasy 5;Action, Casual, Indie, Simulation;200,000 - 500,000;4496;57;4439;1579;2406;83
432370;Sethian;Adventure, Indie;0 - 20,000;70;20;50;0;0;0
432380;Hydra Slayer;Action, Adventure, Casual, Indie, Massively Multiplayer, Simulation;50,000 - 100,000;37;3;34;0;0;0
432390;Weekend Drive - Survive against Zombies, Aliens, and Dinosaurs!;Action, Adventure, Indie;0 - 20,000;2;0;2;0;0;0
432410;The Sacred Stone;Indie;50,000 - 100,000;12;28;-16;234;245;10
432420;Ludoria;Action, Adventure, Indie, RPG;0 - 20,000;8;11;-3;0;0;0
432470;Magdalena;Adventure, Free to Play, Indie, RPG;200,000 - 500,000;121;166;-45;230;216;1
432480;Grenade Madness;Action, Indie, Racing, Strategy;0 - 20,000;18;2;16;0;0;0
432490;ATOM GRRRL!!;Casual, Free to Play, Indie, RPG;0 - 20,000;14;9;5;0;0;0
432500;Evertown;Action, Indie;20,000 - 50,000;46;64;-18;0;0;0
432540;Devil Sealing Stone;Action, Casual, Indie, Strategy;0 - 20,000;4;3;1;0;0;0
432590;And So It Was;Action, Free to Play, Indie;0 - 20,000;24;15;9;0;0;0
432620;Mimic Arena;Simulation;0 - 20,000;9;7;2;0;0;0
432640;BuriedTown;Casual, Indie, Strategy, Early Access;0 - 20,000;20;22;-2;0;0;0
432720;Welkin Road;Adventure, Casual;0 - 20,000;54;18;36;580;580;0
432770;Small Town Terrors: Livingston;Action, Adventure, Casual;0 - 20,000;50;21;29;0;0;0
432780;Dream Catcher Chronicles: Manitou;Indie;0 - 20,000;14;13;1;0;0;0
432790;Angel Flare;Indie, Strategy;0 - 20,000;4;1;3;0;0;0
432870;Special Tactics;Casual, Indie;0 - 20,000;79;20;59;0;0;0
432890;Quote;Action, Adventure, Indie, RPG;0 - 20,000;9;5;4;0;0;0
432940;Breakneck;Action, Indie;0 - 20,000;102;29;73;0;0;1
432950;Orange Moon;Casual, Indie;0 - 20,000;68;34;34;80;118;0
432980;INVERSUS Deluxe;Indie;20,000 - 50,000;298;36;262;57;70;1
432990;Green Game: TimeSwapper;Action, Adventure;0 - 20,000;55;7;48;330;371;0
433000;Lost Lands: The Golden Curse;Action, Adventure, Indie;20,000 - 50,000;442;25;417;446;446;4
433100;The Town of Light;Action, Indie;50,000 - 100,000;1849;479;1370;181;229;1
433110;Zipple World;Action, Casual, Indie;0 - 20,000;12;14;-2;0;0;0
433120;Crash Landing;Action, Indie, Strategy;0 - 20,000;4;11;-7;0;0;0
433130;WarBirds Dogfights;Action, Casual, Indie;0 - 20,000;3;7;-4;0;0;0
433170;Die Young;Casual, Indie;50,000 - 100,000;1343;342;1001;407;541;2
433190;CDF Starfighter VR;RPG;0 - 20,000;66;38;28;0;0;0
433210;Rhino's Rage;Indie, Strategy;50,000 - 100,000;42;60;-18;159;176;0
433280;Warlords Battlecry III;RPG, Strategy;100,000 - 200,000;605;125;480;373;688;5
433290;Nemesis of the Roman Empire;Casual, Racing;20,000 - 50,000;75;5;70;0;0;6
433300;Marvel: Ultimate Alliance;Adventure, Casual, Indie, RPG;20,000 - 50,000;344;205;139;20;28;1
433320;Marvel: Ultimate Alliance 2;Action, Adventure, Indie, Simulation;20,000 - 50,000;188;168;20;61;61;1
433340;Slime Rancher;Casual, Indie, Strategy;2,000,000 - 5,000,000;101245;2181;99064;1193;579;1964
433350;BlackShot: Mercenary Warfare FPS;Action, Indie;500,000 - 1,000,000;1587;1331;256;291;51;17
433360;Drawn: Dark Flight;Action, Adventure, Indie, RPG, Strategy;0 - 20,000;6;7;-1;0;0;0
433380;Back in 1995;Adventure, Casual, Indie;20,000 - 50,000;75;37;38;0;0;0
433400;Kim;Action, Casual, Strategy;20,000 - 50,000;60;10;50;0;0;1
433400;Kim;Sports;20,000 - 50,000;60;10;50;0;0;1
433450;INFERNO CLIMBER;Adventure, Casual, Free to Play;0 - 20,000;62;48;14;0;0;0
433480;Rayon Riddles - Rise of the Goblin King;Adventure, Casual, Strategy;0 - 20,000;14;2;12;0;0;0
433490;Super Flippin' Phones;Action, Adventure, Casual, Indie, Strategy, Early Access;0 - 20,000;26;6;20;0;0;0
433530;Heliborne Collection;Education, Software Training, Utilities;200,000 - 500,000;2708;943;1765;496;651;18
433550;DARQ: Complete Edition;Adventure;200,000 - 500,000;3223;205;3018;156;240;5
433570;Side Quest;Adventure;0 - 20,000;8;4;4;0;0;0
433580;Timelapse;Adventure, Indie;0 - 20,000;28;8;20;0;0;0
433590;The Song of Seven : Overture;Adventure, Indie;0 - 20,000;32;8;24;0;0;0
433600;A Legend of Luca;Casual, Strategy;0 - 20,000;164;41;123;24;29;1
433630;vrAMP;Adventure, RPG, Strategy;0 - 20,000;32;13;19;0;0;0
433650;Book Of Merlin;Action, RPG, Early Access;0 - 20,000;16;18;-2;0;0;0
433660;Blockpocalypse;Action;0 - 20,000;13;2;11;0;0;0
433670;Professional Farmer 2017;Sexual Content, Nudity, Indie, Strategy;20,000 - 50,000;71;151;-80;0;0;3
433700;Carpe Lucem - Seize The Light VR;Adventure, Casual, Indie;0 - 20,000;43;5;38;0;0;0
433790;Wooden Floor 2 - Resurrection;Adventure, Indie;20,000 - 50,000;31;31;0;161;189;0
433830;Rescue From Goblin Deep;Violent, Gore, Action;0 - 20,000;4;2;2;0;0;0
433840;Trulon: The Shadow Engine;Adventure, Casual, Indie;0 - 20,000;54;26;28;0;0;0
433840;Trulon: The Shadow Engine;Action, Adventure, Indie, Early Access;0 - 20,000;54;26;28;0;0;0
433850;Z1 Battle Royale;Action;10,000,000 - 20,000,000;115082;92219;22863;2988;116;75
433890;MechoEcho;Free to Play, Massively Multiplayer, Strategy;0 - 20,000;36;5;31;0;0;0
433900;Helium;Action, Casual, Indie;20,000 - 50,000;58;48;10;30;30;1
433910;Neon Drive;Racing;100,000 - 200,000;1700;331;1369;129;179;1
433920;Aveyond 4: Shadow of the Mist;Casual, Indie, Simulation;20,000 - 50,000;143;7;136;0;0;0
433930;MARI indie 3.0;Action, Adventure, Indie;0 - 20,000;8;11;-3;0;0;0
433950;Bit Blaster XL;Action, Indie, RPG, Strategy;200,000 - 500,000;5903;204;5699;140;94;5
433960;Shadow Of Nebula;Design & Illustration, Software Training, Utilities;0 - 20,000;9;1;8;0;0;0
434000;Paws;Action, Indie, Simulation;20,000 - 50,000;568;54;514;0;0;3
434020;Last Hope - Tower Defense;Action, Indie;50,000 - 100,000;356;69;287;56;56;1
434030;Aerofly FS 2 Flight Simulator;Action, Indie;100,000 - 200,000;1526;417;1109;274;303;14
434050;Duke Nukem 3D: 20th Anniversary World Tour;Adventure, Indie;500,000 - 1,000,000;3369;652;2717;192;224;42
434070;Plight of the Zombie;Action, Indie;20,000 - 50,000;30;8;22;0;0;1
434090;Bridge! 2;Action, Adventure, Casual, Indie;0 - 20,000;19;35;-16;0;0;0
434090;Bridge! 2;Action, Adventure, Indie;0 - 20,000;19;35;-16;0;0;0
434130;Witch and Hero(魔女と勇者);Adventure, Indie, RPG, Strategy;0 - 20,000;70;13;57;0;0;0
434140;New Outbreak;Action, Adventure, Free to Play, Indie;0 - 20,000;1;1;0;0;0;0
434160;A Hole New World;Casual, Indie, Strategy;0 - 20,000;69;18;51;0;0;0
434170;The Jackbox Party Pack 3;Casual, Free to Play, Massively Multiplayer, Simulation;200,000 - 500,000;5019;149;4870;792;369;471
434190;Follia - Dear father;Free to Play;20,000 - 50,000;102;63;39;0;0;0
434210;It's Spring Again;Action, Adventure, Casual, Free to Play, Indie, Massively Multiplayer, Strategy;100,000 - 200,000;719;64;655;226;231;3
434220;Bear Haven Nights;Action, Indie;20,000 - 50,000;40;9;31;295;324;0
434230;Fairies vs. Darklings: Arcane Edition;Indie, Simulation;0 - 20,000;17;4;13;0;0;0
434230;Fairies vs. Darklings: Arcane Edition;Adventure, Casual, Indie;0 - 20,000;17;4;13;0;0;0
434240;Alien Blitz;Action, Indie;0 - 20,000;18;6;12;0;0;0
434250;Masked Shooters 2;Strategy;200,000 - 500,000;1137;464;673;169;172;2
434260;My Name is Mayo;Casual, Indie;50,000 - 100,000;2254;450;1804;28;27;0
434270;Parasite;Indie, RPG, Strategy;0 - 20,000;4;3;1;0;0;0
434290;Typefighters (Steam Edition);Action, Indie, Strategy;20,000 - 50,000;94;42;52;0;0;0
434300;Wormhole City;Free to Play, Indie, Simulation;20,000 - 50,000;12;26;-14;25;25;0
434310;imprint-X;Action, Indie;0 - 20,000;28;9;19;0;0;0
434340;Spheria;Action, Indie;0 - 20,000;2;0;2;0;0;0
434360;Kitten Rampage;Action, Adventure, Racing, RPG, Simulation;0 - 20,000;52;39;13;0;0;0
434360;Kitten Rampage;Action, Indie, Massively Multiplayer, RPG, Early Access;0 - 20,000;52;39;13;0;0;0
434370;Buried: An Interactive Story;Action, Free to Play, Indie;0 - 20,000;144;7;137;35;35;0
434390;Lost Bros;Action, Indie, Simulation, Strategy, Early Access;0 - 20,000;13;3;10;0;0;0
434410;Moonlight;Adventure, Indie;0 - 20,000;221;15;206;0;0;0
434420;The Chosen RPG;Adventure, Casual, Indie, RPG, Simulation;200,000 - 500,000;838;349;489;188;210;2
434430;Abbot's Book Demo;Action, Indie, RPG, Strategy, Early Access;50,000 - 100,000;176;23;153;18;20;0
434460;Rock of Ages 2: Bigger & Boulder;Action, Free to Play, Indie, Massively Multiplayer;200,000 - 500,000;2514;444;2070;249;234;17
434470;Puzzle Party;Action, Indie;0 - 20,000;20;2;18;0;0;0
434480;Mathoria: It All Adds Up;Action, Adventure, Massively Multiplayer, RPG;20,000 - 50,000;52;38;14;0;0;0
434490;Otem's Defiance;RPG;0 - 20,000;28;0;28;0;0;0
434500;BATTLE PIXELS;Indie, Simulation, Strategy;20,000 - 50,000;37;28;9;302;312;0
434510;Formicide;Animation & Modeling, Education;100,000 - 200,000;262;58;204;12;15;0
434520;Simutrans;Adventure, Indie, Simulation;200,000 - 500,000;362;119;243;71;107;32
434530;Flobe;Action, RPG, Strategy;50,000 - 100,000;43;5;38;212;212;0
434540;Secret of the Pendulum;Action, Adventure, Indie, Simulation;0 - 20,000;2;5;-3;0;0;0
434570;Blood and Bacon;Action, Casual, Indie, RPG;500,000 - 1,000,000;28728;1469;27259;232;148;48
434580;Attack of the Mutant Fishcrows;Action, Strategy;0 - 20,000;6;6;0;0;0;0
434600;Blue Bird;Indie;0 - 20,000;29;25;4;0;0;0
434610;Forbidden Planet;Action;200,000 - 500,000;146;152;-6;244;215;0
434650;Lost Castle / 失落城堡;Indie, Simulation, Strategy, Early Access;2,000,000 - 5,000,000;19277;2618;16659;1127;692;416
434660;Octahedron: Transfixed Edition;Action, Indie;20,000 - 50,000;140;14;126;0;0;0
434700;Forgotten Ball;Adventure, Indie;0 - 20,000;15;4;11;0;0;0
434730;Half Dead;Casual;200,000 - 500,000;2545;716;1829;90;62;2
434740;Lichtspeer;Action, Adventure, Simulation;20,000 - 50,000;119;26;93;0;0;0
434750;Z-Exemplar;Indie;0 - 20,000;44;5;39;0;0;0
434790;Planet 1138;Action, Indie;0 - 20,000;10;6;4;0;0;0
434800;The Great Escape;Adventure, Indie;0 - 20,000;16;11;5;278;258;0
434820;Brushwood Buddies;Adventure, Casual, Indie, RPG;50,000 - 100,000;115;21;94;164;196;8
434860;Wanderjahr;Action, Indie;0 - 20,000;13;3;10;0;0;0
434870;Megalo Polis;Simulation, Sports;0 - 20,000;5;6;-1;0;0;0
434880;Hieroglyphika;Action, Free to Play, Indie;20,000 - 50,000;95;52;43;0;0;0
434890;Eight Mini Racers;Indie, RPG;50,000 - 100,000;45;33;12;259;245;0
434920;Last Heroes 2;Action, Indie;50,000 - 100,000;35;15;20;420;525;0
434930;GiAnt;Action, Adventure, Indie;0 - 20,000;10;17;-7;0;0;0
434960;Rolling Gauntlet;Action, Casual, Indie;0 - 20,000;4;9;-5;0;0;0
434970;That Dam Level redux;Free to Play, Indie, Simulation;0 - 20,000;2;1;1;0;0;0
434980;Onion Force;Adventure, Casual;20,000 - 50,000;58;13;45;0;0;0
434980;Onion Force;Adventure, Casual, Indie;20,000 - 50,000;58;13;45;0;0;0
435000;The Whisperer in Darkness;Action, Adventure, Indie;0 - 20,000;31;7;24;524;524;0
435010;Krinkle Krusher;;0 - 20,000;26;25;1;0;0;0
435020;AFL Evolution;Indie;0 - 20,000;78;26;52;0;0;0
435030;Lost Lands: Mahjong;Action, Casual, Indie, Strategy, Early Access;100,000 - 200,000;4508;402;4106;299;383;61
435040;Incredible Dracula: Chasing Love Collector's Edition;Adventure, Indie;0 - 20,000;63;20;43;215;215;2
435050;Glory Kingdom;Action, Indie;0 - 20,000;2;3;-1;0;0;0
435060;GameLooper;Adventure, Casual, Indie;100,000 - 200,000;159;70;89;67;77;0
435070;Elansar;Adventure, Casual, Indie;0 - 20,000;11;8;3;0;0;0
435080;Philia : the Sequel to Elansar;Action, Indie, Racing, Simulation, Sports;0 - 20,000;2;2;0;0;0;0
435100;2Dark;Adventure, Casual, Indie;200,000 - 500,000;439;134;305;294;324;2
435120;Rusty Lake Hotel;Indie, Simulation, Strategy;200,000 - 500,000;6312;277;6035;199;117;53
435140;Rush for gold: Alaska;Adventure, Casual, Indie;20,000 - 50,000;37;12;25;245;218;0
435150;Divinity: Original Sin 2 - Definitive Edition;Action, Adventure, Indie, RPG, Strategy, Early Access;5,000,000 - 10,000,000;151676;6257;145419;4268;2388;7676
435230;Medieval Playground;Casual, Indie, Sports;0 - 20,000;6;17;-11;0;0;0
435250;Deadhunt;Casual, Indie;0 - 20,000;125;11;114;6;6;2
435260;Planet Stronghold: Colonial Defense;Action, Casual, Indie;0 - 20,000;29;6;23;0;0;0
435300;We Know the Devil;Action, Adventure, Indie;0 - 20,000;733;47;686;65;127;0
435360;Campus Notes - forget me not.;Action, Indie, Strategy;0 - 20,000;62;9;53;160;160;0
435400;Hidden Folks;Action, Casual;200,000 - 500,000;8156;279;7877;220;221;27
435410;Fractal Space;Adventure, Casual, Free to Play, Indie, Massively Multiplayer, RPG, Strategy;0 - 20,000;0;0;0;0;0;0
435420;Operation: Matriarchy;Action, Casual, Indie;20,000 - 50,000;58;35;23;205;205;1
435440;Galaxy Control: 3D Strategy;Action, Casual, Indie;100,000 - 200,000;266;197;69;9;13;38
435460;NotCoD;Adventure, Casual, Free to Play, Massively Multiplayer, Simulation, Sports, Early Access;0 - 20,000;71;9;62;0;0;0
435480;Trials of the Blood Dragon;Education;100,000 - 200,000;133;65;68;92;92;1
435490;Pierhead Arcade;Adventure;0 - 20,000;238;29;209;52;52;1
435530;The Final Station;Strategy;200,000 - 500,000;6345;977;5368;315;265;13
435600;My Tower, My Home;Action, Casual, Indie, Early Access;0 - 20,000;22;11;11;0;0;0
435730;apartment: a separated place;Action, Adventure, Casual, Indie;0 - 20,000;9;0;9;0;0;0
435750;CyberLink ColorDirector 4;Indie, Simulation, Strategy;0 - 20,000;1;0;1;0;0;0
435780;VIOLET: Space Mission;Action, Adventure, Indie;0 - 20,000;9;10;-1;0;0;0
435790;10 Second Ninja X;RPG;200,000 - 500,000;2207;542;1665;49;10;5
435800;Binaries;Indie;0 - 20,000;63;7;56;28;28;0
435840;The Preposterous Awesomeness of Everything;Adventure, Indie, RPG;20,000 - 50,000;81;7;74;0;0;0
435970;RefRain - prism memories -;Action, Indie, RPG, Strategy;0 - 20,000;99;2;97;228;228;1
436000;Lovely Planet Arcade;Action, Simulation, Sports, Early Access;0 - 20,000;104;31;73;0;0;0
436060;Lolly Joe;Action, Adventure, Indie;0 - 20,000;11;7;4;0;0;0
436070;Nadia Was Here;Adventure, Casual, Indie;0 - 20,000;34;3;31;0;0;0
436110;Medusa's Labyrinth;Casual, Indie;500,000 - 1,000,000;851;241;610;10;12;1
436140;Empire of the Gods;Action, Indie;50,000 - 100,000;46;18;28;201;238;0
436160;The Panic Room;Adventure, Indie, RPG;100,000 - 200,000;235;186;49;5;5;33
436180;Spacelords;Racing, Simulation, Sports;500,000 - 1,000,000;1661;1501;160;575;68;12
436220;A-10 VR;Action, Indie, Early Access;20,000 - 50,000;136;10;126;38;38;0
436230;Detached;Animation & Modeling, Design & Illustration, Video Production;20,000 - 50,000;197;144;53;139;203;2
436240;Melancholy Republic;Action, Casual, Indie, Early Access;0 - 20,000;16;6;10;0;0;0
436260;Ultimate Arena FPS;Action, Adventure, Casual, Strategy;50,000 - 100,000;127;106;21;0;0;0
436270;Civil War: 1863;Action, RPG;0 - 20,000;29;19;10;332;333;0
436270;Civil War: 1863;Adventure, Casual;0 - 20,000;29;19;10;332;333;0
436280;Sudoku Quest;Free to Play, Indie, Massively Multiplayer, Simulation, Sports, Strategy;0 - 20,000;55;26;29;185;295;0
436290;Children of Zodiarcs;Action, Adventure;20,000 - 50,000;350;141;209;3;3;1
436320;Raw Data;Casual;200,000 - 500,000;1884;538;1346;155;131;6
436340;Kiya;Sports;0 - 20,000;29;4;25;0;0;0
436360;Robo's World: The Zarnok Fortress;Casual, Indie, Strategy;20,000 - 50,000;16;4;12;1;1;0
436360;Robo's World: The Zarnok Fortress;Free to Play, Indie, Massively Multiplayer, RPG;20,000 - 50,000;16;4;12;1;1;0
436390;Prison Run and Gun;Casual, Indie, Strategy;20,000 - 50,000;451;40;411;166;242;0
436400;Heroes of the Seven Seas VR;Action;0 - 20,000;33;12;21;0;0;0
436410;Beyond The Destiny;Indie, RPG, Strategy, Early Access;0 - 20,000;5;14;-9;0;0;0
436470;Gamma Bros;Action, Adventure, Indie;0 - 20,000;124;14;110;0;0;0
436480;Soup: the Game;Action, Indie;0 - 20,000;27;19;8;159;159;0
436490;Firebird - La Peri;Indie;0 - 20,000;167;39;128;0;0;0
436500;Diaries of a Spaceport Janitor;Action, Adventure, Casual, Indie;100,000 - 200,000;623;233;390;346;544;3
436510;Worlds of Chaos: Invasion;Strategy;0 - 20,000;6;6;0;0;0;0
436520;Line of Sight;Adventure;2,000,000 - 5,000,000;5386;3706;1680;190;60;43
436530;Bullshot;Action, Adventure, Indie, RPG;20,000 - 50,000;223;71;152;421;586;1
436560;Kings and Heroes;Adventure, Indie;50,000 - 100,000;443;370;73;972;1930;0
436670;The Legend of Heroes: Trails in the Sky the 3rd;Casual;100,000 - 200,000;1358;80;1278;1030;1030;77
436680;A More Beautiful World - A Kinetic Visual Novel;Indie;0 - 20,000;1;1;0;0;0;0
436690;Tempest Citadel;Indie, Simulation, Strategy;0 - 20,000;36;11;25;151;151;0
436740;Hunger;Action, Free to Play, Massively Multiplayer, RPG;0 - 20,000;9;3;6;0;0;0
436860;Arctic alive;Action, Free to Play, Indie, Massively Multiplayer;0 - 20,000;32;25;7;0;0;0
436870;Tank Brawl;;20,000 - 50,000;24;13;11;0;0;0
436940;Quar: Battle for Gate 18;Adventure, Casual, Indie;0 - 20,000;52;7;45;0;0;0
436950;Mosaic Maze;Action, Casual, Indie;0 - 20,000;4;1;3;0;0;0
437000;GUILTY GEAR 2 -OVERTURE-;Indie, Simulation;50,000 - 100,000;190;85;105;0;0;4
437010;Space Battle Core;Action, Indie;0 - 20,000;0;0;0;0;0;0
437020;WITCH-BOT MEGLILO;Action, Adventure, Indie;0 - 20,000;98;9;89;0;0;0
437030;MEMENTO;Adventure, Casual, Indie;0 - 20,000;42;13;29;0;0;0
437060;MOAI 3: Trade Mission Collector's Edition;;0 - 20,000;43;3;40;0;0;3
437080;Space Rift - Episode 1;Massively Multiplayer;0 - 20,000;57;16;41;0;0;0
437090;Wobbly Jungle;Indie, Simulation, Strategy;0 - 20,000;40;5;35;342;342;0
437100;My Night Job;Action, Indie, RPG, Early Access;20,000 - 50,000;77;9;68;0;0;0
437160;The Lion's Song: Episode 1 - Silence;Adventure, Casual, Indie, Early Access;200,000 - 500,000;1949;150;1799;131;224;2
437170;The Amazing Adventures of Ash - Afterparty;Indie, RPG;0 - 20,000;7;2;5;0;0;0
437170;The Amazing Adventures of Ash - Afterparty;Indie, RPG;0 - 20,000;7;2;5;0;0;0
437180;Chill the Piro;Casual, Simulation;20,000 - 50,000;23;8;15;312;320;0
437210;The Hunt;Adventure;0 - 20,000;10;5;5;0;0;0
437220;The Culling;Action, Casual, Indie;1,000,000 - 2,000,000;10186;7628;2558;402;134;2
437250;A House of Many Doors;Casual, Indie, RPG, Strategy;20,000 - 50,000;325;60;265;21;21;1
437340;Toys of War;Action, Casual, Indie, Strategy;0 - 20,000;9;1;8;0;0;0
437350;Call of Duty: Black Ops III - Multiplayer Starter Pack;Casual, Free to Play, Simulation;0 - 20,000;120;76;44;0;0;0
437380;Vanquish: The Adventures of Lady Exton;Action, Adventure, Indie, RPG, Early Access;0 - 20,000;8;6;2;0;0;0
437390;HoPiKo;Indie, Simulation, Strategy;50,000 - 100,000;148;48;100;129;129;0
437400;SOLRAVEN;Indie, RPG;50,000 - 100,000;12;30;-18;0;0;0
437420;The Secret Order 3: Ancient Times;Adventure, Casual, Indie;50,000 - 100,000;279;40;239;278;302;4
437440;Lord of Rigel;Action, Adventure, Casual, Free to Play, Early Access;20,000 - 50,000;24;11;13;0;0;4
437520;ZeGame;Action, Indie, RPG, Early Access;0 - 20,000;82;1;81;0;0;0
437530;A Blind Legend;Action, Adventure, Indie, Early Access;20,000 - 50,000;189;51;138;0;0;1
437550;Melon Simulator;Action;;;;0;;;
437570;GoNNER;Action, Indie;50,000 - 100,000;1049;210;839;223;268;3
437610;SQUIDS FROM SPACE;Adventure, Casual, Indie, RPG;20,000 - 50,000;204;24;180;0;0;1
437630;State of Mind;Adventure, Casual;200,000 - 500,000;1548;400;1148;306;384;8
437690;Venture Kid;Adventure, Simulation, Early Access;20,000 - 50,000;143;27;116;306;306;0
437710;Magic Flute;Action, Adventure;0 - 20,000;10;3;7;0;0;0
437720;Blossoms Bloom Brightest;Utilities;20,000 - 50,000;107;53;54;0;0;0
437730;Roadclub: League Racing;Action, Adventure, Casual, Indie, RPG;0 - 20,000;46;8;38;0;0;0
437740;Inside: Before Birth;Action, Indie;0 - 20,000;18;24;-6;0;0;0
437870;Earth Space Colonies;Action, Indie;20,000 - 50,000;83;80;3;334;433;0
437880;Project Graviton;Indie, Simulation, Strategy;0 - 20,000;15;8;7;0;0;0
437900;Party Jousting;Action, Indie;1,000,000 - 2,000,000;652;60;592;21;17;3
437920;Tricky Towers;Action, Adventure, Indie;1,000,000 - 2,000,000;11810;1233;10577;332;213;130
438000;PIXELMAN;Adventure, Indie, Simulation, Early Access;50,000 - 100,000;135;28;107;96;129;1
438010;PulseCharge;Action, Adventure, Indie, Simulation;200,000 - 500,000;81;80;1;239;241;0
438020;AI: Rampage;Action, Casual, Free to Play, Indie, Strategy;500,000 - 1,000,000;173;296;-123;287;269;1
438030;Dead6hot;Action, Adventure, Indie;200,000 - 500,000;212;260;-48;242;251;0
438040;Shakes and Fidget;Action, Indie;1,000,000 - 2,000,000;27205;1956;25249;3389;454;3422
438080;Surfingers;Adventure, Indie, Early Access;200,000 - 500,000;463;123;340;160;230;1
438090;Defend Felinearth;Adventure, Casual, Indie;0 - 20,000;5;4;1;0;0;0
438100;VRChat;Action, Adventure, Indie;10,000,000 - 20,000,000;136536;54686;81850;2980;90;26276
438110;CV Maker for Windows;Action, Casual, Indie;0 - 20,000;4;8;-4;0;0;0
438130;Root Double -Before Crime * After Days- Xtend Edition;Adventure, Indie;20,000 - 50,000;374;37;337;857;1445;3
438140;Star Realms;Adventure, Indie, RPG;200,000 - 500,000;1446;233;1213;2;4;70
438160;LILT;Action, Adventure, Massively Multiplayer, RPG, Simulation, Strategy;0 - 20,000;3;0;3;0;0;0
438180;Super Mustache;Action, Adventure, Indie, RPG, Simulation;500,000 - 1,000,000;447;167;280;191;196;0
438210;MULE Returns;Action, Indie, Simulation, Sports;0 - 20,000;0;0;0;0;0;0
438220;Castle Heist: Chapter 1;Casual, Indie, RPG;0 - 20,000;9;5;4;0;0;0
438240;Corpo Tale;Adventure, Indie;0 - 20,000;17;0;17;0;0;0
438260;Rewind;Indie, Early Access;0 - 20,000;15;3;12;0;0;0
438260;Rewind;Action, Adventure, Indie;0 - 20,000;15;3;12;0;0;0
438270;Learn Japanese To Survive! Hiragana Battle;Action, Adventure, Indie;100,000 - 200,000;1751;159;1592;235;203;14
438300;Shepherds of the Abyss;Action;0 - 20,000;12;10;2;0;0;0
438310;SCORE;Casual;0 - 20,000;16;26;-10;0;0;0
438320;Rush Rover;Indie, RPG;20,000 - 50,000;206;12;194;0;0;0
438340;Drizzlepath: Genie;Adventure, Indie, Strategy;0 - 20,000;111;81;30;272;272;0
438350;Dynetzzle Extended;Strategy;0 - 20,000;28;3;25;0;0;0
438360;Infinitesimal Point;Action, Adventure, Casual, Indie, Racing, RPG, Simulation, Sports;0 - 20,000;10;5;5;0;0;0
438420;Zenith;Action, Adventure, Casual, Indie;100,000 - 200,000;400;173;227;5;5;2
438430;Valentino Rossi The Game;Adventure;20,000 - 50,000;330;76;254;0;0;5
438440;Star Rogue;Animation & Modeling, Design & Illustration, Photo Editing;0 - 20,000;20;0;20;0;0;0
438450;3DF Zephyr Lite Steam Edition;Action, Indie, RPG;0 - 20,000;63;2;61;0;0;1
438460;ARENA 3D;RPG;0 - 20,000;33;7;26;0;0;0
438480;Rock 'N' Roll Defense;Animation & Modeling, Audio Production, Software Training, Utilities, Video Production;200,000 - 500,000;1829;290;1539;285;284;69
438490;GOD EATER 2 Rage Burst;Casual, Indie, Racing;200,000 - 500,000;3200;894;2306;1143;429;30
438560;Mystery Case Files: Escape from Ravenhearst;Adventure, Indie;0 - 20,000;29;23;6;0;0;0
438600;Soccer Manager;Casual, Indie, Strategy;50,000 - 100,000;141;82;59;62;60;0
438640;LEGO STAR WARS: The Force Awakens;Adventure, Free to Play, Massively Multiplayer, RPG;500,000 - 1,000,000;5063;878;4185;1051;645;55
438650;Gravity Compass;Simulation;0 - 20,000;9;9;0;0;0;0
438660;Jerry Rice & Nitus' Dog Football;Indie;0 - 20,000;38;9;29;0;0;1
438680;One Troll Army;Action, Indie;500,000 - 1,000,000;1175;194;981;241;129;1
438720;Heroes of Shadow Guard;Action, Indie, Racing, Early Access;20,000 - 50,000;28;29;-1;0;0;0
438730;Poly Towns;Action, Casual, Free to Play, Indie, Racing, Simulation, Sports, Early Access;0 - 20,000;19;25;-6;0;0;0
438740;Friday the 13th: The Game;Action, Indie;2,000,000 - 5,000,000;56914;14988;41926;653;224;456
438770;Street Posse Showdown;Indie;0 - 20,000;0;3;-3;0;0;0
438780;Terrarium Land;Casual, Indie, RPG, Simulation, Sports, Strategy;0 - 20,000;6;2;4;0;0;0
438790;Random Access Murder;Action, Indie, RPG, Early Access;20,000 - 50,000;38;125;-87;0;0;0
438820;Hyper Box;Free to Play, Indie, Massively Multiplayer, RPG, Early Access;20,000 - 50,000;38;12;26;0;0;0
438910;Hack, Slash & Backstab;Action, Indie;0 - 20,000;1;8;-7;0;0;0
438920;Legends of Callasia;Adventure, Indie;50,000 - 100,000;208;66;142;18;18;1
438940;XBlaze Lost: Memories;Violent, Gore, Action, Indie;0 - 20,000;30;9;21;0;0;1
439190;Stories: The Path of Destinies;Free to Play, Massively Multiplayer, RPG;2,000,000 - 5,000,000;5538;734;4804;363;302;10
439250;Space Pilgrim Episode III: Delta Pavonis;Action, Casual, Indie;200,000 - 500,000;304;49;255;259;263;1
439260;"""BUTTS: The VR Experience""";Casual, Indie, RPG, Strategy;0 - 20,000;74;17;57;3;3;0
439310;Until I Have You;Action, Indie, Simulation, Strategy;20,000 - 50,000;119;52;67;250;250;0
439340;Tavern Tycoon - Dragon's Hangover;Strategy;50,000 - 100,000;544;244;300;14;14;3
439350;Kritika:REBOOT;Action, Indie;500,000 - 1,000,000;3571;1104;2467;439;174;0
439370;Midair;Action, Casual, Free to Play, Massively Multiplayer, Simulation, Strategy;100,000 - 200,000;466;379;87;128;72;0
439400;Legends of Callasia Demo;Action, Indie;0 - 20,000;0;0;0;0;0;0
439420;SteelLIFE;Indie, RPG, Simulation, Strategy;0 - 20,000;18;4;14;0;0;0
439440;Of Carrots And Blood;Adventure;20,000 - 50,000;75;30;45;82;151;0
439460;Ships 2017;Adventure;20,000 - 50,000;63;115;-52;10;10;0
439490;BLUE REVOLVER;Casual;20,000 - 50,000;389;6;383;4;4;1
439530;Rock-N-Rogue: A Boo Bunny Plague Adventure;Adventure;0 - 20,000;8;13;-5;0;0;0
439550;'n Verlore Verstand;Action, Indie, Strategy;50,000 - 100,000;46;66;-20;577;605;0
439660;Tower Unite Dedicated Server;Action, Indie;0 - 20,000;3;0;3;0;0;0
439700;Z1 Battle Royale: Test Server;Adventure, Casual, Indie, Simulation;5,000,000 - 10,000,000;1326;1196;130;726;20;4
439720;Unending Galaxy;Action, Adventure, Casual, Indie;100,000 - 200,000;72;40;32;0;0;0
439730;XO-Planets;Action, Adventure, Indie;0 - 20,000;13;2;11;0;0;0
439740;Eclipsed;Casual, Free to Play, Indie;0 - 20,000;13;3;10;0;0;0
439750;The Lost Heir 2: Forging a Kingdom;Action, Casual, Indie;0 - 20,000;27;8;19;0;0;0
439770;The Lost Heir: The Fall of Daria;Adventure, Indie;0 - 20,000;44;14;30;0;0;1
439800;Clouds & Sheep 2;Action, Casual, Indie, Simulation;0 - 20,000;124;21;103;0;0;0
439880;Heroes of Loot 2;Indie, RPG, Simulation, Strategy, Early Access;0 - 20,000;27;9;18;0;0;0
439910;Risky Rescue;Action, Indie;100,000 - 200,000;281;84;197;136;193;0
439920;Royal Heroes;Sexual Content, Violent, Adventure, Indie, Strategy;100,000 - 200,000;234;65;169;328;392;2
439930;Control Craft 2;Indie, RPG;50,000 - 100,000;216;69;147;277;272;6
439930;Control Craft 2;Action, Indie;50,000 - 100,000;216;69;147;277;272;6
439940;Lucid9: Inciting Incident;Racing;100,000 - 200,000;922;96;826;18;18;2
439960;Falling Stars: War of Empires;Adventure, Indie, RPG;0 - 20,000;11;4;7;0;0;0
440020;bit Dungeon+;Action, Adventure, Indie, RPG, Early Access;20,000 - 50,000;82;111;-29;0;0;0
440100;Fall of Gyes;Action, Adventure, Indie;0 - 20,000;9;2;7;0;0;0
440120;Vreal;Animation & Modeling, Design & Illustration, Education, Software Training, Utilities, Game Development;20,000 - 50,000;23;11;12;0;0;0
440280;Overpower;Adventure, Indie, Simulation;0 - 20,000;36;7;29;0;0;0
440310;Project Arrhythmia;Indie, Racing, Simulation, Sports;50,000 - 100,000;1705;58;1647;0;0;30
440340;Banzai Escape;Indie, Strategy;0 - 20,000;96;43;53;259;259;0
440340;Banzai Escape;Action, Free to Play;0 - 20,000;96;43;53;259;259;0
440380;Super Kitty Boing Boing;Casual, Indie, Strategy;0 - 20,000;10;15;-5;0;0;0
440410;Wolfsong;Adventure, Casual;0 - 20,000;15;7;8;0;0;0
440420;True Fear: Forsaken Souls Part 1;Casual, Indie, Simulation;20,000 - 50,000;716;69;647;260;333;12
440450;Escape: Sierra Leone;Indie;0 - 20,000;27;21;6;0;0;0
440520;VirtualHere For Steam Link;Action, Indie, Massively Multiplayer, Strategy;0 - 20,000;151;167;-16;1;1;2
440520;VirtualHere For Steam Link;Action, Indie;0 - 20,000;151;167;-16;1;1;2
440540;Ara Fell: Enhanced Edition;Action, Free to Play, Massively Multiplayer;100,000 - 200,000;1619;82;1537;62;113;36
440550;Atomik: RunGunJumpGun;Action, Indie;20,000 - 50,000;255;35;220;23;38;0
440630;The Brookhaven Experiment;Action, Adventure, Casual, Indie, RPG;50,000 - 100,000;738;117;621;359;678;4
440640;Sweet F. Cake;Casual, Indie, Strategy;20,000 - 50,000;433;51;382;443;443;1
440650;Niche - a genetics survival game;Adventure, Indie;200,000 - 500,000;3930;593;3337;115;112;60
440660;Void Vikings;Action, Adventure, Casual, Indie;0 - 20,000;20;6;14;1072;1072;0
440660;Void Vikings;Casual;0 - 20,000;20;6;14;1072;1072;0
440690;Mesel;Action, Casual;0 - 20,000;49;19;30;0;0;0
440720;Pandora`s room;Adventure, Casual, Indie;0 - 20,000;9;12;-3;0;0;0
440730;Survival Zombies The Inverted Evolution;Indie, Strategy, Early Access;50,000 - 100,000;569;418;151;80;108;0
440740;Epic battles within 5 seconds!;Action, Adventure, Casual, Indie, RPG, Simulation, Strategy;100,000 - 200,000;187;150;37;475;87;0
440750;Story of a Cube;Action, Adventure, Casual, Indie, Simulation;20,000 - 50,000;17;15;2;218;241;0
440760;Cube Destroyer;Action, Adventure, Casual, Indie, RPG;100,000 - 200,000;976;168;808;194;209;20
440770;Drawn Story;Action, Casual;0 - 20,000;5;10;-5;0;0;0
440790;Spellbind : Luppe's tale;Action, Adventure, Casual, Indie;20,000 - 50,000;20;13;7;208;208;9
440800;Trial by Viking;Action, Indie, Strategy, Early Access;0 - 20,000;25;5;20;0;0;0
440810;1943 Megami Strike;Casual, Indie;0 - 20,000;33;50;-17;193;193;0
440870;Mysteries of the Past: Shadow of the Daemon Collector's Edition;Action, Indie, Massively Multiplayer;0 - 20,000;30;13;17;0;0;0
440880;The Count Lucanor;Action, Adventure, Indie, Sports;100,000 - 200,000;1979;119;1860;296;315;3
440900;Conan Exiles;Casual, Indie;2,000,000 - 5,000,000;69347;19095;50252;6452;1620;12767
440950;Story Of the Survivor;Action, Indie, Racing;20,000 - 50,000;36;25;11;2;2;0
441010;Mount Your Friends 3D: A Hard Man is Good to Climb;Adventure;100,000 - 200,000;324;41;283;225;313;9
441050;Polandball: Can into Space!;Action, Adventure, Indie, RPG;0 - 20,000;476;28;448;143;143;1
441060;Silver Creek Falls - Chapter 3;Action, Free to Play, Early Access;0 - 20,000;26;10;16;0;0;0
441230;Babel: Tower to the Gods;Action, Free to Play, Strategy;0 - 20,000;27;4;23;0;0;0
441250;Talewind;Indie, Simulation, Strategy, Early Access;0 - 20,000;50;40;10;228;228;0
441250;Talewind;Action, Indie, Racing, Early Access;0 - 20,000;50;40;10;228;228;0
441280;Pharaoh Rebirth+;Action, Adventure, Indie, Early Access;0 - 20,000;283;22;261;0;0;0
441350;Assault Suit Leynos;Action, Indie;20,000 - 50,000;106;68;38;0;0;0
441380;PAC-MAN CHAMPIONSHIP EDITION 2;Action, Adventure, Indie, RPG;200,000 - 500,000;1413;627;786;250;56;11
441440;Sometimes Always Monsters;Action, Indie, Racing;0 - 20,000;113;41;72;0;0;1
441510;The Incredible Baron;Adventure, Indie;0 - 20,000;38;4;34;0;0;0
441550;STAR WARS Rebellion;Action, Adventure, Casual;100,000 - 200,000;939;127;812;404;603;78
441640;VALENS;Action, Adventure, Indie;0 - 20,000;6;13;-7;0;0;0
441670;Jelly Killer;Indie, Simulation, Early Access;20,000 - 50,000;257;68;189;132;132;0
441670;Jelly Killer;Action, Indie, Racing;20,000 - 50,000;257;68;189;132;132;0
441680;Obscuritas;Action, Casual, Indie, Racing, Sports;50,000 - 100,000;117;67;50;0;0;0
441770;MindTex 2;Action, Casual, Free to Play, Indie, Simulation, Sports, Early Access;0 - 20,000;101;5;96;0;0;1
441790;Fragmented;Action, Indie;100,000 - 200,000;844;1099;-255;657;738;3
441830;I am Setsuna;Adventure, Simulation;50,000 - 100,000;1118;415;703;1851;3664;5
441850;ScriptVOX Studio;Audio Production, Utilities;0 - 20,000;0;1;-1;0;0;0
441870;OutDrive;Action, Indie;200,000 - 500,000;3472;1084;2388;124;134;3
442000;Alone K.W.;Action, Casual, Indie;50,000 - 100,000;19;40;-21;672;1104;0
442070;Drawful 2;Indie, Strategy;500,000 - 1,000,000;2428;571;1857;174;16;55
442080;Riders of Icarus;Adventure, Indie, RPG;1,000,000 - 2,000,000;6899;3533;3366;357;113;104
442120;Pinball FX3;Indie, Simulation, Early Access;500,000 - 1,000,000;3736;510;3226;443;164;271
442140;Dyadic;Indie, Strategy;0 - 20,000;18;5;13;0;0;0
442190;Mind Dead;Action, Adventure, Casual, Indie;0 - 20,000;12;30;-18;13;13;0
442210;Switchcars;Casual, Free to Play, Indie;50,000 - 100,000;388;41;347;7;7;1
442220;Iron Madness;Action, Indie;0 - 20,000;47;50;-3;0;0;0
442260;Sprinter;Action, Adventure, Casual, Indie;0 - 20,000;33;9;24;0;0;0
442290;Pointless;Indie, RPG, Strategy;20,000 - 50,000;163;98;65;24;38;0
442500;Age of Gladiators;Adventure, Casual, Indie;100,000 - 200,000;550;147;403;262;269;2
442660;The SoulKeeper VR;Action, Indie, Simulation, Early Access;0 - 20,000;47;34;13;0;0;0
442710;Fantasy Tales Online;Free to Play;100,000 - 200,000;317;135;182;55;72;0
442760;Endless Burst;RPG, Strategy;0 - 20,000;1;4;-3;0;0;0
442770;The Minims;Action, Simulation, Strategy, Early Access;0 - 20,000;14;5;9;20;20;0
442780;STRAFE: Gold Edition;Casual, RPG;200,000 - 500,000;1686;631;1055;239;112;3
442810;UFO Online: Invasion;RPG, Strategy;200,000 - 500,000;346;241;105;27;27;0
442860;Vega Tank;Casual, Indie, RPG, Early Access;0 - 20,000;2;1;1;0;0;0
442890;Magic Potion Explorer;Action, Indie, RPG;0 - 20,000;50;41;9;0;0;0
443000;DUAL GEAR;Adventure, Casual, Indie;0 - 20,000;246;75;171;31;31;1
443020;Victory and Glory: Napoleon;Action, Free to Play, Strategy;20,000 - 50,000;94;28;66;0;0;3
443070;Insane Insects: The Inception;;0 - 20,000;1;8;-7;0;0;0
443110;Armored Warfare;Adventure, Indie;500,000 - 1,000,000;2503;1127;1376;2507;334;256
443250;Legacy of the Elder Star;Adventure;0 - 20,000;48;6;42;9;9;0
443260;Hero Generations: ReGen;Adventure, Casual, Indie, Simulation;50,000 - 100,000;51;36;15;0;0;1
443330;Malus Code;Action, Adventure, Casual, Indie;0 - 20,000;71;30;41;305;305;0
443360;Red Comrades 2: For the Great Justice. Reloaded;Action, Indie, Racing;50,000 - 100,000;247;43;204;284;284;1
443370;The Treasures of Montezuma 5;Action, Adventure, Indie;100,000 - 200,000;108;48;60;314;314;6
443380;Tokyo Babel;Action, Adventure, Indie, RPG;0 - 20,000;69;8;61;0;0;0
443420;Artificial Defense;Action, Adventure, Indie;20,000 - 50,000;171;35;136;248;248;0
443420;Artificial Defense;Indie, Simulation, Strategy;20,000 - 50,000;171;35;136;248;248;0
443450;LASTFIGHT;Indie, Simulation, Strategy;0 - 20,000;60;15;45;66;95;0
443460;Star Sky 2;Adventure, Indie, Simulation;0 - 20,000;66;12;54;125;125;0
443530;Adam and Eve: The Game - Chapter 1;Action, Indie, Early Access;0 - 20,000;23;71;-48;75;75;0
443570;DreamBreak;Action;20,000 - 50,000;48;54;-6;0;0;0
443580;Antenna;Action, Indie;200,000 - 500,000;1842;607;1235;15;20;0
443630;Chicku;Animation & Modeling, Design & Illustration, Education, Software Training, Video Production, Web Publishing;0 - 20,000;67;8;59;0;0;0
443650;Wailing Heights;Action, Adventure, Indie;0 - 20,000;92;22;70;426;426;0
443700;The Inner Sea;Casual, Indie, Racing;0 - 20,000;16;8;8;0;0;0
443800;Ruckus Ridge VR Party;Casual;0 - 20,000;36;20;16;0;0;0
443810;This Is the Police;Action, Indie;500,000 - 1,000,000;7997;1634;6363;586;387;96
443830;The Daring Mermaid Expedition;Action, Casual, Free to Play, Strategy;0 - 20,000;11;10;1;0;0;0
443850;Tross;Casual, Indie, RPG, Simulation;0 - 20,000;22;34;-12;0;0;0
443880;Loot Rascals;Action, Adventure, Indie, RPG;20,000 - 50,000;139;59;80;81;132;0
443890;BUCK: Saturday Morning Cartoon Apocalypse;Adventure, Indie, RPG;0 - 20,000;47;8;39;0;0;0
443970;S2ENGINE HD;Adventure, Indie, RPG;20,000 - 50,000;205;75;130;38;38;2
443980;Burokku Girls;Casual, Indie, Simulation;0 - 20,000;36;18;18;0;0;0
444000;Super Night Riders;Action;0 - 20,000;171;26;145;0;0;0
444020;Coffee Pot Terrarium;Casual;0 - 20,000;4;5;-1;0;0;0
444090;Paladins;Casual;10,000,000 - 20,000,000;285699;48938;236761;3404;492;11441
444130;Auralux: Constellations;Action, Casual, Simulation;20,000 - 50,000;108;29;79;0;0;4
444140;Sonicomi;Strategy;20,000 - 50,000;477;50;427;195;195;1
444160;Bonsai;Simulation;50,000 - 100,000;89;74;15;175;187;0
444170;Unhack 2;Simulation;0 - 20,000;76;4;72;0;0;2
444180;Techwars Online;Casual, Simulation;20,000 - 50,000;80;44;36;0;0;0
444190;Princess Edge - Dragonstone;Action, Casual, Indie, Sports, Early Access;0 - 20,000;22;6;16;0;0;0
444200;World of Tanks Blitz;Strategy;10,000,000 - 20,000,000;100980;24691;76289;4995;167;21442
444210;Strike Force: Desert Thunder;Casual, Indie, Sports;0 - 20,000;4;23;-19;0;0;0
444220;Asteroid Bounty Hunter;Casual;100,000 - 200,000;477;253;224;239;232;1
444250;Crown and Council;Utilities;200,000 - 500,000;480;270;210;70;93;0
444260;Mindless Running;RPG;20,000 - 50,000;254;136;118;155;234;0
444270;Hypersensitive Bob;Adventure, Casual, Indie;0 - 20,000;47;9;38;193;193;0
444280;Alice's Patchwork;Adventure, Casual, Indie;200,000 - 500,000;197;40;157;339;444;4
444320;Jumpix Jump;Action;0 - 20,000;21;22;-1;0;0;0
444330;Battleships at Dawn!;Adventure, Indie;0 - 20,000;2;0;2;0;0;0
444350;HACK_IT;Action, Indie;20,000 - 50,000;36;110;-74;0;0;0
444410;Find Out;Action, Simulation;100,000 - 200,000;67;53;14;232;215;274
444420;24 Hours 'til Rescue;Action, Adventure, Indie;20,000 - 50,000;22;62;-40;1;1;0
444430;Zeus vs Monsters - Math Game for kids;Action, Adventure, Indie, RPG;20,000 - 50,000;43;15;28;1;1;1
444460;Love is Blind: Mutants;Simulation;100,000 - 200,000;40;82;-42;264;268;0
444470;Moor;Action, Adventure;0 - 20,000;16;5;11;0;0;0
444480;Broken Dreams;Design & Illustration;500,000 - 1,000,000;326;137;189;227;247;0
444490;POLYWAR;Action, Indie;200,000 - 500,000;363;150;213;251;268;0
444520;Leave Me Alone: A Trip To Hell;Action, Casual, Indie, Racing, Simulation;20,000 - 50,000;79;20;59;308;312;0
444520;Leave Me Alone: A Trip To Hell;Action, Indie;20,000 - 50,000;79;20;59;308;312;0
444530;Light Repair Team #4;Indie;20,000 - 50,000;43;4;39;24;24;0
444550;Void 21;Adventure, Casual, Indie, RPG;0 - 20,000;25;5;20;0;0;0
444580;ALONE IN SPACE;Adventure, Indie;20,000 - 50,000;85;75;10;2889;2889;0
444580;ALONE IN SPACE;Action, Adventure, Casual, Indie, Strategy;20,000 - 50,000;85;75;10;2889;2889;0
444590;Skautfold: Shrouded in Sanity;Simulation;50,000 - 100,000;387;75;312;8;8;0
444620;SpellKnights;Action, Adventure;50,000 - 100,000;34;45;-11;5;7;0
444640;Bloons TD Battles;Action, Indie, Simulation, Strategy, Early Access;1,000,000 - 2,000,000;24409;2535;21874;489;113;557
444650;Endciv;Adventure, Indie, RPG;0 - 20,000;24;45;-21;0;0;0
444670;Super Impossible Road;Action, Indie;0 - 20,000;81;11;70;0;0;0
444690;TRAPPED;Adventure;200,000 - 500,000;144;253;-109;242;242;1
444710;Battle Crust;Adventure;0 - 20,000;30;5;25;0;0;0
444710;Battle Crust;Adventure;0 - 20,000;30;5;25;0;0;0
444720;Inexistence;Adventure;50,000 - 100,000;235;119;116;206;280;0
444740;Cologne;Adventure, Indie;0 - 20,000;5;5;0;0;0;0
444770;Mimpi Dreams;Casual, Indie;20,000 - 50,000;720;49;671;71;88;6
444800;NO THING;Free to Play;20,000 - 50,000;252;36;216;337;337;0
444830;Concrete and Steel;Action, Indie;0 - 20,000;18;9;9;0;0;0
444870;Combat Racers;Casual, Indie, Simulation;0 - 20,000;6;3;3;0;0;0
444930;Zaccaria Pinball;Indie, Simulation;200,000 - 500,000;1044;201;843;13;17;21
444940;UBERMOSH:BLACK;Adventure, Indie, Simulation;50,000 - 100,000;274;52;222;88;98;1
444950;Let's Eat! Seaside Cafe;Action, Indie;0 - 20,000;1;2;-1;0;0;0
444970;SPATIAL SOUND CARD;Adventure, Free to Play, Indie;20,000 - 50,000;161;67;94;219;219;9
444990;Ad Exitum;Casual, Simulation;0 - 20,000;1;3;-2;0;0;0
445000;Nova Nukers!;Adventure;0 - 20,000;26;4;22;0;0;0
445020;Frozen Synapse 2;Adventure;0 - 20,000;150;76;74;684;1319;1
445040;Sorcery! Part 3;Action, Indie, Strategy;0 - 20,000;88;9;79;0;0;1
445050;Paintey;Adventure, Casual, Indie;0 - 20,000;4;1;3;0;0;0
445070;Tatsu;Action, Adventure, Casual, Indie;0 - 20,000;26;8;18;0;0;1
445110;Tasty Planet: Back for Seconds;Action, Casual, Indie;0 - 20,000;420;33;387;671;870;0
445130;The Average Everyday Adventures of Samantha Browne;Indie, Racing;100,000 - 200,000;856;195;661;11;15;2
445140;Smell Of Death;Action, Indie;0 - 20,000;37;20;17;0;0;0
445140;Smell Of Death;Adventure, Indie, Early Access;0 - 20,000;37;20;17;0;0;0
445170;The Haunting of Billy Classic;Action, Casual, Indie;20,000 - 50,000;28;12;16;226;249;0
445190;Expeditions: Viking;Casual, Indie, Simulation, Early Access;200,000 - 500,000;2966;586;2380;389;473;63
445210;Tiny Knight;Action, Casual, Indie, Simulation;0 - 20,000;20;10;10;0;0;0
445220;Avorion;Action, Indie, Early Access;500,000 - 1,000,000;10230;1088;9142;4815;1507;1016
445230;Lost girl`s [diary];Adventure, Indie;50,000 - 100,000;838;188;650;25;39;0
445310;Might and Magic: Heroes VII – Trial by Fire;Action, Indie, Simulation;0 - 20,000;834;438;396;1534;1871;173
445350;Atomic Space Command;Casual, Indie;0 - 20,000;7;10;-3;0;0;0
445420;Aselia the Eternal -The Spirit of Eternity Sword-;Action, Indie;0 - 20,000;56;12;44;0;0;0
445430;Seinarukana -The Spirit of Eternity Sword 2-;Action, Casual;0 - 20,000;27;3;24;0;0;3
445550;Watson's Watch;Action, Indie, Early Access;0 - 20,000;9;3;6;0;0;0
445600;Void Raiders;Action, Casual, Indie, Strategy;0 - 20,000;54;22;32;0;0;0
445670;The Stargazers;Casual, Indie, Strategy;0 - 20,000;7;8;-1;0;0;0
445720;Battle Islands: Commanders;Action, Indie;200,000 - 500,000;400;445;-45;59;78;12
445730;Watch paint dry;Action, Adventure, Casual, Indie;0 - 20,000;0;0;0;0;0;0
445750;Settled;Violent, Gore, Action, Adventure, Casual, Indie;0 - 20,000;111;20;91;48;48;0
445770;Airport Madness 3D;Indie, Massively Multiplayer, RPG, Early Access;0 - 20,000;267;55;212;727;785;5
445800;Love Language Japanese;Action, Indie;0 - 20,000;135;30;105;0;0;0
445840;Undead vs Plants;Indie, RPG;20,000 - 50,000;19;29;-10;0;0;0
445860;Toy Plane Heroes;Action, Casual, Indie, Simulation, Early Access;0 - 20,000;40;10;30;0;0;0
445870;Phantom Trigger;Action, Casual, Indie, Simulation;0 - 20,000;54;32;22;124;124;0
445950;Asher;Action, Adventure, Casual, Indie;0 - 20,000;11;1;10;0;0;0
445980;Wizard of Legend;Action, Adventure, Indie;1,000,000 - 2,000,000;15831;1546;14285;576;211;217
446000;Stellar Monarch;Simulation;50,000 - 100,000;176;45;131;41;75;0
446010;CitiesCorp Concept - Build Everything on Your Own;Action, Adventure, Indie;0 - 20,000;5;6;-1;0;0;0
446020;Jalopy;Action, Adventure, Indie, Early Access;200,000 - 500,000;6541;1945;4596;507;263;45
446030;Corroded;Casual, Free to Play, Strategy;200,000 - 500,000;73;14;59;76;70;0
446040;Blade Arcus from Shining: Battle Arena;Action, Adventure, Indie;0 - 20,000;177;35;142;24;34;1
446050;Operation KREEP;Adventure, Indie;0 - 20,000;14;3;11;0;0;0
446050;Operation KREEP;Action, Indie;0 - 20,000;14;3;11;0;0;0
446060;akeytsu Indie 2017;Action, Casual, Indie;0 - 20,000;38;4;34;0;0;0
446070;ecotone;Free to Play, Indie, RPG;0 - 20,000;22;3;19;0;0;0
446100;Mantis Burn Racing;Casual;0 - 20,000;89;32;57;20;20;0
446100;Mantis Burn Racing;Adventure, Indie;0 - 20,000;89;32;57;20;20;0
446110;Happy Critters;Adventure;0 - 20,000;1;0;1;0;0;0
446120;Bunker Punks;Casual, Indie;20,000 - 50,000;298;107;191;287;287;1
446150;GUNS UP!;Indie, Simulation;500,000 - 1,000,000;4189;1626;2563;396;295;101
446240;Trawl;Action, Adventure, Casual, Indie;0 - 20,000;25;13;12;0;0;0
446250;Silver Bullet: Prometheus;Action, Casual, Indie, Simulation;0 - 20,000;44;18;26;0;0;0
446310;Sabres of Infinity;Action, Adventure, Casual, Indie;0 - 20,000;120;7;113;0;0;5
446330;Guns of Infinity;Indie;0 - 20,000;92;4;88;0;0;3
446380;Sophie's Curse;Adventure, Indie;50,000 - 100,000;378;72;306;200;309;2
446390;Onechanbara Z2: Chaos;Casual, Indie;20,000 - 50,000;635;181;454;0;0;3
446430;Doctor Watson - Treasure Island;Indie;0 - 20,000;0;6;-6;0;0;0
446440;Doctor Watson - The Riddle of the Catacombs;Adventure, Free to Play, Indie, RPG, Early Access;20,000 - 50,000;1;9;-8;0;0;0
446450;Blaster Simulator;Action, Indie, Racing;0 - 20,000;15;27;-12;0;0;0
446450;Blaster Simulator;Action, Indie, Racing;0 - 20,000;15;27;-12;0;0;0
446460;Highland Warriors;Adventure, Indie, RPG, Strategy;0 - 20,000;30;19;11;0;0;2
446470;New York Taxi Simulator;Indie, Strategy;0 - 20,000;15;47;-32;0;0;0
446490;Rail Cargo Simulator;Indie, RPG, Early Access;0 - 20,000;6;41;-35;0;0;0
446510;Armed and Gelatinous;Casual, Indie;0 - 20,000;5;0;5;0;0;0
446530;One Last Crane;Indie, Simulation;0 - 20,000;3;3;0;0;0;0
446540;Smash Up;Action, Casual, Indie, Simulation;20,000 - 50,000;137;94;43;141;141;2
446550;Infinite Minigolf;Indie;0 - 20,000;94;28;66;0;0;0
446560;Just Dance 2017;Action, Adventure, Casual, Indie, Racing, Sports;50,000 - 100,000;1546;413;1133;535;873;5
446570;Grove - VR Browsing Experience;Action, Adventure, Casual, Indie, Strategy;0 - 20,000;0;6;-6;0;0;0
446590;7 Mages;Simulation, Strategy;0 - 20,000;82;49;33;0;0;2
446600;Magi Trials;Action, Adventure, Casual, Indie, RPG, Strategy;0 - 20,000;97;21;76;282;478;0
446610;Bunny Bounce;Adventure, Casual, Indie;0 - 20,000;39;36;3;92;92;0
446620;Zombie Training Simulator;Action, Casual, Indie;100,000 - 200,000;509;50;459;135;162;1
446640;Space Pilgrim Episode IV: Sol;Indie, Strategy;100,000 - 200,000;303;37;266;210;241;1
446760;Neighborhorde;Action, Adventure, Indie, RPG;0 - 20,000;34;4;30;0;0;0
446770;Skeet: VR Target Shooting;Adventure, Indie;50,000 - 100,000;124;39;85;15;17;1
446780;AMOK;Utilities;50,000 - 100,000;86;114;-28;277;289;0
446790;Diluvion: Resubmerged;Action;100,000 - 200,000;654;388;266;153;219;2
446800;Transport Fever;Action, Indie, Early Access;500,000 - 1,000,000;8629;1727;6902;5319;2005;277
446810;Blossom Tales: The Sleeping King;Indie, Strategy;100,000 - 200,000;439;58;381;0;0;3
446830;The Lonesome Fog;Adventure, Casual, Free to Play, Indie, Simulation;20,000 - 50,000;69;9;60;0;0;0
446840;Splasher;Adventure, Indie, Simulation;20,000 - 50,000;873;64;809;158;275;3
446850;Mindball Play;Action, Adventure, Casual, Indie;0 - 20,000;67;18;49;239;328;1
446870;Glitchrunners;Adventure, Casual, Free to Play;0 - 20,000;5;20;-15;2;2;0
446910;Night Blights;Casual, Free to Play, Indie, Early Access;0 - 20,000;90;9;81;0;0;1
446990;The Huntsman: Winter's Curse;Free to Play, RPG;100,000 - 200,000;205;79;126;57;57;2
447000;Grimsfield;Free to Play, RPG;0 - 20,000;19;2;17;0;0;0
447010;Bird of Light;Casual, Free to Play, Sports;0 - 20,000;20;3;17;5;5;0
447020;Farming Simulator 17;Adventure, Casual, Indie;500,000 - 1,000,000;20563;1430;19133;5925;1854;905
447040;Watch_Dogs 2;Casual, Indie, Strategy;1,000,000 - 2,000,000;50625;10246;40379;2084;898;574
447100;XLR;Action, Indie;0 - 20,000;8;14;-6;0;0;0
447120;Where the Water Tastes Like Wine;Action, Indie, RPG, Strategy;50,000 - 100,000;981;265;716;198;263;10
447150;APE OUT;Action, Casual, Indie, Strategy;100,000 - 200,000;2440;140;2300;170;205;3
447170;Destiny's Princess: A War Story, A Love Story;Education, Software Training, Utilities;20,000 - 50,000;198;61;137;0;0;0
447180;My Secret Pets!;Free to Play, Indie, Strategy;0 - 20,000;88;39;49;0;0;0
447190;Pub Encounter;Adventure, Indie;0 - 20,000;210;35;175;530;530;0
447200;The Men of Yoshiwara: Ohgiya;Action, Adventure, Casual, Indie;0 - 20,000;177;27;150;39;39;1
447210;Blink;Casual, Strategy;0 - 20,000;70;6;64;0;0;0
447240;Zasa - An AI Story;Indie, Strategy;20,000 - 50,000;128;9;119;0;0;0
447270;IKEA VR Experience;Adventure, Indie, RPG;50,000 - 100,000;240;104;136;9;8;1
447290;Redeemer: Enhanced Edition;Action, Casual, Indie;200,000 - 500,000;2298;346;1952;187;169;3
447310;Paper Train Traffic;Action, Casual, Indie;20,000 - 50,000;78;24;54;111;178;0
447330;Sluggy's Fruit Emporium;Indie;0 - 20,000;0;0;0;0;0;0
447530;VA-11 Hall-A: Cyberpunk Bartender Action;Indie, Simulation;500,000 - 1,000,000;30421;726;29695;581;405;79
447540;Lost Cosmonaut;Indie, RPG, Simulation, Strategy;0 - 20,000;0;2;-2;0;0;0
447570;Regeria Hope Episode 1;Action, Indie;50,000 - 100,000;293;58;235;100;100;0
447690;Dimensional Intersection;Action, Casual, Indie, Strategy;0 - 20,000;29;12;17;0;0;0
447700;Crystal Crisis;Action, Indie, Early Access;0 - 20,000;83;24;59;21;21;1
447780;LostWinds;Adventure, Indie;50,000 - 100,000;502;113;389;226;264;3
447800;LostWinds 2: Winter of the Melodias;Casual;20,000 - 50,000;223;44;179;234;234;2
447820;Day of Infamy;Action, Adventure, Casual, Indie;1,000,000 - 2,000,000;18093;3780;14313;1725;291;36
447850;The Next Door;Action, Indie, Strategy;200,000 - 500,000;433;378;55;201;209;1
447860;Maria the Witch;Action, Casual, Indie;0 - 20,000;40;22;18;325;358;0
447890;Cat on a Diet;Strategy;100,000 - 200,000;664;147;517;213;261;0
447920;Drift (Over) Drive;Adventure, Free to Play, Massively Multiplayer, RPG;200,000 - 500,000;20;25;-5;250;254;0
447930;LYDIA: SWEET DREAMS;Action, Indie;0 - 20,000;4;0;4;0;0;0
447940;Brine;Adventure, Indie;0 - 20,000;103;281;-178;5;5;0
447950;Bad Caterpillar;Casual, Strategy;20,000 - 50,000;102;7;95;187;187;0
447960;XCavalypse;Action, Adventure, Casual, Indie, RPG, Simulation, Strategy;0 - 20,000;28;17;11;0;0;0
447980;Blast Brawl 2;Casual, Indie;20,000 - 50,000;22;1;21;0;0;0
447990;Spectrubes;Action, Casual, Indie;0 - 20,000;13;8;5;325;347;0
447990;Spectrubes;Action, Casual, Indie;0 - 20,000;13;8;5;325;347;0
448000;Sparkle ZERO;Violent, Gore, Action, Adventure;20,000 - 50,000;168;154;14;206;229;0
448010;RePete;Action, Casual, Indie;0 - 20,000;32;6;26;272;272;0
448020;Share;Action, Indie;20,000 - 50,000;205;79;126;191;191;1
448020;Share;Action, Adventure, Indie, Simulation, Early Access;20,000 - 50,000;205;79;126;191;191;1
448060;X-17;Indie, Strategy;0 - 20,000;42;44;-2;256;269;1
448070;Red Risk;Adventure, Casual, Indie, Strategy;200,000 - 500,000;499;350;149;261;257;3
448080;Fibbage XL;Casual, Indie;50,000 - 100,000;248;15;233;46;73;25
448090;Virtual Rogue;Indie, RPG, Strategy;0 - 20,000;16;10;6;0;0;0
448110;So Long Earth;Casual, Free to Play, Indie, Strategy;0 - 20,000;28;19;9;0;0;0
448140;Night light;Action;0 - 20,000;0;4;-4;0;0;0
448150;Mystica: The Ninth Society;Adventure, Indie, RPG;0 - 20,000;29;18;11;228;228;0
448160;WOLFLAME;Action, Adventure, Casual, Indie;20,000 - 50,000;81;12;69;0;0;0
448170;Last Dream: World Unknown;Action, Adventure, Casual, Indie, RPG;20,000 - 50,000;52;15;37;0;0;1
448230;AsteroidsHD;Action, Indie, Simulation, Early Access;0 - 20,000;12;16;-4;0;0;0
448240;Hybrid Animals;Action, Adventure, Indie;50,000 - 100,000;232;173;59;105;141;2
448280;Job Simulator;Action, Indie;500,000 - 1,000,000;3591;379;3212;278;201;69
448290;Nefarious;Casual, Indie;0 - 20,000;337;58;279;592;1096;1
448300;Logic Missile;Action, Adventure, Indie;0 - 20,000;3;1;2;0;0;0
448310;Bitardia Cards: Memes of 2ch;Action, Adventure, Indie;20,000 - 50,000;142;47;95;34;50;0
448320;GIBZ;Simulation, Strategy;100,000 - 200,000;870;137;733;171;197;7
448370;IS Defense;Strategy;50,000 - 100,000;1336;110;1226;196;196;2
448380;Escape: Close Call;Casual, Simulation, Strategy;0 - 20,000;28;4;24;0;0;0
448390;Maneki's Curse;Adventure, Casual, Indie;0 - 20,000;18;13;5;0;0;0
448390;Maneki's Curse;Indie, Strategy;0 - 20,000;18;13;5;0;0;0
448400;Hidden Object 6-in-1 bundle;Action;20,000 - 50,000;180;46;134;1003;588;10
448440;Bizarre Earthquake;Strategy;100,000 - 200,000;263;193;70;255;312;1
448470;Bacteria;Strategy;1,000,000 - 2,000,000;218;160;58;361;388;22
448480;Caravanserail;Free to Play;20,000 - 50,000;31;26;5;214;214;0
448500;Little Walker;Adventure, Indie, RPG;0 - 20,000;35;2;33;206;206;0
448510;Overcooked;Action, Indie;1,000,000 - 2,000,000;11930;1204;10726;331;213;117
448520;Deranged Rabbits;Action, Indie, Simulation, Early Access;0 - 20,000;34;1;33;251;251;0
448530;Square's Route;Casual, Simulation;20,000 - 50,000;42;8;34;0;0;0
448540;Terror Lab;Casual, Simulation;0 - 20,000;55;36;19;0;0;0
448540;Terror Lab;Casual, Simulation;0 - 20,000;55;36;19;0;0;0
448550;Minimal;Action, Casual, Indie;0 - 20,000;28;2;26;0;0;0
448560;Mind Games;Indie;20,000 - 50,000;122;44;78;242;242;0
448570;Origin Of Destiny: Crimson Awakening;Action, Indie, Racing;50,000 - 100,000;91;34;57;9;9;0
448580;Dead End Road;Indie, Simulation, Strategy;20,000 - 50,000;231;36;195;0;0;0
448610;Draw Rider;Action, Indie;50,000 - 100,000;125;43;82;229;287;10
448620;Rebirth of Island;Action, Indie, Early Access;0 - 20,000;55;43;12;0;0;0
448630;Rabiez: Epidemic;Indie, Strategy;200,000 - 500,000;87;118;-31;247;260;1
448640;Elements II: Hearts of Light;Action, Adventure, Casual, Indie, Early Access;100,000 - 200,000;80;55;25;250;249;1
448650;GEO Master;Action, Indie;0 - 20,000;24;8;16;0;0;0
448670;Pinball HD Collection;Action, Indie;0 - 20,000;56;33;23;0;0;1
448690;Lionessy Story;Action, Casual, Indie, Strategy;0 - 20,000;40;30;10;0;0;0
448710;VirZOOM Arcade;Indie, RPG;50,000 - 100,000;24;6;18;2;2;1
448720;Puzzle Box;Action, Indie, Racing, Early Access;0 - 20,000;27;6;21;0;0;0
448730;Imhotep, Pyramid Builder;Casual, Indie, Simulation;0 - 20,000;12;4;8;0;0;0
448750;Infinity Saga;Casual, Indie;0 - 20,000;20;8;12;0;0;0
448780;Sixtieth Kilometer;Action, Adventure, Free to Play, Massively Multiplayer, RPG;200,000 - 500,000;1203;350;853;274;296;5
448790;Infinity Wings - Scout & Grunt;Casual, Simulation, Strategy;20,000 - 50,000;26;16;10;253;270;0
448800;Semispheres;Action, Adventure, Indie;0 - 20,000;61;6;55;0;0;1
448810;Torgar's Quest;Action, Sports;0 - 20,000;12;3;9;0;0;0
448820;Planet in the Shadows;Free to Play, RPG, Strategy;0 - 20,000;19;8;11;0;0;0
448830;ASMR Universe;Indie, Simulation;100,000 - 200,000;79;36;43;217;310;0
448850;Overload;Casual;100,000 - 200,000;1671;102;1569;224;242;11
448860;Colony 42;Casual, Free to Play, Indie, Early Access;0 - 20,000;20;8;12;0;0;0
448880;Spells 'n' Stuff;Action, Indie, Strategy;0 - 20,000;7;4;3;0;0;0
448910;Axes and Acres;Adventure, Casual, Indie, Simulation;20,000 - 50,000;111;23;88;104;104;3
448930;About Elise;Action, Indie;50,000 - 100,000;102;30;72;1;1;0
448960;I, Hope;Adventure, Casual, Indie;0 - 20,000;28;7;21;0;0;0
448980;The Divergent Series: Allegiant VR;Action, Adventure, Indie;50,000 - 100,000;68;36;32;10;13;0
448990;Phlyndir;Action, Indie;0 - 20,000;1;2;-1;0;0;0
449000;Steno Arcade;Adventure, Casual, Indie;50,000 - 100,000;140;40;100;1;1;0
449020;The Bottom of the Well;Utilities, Video Production, Early Access;50,000 - 100,000;454;80;374;23;23;1
449040;Jesus Christ RPG Trilogy;Action, Racing, Simulation;100,000 - 200,000;1300;212;1088;15;14;2
449050;Rock Paper Scissors Champion;Action, Casual, Indie, Simulation, Strategy;50,000 - 100,000;273;210;63;1;2;0
449060;Cellar;Adventure, Indie, Strategy;50,000 - 100,000;147;33;114;137;215;0
449070;YEARN Tyrant's Conquest;Casual, Indie;0 - 20,000;2;8;-6;0;0;0
449090;Zombie Parking;RPG, Strategy;20,000 - 50,000;69;25;44;282;282;0
449100;City of the Shroud;Action, Adventure, Indie;0 - 20,000;19;5;14;0;0;0
449120;Nanobots;Action, Casual, Indie;20,000 - 50,000;10;5;5;275;282;0
449130;ENGAGE;Action, Indie, Strategy;50,000 - 100,000;59;13;46;0;0;1
449140;Istrolid;Casual, Indie;200,000 - 500,000;2275;327;1948;207;38;7
449150;PataNoir;Casual, Indie;0 - 20,000;13;2;11;0;0;0
449160;Land it Rocket;Indie, RPG, Strategy;0 - 20,000;12;3;9;0;0;0
449170;Gnomes Garden 2;Action, Adventure, Indie, RPG, Strategy;20,000 - 50,000;155;14;141;267;291;0
449180;Meld;Indie;0 - 20,000;28;1;27;0;0;0
449200;Calcu-Late;Simulation, Strategy;500,000 - 1,000,000;198;142;56;222;217;1
449210;Verdict Guilty - 유죄 평결;Action, Adventure, Indie;50,000 - 100,000;629;108;521;151;171;0
449220;A grande bagunça espacial - The big space mess;Casual, Simulation;200,000 - 500,000;692;383;309;250;249;101
449240;Stormworm+;Casual, Indie, Racing, Sports;20,000 - 50,000;56;2;54;0;0;0
449250;A Little Lily Princess;Action, Simulation;0 - 20,000;254;18;236;45;79;0
449250;A Little Lily Princess;Action, Adventure, Indie;0 - 20,000;254;18;236;45;79;0
449300;Planar Conquest;Adventure, Indie;50,000 - 100,000;270;186;84;0;0;9
449310;Spunk and Moxie;Violent, Action, Indie;0 - 20,000;20;3;17;0;0;0
449320;Dino Eggs: Rebirth;Adventure, Free to Play, RPG, Strategy;0 - 20,000;13;6;7;0;0;0
449330;Grid Masters;Action, Indie, Early Access;0 - 20,000;6;5;1;0;0;0
449340;Serafina's Crown;Indie, Strategy;20,000 - 50,000;36;12;24;190;190;0
449350;Backstreets of the Mind;Adventure, Indie;0 - 20,000;13;9;4;0;0;0
449420;Mini's Magic World;Action, Indie;0 - 20,000;6;2;4;0;0;0
449450;SPLIT BULLET;Action;0 - 20,000;57;5;52;0;0;0
449460;Commands & Colors: The Great War;Casual;20,000 - 50,000;48;42;6;188;188;0
449470;Atulos Online;Adventure, Indie;20,000 - 50,000;185;79;106;0;0;0
449500;Hush Hush - Unlimited Survival Horror;Action, Adventure, Casual, Free to Play, Indie, Simulation;0 - 20,000;3;7;-4;0;0;0
449510;The Crow's Eye;Action;20,000 - 50,000;129;42;87;0;0;0
449520;Rush for gold: California;Action, Adventure, Casual, Indie;20,000 - 50,000;31;14;17;225;211;0
449530;Grand Pigeon's Duty;Action, Adventure, Indie, RPG;50,000 - 100,000;449;133;316;273;282;0
449540;There's Poop In My Soup;Action, Indie, Early Access;200,000 - 500,000;3795;494;3301;216;249;6
449550;Chicken Invaders 2;Adventure, Free to Play, Simulation;20,000 - 50,000;364;12;352;280;280;5
449560;Space Ranger ASK;Action, Casual, Indie;0 - 20,000;9;2;7;0;0;0
449610;Monster Boy and the Cursed Kingdom;Action, Indie;50,000 - 100,000;1792;177;1615;1297;2132;17
449640;Bloody Zombies;Casual, Indie, Strategy;0 - 20,000;55;26;29;51;51;1
449680;SAMOLIOTIK;Education, Software Training;500,000 - 1,000,000;2243;426;1817;3341;287;2
449690;Fatal Fight;Education, Software Training;0 - 20,000;46;15;31;0;0;0
449700;Ariel;Adventure, Indie;0 - 20,000;9;3;6;0;0;0
449710;REDCON;Massively Multiplayer, Simulation, Early Access;50,000 - 100,000;451;106;345;159;247;4
449760;Tenrow;Action, Indie, Strategy, Early Access;100,000 - 200,000;130;29;101;256;228;0
449770;Legend of Moros;Indie, Simulation;0 - 20,000;6;0;6;0;0;0
449800;Attack on Titan / A.O.T. Wings of Freedom;Action, Casual, Indie;100,000 - 200,000;3155;553;2602;507;721;16
449820;Daughter of Shadows: An SCP Breach Event;Indie, Strategy;0 - 20,000;48;38;10;0;0;0
449940;! That Bastard Is Trying To Steal Our Gold !;Action, Casual, Indie;50,000 - 100,000;43;66;-23;394;403;4
449960;Book of Demons;Action, Adventure, Indie, Massively Multiplayer, Simulation;500,000 - 1,000,000;9233;2317;6916;248;194;255
450020;DAMAGE CONTROL;Adventure, Indie;0 - 20,000;11;14;-3;247;247;0
450040;Stealth Labyrinth;Indie, RPG, Strategy;0 - 20,000;16;14;2;0;0;0
450050;Yon Paradox;Adventure, Indie;0 - 20,000;32;22;10;168;168;0
450060;Insane Decay of Mind: The Labyrinth;Action, Adventure, Indie, RPG;0 - 20,000;28;26;2;0;0;0
450120;Capitalism Plus;Casual, Indie;0 - 20,000;83;14;69;0;0;2
450120;Capitalism Plus;Action, Adventure, Indie;0 - 20,000;83;14;69;0;0;2
450140;Seven Kingdoms: Ancient Adversaries;Adventure, Casual;50,000 - 100,000;167;5;162;1;1;4
450150;Campgrounds: The Endorus Expedition Collector's Edition;Casual, Indie, Strategy;0 - 20,000;2;0;2;0;0;1
450170;BOOR;Free to Play, Strategy;50,000 - 100,000;176;36;140;196;196;1
450190;MAZE LORD;Adventure, Indie;50,000 - 100,000;176;49;127;395;401;0
450220;Overload Playable Teaser 3.0;Action, Indie;100,000 - 200,000;628;39;589;57;101;0
450250;Aegis of Earth: Protonovus Assault;Action, Adventure, Casual, Indie;0 - 20,000;39;19;20;0;0;0
450290;Assault on Arnhem;Action, Indie;20,000 - 50,000;29;33;-4;387;387;1
450390;The Lab;Gore, Indie;1,000,000 - 2,000,000;5334;273;5061;104;44;34
450440;Creepy Castle;Casual, Sports;0 - 20,000;169;20;149;0;0;2
450500;Ace of Seafood;Indie, RPG, Strategy;20,000 - 50,000;478;57;421;94;94;1
450540;Hot Dogs, Horseshoes & Hand Grenades;Indie;1,000,000 - 2,000,000;16933;528;16405;1040;419;409
450570;Roadworks Simulator;Casual, Indie, Simulation, Sports, Strategy;0 - 20,000;5;15;-10;0;0;0
450590;Safety Driving Simulator: Car;Adventure, Indie;0 - 20,000;29;34;-5;0;0;0
450600;Safety Driving Simulator: Motorbike;Adventure, Indie, RPG;0 - 20,000;13;17;-4;0;0;0
450630;Woeful Woebots;Action;0 - 20,000;13;7;6;0;0;0
450650;Polyology;Casual, Indie, Simulation, Strategy;0 - 20,000;22;2;20;141;141;0
450670;Table Top Racing: World Tour;Casual, Indie;100,000 - 200,000;490;145;345;142;185;1
450700;The Spatials: Galactology;Casual, Indie;50,000 - 100,000;176;70;106;248;248;0
450740;Mind Unleashed;Adventure, Indie, RPG;0 - 20,000;20;14;6;0;0;0
450760;GraveRun;Sexual Content, Nudity, Violent, Gore, Action, Free to Play, RPG;0 - 20,000;23;1;22;0;0;0
450850;Cube Land Arena;Action, Adventure, Indie;50,000 - 100,000;149;83;66;301;320;0
450860;Andarilho;Action, Casual, Indie, Strategy;100,000 - 200,000;725;366;359;226;315;110
450950;Danmaku Unlimited 3;Action, Casual, Indie;20,000 - 50,000;165;19;146;0;0;0
451000;Ember Kaboom;Indie, RPG;20,000 - 50,000;98;19;79;0;0;0
451010;Kittypocalypse;Indie, Strategy, Early Access;0 - 20,000;177;23;154;0;0;2
451020;Battle Chasers: Nightwar;Action, Adventure, Indie;200,000 - 500,000;5795;810;4985;778;764;47
451060;Wincars Racer;Adventure, Free to Play, Indie;0 - 20,000;7;4;3;0;0;0
451080;Giant Cop: Justice Above All;Action, Adventure, Indie, Racing, Simulation, Early Access;0 - 20,000;28;10;18;0;0;0
451100;Cubikolor;Casual, Indie;0 - 20,000;32;2;30;322;322;0
451130;Khan: Absolute Power;Indie, RPG;50,000 - 100,000;109;86;23;0;0;86
451140;Drawn: Dark Flight Collector's Edition;RPG, Simulation, Strategy;0 - 20,000;28;11;17;0;0;1
451200;Candlelight;Casual, Indie;0 - 20,000;18;5;13;0;0;0
451210;Rocket Shooter;Action, Indie;0 - 20,000;2;3;-1;0;0;0
451230;Wartune;Indie, RPG, Strategy;20,000 - 50,000;50;50;0;0;0;0
451310;A Fold Apart;Action, Adventure, Indie;0 - 20,000;79;17;62;0;0;1
451340;Gold Rush: The Game;Casual, Indie, Simulation;500,000 - 1,000,000;9070;3576;5494;1532;1377;350
451350;Tropical Fish Shop 2;Indie, Massively Multiplayer, RPG;20,000 - 50,000;16;7;9;254;252;0
451360;Fenrisulfr Puzzle;Casual, Indie;0 - 20,000;27;6;21;0;0;0
451400;Meridian: Squad 22;Action, Adventure, Indie;0 - 20,000;82;41;41;20;20;0
451400;Meridian: Squad 22;Action, Indie;0 - 20,000;82;41;41;20;20;0
451520;theBlu;Action, Casual, Indie, Simulation, Sports;200,000 - 500,000;1087;192;895;83;127;9
451540;Snakes on an Extradimensional Plane;Action, Adventure, Casual, Indie, Early Access;0 - 20,000;6;0;6;0;0;0
451570;Demetrios - The BIG Cynical Adventure;Adventure, Indie, RPG;20,000 - 50,000;289;57;232;107;107;1
451590;¡Zombies! : Faulty Towers;Adventure, Casual;0 - 20,000;1;0;1;0;0;0
451600;CounterAttack;Action, Adventure, Casual, Indie, Racing, Simulation;0 - 20,000;234;24;210;140;140;3
451630;Brute;Casual, Indie;0 - 20,000;23;5;18;0;0;0
451640;C14 Dating;Action, Indie;0 - 20,000;51;6;45;0;0;1
451640;C14 Dating;Adventure, Indie, Simulation;0 - 20,000;51;6;45;0;0;1
451650;Whirligig VR Media Player;Violent, Gore, Adventure, Casual, Indie;50,000 - 100,000;350;90;260;56;54;10
451660;Trucker;Adventure, Indie;0 - 20,000;29;30;-1;271;274;0
451670;War Birds: WW2 Air strike 1942;Action, Adventure, Indie, RPG, Early Access;0 - 20,000;34;27;7;210;210;0
451700;Secrets of Deep Earth Shrine;Indie;0 - 20,000;10;7;3;269;287;0
451760;Highway Blossoms;Adventure, Indie;100,000 - 200,000;2330;123;2207;260;280;7
451780;Trillion: God of Destruction;Violent, Action, Early Access;50,000 - 100,000;302;143;159;265;442;2
451800;End Of The Mine;Action, Adventure, Indie, RPG, Early Access;0 - 20,000;7;6;1;0;0;0
451840;Out of Ammo;Action, Indie;50,000 - 100,000;592;122;470;111;167;0
451870;Nighttime Terror VR: Dessert Defender;Indie, Racing, Sports;0 - 20,000;10;6;4;0;0;0
451880;Catch a Falling Star;Action, Adventure;200,000 - 500,000;424;156;268;251;229;0
451900;WizardCraft;Action, Casual, Indie;0 - 20,000;23;10;13;0;0;0
451920;Thorne - Death Merchants;Action, Indie;100,000 - 200,000;208;48;160;212;215;11
451930;qrth-phyl;Casual, Indie, Simulation;0 - 20,000;19;2;17;0;0;1
451950;EEP Train Simulator Mission;Adventure, Indie, RPG;0 - 20,000;3;12;-9;0;0;0
451960;The Secret of Pineview Forest;Action, Indie;20,000 - 50,000;66;50;16;0;0;0
451960;The Secret of Pineview Forest;Strategy;20,000 - 50,000;66;50;16;0;0;0
451980;The Body VR: Journey Inside a Cell;Free to Play, Indie, Massively Multiplayer, RPG, Simulation, Strategy;50,000 - 100,000;233;19;214;16;17;3
451990;Cranks and Goggles;Animation & Modeling, Design & Illustration;20,000 - 50,000;136;39;97;0;0;0
452000;Military Life: Tank Simulator;Sports, Strategy, Early Access;20,000 - 50,000;13;30;-17;0;0;0
452060;Caveblazers;Indie, RPG, Simulation, Strategy;200,000 - 500,000;3289;477;2812;681;313;55
452120;Midvinter;Action, Adventure, Casual, Indie, Simulation, Early Access;20,000 - 50,000;61;12;49;197;211;1
452180;One Clone Left;Free to Play, Massively Multiplayer, Strategy;0 - 20,000;4;1;3;0;0;0
452230;Spellstone;Action, Indie;100,000 - 200,000;264;148;116;2318;2321;13
452240;Dawn of the Robot Empire;Casual, Indie;0 - 20,000;8;0;8;0;0;0
452320;Party Saboteurs: After Party;Action, Adventure, Casual, Massively Multiplayer;0 - 20,000;32;16;16;116;116;0
452340;Ian's Eyes;Action, Casual, Indie;20,000 - 50,000;65;40;25;244;244;0
452410;Damsel;Violent, Action, Indie, Early Access;0 - 20,000;60;15;45;0;0;0
452420;Koihime Enbu 恋姫†演武;Adventure, Casual, Indie;0 - 20,000;247;42;205;430;430;1
452440;Flowers -Le volume sur printemps-;Action, Adventure, Indie, RPG;50,000 - 100,000;1422;65;1357;911;911;5
452450;Rising Islands;Casual, Indie;0 - 20,000;65;44;21;210;210;0
452450;Rising Islands;Action, Indie, Strategy;0 - 20,000;65;44;21;210;210;0
452490;The Cubicle.;Action, Indie;100,000 - 200,000;537;76;461;7;8;0
452510;UNDER NIGHT IN-BIRTH Exe:Late;Action, Adventure, Indie, Early Access;50,000 - 100,000;845;87;758;352;632;1
452540;Skylar & Plux: Adventure On Clover Island;Indie, Strategy;20,000 - 50,000;362;52;310;0;0;0
452570;Battle Chef Brigade Deluxe;Casual, Simulation, Sports, Early Access;100,000 - 200,000;2086;73;2013;187;220;9
452650;The Rebel;Action, Casual, Indie, Strategy;0 - 20,000;24;33;-9;0;0;0
452710;Realities;Action, Casual, Indie;200,000 - 500,000;184;66;118;74;96;0
452860;Mad Bullets;Action, Indie;0 - 20,000;286;24;262;0;0;1
452930;Insane;Free to Play, Massively Multiplayer, RPG;0 - 20,000;7;10;-3;0;0;0
452940;Theory Test UK 2016/17 - Driving Test Success;Action, Adventure, Indie, RPG;0 - 20,000;34;0;34;0;0;0
452950;Hazard Perception Test UK 2016/17 Bundle - Driving Test Success;Adventure, Indie, Simulation;0 - 20,000;4;4;0;0;0;0
452970;Asemblance;Action, Adventure, Indie;0 - 20,000;82;42;40;5;5;0
453000;Wave Beta;Adventure, Casual, Indie, RPG;100,000 - 200,000;537;44;493;132;209;0
453030;The Fifth Expedition;Casual, Free to Play, Massively Multiplayer, Sports, Strategy;0 - 20,000;12;7;5;0;0;0
453090;Parkitect;Adventure, Casual;200,000 - 500,000;5930;336;5594;697;652;226
453100;Frederic: Resurrection of Music Director's Cut;Action, Indie, RPG, Early Access;50,000 - 100,000;260;56;204;184;254;0
453130;Powargrid;Action, Adventure, Indie;0 - 20,000;27;5;22;0;0;0
453220;BrambleLash;Action, Adventure, Indie;0 - 20,000;11;2;9;0;0;0
453270;Madness Cubed;Animation & Modeling, Design & Illustration;100,000 - 200,000;702;219;483;220;233;0
453290;Awareness Rooms;Casual, Indie, Strategy;50,000 - 100,000;325;77;248;71;71;0
453300;A Healer Only Lives Twice;Indie, Strategy;20,000 - 50,000;147;35;112;138;259;1
453310;Blackwood Crossing;Indie, Strategy;0 - 20,000;329;70;259;91;151;0
453320;Vairon's Wrath;Action, Casual, Indie;0 - 20,000;15;1;14;0;0;0
453340;Hustle Cat;Action, Adventure, Indie, Simulation, Early Access;50,000 - 100,000;1109;87;1022;45;45;4
453350;Vaccine War;Strategy;0 - 20,000;22;8;14;0;0;0
453470;Hacked;Action;0 - 20,000;6;3;3;0;0;0
453480;Shadowverse CCG;Action, Adventure, Indie, RPG;1,000,000 - 2,000,000;10199;3385;6814;9316;403;9408
453500;Frio - Lost in old town;Casual, Indie;0 - 20,000;48;14;34;0;0;0
453510;One Man Is Not No Man;Adventure, Indie, Simulation;0 - 20,000;56;7;49;0;0;0
453650;Marble Void;Action, Adventure, Indie, Early Access;0 - 20,000;18;3;15;8;8;0
453660;Rogue Contracts: Syndicate;Action, Adventure, Casual, Indie;0 - 20,000;16;11;5;254;254;0
453670;The Lost Souls;Adventure, Casual, Indie, Simulation, Sports, Strategy;100,000 - 200,000;86;94;-8;255;246;1
453680;MiniGolf Mania;Action, Simulation, Sports, Strategy;20,000 - 50,000;72;37;35;350;350;0
453690;Dark Quest 2;Violent, Gore, Action, Adventure, Indie, RPG;50,000 - 100,000;473;91;382;158;158;1
453700;prog.1;Action, Adventure, Indie;0 - 20,000;10;2;8;0;0;0
453710;TableTop Soccer;Action, Casual, Indie, Sports;20,000 - 50,000;87;22;65;0;0;0
453720;Last Will;Action, Adventure, Indie, RPG;50,000 - 100,000;237;69;168;173;272;2
453730;Borstal;Action, Indie;0 - 20,000;19;11;8;0;0;0
453740;Spaceman Sparkles 3;Action, Simulation;0 - 20,000;24;4;20;0;0;0
453750;Tyto Ecology;Casual, Indie, Strategy;50,000 - 100,000;314;100;214;144;144;0
453770;Forgotten Tales: Day of the Dead;Casual, Indie, Strategy;0 - 20,000;36;15;21;0;0;0
453780;Secrets of Magic: The Book of Spells;Casual;0 - 20,000;43;4;39;0;0;1
453790;Candice DeBébé's Incredibly Trick Lifestyle;Indie, Simulation, Strategy;0 - 20,000;149;22;127;175;175;0
453790;Candice DeBébé's Incredibly Trick Lifestyle;Action, Indie, Racing, Early Access;0 - 20,000;149;22;127;175;175;0
453810;Blasting Agent: Ultimate Edition;Action, Indie, RPG, Early Access;0 - 20,000;18;17;1;0;0;0
453820;Hero Quest: Tower Conflict;Action, Indie;200,000 - 500,000;86;221;-135;258;249;0
453830;Innoquous 5;Utilities, Early Access;0 - 20,000;27;4;23;170;277;6
453830;Innoquous 5;Action, Indie, Sports, Strategy;0 - 20,000;27;4;23;170;277;6
453850;Dear RED - Extended;Violent, Gore, Action, Adventure, Indie;200,000 - 500,000;232;114;118;210;204;6
453870;Quantum Chess;Action, Adventure, Indie;0 - 20,000;33;15;18;0;0;0
453880;Ninja Outbreak;Adventure, Indie, RPG, Strategy;0 - 20,000;5;2;3;210;210;0
453890;Black Rose;Action;100,000 - 200,000;729;179;550;291;570;1
453900;Apex War;Action, Simulation, Early Access;0 - 20,000;0;0;0;0;0;0
453910;Love is Dead;Casual, Indie;50,000 - 100,000;142;86;56;266;441;3
453910;Love is Dead;Adventure, Casual, Indie, RPG;50,000 - 100,000;142;86;56;266;441;3
453950;To Ash;Utilities;0 - 20,000;21;6;15;214;214;0
453960;Envy the Dead;Action, Simulation;50,000 - 100,000;147;68;79;226;221;1
453980;Airstrike HD;Casual;100,000 - 200,000;205;176;29;267;294;2
453990;Mibibli's Quest;Action, Indie, RPG;20,000 - 50,000;74;3;71;3;3;0
454030;Link;Adventure, Casual, Strategy;0 - 20,000;27;19;8;0;0;0
454060;Blueprint Tycoon;Adventure, Indie;50,000 - 100,000;864;189;675;206;264;1
454070;Boundel: The Second Era;Adventure, Indie;0 - 20,000;165;128;37;0;0;0
454080;Burst;Action, RPG;20,000 - 50,000;22;19;3;313;320;0
454100;Dungeon Escape;Racing, Simulation, Sports;100,000 - 200,000;604;160;444;164;211;3
454120;Starbase;Action, Casual, Indie;200,000 - 500,000;3731;2345;1386;1287;1637;58
454130;Nil-Ninjahtic: Ronin;Action, Indie, RPG;0 - 20,000;21;6;15;0;0;0
454140;First Person Tennis - The Real Tennis Simulator;Adventure;0 - 20,000;283;40;243;309;309;3
454160;Dark Fear;Adventure, Casual, Indie;0 - 20,000;186;10;176;0;0;0
454170;XorceD - Sashiro's Laedrum;Action, Indie, Massively Multiplayer, Early Access;0 - 20,000;18;0;18;0;0;0
454180;CrazyCars3D;Action, Adventure, Indie;50,000 - 100,000;142;70;72;284;272;0
454190;Cubicolor;Indie, Simulation, Early Access;0 - 20,000;178;14;164;0;0;0
454200;Neon Hardcorps;Action, Indie;200,000 - 500,000;125;153;-28;239;227;1
454220;The Temporal Invasion;Strategy;20,000 - 50,000;73;27;46;447;452;1
454230;SLG Remix;Action, Indie, Sports;0 - 20,000;12;29;-17;0;0;0
454240;A Tofu Tail;Free to Play, Racing, Simulation, Sports, Early Access;0 - 20,000;8;1;7;0;0;0
454250;The Eyes of Ara;Action, Adventure, Indie;20,000 - 50,000;524;98;426;227;390;7
454260;The HinterLands;Casual, Indie;0 - 20,000;4;4;0;0;0;0
454320;[the Sequence];Adventure, Casual, Indie, Simulation;20,000 - 50,000;149;15;134;290;290;1
454330;A Room Beyond;Action, Free to Play, Indie, Simulation;0 - 20,000;19;5;14;0;0;0
454350;Days of War: Definitive Edition;Action, Adventure, Indie;20,000 - 50,000;1007;931;76;29;29;1
454370;Battlecursed;Indie, Strategy;0 - 20,000;9;4;5;0;0;0
454380;Champions of Breakfast;Casual, Indie, Simulation, Strategy;0 - 20,000;128;1;127;0;0;1
454390;Rally Copters;Casual, RPG, Simulation;0 - 20,000;4;0;4;0;0;1
454410;GIGA WRECKER;Action, Casual, Indie;50,000 - 100,000;474;114;360;745;751;0
454420;Mini Metal;Casual, Indie, Simulation;0 - 20,000;19;7;12;0;0;0
454430;Crystal Chip Collector;Simulation;0 - 20,000;4;8;-4;0;0;0
454480;Break Through: Artificial Maze;Action, Adventure, Casual, Indie;0 - 20,000;8;3;5;0;0;0
454530;Decisive Campaigns: Barbarossa;Casual, Indie;0 - 20,000;167;19;148;0;0;8
454530;Decisive Campaigns: Barbarossa;Adventure, Casual, Free to Play, Massively Multiplayer, RPG;0 - 20,000;167;19;148;0;0;8
454540;LuckCatchers;;200,000 - 500,000;440;363;77;25;25;3
454550;Qubicle Voxel Editor;Casual;0 - 20,000;80;43;37;0;0;11
454560;Ultimate Fight Manager 2016;Casual, Indie;0 - 20,000;8;15;-7;0;0;0
454570;I Am Caligula;Utilities;0 - 20,000;38;17;21;0;0;0
454580;Spider Wars;Adventure, Indie;0 - 20,000;24;56;-32;0;0;0
454600;Age of Cavemen;Casual, Indie, Simulation;100,000 - 200,000;316;243;73;18;26;0
454610;Demon's Crystals;Action, Racing;0 - 20,000;53;15;38;0;0;0
454630;Button Frenzy;Action, Indie, Strategy;0 - 20,000;13;2;11;0;0;0
454650;DRAGON BALL XENOVERSE 2;Action;1,000,000 - 2,000,000;34713;4180;30533;1947;1000;2107
454670;Piggy Princess;Action;0 - 20,000;27;22;5;299;306;0
454680;MetaTron;Action, Casual, Indie, Early Access;0 - 20,000;49;62;-13;200;250;0
454690;Cyber City 2157: The Visual Novel;Action, Adventure, Indie, Racing, Simulation, Sports;200,000 - 500,000;118;96;22;308;342;0
454700;Shiny Gauntlet;Adventure, Indie, RPG;0 - 20,000;8;14;-6;160;160;0
454720;RAM BOE;Adventure, Simulation;0 - 20,000;15;6;9;0;0;10
454730;World Of Undead;Action, Casual, Indie;0 - 20,000;3;5;-2;0;0;0
454750;Aeternum;Action, Adventure, Indie;0 - 20,000;12;3;9;0;0;0
454770;Mystic Melee;Action, Indie, Simulation, Sports;0 - 20,000;32;12;20;0;0;1
454780;Atriage;Adventure, Indie;0 - 20,000;4;3;1;0;0;0
454830;Beach Ball Valley;Adventure, Indie, Strategy;0 - 20,000;10;0;10;0;0;0
454870;Magic Quest;Strategy, Early Access;50,000 - 100,000;32;17;15;282;282;0
454890;Project Starship;Indie, Strategy;50,000 - 100,000;375;73;302;279;252;0
454900;Amaranthine;Casual;20,000 - 50,000;98;9;89;0;0;0
454910;Twin Saga;Action, Casual, Indie;200,000 - 500,000;590;241;349;67;75;0
454950;Mainlining;Action, Casual, Indie, Sports;100,000 - 200,000;251;66;185;157;209;1
454970;Gravity Den;Action, Indie, RPG, Early Access;20,000 - 50,000;55;11;44;403;465;5
455000;The Lost;Animation & Modeling, Audio Production, Design & Illustration, Education, Early Access;20,000 - 50,000;38;28;10;228;235;0
455020;Jackpot Poker by PokerStars;Action, Indie;100,000 - 200,000;184;179;5;139;213;0
455080;Awakening: The Redleaf Forest Collector's Edition;Action, Indie;0 - 20,000;12;1;11;0;0;0
455100;Gerty;Adventure, Casual, Indie, RPG, Simulation, Strategy;0 - 20,000;37;7;30;0;0;0
455110;Pertinence;Education;0 - 20,000;26;10;16;379;547;0
455120;Stay Close;Indie, Sports;100,000 - 200,000;1004;610;394;113;131;0
455160;PaintLab;Adventure;0 - 20,000;28;8;20;11;11;0
455190;Domain Defense VR;Free to Play, Strategy, Early Access;0 - 20,000;13;4;9;0;0;0
455200;The Battle for Sector 219;Adventure, Casual, Indie, RPG, Strategy;0 - 20,000;18;17;1;0;0;0
455230;Bazaar;Action, Indie;0 - 20,000;12;3;9;0;0;0
455290;Dashing Dinos;Adventure, Casual;0 - 20,000;3;1;2;1;1;0
455300;Deuterium Wars;Adventure, Casual;100,000 - 200,000;471;129;342;0;0;0
455310;Bloody Chronicles - New Cycle of Death Visual Novel;Adventure, Indie, Simulation;0 - 20,000;81;19;62;0;0;0
455340;Warhammer 40,000: Armageddon - Da Orks;Casual;0 - 20,000;56;27;29;0;0;3
455400;PAC-MAN 256;Casual;100,000 - 200,000;1625;134;1491;80;116;13
455440;Spell Fighter VR;Violent, Gore, Action, Adventure, Indie;100,000 - 200,000;255;115;140;65;108;0
455480;Shift Orb;Casual, Indie;0 - 20,000;0;1;-1;0;0;0
455490;Don't Die Dateless, Dummy!;Action, Free to Play;0 - 20,000;41;25;16;0;0;0
455590;Skedaddle;Action, Adventure, Indie;0 - 20,000;18;7;11;0;0;0
455640;Edgar;Adventure;0 - 20,000;21;12;9;1;1;0
455690;Pixel Puzzles Junior Jigsaw;Action, Adventure, Casual, Indie;50,000 - 100,000;135;19;116;637;663;11
455700;Big Buck Hunter Arcade;Indie, Simulation, Strategy;0 - 20,000;43;36;7;0;0;1
455710;Project RPG Remastered;Action, Adventure, Indie, RPG, Early Access;50,000 - 100,000;74;105;-31;216;211;0
455720;Dolphin Defense;Action, Indie;0 - 20,000;3;3;0;0;0;0
455770;YamaYama;Casual, Indie;0 - 20,000;10;3;7;0;0;0
455820;Omensight: Definitive Edition;Indie, Strategy;50,000 - 100,000;1239;155;1084;336;337;3
455830;FrightShow Fighter;RPG;0 - 20,000;20;9;11;0;0;0
455910;STAR WARS: Rogue Squadron 3D;Design & Illustration, Photo Editing;100,000 - 200,000;806;293;513;37;25;13
455940;Odd||Even;Free to Play;20,000 - 50,000;55;43;12;265;301;0
455960;Domain Defense;Racing;0 - 20,000;25;14;11;0;0;0
455970;Nokori;Indie, Simulation, Strategy;20,000 - 50,000;24;27;-3;209;215;0
455980;Judgment: Apocalypse Survival Simulation;Indie, Simulation, Sports, Strategy, Early Access;100,000 - 200,000;1607;396;1211;486;691;54
455990;Smash Pixel Racing;Utilities;0 - 20,000;9;2;7;0;0;0
456090;Dead Some Day;Casual, Simulation;0 - 20,000;9;12;-3;0;0;0
456130;Space Scaven;Action, Adventure, Indie;0 - 20,000;28;2;26;210;226;0
456150;SpaceSys;Free to Play, Massively Multiplayer, Simulation, Sports;0 - 20,000;0;2;-2;0;0;0
456160;Flag N Frag;Free to Play, Indie, Strategy;0 - 20,000;5;7;-2;0;0;0
456170;Bannerman;Adventure, Indie;100,000 - 200,000;109;35;74;0;0;0
456180;The American Dream;Action, Indie;20,000 - 50,000;74;34;40;0;0;0
456210;A Land Fit For Heroes;Adventure, Indie, RPG, Simulation;0 - 20,000;15;14;1;0;0;1
456390;Exception;Indie, Strategy;0 - 20,000;36;0;36;0;0;0
456420;Gunslinger Trainer;Indie, RPG;0 - 20,000;1;6;-5;0;0;0
456430;Christmas Adventure: Candy Storm;Indie, RPG;20,000 - 50,000;319;35;284;0;0;0
456440;The Orphan Dreams;Action, Adventure, Indie;0 - 20,000;37;17;20;1;1;0
456450;Jaunt VR - Experience Cinematic Virtual Reality;Casual, Indie, Simulation;0 - 20,000;22;21;1;9;9;0
456540;STAR WARS: Rebel Assault I + II;Casual, Indie, Simulation;20,000 - 50,000;130;76;54;7;5;0
456660;Slime & Friends;Free to Play, Massively Multiplayer, RPG;50,000 - 100,000;25;35;-10;281;347;0
456670;Hand of Fate 2;Adventure, Casual, Indie;200,000 - 500,000;4498;774;3724;332;227;50
456690;Weather Lord: Following the Princess Collector's Edition;Strategy;0 - 20,000;35;7;28;0;0;1
456740;Doctor Kvorak's Obliteration Game;Casual, Indie, Sports;0 - 20,000;14;2;12;0;0;0
456750;The Room Three;Adventure, Indie, RPG;200,000 - 500,000;8840;326;8514;347;363;84
456760;A dragon girl looks up at the endless sky;Action, Indie;0 - 20,000;34;5;29;0;0;0
456780;DUCATI - 90th Anniversary;Indie, Strategy;20,000 - 50,000;163;69;94;127;127;1
456810;Zombillie;Simulation;100,000 - 200,000;179;74;105;263;306;1
456830;Dual Core;Strategy;0 - 20,000;21;2;19;0;0;0
456920;Gary the Gull;Casual, Indie, Simulation;0 - 20,000;16;19;-3;0;0;0
457130;Runes: The Forgotten Path;Indie, Simulation, Sports;0 - 20,000;69;17;52;0;0;1
457140;Oxygen Not Included;Casual, Indie, Simulation;2,000,000 - 5,000,000;92739;3299;89440;3916;909;9337
457210;SEUM: Speedrunners from Hell;Indie;100,000 - 200,000;2685;147;2538;359;329;8
457230;Atlas Reactor VR Character Viewer;Indie, Simulation, Strategy;0 - 20,000;31;3;28;8;9;0
457320;HoloBall;Action, Casual, Indie, Simulation, Strategy;50,000 - 100,000;412;49;363;215;215;0
457330;High Octane Drift;Adventure, Casual, Indie, RPG, Simulation, Strategy;1,000,000 - 2,000,000;3274;2642;632;132;18;34
457340;Dimensional;Strategy;0 - 20,000;43;10;33;0;0;0
457370;Alexa's Wild Night;Action, Adventure, Indie, RPG, Early Access;0 - 20,000;36;10;26;0;0;0
457380;Storm VR;Action, Indie;0 - 20,000;75;27;48;0;0;0
457420;Surgeon Simulator VR: Meet The Medic;Action, Indie;200,000 - 500,000;314;116;198;15;17;5
457450;Defend Your Crypt;Casual, Free to Play, Indie;20,000 - 50,000;39;7;32;77;77;0
457480;Domino Sky;Action, Casual, Indie;50,000 - 100,000;267;59;208;115;116;1
457490;Forgotten, Not Lost - A Kinetic Novel;Animation & Modeling, Early Access;50,000 - 100,000;195;26;169;210;256;0
457520;Moustache Mountain;Indie, Simulation, Strategy, Early Access;50,000 - 100,000;99;36;63;81;81;0
457530;My Lady;Action, Indie, Early Access;0 - 20,000;125;28;97;35;35;0
457550;Bigscreen Beta;Adventure, Casual, Indie;500,000 - 1,000,000;2376;398;1978;233;108;59
457570;Camp Sunshine;Adventure, Casual, Free to Play, Indie;0 - 20,000;247;22;225;249;430;0
457580;The Visitor;RPG, Strategy;0 - 20,000;154;49;105;6;6;0
457590;Luna Online: Reborn;Adventure, Indie;100,000 - 200,000;249;161;88;2430;4768;0
457600;Emerge: Cities of the Apocalypse;Casual, Indie, Simulation;100,000 - 200,000;102;48;54;0;0;1
457650;Stonehenge VR SANDBOX;Sexual Content, Adventure, Casual;0 - 20,000;4;2;2;0;0;0
457660;Andromedum;Action, Casual, Indie;0 - 20,000;11;5;6;0;0;0
457670;Vrideo;;50,000 - 100,000;38;27;11;2;2;0
457680;OPUS: The Day We Found Earth;Action, Indie;100,000 - 200,000;1147;171;976;306;466;4
457690;Hotel Blind;Simulation, Sports, Strategy;0 - 20,000;9;37;-28;0;0;0
457710;Road Madness;Casual, Indie;100,000 - 200,000;141;313;-172;255;249;0
457730;Mushroom Wars 2;Adventure, Indie, Strategy;200,000 - 500,000;573;337;236;107;121;3
457760;The Signal From Tölva;Adventure, Indie, RPG;50,000 - 100,000;690;331;359;398;562;1
457770;Audio Arena;Animation & Modeling, Design & Illustration, Education;0 - 20,000;19;5;14;0;0;0
457790;Capria: Magic of the Elements;Free to Play, Indie, Simulation;;;;0;;;
457820;Outrage;Action, Adventure, Casual, Free to Play, Indie, RPG, Early Access;50,000 - 100,000;89;54;35;247;254;0
457860;Apollo 11 VR;Indie;50,000 - 100,000;499;103;396;173;173;0
457870;Minigame Party VR;Simulation;0 - 20,000;4;2;2;0;0;0
457890;TumbleSeed;Action, Indie;20,000 - 50,000;162;49;113;37;37;1
457960;Holopoint;Adventure, Indie;20,000 - 50,000;630;72;558;58;95;0
457960;Holopoint;Action, Indie;20,000 - 50,000;630;72;558;58;95;0
457980;Adele: Following the Signs;Adventure;0 - 20,000;16;9;7;0;0;0
458000;March of the Living;Action, Casual, Indie;50,000 - 100,000;379;147;232;514;514;1
458030;StarFringe: Adversus;Adventure, Indie, RPG, Strategy;20,000 - 50,000;39;36;3;0;0;53
458040;Hex Gambit;Action, Adventure;0 - 20,000;18;5;13;0;0;0
458060;Drusilla Dreams;Action;0 - 20,000;27;23;4;19;19;0
458110;VReakout;Casual, Indie;0 - 20,000;5;1;4;0;0;0
458170;SpiritSphere DX;;0 - 20,000;40;8;32;18;18;0
458180;POSTZ: ZOMBIES VR;Action, Indie;0 - 20,000;3;1;2;0;0;0
458190;VR0GU3: Unapologetic Hardcore VR Edition;Action, Sports;0 - 20,000;4;6;-2;0;0;0
458200;Rumpus;Action, Adventure;0 - 20,000;3;1;2;0;0;0
458230;Infinite Shooter;Adventure, Indie;0 - 20,000;3;1;2;0;0;0
458290;Space Bit Attack;Action, Indie;0 - 20,000;9;5;4;0;0;0
458330;Vilmonic;Adventure, Indie, RPG;50,000 - 100,000;58;18;40;0;0;0
458360;eMedia Piano and Keyboard Method;Action, Indie, Strategy;0 - 20,000;25;1;24;0;0;1
458370;VR Baseball;Casual;0 - 20,000;24;7;17;0;0;0
458380;Gahkthun of the Golden Lightning Steam Edition;Action, Casual, Indie, Racing;0 - 20,000;74;7;67;0;0;0
458410;Cabals: Magic & Battle Cards;Adventure, Casual, Indie;20,000 - 50,000;40;21;19;0;0;0
458450;GAIN;Action, Casual;0 - 20,000;13;34;-21;3;3;0
458450;GAIN;Adventure, Indie;0 - 20,000;13;34;-21;3;3;0
458470;Grim Legends 3: The Dark City;Action, Adventure, Indie;50,000 - 100,000;626;48;578;250;323;6
458480;Mythic Wonders: The Philosopher's Stone;Adventure, Indie;50,000 - 100,000;275;37;238;238;263;1
458490;Who Must Die;Adventure, Casual, Free to Play, Indie, Massively Multiplayer, Simulation;0 - 20,000;11;12;-1;0;0;0
458520;Wrath of Anna;Racing, RPG, Simulation, Early Access;50,000 - 100,000;79;153;-74;179;198;0
458540;Lines;Adventure, Indie;0 - 20,000;90;12;78;316;316;0
458560;Plastic Playground;Action, Indie;50,000 - 100,000;46;98;-52;11;20;0
458580;Windlands 2;Action, Indie;20,000 - 50,000;298;71;227;49;49;0
458590;ABE VR;Sports, Early Access;50,000 - 100,000;180;116;64;11;13;0
458600;ZRoll;Adventure, Casual, Indie, RPG, Strategy;200,000 - 500,000;113;78;35;243;228;2
458630;Political Animals;Adventure, Casual, Indie, RPG, Simulation, Strategy;20,000 - 50,000;128;54;74;756;756;0
458660;The Slimeking's Tower;Action, Adventure, Indie, RPG, Strategy;20,000 - 50,000;168;44;124;0;0;0
458680;Auto Age: Standoff;Adventure, Casual, Indie, RPG, Simulation, Strategy;0 - 20,000;75;36;39;182;182;0
458700;Cursor Challenge;Adventure, Casual, Indie, RPG;0 - 20,000;20;14;6;0;0;16
458710;Kingdom Rush Frontiers - Tower Defense;Adventure, Indie;200,000 - 500,000;6593;217;6376;1315;849;211
458730;Conception II: Children of the Seven Stars;Action, Adventure, Indie, Early Access;20,000 - 50,000;504;112;392;0;0;13
458750;FireAlpaca SE;Action, Indie;20,000 - 50,000;126;12;114;0;0;96
458760;Palinurus;Action, Casual, Indie, Racing, RPG, Simulation, Strategy, Early Access;0 - 20,000;243;11;232;1;1;0
458770;WRC 6 FIA World Rally Championship;Action, Adventure, Casual, Indie;50,000 - 100,000;653;331;322;232;428;9
458820;States, Firms, & Households;Adventure, Casual, Indie, Strategy, Early Access;0 - 20,000;0;6;-6;0;0;0
458830;Snooker Nation Championship;Action, Indie;20,000 - 50,000;176;105;71;682;682;3
458890;Within VR - Cinematic Virtual Reality;Action, Adventure, Indie;20,000 - 50,000;43;38;5;0;0;0
458970;Intruder Alert: Ixian Operations;Education;0 - 20,000;45;24;21;2;2;0
458990;Astral Domine;Adventure, Free to Play, Indie;0 - 20,000;18;13;5;2;2;0
459010;Ghost Town Mine Ride & Shootin' Gallery;Action, Casual, Indie;20,000 - 50,000;342;54;288;81;81;0
459020;Melting Hearts: Our Love Will Grow 2;Violent, Adventure;0 - 20,000;36;26;10;232;248;0
459040;Medieval Battlefields;Action, Casual, Indie;20,000 - 50,000;10;5;5;0;0;0
459050;Wizards:Home;Indie, Simulation, Strategy;0 - 20,000;0;1;-1;0;0;0
459080;YIIK: A Postmodern RPG;Action, Adventure, Indie, RPG;50,000 - 100,000;365;176;189;36;36;1
459090;Masquerada: Songs and Shadows;Adventure, Indie, RPG;0 - 20,000;453;50;403;291;561;3
459130;Love in the Glen;Free to Play, Indie, Racing, Simulation;20,000 - 50,000;38;22;16;254;282;0
459150;Super Cat Herding: Totally Awesome Edition;Action, Casual, Simulation, Strategy;0 - 20,000;26;5;21;0;0;0
459160;Allods Online;Adventure, Casual, Indie, RPG, Simulation;100,000 - 200,000;453;192;261;133;188;17
459170;Discovr Egypt: King Tut's Tomb;Adventure, Indie, RPG;0 - 20,000;30;21;9;5;5;0
459220;Halo Wars: Definitive Edition;Action, Casual, Indie, Early Access;200,000 - 500,000;6138;672;5466;470;437;230
459260;Bowslinger;Action, Adventure, Casual, Indie;0 - 20,000;18;13;5;0;0;0
459310;The Hero Project: Redemption Season;Casual, Free to Play, Indie, Strategy;0 - 20,000;71;40;31;0;0;1
459350;Battlesloths 2025: The Great Pizza Wars;Action, Casual, Indie;0 - 20,000;72;13;59;674;674;0
459350;Battlesloths 2025: The Great Pizza Wars;Indie, RPG, Simulation;0 - 20,000;72;13;59;674;674;0
459370;Riverbond;Adventure, Casual, Indie;20,000 - 50,000;77;19;58;0;0;0
459410;Sector 724;Casual, Free to Play, RPG;0 - 20,000;6;4;2;402;416;0
459470;Wars of Napoleon;Adventure, Indie;20,000 - 50,000;51;46;5;0;0;4
459520;Kinacoustic;Casual, Indie;0 - 20,000;16;1;15;0;0;0
459540;Cherry Tree High Girls' Fight;Casual, Indie, Strategy;0 - 20,000;41;15;26;0;0;0
459550;Catch Canvas;Action, Indie, Strategy;0 - 20,000;67;25;42;0;0;0
459550;Catch Canvas;Simulation;0 - 20,000;67;25;42;0;0;0
459580;LightWalk;Casual, Indie;0 - 20,000;12;0;12;0;0;0
459610;Star Fleet Armada Rogue Adventures;Adventure, Indie;0 - 20,000;21;6;15;0;0;0
459630;R.C. Bot Inc.;Free to Play, Massively Multiplayer, RPG, Strategy;0 - 20,000;3;6;-3;0;0;0
459640;You... and who else?;Action, RPG;20,000 - 50,000;27;12;15;293;293;0
459680;Auro: A Monster-Bumping Adventure;Adventure, Indie, Simulation;20,000 - 50,000;59;10;49;0;0;0
459730;A World With No Colour;Casual, Free to Play, Indie, Racing;0 - 20,000;2;0;2;0;0;0
459760;Exotic Matter;Violent, Action, Indie, Early Access;0 - 20,000;15;11;4;0;0;0
459770;Longshot Universe;Action, Casual, Sports;0 - 20,000;2;0;2;0;0;0
459780;Vektron Revenge;Casual, Indie;0 - 20,000;4;0;4;0;0;0
459820;Crush Crush;Strategy;1,000,000 - 2,000,000;20587;2193;18394;7179;350;2836
459830;Final Days;Action, Indie, Early Access;20,000 - 50,000;80;10;70;0;0;0
459840;Monster Bash HD;Casual, Indie, Simulation, Sports, Strategy;0 - 20,000;46;0;46;0;0;1
459870;VIRTUAnimator;Indie;0 - 20,000;5;3;2;0;0;0
459880;PlayFortress;Adventure, Indie, RPG;0 - 20,000;8;8;0;0;0;0
459940;Deer Man;Casual;20,000 - 50,000;227;90;137;0;0;0
460060;Varenje;Indie, Strategy;100,000 - 200,000;1104;157;947;22;35;3
460120;Megadimension Neptunia VII;Action, Indie;200,000 - 500,000;2942;162;2780;1154;1129;16
460140;Midnight at the Celestial Palace: Part I;Casual, Indie, Early Access;0 - 20,000;27;1;26;0;0;0
460150;One Last Chance;Action, Adventure, Indie, Massively Multiplayer, RPG, Simulation, Strategy, Early Access;20,000 - 50,000;57;26;31;220;220;0
460160;The Leisure of Grisaia;Action, Adventure, Casual, Indie, Massively Multiplayer, Racing, Simulation, Sports, Early Access;0 - 20,000;256;22;234;402;482;1
460190;Rocket Riot;Action;0 - 20,000;48;14;34;246;246;0
460210;Bearslayer;Adventure;;;;0;;;
460220;Xenoraid: The First Space War;Casual, Simulation, Strategy;20,000 - 50,000;108;15;93;135;135;1
460230;Starters Orders 6 Horse Racing;Casual, Simulation, Strategy;0 - 20,000;84;21;63;0;0;7
460230;Starters Orders 6 Horse Racing;Action, Sports;0 - 20,000;84;21;63;0;0;7
460250;;Adventure, Indie;0 - 20,000;111;13;98;0;0;0
460250;;Action, Indie;0 - 20,000;111;13;98;0;0;0
460340;Guards;Sports;100,000 - 200,000;386;67;319;0;0;1
460430;The Letter - Horror Visual Novel;Action, Casual, Indie;100,000 - 200,000;1102;153;949;29;29;9
460470;Hindenburg VR;Casual, Indie, Simulation, Strategy;0 - 20,000;21;9;12;0;0;1
460510;One Dark Night;Simulation, Sports;0 - 20,000;45;52;-7;2;2;0
460540;Temple of Rust;Casual, Indie, Simulation, Strategy;20,000 - 50,000;69;11;58;0;0;0
460560;Blamdown: Udder Fury;Action, Indie, RPG;0 - 20,000;21;5;16;0;0;0
460570;Starfall Online;Action, Adventure, RPG;20,000 - 50,000;76;56;20;0;0;0
460580;Star Chart;Indie, Simulation, Strategy;0 - 20,000;10;12;-2;0;0;0
460580;Star Chart;Action, Indie, RPG;0 - 20,000;10;12;-2;0;0;0
460630;Trouble Witches Origin - Episode1 Daughters of Amalgam -;Casual, Indie;0 - 20,000;173;12;161;0;0;3
460640;Breached;Casual, Free to Play, Indie, Simulation, Strategy, Early Access;20,000 - 50,000;73;57;16;77;77;0
460650;Tick Tock Bang Bang;Indie, Simulation, Strategy;0 - 20,000;39;12;27;0;0;0
460700;Song of the Deep;Action, Adventure, Indie, RPG;50,000 - 100,000;668;122;546;131;183;3
460730;Draco Dux;Adventure, Casual, Indie;0 - 20,000;1;0;1;0;0;0
460780;Avadon 3: The Warborn;Adventure, Casual, RPG, Strategy;0 - 20,000;102;10;92;0;0;1
460790;Bayonetta;Action, Massively Multiplayer;1,000,000 - 2,000,000;21659;1798;19861;450;233;156
460810;Vanquish;Casual;500,000 - 1,000,000;5358;664;4694;224;160;20
460850;Allumette;Free to Play, Indie, Simulation;50,000 - 100,000;552;32;520;25;37;0
460910;A-Gents;Adventure, Casual;20,000 - 50,000;102;24;78;392;469;0
460920;Steep;Action, Casual, Indie;1,000,000 - 2,000,000;19554;4061;15493;773;251;176
460930;Tom Clancy's Ghost Recon Wildlands;Adventure, Casual, Indie;2,000,000 - 5,000,000;58417;15444;42973;2743;1745;1589
460940;Father´s Island;Adventure, Casual, Free to Play;0 - 20,000;31;21;10;334;342;0
460950;Katana ZERO;Action, Indie;1,000,000 - 2,000,000;53338;984;52354;367;292;142
460960;The Deed: Dynasty;Adventure, Indie;50,000 - 100,000;409;61;348;184;196;5
460970;Soulcaster: Part I & II;Adventure, Casual, Indie;0 - 20,000;35;6;29;0;0;0
460990;The Impossible Travel Agency;Action, Casual, Strategy;20,000 - 50,000;27;14;13;3;3;0
461010;Roll'd;Action, Casual;50,000 - 100,000;219;62;157;165;232;0
461030;A Long Way Home;Action, Indie;0 - 20,000;24;14;10;0;0;0
461030;A Long Way Home;Indie, RPG, Strategy;0 - 20,000;24;14;10;0;0;0
461040;PICO PARK;Adventure, RPG, Simulation, Strategy;200,000 - 500,000;687;293;394;17;4;60
461100;SteamDolls VR;Action, Casual, Indie;0 - 20,000;0;0;0;0;0;0
461170;Bucket Detective;Action, Casual, Indie, Simulation;0 - 20,000;212;34;178;0;0;0
461180;SurrealVR;Action, Adventure, Indie;50,000 - 100,000;44;29;15;12;12;0
461210;Riding Out;Action, Adventure, Casual, Indie, Strategy, Early Access;0 - 20,000;64;109;-45;0;0;0
461210;Riding Out;Free to Play, Strategy, Early Access;0 - 20,000;64;109;-45;0;0;0
461220;Beglitched;Action, Adventure, Indie;0 - 20,000;104;10;94;29;29;0
461230;Dashy Square;Casual, Indie;0 - 20,000;141;19;122;268;268;0
461230;Dashy Square;Adventure, Indie, RPG;0 - 20,000;141;19;122;268;268;0
461280;Missileman Origins;Action, Adventure, Indie, RPG;20,000 - 50,000;9;2;7;256;256;0
461320;Smackitball;Casual, Free to Play, Simulation;0 - 20,000;10;7;3;0;0;0
461340;A Timely Intervention;Action, Adventure, Indie, RPG, Early Access;50,000 - 100,000;32;5;27;0;0;2
461350;The King's Heroes;Action, Adventure;20,000 - 50,000;21;12;9;251;251;9
461360;Thorne - Son of Slaves (Ep.2);Action, Indie;20,000 - 50,000;92;16;76;210;211;36
461370;Midnight's Blessing 2;Action, Indie, Strategy;0 - 20,000;7;9;-2;208;213;0
461380;A Princess' Tale;Casual, Indie;50,000 - 100,000;31;19;12;362;505;0
461390;Bulby - Diamond Course;Casual, Indie;20,000 - 50,000;26;23;3;222;286;0
461400;Massive;Action, Adventure, Indie, Strategy;0 - 20,000;71;33;38;5;5;0
461410;Protonwar;Action, Indie;20,000 - 50,000;77;14;63;0;0;4
461430;EmergeNYC;Adventure, Indie, Simulation;100,000 - 200,000;2395;1253;1142;1045;2021;47
461480;Archibald's Adventures;Action, Casual, Indie, Strategy;0 - 20,000;71;7;64;0;0;0
461490;Kaboom Monsters;Indie, Simulation, Strategy, Early Access;50,000 - 100,000;65;54;11;195;195;1
461500;Omega Agent;Action, Indie, Early Access;0 - 20,000;41;12;29;0;0;0
461510;Tears of Avia;Action, Indie;50,000 - 100,000;42;36;6;0;0;0
461520;Grizzly Valley;Action, Adventure, Casual, RPG;100,000 - 200,000;91;143;-52;95;136;0
461540;Typing Instructor for Kids Platinum 5 - Mac;Action, Indie;0 - 20,000;0;0;0;0;0;0
461560;MANDAGON;Casual, Indie;200,000 - 500,000;5214;281;4933;24;17;2
461580;Galaxy Cannon Rider;Adventure, Casual, Indie;0 - 20,000;9;5;4;0;0;0
461590;The Way Of Love: Sub Zero;Indie, RPG, Simulation, Strategy, Early Access;0 - 20,000;4;4;0;0;0;0
461600;Zipple World 2: The Sweet Chaos;Action, Adventure, Indie;0 - 20,000;2;2;0;0;0;0
461620;Predynastic Egypt;Casual;100,000 - 200,000;1562;137;1425;291;305;14
461640;Sins Of The Demon RPG;Action, Adventure, Indie, RPG, Simulation;200,000 - 500,000;802;151;651;257;231;2
461650;It's Killing Time;Action, Indie, Early Access;0 - 20,000;11;6;5;0;0;0
461680;FPV Air Tracks;Adventure, Casual, Indie, RPG;20,000 - 50,000;65;129;-64;0;0;0
461700;Seduce Me 2: The Demon War;Action, Indie, Early Access;20,000 - 50,000;347;26;321;0;0;2
461710;Tales Across Time;Casual, Indie, Simulation, Strategy;0 - 20,000;56;13;43;0;0;0
461730;Blaite;Indie, RPG, Strategy;100,000 - 200,000;355;137;218;175;175;0
461750;Ghoul Kid;Action, Casual, Sports;50,000 - 100,000;106;38;68;11;11;0
461760;Reptilian Rebellion;Casual, Simulation, Strategy;50,000 - 100,000;45;16;29;227;235;0
461780;Moonstone Tavern - A Fantasy Tavern Sim!;Casual, Indie;20,000 - 50,000;67;69;-2;210;210;0
461810;CAFE 0 ~The Sleeping Beast~;RPG;20,000 - 50,000;42;7;35;0;0;0
461830;Adventure Apes and the Mayan Mystery;Action, Indie;0 - 20,000;15;5;10;252;252;0
461840;Zenge;Action, Casual, Indie;100,000 - 200,000;2773;143;2630;82;107;1
461850;Abrix 2 - Diamond version;Adventure;50,000 - 100,000;54;33;21;289;289;0
461860;Tower Dwellers;Indie, Strategy;0 - 20,000;18;15;3;0;0;0
461870;Police Simulator: Patrol Duty;Adventure, Indie;100,000 - 200,000;2001;1830;171;372;509;10
461880;Hyposphere;Utilities;200,000 - 500,000;101;94;7;362;358;1
461890;NORTH;Indie, RPG, Simulation, Strategy;200,000 - 500,000;266;156;110;204;232;1
461910;Forge of Gods (RPG);Utilities;500,000 - 1,000,000;2014;665;1349;144;74;0
461940;Plancon: Space Conflict;Casual, Indie;20,000 - 50,000;50;76;-26;178;197;0
461950;Beat Cop;Adventure, Indie, RPG;200,000 - 500,000;3670;752;2918;206;138;27
461970;Skyreach;Adventure;50,000 - 100,000;71;99;-28;10;10;0
461990;The Prison Game;Indie, Massively Multiplayer, Strategy;0 - 20,000;8;11;-3;0;0;0
462000;Cyberpong;Action, Adventure, Indie, Simulation;0 - 20,000;95;13;82;0;0;0
462070;IWO: Bloodbath in the Bonins;Adventure, Indie, RPG;20,000 - 50,000;11;17;-6;332;332;0
462100;Starr Mazer: DSP;Casual;50,000 - 100,000;190;56;134;0;0;0
462110;3 Coins At School;Adventure, Casual, Indie;100,000 - 200,000;47;69;-22;360;366;0
462130;Momentum;Action;0 - 20,000;16;7;9;6;6;0
462220;Mahjong Deluxe 3;Action, Adventure, Indie, RPG, Early Access;50,000 - 100,000;78;36;42;276;302;4
462240;Post Human W.A.R;Nudity, Violent, Adventure, Casual;20,000 - 50,000;94;19;75;0;0;1
462250;Boiling Bolt;Violent, Adventure, Casual;0 - 20,000;17;10;7;278;278;0
462380;Music of the Spheres;Casual, Indie;0 - 20,000;1;0;1;0;0;0
462400;Slide Ride Arcade;Adventure;0 - 20,000;5;3;2;348;404;0
462400;Slide Ride Arcade;Action, Indie, Racing;0 - 20,000;5;3;2;348;404;0
462480;Sweet Escape VR;Indie, RPG;0 - 20,000;47;7;40;105;105;2
462520;Super Kaiju;Casual;0 - 20,000;24;3;21;0;0;0
462530;8i - Make VR Human;Action, Adventure, Casual, Indie, Racing;0 - 20,000;47;24;23;0;0;0
462580;New Yankee in Santa's Service;Action, Adventure, Indie, RPG;0 - 20,000;16;5;11;259;259;0
462590;Taekwondo Grand Prix;Indie, Simulation, Early Access;0 - 20,000;66;13;53;0;0;2
462620;Pocket Kingdom;Action, Adventure, Casual, Free to Play, Indie;0 - 20,000;145;9;136;0;0;0
462630;RiftStar Raiders;Casual, Indie;0 - 20,000;8;3;5;0;0;0
462640;Surf World Series;Action, Adventure, Indie;0 - 20,000;32;12;20;0;0;1
462670;VR-Xterminator;Adventure, Free to Play;0 - 20,000;8;1;7;0;0;0
462680;BalanCity;Adventure, Casual, Free to Play;200,000 - 500,000;607;158;449;38;44;3
462700;Cricket Captain 2016;Simulation, Sports;0 - 20,000;39;19;20;0;0;0
462730;Townopolis;Indie, Strategy;20,000 - 50,000;66;33;33;243;268;4
462770;Pyre;Adventure, Casual, Indie;500,000 - 1,000,000;7361;755;6606;223;105;23
462780;Darksiders Warmastered Edition;Simulation, Strategy;1,000,000 - 2,000,000;11206;1654;9552;710;259;139
462830;Airline Director 2 - Tycoon Game;Adventure;0 - 20,000;19;40;-21;0;0;0
462860;Crawlers and Brawlers;Indie, Strategy, Early Access;0 - 20,000;35;9;26;0;0;0
462910;Poly Runner VR;Adventure, Casual, Indie;20,000 - 50,000;57;13;44;17;8;1
462930;AdVenture Communist;Action, Indie, RPG;500,000 - 1,000,000;2945;1521;1424;374;52;48
462940;Making History: The Second World War;Casual, Indie, Simulation;20,000 - 50,000;186;50;136;0;0;18
462950;The East New World;Indie;0 - 20,000;24;24;0;0;0;0
462960;Caveman World: Mountains of Unga Boonga;Action, Indie, Early Access;100,000 - 200,000;433;196;237;199;225;0
462990;Tomoyo After ~It's a Wonderful Life~ English Edition;Action;0 - 20,000;486;43;443;561;561;2
463000;Hero Battle;Action;50,000 - 100,000;97;54;43;232;263;0
463010;One Way Flight;Simulation, Sports;0 - 20,000;7;6;1;0;0;0
463020;Wander No More;Action, Indie;20,000 - 50,000;136;23;113;0;0;0
463030;Bottle;Simulation;20,000 - 50,000;271;151;120;153;232;0
463060;Clover Tale;Adventure, Casual;100,000 - 200,000;590;199;391;4129;8238;12
463070;Mecha Ritz: Steel Rondo;Adventure, Casual, Indie;0 - 20,000;112;2;110;0;0;1
463100;Liveza: Death of the Earth;Action, Adventure, Indie;50,000 - 100,000;82;71;11;239;229;0
463110;Farnham Fables;Action, Adventure, Indie, RPG, Early Access;100,000 - 200,000;260;109;151;233;228;6
463120;MOP Operation Cleanup;Action, Indie;0 - 20,000;0;2;-2;0;0;0
463130;Bug N Out;Adventure;0 - 20,000;2;1;1;0;0;0
463150;BARRIER X;Indie;200,000 - 500,000;1943;297;1646;129;130;3
463160;Super Dungeon Tactics;Action, Strategy;20,000 - 50,000;114;31;83;0;0;0
463170;Jagged Alliance: Rage!;Action, Adventure, Indie;100,000 - 200,000;228;211;17;2532;2532;3
463180;Super Blue Fighter;Action, Free to Play, Indie;100,000 - 200,000;88;26;62;182;200;0
463210;State of Anarchy;Action, Adventure, Indie, Simulation, Early Access;100,000 - 200,000;892;154;738;249;247;0
463220;Dungeon of Zolthan;Adventure, Indie, RPG, Strategy, Early Access;100,000 - 200,000;392;116;276;253;248;1
463250;One Tower;Casual, Indie, RPG;50,000 - 100,000;45;49;-4;1;1;0
463270;Ghost 1.0;Adventure, Casual, Indie;100,000 - 200,000;1780;165;1615;201;361;5
463290;Kismet;Action, RPG;0 - 20,000;127;13;114;13;13;0
463320;The Sea Eternal;Indie, Simulation, Sports, Strategy;0 - 20,000;12;13;-1;0;0;0
463350;Storm Of Spears RPG;Indie, Simulation, Sports, Strategy;100,000 - 200,000;399;150;249;199;190;0
463390;One Thousand Lies;Indie;50,000 - 100,000;908;107;801;22;38;1
463400;Spellbound;Action, Adventure, Free to Play, Indie, RPG, Strategy;0 - 20,000;19;5;14;0;0;0
463410;Panic Pump - Can you save them ALL?;Adventure, Casual;0 - 20,000;2;1;1;0;0;0
463430;Ironguard;Strategy;0 - 20,000;5;5;0;0;0;0
463440;Retool;Action, Adventure, Indie;0 - 20,000;1;5;-4;0;0;0
463450;Bipolar Game;Action, Adventure, Casual, Indie, Racing, Simulation, Sports;0 - 20,000;5;0;5;0;0;0
463460;Resette's Prescription ~Book of memory, Swaying scale~;Action;0 - 20,000;40;11;29;0;0;1
463470;Lithium: Inmate 39;Adventure, Casual;0 - 20,000;20;11;9;0;0;0
463480;A Shooty Bit;Action;0 - 20,000;22;7;15;235;235;0
463480;A Shooty Bit;Adventure, Casual;0 - 20,000;22;7;15;235;235;0
463510;Norman's Great Illusion;Adventure, Casual;0 - 20,000;22;11;11;0;0;0
463530;Empires of the Undergrowth;Adventure, Casual;200,000 - 500,000;7491;394;7097;1145;767;425
463540;StreetCraft;Adventure, Indie;0 - 20,000;15;2;13;0;0;0
463700;Super Cloudbuilt;Casual;20,000 - 50,000;243;34;209;165;201;3
463710;Puzzle Galaxies;Casual, Strategy;200,000 - 500,000;91;58;33;210;222;14
463760;The Beggar's Ride;Adventure, Casual;0 - 20,000;142;36;106;0;0;0
463800;FreeHolder;Adventure, Casual;0 - 20,000;73;19;54;0;0;0
463830;Izeriya;Casual;0 - 20,000;6;7;-1;0;0;0
463850;Muddy Heights 2;Adventure, Casual;20,000 - 50,000;224;60;164;542;542;2
463870;Deathwave;Adventure, Casual;0 - 20,000;13;19;-6;0;0;0
463880;Beyond Magic;Casual, Strategy;20,000 - 50,000;34;12;22;198;201;0
463920;Initia: Elemental Arena;Adventure, Casual;0 - 20,000;27;66;-39;0;0;0
463930;The Dweller;Adventure, Casual;20,000 - 50,000;539;40;499;238;286;1
463980;Solitairica;Casual, Strategy;50,000 - 100,000;321;81;240;787;787;9
464000;Arcade Saga;Adventure, Casual;0 - 20,000;33;10;23;0;0;0
464020;Super Puzzle Galaxy;Adventure, Casual;0 - 20,000;2;3;-1;0;0;0
464040;Log Drive Runner;Action, Casual, Indie;0 - 20,000;15;2;13;0;0;0
464050;Heroes Must Die;Action, Adventure, Indie;0 - 20,000;38;12;26;0;0;0
464050;Heroes Must Die;Indie, RPG;0 - 20,000;38;12;26;0;0;0
464060;RUINER;Casual, Indie;500,000 - 1,000,000;9373;1028;8345;283;185;11
464070;Diorama Battle of NINJA　虚拟3D世界 忍者之战;Action, Casual, Indie, Racing, Simulation, Sports;0 - 20,000;29;14;15;1;1;4
464080;Kyoto Colorful Days;Action, Adventure, Indie, Massively Multiplayer, RPG, Early Access;20,000 - 50,000;145;26;119;0;0;1
464100;Codex of Victory;Action, Free to Play, Indie;20,000 - 50,000;256;110;146;464;464;1
464110;Factotum 90;Sexual Content, Nudity, Animation & Modeling, Design & Illustration, Utilities;0 - 20,000;14;0;14;0;0;0
464120;Xcinerator;Action, Adventure, Indie;0 - 20,000;17;2;15;0;0;0
464150;Regalia: Of Men and Monarchs;Action, Indie, Early Access;50,000 - 100,000;408;106;302;0;0;3
464170;VRMark;Adventure, RPG, Strategy;0 - 20,000;70;43;27;57;94;4
464230;Colours of Magic: Aqua Teeter;Action, Adventure, Indie;20,000 - 50,000;70;17;53;183;183;0
464240;Detective Hunt - Crownston City PD;Action, Adventure, Casual, Indie, RPG;0 - 20,000;14;9;5;0;0;0
464260;Xeno Crisis;Adventure, Indie, RPG;0 - 20,000;107;14;93;0;0;1
464340;Syberia 3;Action, Adventure, Indie;200,000 - 500,000;1912;1778;134;463;567;65
464350;Screeps: World;Adventure, Casual;200,000 - 500,000;1491;168;1323;414;369;47
464360;3030 Deathwar Redux - A Space Odyssey;Indie;100,000 - 200,000;1011;65;946;187;224;2
464380;Best of Us;Action, Adventure, Casual, Indie, Simulation;0 - 20,000;3;10;-7;0;0;0
464400;Bounce;Indie, Simulation, Strategy;0 - 20,000;37;3;34;35;35;0
464440;Annie Amber;Indie, RPG;20,000 - 50,000;49;36;13;126;126;0
464450;DoDonPachi Resurrection;Adventure, Free to Play, Indie, Massively Multiplayer, RPG;20,000 - 50,000;766;35;731;558;558;6
464470;BloodGate;Casual, Free to Play;20,000 - 50,000;186;174;12;0;0;0
464490;The Afterglow of Grisaia;Casual, Indie, Strategy;0 - 20,000;91;3;88;424;452;0
464500;The Melody of Grisaia;Action, Adventure, Indie;0 - 20,000;71;3;68;413;450;1
464500;The Melody of Grisaia;Action, Indie, Early Access;0 - 20,000;71;3;68;413;450;1
464530;猫肉「Cat Meat」;Adventure, Casual, Strategy;0 - 20,000;16;6;10;3;3;0
464540;Colosse;Action, Indie;20,000 - 50,000;119;25;94;5;6;0
464610;Led It Rain;Adventure, Casual, Simulation;0 - 20,000;19;14;5;0;0;0
464620;Siralim 2;Adventure, Casual, Indie;50,000 - 100,000;411;35;376;123;123;2
464630;Secret Of The Royal Throne;Action, Indie;0 - 20,000;2;15;-13;0;0;0
464650;Runbow;Adventure, Casual, Indie, Simulation;20,000 - 50,000;87;16;71;6;6;0
464670;Empty Soul - S&S Edition;Action, Casual, Indie;0 - 20,000;28;6;22;0;0;0
464690;Vroomist;Indie, RPG, Simulation, Strategy;0 - 20,000;8;32;-24;0;0;0
464700;Maui;Casual, Indie;100,000 - 200,000;191;189;2;18;29;0
464740;Monsters and Medicine;Action, Adventure;0 - 20,000;6;0;6;0;0;0
464780;ChuSingura46+1 S;Action;200,000 - 500,000;848;130;718;3;5;2
464800;Twisted Worlds;Casual, Free to Play;50,000 - 100,000;69;60;9;0;0;3
464850;Don Bradman Cricket 17;Adventure, RPG, Strategy;0 - 20,000;159;103;56;0;0;2
464900;Pitfall Planet;Action, Free to Play, Indie, Simulation;0 - 20,000;52;0;52;0;0;0
464920;Surviving Mars;Action, Casual, Indie, Racing, Early Access;2,000,000 - 5,000,000;19997;3617;16380;852;204;1307
464940;Sketchfab VR;Action, Indie;0 - 20,000;38;17;21;6;10;0
464950;Sumer;Adventure, Simulation, Strategy, Early Access;0 - 20,000;14;0;14;0;0;0
464960;Hiiro;Casual, Indie, Simulation, Strategy;100,000 - 200,000;254;35;219;327;349;0
465000;Event Horizon;Casual, Indie;20,000 - 50,000;110;28;82;3523;3523;2
465010;Quantized;Casual, Indie;0 - 20,000;1;1;0;0;0;0
465020;Sector Six;Casual, Indie, Strategy;50,000 - 100,000;213;13;200;331;331;2
465050;Grey Phobia;Casual, Indie;20,000 - 50,000;34;32;2;0;0;0
465060;EXZEAL;Action, Adventure, Casual, Indie;0 - 20,000;15;3;12;38;38;0
465070;TRIZEAL Remix;Action, Indie, RPG, Strategy;0 - 20,000;23;2;21;0;0;0
465090;Don Bradman Cricket 17 Demo;Adventure, Casual;0 - 20,000;3;2;1;0;0;1
465100;LUNA The Shadow Dust;Adventure, Indie, RPG;50,000 - 100,000;1278;116;1162;175;175;2
465130;Wicce;Action, Casual, Indie, RPG;0 - 20,000;97;30;67;0;0;0
465130;Wicce;Action, Indie, RPG;0 - 20,000;97;30;67;0;0;0
465150;Mars Odyssey;Action, Adventure, Strategy;0 - 20,000;36;11;25;37;37;0
465170;Crime Secrets: Crimson Lily;Adventure, Free to Play, Indie;50,000 - 100,000;318;112;206;243;288;3
465180;One Day in London;Casual, Indie, Strategy;0 - 20,000;77;8;69;0;0;0
465190;Space Survival;Action, Adventure, Free to Play, Indie;20,000 - 50,000;33;44;-11;212;213;44
465200;Fury Unleashed;Casual, Indie;100,000 - 200,000;1771;205;1566;195;123;23
465240;Serious Sam VR: The Last Hope;Action, Indie, Simulation, Early Access;200,000 - 500,000;1121;198;923;61;83;59
465310;Ricerca VR;Casual;0 - 20,000;23;4;19;0;0;0
465360;Uprising: Join or Die;Action, Casual, Indie;0 - 20,000;68;14;54;5;5;1
465440;Aplowcalypse;Indie, Simulation, Early Access;0 - 20,000;38;12;26;0;0;1
465450;iOMoon;Adventure, Casual, Indie;0 - 20,000;30;6;24;0;0;0
465490;Stellar Tactics;Simulation, Strategy;50,000 - 100,000;956;186;770;97;97;29
465510;Sinful Eden;Action, Adventure, Indie, Massively Multiplayer, Simulation, Early Access;0 - 20,000;14;20;-6;0;0;0
465520;PRICE;Violent, Gore, Adventure, RPG;200,000 - 500,000;4646;274;4372;130;92;2
465540;Adventure World;Adventure, Casual, Indie;0 - 20,000;28;32;-4;145;145;1
465540;Adventure World;Casual, Indie;0 - 20,000;28;32;-4;145;145;1
465660;Franchise Hockey Manager 3;Action, Casual, Strategy;0 - 20,000;55;41;14;0;0;2
465670;Project G;Casual, Indie;0 - 20,000;15;7;8;0;0;0
465710;Heroes Tactics;Action, Indie;100,000 - 200,000;163;99;64;364;376;0
465720;Demon Hunter 2: New Chapter;Action, Casual, Indie;50,000 - 100,000;165;64;101;263;294;1
465750;Tank Battle: North Africa;Action, Indie;20,000 - 50,000;26;8;18;331;341;1
465760;Scrap Garden;Action, Indie;200,000 - 500,000;828;260;568;96;118;3
465780;New Retro Arcade: Neon;Audio Production, Early Access;20,000 - 50,000;478;127;351;32;37;1
465780;New Retro Arcade: Neon;Action, Adventure, Casual, Indie, Sports, Early Access;20,000 - 50,000;478;127;351;32;37;1
465840;THE LAST BLADE;Action, Adventure, Indie, RPG;20,000 - 50,000;118;45;73;77;77;2
465860;Awakening: The Sunhook Spire Collector's Edition;Nudity, Action, Casual, Indie;0 - 20,000;9;1;8;0;0;0
465870;SHOCK TROOPERS 2nd Squad;Indie;20,000 - 50,000;50;42;8;57;57;1
465890;Dark Parables: The Final Cinderella Collector's Edition;Action, Adventure, Casual, Indie, RPG;0 - 20,000;24;0;24;0;0;1
465900;Dark Tales: Edgar Allan Poe's The Gold Bug Collector's Edition;Adventure, Casual, Indie, RPG, Simulation, Strategy;0 - 20,000;17;2;15;0;0;0
465920;Echoes of the Past: The Revenge of the Witch Collector's Edition;Action, Indie;0 - 20,000;4;1;3;0;0;1
465930;OddPlanet;Adventure, Indie, Simulation;20,000 - 50,000;81;70;11;0;0;0
465960;Farm Tribe;Adventure, Indie;0 - 20,000;12;4;8;0;0;0
465970;Grave Mania: Undead Fever;Massively Multiplayer, Simulation, Sports, Early Access;0 - 20,000;10;0;10;0;0;0
465990;Hidden Expedition: The Crown of Solomon Collector's Edition;Adventure, Indie;0 - 20,000;9;3;6;0;0;0
466010;Nevertales: The Beauty Within Collector's Edition;Action, Indie, Racing, Simulation, Sports;0 - 20,000;14;2;12;0;0;0
466020;Off the Record: The Linden Shades Collector's Edition;Action, Casual, Indie;0 - 20,000;9;0;9;0;0;0
466030;Otherworld: Spring of Shadows Collector's Edition;Action, Indie, Early Access;0 - 20,000;16;0;16;0;0;0
466050;Redemption Cemetery: Salvation of the Lost Collector's Edition;Action, Indie;0 - 20,000;11;0;11;0;0;0
466060;Shiver: Vanishing Hitchhiker Collector's Edition;Casual, Indie, Strategy;20,000 - 50,000;26;3;23;0;0;0
466070;Spa Mania;Action, Adventure, Indie, Early Access;0 - 20,000;3;0;3;0;0;0
466080;Surface: The Pantheon Collector's Edition;Racing, Simulation, Sports;0 - 20,000;2;1;1;0;0;1
466100;Witches' Legacy: The Ties That Bind Collector's Edition;Free to Play, Indie, Massively Multiplayer, Strategy;0 - 20,000;9;2;7;0;0;0
466110;Shaolin vs Wutang;Action;20,000 - 50,000;869;71;798;11;11;1
466130;White Day: A Labyrinth Named School;Casual;100,000 - 200,000;1812;435;1377;2628;2877;36
466160;Arelite Core;Action, Indie;0 - 20,000;22;2;20;0;0;0
466170;Idling to Rule the Gods;Strategy, Early Access;200,000 - 500,000;1248;180;1068;891;726;1136
466210;Race & Destroy;Action, Adventure, Casual, Indie, Strategy;0 - 20,000;5;12;-7;0;0;0
466220;Kingdom of Loot;Adventure;0 - 20,000;197;171;26;124;124;0
466240;Deceit;Casual, Indie, Early Access;5,000,000 - 10,000,000;67965;17998;49967;495;90;964
466260;inVR;Adventure, Free to Play, Indie;0 - 20,000;7;8;-1;0;0;0
466270;Half-Life: A Place in the West;Adventure, Indie;100,000 - 200,000;617;77;540;16;30;1
466280;Super Cube Smash;Action, Adventure, Indie;0 - 20,000;8;3;5;0;0;0
466290;BitShift: BattleGrid;Action, Indie;0 - 20,000;6;0;6;0;0;0
466300;Planescape: Torment: Enhanced Edition;Casual, Free to Play;200,000 - 500,000;3451;184;3267;1259;846;96
466350;Fossil Echo;Action, Casual, Indie, Simulation, Strategy;20,000 - 50,000;81;48;33;348;348;0
466350;Fossil Echo;Action, Indie, Racing, Sports;20,000 - 50,000;81;48;33;348;348;0
466420;Warriors' Wrath;Action, Indie;20,000 - 50,000;50;24;26;211;211;1
466430;Choice of Alexandria;Adventure, Casual, Simulation, Early Access;0 - 20,000;70;3;67;0;0;0
466490;Princess Isabella: The Rise of an Heir;Animation & Modeling;20,000 - 50,000;89;71;18;185;212;1
466500;35MM;Casual, Simulation, Sports;200,000 - 500,000;2827;1128;1699;235;246;2
466520;Drone Hunter VR;Action, Adventure, Indie;0 - 20,000;32;18;14;0;0;0
466560;Northgard;Action, Racing, Simulation;2,000,000 - 5,000,000;46051;6204;39847;1812;665;3287
466580;GOD's DEATH;Casual, Sports;20,000 - 50,000;7;13;-6;309;380;0
466630;The Pedestrian;Indie, Strategy, Early Access;100,000 - 200,000;3256;90;3166;244;334;5
466660;Stash;Violent, Adventure, Indie, Simulation;100,000 - 200,000;438;216;222;731;774;0
466720;Vintage VR;Utilities;50,000 - 100,000;80;8;72;4;7;0
466730;King's Guard TD;Indie, Strategy;200,000 - 500,000;210;139;71;189;194;0
466740;ARAYA;Adventure, Indie, RPG, Strategy;50,000 - 100,000;592;192;400;338;338;2
466770;Ghost Croquet;Action, Casual, Indie;0 - 20,000;16;1;15;0;0;0
466780;Prehistoric Tales;Action, Adventure, Casual, Indie;20,000 - 50,000;73;23;50;150;195;5
466800;The Dope Game;Strategy;20,000 - 50,000;163;38;125;17;17;0
466800;The Dope Game;Action, Indie;20,000 - 50,000;163;38;125;17;17;0
466820;Zenodyne R;Free to Play, Strategy;0 - 20,000;56;10;46;311;311;0
466830;Remnants of a Beautiful Day;Casual;0 - 20,000;41;30;11;214;214;0
466840;Super Space Pug;Free to Play, Indie, Strategy;500,000 - 1,000,000;150;126;24;259;237;0
466860;上帝之城 I：监狱帝国 [City of God I - Prison Empire];Indie, Massively Multiplayer, RPG, Simulation;100,000 - 200,000;1318;555;763;1072;1072;9
466870;Aurora Nights;Free to Play, Indie, Massively Multiplayer, RPG;20,000 - 50,000;254;47;207;4;4;0
466890;Z.I.O.N.;Adventure, Indie, RPG;50,000 - 100,000;111;179;-68;332;380;2
466910;Worm.is: The Game;Casual, Free to Play;1,000,000 - 2,000,000;3630;880;2750;219;68;21
466920;Mugen Souls Z;Action, Adventure, Indie, RPG;0 - 20,000;69;17;52;0;0;0
466940;The Sandbox Evolution - Craft a 2D Pixel Universe!;Indie;200,000 - 500,000;606;764;-158;231;249;8
466980;Can't Drive This;Action, Indie, RPG;20,000 - 50,000;287;56;231;45;45;0
467000;Insincere;Action, Indie;200,000 - 500,000;124;125;-1;262;249;0
467010;Fall of Civilization;Action, Indie;50,000 - 100,000;52;81;-29;266;250;0
467010;Fall of Civilization;Adventure, Free to Play;50,000 - 100,000;52;81;-29;266;250;0
467060;Dead Army - Radio Frequency;Casual, Indie;0 - 20,000;39;24;15;0;0;0
467120;Rising Runner;Indie;50,000 - 100,000;11;1;10;287;309;0
467170;Subterrarium;Violent, Action, Adventure, Indie;0 - 20,000;4;1;3;0;0;0
467210;Evo Explores;Casual;20,000 - 50,000;315;18;297;0;0;0
467220;Dyna Bomb;Adventure, Indie;0 - 20,000;33;8;25;108;213;0
467270;Weaves of Fate;Action, Adventure, Indie;20,000 - 50,000;56;22;34;0;0;0
467290;Starship Titanic;Adventure, Indie, Early Access;0 - 20,000;67;17;50;0;0;2
467310;Rogue Port - Red Nightmare;Indie, RPG;100,000 - 200,000;79;21;58;9823;312;42
467320;God of Word;Casual, Indie, RPG, Strategy, Early Access;20,000 - 50,000;90;32;58;0;0;0
467330;Just a Cleric;Casual, Indie, Strategy;0 - 20,000;32;8;24;0;0;0
467350;Leveron Space;Action, Adventure, Indie, Strategy;0 - 20,000;3;10;-7;0;0;0
467360;Off-Peak;Action, Indie, Sports;100,000 - 200,000;1286;178;1108;45;38;2
467370;Escape This;Action, Adventure, Indie, Racing;100,000 - 200,000;271;312;-41;229;221;2
467380;Khimera: Destroy All Monster Girls;Action, Adventure, Casual, Indie;;;;0;;;
467390;Approaching Blocks;Adventure, Casual, Indie;200,000 - 500,000;187;108;79;243;214;1
467400;Go For Launch: Mercury;Casual, Indie, Racing, Simulation;0 - 20,000;57;11;46;0;0;0
467430;Farming 6-in-1 bundle;Simulation, Early Access;20,000 - 50,000;39;13;26;17;17;3
467430;Farming 6-in-1 bundle;Simulation;20,000 - 50,000;39;13;26;17;17;3
467440;Insignificant;Action, Indie;20,000 - 50,000;3;0;3;0;0;0
467470;Shoot Shoot Mega Pack;Indie;0 - 20,000;17;0;17;0;0;0
467480;C O S M;;0 - 20,000;11;11;0;0;0;0
467490;GRAVEN The Purple Moon Prophecy;Action, Adventure, Indie, RPG;0 - 20,000;39;4;35;0;0;0
467520;Power & Revolution;Casual, Indie, Sports;20,000 - 50,000;696;511;185;8094;12129;20
467570;TITANS: Dawn of Tribes;Casual, Indie, Simulation, Strategy;0 - 20,000;123;171;-48;0;0;0
467650;Demolition;Indie, Simulation;0 - 20,000;2;0;2;0;0;0
467660;Paranormal Activity: The Lost Soul;Casual, Indie, Sports;20,000 - 50,000;516;182;334;273;451;3
467680;Negligee: Love Stories;Casual, Indie, Simulation;0 - 20,000;0;0;0;5;5;0
467760;Trapper's Delight;Action, Casual, Indie;20,000 - 50,000;261;22;239;497;497;0
467780;simian.interface++;Action, Indie;0 - 20,000;98;3;95;26;26;0
467790;Crongdor the Barbarian;Adventure, Indie, RPG, Simulation, Strategy;0 - 20,000;3;1;2;0;0;0
467810;Splody;Action, Adventure, Indie, Early Access;0 - 20,000;85;7;78;0;0;0
467820;Zero G Arena;Action, RPG;20,000 - 50,000;656;75;581;65;111;0
467850;METAGAL;Casual, Indie;20,000 - 50,000;93;43;50;547;547;0
467890;Garage Drummer VR;Casual, Free to Play, Indie;0 - 20,000;22;17;5;0;0;0
467900;SWORDY;Action, Adventure, Indie;20,000 - 50,000;67;34;33;0;0;0
467910;EPΘCH;Simulation;0 - 20,000;40;12;28;0;0;0
467930;SMASHING THE BATTLE;Action, Adventure, Indie;20,000 - 50,000;433;142;291;86;96;0
467940;Memoir En Code: Reissue;Action, Adventure, Casual, Free to Play, Massively Multiplayer, Sports, Early Access;0 - 20,000;16;2;14;0;0;0
467950;Survive in Space;Action, Indie, Racing, Sports;200,000 - 500,000;219;98;121;223;257;0
467960;Home Behind;Action, Adventure, Indie;200,000 - 500,000;4765;831;3934;1146;708;57
467990;Versus: Battle of the Gladiator;Casual, Indie;50,000 - 100,000;307;182;125;1;1;0
468000;Impact Winter;Action, Adventure, Casual, Indie, RPG, Simulation;20,000 - 50,000;172;252;-80;18;18;2
468050;The Last Time;Adventure, Indie;0 - 20,000;145;5;140;0;0;1
468070;90 Minute Fever - Football (Soccer) Manager MMO;Free to Play, Indie, Strategy;0 - 20,000;159;95;64;3;3;19
468080;Occurrence at JCR Outpost;Adventure, Casual, Indie;0 - 20,000;3;4;-1;0;0;0
468100;Aqua Moto Racing Utopia;Adventure, Casual, Free to Play, Indie;0 - 20,000;73;30;43;0;0;1
468110;Rescuties! VR;Action, Indie;0 - 20,000;24;0;24;0;0;0
468130;Nebula;Action, Casual, Indie, Early Access;0 - 20,000;4;0;4;0;0;0
468150;Trap House;Action, Adventure;0 - 20,000;6;2;4;0;0;0
468160;Ancient Go;Indie;0 - 20,000;67;36;31;0;0;1
468170;AcidPunk : Echoes of Doll City;Action, Indie;0 - 20,000;25;4;21;0;0;0
468240;VR Regatta - The Sailing Game;Adventure;500,000 - 1,000,000;142;22;120;185;176;0
468250;Warfare Online;Action, Adventure, Indie;200,000 - 500,000;685;336;349;76;87;0
468310;She Wants Me Dead;Action, Casual, Indie;20,000 - 50,000;110;20;90;116;116;0
468320;Mini Golf Mundo;Adventure, Indie;50,000 - 100,000;72;77;-5;177;263;0
468330;HIVE: Altenum Wars;Adventure, Casual, Indie;20,000 - 50,000;61;26;35;225;234;0
468350;Hexaverse;Action, Adventure, Indie, RPG, Strategy;0 - 20,000;2;1;1;0;0;0
468490;Neon Space;Action, Adventure, Casual, Indie;100,000 - 200,000;382;139;243;233;250;0
468530;A Date in the Park;Action, Adventure, Casual, Indie;100,000 - 200,000;1340;204;1136;24;32;0
468540;Match More;Casual, Indie, Strategy;0 - 20,000;1;0;1;0;0;0
468560;Blind Trust;Action, Adventure, Indie;200,000 - 500,000;744;704;40;17;11;2
468570;De-Void;Adventure, Casual;50,000 - 100,000;60;49;11;282;282;0
468650;Super ComboMan: Smash Edition;Action, Casual, Indie, Strategy;0 - 20,000;3;8;-5;18;18;0
468670;Speed Brawl;RPG, Strategy;0 - 20,000;121;24;97;131;169;0
468700;NVIDIA VR Funhouse;Indie, Simulation;200,000 - 500,000;636;167;469;51;55;5
468740;Snow Fortress;Action, Adventure, Indie;0 - 20,000;50;6;44;79;79;0
468780;The Concourse;Action, Adventure, Indie;;;;0;;;
468800;Arkshot;Action, Adventure;20,000 - 50,000;105;32;73;208;384;0
468900;3D Sprite Renderer;Casual, Indie, Simulation, Strategy;0 - 20,000;2;3;-1;0;0;0
468920;Ultimate Fishing Simulator;Sexual Content, Nudity, Adventure, Casual, Indie;200,000 - 500,000;5612;636;4976;371;325;42
468930;Phantaruk;Action, Indie, Racing;20,000 - 50,000;130;76;54;224;224;0
469550;Bambino Rally 3;Indie;0 - 20,000;31;19;12;0;0;0
469600;Legion TD 2 - Multiplayer Tower Defense;Action, Indie;500,000 - 1,000,000;8046;1347;6699;3918;1164;1436
469610;Rick and Morty: Virtual Rick-ality;Action, Adventure, Indie, Massively Multiplayer, Simulation;200,000 - 500,000;1432;480;952;142;126;12
469650;Disney Movies VR;Action, Adventure, Indie, RPG;50,000 - 100,000;111;93;18;10;16;0
469710;Shattered Throne;Action, Indie, Simulation, Sports, Early Access;0 - 20,000;33;9;24;0;0;0
469720;Monsters' Den: Godfall;Adventure, Indie;50,000 - 100,000;399;71;328;35;35;20
469730;Super Mega Neo Pug;Action, Indie, Simulation, Strategy;200,000 - 500,000;617;118;499;211;203;0
469790;Linelight;Adventure, Free to Play, Indie;20,000 - 50,000;853;21;832;0;0;0
469800;Evolution Board Game;Adventure, Free to Play;50,000 - 100,000;305;52;253;134;134;10
469820;Genital Jousting;Casual, Indie;500,000 - 1,000,000;8769;766;8003;100;77;13
469830;Fable Fortune;Action, Indie;100,000 - 200,000;383;164;219;503;503;0
469890;Space Codex;Adventure;200,000 - 500,000;304;63;241;224;242;7
469900;Paradox Paradigm;Action, Indie;0 - 20,000;10;6;4;0;0;0
469920;hackmud;Action, Adventure, Indie, Simulation, Strategy;20,000 - 50,000;520;153;367;175;175;6
469930;Pandum online;Adventure, Indie, RPG, Simulation;0 - 20,000;30;30;0;0;0;0
469980;Legend of Miro;Action, Adventure, Casual, Indie, Massively Multiplayer, Simulation;0 - 20,000;24;29;-5;0;0;0
469990;NEKOPALIVE;Action, Adventure, Indie;200,000 - 500,000;1330;111;1219;5;6;4
470020;SnarfQuest Tales, Episode 1: The Beginning;Casual, Indie;0 - 20,000;4;3;1;0;0;0
470030;Just Bones;Indie, Strategy;0 - 20,000;20;7;13;43;43;0
470040;Spellgear;Adventure, Indie, RPG, Strategy;0 - 20,000;52;28;24;0;0;0
470060;1917 - The Alien Invasion DX;Action, Strategy, Early Access;20,000 - 50,000;105;29;76;0;0;0
470090;Quantum Replica;Adventure, Indie, Strategy;0 - 20,000;56;52;4;6;6;0
470130;Eclipse --- Defending the motherland;Action;50,000 - 100,000;25;24;1;5;6;0
470140;Funklift;Casual, Indie, Simulation;0 - 20,000;8;7;1;0;0;0
470170;Evangeline;Casual, Indie;0 - 20,000;10;15;-5;0;0;0
470210;Rocketbirds 2 Evolution;Action, Free to Play, Indie;20,000 - 50,000;277;87;190;87;87;1
470220;UNO;Action, Adventure;2,000,000 - 5,000,000;32083;11560;20523;375;247;402
470260;Event[0];Action, Adventure, Indie;100,000 - 200,000;1691;421;1270;211;221;1
470270;Tribal Pass;Action, RPG;100,000 - 200,000;294;95;199;289;272;2
470280;Lost Route;Adventure, Indie;0 - 20,000;5;21;-16;0;0;0
470300;Winged Sakura: Demon Civil War;Action, Adventure, Casual, Indie;0 - 20,000;68;19;49;698;698;0
470310;TROUBLESHOOTER: Abandoned Children;Action, Adventure, Indie;200,000 - 500,000;6992;386;6606;1961;3103;332
470440;Matris;Action, Adventure, Casual, Indie, Strategy;0 - 20,000;64;1;63;159;159;1
470450;Where's My Helmet?;Casual, Indie, Simulation, Sports, Strategy;20,000 - 50,000;67;27;40;309;361;12
470470;Birdsketball;Adventure, Indie, RPG, Simulation;0 - 20,000;48;1;47;0;0;0
470480;Angel Express [Tokkyu Tenshi];Action, Casual, Indie;0 - 20,000;32;9;23;409;409;0
470490;RollerGirls From Beyond;Action, Indie;0 - 20,000;13;5;8;0;0;0
470580;In The Shadows;Adventure, Indie, Strategy;0 - 20,000;48;3;45;0;0;0
470590;moto RKD dash SP;Casual, Simulation;0 - 20,000;47;19;28;1;1;0
470740;Demolish & Build 2017;Action, Free to Play, Massively Multiplayer, Strategy;100,000 - 200,000;468;129;339;358;40;1
470760;Antiflux;Action, Adventure, Indie;0 - 20,000;35;6;29;0;0;0
470780;She Remembered Caterpillars;Indie;50,000 - 100,000;437;23;414;127;174;1
470890;WarFire;Adventure, Indie;;;;0;;;
471010;Seven: Enhanced Edition;Action, Indie, RPG;200,000 - 500,000;1195;349;846;164;215;4
471160;Moonshot Galaxy;Casual, Indie, Strategy;0 - 20,000;17;10;7;0;0;0
471160;Moonshot Galaxy;Action, Indie;0 - 20,000;17;10;7;0;0;0
471170;Romopolis;Casual, Indie, RPG;20,000 - 50,000;87;29;58;206;257;1
471200;Melody;Adventure, Casual, Indie;0 - 20,000;5;0;5;0;0;0
471220;Don't Drop the Bass;Indie, RPG, Simulation, Strategy;0 - 20,000;6;1;5;0;0;0
471270;Leave The Nest;Action, Adventure, Simulation;0 - 20,000;9;4;5;0;0;0
471330;VERSUS SQUAD;Indie;100,000 - 200,000;443;113;330;127;145;1
471380;Urban Pirate;Casual, Free to Play, Indie, Strategy;0 - 20,000;32;11;21;0;0;0
471400;Space Jammers;Adventure, Massively Multiplayer;0 - 20,000;10;6;4;0;0;0
471550;Nine Parchments;Adventure, Indie, RPG;500,000 - 1,000,000;2889;858;2031;346;402;44
471570;Grandpa's Table;Action, Adventure, Indie;0 - 20,000;82;1;81;114;114;1
471570;Grandpa's Table;Simulation, Strategy;0 - 20,000;82;1;81;114;114;1
471630;Rexodus: A VR Story Experience;Adventure, Free to Play;100,000 - 200,000;81;32;49;12;14;0
471640;.EXE;Action;0 - 20,000;6;2;4;0;0;0
471660;Kingspray Graffiti VR;Adventure;100,000 - 200,000;675;126;549;93;120;11
471700;Greedy Guns;Action, Casual, Indie, RPG, Strategy;0 - 20,000;65;15;50;0;0;0
471710;Rec Room;Action, Adventure, Indie;1,000,000 - 2,000,000;44290;4128;40162;531;121;2650
471730;Rocket Ski Racing;Action, Adventure, Indie;0 - 20,000;16;7;9;0;0;0
471770;In Case of Emergency, Release Raptor;Adventure, Casual, Indie;20,000 - 50,000;53;18;35;0;0;0
471810;Death Squared;Adventure, Casual, Indie;50,000 - 100,000;440;46;394;294;337;9
471920;Pan-Pan;Casual, Indie, Simulation;0 - 20,000;189;25;164;0;0;0
472060;Ortus Regni;Indie;20,000 - 50,000;148;29;119;9;9;1
472420;Duke Grabowski, Mighty Swashbuckler;Indie;20,000 - 50,000;165;27;138;0;0;1
472680;Elisa: The Innkeeper - Prequel;Adventure, Indie, Early Access;100,000 - 200,000;573;162;411;8;8;0
472690;Sombrero: Spaghetti Western Mayhem;Adventure, Indie;0 - 20,000;25;20;5;331;331;0
472720;Car Car Crash Hands On Edition;Action, Casual, Indie, Simulation, Strategy;0 - 20,000;5;1;4;0;0;0
472740;Ghrian;Action, Indie, Simulation, Sports, Early Access;0 - 20,000;0;3;-3;0;0;0
472770;HELP: THE GAME;Action, Indie;0 - 20,000;9;0;9;0;0;0
472830;Ke-Tsu-No-Ana;Adventure, RPG;0 - 20,000;9;6;3;0;0;0
472870;Higurashi When They Cry Hou - Ch.3 Tatarigoroshi;Action, Indie, Simulation;20,000 - 50,000;632;12;620;188;212;10
473050;UnderWater Adventure;Indie;0 - 20,000;2;20;-18;0;0;0
473140;BomberZone;Indie;50,000 - 100,000;95;37;58;291;280;2
473450;The Narrator Is a DICK;Action, Adventure, Casual, Indie, Strategy;20,000 - 50,000;102;24;78;0;0;0
473460;Memory Oblivion Box;Indie, RPG, Strategy;20,000 - 50,000;871;70;801;540;540;1
473470;Purgatory;Adventure;50,000 - 100,000;149;96;53;234;249;0
473480;Miko Mole;Simulation, Strategy;0 - 20,000;9;8;1;129;129;0
473510;Gal-X-E;Racing, Simulation, Sports;20,000 - 50,000;67;8;59;339;437;0
473520;Autumn;Casual, Free to Play, Indie, Simulation;50,000 - 100,000;139;107;32;198;231;0
473520;Autumn;Adventure, Strategy;50,000 - 100,000;139;107;32;198;231;0
473530;Slime-san: Superslime Edition;Indie, Simulation, Strategy, Early Access;0 - 20,000;240;40;200;305;318;0
473540;Raise Your Own Clone;Action, Adventure, Indie;20,000 - 50,000;9;14;-5;0;0;29
473550;SnowBall FPS;Action, Indie;0 - 20,000;1;2;-1;0;0;0
473560;Cosmic Dust & Rust;Action, Adventure, Casual, Indie;200,000 - 500,000;254;184;70;230;215;0
473610;Shock Tactics;Education;20,000 - 50,000;53;74;-21;0;0;0
473670;The Dolls: Reborn;Casual;50,000 - 100,000;126;151;-25;222;299;45
473690;Absolver;Casual;500,000 - 1,000,000;9825;3925;5900;280;185;49
473720;Mutant Mudds Super Challenge;Adventure, Indie;0 - 20,000;13;1;12;0;0;0
473770;BallisticNG;Action, Adventure, Indie, Simulation;100,000 - 200,000;2424;166;2258;124;7;12
473780;Splitter Critters;Animation & Modeling, Education, Utilities, Web Publishing;0 - 20,000;23;1;22;0;0;0
473800;Bullet Life 2010;Adventure, Strategy;0 - 20,000;58;49;9;0;0;0
473810;Killbot;Action, Indie;20,000 - 50,000;39;68;-29;241;242;0
473840;Diib's Dilemma;Animation & Modeling, Design & Illustration, Utilities, Early Access;0 - 20,000;28;4;24;150;150;2
473840;Diib's Dilemma;Action, Adventure, Indie, Strategy;0 - 20,000;28;4;24;150;150;2
473910;The Nest;Indie, Simulation;0 - 20,000;116;69;47;0;0;0
473920;Corinne Cross's Dead & Breakfast;Indie, Simulation, Strategy;0 - 20,000;126;1;125;0;0;0
473950;Manifold Garden;Action, Adventure, Indie;200,000 - 500,000;4178;165;4013;157;214;10
473970;Zombie City Defense 2;Utilities;20,000 - 50,000;136;53;83;83;125;4
474010;The NADI Project;Adventure, Indie, RPG;100,000 - 200,000;280;142;138;103;154;0
474020;Ragnorium;Casual, Indie;20,000 - 50,000;378;209;169;116;116;2
474030;The Abbey of Crime Extensum;Action, Indie;50,000 - 100,000;201;34;167;0;0;0
474050;Candy Blast;Adventure, Indie, Massively Multiplayer, RPG, Simulation, Early Access;20,000 - 50,000;73;57;16;222;219;2
474210;BUTCHER;Action, Adventure, Indie, RPG, Early Access;50,000 - 100,000;914;144;770;34;49;0
474220;Soldat 2;Action, Adventure, Casual, Indie;20,000 - 50,000;310;37;273;0;0;0
474240;Journey to the Center of the Earth;Casual, Indie;20,000 - 50,000;17;22;-5;0;0;1
474620;Giga Girl;Casual, Strategy;0 - 20,000;16;6;10;0;0;0
474730;Airship Asunder;Action, Indie, RPG;0 - 20,000;9;10;-1;0;0;0
474750;Reigns;Adventure, Casual, Indie;200,000 - 500,000;6534;893;5641;231;186;12
474810;Dorke and Ymp;Action, Free to Play;0 - 20,000;14;10;4;2;2;0
474830;Time in Time;Action, Casual, Indie;100,000 - 200,000;70;24;46;378;442;3
474880;Second Coming;Action, Indie;20,000 - 50,000;2;1;1;0;0;0
474890;Uncrewed;Action, Adventure;0 - 20,000;86;49;37;0;0;0
474910;The Mahjong Huntress;Action, Indie, Massively Multiplayer, Simulation, Strategy, Early Access;50,000 - 100,000;116;92;24;210;245;1
474960;Quantum Break;Violent, RPG, Strategy;1,000,000 - 2,000,000;20189;3413;16776;434;315;85
475050;bloxyz;Simulation;0 - 20,000;5;4;1;0;0;0
475080;Cavernus;Action, Casual;0 - 20,000;8;11;-3;0;0;0
475090;Project Remedium;Early Access;20,000 - 50,000;46;92;-46;0;0;0
475150;Titan Quest Anniversary Edition;Action, Casual, Indie;2,000,000 - 5,000,000;27365;2668;24697;922;226;1294
475190;Scanner Sombre;Indie;100,000 - 200,000;2798;349;2449;111;125;4
475240;ORCS;Adventure, Indie;20,000 - 50,000;315;67;248;127;164;4
475490;Major\Minor - Complete Edition;Adventure, Indie;50,000 - 100,000;434;130;304;411;430;0
475520;Holodaze;Indie, Strategy;0 - 20,000;7;3;4;0;0;0
475530;Go Go Electric Samurai;Simulation;0 - 20,000;17;6;11;5;5;0
475550;Beholder;Simulation;1,000,000 - 2,000,000;21109;1936;19173;309;234;102
475620;MOAI 4: Terra Incognita Collector’s Edition;Adventure;0 - 20,000;23;5;18;0;0;3
475630;Crush Online;Adventure, Casual, Indie, RPG;200,000 - 500,000;309;201;108;155;171;0
475960;Bombslinger;Casual, Indie, Strategy;0 - 20,000;81;16;65;0;0;0
476000;Slightly Magic - 8bit Legacy Edition;Action, Free to Play, Massively Multiplayer, Simulation, Strategy;;;;0;;;
476020;Reflection of Mine;Adventure, Indie;20,000 - 50,000;173;38;135;0;0;1
476030;Johnny Graves—The Unchosen One;Action, Adventure, Indie;0 - 20,000;29;15;14;0;0;0
476240;KNIGHTS;Action, Casual, Simulation, Sports;50,000 - 100,000;659;37;622;191;205;4
476360;Strike Vector EX;Adventure, Indie, Simulation;200,000 - 500,000;644;107;537;378;399;0
476370;MAGATAMA Earrings;Action, Indie;0 - 20,000;13;6;7;0;0;0
476410;One Small Fire At A Time;Casual, Indie;0 - 20,000;56;4;52;0;0;0
476410;One Small Fire At A Time;Adventure, Casual, Indie, Early Access;0 - 20,000;56;4;52;0;0;0
476420;Heart of Crown PC;Action;50,000 - 100,000;428;102;326;1465;1465;4
476430;SwingStar VR;Action, Indie, Simulation, Early Access;0 - 20,000;18;3;15;0;0;0
476450;So Much Blood;Casual, Indie, Simulation, Strategy;0 - 20,000;25;18;7;0;0;0
476460;Picross Touch;Adventure, Casual, Free to Play, Indie, Massively Multiplayer, RPG, Strategy;200,000 - 500,000;1274;79;1195;741;957;94
476490;Choice of the Pirate;Adventure, Casual, Indie;0 - 20,000;91;7;84;0;0;1
476510;Cally's Trials;Adventure, Casual;20,000 - 50,000;118;47;71;21;21;1
476530;Children of a Dead Earth;Action, Indie, Early Access;20,000 - 50,000;582;64;518;7337;7337;6
476540;Google Spotlight Stories: Pearl;Casual, Free to Play, Simulation, Early Access;50,000 - 100,000;343;13;330;26;26;0
476600;Call of Duty: WWII;Simulation;1,000,000 - 2,000,000;23303;11855;11448;738;377;364
476650;The Silver Case;Action, Adventure, Indie, RPG, Strategy;20,000 - 50,000;528;77;451;524;524;3
476670;Emberdoom;Action, Indie, Early Access;20,000 - 50,000;5;1;4;0;0;0
476680;Emberdoom VR;Design & Illustration, Web Publishing;0 - 20,000;0;1;-1;0;0;0
476700;Island 359;Sexual Content, Nudity, Adventure, Casual;20,000 - 50,000;327;102;225;560;560;0
476700;Island 359;Indie;20,000 - 50,000;327;102;225;560;560;0
476710;MechaGore;Adventure, Indie;0 - 20,000;17;16;1;0;0;0
476930;FourChords Guitar Karaoke;Action, Adventure, Indie, RPG;0 - 20,000;69;23;46;1876;1876;2
477010;10 Minute Tower;Action, Indie;0 - 20,000;2;3;-1;0;0;0
477120;Train Chase;Action, Adventure, Casual, Indie;0 - 20,000;5;0;5;0;0;0
477130;Surge;Action;20,000 - 50,000;245;15;230;22;23;0
477140;SparkDimension;Action, Casual, Indie;0 - 20,000;26;49;-23;357;357;0
477160;Human: Fall Flat;Indie, Simulation, Strategy;10,000,000 - 20,000,000;170511;9506;161005;754;367;2984
477170;Chamber 19;Action, Adventure, Indie;0 - 20,000;31;17;14;0;0;0
477180;Shard Games;Action, Adventure, Indie, RPG, Strategy;20,000 - 50,000;32;57;-25;280;285;0
477190;Epic Snowday Adventure;Action, Adventure, Casual, Indie, RPG, Early Access;0 - 20,000;4;1;3;0;0;0
477200;Descent: Road to Legend;Strategy;50,000 - 100,000;312;36;276;2298;2317;9
477270;Lightblade VR;Action, Adventure, Indie;100,000 - 200,000;516;130;386;57;81;0
477290;Magma Tsunami;Adventure, Simulation;200,000 - 500,000;198;106;92;392;426;0
477310;Space Hole 2016;Casual, Indie, Simulation, Strategy;20,000 - 50,000;61;11;50;123;123;1
477720;Toricky;Action, Indie, Strategy, Early Access;0 - 20,000;6;7;-1;0;0;0
477730;Eador. Imperium;Indie;20,000 - 50,000;908;275;633;637;637;22
477740;Zero Escape: The Nonary Games;Web Publishing;200,000 - 500,000;3934;224;3710;744;1208;304
477750;Thirty Years' War;Action, Indie;0 - 20,000;31;15;16;0;0;0
477770;Ride 2;Action, Casual, Indie, Strategy;100,000 - 200,000;2359;365;1994;2740;2358;20
477800;Piñata;Casual, Indie;0 - 20,000;22;20;2;0;0;0
477870;Yomawari: Night Alone;Action, Indie, RPG, Early Access;50,000 - 100,000;1423;376;1047;1304;2464;12
477900;Lord of Dwarves;Action, Indie;0 - 20,000;56;13;43;0;0;0
477910;Wanderer of Teandria;Casual, Simulation;0 - 20,000;10;0;10;0;0;0
477950;Simple Spy;Adventure, Casual;0 - 20,000;14;3;11;1471;1471;0
478000;Qantas VR;Action, Adventure, Casual, Indie, Early Access;0 - 20,000;13;9;4;17;17;0
478010;ABC Coloring Town;Action, Casual, Indie;50,000 - 100,000;199;93;106;310;333;0
478020;Old School 8-in-1 bundle;Adventure, Casual, Indie;0 - 20,000;4;0;4;0;0;0
478210;BUDDY;Casual, Indie, Simulation;0 - 20,000;46;37;9;0;0;0
478950;V ARRR;Action, Adventure, Indie, RPG, Simulation, Strategy;0 - 20,000;51;27;24;24;24;0
478960;Clickteam Fusion 2.5 Free Edition;Action, Casual, Indie;50,000 - 100,000;163;52;111;150;295;5
478980;Mansions of Madness;Sexual Content, Nudity, Violent, Gore, Indie, Simulation;200,000 - 500,000;858;70;788;498;410;53
479000;IrreVRsible;Indie, RPG;0 - 20,000;30;9;21;0;0;0
479010;Kodon;Action, Adventure, Casual;0 - 20,000;176;79;97;0;0;3
479020;Pirates of the Polygon Sea;Action, Adventure, Indie, Simulation;0 - 20,000;77;37;40;0;0;0
479040;Metamorphic;Violent, Gore, Indie, Early Access;0 - 20,000;24;11;13;0;0;0
479100;Music Wars Empire;Indie, Strategy;50,000 - 100,000;75;70;5;0;0;13
479110;Hunter's Legacy;Casual, Indie, Strategy;0 - 20,000;33;12;21;1;1;0
479130;ESEA;Indie, RPG, Strategy;500,000 - 1,000,000;3100;1145;1955;1824;6;622
479140;Framed Wings;Action, Adventure, Casual, Indie, RPG, Simulation;0 - 20,000;20;3;17;0;0;0
479150;BoX -containment-;Action, Indie;0 - 20,000;5;1;4;0;0;0
479170;Drunk Wizards;Action, RPG;0 - 20,000;5;64;-59;0;0;0
479180;Space Universe;Action, Adventure, Casual, Indie;0 - 20,000;2;26;-24;0;0;0
479200;Champions of Odin;Adventure, Indie, RPG;0 - 20,000;8;5;3;0;0;0
479310;Doodler;Action, Adventure, Indie;0 - 20,000;43;4;39;0;0;0
479330;Crazy Stone Deep Learning -The First Edition-;Action, Indie;0 - 20,000;25;7;18;0;0;0
479990;Dungeons & Darkness;Indie, Simulation;0 - 20,000;64;34;30;0;0;0
479990;Dungeons & Darkness;Action, Free to Play, Sports;0 - 20,000;64;34;30;0;0;0
480410;Mitch: Berry Challenge;Casual, Indie, Strategy;0 - 20,000;13;3;10;0;0;0
480430;Hide and Shriek;Casual, Indie, Strategy;500,000 - 1,000,000;3822;768;3054;54;23;55
480450;Floppy Heroes;Action, Adventure, Casual, Indie, Strategy;0 - 20,000;334;18;316;275;275;1
480480;Slash or Die;Casual, Free to Play, Indie;50,000 - 100,000;210;32;178;174;210;0
480490;Prey;Action, Adventure, Casual, Indie;1,000,000 - 2,000,000;38138;3972;34166;1143;493;450
480500;Dogfight Elite;Casual, Indie, Massively Multiplayer, Simulation, Sports, Early Access;0 - 20,000;18;13;5;0;0;1
480500;Dogfight Elite;Action, Casual, Indie, Simulation;0 - 20,000;18;13;5;0;0;1
480640;Pathfinder Adventures;Adventure, Casual, Indie;100,000 - 200,000;462;267;195;717;733;13
480650;Yu-Gi-Oh! Legacy of the Duelist;Indie, Strategy;200,000 - 500,000;3688;671;3017;2649;1607;73
480690;Inbound;Casual, Indie, Strategy;0 - 20,000;36;4;32;0;0;0
480710;Moatboat;Action, Indie;0 - 20,000;0;2;-2;0;0;0
480770;Dreamals;Casual, Free to Play, Indie, Strategy;0 - 20,000;5;2;3;0;0;0
480900;Slap Village: Reality Slap;Action, Racing, Early Access;0 - 20,000;101;18;83;0;0;0
481110;The Bunker;Casual, Indie, Simulation;50,000 - 100,000;988;420;568;105;138;3
481180;System Crash;Indie;20,000 - 50,000;233;50;183;374;374;2
481190;Stable Orbit - Build your own space station;Action, Adventure, Casual, Indie, RPG;50,000 - 100,000;188;171;17;82;82;0
481420;Final Approach: Pilot Edition;Adventure, Casual, Indie;0 - 20,000;27;16;11;8;8;0
481510;Night in the Woods;Casual, Indie, Simulation, Strategy;200,000 - 500,000;13993;937;13056;736;789;83
481600;Finding Hope;Casual, Indie, Simulation;20,000 - 50,000;37;17;20;157;211;3
481870;Mini Thief;Simulation;50,000 - 100,000;305;117;188;62;109;1
481950;Emily: Displaced;Indie, Simulation;0 - 20,000;6;0;6;0;0;0
482210;Quarterback SNAP;Action, Casual, Indie;0 - 20,000;5;2;3;0;0;0
482300;Investigator;Indie, Strategy;50,000 - 100,000;668;291;377;147;163;0
482330;Legends of the Universe - StarCore;Indie;50,000 - 100,000;85;22;63;303;251;1
482390;The Night Cafe: A VR Tribute to Vincent Van Gogh;Indie, Strategy;20,000 - 50,000;244;11;233;8;8;0
482390;The Night Cafe: A VR Tribute to Vincent Van Gogh;Action, Adventure, Indie;20,000 - 50,000;244;11;233;8;8;0
482450;Nitroplus Blasterz: Heroines Infinite Duel;Adventure, Casual;50,000 - 100,000;698;72;626;91;109;0
482460;Reverence: The Ultimate Combat Experience;Action, Indie;0 - 20,000;6;2;4;0;0;0
482730;Football Manager 2017;Action, Casual, Indie;2,000,000 - 5,000,000;6535;4505;2030;31898;20880;922
482890;Fantasy Kingdom Simulator;Action;50,000 - 100,000;59;66;-7;232;229;2
482920;Hero Zero;Adventure, Casual, Indie;200,000 - 500,000;2715;586;2129;754;178;262
482990;Heirs And Graces;Casual, Indie, Simulation;0 - 20,000;70;6;64;0;0;0
483420;Adam Wolfe;Casual, Indie, Strategy;50,000 - 100,000;901;70;831;274;342;1
483490;Circuitous ;Adventure, Indie;0 - 20,000;7;1;6;0;0;0
483680;PolyDome;Adventure, Indie, Massively Multiplayer;20,000 - 50,000;43;6;37;27;27;0
483770;Autobahn Police Simulator 2;Indie, Strategy;100,000 - 200,000;663;488;175;405;497;13
483820;Four Realms;Action, Indie;0 - 20,000;2;0;2;0;0;0
483850;Guns N' Boxes;Action, Indie;0 - 20,000;56;18;38;0;0;0
483950;SMILE GAME BUILDER;Indie, Simulation, Early Access;0 - 20,000;225;33;192;16;16;7
483960;Purino Party;Indie, RPG;0 - 20,000;183;90;93;312;312;0
483970;Directionless;Action, Adventure, Indie;0 - 20,000;50;13;37;0;0;0
483970;Directionless;Indie, Simulation, Early Access;0 - 20,000;50;13;37;0;0;0
483980;Mad Father;Adventure, Casual, Free to Play;50,000 - 100,000;3767;115;3652;151;198;13
484350;VRZ: Torment;Action, Indie;0 - 20,000;165;70;95;14;14;0
484390;Hanger World;Action, Indie;0 - 20,000;27;1;26;0;0;1
484390;Hanger World;Adventure, RPG;0 - 20,000;27;1;26;0;0;1
484830;Deep Blue 3D Maze in Space;Action, Adventure, Casual, Indie;50,000 - 100,000;56;32;24;235;262;0
484870;Battle Dome;Action;50,000 - 100,000;417;58;359;0;0;0
484890;Crazy Otto;Casual, Simulation, Strategy;0 - 20,000;10;5;5;0;0;0
484900;Aven Colony;Action, Casual, Indie;100,000 - 200,000;1695;563;1132;359;428;28
484930;Beekyr Reloaded;Action, Adventure, Indie;0 - 20,000;74;9;65;0;0;0
484950;Evil Maze;Casual, Simulation, Strategy;200,000 - 500,000;891;285;606;292;390;3
484990;Alveari;Action, Adventure, Indie;0 - 20,000;2;0;2;0;0;0
485000;Cthulhu Realms;Indie, Early Access;50,000 - 100,000;151;59;92;23;23;1
485030;PLANET ALPHA;Education;50,000 - 100,000;643;267;376;104;115;2
485040;Nurse Love Addiction;Adventure, Indie, RPG, Strategy, Early Access;0 - 20,000;661;51;610;170;210;1
485040;Nurse Love Addiction;Indie, RPG, Strategy;0 - 20,000;661;51;610;170;210;1
485080;Megapolis;Casual, Indie, Strategy;20,000 - 50,000;98;33;65;270;302;4
485110;PlanetFate;Action, Casual, Simulation, Sports;0 - 20,000;14;2;12;0;0;0
485120;Frog Climbers;Adventure, Casual;20,000 - 50,000;138;29;109;155;157;1
485120;Frog Climbers;Action, Adventure, Casual, Indie;20,000 - 50,000;138;29;109;155;157;1
485130;Super Red-Hot Hero;Casual;0 - 20,000;4;1;3;0;0;0
485150;Web Designer 12 Premium Steam Edition;Casual, Indie, Strategy;0 - 20,000;7;8;-1;0;0;0
485160;Black Hole Hazard;Action, Casual, Indie, Racing;0 - 20,000;33;4;29;0;0;0
485230;HALP!;Simulation, Sports;20,000 - 50,000;75;29;46;7;10;0
485240;Push For Emor;Action, Indie;0 - 20,000;27;18;9;0;0;0
485260;Talent Not Included;Action, Adventure, Indie, RPG;0 - 20,000;35;6;29;0;0;0
485270;Arachnophobia;Casual, Indie;0 - 20,000;4;7;-3;0;0;0
485290;Vermillion Watch: Moorgate Accord Collector's Edition;Adventure, Indie, Strategy;0 - 20,000;16;0;16;0;0;0
485310;Head Shot;Action, Indie;500,000 - 1,000,000;867;868;-1;232;250;1
485330;Star Drifter;Action, Adventure, Indie, Massively Multiplayer, RPG, Early Access;200,000 - 500,000;90;105;-15;219;217;1
485340;The Orchard of Stray Sheep;Adventure, Indie;0 - 20,000;35;12;23;0;0;0
485350;Winter Novel;Action, Adventure, Indie, RPG, Simulation;20,000 - 50,000;445;92;353;255;217;0
485360;Disgraced;Casual, Indie;50,000 - 100,000;70;13;57;0;0;0
485370;Mad Combat Marines;Casual, Indie, Early Access;50,000 - 100,000;275;122;153;110;110;2
485380;Welcome to the Game;Action, Adventure, Indie;100,000 - 200,000;1865;340;1525;154;152;10
485390;Machine Made: Rebirth;Action, Adventure, Casual, Indie, Racing;50,000 - 100,000;105;27;78;351;361;12
485400;Mechajammer;Action, Casual, Indie;100,000 - 200,000;109;92;17;0;0;0
485430;NAL Is Alive;Casual, Indie;20,000 - 50,000;12;9;3;2;2;0
485440;Call Of The Mighty Warriors;Action, Casual, Indie;20,000 - 50,000;141;95;46;359;385;1
485450;Ninja Stealth;Casual, Indie;200,000 - 500,000;888;414;474;236;297;5
485460;The Banner Saga 3;Casual, Indie;100,000 - 200,000;1963;429;1534;489;620;25
485490;Dungeon Journey;Casual, Indie;50,000 - 100,000;195;54;141;240;257;0
485500;Smithy;Casual;50,000 - 100,000;68;20;48;226;215;0
485510;Nioh: Complete Edition;Casual;1,000,000 - 2,000,000;24977;6076;18901;3521;1186;1004
485560;POPixel;Casual;20,000 - 50,000;46;15;31;293;217;1
485570;Milford Heaven - Luken's Chronicles;Indie;20,000 - 50,000;34;19;15;253;239;0
485590;Citadel;Action, Adventure, Indie;0 - 20,000;16;11;5;0;0;0
485600;OESE;Action, Adventure, Indie;0 - 20,000;58;12;46;0;0;0
485610;Ball 3D: Soccer Online;Action, Casual, Sports;500,000 - 1,000,000;7243;1421;5822;1796;65;175
485620;Pick a Hero;Adventure, Indie, Strategy;0 - 20,000;33;14;19;0;0;0
485640;Genius Greedy Mouse;Simulation, Sports;20,000 - 50,000;67;17;50;267;265;0
485650;Campaign Clicker;Action, Strategy;100,000 - 200,000;190;206;-16;21;31;1
485660;Karma Miwa;Animation & Modeling, Utilities;0 - 20,000;37;18;19;271;267;0
485670;Mini Golf Arena;Action, Indie;20,000 - 50,000;246;242;4;141;141;1
485680;sphereFACE;Casual;0 - 20,000;27;1;26;0;0;0
485690;Hope Lake;Action, Indie, Simulation, Sports, Early Access;50,000 - 100,000;334;126;208;203;203;5
485730;Shift;Action, Free to Play, Indie;100,000 - 200,000;217;69;148;248;260;0
485750;Magnetta;Action, Racing, Simulation, Sports;0 - 20,000;11;7;4;0;0;0
485760;Legend of Numbers;RPG;20,000 - 50,000;73;25;48;1;1;1
485770;Penguins of The North;Casual, Indie;0 - 20,000;1;0;1;0;0;0
485790;JOLT: Super Robot Racer;Simulation, Sports;0 - 20,000;7;4;3;0;0;0
485800;Runeous: Part One;Casual, Simulation, Sports;20,000 - 50,000;83;26;57;0;0;0
485830;Star Merc;Action, Indie;50,000 - 100,000;33;20;13;236;250;6
485860;Impossible Quest;Action, Indie, Racing, Early Access;20,000 - 50,000;226;82;144;115;199;2
485870;Super Duper Party Pooper;Action, Adventure, Simulation;100,000 - 200,000;344;91;253;192;236;1
485880;L U N E;Action, Free to Play, Indie, Massively Multiplayer, RPG, Early Access;0 - 20,000;48;3;45;0;0;0
485890;Summer Sale;Adventure, Indie;20,000 - 50,000;548;379;169;96;162;0
485900;Hardware Engineers;Action, Adventure, Racing;0 - 20,000;245;43;202;0;0;2
485920;Neon Warp;Action, Adventure, Indie, RPG;20,000 - 50,000;58;18;40;284;198;58
485950;Rise of the Ancients;Indie, Racing, Simulation;200,000 - 500,000;122;174;-52;221;220;2
485970;Cyber Sentinel;Action, Casual, Indie;0 - 20,000;36;4;32;0;0;0
485980;Syrian Warfare;Action, Adventure, Early Access;200,000 - 500,000;3596;554;3042;206;262;46
486020;Hero;Casual, Indie, Simulation, Strategy;20,000 - 50,000;26;14;12;153;197;0
486120;Escape The Past;Racing, Simulation, Sports;0 - 20,000;40;20;20;302;302;2
486130;Best Buds vs Bad Guys;Action, Indie;0 - 20,000;17;8;9;0;0;0
486140;9Grids VR;Adventure, Indie, RPG;0 - 20,000;3;3;0;0;0;0
486150;Radical Spectrum: Volume 1;Adventure, Indie;50,000 - 100,000;58;50;8;310;318;31
486170;Bathory - The Bloody Countess;Sexual Content, Nudity, Violent, Gore, RPG;0 - 20,000;36;17;19;0;0;0
486180;The Penguin Factory;Action, Indie;0 - 20,000;13;0;13;0;0;0
486230;Con Amore;Free to Play, Indie, Strategy;0 - 20,000;9;4;5;0;0;0
486290;Waddle Home;Sports;0 - 20,000;31;4;27;6;6;0
486300;Plan Z Chapter 1;Casual, RPG, Simulation, Strategy;0 - 20,000;8;10;-2;92;92;0
486310;Meadow;Casual, Indie, RPG, Strategy;500,000 - 1,000,000;5093;599;4494;333;286;12
486320;Orbit: Satellite Defense;Free to Play, Indie, Massively Multiplayer, RPG, Strategy;0 - 20,000;2;1;1;0;0;0
486350;Square Arena;RPG;0 - 20,000;14;3;11;0;0;0
486360;Timore Inferno;Action, Adventure, Indie, Simulation;100,000 - 200,000;200;132;68;203;204;0
486370;Pinball Evolution VR;Action, Adventure, Indie;0 - 20,000;29;5;24;0;0;0
486380;Shigatari;Casual, Indie, RPG;0 - 20,000;208;5;203;0;0;1
486410;Biosys Inc;Casual, Indie, Racing, Early Access;0 - 20,000;7;1;6;0;0;0
486430;Sphoxie;Action, Adventure, Indie;0 - 20,000;10;0;10;239;239;0
486440;Mosh Pit Simulator;Action, Adventure, Indie;0 - 20,000;51;15;36;0;0;0
486460;Twilight Town;Action, Adventure, Indie;20,000 - 50,000;66;42;24;0;0;4
486470;Derelict Redux;Action, Indie;0 - 20,000;9;10;-1;0;0;0
486480;Tales of Destruction;Indie, Strategy;100,000 - 200,000;34;117;-83;231;214;1
486490;Witan;Animation & Modeling, Design & Illustration;0 - 20,000;15;8;7;0;0;0
486500;Spooky Heroes;Adventure, Indie, RPG;0 - 20,000;22;13;9;271;271;0
486510;TOKYO WARFARE;Action, Adventure, Indie, Massively Multiplayer, RPG, Early Access;20,000 - 50,000;268;54;214;477;477;0
486540;Townsmen;Violent, Gore, Action, Adventure;20,000 - 50,000;166;56;110;0;0;0
486630;Toxic Terror;Action, Adventure, Indie, Simulation;0 - 20,000;9;3;6;0;0;0
486640;Cheaters Blackjack 21;RPG, Simulation, Strategy;0 - 20,000;10;16;-6;0;0;0
486650;Potato Thriller;Action, Casual, Indie, Simulation;20,000 - 50,000;429;110;319;0;0;3
486660;Super Mixtape;Adventure, Indie, Early Access;0 - 20,000;15;2;13;0;0;0
486670;Easy French Platinum;Adventure, Casual, Indie;0 - 20,000;3;5;-2;0;0;1
486690;Pastelia Stories;Action, Adventure, Indie, Simulation, Strategy, Early Access;20,000 - 50,000;521;277;244;0;0;1
486720;Bastard Bonds;Adventure, Casual, Indie;20,000 - 50,000;633;73;560;842;908;17
486760;Master Of Marbles;Action, Free to Play, Indie, Strategy, Early Access;0 - 20,000;0;2;-2;0;0;0
486780;Fruit Ninja VR;Action, Adventure, Free to Play, Massively Multiplayer, RPG;50,000 - 100,000;643;163;480;63;78;17
486810;House of Snark 6-in-1 Bundle;Action, Casual, Indie, Massively Multiplayer, Strategy;20,000 - 50,000;82;13;69;200;200;10
486850;Card of spirits;Action, Indie;20,000 - 50,000;73;23;50;0;0;0
486860;MMORPG Tycoon 2;Indie, Simulation, Sports;50,000 - 100,000;2018;275;1743;1852;3174;37
486880;Abrix 2 Diamond version;Action, Casual, Indie, RPG;20,000 - 50,000;56;141;-85;163;186;0
486890;Gear Gauntlet;Strategy;0 - 20,000;3;2;1;0;0;0
486940;Handball Action Total;Indie;0 - 20,000;19;5;14;0;0;0
486990;Jump Stars;Action, Indie;0 - 20,000;14;19;-5;7;7;0
486990;Jump Stars;Action, Indie;0 - 20,000;14;19;-5;7;7;0
487000;Quest Hunter;Action, Adventure, Indie;200,000 - 500,000;1653;375;1278;306;420;30
487030;Beasts Battle;Action, Adventure, Casual;20,000 - 50,000;63;22;41;224;224;0
487040;88 Heroes;Action, Casual, Indie, Racing;0 - 20,000;62;11;51;78;115;0
487120;Citadel: Forged with Fire;Casual, Indie, Strategy;200,000 - 500,000;3909;1813;2096;487;355;49
487180;The Lords of the Earth Flame;RPG;100,000 - 200,000;176;81;95;215;212;0
487220;Freebie;Casual;500,000 - 1,000,000;1008;364;644;253;248;0
487250;Spaera;Casual;50,000 - 100,000;58;66;-8;4;5;0
487330;Totally Unbalanced;Adventure, Casual, Indie;50,000 - 100,000;122;29;93;355;409;0
487350;Pirate Pop Plus;Action, Massively Multiplayer, Early Access;50,000 - 100,000;91;52;39;0;0;0
487370;Akin;Action, Casual, Indie, Strategy;50,000 - 100,000;359;55;304;278;239;1
487380;Tetradecagon;Indie, RPG, Strategy;0 - 20,000;13;2;11;0;0;0
487430;KARAKARA;Indie;50,000 - 100,000;1636;160;1476;163;99;2
487530;Simple Ball: Extended Edition;Adventure, Indie, Simulation;100,000 - 200,000;77;26;51;193;207;3
487580;Ludo Supremo;Action, Indie;50,000 - 100,000;75;56;19;285;315;1
487600;Puzzles Under The Hill;Free to Play, Indie, Simulation, Strategy, Early Access;50,000 - 100,000;70;36;34;182;207;0
487630;Lantern;Action, Free to Play, Indie;0 - 20,000;43;18;25;0;0;0
487700;Conan the mighty pig;Casual, Indie, Simulation;50,000 - 100,000;955;103;852;227;234;3
487720;Agony;Action, Adventure, Indie, RPG, Early Access;200,000 - 500,000;1247;1385;-138;112;213;5
487730;Hat Trick Header;Indie, Strategy;0 - 20,000;9;0;9;0;0;0
487770;Hoops VR;Violent, Gore, Action, Indie;0 - 20,000;49;16;33;0;0;0
488020;Day of Destruction;Strategy;0 - 20,000;3;4;-1;0;0;0
488040;VR Toolbox: 360 Desktop;Simulation;0 - 20,000;64;28;36;0;0;0
488070;Escargot Kart;Adventure;0 - 20,000;7;6;1;0;0;0
488080;Taxi;Action, Adventure, Casual;20,000 - 50,000;1;1;0;0;0;0
488150;Octoshield VR;Action, Adventure, Indie;0 - 20,000;20;9;11;0;0;0
488160;Galaxy Combat Wargames;Action;20,000 - 50,000;12;10;2;52;52;0
488210;JDM Tuner Racing;Casual, Indie, Simulation, Sports, Strategy;200,000 - 500,000;176;194;-18;0;0;0
488220;Valcarta: Rise of the Demon;Adventure, Indie;0 - 20,000;16;8;8;300;300;1
488220;Valcarta: Rise of the Demon;Action, Casual, Indie;0 - 20,000;16;8;8;300;300;1
488280;Gun Done;Adventure, Casual, Indie;20,000 - 50,000;535;61;474;140;181;2
488310;Eleven Table Tennis;Adventure, Indie, RPG;100,000 - 200,000;2848;139;2709;529;232;25
488330;Highway to the Moon;Action, Indie;0 - 20,000;14;8;6;238;246;0
488350;The Karters;Action, Indie;0 - 20,000;21;49;-28;0;0;0
488360;Vistascapes VR;Sexual Content, Nudity, Adventure, Casual;0 - 20,000;17;18;-1;0;0;0
488430;Galaxy in Turmoil;Action, Adventure, Casual, Indie, Strategy;200,000 - 500,000;116;173;-57;0;0;0
488440;Angeldust;Simulation, Early Access;50,000 - 100,000;897;511;386;16;18;1
488460;Zeus Quest Remastered;Adventure, Indie, Simulation;0 - 20,000;22;11;11;249;257;0
488480;SpaceRoads;Adventure, Casual, Indie;20,000 - 50,000;10;7;3;254;269;0
488500;The book of commands : Lost Symbol;Strategy;0 - 20,000;3;1;2;0;0;0
488550;Dream Car Builder;Adventure, Casual, Indie, RPG, Simulation;20,000 - 50,000;863;73;790;4533;8990;16
488580;Hover 2030;Action, Adventure, Casual, Indie, Massively Multiplayer, Racing, Sports, Early Access;20,000 - 50,000;63;21;42;117;144;10
488590;Armed Against the Undead;Indie;0 - 20,000;35;7;28;0;0;0
488660;Just Deserts;Action, Adventure, Indie;0 - 20,000;241;83;158;497;518;3
488690;MX Nitro: Unleashed;Adventure, Casual, Indie;0 - 20,000;95;18;77;0;0;1
488730;God's Trigger;Action, Adventure, Indie;100,000 - 200,000;605;210;395;163;146;3
488760;Left-Hand Path;Action, Adventure, Indie;0 - 20,000;104;19;85;15;15;0
488770;Her Majesty's SPIFFING;Action, Indie;0 - 20,000;225;57;168;0;0;0
488790;South Park: The Fractured But Whole;Adventure, Casual, Indie, Strategy;500,000 - 1,000,000;16079;3483;12596;1136;950;579
488860;MADNESS: Project Nexus;Action, Indie, Strategy;500,000 - 1,000,000;10978;310;10668;1331;2046;214
488890;GentleMoon 2;Indie, Simulation, Strategy;0 - 20,000;35;11;24;0;0;0
488910;Astral Heroes;Action, Casual, Indie, Simulation;50,000 - 100,000;209;93;116;0;0;6
488920;Knockout League - Arcade VR Boxing;Action, Casual, Indie, Racing;20,000 - 50,000;271;75;196;0;0;2
488950;Werewolves Within;Free to Play, Indie;0 - 20,000;93;50;43;0;0;3
488960;Star Vikings Forever;Action, Casual;20,000 - 50,000;79;10;69;0;0;2
489000;The Infinite Black;Action, Adventure, Indie;50,000 - 100,000;134;69;65;234;234;1
489020;iGrow Game;Action, Adventure, Indie, Early Access;50,000 - 100,000;126;94;32;471;490;0
489050;Whitetail Challenge;Action, Adventure;0 - 20,000;3;8;-5;0;0;0
489080;Spellforge;Adventure, Indie;0 - 20,000;3;2;1;0;0;0
489100;MachRace;Action, Adventure, Indie;0 - 20,000;9;1;8;0;0;0
489110;Putty Pals;Action, Adventure, Casual, Indie, Massively Multiplayer, Strategy;0 - 20,000;93;3;90;0;0;2
489120;Sling Ming;Action, Racing, Simulation, Sports;0 - 20,000;16;1;15;0;0;0
489140;Mr. Shifty;Casual, Indie, Strategy;100,000 - 200,000;1376;185;1191;335;401;3
489160;VR Shooter Guns;Action, Adventure, Indie;0 - 20,000;19;11;8;204;204;0
489170;Galaxy Reavers;Utilities;50,000 - 100,000;130;59;71;25;25;0
489180;RealityCapture Steam Edition;Action, Indie;0 - 20,000;82;28;54;0;0;0
489220;Unforgiving Trials: The Darkest Crusade;Adventure, Indie;200,000 - 500,000;402;229;173;267;281;1
489240;Exile to Death;Action, Adventure, Indie, Early Access;0 - 20,000;7;23;-16;0;0;0
489260;Brut@l;Indie, Simulation, Early Access;20,000 - 50,000;87;37;50;0;0;1
489260;Brut@l;Adventure, Indie, RPG;20,000 - 50,000;87;37;50;0;0;1
489360;CASE: Animatronics;Adventure, Casual, Indie, Racing, Simulation, Sports;200,000 - 500,000;2781;495;2286;236;400;7
489370;Quarantine;Action, Casual, Simulation;0 - 20,000;246;164;82;73;73;0
489380;QuiVr;Casual, Indie;50,000 - 100,000;448;51;397;44;44;0
489400;The Last Look;Casual;0 - 20,000;15;6;9;0;0;0
489440;Tentacult!;Action, Casual, Indie, Racing, Sports;0 - 20,000;28;8;20;0;0;0
489460;The Last Leviathan;Indie;50,000 - 100,000;359;200;159;82;82;0
489470;Hide and Secret Treasure of the Ages;Action, Indie, RPG;20,000 - 50,000;25;36;-11;173;173;1
489520;Minion Masters;Strategy;10,000,000 - 20,000,000;54697;5286;49411;3685;177;940
489560;Astroflux;Casual, Indie, Simulation;50,000 - 100,000;201;79;122;24;24;3
489570;Antisphere;Action, Casual, Indie, Simulation;20,000 - 50,000;57;36;21;224;247;0
489580;AWA;Action, Indie;20,000 - 50,000;73;20;53;62;62;0
489600;The Golf Club VR;Action, Adventure, Casual, Indie;20,000 - 50,000;346;158;188;429;810;1
489610;Chicken Assassin: Reloaded;Action;0 - 20,000;774;57;717;230;230;1
489630;Warhammer 40,000: Gladius - Relics of War;Free to Play, Indie, Simulation;200,000 - 500,000;5525;1381;4144;1346;536;590
489660;Fabric;Action, Casual, Indie;20,000 - 50,000;108;16;92;0;0;0
489700;Battle Forever;Adventure, Indie, Simulation;0 - 20,000;13;15;-2;272;272;0
489720;Conga Master;Adventure, Indie;0 - 20,000;61;6;55;0;0;0
489730;Run The Gamut;Simulation;0 - 20,000;1;3;-2;0;0;0
489740;Playthings: VR Music Vacation;Action, Indie;;;;0;;;
489760;Demon Truck;Action, Adventure, Casual, Indie;0 - 20,000;35;7;28;0;0;0
489810;BlockAid;Action, Adventure, Indie, RPG, Early Access;0 - 20,000;5;1;4;0;0;0
489830;The Elder Scrolls V: Skyrim Special Edition;Casual, Simulation;5,000,000 - 10,000,000;223274;20718;202556;3361;1090;32016
489900;Bayla Bunny;Action, Adventure, Casual, Indie, Strategy;50,000 - 100,000;60;70;-10;347;358;0
489930;Adventures of Bertram Fiddle 2: A Bleaker Predicklement;Action, Adventure, Indie;20,000 - 50,000;132;40;92;0;0;0
489940;BATTALION 1944;Indie, Sports;500,000 - 1,000,000;9893;6725;3168;1157;667;11
490040;Child of the Wind;Adventure, Indie;0 - 20,000;15;2;13;0;0;0
490080;Lock's Quest;Strategy;20,000 - 50,000;41;55;-14;426;426;0
490100;Quell Zen;Action, Adventure, Indie;0 - 20,000;50;0;50;0;0;0
490160;Time Tenshi 2;Adventure, Casual, Simulation;0 - 20,000;39;7;32;0;0;0
490170;Mind OVR Matter;Action, Indie, RPG, Strategy;0 - 20,000;16;2;14;0;0;0
490220;Prismata;Action, Casual, Indie, Sports, Early Access;1,000,000 - 2,000,000;932;196;736;519;428;6
490230;SWARMRIDERS;Adventure, Indie, RPG;100,000 - 200,000;402;47;355;1;1;0
490250;Locomancer;Action, Indie;0 - 20,000;53;10;43;30;30;1
490280;Realms of Magic;Action, Indie;20,000 - 50,000;620;133;487;1707;1707;10
490360;Hermodr;Adventure, Indie;0 - 20,000;0;0;0;0;0;0
490370;Imperium Galactica II;Action, Indie;100,000 - 200,000;401;61;340;0;0;17
490380;Flight 787 - Advanced;Action, Adventure, Indie, RPG;0 - 20,000;17;29;-12;0;0;0
490380;Flight 787 - Advanced;Indie, Strategy;0 - 20,000;17;29;-12;0;0;0
490390;神明的一天世界(God's One Day World);Indie;0 - 20,000;612;103;509;421;421;1
490430;Octamari Rescue;Adventure, Indie;0 - 20,000;1;0;1;0;0;0
490450;Tokyo 42;Action, Adventure, Casual, Indie, RPG;50,000 - 100,000;427;184;243;190;134;1
490490;Blasters of the Universe;Adventure, Indie;0 - 20,000;202;32;170;10;10;0
490490;Blasters of the Universe;Casual, Indie, Simulation, Sports;0 - 20,000;202;32;170;10;10;0
490510;Pixel Puzzles 2: Christmas;Simulation, Strategy;20,000 - 50,000;55;5;50;348;395;3
490690;The Barbarian and the Subterranean Caves;Action;0 - 20,000;46;14;32;0;0;0
490820;Fly O'Clock;Free to Play;200,000 - 500,000;456;85;371;185;235;0
490840;Gnomes & Goblins (preview);Action, Indie;100,000 - 200,000;482;30;452;0;0;0
490860;DashBored;Action, Free to Play, Indie;50,000 - 100,000;195;57;138;622;1232;2
490870;Weird Hero;Casual, Indie, Strategy;20,000 - 50,000;123;52;71;152;206;0
490880;Robot Legions Reborn;Action, Adventure, Indie, RPG;20,000 - 50,000;40;10;30;271;271;0
490910;Control Craft 3;Action, RPG;50,000 - 100,000;151;49;102;265;266;8
490920;Wolfpack;Action, Adventure, Indie;50,000 - 100,000;1392;133;1259;957;957;37
490930;Need to Know;Indie;20,000 - 50,000;179;87;92;137;137;0
490950;Frost;Action, Casual, Indie;0 - 20,000;126;13;113;0;0;1
490980;Daily Chthonicle: Editor's Edition;Indie, RPG, Strategy;200,000 - 500,000;101;35;66;241;295;2
490990;Aiball;Indie, Early Access;50,000 - 100,000;75;69;6;0;0;1
491000;Gravity Cat;Action, Indie, Strategy;50,000 - 100,000;379;94;285;264;285;0
491010;IN-VERT: Definitive Edition;Action, Indie;20,000 - 50,000;66;15;51;236;236;0
491020;Revenge of the Spirit: Rite of Resurrection;Adventure;0 - 20,000;4;8;-4;0;0;0
491040;Bot Vice;Indie, Simulation, Strategy;100,000 - 200,000;1149;74;1075;511;511;3
491060;League of Evil;Action, Indie, Early Access;20,000 - 50,000;46;11;35;0;0;0
491070;Shout Of Survival;Casual, Sports;0 - 20,000;3;2;1;0;0;0
491090;Ant Queen;Action;0 - 20,000;156;94;62;0;0;4
491100;Human, we have a problem;Violent, Gore, Action;0 - 20,000;8;1;7;0;0;0
491110;Duckie Dash;Simulation, Strategy;0 - 20,000;12;2;10;0;0;0
491130;Red Trigger;Adventure, Casual, Free to Play, RPG, Simulation, Strategy;200,000 - 500,000;1825;198;1627;57;42;0
491160;GemBreak;Indie, Strategy;0 - 20,000;86;26;60;218;218;0
491180;Discrepant;Casual, Early Access;0 - 20,000;10;9;1;0;0;0
491210;LUMBERMANCER;Action, Indie;0 - 20,000;34;6;28;0;0;0
491220;Mr. Pumpkin Adventure;Animation & Modeling, Design & Illustration, Education, Utilities;0 - 20,000;203;29;174;0;0;0
491240;Lil Big Invasion;Adventure;0 - 20,000;27;1;26;154;226;0
491260;Take Thy Throne;Action, RPG, Early Access;50,000 - 100,000;135;92;43;252;229;0
491280;Drift Horizon Online;Indie, Racing, Simulation;100,000 - 200,000;388;343;45;237;221;1
491330;12 Labours of Hercules V: Kids of Hellas (Platinum Edition);Racing;20,000 - 50,000;336;36;300;1023;1063;2
491350;Way of the Red;Action, Adventure, Casual, Indie;0 - 20,000;30;3;27;0;0;0
491380;SteamVR Driver for Razer Hydra;Adventure;0 - 20,000;3;0;3;0;0;0
491390;Alchemist Penguin;Casual, Indie, Sports;0 - 20,000;10;0;10;0;0;0
491420;the 9th day:第九日;Action, Casual, Indie;0 - 20,000;291;23;268;0;0;0
491440;Grim Dragons;Action, Indie;0 - 20,000;18;7;11;0;0;0
491470;PRINCIPIA: Master of Science;Action, Casual, Indie;20,000 - 50,000;197;78;119;0;0;2
491510;Vanilla Bagel: The Roguelike;Action, Adventure, Indie;0 - 20,000;25;12;13;0;0;0
491510;Vanilla Bagel: The Roguelike;Adventure, Casual, Indie;0 - 20,000;25;12;13;0;0;0
491520;Zero-G VR;Adventure, Casual, Indie;0 - 20,000;98;42;56;0;0;0
491520;Zero-G VR;Adventure, Indie, RPG;0 - 20,000;98;42;56;0;0;0
491530;Notruf 112 | Emergency Call 112;Casual, Indie, RPG;200,000 - 500,000;2709;915;1794;1384;1381;46
491560;Momonga Pinball Adventures;Action, Indie, Simulation;0 - 20,000;20;25;-5;0;0;0
491580;Mahjong Destiny;Indie, Sports;50,000 - 100,000;63;50;13;299;323;0
491620;Beeftacular;Free to Play, Indie;20,000 - 50,000;75;19;56;122;122;0
491650;Reset 1-1;Action, Indie;100,000 - 200,000;152;81;71;245;244;0
491660;Assault on the Necrospire;Action;0 - 20,000;20;9;11;0;0;0
491670;Stratego - Single Player;Simulation, Strategy;20,000 - 50,000;41;10;31;0;0;4
491700;Gotta Go;Action;0 - 20,000;22;5;17;0;0;0
491710;Gun Range VR;Casual;0 - 20,000;3;11;-8;0;0;0
491720;Nary;Action;50,000 - 100,000;40;8;32;212;219;1
491770;Deformers;Indie;50,000 - 100,000;55;122;-67;1;1;0
491800;Across The Line;Casual, Indie, Simulation, Early Access;0 - 20,000;12;11;1;0;0;0
491950;Orwell: Keeping an Eye On You;Indie, Simulation, Sports, Strategy, Early Access;1,000,000 - 2,000,000;12691;1238;11453;328;247;22
492080;Vision of Aurora Borealis;Casual;0 - 20,000;32;9;23;0;0;0
492090;A-Train PC Classic;Adventure, Indie;0 - 20,000;87;21;66;0;0;43
492100;Lord of Djinn;Action, Adventure, Casual, Indie;0 - 20,000;0;0;0;0;0;0
492150;RPG World - Action RPG Maker;Action, Sports, Early Access;20,000 - 50,000;381;164;217;27;37;0
492160;3D Pool;Adventure, Indie, RPG;0 - 20,000;27;27;0;10;10;1
492170;Planet Driller;Adventure, Casual, Indie;20,000 - 50,000;45;27;18;302;302;0
492170;Planet Driller;Strategy;20,000 - 50,000;45;27;18;302;302;0
492180;Haimrik;Adventure, Casual, Indie, Simulation;20,000 - 50,000;204;40;164;0;0;1
492200;CapRiders: Euro Soccer;Action, Indie;0 - 20,000;19;0;19;0;0;0
492220;Bohemian Killing;Action, Indie;20,000 - 50,000;127;69;58;141;141;0
492230;Space Hulk: Tactics;Action, Adventure, Indie, Sports, Early Access;20,000 - 50,000;522;271;251;220;281;4
492270;The Cat! Porfirio's Adventure;Adventure, RPG;20,000 - 50,000;262;59;203;167;183;0
492280;The Agency: Chapter 1;Casual, Simulation, Sports;20,000 - 50,000;31;13;18;273;273;0
492290;Has-Been Heroes;Adventure, Indie;50,000 - 100,000;278;89;189;0;0;1
492340;Pixel Cup Soccer 17;Action, Indie, Early Access;0 - 20,000;264;33;231;207;207;1
492370;Affairs of the Court: Choice of Romance;Simulation, Sports;0 - 20,000;51;14;37;0;0;2
492400;Thunder Gun: Revenge of the Mutants;Action, Adventure, Indie, RPG, Simulation, Early Access;0 - 20,000;5;1;4;0;0;0
492410;Rogues Like Us;Adventure;0 - 20,000;47;6;41;237;237;0
492430;Alteric;Adventure;20,000 - 50,000;80;37;43;175;211;0
492490;Zombie Apocalypse: Escape The Undead City;Adventure;0 - 20,000;24;49;-25;0;0;1
492500;Heroes of the Monkey Tavern;Adventure;50,000 - 100,000;262;90;172;0;0;0
492560;Malkia;Violent, Action, Adventure, Indie;0 - 20,000;2;0;2;0;0;0
492600;Ridge;Action, Adventure, Indie, Racing;0 - 20,000;14;12;2;253;261;0
492610;One Day : The Sun Disappeared;Violent, Action, Indie;0 - 20,000;12;21;-9;252;252;0
492610;One Day : The Sun Disappeared;Casual, Indie;0 - 20,000;12;21;-9;252;252;0
492630;Bear With Me - Episode One;Casual, Simulation, Strategy;100,000 - 200,000;809;113;696;129;138;3
492710;VR Ping Pong;Action, Adventure, Indie;0 - 20,000;108;29;79;16;16;0
492720;Tropico 6;Casual, Indie;1,000,000 - 2,000,000;19698;2933;16765;2070;665;1065
492760;Aftercharge;Adventure;100,000 - 200,000;168;55;113;445;445;0
492800;Shonen Idle Z;Casual;100,000 - 200,000;289;247;42;59;106;0
492840;Veterans Online - Open Beta;Indie;100,000 - 200,000;202;115;87;0;0;0
492850;Astroderps;Adventure, Indie;0 - 20,000;7;5;2;0;0;0
492860;Aperion Cyberstorm;Action, Adventure, Casual, Indie, Early Access;0 - 20,000;1;1;0;0;0;0
492870;FIVE: Champions of Canaan;Casual, Indie, Simulation;20,000 - 50,000;47;22;25;66;66;0
493000;Battle Knights;Casual, Simulation, Sports;0 - 20,000;13;3;10;0;0;0
493040;Beat Ninja;Action, Adventure;0 - 20,000;3;5;-2;0;0;0
493060;Ballistic Tanks;Casual, Indie;50,000 - 100,000;194;40;154;71;76;0
493100;BellyBots;Action, Adventure, Indie, RPG;0 - 20,000;33;8;25;0;0;0
493110;KOTH;Action, Casual, Indie;0 - 20,000;13;2;11;0;0;0
493180;Dynasty Feud;Casual, Indie, Strategy;0 - 20,000;66;16;50;0;0;0
493180;Dynasty Feud;Action, Casual, Free to Play, Indie, Simulation, Strategy;0 - 20,000;66;16;50;0;0;0
493200;RiME;Action;200,000 - 500,000;4303;463;3840;289;333;6
493200;RiME;Casual;200,000 - 500,000;4303;463;3840;289;333;6
493220;After the Empire;Adventure, Casual;0 - 20,000;36;11;25;0;0;0
493290;World VR Competition;Adventure, Casual, Indie;0 - 20,000;17;6;11;0;0;0
493310;Requiem: Avenging Angel;Action, Adventure;50,000 - 100,000;66;13;53;20;20;0
493320;Killing Time;Action, Indie, RPG;100,000 - 200,000;54;16;38;0;0;0
493340;Planet Coaster;Action, Indie;1,000,000 - 2,000,000;53168;5160;48008;1394;333;1822
493370;Ragnarok Clicker;RPG;200,000 - 500,000;816;309;507;5181;4077;24
493380;ChessVR;Racing, Simulation, Sports;0 - 20,000;11;4;7;0;0;0
493400;Funfair;Simulation;0 - 20,000;27;8;19;6;6;0
493410;Steampuff: Phinnegan's Factory;Adventure, Casual, Indie, Simulation;0 - 20,000;19;5;14;0;0;0
493430;Nanome;Action, Adventure, Massively Multiplayer;0 - 20,000;20;3;17;0;0;0
493450;Wild Romance;Casual;20,000 - 50,000;66;57;9;2;2;0
493480;ERISLE;Design & Illustration;0 - 20,000;11;11;0;0;0;0
493490;City Car Driving;Web Publishing;500,000 - 1,000,000;16129;3612;12517;3255;404;669
493500;Bank Limit : Advanced Battle Racing;Sports;0 - 20,000;1;8;-7;0;0;0
493520;GTFO;Action, Indie;1,000,000 - 2,000,000;39479;6910;32569;1501;416;710
493540;Figment;Action, Casual, Sports;100,000 - 200,000;1375;216;1159;133;138;6
493580;Hidden Object - 12 in 1 bundle;Casual, Indie, Strategy;20,000 - 50,000;77;65;12;0;0;4
493620;VR Disc Golf;Action, Free to Play, Indie, Strategy;0 - 20,000;11;3;8;0;0;0
493650;Deep Space Dash;Action, Indie, Strategy, Early Access;200,000 - 500,000;100;234;-134;219;212;0
493670;Valkyrius Prime;RPG;0 - 20,000;9;0;9;0;0;0
493700;Monster Puzzle;Action, Indie;100,000 - 200,000;92;70;22;234;225;0
493710;Laraan;Adventure;100,000 - 200,000;125;135;-10;210;212;0
493770;Awakened;Action, Indie;0 - 20,000;5;9;-4;0;0;0
493780;Nightork Adventures - Beyond the Moons of Shadalee;Casual, Indie;50,000 - 100,000;23;29;-6;257;279;0
493790;#Archery;Action, Adventure, Casual, Indie, RPG, Simulation, Early Access;0 - 20,000;18;9;9;0;0;0
493810;Jonah's Path;Action, Indie;20,000 - 50,000;47;22;25;2;2;0
493820;Rivais Em Batalha;Adventure, Indie;0 - 20,000;34;13;21;217;217;26
493840;Marvel vs. Capcom: Infinite;Action, Casual, Indie;100,000 - 200,000;1537;913;624;653;666;14
493900;Dungeons 3;Casual, Indie;500,000 - 1,000,000;16212;948;15264;784;410;202
493920;NeverMine;Animation & Modeling, Video Production, Early Access;0 - 20,000;1;0;1;0;0;0
493980;Green Ranch;Action, Indie;0 - 20,000;28;10;18;19;19;0
494000;Anthelion;Casual;0 - 20,000;5;3;2;0;0;0
494020;Splash Bash;Casual, Indie;0 - 20,000;1;1;0;0;0;0
494040;PuppetsVR;Action, Casual, Indie;0 - 20,000;8;2;6;0;0;0
494050;Road to your City;Action, Adventure, Free to Play, Massively Multiplayer, RPG;0 - 20,000;47;25;22;0;0;0
494090;Dungeon Girl;Adventure, Casual, Indie;20,000 - 50,000;23;17;6;0;0;0
494100;ENIGMA:;Action, Adventure, Casual, Indie;0 - 20,000;112;3;109;918;918;0
494120;RX squad;Adventure, Casual, Indie;20,000 - 50,000;18;9;9;180;237;0
494150;The Thrill of the Fight - VR Boxing;Action, Adventure, Casual, Indie, Simulation;100,000 - 200,000;3211;152;3059;151;143;20
494160;Lionheart;Adventure, Casual;0 - 20,000;11;6;5;0;0;0
494170;Miniature Garden;Action, Indie;0 - 20,000;54;15;39;0;0;0
494230;Heart's Medicine - Time to Heal;Action, Early Access;20,000 - 50,000;781;49;732;157;157;3
494240;Pengame;Indie;0 - 20,000;0;0;0;0;0;0
494290;MiDZone;Adventure, Casual, Indie;20,000 - 50,000;28;40;-12;238;238;0
494310;Unbreakable Vr Runner;Action, Racing;0 - 20,000;55;1;54;0;0;0
494320;Wizrogue - Labyrinth of Wizardry;Casual, Simulation;0 - 20,000;98;65;33;328;328;0
494350;Bowl VR;Adventure, Casual;0 - 20,000;7;11;-4;0;0;0
494360;Barrow Hill: Curse of the Ancient Circle;Action, Indie;20,000 - 50,000;120;24;96;1544;1544;1
494370;Orbital Strike: Arena;Action, Indie, Simulation, Strategy, Early Access;0 - 20,000;19;5;14;0;0;0
494380;VR Boxing Workout;Indie, Sports, Early Access;0 - 20,000;2;8;-6;0;0;0
494430;Praey for the Gods;Adventure, Casual;100,000 - 200,000;1990;375;1615;207;274;3
494440;The Amazing Shinsengumi: Heroes in Love;Action, Indie, RPG;0 - 20,000;59;42;17;0;0;0
494450;Office lovers;Indie, Simulation, Strategy;0 - 20,000;51;61;-10;0;0;0
494460;Dangerous Relationship;Action, Adventure, Indie;0 - 20,000;39;39;0;0;0;0
494470;My Butler;Action, Adventure, Casual, Indie;0 - 20,000;44;39;5;0;0;0
494530;Orc Hunter VR;Adventure, Indie, RPG;0 - 20,000;9;13;-4;0;0;0
494580;STANDBY;Adventure;20,000 - 50,000;159;56;103;171;188;6
494600;EARTH'S DAWN;Racing, Simulation, Sports;20,000 - 50,000;169;57;112;0;0;1
494670;TransRoad: USA;Casual, Free to Play, Indie, Simulation, Strategy;20,000 - 50,000;193;184;9;151;151;4
494700;Eliosi's Hunt;Action, Indie;0 - 20,000;49;18;31;101;101;0
494720;Morphblade;Adventure, Indie;100,000 - 200,000;482;44;438;28;32;2
494740;Police Quest Collection;Adventure, Indie, Early Access;50,000 - 100,000;83;27;56;4;4;6
494780;MageWorks;Animation & Modeling, Design & Illustration, Utilities;0 - 20,000;9;7;2;0;0;0
494790;Captain Curve's Intergalactic Space Adventure;Indie, Simulation, Strategy;0 - 20,000;1;0;1;0;0;0
494810;VR: Vacate the Room (Virtual Reality Escape);Adventure, Casual, Indie, Strategy;50,000 - 100,000;206;36;170;36;36;0
494820;Acid Flip;Design & Illustration, Utilities;20,000 - 50,000;2;0;2;0;0;0
494820;Acid Flip;Adventure, Casual, Indie, Simulation, Strategy;20,000 - 50,000;2;0;2;0;0;0
494830;ViveSpray;Action, Adventure, Indie, RPG, Simulation, Strategy, Early Access;0 - 20,000;50;26;24;0;0;0
494840;UBOAT;Indie, Early Access;200,000 - 500,000;12057;2789;9268;1615;1934;787
494850;VeeR Pong;Casual, Indie, Strategy;0 - 20,000;2;2;0;0;0;0
494960;Twisted Arrow;Action, Indie;0 - 20,000;80;9;71;0;0;0
494970;Savana;Action, Indie;0 - 20,000;3;2;1;0;0;0
494980;Wondership Q;Action, Adventure, Casual, Indie;0 - 20,000;6;8;-2;0;0;0
494990;Too Angry to Space;Casual, Indie;0 - 20,000;39;16;23;0;0;0
495010;Ranger of the jungle;Action, Indie;0 - 20,000;18;29;-11;0;0;0
495030;VR Battle Grid;Indie, Simulation;20,000 - 50,000;57;6;51;11;11;0
495050;Mega Man Legacy Collection 2;Indie;50,000 - 100,000;921;133;788;743;1332;23
495090;Evolution Planet: Gold Edition;Action, Indie;20,000 - 50,000;39;13;26;0;0;0
495110;Enigmatis 3: The Shadow of Karkhala;Nudity, Violent, Gore, Action, Adventure, Indie, Early Access;50,000 - 100,000;758;58;700;582;780;2
495140;NARUTO: Ultimate Ninja STORM;Adventure, Casual, Indie;200,000 - 500,000;3745;1240;2505;418;246;68
495200;DATH;Casual, Indie, Strategy;0 - 20,000;2;3;-1;0;0;0
495230;Hypnorain;Adventure, Casual, Indie;0 - 20,000;11;7;4;0;0;0
495280;Disgaea 2 PC;Adventure, Indie, Strategy;100,000 - 200,000;1255;120;1135;1058;2078;66
495290;AccuRC 2;Casual, Indie, Simulation;20,000 - 50,000;379;44;335;0;0;24
495300;TrumPiñata;Indie, Simulation;0 - 20,000;12;11;1;0;0;0
495320;Ancient VR coaster;Adventure;0 - 20,000;13;11;2;0;0;0
495390;The Wire Loop Game VR;Casual, Indie, Simulation, Sports;0 - 20,000;7;3;4;0;0;0
495420;State of Decay 2: Juggernaut Edition;Action;1,000,000 - 2,000,000;34569;7545;27024;1868;963;2140
495480;Visual Novel Maker;Adventure, Indie, Early Access;20,000 - 50,000;257;131;126;2;2;19
495520;Ping Pong League;Casual, Indie, Strategy;20,000 - 50,000;73;44;29;102;102;1
495540;Dashy Square VR;Action, Adventure, Casual, Indie;0 - 20,000;1;3;-2;0;0;0
495550;Baskhead;Adventure, Indie;0 - 20,000;5;0;5;0;0;0
495560;Farm Manager 2018;Audio Production;100,000 - 200,000;1872;741;1131;580;773;30
495570;ConflictCraft;Adventure, Casual, Indie;100,000 - 200,000;498;103;395;360;453;0
495580;Divided We Fall: Play For Free;Adventure, Indie, RPG;50,000 - 100,000;128;106;22;29;31;1
495600;Asteroid Fight;Action, Casual, Indie, Simulation;0 - 20,000;13;8;5;0;0;0
495680;Overdriven Reloaded;Action, Casual, Indie;0 - 20,000;28;4;24;0;0;0
495700;Gabriel Knight: Sins of the Father;Action, Casual, Indie, Strategy;20,000 - 50,000;118;16;102;145;145;1
495720;Intrude;Action, Adventure, Casual, Indie;50,000 - 100,000;157;34;123;0;0;1
495730;Ghost Train VR;Action, Adventure, Indie, Strategy;0 - 20,000;2;8;-6;0;0;0
495750;Reckpunk;Adventure, Casual;0 - 20,000;21;4;17;0;0;0
495760;Deios II // DEIDIA;Casual, Indie;0 - 20,000;12;3;9;0;0;0
495770;Free Balling;Casual, Indie;0 - 20,000;0;1;-1;0;0;0
495780;Hexoscope;Action, Indie;50,000 - 100,000;189;24;165;254;219;1
495820;Lil Tanks;Action, Adventure, Indie;0 - 20,000;19;4;15;0;0;0
495830;Endless Labyrinth;Indie;0 - 20,000;16;4;12;0;0;0
495890;Montaro;Action, Adventure, Casual, Indie, Sports;200,000 - 500,000;11560;566;10994;167;160;6
495900;Lance A Lot: Classic Edition;Audio Production, Utilities;0 - 20,000;52;8;44;0;0;0
495910;Dungeon Fighter Online;Racing, Simulation;500,000 - 1,000,000;3088;1854;1234;376;184;211
495960;The Secret Monster Society;Action, Casual, Indie;20,000 - 50,000;24;14;10;331;331;0
495980;Selma and the Wisp;RPG;0 - 20,000;114;47;67;0;0;1
495990;True Love ～Confide to the Maple～;Casual, Simulation;20,000 - 50,000;1198;209;989;135;135;1
496000;BowMage;Action, Indie, Massively Multiplayer, Early Access;0 - 20,000;4;3;1;0;0;0
496030;Dark Parables: The Swan Princess and The Dire Tree Collector's Edition;Casual, Indie;0 - 20,000;16;4;12;0;0;0
496040;Shaq Fu: A Legend Reborn;Action, Adventure, Indie;0 - 20,000;99;30;69;0;0;1
496070;Geo-Fall;Design & Illustration, Education, Photo Editing, Software Training;0 - 20,000;2;0;2;0;0;0
496080;Space, VR!;Adventure, Casual, Indie;0 - 20,000;2;2;0;0;0;0
496120;LaserCat;Adventure;20,000 - 50,000;78;5;73;415;278;2
496160;Return Zero VR;Casual, Indie;0 - 20,000;0;1;-1;0;0;0
496180;GE Neuro;Adventure, Indie;;;;0;;;
496190;Senza Peso;Casual, Simulation;;;;0;;;
496230;Watching Grass Grow In VR - The Game;Indie, Simulation;0 - 20,000;7;4;3;0;0;0
496240;Onward;Action, Adventure, Casual;500,000 - 1,000,000;5926;2542;3384;592;312;95
496260;Corona Blossom Vol.1 Gift From the Galaxy;Casual, Indie;20,000 - 50,000;271;11;260;303;303;0
496290;Deep Dark Dungeon;Adventure, RPG;0 - 20,000;30;20;10;0;0;0
496300;Kingdom: New Lands;Casual, Indie, RPG, Strategy;1,000,000 - 2,000,000;8459;1301;7158;394;262;84
496310;Momento Temporis: Light from the Deep;Casual, Indie, Sports;0 - 20,000;36;11;25;0;0;0
496320;Running Gods;Action, Casual, Indie;20,000 - 50,000;19;6;13;242;242;0
496340;Fighting Fantasy Legends;Action, Strategy;20,000 - 50,000;109;57;52;480;480;1
496350;Supipara - Chapter 1 Spring Has Come!;Indie, RPG;0 - 20,000;226;3;223;182;182;0
496360;RC Racing Off Road 2.0;Casual, Strategy;0 - 20,000;0;5;-5;0;0;0
496380;A Verdant Hue;Adventure, Casual;0 - 20,000;3;3;0;0;0;0
496390;Shiny;Action, Adventure, Casual, Indie;0 - 20,000;30;32;-2;54;55;0
496390;Shiny;Adventure, Casual, Free to Play, Indie;0 - 20,000;30;32;-2;54;55;0
496400;Renoir;Action, Indie;20,000 - 50,000;62;61;1;0;0;2
496440;The Challenge;Casual, Indie;100,000 - 200,000;23;39;-16;302;302;0
496460;Life is Feudal: Forest Village;Casual, Indie, Simulation, Sports;200,000 - 500,000;3622;1866;1756;2171;2406;145
496480;Vex;Action, Adventure, Indie;0 - 20,000;15;7;8;0;0;0
496490;Virtual Battlemap;Simulation;0 - 20,000;48;44;4;0;0;0
496510;M.EXE;Adventure;0 - 20,000;25;9;16;0;0;0
496530;Pigmentone;Adventure, Indie;0 - 20,000;32;13;19;194;194;0
496540;Zone of Lacryma;Adventure;0 - 20,000;24;5;19;0;0;0
496550;Noob Squad;Adventure, Indie, RPG, Strategy;50,000 - 100,000;214;276;-62;132;106;0
496590;Crystal Cosmos;Free to Play;0 - 20,000;27;10;17;212;212;0
496610;Push The Crate: Remastered Edition;Indie, Simulation, Strategy;0 - 20,000;2;3;-1;0;0;0
496620;Monster Slayers;Action, Adventure, Free to Play, Indie, Massively Multiplayer, RPG;100,000 - 200,000;906;234;672;437;555;7
496630;Empty Horizons;Casual, Indie, Strategy, Early Access;20,000 - 50,000;74;11;63;0;0;0
496630;Empty Horizons;Action, Adventure, Free to Play, Massively Multiplayer, RPG, Strategy;20,000 - 50,000;74;11;63;0;0;0
496640;Strange Night;;100,000 - 200,000;228;132;96;265;276;3
496650;Antihorror;Action, Indie, Early Access;50,000 - 100,000;140;45;95;204;216;0
496660;Minotaur;Casual;0 - 20,000;14;14;0;270;270;0
496670;Maze Roller;Casual;0 - 20,000;6;4;2;0;0;0
496680;SweatShop;Adventure, Casual;500,000 - 1,000,000;194;226;-32;214;215;5
496690;Adventures On The Polluted Islands;Action, Casual, Indie;50,000 - 100,000;88;36;52;247;271;0
496730;Sorcerer King: Rivals;Adventure;50,000 - 100,000;229;137;92;5;5;5
496740;Discovering Space 2;Adventure, Indie, Simulation;0 - 20,000;63;24;39;0;0;0
496750;The Housewife;Adventure, Indie, RPG;200,000 - 500,000;103;157;-54;257;250;1
496760;The Beast Within: A Gabriel Knight Mystery;Casual, Indie;20,000 - 50,000;178;17;161;421;421;2
496790;Nothin' But Net;Adventure, Indie;0 - 20,000;5;2;3;0;0;0
496810;MegaTagmension Blanc + Neptune VS Zombies (Neptunia);Action, Adventure, Indie, RPG, Early Access;100,000 - 200,000;1195;163;1032;182;190;2
496820;Ruction: The Golden Tablet;Casual, Indie;0 - 20,000;4;5;-1;0;0;0
496850;Brick Battalion;Casual, Indie, Sports;0 - 20,000;11;2;9;0;0;0
496890;Replica;Action, Indie;100,000 - 200,000;2800;431;2369;134;132;6
496910;DrumKit VR - Play drum kit in the world of VR;Adventure, Indie, Strategy, Early Access;0 - 20,000;7;14;-7;0;0;0
496930;Sumeru;Indie;0 - 20,000;123;37;86;4;4;0
496940;Second Death;Violent, Action, Adventure, Indie, Simulation, Strategy;0 - 20,000;3;0;3;0;0;0
496950;The Slingshot VR;Action, Casual, Indie;0 - 20,000;9;13;-4;0;0;0
496960;Shoot Mania VR: Fun Zombies;Action, Adventure, Indie, RPG;0 - 20,000;14;9;5;0;0;0
496980;Cosmic Cavern 3671　　宇宙最大の地底最大の作戦;RPG;0 - 20,000;12;5;7;3;3;0
496990;Ghost Sweeper;Indie, RPG, Strategy;0 - 20,000;28;3;25;0;0;0
497000;Cross Death  VR;Racing, Simulation;0 - 20,000;4;4;0;0;0;0
497020;Mystic Diary - Hidden Object;Action, Adventure, Indie;0 - 20,000;21;21;0;262;295;0
497040;Underground Keeper;Adventure, Casual, Free to Play, Indie, Simulation;0 - 20,000;37;15;22;0;0;0
497050;Shape Shifter;Adventure, Indie;50,000 - 100,000;76;74;2;217;223;0
497060;Rise;Action, Adventure, Early Access;0 - 20,000;2;5;-3;0;0;0
497090;Amihailu in Dreamland;Casual, Indie, Sports;0 - 20,000;19;7;12;0;0;0
497100;FootRock;Adventure, Indie;50,000 - 100,000;66;27;39;277;273;0
497150;DJ Streamer;Action, Adventure, Indie, RPG, Early Access;0 - 20,000;16;10;6;0;0;0
497160;Voice Again;Adventure, Casual, Free to Play, Indie, Simulation;0 - 20,000;1;0;1;0;0;0
497180;Street Legal Racing: Redline v2.3.1;Action, Casual, Indie, Strategy;200,000 - 500,000;2952;434;2518;2696;2715;74
497190;Pichon;Action, Indie, Sports;0 - 20,000;44;6;38;240;272;0
497260;Fabulous Food Truck;Action, Adventure, Indie;20,000 - 50,000;65;64;1;291;301;0
497270;MIGHT;Violent, Gore, Action, Indie;0 - 20,000;22;15;7;0;0;0
497280;Wrong Dimension - The One Dimensional Platformer;Casual, Indie, Strategy;0 - 20,000;2;1;1;0;0;0
497300;Always Higher;Action, Massively Multiplayer, Simulation;0 - 20,000;5;5;0;0;0;0
497310;PD Particles 9;Action, Casual, Indie, Sports;0 - 20,000;7;1;6;0;0;0
497360;Gabriel Knight 3: Blood of the Sacred, Blood of the Damned;Action;50,000 - 100,000;49;40;9;506;506;1
497380;Rise;Indie, Simulation, Sports, Strategy;0 - 20,000;0;0;0;0;0;0
497400;1 Moment Of Time: Silentville;Adventure, Casual;100,000 - 200,000;505;146;359;266;277;1
497420;Pixelscape: Oceans;Adventure, Casual;0 - 20,000;35;8;27;0;0;0
497430;G Prime;Adventure, Casual;0 - 20,000;8;5;3;0;0;0
497440;HOMEBOUND;Casual, Indie;20,000 - 50,000;49;63;-14;0;0;0
497440;HOMEBOUND;Violent, Action, Racing;20,000 - 50,000;49;63;-14;0;0;0
497450;Blortasia;Action, Indie, Early Access;20,000 - 50,000;49;6;43;0;0;0
497460;Mervils: A VR Adventure;Casual, Indie, Strategy;0 - 20,000;59;8;51;0;0;0
497470;D.N.Age;Action, Adventure, Indie;0 - 20,000;28;31;-3;119;119;1
497480;GravPool;Casual, Indie, Strategy;0 - 20,000;1;0;1;0;0;0
497490;Project Hovercraft;Indie;0 - 20,000;2;5;-3;0;0;0
497510;Crystal Quest Classic;Action;0 - 20,000;24;5;19;0;0;0
497560;Crimson Sword Saga: The Peloran Wars;Casual, Indie;20,000 - 50,000;12;8;4;248;277;0
497570;Building the Great Wall of China 2;Casual, Indie;0 - 20,000;14;3;11;0;0;0
497580;Agent Walker: Secret Journey;;20,000 - 50,000;152;73;79;0;0;1
497590;Sapper's bad dream;Action, Adventure, Casual, Indie;100,000 - 200,000;15;16;-1;219;212;0
497640;Trick & Treat;Action, Adventure, Casual;200,000 - 500,000;2088;78;2010;51;52;2
497670;Line/Dash;Adventure;0 - 20,000;26;7;19;231;231;1
497680;Plates;Adventure, Indie;0 - 20,000;37;10;27;0;0;0
497700;Safety First!;Casual, Indie, Strategy;0 - 20,000;265;62;203;34;49;1
497710;Holobunnies: Pause Cafe;Action, Indie;0 - 20,000;11;9;2;0;0;0
497720;Funfair Ride Simulator 3;Action, Casual, Indie, Simulation;20,000 - 50,000;59;56;3;0;0;0
497720;Funfair Ride Simulator 3;Action, Adventure, Casual, Simulation;20,000 - 50,000;59;56;3;0;0;0
497780;Recursed;Indie, Simulation, Strategy;20,000 - 50,000;407;9;398;26;26;2
497790;Ayumi: Enhanced Edition;Adventure, Indie, Early Access;0 - 20,000;11;0;11;0;0;0
497800;Golden Krone Hotel;Action, Indie;20,000 - 50,000;261;12;249;118;118;2
497820;Quanero VR;Indie;50,000 - 100,000;309;33;276;11;16;0
497850;8-Bit Hordes;Adventure, Indie;50,000 - 100,000;399;98;301;734;354;3
497860;Zezenia Online;Indie, Strategy;50,000 - 100,000;195;93;102;49;49;6
497870;Super Sketch Bob;Action, Adventure, Indie, RPG;0 - 20,000;2;0;2;0;0;0
497880;Doodle WHAT?!;Action, Indie, Early Access;0 - 20,000;8;8;0;0;0;0
497940;Destiny of Ancient Kingdoms;Adventure, Casual, Indie;50,000 - 100,000;89;85;4;104;168;0
497960;Legends of Callasia Demo;Action, Adventure, Casual, Racing, Simulation, Sports;0 - 20,000;0;0;0;0;0;0
498000;Mushroom Crusher Extreme;Action, Indie;0 - 20,000;11;2;9;0;0;0
498030;Barnyard Mahjong 3;Casual, Indie;50,000 - 100,000;71;46;25;244;355;2
498040;The Hidden Dragon;Adventure, Casual, Free to Play;20,000 - 50,000;42;56;-14;182;206;0
498050;Mystery Of Rivenhallows;Simulation;20,000 - 50,000;47;71;-24;253;277;0
498190;Dragon Rage;Action, Adventure, Casual, Indie, RPG;20,000 - 50,000;129;39;90;0;0;0
498240;Batman - The Telltale Series;Strategy;500,000 - 1,000,000;10713;2022;8691;447;526;61
498280;Jurassic Survival;Casual, Strategy;0 - 20,000;11;30;-19;26;26;0
498300;Of Love And Sorrow;Action, Indie;0 - 20,000;9;10;-1;0;0;0
498310;RPG in a Box;Adventure, Indie;0 - 20,000;160;13;147;0;0;14
498320;Trolley Gold;Action, Indie;200,000 - 500,000;66;172;-106;226;227;1
498330;Cats are Liquid - A Light in the Shadows;Action, Adventure, Indie, Early Access;20,000 - 50,000;574;46;528;507;507;0
498360;Puzzle Nebula;Action, Casual, Free to Play, Indie, Sports;20,000 - 50,000;3;1;2;0;0;0
498370;Basketball Court VR;Free to Play, Indie;0 - 20,000;0;3;-3;0;0;0
498450;A Week of Circus Terror;Action, Indie, Early Access;0 - 20,000;19;15;4;0;0;0
498460;Abduction Prologue: The Story Of Jonathan Blake;Action, Adventure, Indie;0 - 20,000;1;10;-9;0;0;0
498470;Switch 'N' Shoot;Animation & Modeling, Education, Early Access;0 - 20,000;116;4;112;0;0;0
498500;I Am The Hero;Action, Indie, Simulation, Sports, Early Access;50,000 - 100,000;445;94;351;0;0;0
498510;DreamLand;Utilities, Video Production;0 - 20,000;38;27;11;6;6;0
498550;Depths of Dread;Adventure;0 - 20,000;7;7;0;0;0;0
498570;Extreme Forklifting 2;Casual;0 - 20,000;167;29;138;0;0;0
498580;ASRECorp;Casual;0 - 20,000;26;10;16;0;0;0
498600;MSI Electric City;Casual;50,000 - 100,000;95;34;61;0;0;0
498620;The Shadowland;Simulation, Sports;20,000 - 50,000;32;22;10;202;202;48
498630;Red Planet: Survive;Action, Indie;0 - 20,000;8;41;-33;0;0;0
498660;Mind Spheres;Action, Indie, Racing, Simulation, Sports, Strategy;200,000 - 500,000;540;159;381;200;209;2
498680;In The Shadow Of The Truth;Indie, Strategy;0 - 20,000;11;5;6;0;0;0
498700;The Ember Saga: A New Fire;Action, Adventure, Indie, Massively Multiplayer, RPG;20,000 - 50,000;9;8;1;386;396;0
498710;After Dreams;Indie, Racing, Simulation, Sports, Early Access;20,000 - 50,000;149;51;98;0;0;0
498720;Inklings;Action, Casual, Indie;0 - 20,000;8;2;6;0;0;0
498740;Way of Redemption;Action, Indie;0 - 20,000;33;13;20;5;5;0
498830;Mustache in Hell;RPG;0 - 20,000;61;8;53;165;271;0
498830;Mustache in Hell;Casual, Indie;0 - 20,000;61;8;53;165;271;0
498850;Ortus Arena, strategy board game online, FOR FREE;Casual, Indie, Early Access;0 - 20,000;27;15;12;1;2;0
498940;WarBirds Dawn of Aces, World War I Air Combat;Adventure, Casual, Indie, Strategy, Early Access;0 - 20,000;6;5;1;0;0;0
498980;DUO;Action, Casual, Indie;0 - 20,000;26;9;17;0;0;1
498990;Balloon Chair Death Match;Action, Adventure, Strategy;0 - 20,000;40;14;26;0;0;0
499070;Pro Strategy Football 2016;Action, Indie, Racing;0 - 20,000;11;3;8;0;0;0
499100;Dark Parables: The Exiled Prince Collector's Edition;Adventure, Indie, RPG, Strategy;20,000 - 50,000;46;7;39;0;0;1
499110;Dark Parables: Rise of the Snow Queen Collector's Edition;Casual, Free to Play;20,000 - 50,000;30;2;28;0;0;2
499120;Dark Parables: The Red Riding Hood Sisters Collector's Edition;Action, Adventure;20,000 - 50,000;27;5;22;0;0;1
499140;Operator Overload;Simulation;0 - 20,000;19;2;17;0;0;0
499210;Road Rage;Indie, Simulation;0 - 20,000;20;36;-16;27;27;0
499210;Road Rage;Action, Indie, Simulation, Sports;0 - 20,000;20;36;-16;27;27;0
499230;SurvHive;Indie;0 - 20,000;52;32;20;8;8;0
499330;Lord Mayor;Action, Adventure, RPG;0 - 20,000;10;7;3;0;0;0
499340;Turner;Simulation, Sports;0 - 20,000;51;4;47;0;0;0
499370;Tower of Archeos;Action, Casual, Indie, Racing, Simulation, Sports;0 - 20,000;42;3;39;0;0;0
499390;Pixeloids;Indie, Strategy, Early Access;0 - 20,000;0;1;-1;0;0;0
499400;The Path of Greatest Resistance;Utilities;0 - 20,000;42;11;31;9;9;0
499420;Star Fields;Adventure, Indie;500,000 - 1,000,000;55;70;-15;239;231;1
499440;klocki;Action, Adventure, Indie, RPG;100,000 - 200,000;4375;135;4240;41;44;1
499450;The Witcher 3: Wild Hunt Game of the Year Edition;Indie, Simulation;0 - 20,000;0;0;0;0;0;0
499460;Tomato Jones;Violent, Gore, Action, Indie;50,000 - 100,000;196;38;158;202;202;0
499510;Dragons Never Cry;Free to Play, Indie;0 - 20,000;8;2;6;0;0;0
499520;The Turing Test;Violent, Action, Adventure, Indie;200,000 - 500,000;6559;927;5632;241;291;10
499540;Wake Up;Casual, Indie, Simulation, Early Access;20,000 - 50,000;74;17;57;15;23;0
499540;Wake Up;Adventure, Indie, Strategy;20,000 - 50,000;74;17;57;15;23;0
499560;Fourtex Jugo;Casual, Indie, Simulation;0 - 20,000;5;5;0;0;0;0
499580;Crystal Control II;Adventure, Casual, Indie, Early Access;0 - 20,000;5;0;5;0;0;0
499610;Copter and Sky;Action, Free to Play, Early Access;0 - 20,000;41;22;19;0;0;0
499660;Medieval Kingdom Wars;Action, Indie;100,000 - 200,000;1948;562;1386;207;240;20
499760;Redswood VR;Strategy;0 - 20,000;21;9;12;0;0;0
499890;Aaero;Sexual Content, Nudity, Violent, Gore, Action, Indie;200,000 - 500,000;708;140;568;161;272;2
499900;Pulse Shift;Nudity, Violent, Gore, Action, Adventure;0 - 20,000;9;5;4;0;0;0
499910;SHINRAI - Broken Beyond Despair;Photo Editing;0 - 20,000;102;9;93;0;0;0
499940;Ascension VR;Animation & Modeling, Audio Production, Design & Illustration, Utilities, Video Production, Web Publishing;0 - 20,000;15;8;7;0;0;0
500090;WyVRn: Dragon Flight VR;Audio Production, Education, Software Training, Utilities, Video Production;0 - 20,000;2;0;2;0;0;0
500110;Glider Island;Audio Production, Design & Illustration, Utilities, Video Production;0 - 20,000;29;5;24;0;0;0
500120;Gazzel Quest, The Five Magic Stones;Photo Editing;0 - 20,000;11;7;4;0;0;0
500140;Wildlife VR;Action, Casual, Massively Multiplayer, Early Access;0 - 20,000;2;3;-1;0;0;0
500150;Time Gap;Action, Adventure, Casual, Indie;50,000 - 100,000;114;51;63;0;0;3
500170;Urlaubsflug Simulator – Holiday Flight Simulator;Adventure, Indie;0 - 20,000;75;60;15;0;0;0
500180;Epic Flail;Action, Casual, Indie, Strategy;0 - 20,000;9;1;8;0;0;0
500190;Firefight;Indie;0 - 20,000;66;15;51;0;0;0
500220;Weather Lord: Legendary Hero Collector's Edition;Adventure, Casual, Indie, Racing;0 - 20,000;13;2;11;0;0;0
500260;Ben and Ed - Blood Party;Action, Indie, RPG, Strategy;100,000 - 200,000;1723;236;1487;193;243;13
500320;A Tale of Caos: Overture;Action, Free to Play, Indie, Racing, Early Access;0 - 20,000;39;16;23;233;233;0
500340;QUACK ATTACK 1985: TURBO DX EDITION;Action, Indie, RPG;0 - 20,000;23;7;16;0;0;0
500350;Final Fleet;Action, Adventure, Indie, RPG;0 - 20,000;8;2;6;0;0;0
500360;VRMultigames;Casual, Indie;20,000 - 50,000;63;19;44;43;43;0
500380;"UNCORPOREAL - ""Fluffy!""";Action, Adventure, Indie;20,000 - 50,000;23;11;12;0;0;0
500420;SoulHunt;Action, Adventure, RPG, Strategy;0 - 20,000;70;17;53;0;0;0
500420;SoulHunt;Adventure;0 - 20,000;70;17;53;0;0;0
500440;Take the Cake;Adventure;0 - 20,000;8;5;3;215;215;0
500470;Emergence ᵠ;Action, Adventure, Casual, Free to Play, Indie, Massively Multiplayer, Early Access;0 - 20,000;38;3;35;0;0;0
500480;Fist of Physics;Action, Adventure, Casual;0 - 20,000;31;10;21;0;0;0
500500;Simple VR Video Player;Adventure, Indie;50,000 - 100,000;240;93;147;288;301;12
500550;Save the Universe, Please!;Casual, Indie;0 - 20,000;7;1;6;0;0;0
500570;Mahjong Deluxe 2: Astral Planes;Adventure, Casual, Indie;20,000 - 50,000;48;46;2;280;305;0
500580;Kitty Cat: Jigsaw Puzzles;Action, Casual, Free to Play, Indie;50,000 - 100,000;214;45;169;302;327;0
500590;Puppy Dog: Jigsaw Puzzles;Indie, RPG;50,000 - 100,000;117;26;91;245;269;0
500660;Limberjack;Casual;0 - 20,000;18;13;5;0;0;0
500670;Tormentor❌Punisher;Strategy;20,000 - 50,000;485;61;424;48;48;0
500680;Jockey Rush;Casual, Indie;0 - 20,000;14;1;13;0;0;0
500680;Jockey Rush;Casual, Indie, RPG, Strategy;0 - 20,000;14;1;13;0;0;0
500690;Secret Santa;Violent, Adventure, Indie;0 - 20,000;71;7;64;0;0;0
500710;Wild Terra Online;Sexual Content, Nudity, Violent, Gore, Action;200,000 - 500,000;1029;666;363;108;61;21
500750;GI Racing 2.0;Sexual Content, Nudity, Action, Indie;0 - 20,000;39;8;31;0;0;1
500760;Kuraburo Kai;Action, Casual, Indie;0 - 20,000;3;5;-2;0;0;0
500790;Moribund;Animation & Modeling, Design & Illustration, Game Development, Early Access;0 - 20,000;18;1;17;0;0;0
500810;Arcanum: Of Steamworks and Magick Obscura;Strategy;200,000 - 500,000;1230;169;1061;579;76;31
500870;Riddles Of The Past;Action, Adventure, Casual, Indie, Strategy;20,000 - 50,000;191;49;142;358;358;0
500880;Tails;Action, Casual, Indie, Strategy;0 - 20,000;8;1;7;0;0;0
500920;House of Alice;Action, Simulation;0 - 20,000;2;1;1;0;0;0
500940;Get The Gems;Action, Simulation;50,000 - 100,000;31;5;26;293;336;0
500980;Endangered;Simulation;50,000 - 100,000;5;8;-3;252;252;0
501020;Super Pixel Racers;Action, Simulation;20,000 - 50,000;81;32;49;0;0;0
501020;Super Pixel Racers;Simulation;20,000 - 50,000;81;32;49;0;0;0
501030;Extravaganza Rising;Animation & Modeling, Design & Illustration, Utilities;50,000 - 100,000;30;14;16;255;255;0
501050;Emerland Solitaire: Endless Journey;Action, Simulation;20,000 - 50,000;75;22;53;0;0;3
501060;C.S.S. CITADEL VR;Indie, Simulation, Strategy;0 - 20,000;0;10;-10;0;0;0
501080;Fishing: Barents Sea;Adventure, Casual, Indie;200,000 - 500,000;1793;484;1309;1793;2426;31
501090;Design it, Drive it : Speedboats;Action, Indie;0 - 20,000;51;11;40;0;0;1
501110;Mount Wingsuit;Action, Free to Play, Massively Multiplayer;0 - 20,000;67;30;37;0;0;0
501120;Clock Simulator;Animation & Modeling, Design & Illustration, Game Development;0 - 20,000;357;46;311;64;64;0
501180;Acan's Call: Act 1;Casual, Indie, Simulation, Early Access;100,000 - 200,000;295;62;233;9;12;0
501190;Axis Football 2016;Casual, Sports;0 - 20,000;92;33;59;0;0;0
501210;Reign of Darkness;Action, Indie, Sports;20,000 - 50,000;215;66;149;0;0;0
501220;Space Ribbon - Slipstream to the Extreme;Action, Adventure, Simulation;0 - 20,000;59;36;23;39;39;0
501270;Robots In The Wild;Action, Adventure, Indie, RPG, Simulation;0 - 20,000;3;1;2;0;0;0
501280;VirZOOM Gamepad Emulator;Action, Adventure, Casual, Indie, Simulation;0 - 20,000;3;2;1;0;0;0
501300;What Remains of Edith Finch;Indie, Strategy;500,000 - 1,000,000;29516;1363;28153;178;142;54
501310;Venture Forth;Adventure;0 - 20,000;8;4;4;0;0;0
501320;The Shrouded Isle;Casual, Indie, Simulation;200,000 - 500,000;889;370;519;165;160;4
501350;Dimension Hunter VR;Adventure, Indie;0 - 20,000;81;19;62;0;0;0
501380;"UNCORPOREAL - ""Alcatraz Island Lofts""";Action;0 - 20,000;13;9;4;0;0;0
501380;"UNCORPOREAL - ""Alcatraz Island Lofts""";Indie, RPG, Simulation, Strategy;0 - 20,000;13;9;4;0;0;0
501420;My Own Pet;Adventure;0 - 20,000;1;1;0;0;0;0
501430;Blue Solar: Chaos War;Action, Indie;0 - 20,000;111;33;78;362;362;0
501440;Stars;Action, Adventure, Casual, Indie;0 - 20,000;11;5;6;0;0;0
501450;Puzzle Cross;Action, Indie, Early Access;0 - 20,000;6;1;5;0;0;0
501470;Hold the door!;Casual, Indie;0 - 20,000;24;15;9;0;0;0
501480;Lost Socks: Naughty Brothers;Adventure, Casual;20,000 - 50,000;46;5;41;373;390;0
501530;SturmFront - The Mutant War: Übel Edition;Action, Adventure, Indie, Simulation, Early Access;0 - 20,000;41;5;36;0;0;1
501590;Bulletstorm: Full Clip Edition;Casual;200,000 - 500,000;5847;774;5073;374;344;29
501600;CyberLink PhotoDirector 8 Deluxe;Adventure, Casual;0 - 20,000;2;3;-1;0;0;0
501610;CyberLink ActionDirector 3;Adventure, Casual;0 - 20,000;11;4;7;0;0;0
501620;CyberLink PowerDirector 15 Ultimate;Adventure, Casual;0 - 20,000;26;7;19;0;0;0
501630;CyberLink PowerDirector 15 Ultra;Casual;0 - 20,000;33;11;22;0;0;2
501640;CyberLink PhotoDirector 8 Ultra;Action, Casual, Indie, Strategy;0 - 20,000;11;4;7;0;0;0
501740;Dropship Down;Action, Adventure, Casual, Indie, Strategy;0 - 20,000;20;20;0;0;0;0
501760;Francisca;Action, Adventure, Indie, RPG;50,000 - 100,000;209;126;83;232;244;0
501790;Unforeseen Incidents;Casual, Indie, Simulation;50,000 - 100,000;668;89;579;157;157;3
501840;Don't Disturb;Adventure, Free to Play, Indie, RPG;20,000 - 50,000;504;93;411;0;0;1
501850;DCR: Drive.Crash.Repeat;Action, Early Access;0 - 20,000;6;0;6;0;0;0
501860;Slayer Shock;Action, Adventure, Indie, RPG, Strategy;0 - 20,000;54;38;16;0;0;0
501860;Slayer Shock;Action, Indie;0 - 20,000;54;38;16;0;0;0
501870;HOVR;Action, Adventure, Indie, Massively Multiplayer, RPG, Early Access;0 - 20,000;0;0;0;0;0;0
501930;Sig.NULL;Indie;20,000 - 50,000;81;32;49;0;0;0
501940;Hikikomori No Chuunibyou;Indie, RPG, Simulation;0 - 20,000;28;15;13;0;0;0
501950;Rogue Islands;Adventure, Indie, Simulation;0 - 20,000;53;24;29;0;0;0
501970;Phantasmagoria 2: A Puzzle of Flesh;Adventure, Indie;20,000 - 50,000;132;33;99;0;0;2
501990;Phantasmagoria;Action, Casual, Massively Multiplayer;100,000 - 200,000;315;49;266;7;7;4
502070;Fast and Curious;Action, Adventure, Indie, Strategy;0 - 20,000;3;1;2;0;0;0
502090;Invisible Mind;Indie, Simulation, Early Access;200,000 - 500,000;63;95;-32;335;374;196
502100;Death's Life;Action, Adventure, Early Access;20,000 - 50,000;41;23;18;229;229;115
502120;Anicon - Animal Complex - Cat's Path;Adventure, Indie;0 - 20,000;26;4;22;0;0;0
502130;Ctrl CV;Action, Indie;50,000 - 100,000;206;55;151;0;0;0
502140;Drayt Empire;Action, Adventure, Indie, RPG, Strategy;200,000 - 500,000;118;120;-2;212;212;3
502150;Interstellar Logistics Inc;Action, Adventure, Indie, RPG, Strategy, Early Access;20,000 - 50,000;30;4;26;214;260;0
502200;Orczz;Adventure, RPG;20,000 - 50,000;16;9;7;0;0;0
502210;Super Markup Man;Indie;20,000 - 50,000;79;18;61;0;0;0
502230;Monsters' Den: Book of Dread;Action, Adventure, Indie, RPG;100,000 - 200,000;168;15;153;654;654;5
502240;You Deserve;Action, Indie, RPG, Early Access;0 - 20,000;187;72;115;232;276;1
502280;BERSERK and the Band of the Hawk;Action, Adventure, Indie;20,000 - 50,000;2183;511;1672;432;555;23
502300;Heartomics: Lost Count;Casual, Indie, Simulation, Strategy;0 - 20,000;27;18;9;0;0;0
502320;Boulder Dash - 30th Anniversary;Action, Adventure, Casual, Indie;0 - 20,000;80;20;60;0;0;4
502340;Unbound;Action, Indie, RPG;0 - 20,000;11;5;6;0;0;0
502350;ATV Quadracer Ultimate;Adventure, Casual;0 - 20,000;1;0;1;0;0;0
502370;Warhammer 40,000: Sanctus Reach;Adventure, Indie;50,000 - 100,000;1088;183;905;352;470;44
502380;Tangled Up!;Action, Indie, Early Access;0 - 20,000;28;16;12;0;0;0
502400;Redactem;Action, Indie;50,000 - 100,000;207;86;121;260;383;1
502410;Airport Fire Department - The Simulation;Action, Adventure, Casual, Indie, RPG, Strategy, Early Access;0 - 20,000;25;47;-22;1;1;1
502420;Firefighters - The Simulation;Action, Adventure, Casual, Indie, Simulation, Strategy;0 - 20,000;35;50;-15;12;12;0
502430;Roadworks - The Simulation;Action, Adventure, Indie;0 - 20,000;10;9;1;0;0;0
502430;Roadworks - The Simulation;Action, Casual, Indie;0 - 20,000;10;9;1;0;0;0
502440;Plant Fire Department - The Simulation;Action, Adventure, Indie, Simulation, Early Access;0 - 20,000;20;23;-3;43;43;0
502450;Professional Construction - The Simulation;Action, Adventure, Indie, Simulation;0 - 20,000;7;19;-12;0;0;0
502460;Hotel Giant;Adventure, Indie;0 - 20,000;9;5;4;0;0;0
502470;Airport Simulator 3: Day & Night;Adventure, Indie, RPG;0 - 20,000;8;27;-19;0;0;0
502480;VoxVR;Indie;0 - 20,000;7;2;5;0;0;0
502500;ACE COMBAT 7: SKIES UNKNOWN;Action, Casual, Indie, Simulation, Sports;1,000,000 - 2,000,000;28195;4206;23989;1217;653;648
502520;Ultimate General: Civil War;Simulation, Strategy;500,000 - 1,000,000;6095;732;5363;824;1047;557
502530;THE GREY MAN;Indie, Simulation, Strategy;0 - 20,000;18;5;13;0;0;0
502540;Cold Vengeance;Casual, Indie, Strategy;0 - 20,000;20;6;14;0;0;0
502550;Strike.is: The Game;Adventure, Indie;200,000 - 500,000;936;342;594;89;21;2
502570;Houdini Indie;Adventure, Casual;0 - 20,000;166;8;158;0;0;83
502600;The Multidimensional Underwear Drawer;Education, Early Access;0 - 20,000;11;4;7;0;0;0
502650;Autumn Park Mini Golf;Action, Adventure, Indie, Simulation, Early Access;0 - 20,000;28;8;20;0;0;0
502700;Laser Lasso BALL;Action, Indie;0 - 20,000;25;2;23;221;221;0
502710;The Last Sniper VR;Action, Casual, Indie, Simulation;50,000 - 100,000;120;73;47;486;486;0
502720;Star Explorers;Adventure, RPG;20,000 - 50,000;124;30;94;0;0;2
502730;Osy Osmosis;Adventure, Indie;0 - 20,000;3;1;2;0;0;0
502740;50 years;Indie, Simulation;100,000 - 200,000;553;62;491;149;189;1
502750;Quest for Glory 1-5;Action, Adventure, Indie;100,000 - 200,000;337;18;319;44;44;11
502770;Voodoo Garden;Action, Casual, Indie;100,000 - 200,000;556;172;384;0;0;2
502780;Avalon: The Journey Begins;Casual, Indie;0 - 20,000;10;4;6;0;0;0
502800;SENRAN KAGURA ESTIVAL VERSUS;Indie, Simulation, Strategy;100,000 - 200,000;4618;257;4361;1309;1768;29
502810;Tank Hero VR;Action, Free to Play, Indie, Massively Multiplayer, RPG, Early Access;0 - 20,000;11;9;2;0;0;0
502820;Batman: Arkham VR;Casual, Indie, Simulation;100,000 - 200,000;1280;605;675;41;48;8
502880;The Janitor;Action, Free to Play;0 - 20,000;27;95;-68;0;0;0
502910;The Return Home Remastered;Adventure, Indie, RPG;50,000 - 100,000;55;77;-22;259;235;0
502920;Gunnihilation;Indie;0 - 20,000;14;0;14;0;0;0
502940;Calm Down, Stalin;Adventure, Casual, Indie;20,000 - 50,000;888;99;789;49;88;0
502990;Kisaragi no Hougyoku;Nudity, Adventure;0 - 20,000;0;2;-2;0;0;0
503010;Azulgar: Star Commanders;Action, Indie;0 - 20,000;57;47;10;8;8;0
503050;Heroes from the Past: Joan of Arc;Action, Adventure, Indie;0 - 20,000;5;0;5;0;0;0
503060;The Agency of Anomalies: Mystic Hospital Collector's Edition;Action, Adventure, Indie, Strategy;0 - 20,000;15;0;15;0;0;0
503070;Off the Record: The Italian Affair Collector's Edition;Racing, Early Access;0 - 20,000;9;1;8;0;0;0
503080;Echoes of the Past: Kingdom of Despair Collector's Edition;Action, Strategy, Early Access;0 - 20,000;5;2;3;0;0;0
503090;Fairy Maids;Action;0 - 20,000;3;4;-1;0;0;0
503100;Black Hat Cooperative;Action, Adventure, Casual, Racing;20,000 - 50,000;58;20;38;76;108;0
503130;Red is Dead - The Complex Fun Random Level Fast Strategy Game;Casual, Indie, Simulation;0 - 20,000;14;2;12;0;0;0
503140;Dungeon Punks;Action, Casual, Indie;0 - 20,000;17;3;14;0;0;0
503150;Frantic Freighter;Free to Play, Indie, Strategy;0 - 20,000;21;6;15;0;0;0
503160;Angels & Demigods - SciFi VR Visual Novel;Adventure;20,000 - 50,000;60;40;20;14;14;0
503180;MiniLAW: Ministry of Law;Animation & Modeling, Design & Illustration, Education;20,000 - 50,000;141;27;114;263;263;0
503240;Hurricane;Adventure, Casual, Indie, RPG;20,000 - 50,000;93;67;26;245;275;0
503290;Maraiyum: Rise of the Setting Sun;Adventure, Casual, RPG;0 - 20,000;4;3;1;0;0;0
503300;Super Star;Action, Casual, Indie, Early Access;200,000 - 500,000;3224;899;2325;114;110;3
503340;Dig 4 Destruction;Audio Production;0 - 20,000;102;12;90;0;0;1
503350;White Noise 2;Audio Production;200,000 - 500,000;2251;570;1681;199;178;4
503370;Hospitalize;Strategy;0 - 20,000;70;97;-27;0;0;0
503390;Roomscale Tower;Action, Indie, Simulation;0 - 20,000;15;10;5;20;20;0
503400;Four Last Things;Design & Illustration;100,000 - 200,000;853;37;816;245;245;1
503410;Zombie Camp;Adventure, Indie, RPG;0 - 20,000;18;8;10;213;213;0
503450;Space Rangers: Quest;Racing, Simulation, Sports;0 - 20,000;49;43;6;2;2;1
503460;Security Hole;Casual, Indie;0 - 20,000;132;10;122;0;0;0
503480;Mahluk:Dark Demon;Action, Indie;50,000 - 100,000;94;52;42;203;250;0
503490;Sword of Fireheart - The Awakening Element;Action, Casual, Indie, Simulation, Strategy;0 - 20,000;0;0;0;0;0;0
503550;DYE;Adventure, Indie;0 - 20,000;61;19;42;207;207;2
503560;911 Operator;Action, Adventure;500,000 - 1,000,000;13201;1614;11587;492;201;79
503580;Duck Season;Animation & Modeling, Design & Illustration, Utilities;100,000 - 200,000;1074;203;871;79;87;4
503620;Fictorum;Action, Adventure, Indie, RPG, Early Access;100,000 - 200,000;809;233;576;411;625;4
503630;INVASION!;Adventure;50,000 - 100,000;157;22;135;7;8;0
503650;Fenimore Fillmore: The Westerner;Adventure;0 - 20,000;74;5;69;0;0;0
503680;The Seeker;Adventure;0 - 20,000;20;8;12;0;0;32
503690;Starship Disco;Action, Adventure, Casual, Indie;0 - 20,000;5;1;4;0;0;0
503700;Fall of Freya (Alpha 1);Racing, Simulation, Sports;0 - 20,000;1;4;-3;0;0;0
503710;Void;Indie, Simulation, Strategy;0 - 20,000;18;14;4;0;0;0
503730;Saving Harmony;Action;0 - 20,000;8;3;5;0;0;0
503750;SPLASH BLAST PANIC;Action, Adventure, Casual, Indie, Strategy;0 - 20,000;6;4;2;0;0;0
503770;Elven Assassin;Action, Casual, Simulation, Sports;50,000 - 100,000;515;88;427;757;884;50
503780;Ice Caves of Europa;Action, Casual, Indie, Strategy;20,000 - 50,000;9;11;-2;0;0;0
503820;A Detective's Novel;Action, Indie;500,000 - 1,000,000;580;273;307;302;280;1
503830;The Life Of Greather;Adventure, Casual, Indie;50,000 - 100,000;71;46;25;232;251;5
503860;Patterna;Adventure, Indie, Strategy;0 - 20,000;38;4;34;0;0;0
503900;Candy Smash VR;Action, Indie, Massively Multiplayer, RPG, Strategy, Early Access;0 - 20,000;22;11;11;202;202;0
503940;Railway Empire;Utilities, Video Production, Early Access;500,000 - 1,000,000;7044;1493;5551;795;235;513
503950;Star Tactics Redux;Violent, Gore, Action, Indie;0 - 20,000;41;8;33;278;278;0
503960;Will of the Gods;Indie, Strategy;50,000 - 100,000;29;8;21;0;0;0
503980;Detective Hank and the Golden Sneeze;Action, Indie;0 - 20,000;11;3;8;0;0;0
504000;Endless Fables: The Minotaur's Curse;Action, Indie;50,000 - 100,000;232;23;209;0;0;6
504010;Chernobyl VR Project;Adventure, Casual, Indie, Massively Multiplayer;0 - 20,000;34;17;17;0;0;0
504050;Planet Nomads;Adventure, Indie, Simulation;100,000 - 200,000;1319;675;644;1800;2132;19
504090;3..2..1..Grenades!;Casual, Free to Play, Indie, Simulation, Strategy;0 - 20,000;26;1;25;0;0;0
504110;The Longest Five Minutes;Action, Adventure, Indie;0 - 20,000;36;14;22;0;0;0
504130;Manual Samuel - Anniversary Edition;Utilities;500,000 - 1,000,000;2278;476;1802;216;256;8
504210;SHENZHEN I/O;Adventure, Indie;200,000 - 500,000;3405;172;3233;461;309;35
504230;Celeste;Casual, Free to Play, Massively Multiplayer, RPG, Simulation, Strategy;1,000,000 - 2,000,000;66222;1520;64702;1281;452;2341
504240;Graveyard Smash;Action, Casual, Indie;0 - 20,000;1;6;-5;198;198;0
504260;Happy Pong;Design & Illustration, Utilities, Video Production;0 - 20,000;6;3;3;0;0;0
504280;The Cold War Era;Action, RPG;0 - 20,000;15;10;5;0;0;0
504300;Gangs of Space;Simulation;50,000 - 100,000;313;102;211;46;83;0
504310;The Cooking Game;Action, Indie;50,000 - 100,000;112;67;45;245;296;6
504370;Battlerite;Action, Casual, Indie;2,000,000 - 5,000,000;49545;9115;40430;861;142;204
504380;Detective Hayseed - Hollywood;Indie, RPG;20,000 - 50,000;111;4;107;80;80;2
504390;Along the Edge;Action, Adventure, Free to Play, Indie, Massively Multiplayer, Strategy;20,000 - 50,000;313;30;283;0;0;1
504400;Optika;Action, Casual, Indie, Racing;0 - 20,000;290;43;247;268;297;0
504410;Escape from Pleasure Planet;Casual, Indie;0 - 20,000;27;17;10;0;0;0
504420;Malazard: Magic Defense;Action, Early Access;0 - 20,000;21;5;16;0;0;0
504430;The Watchmaker;Casual, Indie, Racing, Simulation;20,000 - 50,000;39;34;5;0;0;0
504450;StarSmashers;Action, Indie, Simulation;0 - 20,000;7;13;-6;0;0;0
504460;Team Racing League;Action, Adventure;0 - 20,000;63;26;37;206;206;0
504470;Salvaged;Casual, Indie;0 - 20,000;6;8;-2;0;0;0
504490;The God's Chain;Adventure, Early Access;200,000 - 500,000;127;232;-105;385;300;1
504500;Hover Havoc;Action, Indie;0 - 20,000;4;3;1;0;0;0
504560;The Unwelcomed;Animation & Modeling, Design & Illustration;0 - 20,000;31;11;20;0;0;0
504610;SaberSaw VR;Action, Adventure, Indie;0 - 20,000;1;1;0;0;0;0
504620;Grid Legion, Storm;Design & Illustration, Utilities;0 - 20,000;20;7;13;0;0;0
504630;Broomball VR;Action, Adventure, Indie;0 - 20,000;33;15;18;7;7;0
504650;MasterpieceVR;Adventure, Indie, RPG;0 - 20,000;113;35;78;15;15;1
504660;Tears Revolude;Action, Adventure, Indie, RPG;0 - 20,000;6;7;-1;0;0;0
504670;FARIA: Ghosts of the Stream;Adventure, Indie;0 - 20,000;9;3;6;0;0;0
504690;Woven;Casual, Indie;0 - 20,000;126;27;99;419;424;0
504700;Blockships;Action, Casual, Indie, Simulation, Sports, Early Access;20,000 - 50,000;26;1;25;122;122;1
504710;Music Maker 2017 Steam Edition;Violent, Action, Adventure, Strategy, Early Access;0 - 20,000;64;64;0;2;2;1
504720;Music Maker 2017 Premium Steam Edition;Action, Adventure, Indie, Simulation;0 - 20,000;88;89;-1;0;0;1
504770;Slavistan;Action, Indie, Racing, Simulation, Sports;100,000 - 200,000;632;67;565;209;289;17
504790;Fables from the Den;Action, Indie, Simulation;0 - 20,000;46;7;39;0;0;0
504800;Sorcery! Part 4;Adventure, Casual, Indie;0 - 20,000;68;15;53;0;0;7
504800;Sorcery! Part 4;Casual, Simulation, Sports, Strategy;0 - 20,000;68;15;53;0;0;7
504810;MXGP2 - The Official Motocross Videogame Compact;Action, Adventure, Indie;20,000 - 50,000;58;29;29;17;17;0
504840;Brick Stack VR;Adventure, Casual;0 - 20,000;10;0;10;0;0;0
504850;Castle Invasion: Throne Out;Casual;0 - 20,000;11;4;7;0;0;0
504880;Pixel Puzzles 2: RADical ROACH;Casual, Indie;50,000 - 100,000;67;22;45;211;273;0
504920;39 Days to Mars;Simulation, Sports, Strategy;20,000 - 50,000;243;34;209;191;217;2
504980;Elves Adventure;Action, Simulation;100,000 - 200,000;44;123;-79;207;206;10
504990;VoxVR Viewer;Adventure, RPG;0 - 20,000;5;0;5;0;0;0
505020;Neon Exile;Casual, Indie;0 - 20,000;6;3;3;0;0;0
505060;Warcube;Adventure, Indie;0 - 20,000;289;30;259;93;93;0
505070;Secrets of Me;Action, Indie;0 - 20,000;34;10;24;0;0;0
505080;Gakuen Club;Adventure, Simulation, Early Access;0 - 20,000;39;20;19;0;0;1
505090;The Charming Empire;Indie, Simulation, Strategy;0 - 20,000;43;30;13;0;0;0
505110;Ghost Pursuit VR;Adventure, Casual, Indie;0 - 20,000;10;2;8;0;0;0
505120;Valentino Rossi The Game Compact;Action, Adventure, Casual, Indie, RPG, Strategy;0 - 20,000;30;10;20;0;0;3
505140;Tribe Of Pok;Action, Casual, Indie;0 - 20,000;6;5;1;0;0;0
505170;Carmageddon: Max Damage;Action, Adventure, Casual, Indie, Strategy;200,000 - 500,000;2222;655;1567;219;222;25
505210;Neon Space 2;Action, Adventure, Indie, RPG;100,000 - 200,000;269;110;159;287;334;1
505220;King of Spin VR;Casual, Indie, Strategy;0 - 20,000;7;6;1;0;0;0
505230;Pathologic 2;Indie, Simulation;200,000 - 500,000;7336;613;6723;606;329;84
505270;The Food Run;Sports;0 - 20,000;5;2;3;0;0;0
505290;Super Rock Blasters!;Sexual Content, Adventure, Casual, Indie;0 - 20,000;3;1;2;0;0;0
505330;Apocalipsis;Action, Casual, Indie;100,000 - 200,000;284;119;165;0;0;1
505400;Diamond Joyce and the Secret of Crystal Cave;Strategy;0 - 20,000;22;0;22;0;0;0
505460;Foxhole;RPG;1,000,000 - 2,000,000;23713;5361;18352;6342;910;2361
505460;Foxhole;Adventure, Indie, RPG, Early Access;1,000,000 - 2,000,000;23713;5361;18352;6342;910;2361
505550;Stream Buddy;Action, Adventure, Indie;0 - 20,000;7;7;0;0;0;0
505630;Let Them Come;Action, Indie, RPG;50,000 - 100,000;958;149;809;236;254;0
505640;Antihero;Indie, Simulation, Strategy, Early Access;50,000 - 100,000;662;93;569;0;0;3
505660;The Crystal Nebula;Action, Casual, Indie, Early Access;0 - 20,000;15;2;13;0;0;0
505680;Glaive;Action, Indie, Sports;0 - 20,000;11;5;6;0;0;0
505700;Anyland;Adventure, Indie, RPG;0 - 20,000;359;19;340;11;16;0
505730;Holy Potatoes! We’re in Space?!;Action, Indie, Strategy, Early Access;50,000 - 100,000;593;297;296;441;547;5
505740;Eximius: Seize the Frontline;Casual, Simulation, Sports, Strategy;100,000 - 200,000;485;170;315;537;688;1
505750;Trimmer Tycoon;Action, Indie, Simulation, Strategy;200,000 - 500,000;463;231;232;32;43;0
506030;MAGIX PC Check & Tuning 2017 Steam Edition;Action, Indie;0 - 20,000;7;8;-1;0;0;0
506090;Switch - Or Die Trying;Violent, Action, Indie;0 - 20,000;14;5;9;0;0;0
506140;Shop Heroes;Action, Casual, Indie;500,000 - 1,000,000;2449;1192;1257;876;260;130
506150;Dragon Bros;Action, Adventure, Indie, Early Access;0 - 20,000;24;2;22;0;0;0
506160;VR Fractals;Sexual Content, Nudity, Casual, Simulation, Strategy;0 - 20,000;3;3;0;0;0;0
506260;Cladun Returns: This Is Sengoku!;Action, Indie, Simulation;0 - 20,000;55;17;38;62;62;0
506280;My Lil' Donut;Indie, Simulation, Early Access;0 - 20,000;35;5;30;0;0;0
506470;Quip Anomaly;Indie, Animation & Modeling;0 - 20,000;12;2;10;0;0;0
506500;Party Panic;Casual, Indie, Early Access;200,000 - 500,000;2263;682;1581;251;225;22
506510;Shadows of Adam;Action, Adventure, Indie;20,000 - 50,000;198;20;178;0;0;1
506540;Last Man Standing;Adventure, Indie;2,000,000 - 5,000,000;11094;7050;4044;329;80;0
506550;RollerForce;Casual, Indie;0 - 20,000;21;8;13;0;0;0
506560;A Divided Light;Action, Indie;0 - 20,000;4;1;3;0;0;0
506570;Going Up;Casual, Indie;0 - 20,000;2;3;-1;0;0;0
506590;Sky Valley;Action, Indie;0 - 20,000;51;27;24;213;213;0
506610;Five Nights at Freddy's: Sister Location;Action, Indie;500,000 - 1,000,000;8772;847;7925;141;95;33
506630;;Casual, Indie;0 - 20,000;1;0;1;0;0;0
506670;ORBITAL;Indie;1,000,000 - 2,000,000;200;73;127;240;230;1
506700;Levantera: Tale of The Winds;Casual, Indie, Racing;0 - 20,000;9;1;8;0;0;0
506730;Dinosaur Forest;Action, Indie;100,000 - 200,000;380;291;89;156;182;0
506750;AM Model Viewer;Action, Adventure, Indie;0 - 20,000;9;4;5;0;0;0
506760;Twisty's Asylum Escapades;Casual, Indie;0 - 20,000;23;22;1;226;211;1
506760;Twisty's Asylum Escapades;Action, Racing;0 - 20,000;23;22;1;226;211;1
506780;Think Space;Action, Indie;0 - 20,000;15;3;12;0;0;0
506830;Goo Saga;Casual, Indie;0 - 20,000;18;6;12;0;0;0
506840;The Dungeons of Castle Madness;Animation & Modeling, Design & Illustration, Early Access;0 - 20,000;13;11;2;0;0;0
506870;Unexplored;Action, Casual, Indie, Sports;100,000 - 200,000;585;86;499;0;0;1
506900;Downward;Casual, Indie;20,000 - 50,000;359;140;219;1036;1036;0
506930;CoLab;Indie, Racing, Simulation;0 - 20,000;8;8;0;0;0;0
506960;Pong Champion VR;Action, Indie, Simulation;0 - 20,000;10;4;6;0;0;0
506980;Drone: Remote Tactical Warfare;Adventure;0 - 20,000;2;1;1;0;0;0
507010;Mr.President!;Action, Casual, Indie, Simulation;100,000 - 200,000;2954;739;2215;113;126;8
507030;Bicyclism EP;Action, Casual, Free to Play, Indie, Early Access;0 - 20,000;16;9;7;0;0;0
507050;DOGOS;Action, Adventure, Casual, Indie, Strategy;0 - 20,000;43;21;22;0;0;0
507060;Sceal: An Irish Folklore Adventure;Casual, Indie;0 - 20,000;19;2;17;0;0;0
507080;Baseball Mogul Diamond;Adventure, Indie;0 - 20,000;33;10;23;0;0;0
507120;The Superfluous;Action, Racing, Sports;0 - 20,000;40;9;31;0;0;0
507140;Tesla's Tower: The Wardenclyffe Mystery;Action, Indie, Racing;0 - 20,000;8;1;7;0;0;0
507210;The Wire;Action, Adventure, Casual, Indie, Simulation, Strategy, Early Access;0 - 20,000;24;8;16;0;0;0
507270;Lily´s Epic Quest;Indie, Simulation, Strategy;0 - 20,000;12;6;6;0;0;0
507300;Club Manager 2017;Casual, Indie;0 - 20,000;31;22;9;0;0;18
507340;Strike Squadron: Caracará;Adventure, Indie;0 - 20,000;8;3;5;0;0;0
507360;The Wizard's Lair;Adventure, Simulation;20,000 - 50,000;7;8;-1;285;310;0
507380;Black Sand Drift;Action, Casual, Indie;200,000 - 500,000;157;68;89;304;345;14
507390;Gone In November;Action, Casual, Indie;200,000 - 500,000;234;140;94;199;202;5
507400;Vindictive Drive;Casual, Indie;20,000 - 50,000;47;19;28;240;235;3
507440;Island Simulator 2016;Action, Free to Play, Racing, Sports;0 - 20,000;1;6;-5;0;0;0
507490;Ashes of the Singularity: Escalation;Adventure, Casual, Indie, Racing;500,000 - 1,000,000;3275;1082;2193;466;150;46
507520;Zzzz-Zzzz-Zzzz;Casual, Simulation;100,000 - 200,000;182;49;133;0;0;0
508170;BlackSmith HIT;Utilities;200,000 - 500,000;374;110;264;204;283;1
508180;Fly and Destroy;Action, Adventure, Free to Play, Indie, RPG, Early Access;100,000 - 200,000;154;104;50;225;257;2
508190;Dragon Knight;Adventure, Indie;100,000 - 200,000;1959;624;1335;96;74;5
508200;Bacon Tales - Between Pigs and Wolves;Adventure, Free to Play, Indie, Massively Multiplayer, RPG, Strategy;50,000 - 100,000;28;16;12;206;206;0
508230;Anime Studio Simulator;Action, Adventure, Indie, RPG;0 - 20,000;47;23;24;0;0;0
508250;Aussie Sports VR 2016;Adventure, Casual, Strategy, Early Access;0 - 20,000;3;1;2;0;0;0
508260;Treasure of a Blizzard;Action, Adventure, Strategy;0 - 20,000;140;27;113;0;0;0
508290;$1 Ride;Action, Casual, Simulation;500,000 - 1,000,000;400;451;-51;226;201;0
508300;Strategy & Tactics: Dark Ages;Action, Adventure, Indie;50,000 - 100,000;112;75;37;239;239;1
508330;GALER: Plague of Heroes;Adventure, Indie, Simulation;0 - 20,000;3;0;3;0;0;0
508350;Draconic Order VR;Action, Indie;0 - 20,000;7;4;3;0;0;0
508390;Scrap Garden - The Day Before;Adventure, Casual, Free to Play, Indie;200,000 - 500,000;708;232;476;19;22;0
508410;SKIPCHASER;Action, Adventure, Indie, Racing;0 - 20,000;49;17;32;217;256;0
508410;SKIPCHASER;Action, Adventure, Indie;0 - 20,000;49;17;32;217;256;0
508440;Totally Accurate Battle Simulator;Action, Casual, Indie;2,000,000 - 5,000,000;99828;2143;97685;716;313;2451
508450;NASCAR Heat Evolution;Adventure, Indie;20,000 - 50,000;166;141;25;0;0;2
508520;MiniBotz;Action, Adventure, Indie;0 - 20,000;9;6;3;0;0;0
508530;HackyZack;RPG, Strategy;50,000 - 100,000;161;78;83;215;273;1
508540;Haeven;Adventure, Indie;20,000 - 50,000;21;11;10;239;239;0
508550;Sneak Thief;Action, Indie;100,000 - 200,000;1140;379;761;187;239;6
508580;CasinoXR;Action, Casual, Indie;0 - 20,000;18;9;9;0;0;0
508600;ROD: Revolt Of Defense;Adventure, Indie, Early Access;20,000 - 50,000;436;111;325;11;11;0
508610;PROJECT XINATRA;Casual, Indie, Simulation;0 - 20,000;4;2;2;6;6;0
508620;ZombLabs;Action, Free to Play, Indie, RPG, Early Access;0 - 20,000;0;0;0;0;0;0
508630;Soldiers Lost Forever (1914-1918);Adventure, Casual, Indie;20,000 - 50,000;19;11;8;0;0;0
508650;Signal Decay;Free to Play, Indie;0 - 20,000;52;12;40;0;0;0
508660;Triple X Tycoon;Action, Indie, Early Access;0 - 20,000;0;0;0;0;0;0
508680;Domino VR;Action, Casual, Indie;0 - 20,000;2;1;1;0;0;0
508690;AnimVR;Action, Indie, Sports, Early Access;0 - 20,000;9;7;2;0;0;0
508710;Project Lounge;Casual, Simulation, Strategy;20,000 - 50,000;53;22;31;26;26;2
508730;Painted Legend;Casual, Indie, Simulation, Sports;0 - 20,000;26;12;14;223;223;7
508740;Wheels of Aurelia;Action, Strategy;20,000 - 50,000;84;82;2;0;0;0
508740;Wheels of Aurelia;Action, Free to Play, Massively Multiplayer, Early Access;20,000 - 50,000;84;82;2;0;0;0
508760;Ball of Wonder;RPG, Strategy;100,000 - 200,000;54;28;26;277;327;0
508790;Flat Heroes;Action, Adventure, Indie;50,000 - 100,000;429;50;379;1;1;2
508820;Won't You Be My Laser?;Action, Adventure, Casual, Indie;20,000 - 50,000;42;18;24;195;198;0
508840;Broken Armor;Adventure, Indie;100,000 - 200,000;466;97;369;234;299;3
508890;Meteor Crush VR;Action;0 - 20,000;3;0;3;0;0;0
508900;Zup! X;Simulation, Strategy;200,000 - 500,000;5809;182;5627;141;91;9
508910;Deus Ex Machina, Game of the Year, 30th Anniversary Collector’s Edition;Indie;0 - 20,000;27;4;23;3;3;0
508930;Mini Z Racers Turbo;Action, Adventure, Indie, RPG, Sports;0 - 20,000;7;9;-2;0;0;0
508940;Escape Lizards;Action, Indie, Early Access;0 - 20,000;13;2;11;0;0;0
508950;Beerman;Casual, Indie, Simulation, Strategy;20,000 - 50,000;33;23;10;394;463;0
508950;Beerman;Adventure, Indie;20,000 - 50,000;33;23;10;394;463;0
508980;Crashday Redline Edition;Action, Adventure, Early Access;50,000 - 100,000;1280;169;1111;242;276;6
509020;Sceelix - Procedural Power;Indie;0 - 20,000;8;4;4;0;0;0
509070;Super VR Trainer;Action, Adventure, Indie;0 - 20,000;18;6;12;0;0;1
509110;Spikit;Action, Indie, Strategy, Early Access;50,000 - 100,000;319;79;240;240;218;0
509130;RC-AirSim - RC Model Airplane Flight Simulator;Violent, Simulation, Sports;0 - 20,000;28;8;20;0;0;0
509140;HVR;Adventure, Indie;0 - 20,000;0;0;0;0;0;0
509160;Gebub's Adventure;Indie, RPG, Early Access;0 - 20,000;28;1;27;0;0;0
509160;Gebub's Adventure;Strategy;0 - 20,000;28;1;27;0;0;0
509170;VRNinja;Adventure, Indie;0 - 20,000;9;9;0;141;141;0
509190;Rollout;Adventure;20,000 - 50,000;46;33;13;7;7;0
509210;Clockwork;Action, Indie;0 - 20,000;45;27;18;0;0;0
509220;Save Jesus;Free to Play, Indie, Sports, Strategy;200,000 - 500,000;1885;202;1683;141;175;2
509230;Erusal;Adventure, Casual;0 - 20,000;12;13;-1;13;13;0
509250;TO THE TOP;Adventure, Casual, Free to Play, Indie, Massively Multiplayer, RPG, Strategy;100,000 - 200,000;647;102;545;31;32;3
509260;Northern Regime;Adventure, Indie;0 - 20,000;9;20;-11;0;0;0
509290;One Night Two Crazies;Action, Indie, Simulation, Strategy;0 - 20,000;40;11;29;20;20;0
509290;One Night Two Crazies;Casual, Indie, Strategy;0 - 20,000;40;11;29;20;20;0
509310;ThrounnelVR;Action, Indie;50,000 - 100,000;6;1;5;0;0;0
509340;Abandoned Hospital VR;Casual, Indie, Simulation;0 - 20,000;3;1;2;0;0;0
509340;Abandoned Hospital VR;Casual, Free to Play, Indie, Simulation;0 - 20,000;3;1;2;0;0;0
509360;TRESPASS - Episode 1;Strategy;0 - 20,000;44;17;27;0;0;0
509380;Mech Ace Combat - Trainer Edition;Action, Adventure, Free to Play, Indie, RPG;0 - 20,000;0;0;0;0;0;0
509390;GalaxIverse;Action, Adventure, Indie;20,000 - 50,000;24;11;13;192;193;4
509420;Riding Club Championships;Action, Casual, Indie, Massively Multiplayer, Simulation;100,000 - 200,000;471;157;314;26;34;9
509440;God Simulator;Simulation;0 - 20,000;4;13;-9;0;0;0
509440;God Simulator;Adventure, Indie;0 - 20,000;4;13;-9;0;0;0
509450;Colony;Action, Indie, Early Access;0 - 20,000;3;3;0;0;0;0
509510;Holos;Casual, Indie, Strategy;0 - 20,000;0;0;0;0;0;0
509530;Gods and Nemesis: of Ghosts from Dragons;Action, Casual, RPG;0 - 20,000;23;14;9;0;0;0
509540;SVRVIVE: The Deus Helix;Action, Adventure, Indie, RPG;20,000 - 50,000;69;28;41;0;0;0
509560;Heroes of Dire;Casual, Indie, Strategy;50,000 - 100,000;135;59;76;120;155;0
509570;In Celebration of Violence;Indie, Early Access;20,000 - 50,000;408;54;354;269;269;2
509580;The Lord of the Rings: Adventure Card Game - Definitive Edition;Action, Adventure, Indie, RPG;20,000 - 50,000;1064;370;694;298;392;5
509610;Beachhead 2000;Adventure, Casual;0 - 20,000;13;29;-16;0;0;0
509620;Last Stitch Goodnight;Action, Adventure, Indie;0 - 20,000;8;2;6;0;0;0
509770;PostCollapse;Action, Indie;0 - 20,000;71;52;19;0;0;0
509780;Fire Arrow Plus;Action, Adventure, Indie;0 - 20,000;36;4;32;622;622;0
509800;The Last Weekend;Action, Adventure, Indie;50,000 - 100,000;219;147;72;81;81;0
509820;Super Grav;Adventure, Casual, Indie;0 - 20,000;13;1;12;0;0;0
509830;Evil Robots From N1M;Adventure, Casual, Indie, Simulation;0 - 20,000;0;1;-1;0;0;0
509850;Bumper;Adventure, Indie;20,000 - 50,000;79;28;51;199;235;0
509860;Baezult;Casual, Indie, Simulation;20,000 - 50,000;52;17;35;0;0;0
509880;The End o,,,o;Education;20,000 - 50,000;119;64;55;0;0;0
509910;Night Vigil;Action, Adventure;0 - 20,000;6;3;3;271;271;0
509920;Doc Apocalypse;Casual, Indie, Strategy;20,000 - 50,000;18;10;8;225;232;0
509930;NightmareZ;Action, Indie, Strategy;20,000 - 50,000;17;26;-9;295;354;0
509960;Pinga Ponga;Action, Casual, Simulation, Early Access;20,000 - 50,000;25;32;-7;259;259;0
509980;BIGFOOT;Indie, Simulation, Early Access;1,000,000 - 2,000,000;12674;2843;9831;305;205;233
510000;Xecryst Remains;Action, Indie;20,000 - 50,000;70;21;49;0;0;0
510040;A Matter of Murder;Casual, Indie;;;;0;;;
510050;You Have 10 Seconds;Violent, Gore, Adventure, Indie;100,000 - 200,000;1153;129;1024;22;11;0
510060;Punch Bomb;Indie, Strategy;0 - 20,000;35;0;35;0;0;0
510070;Shiperoids;Action, Adventure, Indie, Early Access;0 - 20,000;14;3;11;0;0;0
510080;Worldy Cup;Casual, Indie, Simulation, Sports;0 - 20,000;13;5;8;0;0;0
510110;New Yankee in King Arthur's Court 2;Action, Indie;0 - 20,000;8;8;0;0;0;0
510130;Power Link VR;Indie;0 - 20,000;23;2;21;8;15;0
510180;NDE Rescue;Action, Casual, Indie, Early Access;0 - 20,000;1;0;1;0;0;0
510190;Lazarus;Indie, RPG;0 - 20,000;26;21;5;0;0;0
510240;forma.8;Action, Casual;0 - 20,000;40;7;33;0;0;0
510250;Super Destronaut;Action;0 - 20,000;39;4;35;0;0;0
510280;Orange Adventure;Action, Adventure, Casual, Indie, Simulation;0 - 20,000;9;1;8;0;0;0
510290;DEXED;Action, Casual, Indie, Early Access;0 - 20,000;34;10;24;0;0;0
510320;Conflict of Heroes: Awakening the Bear;Video Production;0 - 20,000;20;14;6;0;0;0
510330;Shotgun Raiders;Action, Adventure;0 - 20,000;15;12;3;304;347;0
510360;Recession;Action, Casual, Indie, RPG;0 - 20,000;13;6;7;0;0;0
510370;Dragon Souls;Indie, Simulation, Sports, Strategy, Early Access;20,000 - 50,000;49;28;21;0;0;0
510380;GoVenture MICRO BUSINESS;Action, Free to Play, Indie, Massively Multiplayer, Strategy;0 - 20,000;1;7;-6;0;0;0
510390;Unknown Fate;Strategy;0 - 20,000;42;21;21;0;0;0
510410;Cogs and Cowboys;Casual, Indie, Strategy;0 - 20,000;10;8;2;0;0;0
510420;The Hex;Action, Indie, Early Access;50,000 - 100,000;2705;168;2537;315;430;20
510430;Stacks On Stacks (On Stacks);Indie;0 - 20,000;12;0;12;0;0;0
510490;The Fall Part 2: Unbound;Casual, Indie, Simulation;100,000 - 200,000;474;108;366;220;220;4
510500;Executive Assault 2;Action, Adventure, Casual, Indie, RPG;100,000 - 200,000;859;163;696;367;373;9
510510;WWE 2K17;Action, Adventure, Casual, Indie, Strategy;200,000 - 500,000;1099;605;494;5501;6292;18
510520;Little Red Lie;Adventure, Indie, RPG;0 - 20,000;106;17;89;0;0;1
510540;Long Gone Days;Indie, RPG, Strategy;20,000 - 50,000;274;16;258;302;302;0
510550;Congo Merc;Adventure, Sports;0 - 20,000;10;19;-9;258;258;0
510570;CURSE;Action, Indie, Strategy;0 - 20,000;43;25;18;91;91;0
510590;D: The Game;Casual, Indie;20,000 - 50,000;88;13;75;0;0;0
510620;THOTH;Action, Adventure, Indie, Early Access;50,000 - 100,000;363;70;293;148;155;2
510630;Soccer Manager 2017;Action, Indie;200,000 - 500,000;414;217;197;441;618;0
510650;Eventide 2: The Sorcerers Mirror;Casual, Indie, Sports;50,000 - 100,000;217;66;151;158;158;3
510660;Big Bang Empire;Casual, Indie, RPG, Early Access;100,000 - 200,000;720;351;369;19;26;28
510680;Re Angel;Adventure;0 - 20,000;135;2;133;0;0;0
510700;Armor Clash VR;Action, Adventure, Indie;0 - 20,000;8;3;5;0;0;0
510710;Bloxiq VR;Casual, Indie;0 - 20,000;3;2;1;0;0;0
510730;Grim Seventh;Action, Casual, Indie;0 - 20,000;12;8;4;0;0;0
510740;Konrad's Kittens;Indie, Simulation;0 - 20,000;33;7;26;0;0;0
510750;Driftwood The Visual Novel;Casual, Indie;0 - 20,000;36;36;0;0;0;0
510780;SkyBoats;Action, Adventure;0 - 20,000;18;6;12;215;215;1
510790;The Sun Will Rise;Action, Adventure, Indie;20,000 - 50,000;37;32;5;0;0;0
510830;Citadel 1986;Indie;0 - 20,000;15;2;13;0;0;0
510840;Evolvation;Utilities, Early Access;1,000,000 - 2,000,000;628;286;342;1152;311;3
510850;Mars 2030;Action, Casual, Indie;0 - 20,000;58;27;31;0;0;1
510850;Mars 2030;Action, Indie, RPG, Early Access;0 - 20,000;58;27;31;0;0;1
510910;Temple of the Apsara;Action, Casual, Indie, Strategy;0 - 20,000;37;13;24;0;0;0
510930;Thirst VR;Casual, Indie;0 - 20,000;93;27;66;0;0;0
510960;Puzzling Rooms VR;Action, Casual, Indie, Simulation, Early Access;0 - 20,000;2;0;2;0;0;0
510990;LooWarVR;Action, Adventure, Free to Play, Indie, Simulation, Strategy;0 - 20,000;14;1;13;0;0;0
511010;TAIKER;Action, Indie;0 - 20,000;23;13;10;0;0;0
511070;MANIC MINERS;Action, Adventure, Indie;0 - 20,000;7;7;0;1;1;0
511070;MANIC MINERS;Free to Play, Strategy, Early Access;0 - 20,000;7;7;0;1;1;0
511090;The Shape Of Heart;Adventure;50,000 - 100,000;180;41;139;0;0;0
511120;ikenie;Adventure;0 - 20,000;4;1;3;0;0;0
511140;New York Mysteries: The Lantern of Souls;Design & Illustration;20,000 - 50,000;206;18;188;0;0;4
511160;Cubway;Indie, RPG;50,000 - 100,000;91;34;57;327;340;1
511190;Graveyard Shift;Action, Casual, Indie;20,000 - 50,000;37;21;16;0;0;0
511230;The Last;Action, Adventure, Indie;0 - 20,000;2;2;0;0;0;0
511250;Cloudbase Prime;Action, Casual, Indie;0 - 20,000;20;8;12;0;0;0
511320;Echoes of the Fey: The Fox's Trail;Casual, Indie;0 - 20,000;19;4;15;0;0;0
511330;Farm Life: Natures Adventure;Action, Adventure, Racing, Early Access;20,000 - 50,000;20;20;0;228;287;0
511350;Mr. Massagy;Action, Indie;0 - 20,000;194;8;186;0;0;0
511360;UNCORPOREAL - Holographic Photography Demo;Adventure, Indie;0 - 20,000;17;2;15;6;6;0
511370;Wrath Of The Fire God;Adventure, Casual, Early Access;0 - 20,000;23;2;21;0;0;0
511380;Pozzo Jello Crusade;Action, Adventure, Indie, RPG, Early Access;0 - 20,000;23;1;22;0;0;0
511390;Base Raid;Action, Indie;0 - 20,000;7;2;5;0;0;0
511420;Aleph Null;Action, Adventure, Free to Play, Indie, Massively Multiplayer;0 - 20,000;1;0;1;0;0;0
511430;CrossWorlds: Escape;Action, Adventure, Early Access;0 - 20,000;91;50;41;0;0;1
511440;Last Year: The Nightmare;Adventure, Casual, Indie, RPG, Strategy, Early Access;20,000 - 50,000;381;174;207;48;48;4
511460;Unaided: 1939;Action, Adventure, Indie, Strategy;0 - 20,000;10;6;4;0;0;0
511470;Glass Masquerade;Violent, Gore, Utilities;1,000,000 - 2,000,000;5595;164;5431;305;264;16
511490;Malavision: The Beginning;Action, Indie, Simulation;0 - 20,000;31;19;12;467;486;0
511500;Nanuleu;Action, Casual, Indie, Early Access;0 - 20,000;53;11;42;0;0;0
511540;MoonQuest;Audio Production, Video Production;0 - 20,000;77;27;50;171;171;0
511560;World of Golf;Action, Adventure, Casual, Free to Play, Indie, Early Access;0 - 20,000;10;8;2;0;0;0
511570;NIGHTSTAR;Adventure, Indie;0 - 20,000;57;5;52;0;0;0
511600;Space Jones VR;Indie, Racing, Simulation;0 - 20,000;15;7;8;0;0;0
511610;Adventure Of Thieves;Action, Adventure, Indie;0 - 20,000;3;2;1;0;0;0
511630;Max, an Autistic Journey;Adventure, Casual;50,000 - 100,000;78;17;61;0;0;0
511660;Beachhead 2002;Action;0 - 20,000;52;25;27;0;0;2
511680;Fate/EXTELLA;Adventure, Indie;100,000 - 200,000;3672;334;3338;507;607;7
511690;Duck Force;Action, Casual, Indie, Racing;0 - 20,000;9;1;8;0;0;0
511700;Ship It;Action, Casual, Indie, Sports, Early Access;0 - 20,000;13;1;12;0;0;0
511720;MAGIX Video deluxe 2017 Plus Steam Edition;Adventure, Indie;0 - 20,000;38;45;-7;0;0;2
511740;Gal*Gun: Double Peace;Indie, Simulation, Strategy, Early Access;100,000 - 200,000;1701;261;1440;36;36;9
511750;Showdown Adventure;Adventure, Indie;20,000 - 50,000;42;13;29;208;208;0
511760;Devastated;Indie;0 - 20,000;7;1;6;0;0;0
511790;Retro Football Boss;Action, Adventure, Indie, RPG;0 - 20,000;19;12;7;0;0;0
511800;ONRAID;Adventure, Indie, RPG;500,000 - 1,000,000;1369;441;928;49;33;0
511810;CHEXS;Free to Play, Indie, Massively Multiplayer, Strategy;0 - 20,000;8;6;2;0;0;0
511820;Le Havre: The Inland Port;Casual, Free to Play, Indie;0 - 20,000;30;22;8;65;65;0
511830;VR Ultimate Paintball: Heartbreak, Regret & Paintbots;Indie, Simulation, Strategy, Early Access;0 - 20,000;6;6;0;0;0;0
511920;Reproduction Man;Adventure, Indie, Simulation;0 - 20,000;1;2;-1;0;0;0
511960;Gravity Shot;Indie;20,000 - 50,000;4;1;3;0;0;0
512000;Kite;Action, Casual, Indie;0 - 20,000;25;2;23;0;0;0
512020;Box Maze;Indie, Simulation;50,000 - 100,000;137;58;79;230;242;29
512060;Stay! Stay! Democratic People's Republic of Korea!;Violent, Action, Indie;100,000 - 200,000;520;35;485;289;337;0
512080;Fancy Skiing VR;Adventure, Casual, Indie;50,000 - 100,000;169;68;101;78;78;2
512090;Tank Defense Division;Action, Free to Play, Indie;0 - 20,000;3;3;0;0;0;0
512110;Cosmos Crash VR;Gore, Action, Adventure, Indie;0 - 20,000;27;4;23;0;0;0
512120;Nakiti Generations;Action, Casual, Indie;0 - 20,000;17;12;5;0;0;0
512150;Swordlord;Action, Casual, Strategy, Early Access;0 - 20,000;39;0;39;0;0;0
512160;Volleying;Casual, Indie;50,000 - 100,000;229;99;130;164;147;4
512170;the research facility NO.507;Action, Casual, Indie;0 - 20,000;48;36;12;0;0;0
512220;Trickster VR: Co-op Dungeon Crawler;Action, Casual, Indie;50,000 - 100,000;391;66;325;76;76;0
512230;Sally's Law;Action, Adventure, Casual, Indie, Strategy;20,000 - 50,000;186;25;161;19;19;1
512240;Duckpocalypse;Action, Free to Play, Massively Multiplayer;0 - 20,000;46;6;40;0;0;0
512250;Oh...Sir!! The Insult Simulator;Action, Indie;200,000 - 500,000;3184;310;2874;197;115;18
512260;Avalon Legends Solitaire 2;Action, Adventure, Casual, Indie, Simulation, Sports, Strategy;20,000 - 50,000;46;6;40;0;0;3
512270;Home - A VR Spacewalk;Indie, Racing;100,000 - 200,000;245;100;145;16;17;1
512300;Unbox: Newbie's Adventure;Action, Adventure, Indie, Massively Multiplayer, Early Access;50,000 - 100,000;484;99;385;178;230;2
512370;Hero Boy;Strategy;0 - 20,000;5;0;5;0;0;0
512400;Multiscreens;Adventure, Indie;0 - 20,000;2;9;-7;0;0;0
512410;69 Ways to Kill a Zombie;Animation & Modeling, Design & Illustration, Utilities, Early Access;0 - 20,000;7;19;-12;0;0;0
512420;Wave Magic VR;Action, Casual, Indie;0 - 20,000;15;8;7;0;0;0
512430;Make America Great Again;Casual, Indie;20,000 - 50,000;26;37;-11;0;0;0
512460;Nature And Life - Drunk On Nectar;Early Access;0 - 20,000;183;20;163;0;0;3
512470;The Pirate: Caribbean Hunt;Adventure;500,000 - 1,000,000;3293;737;2556;305;64;37
512490;Zombie Estate 2;Action, Casual, Indie, Strategy;50,000 - 100,000;537;14;523;1863;1863;6
512550;Cursed West;Action, Indie;20,000 - 50,000;52;24;28;250;270;0
512560;HoCWar;Adventure;50,000 - 100,000;71;54;17;31;31;0
512600;Gochi-Show! -How To Learn Japanese Cooking Game-;Action, Casual, Indie, Massively Multiplayer, Simulation, Strategy, Early Access;0 - 20,000;50;13;37;468;468;1
512610;Gochi-Show! for Girls -How To Learn Japanese Cooking Game-;Adventure;0 - 20,000;10;4;6;0;0;0
512630;VR Gallery;Action, Indie;0 - 20,000;21;5;16;1;1;0
512640;Final Quest;Casual, Indie, Racing, Simulation;200,000 - 500,000;69;101;-32;209;210;1
512680;Pan-Dimensional Conga Combat;Action, Indie;0 - 20,000;14;0;14;0;0;0
512700;Duckles: the Jigsaw Witch;Casual, Indie;50,000 - 100,000;7;16;-9;217;246;0
512720;Velocidevorium;Adventure, Casual, Indie, Strategy;0 - 20,000;0;0;0;0;0;0
512740;Flat Path;Casual, Simulation, Sports, Strategy;50,000 - 100,000;66;8;58;279;280;0
512750;One Giant Leap;Action, Strategy;0 - 20,000;15;0;15;0;0;0
512770;IACTURA;Action, Strategy;50,000 - 100,000;21;10;11;176;211;0
512790;Quern - Undying Thoughts;Casual, Simulation;100,000 - 200,000;2759;241;2518;211;260;18
512830;Zombie Trigger;Action;0 - 20,000;3;6;-3;0;0;0
512890;Elsinore;Action;0 - 20,000;240;9;231;0;0;2
512890;Elsinore;Simulation;0 - 20,000;240;9;231;0;0;2
512900;Streets of Rogue;Simulation;1,000,000 - 2,000,000;16951;662;16289;1219;392;358
512920;Trigger Time;Simulation;0 - 20,000;23;7;16;0;0;0
513000;KUBOOM;Casual, RPG, Strategy, Early Access;200,000 - 500,000;1639;1334;305;95;45;77
513050;Outrageous Grounds: The Maze;Action, Adventure, Indie, RPG;0 - 20,000;11;6;5;0;0;0
513140;OCCHIO;Action, Adventure, Indie, Simulation;0 - 20,000;7;2;5;0;0;0
513150;Daylight's End VR Edition;Indie, Simulation, Strategy;20,000 - 50,000;12;16;-4;0;0;0
513170;The Tower: Last Stand;Casual;0 - 20,000;3;2;1;0;0;0
513190;Voidrunner;Action, Indie;0 - 20,000;57;24;33;244;244;0
513200;EDMtv VR;Action, Casual, Simulation;;;;0;;;
513210;Rescue Bear Operation;Violent, Action, Indie;0 - 20,000;53;16;37;0;0;0
513230;The Underground Man;Action, Casual, Indie, Racing, Early Access;50,000 - 100,000;1106;257;849;207;228;1
513240;Birdtual Reality;Action, Free to Play, Indie;0 - 20,000;3;4;-1;0;0;0
513250;Rogue Stache;Adventure, Casual, RPG, Early Access;0 - 20,000;41;3;38;0;0;0
513260;Green Moon 2;Action, Adventure, Indie, Early Access;0 - 20,000;3;2;1;0;0;0
513270;Lockdown: Stand Alone;Action, Indie, Racing;0 - 20,000;24;18;6;0;0;0
513290;Lucius III;Casual, Strategy;50,000 - 100,000;514;474;40;0;0;3
513300;Schacht;Casual, Strategy;0 - 20,000;28;6;22;112;112;0
513310;Aviators;Casual;0 - 20,000;1;0;1;0;0;0
513320;ALICE VR;Simulation, Strategy, Early Access;50,000 - 100,000;99;166;-67;0;0;1
513330;Party Tycoon;Violent, Gore, Action, Indie, Massively Multiplayer;20,000 - 50,000;161;148;13;0;0;0
513340;Through Abandoned: The Forest;Indie;50,000 - 100,000;198;40;158;285;294;293
513360;Mu Cartographer;Casual, Indie, Racing, Strategy;20,000 - 50,000;185;22;163;454;904;0
513370;Blade & Bones;Adventure, Indie, RPG;20,000 - 50,000;59;128;-69;179;205;0
513420;VR Escape the space station;Action, Casual, Free to Play;0 - 20,000;37;23;14;0;0;0
513440;Path of War;Action, Casual, Indie;100,000 - 200,000;102;80;22;21;21;7
513450;Drop Alive;Action, Casual, Indie;200,000 - 500,000;1293;155;1138;25;17;1
513460;Agenda;Action, Indie;0 - 20,000;21;27;-6;0;0;0
513480;Geo;Action, Casual, Indie;20,000 - 50,000;139;22;117;0;0;2
513490;1943 Berlin Blitz;Casual, Indie;20,000 - 50,000;252;19;233;0;0;0
513510;Intralism;Action, Indie;500,000 - 1,000,000;4325;631;3694;196;219;5
513550;Vive le Roi;Indie, Simulation;0 - 20,000;48;32;16;3;3;0
513550;Vive le Roi;Adventure, Casual;0 - 20,000;48;32;16;3;3;0
513560;Hunger Dungeon;Nudity, Adventure, Casual, Indie, Early Access;200,000 - 500,000;1655;635;1020;45;22;1
513570;Wooden House;Adventure, Casual;100,000 - 200,000;178;110;68;263;257;0
513580;Miaou Moon;Adventure, Casual;0 - 20,000;22;14;8;0;0;0
513590;So Many Cubes;Adventure, Casual;200,000 - 500,000;45;105;-60;258;271;1
513600;Energy Invasion;Adventure, Casual;20,000 - 50,000;26;19;7;284;290;2
513610;Madrobot X;Adventure, Casual;100,000 - 200,000;105;15;90;200;200;0
513620;SkyTime;Casual;100,000 - 200,000;122;74;48;217;218;9
513660;Rest in Jelly;Casual;0 - 20,000;0;0;0;0;0;0
513680;Maximum Archery The Game;Action, Indie;0 - 20,000;5;5;0;0;0;0
513690;Danger Zone 2;Action, Casual;0 - 20,000;47;34;13;177;270;0
513710;SCUM;Action, Adventure, Indie, Simulation;2,000,000 - 5,000,000;63144;21499;41645;2281;824;13474
513720;Archipelago;Casual, Indie, Strategy;0 - 20,000;34;16;18;1;1;0
513760;3dSunshine;Action, Adventure, Casual;20,000 - 50,000;43;7;36;7;7;0
513770;Click Space Miner;Adventure, Indie;0 - 20,000;9;13;-4;0;0;0
513770;Click Space Miner;Indie, Racing;0 - 20,000;9;13;-4;0;0;0
513780;Turbo Pug DX;Action, Casual, Indie;500,000 - 1,000,000;1350;384;966;201;231;1
513790;DEADLOCK;Casual, Indie, Racing, Simulation;0 - 20,000;16;6;10;26;26;0
513810;Arkham Nightmares;Action, Adventure, Indie, RPG;0 - 20,000;4;8;-4;0;0;0
513820;LUXIS;Adventure, Casual, Indie, RPG;20,000 - 50,000;38;10;28;317;323;0
513840;Friday Night Bullet Arena;Action, Indie, Early Access;0 - 20,000;9;2;7;0;0;0
513860;Elena;Casual, Free to Play, Indie, Simulation;0 - 20,000;37;9;28;0;0;0
513860;Elena;Action, Casual, Indie, Simulation, Strategy;0 - 20,000;37;9;28;0;0;0
513880;Panzer Warfare;Simulation;20,000 - 50,000;43;26;17;449;451;2
513890;The Frostrune;Action, Indie;50,000 - 100,000;314;29;285;0;0;0
513910;C.A.R.L.;Racing, Simulation, Sports;0 - 20,000;18;1;17;0;0;5
513920;Desperate Times;Casual, Free to Play, Indie, Simulation, Strategy;0 - 20,000;8;2;6;0;0;0
513930;J.U.R : Japan Underground Racing;Casual, Simulation;50,000 - 100,000;66;83;-17;0;0;1
513960;Galactic Fighters;Action, Indie;0 - 20,000;10;1;9;3;3;0
513980;Oh No! Bugs!;Casual, Indie, Simulation;50,000 - 100,000;90;20;70;240;261;1
513990;Happy Empire;Action, Indie;0 - 20,000;34;30;4;0;0;0
514010;Football Mogul 15;Action, Indie;0 - 20,000;21;12;9;0;0;0
514050;Uprising 2: Lead and Destroy;Adventure, Indie, RPG;0 - 20,000;13;3;10;0;0;0
514080;Deadly Dozen;Action, Early Access;20,000 - 50,000;34;12;22;1;1;0
514090;Beautiful Japanese Scenery - Animated Jigsaws;Action, Adventure, Casual, Indie;50,000 - 100,000;185;25;160;242;242;19
514130;European Air War;Indie;0 - 20,000;23;4;19;0;0;2
514140;Elite Warriors: Vietnam;Action, Adventure, Casual, Indie, Simulation;0 - 20,000;18;15;3;1;1;0
514150;Line of Sight: Vietnam;Action, Casual, Indie;0 - 20,000;51;20;31;30;30;0
514160;18 Wheels of Steel: Across America;Strategy;0 - 20,000;122;16;106;9;9;1
514170;18 Wheels of Steel: Convoy;Action, Adventure, Strategy;0 - 20,000;57;19;38;21;21;3
514180;18 Wheels of Steel: Haulin’;Casual, Indie, Strategy;0 - 20,000;70;11;59;158;158;1
514200;Mythic Victory Arena;Adventure, Casual, Indie, RPG, Strategy;20,000 - 50,000;4;2;2;0;0;0
514220;Super GunWorld 2;Indie, Strategy;0 - 20,000;8;5;3;363;363;0
514240;ALONE?;Adventure, Casual, Indie;0 - 20,000;68;106;-38;170;170;0
514290;Factory Engineer;Action, Adventure, Indie;20,000 - 50,000;60;69;-9;90;174;0
514310;SENRAN KAGURA Bon Appétit! - Full Course;Action, Indie;20,000 - 50,000;827;64;763;0;0;5
514340;Aliens Go Home Run;Action, Adventure, Indie, Early Access;0 - 20,000;65;6;59;0;0;0
514340;Aliens Go Home Run;Action, Casual, Indie, Sports;0 - 20,000;65;6;59;0;0;0
514350;Fancy Slingshot VR;Action, Adventure, Indie, RPG;0 - 20,000;8;4;4;0;0;0
514360;Freedom Fighter;Violent, Gore, Action;20,000 - 50,000;37;17;20;281;291;12
514370;DragonBlast VR;Adventure, Indie, RPG;0 - 20,000;7;2;5;0;0;0
514390;PooShooter: Toilet Invaders;Indie, Simulation, Early Access;20,000 - 50,000;69;24;45;3;3;0
514400;Legends of Time;Action, Indie;0 - 20,000;15;9;6;0;0;0
514410;Gun Brothers;Action, Adventure, Casual, Indie;0 - 20,000;37;60;-23;14;14;0
514460;Cyberline Racing;Action, Indie;100,000 - 200,000;88;54;34;148;196;1
514470;Fantastic 4 In A Row 2;Action, Adventure, Free to Play, Indie, Massively Multiplayer, RPG, Strategy;20,000 - 50,000;54;44;10;179;201;0
514480;Fantastic Checkers 2;Action, Casual;50,000 - 100,000;37;63;-26;292;316;0
514490;Ultimate Word Search 2: Letter Boxed;Action, Adventure, Strategy, Early Access;50,000 - 100,000;32;52;-20;180;206;0
514500;Atomic Society;Action, Adventure, Indie;50,000 - 100,000;375;175;200;309;309;1
514510;Unreal Heroes;Adventure, Indie;0 - 20,000;0;1;-1;0;0;0
514520;Sparky's Hunt;Indie, Simulation, Strategy;0 - 20,000;6;2;4;1;1;0
514530;Rally Racers;Action, Casual, Indie, Racing, Strategy;0 - 20,000;3;0;3;0;0;0
514540;HFH Discontinued  [Upgrading to 3D and Leaving Steam];Action, Indie, Early Access;0 - 20,000;8;1;7;259;270;0
514550;Beat The Dictators;Adventure, Casual, Indie;0 - 20,000;10;21;-11;0;0;0
514570;Pinball Parlor;Action, Adventure, Casual, RPG, Simulation;0 - 20,000;11;9;2;0;0;0
514580;Cooking Witch;Adventure, Casual, Indie, Early Access;50,000 - 100,000;198;25;173;217;243;0
514620;Ellipsis;Adventure, Casual, Indie;0 - 20,000;218;12;206;43;65;1
514640;TankYou!;Action, Simulation;0 - 20,000;11;2;9;0;0;0
514650;Orbital X;Casual, Strategy;0 - 20,000;37;5;32;196;329;0
514660;BitMaster;Indie, Racing, Simulation, Early Access;100,000 - 200,000;128;64;64;211;209;1
514670;Satellite Command;Action, Indie;20,000 - 50,000;52;27;25;0;0;1
514700;Mystery Case Files: 13th Skull Collector's Edition;Action, Adventure, Casual, Indie, RPG;50,000 - 100,000;80;15;65;0;0;3
514720;Dark Tales: Edgar Allan Poe's The Masque of the Red Death Collector's Edition;Action, Indie;0 - 20,000;6;1;5;0;0;0
514730;Hidden Expedition: Dawn of Prosperity Collector's Edition;Adventure, Indie;0 - 20,000;5;0;5;0;0;0
514740;Final Cut: Death on the Silver Screen Collector's Edition;Indie;0 - 20,000;4;0;4;0;0;0
514750;Nightmare Adventures: The Witch's Prison;Action, Casual, Indie, Strategy;0 - 20,000;17;2;15;0;0;0
514760;Spirits of Mystery: Amber Maiden Collector's Edition;Sports, Early Access;0 - 20,000;6;0;6;0;0;0
514770;Grave Mania: Pandemic Pandemonium;Adventure, Casual, Indie;0 - 20,000;5;0;5;0;0;1
514810;Eldritch Hunter;Action, Casual, Indie, Simulation;0 - 20,000;35;8;27;0;0;0
514820;Wasps!;Action, Adventure, Indie, Simulation, Early Access;0 - 20,000;6;3;3;0;0;0
514870;Fat City;Action, Indie;0 - 20,000;3;0;3;0;0;0
514890;Super Jagua;Sexual Content, Nudity, Casual, Indie;0 - 20,000;79;14;65;218;218;1
514900;>observer_;Violent, Gore, Action, Adventure, Indie;500,000 - 1,000,000;4524;1190;3334;403;332;4
514920;Crash Wheels;Action, Indie, Simulation, Strategy, Early Access;100,000 - 200,000;952;148;804;145;128;3
514930;Super Hop 'N' Bop ULTRA;Action, Casual, Indie, Strategy;0 - 20,000;6;4;2;0;0;0
514970;Drive Megapolis;Action, Adventure, Casual;200,000 - 500,000;115;178;-63;234;231;0
514990;Outbreak;Casual, Indie, Simulation, Strategy;100,000 - 200,000;73;44;29;348;361;0
515000;PANIC at Multiverse High!;Indie;0 - 20,000;11;2;9;0;0;0
515010;A Duel Hand Disaster: Trackher;Action, Indie;0 - 20,000;28;2;26;0;0;0
515020;The VR Museum of Fine Art;Casual, Indie, Simulation;50,000 - 100,000;265;28;237;17;23;2
515040;Make America Great Again: The Trump Presidency;Animation & Modeling, Design & Illustration, Utilities, Video Production, Early Access;50,000 - 100,000;1553;240;1313;149;120;2
515060;Third Eye;Action, Indie;0 - 20,000;8;3;5;0;0;0
515180;Bus Simulator 18;Action, Indie;500,000 - 1,000,000;9236;2197;7039;901;620;226
515200;Cliff Hanger;Sports;0 - 20,000;1;5;-4;0;0;0
515220;F1 2017;Casual;200,000 - 500,000;5137;759;4378;6844;1809;62
515230;Cleo's Lost Idols;Adventure, Indie, RPG;0 - 20,000;24;15;9;0;0;0
515260;Virtual Rides 3 - Funfair Simulator;Simulation, Strategy, Early Access;50,000 - 100,000;593;86;507;2767;2767;5
515470;Hyper color ball;Action, Adventure, Early Access;200,000 - 500,000;138;171;-33;220;217;1
515570;UBERMOSH Vol.3;Casual, Simulation;20,000 - 50,000;244;30;214;0;0;0
515650;Straimium Immortaly;Action, Adventure, Indie;0 - 20,000;143;12;131;0;0;0
515690;Warriors of Vilvatikta;Action, Casual, Indie;500,000 - 1,000,000;70;74;-4;275;237;0
515700;Snowday;Action, Strategy;0 - 20,000;13;3;10;0;0;0
515740;Radical Heroes: Crimson City Crisis;Action, Indie, RPG;0 - 20,000;16;8;8;0;0;1
515890;Marty Thinks 4D;Adventure, Casual;0 - 20,000;6;0;6;0;0;0
515900;ROCK;Indie, RPG, Simulation, Strategy;0 - 20,000;4;7;-3;0;0;0
515910;Hooligan Vasja;Violent, Adventure, Indie;50,000 - 100,000;108;63;45;275;297;1
515960;Martha Is Dead;Action, Adventure, Indie, Strategy;100,000 - 200,000;1812;425;1387;314;375;15
515980;The Horus Heresy: Battle of Tallarn - Iron Edition;Casual, Indie;20,000 - 50,000;36;37;-1;0;0;0
516000;Candy Thieves - Tale of Gnomes;Action, Indie;0 - 20,000;3;0;3;0;0;0
516010;Board Defenders;Action, Simulation, Strategy;0 - 20,000;18;1;17;190;229;0
516030;Insane Robots;Action, Indie;0 - 20,000;20;4;16;0;0;0
516040;Everything is Peachy;Adventure, Casual, Indie, Simulation, Strategy;20,000 - 50,000;13;9;4;0;0;0
516110;ToeJam & Earl: Back in the Groove!;Action, Casual, Indie;100,000 - 200,000;863;97;766;107;155;11
516120;Juno's Darkest Hour;Action, Adventure;0 - 20,000;15;2;13;0;0;0
516130;Runner3;Action, Indie;20,000 - 50,000;192;60;132;288;575;2
516250;Skynet Rising : Portal to the Past;Action, Adventure, Casual, Indie, Early Access;0 - 20,000;10;16;-6;0;0;0
516410;Football Blitz;Adventure;0 - 20,000;24;10;14;324;397;0
516410;Football Blitz;Racing;0 - 20,000;24;10;14;324;397;0
516430;Ruin of the Reckless;Adventure, Indie, RPG, Strategy, Early Access;0 - 20,000;62;14;48;0;0;0
516440;Alien Rampage;Casual, Indie;0 - 20,000;33;14;19;0;0;0
516450;Glory by Example;Indie, Strategy;0 - 20,000;7;0;7;0;0;0
516460;50 Years;Simulation, Strategy;0 - 20,000;1;1;0;0;0;0
516470;CRAPPY ZOMBIE GAME;Simulation, Strategy;0 - 20,000;20;12;8;0;0;0
516480;Pinkman;Action, Casual;20,000 - 50,000;516;12;504;130;247;2
516500;Zissi's Island;Adventure;0 - 20,000;15;2;13;0;0;0
516510;Orake Classic;Casual, Indie;200,000 - 500,000;456;190;266;60;14;5
516530;Chaos Of Hearts;Action, Indie;0 - 20,000;2;2;0;0;0;0
516550;Relativity;Action, Casual, Indie, Simulation;0 - 20,000;12;1;11;0;0;0
516560;The Odyssey;Simulation, Early Access;0 - 20,000;14;6;8;247;247;0
516570;ADAPTR;Action, Indie, Early Access;0 - 20,000;20;1;19;0;0;0
516580;DYSTORIA;Action, Early Access;0 - 20,000;47;3;44;0;0;0
516590;CyberThreat;Sports, Early Access;0 - 20,000;71;26;45;1;1;0
516600;Bai Qu: Hundreds of Melodies;Casual, Indie, Simulation, Sports, Strategy;20,000 - 50,000;632;23;609;1;1;0
516610;Guardian war VR;;0 - 20,000;8;4;4;0;0;0
516640;A Large Quantity Of Mushrooms;Action, Adventure, Indie, Simulation, Early Access;0 - 20,000;3;1;2;0;0;0
516650;Preston Sterling;Action, Adventure, Casual;0 - 20,000;13;11;2;0;0;0
516680;Flying Baron 1916;Adventure, Indie, Simulation;0 - 20,000;0;6;-6;0;0;0
516740;Elves vs Goblins Defender;Casual, Indie, Strategy;0 - 20,000;1;1;0;0;0;0
516750;My Summer Car;Action, Indie, Simulation, Early Access;1,000,000 - 2,000,000;47685;3028;44657;2231;1027;1644
516790;Fat Mask;Action, Adventure, Indie, Early Access;0 - 20,000;20;4;16;0;0;1
516810;The Garden;Adventure, Indie;;;;0;;;
516820;Exodemon;Casual, Indie;0 - 20,000;51;2;49;0;0;0
516840;The Tale of Doris and the Dragon - Episode 1;Adventure, Indie;20,000 - 50,000;64;4;60;0;0;0
516870;Isomorph;Casual, Indie, Early Access;0 - 20,000;1;1;0;0;0;0
516890;Alchemic Jousts;Action, Indie;0 - 20,000;32;5;27;0;0;0
516900;Oniris Basket VR;Action, Adventure, Indie;0 - 20,000;5;0;5;0;0;0
516920;Veilia;Action, Casual, Free to Play, RPG;0 - 20,000;7;6;1;0;0;0
516940;MineSweeper VR;Action, Indie, Simulation;0 - 20,000;34;8;26;0;0;0
516950;STARS Simulation;Action, Casual, Indie;20,000 - 50,000;5;7;-2;272;275;0
516960;B.C.E.;Utilities;0 - 20,000;4;2;2;0;0;0
517000;Sakura Shrine Girls;Action, Simulation;0 - 20,000;191;60;131;212;216;1
517010;Aztecalypse;Action, Indie;50,000 - 100,000;28;32;-4;205;221;0
517020;Virtual Warfighter;Indie;0 - 20,000;44;26;18;0;0;0
517060;Day of the Trumplings;Adventure, Simulation, Sports;0 - 20,000;9;11;-2;0;0;0
517100;Funk Unplugged;Action, Adventure, Indie;0 - 20,000;14;3;11;0;0;0
517110;Cards of Chaos;Violent, Gore, Action, Indie, Simulation;0 - 20,000;12;4;8;82;82;0
517130;Soundboxing;Indie, Strategy;50,000 - 100,000;498;68;430;451;662;0
517140;POLYCRUSHER;Indie;0 - 20,000;13;10;3;0;0;0
517160;Richie's Plank Experience;Action, Adventure, Indie, RPG;50,000 - 100,000;467;109;358;175;202;14
517170;Tvori;Action, Adventure, Free to Play, Indie;0 - 20,000;49;16;33;0;0;0
517190;Rebound;Adventure, Casual, Indie;0 - 20,000;6;1;5;0;0;1
517210;Bad Pad;Adventure, Free to Play, RPG;0 - 20,000;38;4;34;0;0;1
517220;Balls! Virtual Reality Cricket;Casual, Indie, Simulation, Strategy;0 - 20,000;22;9;13;0;0;0
517230;Spinning Maze;Action, Indie, RPG;0 - 20,000;14;2;12;0;0;0
517240;Machinations: Fog of War;Adventure, Casual, Indie;0 - 20,000;3;6;-3;0;0;0
517270;Pro Farm Manager;Casual, Sports;0 - 20,000;10;18;-8;0;0;0
517280;ZEscape;Casual, Sports;0 - 20,000;12;6;6;0;0;0
517300;Publisher Tycoon;Action, Sports;0 - 20,000;6;5;1;0;0;0
517320;GunGirl 2;Action, Indie;20,000 - 50,000;123;13;110;2;2;1
517330;Stellar Interface;Casual, Indie;20,000 - 50,000;160;30;130;0;0;1
517340;Tank Tread;Action, Casual, Indie;0 - 20,000;2;3;-1;0;0;0
517350;Squareface;Casual, Indie;0 - 20,000;59;16;43;0;0;0
517360;The Secret Order 4: Beyond Time;Casual, Indie, Simulation, Strategy;20,000 - 50,000;134;71;63;485;767;3
517370;Tavernier;Casual, Indie, Strategy;20,000 - 50,000;136;39;97;0;0;1
517400;VR Amazing Files: Horror Hospital;Racing, Simulation, Early Access;0 - 20,000;13;18;-5;0;0;0
517460;SteamHammerVR - The Rogue Apprentice;Utilities;0 - 20,000;21;14;7;0;0;0
517470;King of Booze: Drinking Game;Adventure, Indie, RPG;0 - 20,000;38;11;27;204;261;4
517480;VHSoverdose;Action, Adventure, Indie, Early Access;0 - 20,000;1;3;-2;0;0;0
517500;Tactics: Bludgeons Blessing;Adventure, Indie, RPG;0 - 20,000;0;4;-4;0;0;0
517510;Flatshot;Accounting, Animation & Modeling, Audio Production, Design & Illustration, Education, Photo Editing, Software Training, Utilities, Video Production, Web Publishing;0 - 20,000;8;4;4;0;0;0
517550;The Enlightened League of Bone Builders and the Osseous Enigma;Action, Casual, Indie, Early Access;0 - 20,000;23;8;15;0;0;0
517620;Gooblins;Action, Indie;0 - 20,000;9;2;7;0;0;0
517630;Just Cause 4 Reloaded;Simulation;1,000,000 - 2,000,000;15094;9534;5560;1317;892;373
517660;Drop Out 0;Action, Indie, Simulation, Strategy;0 - 20,000;11;3;8;270;270;0
517670;Cowbots and Aliens;Action, Adventure, Indie, RPG;0 - 20,000;82;14;68;0;0;0
517680;A dead world's dream;Education;0 - 20,000;32;11;21;0;0;0
517680;A dead world's dream;Casual, Indie, Simulation;0 - 20,000;32;11;21;0;0;0
517710;Redout: Enhanced Edition;Indie, Racing;200,000 - 500,000;3701;635;3066;376;200;6
517720;Epic Tavern;Action;0 - 20,000;197;110;87;0;0;0
517770;Caketomino;Casual, Indie;0 - 20,000;0;1;-1;0;0;0
517780;Ogre;Action, Casual, Indie;0 - 20,000;140;70;70;0;0;1
517790;Caesar 3;Casual, Indie, RPG, Simulation;200,000 - 500,000;1363;119;1244;51;76;177
517810;Caesar IV;Action, Indie, Massively Multiplayer, Early Access;100,000 - 200,000;422;179;243;418;420;57
517860;Fly to KUMA MAKER;Casual, Indie, Strategy;0 - 20,000;8;0;8;0;0;0
517910;Sisyphus Reborn;Adventure, Casual, Indie, RPG, Simulation;50,000 - 100,000;863;67;796;0;0;0
517930;The Castles of Dr. Creep;Strategy;0 - 20,000;42;4;38;58;58;0
517960;Crate Punks;Action, Adventure, Indie, Early Access;0 - 20,000;5;1;4;0;0;0
517970;CRANGA!: Harbor Frenzy;Action, Indie;0 - 20,000;21;1;20;0;0;0
517990;City VR;Casual, Indie, Strategy;0 - 20,000;8;6;2;0;0;0
518000;Edge Guardian;Adventure, Casual, Indie;0 - 20,000;9;0;9;0;0;0
518030;Aim Hero;Action, Indie;200,000 - 500,000;5162;868;4294;277;89;14
518040;Volleyball Unbound - Pro Beach Volleyball;Action, RPG, Simulation;20,000 - 50,000;149;12;137;0;0;5
518060;Chess Ultra;Adventure, Indie, RPG, Strategy;100,000 - 200,000;1273;419;854;235;351;22
518110;Ahros: One Warrior Chronicle;Utilities;0 - 20,000;15;15;0;80;80;0
518120;Chimpact 1 - Chuck's Adventure;Adventure, Casual, Indie, Simulation;20,000 - 50,000;148;54;94;5;8;0
518130;How to shoot a criminal;Action, Free to Play, Indie, Massively Multiplayer, Racing, Simulation, Early Access;0 - 20,000;24;8;16;0;0;0
518140;Lectrovolt II;Adventure, Free to Play, Indie, RPG;0 - 20,000;5;4;1;0;0;0
518150;Intruder;Casual, Indie, Simulation, Sports, Early Access;200,000 - 500,000;4772;514;4258;546;510;158
518190;Sky Jac;Racing, Simulation, Sports;0 - 20,000;10;7;3;0;0;0
518280;Dead End Junction;Action, Indie, Massively Multiplayer, Simulation;0 - 20,000;34;11;23;0;0;1
518320;Soko Match;Adventure, Indie;0 - 20,000;24;9;15;0;0;0
518580;Accounting (Legacy);Action, Adventure, Casual, Indie;200,000 - 500,000;2294;164;2130;36;36;0
518610;Live In Color;Simulation, Strategy;0 - 20,000;6;2;4;0;0;0
518620;Ballistick;Action, Adventure, Indie;50,000 - 100,000;68;155;-87;129;129;2
518650;illumine;Casual, Indie, Strategy;0 - 20,000;50;7;43;113;113;0
518670;Intensive Exposure;Indie;20,000 - 50,000;152;24;128;12;12;0
518680;Kapsul Infinite;Indie, Simulation, Strategy, Early Access;0 - 20,000;5;1;4;0;0;0
518690;Seventh Knight PC Security;Adventure, Free to Play, Indie, RPG;0 - 20,000;18;16;2;0;0;0
518720;Overkill VR: Action Shooter FPS;Indie;20,000 - 50,000;194;71;123;77;77;0
518730;Zombo Buster Rising;Violent, Action, Indie, Strategy;20,000 - 50,000;415;32;383;192;196;1
518740;Why is the Princess in a Magic Forest?!;Casual, Indie;0 - 20,000;1;0;1;0;0;0
518790;theHunter: Call of the Wild;Action, Indie, Simulation;2,000,000 - 5,000,000;111713;15696;96017;1363;398;5911
518800;Lone Leader;Indie, RPG;200,000 - 500,000;122;223;-101;339;340;1
518920;Surgeon Simulator: Experience Reality;Action, Casual, Indie, Sports, Early Access;50,000 - 100,000;411;412;-1;74;37;4
519020;Shuttle Siege;Casual, Indie;0 - 20,000;16;7;9;0;0;0
519030;Don't Let Go!;Casual, Indie;0 - 20,000;44;22;22;0;0;0
519080;Soda Girls;Adventure, Indie;20,000 - 50,000;265;39;226;0;0;0
519140;Minds Eyes;Indie;200,000 - 500,000;1123;459;664;50;49;6
519160;Toon Ocean VR;Indie;0 - 20,000;9;5;4;0;0;0
519170;The Journey Home;Casual, Free to Play, Indie, Simulation;0 - 20,000;16;16;0;0;0;0
519180;Streamer Simulator;Sexual Content, Nudity, Casual, Indie;0 - 20,000;9;39;-30;0;0;0
519190;Next Day: Survival;Action, Adventure, Casual, Indie;500,000 - 1,000,000;6377;3745;2632;785;524;13
519200;Kitty Kitty Boing Boing: the Happy Adventure in Puzzle Garden!;Adventure, Casual, Indie;0 - 20,000;17;5;12;43;43;0
519490;NBA 2KVR Experience;Adventure, Indie, Strategy;0 - 20,000;5;11;-6;0;0;0
519540;Virtual Islands;Casual, Free to Play, Indie;0 - 20,000;5;1;4;0;0;0
519550;SPACE DVRTS;Indie;0 - 20,000;0;1;-1;0;0;0
519860;DUSK;Sexual Content, Action, Adventure, Indie, RPG;1,000,000 - 2,000,000;17499;398;17101;284;176;88
519870;Flying Pengy;Action, Casual, Indie;20,000 - 50,000;64;11;53;199;199;8
519890;Star Boss;Strategy;20,000 - 50,000;11;2;9;209;218;0
519940;Kubz VR;Strategy;0 - 20,000;18;7;11;0;0;0
519980;Trains VR;Strategy;0 - 20,000;19;5;14;0;0;0
519990;Zenza;Strategy;0 - 20,000;3;17;-14;1;1;0
520010;Climbey;Strategy;20,000 - 50,000;1027;104;923;96;106;2
520040;LUMEN;Strategy;0 - 20,000;5;2;3;0;0;0
520080;Your Star;Strategy;0 - 20,000;3;4;-1;0;0;0
520120;Vanguard V;RPG;0 - 20,000;10;5;5;0;0;0
520150;A Midsummer Night's Choice;Strategy;0 - 20,000;22;4;18;0;0;0
520210;DreamDesk VR;Strategy;0 - 20,000;5;9;-4;0;0;0
520230;TwinForce;Strategy;0 - 20,000;7;0;7;0;0;0
520250;Visitors;RPG;20,000 - 50,000;37;37;0;26;26;0
520270;Thrills & Chills - Roller Coasters;Strategy;0 - 20,000;42;21;21;0;0;1
520290;Fright Light;Free to Play, Indie, Simulation, Strategy;0 - 20,000;36;9;27;0;0;0
520300;Underworld Dungeon;Casual, Indie, Simulation;0 - 20,000;6;1;5;0;0;0
520350;Remembering Pearl Harbor;Action, Adventure;0 - 20,000;5;4;1;0;0;0
520370;Pigeon Fight;Web Publishing;0 - 20,000;10;3;7;103;103;0
520380;Camper Jumper Simulator;Adventure, Indie, Strategy;20,000 - 50,000;31;54;-23;37;37;0
520440;GUILTY GEAR Xrd REV 2;Gore, Action, Casual, Indie;500,000 - 1,000,000;8190;529;7661;1604;199;288
520470;Music Inside: A VR Rhythm Game;Action, Indie;20,000 - 50,000;37;16;21;0;0;0
520510;Tribocalypse VR;Action, Adventure, Indie;0 - 20,000;8;2;6;0;0;0
520530;INTERSHELTER;Violent, Action;50,000 - 100,000;698;350;348;299;338;0
520540;Tribloos 3;Gore, Action, Adventure, Indie;0 - 20,000;15;1;14;0;0;0
520600;Purrfect Date - Visual Novel/Dating Simulator;Action, Indie;20,000 - 50,000;275;178;97;48;67;2
520610;Drive on Moscow;Action, Indie;20,000 - 50,000;64;15;49;0;0;4
520660;Wrack: Exoverse;Action, Adventure, Casual, Indie, Simulation;0 - 20,000;29;12;17;120;120;0
520670;Strikers Edge;Action, Indie;20,000 - 50,000;76;35;41;0;0;0
520680;Lost Cities;Indie, Strategy;0 - 20,000;11;14;-3;0;0;0
520720;Dear Esther: Landmark Edition;Action, Indie, RPG;200,000 - 500,000;3888;1338;2550;190;30;8
520750;DWVR;Action, Adventure, Indie, RPG;0 - 20,000;17;1;16;0;0;0
520810;Metal Noise;Action, Adventure, Simulation;0 - 20,000;2;4;-2;0;0;0
520820;Dawn's Light;Action, Adventure, Indie;0 - 20,000;39;6;33;0;0;0
520840;Gaming Accelerator 2;Casual, Strategy;0 - 20,000;10;9;1;0;0;0
520850;Lost in Secular Love;Indie, RPG, Early Access;20,000 - 50,000;377;48;329;0;0;1
520860;Impulse of War;Adventure;100,000 - 200,000;292;155;137;56;81;0
520910;Kokurase Episode 1;Action, Indie;20,000 - 50,000;117;12;105;50;52;0
520930;Pong It! VR;Action, Adventure, Indie;0 - 20,000;15;2;13;0;0;0
520940;MX vs ATV All Out;Casual, Free to Play, Sports;100,000 - 200,000;1120;287;833;418;579;19
520950;DRIFT21;Action, Adventure, Sports;50,000 - 100,000;1432;497;935;488;712;34
520990;Barrow Hill: The Dark Path;Action;0 - 20,000;92;29;63;3427;3427;0
521000;Globe Rush;Adventure, Indie;0 - 20,000;5;2;3;0;0;0
521100;MinosMaze - The Minotaur's Labyrinth;Action, Casual, Indie, Simulation, Sports, Early Access;20,000 - 50,000;32;26;6;225;225;0
521130;Dots eXtreme;Adventure, Indie, RPG, Strategy;50,000 - 100,000;84;12;72;236;241;0
521140;King Machine;Adventure, Indie, Strategy;0 - 20,000;1;2;-1;0;0;0
521150;Another Brick in The Mall;Action, Casual, Indie;100,000 - 200,000;1768;341;1427;696;769;21
521200;Epic Battle Fantasy 3;Adventure, Casual, Indie, RPG;200,000 - 500,000;1721;57;1664;512;557;17
521210;Timore 5;Adventure, Indie, Simulation;0 - 20,000;79;23;56;18;18;0
521230;Stone Age Wars;Indie;20,000 - 50,000;137;64;73;239;233;0
521280;Atlantis: Pearls of the Deep;Indie, RPG;0 - 20,000;60;10;50;380;380;0
521280;Atlantis: Pearls of the Deep;Casual, Free to Play, Indie, Simulation, Sports;0 - 20,000;60;10;50;380;380;0
521300;The Electric Shocktopus;Adventure;0 - 20,000;7;0;7;0;0;0
521330;Skull Ball Heroes;Violent, Indie;20,000 - 50,000;45;15;30;30;30;0
521340;True or False;Adventure, Indie;100,000 - 200,000;880;433;447;17;17;0
521350;Use Your Words;Action, Casual, Indie, Simulation, Early Access;100,000 - 200,000;641;82;559;319;278;29
521390;RhythmSlinger;Action;0 - 20,000;2;1;1;0;0;0
521420;Bunka no Kenkyu - Revival of Queen Leyak -;Adventure;0 - 20,000;6;9;-3;0;0;0
521430;Super Switch;Action, Indie;20,000 - 50,000;80;19;61;296;362;29
521450;Hunted: One Step Too Far - Reborn Edition;Action, Indie;0 - 20,000;32;25;7;5;5;0
521470;Magical Otoge Ciel;Action;50,000 - 100,000;211;18;193;2;2;2
521500;Sakura Space;Action, Indie, Early Access;50,000 - 100,000;237;69;168;170;233;1
521510;MAGICAL×SPIRAL;Simulation, Early Access;0 - 20,000;17;3;14;0;0;0
521540;This World Unknown;Casual, Indie;0 - 20,000;32;11;21;0;0;0
521540;This World Unknown;Simulation;0 - 20,000;32;11;21;0;0;0
521560;The Mystery Of Woolley Mountain;Action, Indie, Simulation;0 - 20,000;48;8;40;0;0;0
521570;You Have 10 Seconds 2;Animation & Modeling, Design & Illustration, Early Access;100,000 - 200,000;597;63;534;20;16;2
521580;Where are my Internets?;Casual, Indie, Strategy;20,000 - 50,000;60;26;34;0;0;0
521590;Subterra;Casual, Indie, Early Access;50,000 - 100,000;73;37;36;175;219;1
521620;Alchemist Adventure;Action, Casual, Indie, Sports, Early Access;20,000 - 50,000;78;16;62;0;0;0
521630;Toadled;Action, Casual, Indie, Sports;20,000 - 50,000;327;57;270;333;294;0
521650;Genghis Khan;Audio Production, Video Production;20,000 - 50,000;5;3;2;0;0;2
521660;NOBUNAGA'S AMBITION: Zenkokuban;Video Production;20,000 - 50,000;5;2;3;0;0;4
521670;Romance of the Three Kingdoms;Video Production;20,000 - 50,000;15;3;12;0;0;0
521680;Bandit Kings of Ancient China;Casual, Indie;20,000 - 50,000;17;5;12;0;0;19
521690;Romance of the Three Kingdoms II;Casual, Indie;20,000 - 50,000;16;2;14;0;0;25
521700;NOBUNAGA'S AMBITION: Sengoku Gunyuuden;Indie, Simulation;0 - 20,000;1;5;-4;0;0;3
521710;Romance of the Three Kingdoms III;Action, Casual, Indie;20,000 - 50,000;9;10;-1;0;0;0
521720;Uncharted Waters;Adventure, Free to Play, Massively Multiplayer, RPG;0 - 20,000;22;3;19;0;0;4
521730;Romance of the Three Kingdoms IV with Power Up Kit;Casual, Indie;20,000 - 50,000;17;13;4;0;0;6
521740;NOBUNAGA'S AMBITION: Bushou Fuunroku;Education, Utilities;20,000 - 50,000;9;1;8;0;0;0
521750;Romance of the Three Kingdoms V with Power Up Kit;Animation & Modeling, Audio Production, Design & Illustration, Education, Software Training, Video Production;20,000 - 50,000;58;13;45;0;0;22
521760;Taiko Risshiden;Action, Adventure, Casual, Indie, Early Access;0 - 20,000;38;6;32;0;0;3
521790;Ancient Frontier;Action, Indie, Early Access;0 - 20,000;79;42;37;311;311;1
521860;Lop Nor Zombie VR (HTC Vive);Casual, Indie, Racing;0 - 20,000;41;16;25;0;0;0
521880;RPG Maker VX;Design & Illustration, Utilities;20,000 - 50,000;101;16;85;21;31;9
521890;Hello Neighbor;Action, Indie;500,000 - 1,000,000;8984;2197;6787;1165;370;175
521920;Death's Hangover;Action, Adventure, Indie, Simulation;20,000 - 50,000;406;51;355;203;203;1
521950;Bullet Sorrow VR;Adventure, Indie;0 - 20,000;230;46;184;0;0;0
521980;Autumn Dream;Action, Adventure, Casual, Sports, Strategy, Early Access;20,000 - 50,000;92;103;-11;232;265;0
521990;Galactic Storm;Action, Adventure, Casual, Indie;0 - 20,000;19;9;10;0;0;0
522000;Blind Blades;Action, Adventure, Indie, Strategy;0 - 20,000;5;1;4;0;0;0
522010;Lost Crew;Action, Indie, Simulation, Sports;50,000 - 100,000;39;6;33;299;315;0
522020;Blue Effect VR;Action;0 - 20,000;108;27;81;0;0;0
522030;Eclipse: New Dawn for the Galaxy;Adventure, Casual, Indie;0 - 20,000;76;41;35;0;0;0
522040;Princess Remedy 2: In A Heap of Trouble;Action, Free to Play, Indie, Massively Multiplayer, Strategy;20,000 - 50,000;541;52;489;298;298;0
522070;Abstract Initiative;Indie, Massively Multiplayer, RPG, Strategy, Early Access;0 - 20,000;0;0;0;0;0;0
522080;Gemstone Keeper;Action, Adventure, Indie, Massively Multiplayer, RPG;0 - 20,000;7;5;2;0;0;0
522090;Medieval Defenders;Adventure, Casual, Indie, RPG, Simulation;200,000 - 500,000;81;141;-60;322;366;11
522130;LandTraveller;Adventure, Indie;20,000 - 50,000;43;3;40;0;0;0
522200;Loading Human: Chapter 1;Action, Casual;0 - 20,000;13;27;-14;0;0;0
522210;Serial Cleaner;Action, Casual, Indie, Racing;500,000 - 1,000,000;2440;389;2051;267;274;19
522220;InMind 2 VR;Action, Casual, Indie;0 - 20,000;19;8;11;0;0;0
522230;The Fishing Club 3D;Casual, Indie;100,000 - 200,000;360;115;245;680;1295;103
522240;Pool Panic;Adventure, Casual, Indie, RPG;20,000 - 50,000;247;68;179;116;166;0
522250;Quick Draw;Action, Casual, Indie;0 - 20,000;23;14;9;0;0;0
522300;Polywings;Violent, Gore, Action, Indie;0 - 20,000;14;6;8;0;0;0
522340;Ghostlords;Action, Indie;20,000 - 50,000;64;3;61;220;232;0
522470;The House of Da Vinci;Indie, Strategy, Early Access;200,000 - 500,000;4086;510;3576;383;445;43
522490;Carrie's Order Up!;Action, Adventure, Free to Play, Indie;0 - 20,000;123;4;119;217;217;0
522530;Revenant Saga;Action, Indie;0 - 20,000;15;6;9;0;0;0
522570;The Last Hope;Casual, Indie, Strategy;100,000 - 200,000;353;556;-203;212;215;0
522590;Near Midnight;Action, Adventure, Indie, Simulation;0 - 20,000;21;28;-7;0;0;0
522610;Lord of the Seal;Adventure, Indie, RPG;0 - 20,000;10;4;6;0;0;0
522660;Snooker-online multiplayer snooker game!;Action, RPG;20,000 - 50,000;47;75;-28;0;0;3
522690;In Fear I Trust;Action, Indie;0 - 20,000;23;26;-3;46;46;0
522690;In Fear I Trust;Adventure, Indie, RPG;0 - 20,000;23;26;-3;46;46;0
522700;The Final Days: I'm Still Alive;Action, Casual, Indie;0 - 20,000;6;3;3;0;0;0
522710;Virtual Escape: The Play Room;Action, Indie, Early Access;0 - 20,000;31;1;30;0;0;0
522730;God Of Arrows VR;Action, Adventure, Indie, RPG, Simulation, Early Access;0 - 20,000;32;10;22;0;0;0
522740;Oh My Godheads;Utilities;0 - 20,000;15;21;-6;280;280;0
522880;PSYCHO-PASS: Mandatory Happiness;Action, Adventure, Casual, Indie;0 - 20,000;121;27;94;342;342;0
522890;Ant-gravity: Tiny's Adventure;Animation & Modeling, Design & Illustration, Utilities;0 - 20,000;14;4;10;0;0;0
522900;When It Hits the Fan;Adventure, Indie, RPG;0 - 20,000;8;0;8;0;0;0
522940;GUN GODZ;Adventure, Indie, RPG;50,000 - 100,000;519;75;444;13;13;0
522950;Mayhem ZX;Adventure, Indie, RPG;0 - 20,000;6;2;4;0;0;0
522960;Airship Commander;Adventure, RPG;0 - 20,000;3;5;-2;0;0;0
522990;Spell Casting: Meowgically Enhanced Edition;Adventure, Casual;0 - 20,000;19;5;14;0;0;1
523000;Princess Maker 2 Refine;Action, Casual, Indie, Simulation, Sports;100,000 - 200,000;1248;93;1155;313;620;24
523030;Tank Universal 2;Action, Indie;0 - 20,000;34;7;27;0;0;0
523050;Artstage;Action, Indie;0 - 20,000;14;0;14;0;0;0
523060;Planet Smasher;Animation & Modeling, Design & Illustration, Utilities, Video Production;0 - 20,000;13;3;10;0;0;0
523070;Black Forest;Indie;20,000 - 50,000;235;70;165;19;19;4
523080;Playground;Adventure, Indie;0 - 20,000;21;21;0;1926;1926;0
523090;Bomb U!;Adventure, Indie;0 - 20,000;47;7;40;0;0;0
523110;VEGAS Movie Studio 14 Steam Edition;Action, Adventure, Free to Play, Massively Multiplayer, RPG;0 - 20,000;90;63;27;0;0;1
523130;MAGIX Fastcut Plus 2017 Steam Edition;Action;0 - 20,000;15;17;-2;0;0;0
523150;Mahjong World Contest (麻将);Casual, Indie, RPG, Simulation;200,000 - 500,000;159;19;140;242;290;19
523160;Alice's Patchworks 2;Action, Adventure, Indie;100,000 - 200,000;205;57;148;257;275;2
523170;ShotForge;Simulation, Strategy;20,000 - 50,000;59;20;39;30;42;0
523180;Doritos VR Battle;Utilities, Video Production;0 - 20,000;11;6;5;0;0;0
523190;Weapons of Mythology - New Age -;Action, Indie, Strategy;20,000 - 50,000;33;51;-18;0;0;0
523210;A Normal Lost Phone;Action, Adventure, Indie;50,000 - 100,000;1938;245;1693;181;211;3
523220;Virtual Race Car Engineer 2016;Action, Adventure, Indie, RPG;0 - 20,000;2;1;1;0;0;0
523410;Ozapell Basic;RPG;0 - 20,000;9;4;5;0;0;0
523440;zTime (Danger Noodles!);Indie, Strategy;0 - 20,000;6;0;6;0;0;0
523550;Defense of Castle Chilly;Action, Indie;0 - 20,000;5;3;2;0;0;0
523570;Across Flash;Indie, Strategy;0 - 20,000;4;1;3;0;0;0
523600;Card Creator;Racing, Early Access;20,000 - 50,000;321;105;216;0;0;51
523610;Beyond Enemy Lines;Action, Indie;0 - 20,000;17;23;-6;0;0;0
523640;The Works of Mercy;Action, Free to Play, Indie;20,000 - 50,000;85;133;-48;4;4;0
523650;Lust for Darkness;Action, Adventure, Indie;100,000 - 200,000;2354;1050;1304;154;197;9
523660;HYPERCHARGE: Unboxed;Audio Production;500,000 - 1,000,000;2963;324;2639;175;179;54
523680;Honey Rose: Underdog Fighter Extraordinaire;Action, Indie;20,000 - 50,000;34;10;24;0;0;0
523710;Sword Master VR;Adventure, Indie, Early Access;20,000 - 50,000;147;59;88;108;108;0
523720;Unruly Ghouls;RPG;0 - 20,000;16;0;16;0;0;0
523730;Sweet Volley High;Action, Adventure, Casual, Indie;20,000 - 50,000;56;23;33;278;278;0
523740;Techwars: Global Conflict;Action, Adventure;50,000 - 100,000;205;90;115;139;171;0
523750;The 4th Coming;Indie, Simulation;0 - 20,000;31;19;12;0;0;7
523760;Loot or Die;Action, Free to Play, Indie;0 - 20,000;29;7;22;0;0;0
523770;Of Bird and Cage;Indie, Sports;100,000 - 200,000;164;43;121;0;0;0
523780;Emily is Away Too;Adventure, Casual, Indie;200,000 - 500,000;4976;339;4637;339;181;8
523810;Wonder Boy Returns;Casual, Indie, Simulation, Early Access;0 - 20,000;62;21;41;0;0;0
523870;Breaking Fast;Action, Casual, Indie, Strategy;0 - 20,000;32;5;27;0;0;0
523880;peakvox Escape Virus HD;Action, Indie;0 - 20,000;3;2;1;0;0;0
523890;StarDrone VR;Action, Adventure, Indie;20,000 - 50,000;2;0;2;0;0;0
523900;Fated Souls 2;Indie, Simulation, Strategy, Early Access;20,000 - 50,000;17;5;12;213;213;0
523940;ZombVR;Adventure, Casual, Indie;0 - 20,000;13;14;-1;0;0;0
523960;TENET;Simulation;20,000 - 50,000;48;17;31;0;0;0
523970;Atomic Butcher: Homo Metabolicus;Action, Adventure, Casual;0 - 20,000;11;1;10;0;0;0
524010;Siege of Centauri;Action, Indie, Racing, Sports, Early Access;50,000 - 100,000;258;140;118;890;1329;0
524030;Machine Learning: Episode I;Action, Adventure, Free to Play, Indie;50,000 - 100,000;52;22;30;172;209;4
524050;Salmon Ninja;Casual, Indie, Strategy;0 - 20,000;15;1;14;0;0;0
524060;Block Wave VR;Action, Casual, Simulation, Sports;0 - 20,000;9;5;4;0;0;0
524110;Emergency 2017;Casual, Indie;200,000 - 500,000;256;136;120;1320;1975;6
524120;Raptor Valley;Simulation, Sports;0 - 20,000;38;9;29;0;0;0
524200;Queen Of Thieves;Sports;0 - 20,000;14;11;3;0;0;0
524220;NieR:Automata;Indie, Simulation, Sports, Strategy;1,000,000 - 2,000,000;96466;16449;80017;2203;957;944
524240;STONEBOND: The Gargoyle's Domain;Action, Indie, Sports, Early Access;0 - 20,000;8;4;4;0;0;0
524250;Dad Quest;Adventure, Casual, Indie;20,000 - 50,000;125;16;109;0;0;0
524350;TileDynasty FPS Arena;Action, Adventure, Indie, RPG, Simulation, Early Access;0 - 20,000;1;0;1;0;0;0
524380;Yore VR;Action, RPG;20,000 - 50,000;67;92;-25;0;0;0
524380;Yore VR;Action, Adventure, Casual, Indie, Early Access;20,000 - 50,000;67;92;-25;0;0;0
524430;Skool Daze Reskooled;Action, Indie;20,000 - 50,000;20;8;12;0;0;1
524490;Shadron;Adventure, Indie, Early Access;0 - 20,000;21;3;18;525;667;0
524520;Fatehaven;Action, Indie;0 - 20,000;61;18;43;0;0;0
524540;Samurai of Hyuga;Adventure, Indie;0 - 20,000;41;8;33;0;0;1
524560;Samurai of Hyuga Book 2;Action, Adventure, Casual, Free to Play, Indie;0 - 20,000;38;5;33;0;0;1
524580;Fairy Fencer F Advent Dark Force;Adventure, Free to Play, Indie, RPG;100,000 - 200,000;1927;340;1587;682;422;10
524600;Dark Parables: Curse of Briar Rose Collector's Edition;Indie, Early Access;50,000 - 100,000;57;13;44;0;0;0
524610;Ceggtcher VR;Adventure, Simulation, Strategy;0 - 20,000;0;7;-7;0;0;0
524640;Asura: Vengeance Edition;Action, Adventure, Casual, Indie;50,000 - 100,000;578;94;484;245;245;1
524650;DANGEROUS DUELS;Adventure, Indie;0 - 20,000;11;3;8;0;0;0
524660;RutonyChat;Adventure, Casual, Indie;100,000 - 200,000;583;163;420;788;906;608
524690;Bitslap;Action, Indie;0 - 20,000;26;1;25;0;0;0
524850;Alicemare;Action, Casual, Indie;50,000 - 100,000;794;104;690;0;0;2
524910;Hidden Through Time;Action, Adventure, Casual, Indie, Early Access;50,000 - 100,000;1924;122;1802;467;468;27
524940;Javva Juice;Action, Sports;0 - 20,000;11;4;7;0;0;0
524970;Helmet Heroes;Free to Play, Simulation;200,000 - 500,000;484;433;51;534;534;7
525040;The Disney Afternoon Collection;Adventure;20,000 - 50,000;679;81;598;71;90;4
525050;Artisan: Going Home Again;Indie, Simulation;0 - 20,000;14;0;14;0;0;0
525070;Captain Lycop : Invasion of the Heters;;20,000 - 50,000;15;6;9;318;343;0
525080;The Race for the White House 2016;Action, Adventure;0 - 20,000;13;14;-1;0;0;1
525100;SLIVER.tv;Action, Casual, Indie;20,000 - 50,000;24;18;6;1;1;0
525150;Space Fuss;Casual, Strategy;20,000 - 50,000;76;19;57;203;223;0
525190;The Construct;Casual, Indie, Strategy;20,000 - 50,000;49;36;13;458;480;48
525210;Nock: Hidden Arrow;Action, Casual, Indie, Racing, Sports;0 - 20,000;25;9;16;11;11;0
525240;LOST SPHEAR;Casual, Indie, Simulation, Early Access;20,000 - 50,000;104;77;27;52;52;2
525300;Starship Annihilator;Sports;200,000 - 500,000;85;50;35;293;301;9
525330;Galaxy of Trian Board Game;Action, Adventure, Casual, Indie, RPG, Strategy;0 - 20,000;4;4;0;0;0;0
525360;Shio;Casual, RPG, Simulation;100,000 - 200,000;1187;318;869;346;346;2
525370;Gobernators (Parodia política peruana);Adventure, Indie;20,000 - 50,000;64;17;47;0;0;0
525380;Demon Peak;Action, Indie;20,000 - 50,000;142;64;78;0;0;0
525420;Samplitude Music Studio 2017 Steam Edition;Simulation;0 - 20,000;19;16;3;0;0;2
525450;King Oddball;Casual, Indie;0 - 20,000;76;6;70;88;88;0
525480;.hack//G.U. Last Recode;Casual, Indie, Strategy;100,000 - 200,000;2697;392;2305;2346;3648;65
525500;Candy Kingdom VR;Adventure, Indie, RPG, Strategy;0 - 20,000;33;8;25;0;0;0
525510;Guns, Gore and Cannoli 2;Casual, Indie;200,000 - 500,000;3266;194;3072;409;433;61
525530;What Would You Do?;Indie, Simulation, Strategy;0 - 20,000;7;7;0;0;0;0
525590;Brawlderdash;Action, Adventure, Indie;0 - 20,000;0;2;-2;0;0;0
525600;Dyno Adventure;RPG;0 - 20,000;8;12;-4;284;311;0
525620;Octogeddon;RPG;100,000 - 200,000;662;66;596;1106;1106;31
525640;Bullets And More VR - BAM VR;RPG;50,000 - 100,000;454;63;391;765;765;0
525660;Moonlit Mayhem;Action, Casual, Indie;0 - 20,000;4;4;0;0;0;0
525680;Deisim;Casual, Simulation;20,000 - 50,000;583;49;534;184;242;8
525690;MMM: Murder Most Misfortunate;Indie, Strategy;20,000 - 50,000;77;9;68;138;220;1
525700;Birthdays the Beginning;Violent, Action, Adventure;50,000 - 100,000;504;314;190;742;742;5
525740;Slashy Hero;Action, Indie;0 - 20,000;32;2;30;0;0;0
525760;Awesome Obstacle Challenge;Design & Illustration, Photo Editing;0 - 20,000;8;2;6;0;0;0
525780;Doorways: Old Prototype;Indie, Early Access;100,000 - 200,000;547;90;457;51;75;0
525860;Garden Wars;Action, Indie;20,000 - 50,000;2;0;2;0;0;0
525870;WackyMoles;Adventure, Casual;0 - 20,000;3;3;0;0;0;0
525910;Cockroach VR;Action, Adventure, Indie, RPG;0 - 20,000;43;2;41;0;0;0
525920;Pro Cycling Manager 2017;Indie, Simulation;100,000 - 200,000;306;116;190;84569;84569;28
525950;JUST BAT (VR CRICKET);Adventure, Indie, RPG;0 - 20,000;10;2;8;0;0;0
526090;Very Real Chess;Violent, Gore, Action, Indie;0 - 20,000;2;2;0;0;0;0
526130;Sky Sanctuary;Action, Casual, Indie, Early Access;0 - 20,000;40;5;35;0;0;0
526140;The Gallery - Episode 2: Heart of the Emberstone;Indie;0 - 20,000;327;64;263;153;153;1
526160;The Wild Eight;Casual, Indie, Simulation, Strategy;200,000 - 500,000;4970;2093;2877;375;376;520
526180;Deus Ex: Mankind Divided - VR Experience;Action, Indie;50,000 - 100,000;139;140;-1;0;0;1
526240;CloudBound;Action, RPG, Simulation;0 - 20,000;37;7;30;0;0;0
526290;MY FIGHT;Casual, Indie;50,000 - 100,000;42;28;14;284;271;0
526310;Silhouette: Chapter One;Action, Indie, Simulation, Sports, Strategy;0 - 20,000;13;4;9;2;2;0
526400;Embers of Magic;Action;20,000 - 50,000;73;15;58;0;0;0
526430;"Project ""Fire""";Action, Adventure, Indie, RPG;20,000 - 50,000;73;27;46;0;0;0
526440;vRhythm;Action, Indie;0 - 20,000;4;1;3;0;0;0
526450;Hack Time;Simulation, Strategy;0 - 20,000;0;4;-4;0;0;0
526470;Deep Below;Casual, Indie;0 - 20,000;13;10;3;0;0;0
526490;Higurashi When They Cry Hou - Ch.4 Himatsubushi;Action, Indie;0 - 20,000;435;12;423;144;144;5
526510;The Hateful Dead;Casual, Indie;0 - 20,000;21;5;16;0;0;0
526540;8infinity;Casual, Indie;500,000 - 1,000,000;245;111;134;206;225;0
526550;PitchFork;Adventure, Casual, Indie, Early Access;0 - 20,000;3;3;0;0;0;0
526590;Boxing Saga;Casual, Indie;0 - 20,000;14;12;2;90;90;0
526730;Life of Lon: Chapter 1;Action, Indie;0 - 20,000;32;12;20;8;8;0
526730;Life of Lon: Chapter 1;Adventure, Casual, Indie, RPG;0 - 20,000;32;12;20;8;8;0
526740;hack_me;Action, Adventure, Indie, Early Access;200,000 - 500,000;1283;834;449;173;203;0
526750;The Gleam: VR Escape the Room;Casual, Simulation;50,000 - 100,000;18;36;-18;269;269;0
526780;Jumper Jape;Adventure, Casual;0 - 20,000;16;1;15;0;0;0
526790;Monsti;Adventure, Casual;500,000 - 1,000,000;384;238;146;254;262;12
526800;Cubotrox;Casual, Simulation;0 - 20,000;48;4;44;0;0;0
526870;Satisfactory;Casual, Simulation;2,000,000 - 5,000,000;119388;3504;115884;4101;1768;16621
526880;Chess Knight 2;Adventure, Casual;50,000 - 100,000;65;73;-8;339;360;0
526890;A Day in the Woods;Action, Indie, Massively Multiplayer, RPG, Early Access;0 - 20,000;21;1;20;0;0;0
526920;SQUAKE;Indie, Strategy, Early Access;50,000 - 100,000;99;49;50;279;279;0
526960;Fair Islands VR;Action, Adventure, Indie, RPG;0 - 20,000;0;5;-5;0;0;0
526980;Handball 17;Action, Adventure, Indie;0 - 20,000;62;38;24;0;0;2
527040;Armies of Riddle CLASSIC;Action, Casual, Indie, Simulation;20,000 - 50,000;0;2;-2;0;0;0
527040;Armies of Riddle CLASSIC;Casual, Free to Play, Indie;20,000 - 50,000;0;2;-2;0;0;0
527100;Star Trek: Bridge Crew;Casual, Indie;200,000 - 500,000;2229;672;1557;168;200;13
527110;The Melody of Dust;Action, Adventure, Casual, Indie;0 - 20,000;9;2;7;0;0;0
527150;Dead;Action, Adventure, Indie, Simulation, Strategy;50,000 - 100,000;179;15;164;197;197;1
527160;Cmoar VR Cinema;Sports;0 - 20,000;125;82;43;8;8;0
527190;WORLD END ECONOMiCA episode.03;Adventure, Casual;20,000 - 50,000;206;12;194;588;588;0
527210;Janken Cards;Action, Indie, RPG;0 - 20,000;26;11;15;622;622;1
527230;For The King;Casual, Indie, Massively Multiplayer, Strategy;1,000,000 - 2,000,000;28182;3531;24651;1046;802;2412
527240;Geology Business;Indie, Strategy;20,000 - 50,000;44;34;10;0;0;0
527250;VilleTown;Simulation, Strategy;0 - 20,000;12;2;10;0;0;0
527260;Lurk;Video Production;0 - 20,000;10;1;9;0;0;0
527270;Atelier Sophie: The Alchemist of the Mysterious Book;Action, Indie;50,000 - 100,000;1587;240;1347;243;304;2
527280;Nights of Azure;Casual, Indie, Strategy;20,000 - 50,000;434;188;246;0;0;0
527290;Atelier Firis: The Alchemist and the Mysterious Journey / フィリスのアトリエ ～不思議な旅の錬金術士～;Action;20,000 - 50,000;513;104;409;0;0;5
527300;DOPAMINE;Action;0 - 20,000;2;0;2;0;0;0
527310;Bubble Labs VR;Adventure, Indie;0 - 20,000;12;4;8;0;0;0
527320;Defend the Highlands: World Tour;Action, Casual, Indie;0 - 20,000;16;4;12;0;0;0
527330;Grave: VR Prologue;Action, Indie;0 - 20,000;5;12;-7;0;0;0
527340;What The Box?;Indie, Strategy;50,000 - 100,000;591;159;432;8;8;4
527350;CGWallpapers;Adventure, Indie, Massively Multiplayer, RPG;0 - 20,000;25;17;8;108;108;0
527360;Escape Station;Casual, Indie;0 - 20,000;0;2;-2;0;0;0
527380;Captain Kaon;Action, Indie, Early Access;20,000 - 50,000;22;8;14;8;8;0
527420;Demon Hunter 3: Revelation;Adventure, Casual, Free to Play, Indie, Early Access;20,000 - 50,000;209;25;184;185;185;1
527430;Warhammer 40,000: Inquisitor - Martyr;Violent, Action;1,000,000 - 2,000,000;12380;4071;8309;955;738;515
527450;Cockroach Simulator;Action, Casual, Simulation, Sports, Strategy;100,000 - 200,000;2268;545;1723;120;113;4
527470;Donuts'n'Justice;Action, Casual, Indie;20,000 - 50,000;113;26;87;398;398;0
527510;The Legions of Rome;Casual, Indie;0 - 20,000;16;33;-17;0;0;0
527520;Strike Force: Arctic Storm;Action, Adventure, Casual;0 - 20,000;1;9;-8;0;0;0
527580;PITCH-HIT ARCADE;Action, Adventure, Indie;0 - 20,000;19;4;15;0;0;0
527700;Containment Initiative;Action, Indie, RPG;20,000 - 50,000;431;51;380;19;19;0
527710;Crown Champion: Legends of the Arena;Free to Play, Massively Multiplayer, Simulation, Strategy;100,000 - 200,000;154;39;115;316;399;3
527720;Keep Defending;Action;0 - 20,000;47;8;39;0;0;0
527730;Bus Tycoon ND (Night and Day);Adventure, Indie, RPG, Strategy;0 - 20,000;10;14;-4;0;0;0
527740;YANKAI'S TRIANGLE;Simulation;0 - 20,000;54;11;43;0;0;1
527750;Merger 3D;Indie, Racing, Simulation, Early Access;200,000 - 500,000;82;111;-29;290;302;2
527760;Just Hero;Sports, Early Access;200,000 - 500,000;162;155;7;214;218;4
527770;Russian SuperHero Dead Ivan;Casual, Indie;200,000 - 500,000;113;126;-13;217;229;4
527790;Cranium Conundrum;Action, Adventure, Indie;100,000 - 200,000;23;43;-20;250;250;1
527800;War Cube;Action, Adventure, Casual, Indie, Early Access;20,000 - 50,000;42;22;20;267;264;98
527810;Dynamite Alex;Action, Indie, RPG;20,000 - 50,000;16;11;5;278;278;0
527820;Lifestream - A Haunting Text Adventure;Adventure, RPG, Early Access;0 - 20,000;29;1;28;0;0;0
527880;Dreadful;Action, Casual, Sports;0 - 20,000;7;6;1;0;0;0
527890;Shop-n-Spree: Shopping Paradise;Action, Adventure, Casual, Indie;0 - 20,000;6;2;4;0;0;1
527900;Grim Tales: The Bride Collector's Edition;Simulation, Sports, Early Access;20,000 - 50,000;20;13;7;0;0;0
527910;Nevertales: Shattered Image Collector's Edition;Casual, Indie, Simulation;0 - 20,000;11;1;10;0;0;0
527920;Farm Tribe 2;Simulation, Early Access;0 - 20,000;15;1;14;0;0;0
527930;Spa Mania 2;RPG;0 - 20,000;1;3;-2;0;0;0
527940;Mystery Trackers: The Void Collector's Edition;Action, Adventure, Indie;0 - 20,000;11;0;11;0;0;2
527950;Divergence: Year Zero;Adventure, Free to Play, Indie;0 - 20,000;9;7;2;0;0;0
527960;Fractured State;Indie, RPG, Strategy;0 - 20,000;5;2;3;0;0;0
527990;Gladiator Trainer;Action, Indie, Sports, Early Access;100,000 - 200,000;172;68;104;252;202;1
528010;Eternal Return;Indie, Strategy;0 - 20,000;21;15;6;3;3;0
528020;Destroyer;Indie, RPG, Strategy;0 - 20,000;7;2;5;0;0;0
528060;東周列萌志 Philosophic Love;Action, Adventure, Massively Multiplayer, RPG, Simulation, Early Access;100,000 - 200,000;717;68;649;0;0;3
528070;Solitaire Beach Season;Action, Casual, Indie, Early Access;50,000 - 100,000;64;27;37;243;291;2
528110;Tennis Elbow Manager;Action;20,000 - 50,000;25;5;20;0;0;3
528120;Darkness and Flame: Born of Fire Collector's Edition;Action, Adventure, Casual, RPG, Simulation, Strategy, Early Access;20,000 - 50,000;116;10;106;0;0;1
528160;Solstice Chronicles: MIA;Action, Indie;20,000 - 50,000;220;74;146;46;46;0
528180;Agricola: All Creatures Big and Small;Action, Casual, Indie, Strategy;0 - 20,000;44;63;-19;68;68;1
528190;Carpe Deal 'Em;Indie;20,000 - 50,000;4;3;1;0;0;0
528200;VEGAS Pro 14 Edit Steam Edition;Action, Casual, Indie, Sports;20,000 - 50,000;1180;263;917;1609;1984;113
528230;SYNTHETIK: Legion Rising;Adventure, Casual, Indie;500,000 - 1,000,000;10715;615;10100;792;285;209
528250;Patchwork;Violent, Action, Casual, Indie, Simulation, Strategy;20,000 - 50,000;170;57;113;12;12;2
528260;TITAN SLAYER;Violent, Action, Adventure;0 - 20,000;66;17;49;0;0;0
528270;NEON Ultra;Action, Adventure, Casual, Indie;20,000 - 50,000;33;3;30;0;0;0
528300;Soulless: Ray Of Hope;Action, Indie, Sports;100,000 - 200,000;230;80;150;128;149;0
528420;Evil Orbs;Design & Illustration;0 - 20,000;12;0;12;0;0;0
528430;Wells;Adventure;20,000 - 50,000;78;23;55;181;257;0
528450;Hunt: The Unknown Quarry;Adventure, Casual, Indie;50,000 - 100,000;31;13;18;0;0;0
528460;Rogalia;Adventure, Strategy;20,000 - 50,000;342;148;194;11;11;9
528510;Turbo Pug 3D;Adventure, Indie, Strategy;100,000 - 200,000;234;109;125;233;228;0
528550;Drunkn Bar Fight;Action, Adventure, Indie;100,000 - 200,000;704;241;463;72;82;10
528580;Found;Action, Adventure, Simulation;50,000 - 100,000;122;17;105;8;9;0
528610;Double Dragon IV;Sports;100,000 - 200,000;432;285;147;0;0;3
528640;Rugby Union Team Manager 2017;Action, Casual, Indie;0 - 20,000;56;46;10;0;0;2
528660;Spin Rush;Adventure, Casual, Indie, Simulation;100,000 - 200,000;389;117;272;234;272;1
528670;Elems;Action, Adventure;500,000 - 1,000,000;15;10;5;298;316;0
528720;Shu;Action, Adventure, Free to Play, Indie;20,000 - 50,000;130;33;97;0;0;0
528730;Crypt of the Serpent King;Adventure, Casual, Free to Play, Indie, Simulation;20,000 - 50,000;149;37;112;74;74;0
528740;Operation: New Earth;Action, Indie, RPG, Early Access;200,000 - 500,000;357;257;100;171;196;266
528770;Twixel;Action, Indie;20,000 - 50,000;18;2;16;195;195;1
528790;Francois BOUILLE;Animation & Modeling, Design & Illustration;0 - 20,000;0;1;-1;0;0;0
528820;Eisenwald: Blood of November;Action, Free to Play, Strategy;100,000 - 200,000;82;78;4;6;6;2
528820;Eisenwald: Blood of November;Casual;100,000 - 200,000;82;78;4;6;6;2
528860;Proxy - Ultimate Hacker;Strategy;0 - 20,000;14;2;12;0;0;0
528900;Multirotor Sim 2;Adventure;0 - 20,000;5;6;-1;0;0;0
528910;Golf Pro VR;Action, Adventure, Casual, Indie;0 - 20,000;2;4;-2;0;0;0
528930;Fruit for the Village;Action, Adventure;0 - 20,000;1;3;-2;0;0;0
528940;Birthright Cataclysm - Overture;Adventure, Indie;0 - 20,000;7;2;5;0;0;0
528950;Nekuia;Action;0 - 20,000;16;3;13;261;261;0
528960;Blanco: The Color of Adventure;Action, Casual, Indie, Sports;0 - 20,000;24;5;19;0;0;0
528970;SOS Survival;Action, Indie, Early Access;0 - 20,000;19;10;9;0;0;0
528980;Arakion: Book One;Indie;0 - 20,000;15;8;7;0;0;0
528990;Basketball Babe;Action, Adventure, Indie, RPG;0 - 20,000;21;3;18;0;0;0
529020;Virtual-O;Strategy;0 - 20,000;94;11;83;3911;3911;0
529040;Fine China;Simulation;0 - 20,000;9;3;6;0;0;0
529060;Space Simulator;Indie, RPG, Early Access;50,000 - 100,000;56;92;-36;0;0;0
529090;Violet Haunted;Casual, Indie, Simulation;0 - 20,000;2;1;1;0;0;0
529100;Omni Link;Action, Casual, Indie;0 - 20,000;37;4;33;0;0;0
529110;Awkward Dimensions Redux;Action, Adventure, Casual, Indie, Massively Multiplayer, Simulation, Strategy;200,000 - 500,000;2350;572;1778;16;22;1
529130;Expect The Unexpected;Action;20,000 - 50,000;53;28;25;0;0;0
529140;Ulama: Arena of the Gods;Action, Adventure, Indie;0 - 20,000;6;0;6;0;0;0
529150;Lazerbait;Action, Casual, Indie, Massively Multiplayer;20,000 - 50,000;473;15;458;32;31;0
529160;Moekuri: Adorable + Tactical SRPG;Adventure, Indie;50,000 - 100,000;334;52;282;392;392;1
529180;Dark and Light;Adventure, Free to Play, Indie;500,000 - 1,000,000;6010;5169;841;3909;2286;80
529240;Creature Clicker - Capture, Train, Ascend!;Action, Indie;200,000 - 500,000;182;199;-17;234;216;3
529260;Robot Incursion;Casual;0 - 20,000;3;2;1;0;0;0
529280;TEOT - The End OF Tomorrow;Indie;0 - 20,000;9;9;0;0;0;0
529340;Victoria 3;Casual, Indie, Strategy;500,000 - 1,000,000;18575;9409;9166;2865;2294;6218
529360;Void Rangers;Adventure, RPG;0 - 20,000;29;7;22;0;0;0
529410;Kittypocalypse - Ungoggled;Indie;0 - 20,000;42;11;31;0;0;0
529420;Crazy Sapper 3D;Action, Indie;20,000 - 50,000;49;29;20;226;217;4
529440;Behold the Kickmen;Adventure, Casual, Indie;50,000 - 100,000;368;89;279;28;28;1
529450;I Know a Tale;Action, Indie, Simulation;0 - 20,000;31;10;21;0;0;0
529480;Chopper: Lethal darkness;Adventure, Casual, Indie;0 - 20,000;42;15;27;184;184;0
529490;Rogue Trooper Redux;Action, Indie, Massively Multiplayer, RPG, Simulation, Early Access;50,000 - 100,000;243;66;177;68;74;0
529500;ALONE? - VR;Action, Adventure;0 - 20,000;26;15;11;0;0;0
529540;Thread Studio;Free to Play, Strategy;0 - 20,000;15;1;14;0;0;0
529580;Kyurinaga's Revenge;Action, Adventure, Indie;0 - 20,000;13;4;9;0;0;0
529590;Please, Don't Touch Anything 3D;Indie, Strategy;100,000 - 200,000;749;132;617;152;179;7
529610;FISH LAKE;Action, Free to Play;0 - 20,000;3;0;3;0;0;0
529630;The Rabbit Hole Remastered;Casual, Indie;0 - 20,000;11;9;2;0;0;0
529660;Mages of Mystralia;Action, Indie;50,000 - 100,000;1102;175;927;297;452;9
529670;The Bellows;Adventure, Casual;50,000 - 100,000;201;33;168;14;20;0
529700;Total Extreme Wrestling 2013;Action, Free to Play, Indie;0 - 20,000;67;6;61;0;0;10
529700;Total Extreme Wrestling 2013;Adventure, Strategy;0 - 20,000;67;6;61;0;0;10
529730;Seabed Prelude;Action, Indie;0 - 20,000;4;3;1;0;0;0
529760;TAIKU MANSION;Indie;100,000 - 200,000;102;241;-139;220;239;0
529770;Ley Lines;Action, Indie, RPG;50,000 - 100,000;121;26;95;3;3;0
529780;Disturbed;;200,000 - 500,000;1533;128;1405;30;31;1
529790;Gone with the Demon;Action, Indie;0 - 20,000;16;6;10;0;0;0
529820;Beyond Power VR;Action, Indie;0 - 20,000;6;6;0;0;0;0
529830;Game Character Hub: Portfolio Edition;Adventure, Indie, Simulation, Strategy;0 - 20,000;79;41;38;6;6;3
529840;Brawl of Ages;Casual, Indie;200,000 - 500,000;534;247;287;61;44;0
529860;ColecoVision Flashback;Indie, RPG, Early Access;0 - 20,000;6;7;-1;0;0;0
529870;Microgons;Indie, RPG, Strategy;20,000 - 50,000;53;9;44;0;0;0
529890;Maniac Mansion;Indie;0 - 20,000;118;20;98;2;2;1
529890;Maniac Mansion;Action, Indie;0 - 20,000;118;20;98;2;2;1
529900;Polygon Attack;Free to Play, Indie, RPG, Simulation, Strategy;50,000 - 100,000;206;31;175;252;280;1
529910;ARK Park;Adventure, Casual, Free to Play, Indie;0 - 20,000;176;194;-18;0;0;2
529920;Resurgence;Action, Adventure, Indie;500,000 - 1,000,000;13;8;5;238;257;0
529940;ShowdownVR;Action, Indie;0 - 20,000;5;3;2;0;0;0
529950;12 orbits;Action, Indie;50,000 - 100,000;219;30;189;42;42;2
529970;PositronX;Adventure, Indie, RPG, Strategy;0 - 20,000;62;18;44;0;0;0
530010;Water Heroes: A Game for Change;Action, Indie;0 - 20,000;4;1;3;0;0;0
530020;World to the West;Action, Indie, Strategy;20,000 - 50,000;281;82;199;579;579;1
530040;reconquest;Action, Indie, Strategy;0 - 20,000;134;116;18;0;0;0
530070;Train Sim World 2020;Strategy;200,000 - 500,000;5408;1569;3839;1019;984;34
530080;Super Toaster X: Learn Japanese RPG;Adventure, Indie;0 - 20,000;1;4;-3;0;0;0
530110;Tales of a Spymaster;Casual, Free to Play, Massively Multiplayer, Strategy;0 - 20,000;17;13;4;0;0;0
530120;VR The Diner Duo;Violent, Gore, Action, Indie, RPG, Early Access;50,000 - 100,000;396;18;378;152;152;1
530130;Akuto: Showdown;Indie, Simulation, Strategy;0 - 20,000;18;6;12;0;0;0
530160;Eve of Destruction - REDUX VIETNAM;Sexual Content, Nudity, Adventure, Casual;0 - 20,000;38;21;17;0;0;0
530240;Pixel-Warfare: Pro;Casual, Indie;50,000 - 100,000;56;46;10;0;0;0
530290;The Planet of the Vicious Creatures;Casual, Indie, Strategy;0 - 20,000;11;6;5;5;5;0
530300;Slymes;Casual, Indie;0 - 20,000;6;1;5;0;0;0
530320;Wandersong;Action, Indie, RPG;100,000 - 200,000;2801;127;2674;358;406;12
530330;Blameless;Casual, Indie;200,000 - 500,000;3811;723;3088;38;38;7
530350;Smashbox Arena;Action, Adventure, Indie, RPG, Strategy;50,000 - 100,000;413;36;377;0;0;7
530360;Requiescence;Indie, RPG;0 - 20,000;33;2;31;0;0;0
530370;Warlock's Tower;Action, Free to Play, Indie;0 - 20,000;48;1;47;0;0;0
530390;Slayaway Camp;Utilities;50,000 - 100,000;723;36;687;356;406;2
530500;The Rosefinch Curse（Ning's Wing 1）;Action, Casual, Free to Play, Indie, Sports;0 - 20,000;13;3;10;0;0;0
530510;Manipulated;Action, Adventure, Casual, Indie, Simulation;0 - 20,000;39;6;33;0;0;0
530530;Si Kancil : The Adventurous Mouse Deer;Casual, Indie;0 - 20,000;3;2;1;0;0;0
530540;mr.President Prologue Episode;Action, Adventure, Free to Play, Early Access;100,000 - 200,000;67;43;24;207;221;1
530550;Bubble Jungle  Super Chameleon Platformer World;Adventure, Indie, RPG, Strategy;20,000 - 50,000;15;2;13;694;701;0
530560;STEAM HAMMER;Adventure, Indie;20,000 - 50,000;230;332;-102;255;255;0
530620;Resident Evil 7 Teaser: Beginning Hour;Action, Indie, Simulation, Sports;1,000,000 - 2,000,000;3812;491;3321;40;24;11
530630;Empires Apart;Action, Adventure, Indie, Racing;100,000 - 200,000;1517;682;835;112;126;23
530650;Rogues or Heroes;Indie, Sports;0 - 20,000;7;2;5;0;0;0
530680;Grave Matters;Adventure;20,000 - 50,000;1;2;-1;0;0;0
530700;Argo;Indie, Simulation;2,000,000 - 5,000,000;5694;5436;258;87;28;2
530720;Solitaire Royale;Action, Simulation;0 - 20,000;25;20;5;0;0;2
530740;Spareware;Adventure, Indie;0 - 20,000;20;7;13;211;211;0
530820;Subject A-119;Action, Adventure, Casual, Indie;20,000 - 50,000;15;14;1;0;0;0
530830;Sophie's Guardian;Action, Indie;0 - 20,000;46;18;28;13;13;0
530860;The Wanderer;Casual, Indie;20,000 - 50,000;24;12;12;210;220;5
530890;Haydee;Action, Indie;200,000 - 500,000;5116;897;4219;140;85;9
530920;Archimedes;Action, Indie, RPG;20,000 - 50,000;166;40;126;389;541;0
530930;Soulblight;Simulation;0 - 20,000;49;76;-27;0;0;0
530940;BIOHAZARD 7 resident evil グロテスクVer.;Adventure, Indie;0 - 20,000;0;0;0;2278;2278;20
530950;Tower 57;Casual, RPG, Simulation;100,000 - 200,000;431;248;183;180;260;2
530960;ROM: Extraction;Adventure, Indie, Strategy;20,000 - 50,000;75;43;32;0;0;0
531050;Far Beyond: A space odyssey VR;Nudity, Casual, Free to Play;0 - 20,000;117;53;64;102;102;0
531050;Far Beyond: A space odyssey VR;Free to Play, Strategy, Early Access;0 - 20,000;117;53;64;102;102;0
531070;The Tower - Fantogame;Violent, Gore, Adventure, Casual, Free to Play, Indie;0 - 20,000;8;14;-6;0;0;0
531080;Minotaur's Maze;Strategy;0 - 20,000;6;2;4;0;0;0
531110;Battles of Norghan;Action, Indie;0 - 20,000;27;6;21;0;0;0
531140;All the Delicate Duplicates;Indie;0 - 20,000;34;10;24;0;0;0
531180;AIRHEART - Tales of broken Wings;Casual;0 - 20,000;142;26;116;135;135;0
531190;HEBEREKE!: March! Red Army Girls' Brigade;Adventure, Indie;50,000 - 100,000;180;26;154;7;7;0
531240;Max Stern;Action, Indie;0 - 20,000;21;17;4;296;273;0
531270;The Art of Fight | 4vs4 Fast-Paced FPS;Casual;0 - 20,000;236;116;120;44;44;0
531480;ShapeRockets;Adventure, Casual;0 - 20,000;14;2;12;0;0;0
531510;Just Shapes & Beats;Action, Indie;500,000 - 1,000,000;15958;367;15591;1111;995;103
531520;TankCraft;Adventure, Casual;0 - 20,000;12;11;1;123;211;0
531530;Polygod;Adventure, Casual;0 - 20,000;109;17;92;0;0;0
531540;Hidden Dimensions 3;Adventure, Casual;0 - 20,000;62;14;48;1;1;3
531630;Non-Linear Text Quests;Adventure, Casual;0 - 20,000;30;8;22;0;0;0
531640;Eternal Card Game;Action, Adventure, Indie;500,000 - 1,000,000;5098;1460;3638;2334;699;267
531660;Exoplanet: First Contact;Indie;20,000 - 50,000;229;64;165;0;0;0
531680;8-Bit Invaders!;Casual, Indie;20,000 - 50,000;330;69;261;146;179;4
531730;Corona Blossom Vol.2 The Truth From Beyond;Action, Indie;20,000 - 50,000;156;4;152;1;1;0
531740;Rubek;Action, Indie;20,000 - 50,000;73;24;49;119;205;0
531740;Rubek;Casual, Indie;20,000 - 50,000;73;24;49;119;205;0
531780;Castle Explorer;Violent, Gore, Action, Adventure, Indie;0 - 20,000;27;7;20;0;0;0
531860;Where's My What?;Action, Adventure, Casual, Indie;50,000 - 100,000;55;65;-10;243;295;0
531890;Guardian's Oath;Action, Adventure, Casual, Indie;20,000 - 50,000;109;39;70;358;533;0
531910;Bad Sector HDD;Adventure, Indie, RPG;0 - 20,000;53;4;49;277;277;0
531910;Bad Sector HDD;Adventure, Indie, RPG;0 - 20,000;53;4;49;277;277;0
531920;Carton;Adventure, Indie, RPG, Simulation, Strategy;0 - 20,000;52;25;27;392;398;5
531930;Dungeon Rats;Sexual Content, Nudity, Casual, Free to Play, Indie;50,000 - 100,000;424;131;293;41;41;4
531960;Bloody Walls;Casual, Indie;100,000 - 200,000;960;266;694;39;64;0
531980;VR Photo Viewer;Action, Adventure, Casual, Indie, Racing;0 - 20,000;25;12;13;0;0;0
531990;Egg Time;Action, Indie;20,000 - 50,000;50;6;44;4;4;0
532030;DMT: Dream Dealer;Adventure, Casual, Indie;100,000 - 200,000;110;98;12;393;397;0
532070;The Miners;Action, Adventure, Casual, Indie;0 - 20,000;3;0;3;0;0;0
532080;Apocalypse Mechanism;Casual, Free to Play, Indie, Strategy;0 - 20,000;7;7;0;0;0;0
532090;Dawn's Light 2;Casual, Indie, Simulation;0 - 20,000;14;2;12;0;0;0
532110;Rusty Lake: Roots;Action, Casual, Free to Play, Indie, Strategy;200,000 - 500,000;5427;203;5224;438;353;88
532120;Header Goal VR: Being Axel Rix;RPG;0 - 20,000;15;2;13;0;0;0
532170;WaveLand;Action, Casual, Indie, Simulation;0 - 20,000;64;10;54;0;0;0
532190;Super Blood Hockey;Casual, Indie;50,000 - 100,000;826;70;756;294;514;1
532210;Life is Strange 2;Action, Indie;10,000,000 - 20,000,000;24382;4288;20094;388;204;190
532260;Top Floor;Action, Simulation;0 - 20,000;11;19;-8;0;0;0
532270;Lethal VR;Action, Adventure, Indie, RPG;20,000 - 50,000;150;40;110;315;315;1
532290;Dark Train;Indie;20,000 - 50,000;131;45;86;0;0;1
532320;de Blob;Free to Play, Design & Illustration;20,000 - 50,000;220;29;191;0;0;2
532470;In Extremis;Violent, Action, Casual, Indie, Strategy, Early Access;0 - 20,000;23;4;19;0;0;0
532600;Sweet Candy Mahjong;Casual, Indie, Strategy;0 - 20,000;36;33;3;260;283;1
532660;Exteria;Action, Adventure, Free to Play, Indie;0 - 20,000;14;17;-3;0;0;0
532670;Manor of the Damned!;Action, Adventure, Indie;0 - 20,000;2;6;-4;0;0;0
532690;Neo ATLAS 1469;Action, Adventure, Indie, Simulation;0 - 20,000;27;18;9;0;0;0
532700;Finque;Gore, Action, Free to Play, Indie;0 - 20,000;13;6;7;0;0;0
532740;Crazy Flies;Action, Indie;0 - 20,000;0;1;-1;0;0;0
532750;Dwarrows;Adventure, Indie, RPG, Early Access;20,000 - 50,000;98;21;77;640;640;3
532800;ComPet - Epic Beast Battles;Casual;20,000 - 50,000;44;31;13;0;0;0
532840;CAYNE;Action, Adventure, Indie;200,000 - 500,000;1251;296;955;171;193;2
532890;Civil War: 1862;Action, Casual, Indie;20,000 - 50,000;21;12;9;0;0;1
532890;Civil War: 1862;Casual, Simulation, Strategy;20,000 - 50,000;21;12;9;0;0;1
532900;Outskirts;Casual, Strategy;0 - 20,000;8;0;8;0;0;0
532920;The Artifact;Simulation;20,000 - 50,000;128;69;59;401;419;0
532950;Hoyle Official Casino Games;Design & Illustration, Utilities;0 - 20,000;3;15;-12;0;0;1
532980;Thaumistry: In Charm's Way;Action, Indie;0 - 20,000;52;0;52;0;0;0
533010;Filthy Lucre;Simulation;0 - 20,000;55;19;36;0;0;0
533030;Haunted Hotel;Sexual Content, Nudity, Adventure, Casual, Indie, Simulation;0 - 20,000;5;8;-3;0;0;0
533040;Dark Parables: The Thief and the Tinderbox Collector's Edition;Action, Adventure, Indie;0 - 20,000;14;3;11;0;0;2
533050;Lazy Galaxy: Rebel Story;Casual, Indie;0 - 20,000;27;3;24;332;332;0
533060;PuppetShow: Mystery of Joyville;Indie, Strategy;0 - 20,000;12;2;10;0;0;0
533070;League of Light: Dark Omens Collector's Edition;Action, Casual, Indie, Sports;0 - 20,000;8;0;8;0;0;0
533080;Phantasmat: Crucible Peak Collector's Edition;Action;0 - 20,000;9;3;6;0;0;0
533090;Haunted Legends: The Queen of Spades Collector's Edition;Indie, Simulation, Early Access;0 - 20,000;5;2;3;0;0;0
533120;VCB: Why City (Beta Version);Action, Adventure, RPG, Early Access;200,000 - 500,000;1911;425;1486;0;0;1
533170;Don't Chat With Strangers;Action, Casual, Indie, Early Access;20,000 - 50,000;69;76;-7;0;0;0
533180;Campfire: One of Us Is the Killer;Action, Casual, Free to Play, Massively Multiplayer, RPG, Strategy;50,000 - 100,000;34;38;-4;236;270;1
533260;Behold!;Action;0 - 20,000;15;6;9;0;0;0
533280;Wild Arena;Action, Adventure, Indie;0 - 20,000;0;1;-1;0;0;0
533300;Zup!;Casual, Simulation, Sports;200,000 - 500,000;7755;464;7291;187;63;3
533320;Space Trucker;Casual, Indie;0 - 20,000;21;20;1;119;119;0
533330;Shut Eye;Adventure, Indie;50,000 - 100,000;63;50;13;186;201;0
533340;Captivity;Adventure, Casual;100,000 - 200,000;46;45;1;228;252;0
533360;Zia and the goddesses of magic;Casual, Indie;0 - 20,000;5;4;1;0;0;0
533470;The Cube Hotel（Ning's Wing 2）;Action, Indie;0 - 20,000;5;5;0;0;0;0
533480;Academagia: The Making of Mages;Action, Indie, Simulation;20,000 - 50,000;189;74;115;0;0;3
533540;MONMUSU;Action, Casual, Indie, Sports, Early Access;500,000 - 1,000,000;4025;1012;3013;603;131;30
533580;Entangle;Casual, Indie;0 - 20,000;47;4;43;0;0;0
533630;Fight Me Bro!;Simulation;0 - 20,000;4;0;4;0;0;0
533690;Think To Die;Action, Indie, Simulation, Strategy;100,000 - 200,000;281;90;191;11;11;0
533740;Tunnel VR;Action, Casual, Indie, Early Access;0 - 20,000;2;1;1;0;0;0
533770;The Writer: A Change Of Identity;Action, Adventure, Indie, Simulation, Strategy;0 - 20,000;7;4;3;0;0;0
533780;Zombie Defense;Action, Casual, Indie, Strategy;500,000 - 1,000,000;1663;325;1338;505;263;25
533820;Atonement 2: Ruptured by Despair;Indie, Racing, Simulation, Strategy;50,000 - 100,000;111;43;68;234;242;0
533850;EggK47;Action, Adventure, Casual;20,000 - 50,000;164;34;130;4;4;0
533860;Multimirror;Action, Casual, Indie, Massively Multiplayer;100,000 - 200,000;56;76;-20;277;265;0
533890;ReBoot;Indie, RPG;0 - 20,000;13;7;6;122;122;0
533920;Battle Tank Armada;Adventure;0 - 20,000;1;3;-2;0;0;0
533950;Don't open the doors!;Action, Casual, Indie;0 - 20,000;251;43;208;0;0;1
533960;Scary Humans;Adventure, Indie;20,000 - 50,000;6;0;6;0;0;0
533970;Blocks by Google;Strategy;100,000 - 200,000;166;26;140;59;76;0
534000;Fast Action Hero;Action, Free to Play, Indie, Massively Multiplayer;0 - 20,000;86;13;73;0;0;0
534010;Defense of Egypt: Cleopatra Mission;Casual, Indie, Simulation;100,000 - 200,000;96;42;54;366;372;0
534190;Blink the Bulb;Action, Adventure, Indie;0 - 20,000;76;12;64;1;1;0
534190;Blink the Bulb;Sexual Content, Indie, Simulation;0 - 20,000;76;12;64;1;1;0
534210;MegaRats;Action, Casual, Indie;0 - 20,000;5;7;-2;0;0;0
534220;Dragon's Sin;Action, Adventure, RPG;200,000 - 500,000;318;155;163;10;18;1
534230;Quell 4D;Action, Indie, Strategy, Early Access;0 - 20,000;75;17;58;0;0;0
534240;The Island of Eternal Struggle;Adventure, Indie;0 - 20,000;2;0;2;0;0;0
534270;Solitaire 220 Plus;Action, Casual, Indie, Strategy;0 - 20,000;6;2;4;0;0;1
534290;Cursed Castilla (Maldita Castilla EX);Action, Indie, RPG;50,000 - 100,000;476;80;396;238;395;0
534320;4Team;Casual, Simulation, Sports, Strategy;0 - 20,000;11;10;1;0;0;0
534350;Ancient Rome 2;Action, Casual, Indie;0 - 20,000;8;6;2;0;0;0
534370;Pure Farming 2018;Adventure, Indie, RPG;200,000 - 500,000;1035;388;647;834;945;14
534380;Dying Light 2 Stay Human;Casual, Indie;2,000,000 - 5,000,000;98774;26354;72420;2070;1654;10161
534430;Arcade Artist;Racing;0 - 20,000;4;2;2;0;0;0
534440;Killing Zombies;Indie;0 - 20,000;18;5;13;20;20;0
534480;Tropical Girls VR;Casual, Simulation, Strategy;0 - 20,000;13;23;-10;0;0;0
534550;Guacamelee! 2;Indie, Simulation;200,000 - 500,000;2436;240;2196;368;285;33
534560;Ramify;Casual;20,000 - 50,000;21;1;20;226;226;32
534570;Survival Kingdom;Action, Indie, RPG, Strategy;0 - 20,000;26;16;10;89;89;0
534570;Survival Kingdom;Casual, Indie, Early Access;0 - 20,000;26;16;10;89;89;0
534660;Lux umbra;Adventure, Casual, Free to Play;0 - 20,000;2;6;-4;0;0;0
534680;Dolphin Up;Adventure;0 - 20,000;28;1;27;0;0;0
534720;Tornuffalo;Action, Indie, Strategy;0 - 20,000;44;4;40;0;0;0
534740;Icity - a Flight Sim ... and a City Builder;Action, Adventure, Indie, RPG;0 - 20,000;2;3;-1;0;0;0
534750;The Rise of Captain Longbeard;Casual, Indie;0 - 20,000;17;5;12;0;0;0
534780;XGun-Weapon Evolution;Adventure, Indie;0 - 20,000;105;10;95;0;0;0
534820;Heroes Evolved;Casual, Simulation, Early Access;200,000 - 500,000;348;296;52;36;33;0
534870;Arcane;Adventure, Indie;0 - 20,000;16;5;11;8;8;0
534880;Super Ninja Hero VR;Adventure, Casual, Indie, RPG, Strategy;0 - 20,000;11;1;10;0;0;0
534980;Never Forget Me;Adventure, Indie;0 - 20,000;13;6;7;0;0;0
535000;EXIT;Action, Adventure, Indie, RPG;0 - 20,000;35;2;33;249;249;0
535010;Pen Island VR;Action, Indie, Sports, Early Access;0 - 20,000;4;3;1;0;0;0
535150;BUSTED!;Indie;0 - 20,000;59;19;40;0;0;1
535160;"Fire in the Goal ""轰个球""";Casual, Indie;0 - 20,000;34;3;31;0;0;0
535170;Climbtime;Indie, Simulation, Strategy;0 - 20,000;26;16;10;10;10;0
535190;Chunky Orbits;Action, Adventure, Casual, Indie;0 - 20,000;21;1;20;0;0;0
535240;Landmine Larry;Action;0 - 20,000;3;0;3;0;0;0
535260;Save Home;Adventure, Indie;0 - 20,000;30;18;12;326;338;213
535270;Constricting Cubes;Action, Adventure, Indie;20,000 - 50,000;6;7;-1;0;0;0
535280;Retro Parking;Action, Adventure, Indie, Simulation, Early Access;0 - 20,000;47;6;41;36;36;0
535330;Block King;Action, Casual, Racing;0 - 20,000;23;1;22;0;0;0
535350;Elderine: Dreams to Destiny;Casual, Indie, Strategy;0 - 20,000;4;3;1;31;31;0
535370;The Secret of Middle City;Adventure, Indie, Simulation;0 - 20,000;1;2;-1;0;0;0
535380;Asteroid Blaster VR;Casual, Indie, Simulation, Strategy;0 - 20,000;22;4;18;0;0;0
535410;Saga of the Void: Admirals;Adventure, Casual, Indie;0 - 20,000;27;6;21;0;0;0
535440;WAR7;Adventure, Casual;0 - 20,000;11;19;-8;4;4;0
535440;WAR7;Action, Adventure, Indie, Strategy;0 - 20,000;11;19;-8;4;4;0
535460;A Fear Of Heights, And Other Things;Simulation, Strategy;20,000 - 50,000;51;10;41;0;0;0
535480;Sundered: Eldritch Edition;Action, Adventure, Casual, Indie;200,000 - 500,000;3608;747;2861;193;169;25
535490;Porno Studio Tycoon;Free to Play, RPG;0 - 20,000;118;101;17;0;0;1
535520;Nidhogg 2;Free to Play, Massively Multiplayer;100,000 - 200,000;877;197;680;76;113;6
535530;Demon Hunter;Action, Adventure, Indie, Strategy;0 - 20,000;4;4;0;0;0;0
535630;One More Night;Violent, Gore, Action, Indie;0 - 20,000;27;7;20;0;0;0
535650;Dwingle : B.O.T;Action, Indie, Early Access;0 - 20,000;17;1;16;0;0;0
535680;Moorhuhn schlägt zurück;Strategy;0 - 20,000;9;0;9;0;0;0
535690;Crash Force;Action, Adventure, Casual, Indie, Strategy;0 - 20,000;91;31;60;188;211;0
535700;3D Chess;Free to Play, Simulation, Early Access;0 - 20,000;79;50;29;158;158;1
535750;VR Fun World;Action;0 - 20,000;9;5;4;0;0;0
535760;Unforgiving Trials: The Space Crusade;Adventure, Casual, Simulation;500,000 - 1,000,000;178;113;65;256;248;0
535840;Marblize;Adventure, Indie, RPG;0 - 20,000;11;3;8;0;0;0
535850;Micro Machines World Series;Adventure;50,000 - 100,000;162;376;-214;60;114;3
535890;Stereo Aereo;Action, Indie;0 - 20,000;29;5;24;0;0;0
535910;Meow-Jong;Racing, Simulation, Sports;0 - 20,000;34;0;34;0;0;0
535930;Two Point Hospital;Action, Adventure, Casual, Free to Play, Massively Multiplayer, RPG;1,000,000 - 2,000,000;27289;2497;24792;1191;330;829
535980;Phrase Shift;Casual, Indie, Strategy;0 - 20,000;41;6;35;0;0;0
536040;Cards of Cthulhu;Casual;0 - 20,000;147;67;80;181;256;1
536050;994 W 24th;Action, Casual, Indie, Racing;0 - 20,000;0;0;0;0;0;0
536210;Please State Your Name : A VR Animated Film;Casual, Indie, Sports;0 - 20,000;46;16;30;0;0;0
536220;The Walking Dead: A New Frontier;Casual, Indie;500,000 - 1,000,000;10732;2531;8201;546;573;65
536230;Siege Hammer;Action, Adventure;0 - 20,000;8;1;7;0;0;0
536270;Ancestors: The Humankind Odyssey;Action, Adventure;200,000 - 500,000;5613;1658;3955;421;202;482
536280;Disintegration;Adventure, Indie, Simulation, Strategy;200,000 - 500,000;343;336;7;53;53;1
536320;The Space Garden;Adventure, Indie, Simulation;0 - 20,000;19;27;-8;0;0;0
536370;Percussive VR;Simulation, Early Access;0 - 20,000;7;3;4;0;0;0
536410;Greenwood the Last Ritual;Sports, Early Access;100,000 - 200,000;37;22;15;220;213;1
536420;Shining Plume;Racing;50,000 - 100,000;37;24;13;208;227;5
536430;The Revenge of Johnny Bonasera: Episode 1;Adventure, Indie;0 - 20,000;50;9;41;0;0;0
536450;Vzerthos: The Heir of Thunder;Simulation, Sports;20,000 - 50,000;72;26;46;332;332;0
536460;Warp League Basketball;Adventure, Indie;0 - 20,000;0;0;0;0;0;0
536470;Magnetized;Casual, Indie;0 - 20,000;44;6;38;0;0;0
536490;Perfect Fit - Totemland;Simulation, Strategy;20,000 - 50,000;29;11;18;256;257;0
536510;Hacker Series;Action, Indie, Strategy;0 - 20,000;8;18;-10;0;0;0
536530;Marlene Betwixt;Violent, Action, Indie, Early Access;0 - 20,000;11;8;3;0;0;0
536560;CHAOS CODE -NEW SIGN OF CATASTROPHE-;Adventure, Indie, RPG;20,000 - 50,000;193;24;169;581;581;5
536630;Maze Sounds;Casual;0 - 20,000;14;19;-5;7;7;0
536640;Grimm: Dark Legacy;Action, Indie, Simulation;0 - 20,000;36;42;-6;0;0;0
536660;JCB Pioneer: Mars;Action, Adventure;0 - 20,000;65;81;-16;0;0;0
536670;Fear Of Traffic;Casual, Indie, Simulation;0 - 20,000;2;1;1;0;0;0
536690;AENTITY;Adventure, Indie;0 - 20,000;41;15;26;0;0;0
536750;BoomTown! Deluxe;Action, Adventure, Indie, Massively Multiplayer, RPG, Simulation, Early Access;50,000 - 100,000;136;29;107;270;271;4
536770;THE AWKWARD STEVE DUOLOGY;Indie;0 - 20,000;47;6;41;0;0;0
536780;Lost Grimoires: Stolen Kingdom;Strategy;20,000 - 50,000;191;33;158;178;178;1
536800;FILE 9;Action, Indie;0 - 20,000;2;5;-3;0;0;0
536890;Glittermitten Grove;Adventure, Indie;20,000 - 50,000;402;82;320;0;0;3
536900;The Last Sky;Action, Adventure, Casual, Indie;0 - 20,000;32;6;26;0;0;0
536920;Groggers!;Casual, Indie;0 - 20,000;2;1;1;0;0;0
536930;MOBIUS FINAL FANTASY;Indie;1,000,000 - 2,000,000;3172;1184;1988;2119;68;0
536950;Legend of Ares;Action, Adventure, Casual, Indie;20,000 - 50,000;31;24;7;0;0;0
536960;No Way Out - A Dead Realm Tale;Adventure, Casual, Indie;0 - 20,000;19;6;13;0;0;0
537000;Nelo;Indie;0 - 20,000;93;35;58;0;0;0
537020;Legions of Tyrandel;Adventure, Casual, Indie, Simulation, Strategy;0 - 20,000;4;1;3;0;0;0
537060;MagixHome VR;Action, Adventure, Casual, Indie;0 - 20,000;9;8;1;59;59;0
537110;Angels of Death;RPG;200,000 - 500,000;3795;237;3558;3176;331;25
537130;Red Spider: Vengeance;Action, Adventure, Casual, Indie, RPG, Sports;0 - 20,000;19;6;13;1;1;0
537130;Red Spider: Vengeance;Action, Casual, Indie;0 - 20,000;19;6;13;1;1;0
537140;Nemesis Perspective;Action, Indie, Early Access;0 - 20,000;106;12;94;20;21;0
537170;4x4 Offroad Racing - Nitro;Simulation;0 - 20,000;1;3;-2;0;0;0
537180;Digimon Masters Online;Action, Adventure, Casual, Indie, Simulation, Sports;1,000,000 - 2,000,000;5469;2617;2852;4754;54;307
537200;Defense Of Greece TD;Indie;100,000 - 200,000;44;24;20;243;265;0
537340;Guts and Glory;Indie;200,000 - 500,000;1852;468;1384;116;106;10
537380;Abyssal Zone;Action, Casual, Indie, Strategy;0 - 20,000;1;0;1;0;0;0
537430;Inner Chains;Action, Casual, Free to Play, Indie, RPG;200,000 - 500,000;217;250;-33;70;70;0
537450;ReCore: Definitive Edition;Indie, Simulation, Strategy, Early Access;100,000 - 200,000;738;465;273;284;284;11
537520;SYMMETRY;Education;50,000 - 100,000;105;89;16;0;0;0
537540;The Last Journey;Indie, Simulation, Strategy, Early Access;0 - 20,000;22;26;-4;0;0;0
537590;Bridge to Nowhere;Simulation, Sports, Early Access;0 - 20,000;6;6;0;0;0;0
537630;Tee Time Golf;Action, Casual, Indie, Sports, Early Access;20,000 - 50,000;130;30;100;155;155;2
537660;Brumm;Casual;0 - 20,000;6;3;3;0;0;0
537700;Octave;Casual;20,000 - 50,000;109;40;69;270;258;0
537740;Dino Dini's Kick Off Revival - Steam Edition;Casual;0 - 20,000;32;31;1;0;0;0
537750;Dungeon Of Doom Puzzle;Casual;0 - 20,000;3;1;2;0;0;0
537760;Arizona Rose and the Pirates' Riddles;Action, Adventure, Indie, RPG, Simulation, Strategy, Early Access;0 - 20,000;12;2;10;0;0;0
537800;Bomber Crew;Adventure, Indie;500,000 - 1,000,000;10542;1469;9073;320;197;70
537920;Supa Kila Monsta Hunta;Adventure, Casual, Indie;0 - 20,000;4;1;3;0;0;0
537990;Heroine Anthem Zero -Sacrifice-;Indie;50,000 - 100,000;436;234;202;0;0;2
537990;Heroine Anthem Zero -Sacrifice-;Casual, Indie, Strategy;50,000 - 100,000;436;234;202;0;0;2
538000;Hop Step Sing! Kisekiteki Shining! (HQ Edition);Action, Adventure, Indie;0 - 20,000;51;6;45;0;0;0
538040;Dante's Forest;Casual, Indie, Simulation;0 - 20,000;3;0;3;0;0;0
538050;The baron got you again;Casual, Indie;0 - 20,000;5;5;0;0;0;0
538060;Doodle God: 8-bit Mania - Collector's Item;Casual, Indie;20,000 - 50,000;95;78;17;242;253;0
538060;Doodle God: 8-bit Mania - Collector's Item;Indie, Racing, Strategy;20,000 - 50,000;95;78;17;242;253;0
538070;Bad Dream: Coma;Free to Play, Massively Multiplayer, Racing;100,000 - 200,000;1692;152;1540;225;254;4
538100;Feel The Snow;Action, Free to Play, Massively Multiplayer;100,000 - 200,000;2458;317;2141;309;387;10
538110;Delila's Gift;Adventure, Casual;0 - 20,000;18;3;15;0;0;0
538170;Raging Titan;Adventure, Casual, Indie;0 - 20,000;7;3;4;0;0;0
538220;HAUNTED: Halloween '85 (Original NES Game);Casual, Indie, Strategy;0 - 20,000;21;6;15;0;0;0
538330;A-Escape VR;Action, Casual, Indie, Simulation;0 - 20,000;14;9;5;0;0;0
538390;Crimson Nights;Casual, Indie, Racing;0 - 20,000;2;1;1;0;0;0
538410;Chicken Chase;Casual, Indie, Strategy;0 - 20,000;6;2;4;0;0;0
538470;Remind Yourself;Action, Adventure, Casual, Indie;0 - 20,000;2;3;-1;0;0;0
538490;Shatter Quest;Indie;0 - 20,000;1;2;-1;0;0;0
538510;Trickshot;Indie, RPG;0 - 20,000;1;4;-3;0;0;0
538550;Party Golf;Adventure, Casual, Indie, Simulation;0 - 20,000;48;10;38;4;4;2
538550;Party Golf;Action, Adventure, Indie, RPG;0 - 20,000;48;10;38;4;4;2
538560;Help Me Doctor;Strategy;0 - 20,000;4;13;-9;15;15;0
538560;Help Me Doctor;Violent, Adventure, Indie, Simulation, Strategy, Early Access;0 - 20,000;4;13;-9;15;15;0
538590;Sleeping Valley;Casual, Indie;200,000 - 500,000;97;198;-101;202;213;1
538680;The Legend of Heroes: Trails of Cold Steel;Strategy;200,000 - 500,000;4417;227;4190;3633;4637;127
538700;TURGUL: RAPID FIGHTING;Strategy;0 - 20,000;1;2;-1;0;0;0
538710;Dead Hungry;Action, Adventure, Casual, Indie;0 - 20,000;47;4;43;0;0;0
538790;Primal Carnage: Onslaught;Casual;0 - 20,000;10;11;-1;0;0;0
538810;Train Mechanic Simulator 2017;Action;50,000 - 100,000;484;241;243;155;233;3
538840;City Climber;Action, Indie, Simulation;50,000 - 100,000;256;84;172;105;174;1
538880;Triennale Game Collection;Casual, Indie;20,000 - 50,000;66;16;50;0;0;0
538900;ZIQ;Violent, Action, Casual, Indie, Simulation, Early Access;0 - 20,000;12;0;12;0;0;0
538920;Fiery Disaster;Action, Indie;20,000 - 50,000;22;24;-2;63;63;3
538950;Plenty: Skyhearth;Casual;20,000 - 50,000;48;8;40;0;0;0
538990;SugarMill;Action, Adventure, Casual, Indie, RPG;0 - 20,000;38;39;-1;0;0;0
539010;7VR Wonders;Action, Adventure, Indie, RPG;0 - 20,000;3;7;-4;0;0;0
539050;Super Island God VR;Adventure, Indie, RPG;0 - 20,000;37;23;14;0;0;0
539090;Clazer;Indie, RPG, Strategy;0 - 20,000;23;8;15;0;0;0
539090;Clazer;Simulation;0 - 20,000;23;8;15;0;0;0
539190;CuVRball;Adventure, Indie;0 - 20,000;17;4;13;0;0;0
539270;Mahjong;Adventure, Casual, Indie;100,000 - 200,000;257;54;203;232;232;27
539280;Tetraminos;Adventure;20,000 - 50,000;59;25;34;0;0;3
539290;Brick Breaker;Casual, Indie, RPG, Strategy;0 - 20,000;38;49;-11;0;0;3
539300;Solitaire;Action, Indie;20,000 - 50,000;54;60;-6;0;0;4
539320;Picontier / ピコンティア;Casual;0 - 20,000;90;34;56;0;0;2
539330;Light Fairytale Episode 1;Action, Adventure, Indie;50,000 - 100,000;181;38;143;0;0;0
539340;Future Unfolding;Action, Adventure, Indie;0 - 20,000;79;12;67;0;0;1
539370;TV Trouble;Action, Indie;0 - 20,000;34;6;28;0;0;0
539400;Son of a Witch;Adventure, Free to Play, Indie, Massively Multiplayer, RPG;20,000 - 50,000;337;46;291;591;591;8
539440;Citalis;Action, Adventure, Indie, Early Access;200,000 - 500,000;106;106;0;254;256;1
539450;Crab Dub;Indie, Simulation, Strategy;100,000 - 200,000;187;74;113;243;245;4
539460;Puzzle Cube;Action, Indie, Strategy;20,000 - 50,000;85;27;58;266;229;4
539470;Police Stories;Action, Adventure, Casual, Indie;500,000 - 1,000,000;5669;961;4708;273;265;131
539550;SeaWolf VR;Simulation;0 - 20,000;4;2;2;0;0;0
539560;Vienna Automobile Society;Action, Adventure, Indie, Massively Multiplayer, RPG, Simulation, Early Access;0 - 20,000;5;3;2;0;0;0
539640;Racecar.io;Action, Indie;50,000 - 100,000;193;136;57;26;26;0
539640;Racecar.io;Adventure, Casual, Indie;50,000 - 100,000;193;136;57;26;26;0
539650;TwelveSky 2 Classic;Action, Casual, Indie;50,000 - 100,000;136;64;72;16;26;2
539660;ChronoClock;Action, Indie, Racing;0 - 20,000;120;9;111;0;0;1
539670;Sakura Nova;Action, Casual, Indie;50,000 - 100,000;336;52;284;217;228;1
539690;Nanomedix Inc;Action, Indie;20,000 - 50,000;6;3;3;0;0;0
539720;Razortron 2000;RPG;200,000 - 500,000;1346;217;1129;269;290;160
539750;Kombine;Adventure, Indie, RPG, Strategy;20,000 - 50,000;84;24;60;331;327;1
539980;Space Cat;Adventure, Indie;0 - 20,000;20;1;19;0;0;0
540010;Symphony of the Machine;Action, Adventure;0 - 20,000;8;2;6;0;0;0
540020;Final Quest II;Action, Adventure;200,000 - 500,000;65;96;-31;229;210;1
540060;Fabulous - Angela's Fashion Fever;Action, Adventure;0 - 20,000;101;23;78;0;0;2
540100;Imprisoned Light;Adventure, Casual, Indie;20,000 - 50,000;132;72;60;9;9;1
540150;Tank Battle: Blitzkrieg;Adventure, Indie, RPG, Simulation, Early Access;20,000 - 50,000;15;7;8;1;1;0
540180;Kommissar;Action, Adventure, Casual, Strategy;0 - 20,000;8;25;-17;0;0;0
540190;Tetropunk;Action, Adventure, Indie;100,000 - 200,000;113;32;81;385;365;159
540230;Civil War: 1861;Action, Casual, Indie;50,000 - 100,000;31;11;20;0;0;0
540250;Tank Battle: 1945;Adventure, Casual;0 - 20,000;11;8;3;0;0;0
540320;Vulture Island;Adventure, Indie, RPG;0 - 20,000;7;2;5;0;0;0
540360;Jewel Quest Seven Seas Collector's Edition;Action, Adventure, Casual, Indie;20,000 - 50,000;11;3;8;0;0;0
540410;Queendoom;Casual, Indie;0 - 20,000;22;1;21;0;0;0
540500;Starfighter Arduxim;Casual;0 - 20,000;15;5;10;0;0;0
540510;ISLANDS: Non-Places;Action, Free to Play;20,000 - 50,000;283;62;221;35;35;0
540550;Commercium;Education;0 - 20,000;8;13;-5;0;0;0
540590;Red Barton and The Sky Pirates;Casual, Indie, Simulation;0 - 20,000;2;10;-8;0;0;0
540610;Delicious! Pretty Girls Mahjong Solitaire;Simulation, Early Access;50,000 - 100,000;1468;233;1235;128;187;5
540640;Tales of the Elements;Action, Casual, Indie;50,000 - 100,000;13;6;7;220;212;0
540650;Dawn of Warriors;Nudity, Violent, Action, Indie, Early Access;0 - 20,000;8;12;-4;0;0;0
540660;Sorcery Is for Saps;Nudity, Casual, Indie;0 - 20,000;16;4;12;5588;5588;0
540690;Hellenica;Violent, Gore, Action, Indie, Early Access;0 - 20,000;33;15;18;0;0;0
540740;Perfect;Adventure, Casual, Indie;0 - 20,000;29;34;-5;0;0;1
540770;Subject 264;Nudity, Adventure;0 - 20,000;16;2;14;0;0;6
540780;Delicious - Emily's Message in a Bottle;Adventure, Free to Play, Indie;0 - 20,000;114;7;107;0;0;6
540840;Lara Croft GO;Action, Casual, Indie, Simulation;200,000 - 500,000;2907;240;2667;238;221;8
540860;Dragon Kingdom War;Action, Indie;20,000 - 50,000;41;35;6;398;413;0
540870;Crewsaders;Action, Indie;20,000 - 50,000;25;12;13;7;7;0
540880;Rose of Winter;Violent, Action, Adventure, RPG, Strategy, Early Access;0 - 20,000;171;14;157;0;0;0
540880;Rose of Winter;Adventure, Indie, Strategy;0 - 20,000;171;14;157;0;0;0
540900;Nuclear Contingency;Free to Play, Massively Multiplayer, RPG, Strategy;100,000 - 200,000;139;131;8;210;216;1
541160;MC Lars: The Video Game;Adventure, Indie;0 - 20,000;10;3;7;0;0;0
541200;GTTOD: Get To The Orange Door;Casual, Indie, Simulation;200,000 - 500,000;2156;287;1869;861;1311;11
541210;Cold Waters;Indie, Racing, Simulation;100,000 - 200,000;3326;510;2816;859;1476;162
541230;Alien Shooter TD;Free to Play, Massively Multiplayer, RPG;0 - 20,000;649;106;543;664;1036;4
541230;Alien Shooter TD;;0 - 20,000;649;106;543;664;1036;4
541240;Red's Kingdom;Indie, Simulation;0 - 20,000;30;2;28;0;0;0
541270;EEP 13;Violent, Gore, Action, Adventure, Indie;0 - 20,000;16;5;11;0;0;0
541300;Survive the Nights;Adventure, Sports;500,000 - 1,000,000;2311;1298;1013;364;547;35
541310;Tiny Thor;Indie, Strategy;0 - 20,000;0;0;0;0;0;0
541370;Clickdraw Clicker;Casual;100,000 - 200,000;147;290;-143;228;211;2
541380;PhysDrive;Action, Adventure, Casual, Indie, Early Access;100,000 - 200,000;58;64;-6;269;344;0
541410;Skyway;Casual;0 - 20,000;4;1;3;0;0;0
541450;Operation Abyss: New Tokyo Legacy;Action, Casual;0 - 20,000;111;49;62;49;49;6
541560;Suppressed;Action, Casual;0 - 20,000;8;5;3;0;0;0
541570;Sally Face - Episode One;Action, Casual;500,000 - 1,000,000;13645;414;13231;719;448;206
541640;Disney Infinity 1.0: Gold Edition;Action, Adventure, Simulation;0 - 20,000;279;36;243;21;21;64
541670;Disney Infinity 3.0: Gold Edition;Casual, Indie, Simulation, Strategy;50,000 - 100,000;779;118;661;236;236;102
541720;Redrum: Dead Diary;Free to Play, Indie, Racing, Sports;0 - 20,000;40;28;12;0;0;0
541760;The Frontier;Racing;0 - 20,000;3;0;3;0;0;0
541770;RuinsCity_VR;Casual, Early Access;0 - 20,000;0;2;-2;0;0;0
541910;David Slade Mysteries: Case Files;Action, Indie;0 - 20,000;8;1;7;0;0;0
541920;Help;Action, Adventure, Indie;20,000 - 50,000;71;66;5;254;291;1
541930;Panoptic;Action, Adventure, Indie;0 - 20,000;270;11;259;23;23;4
541960;TRI.DEFENDER;Indie, Strategy, Early Access;0 - 20,000;9;2;7;221;221;0
541970;Lost in Reefs: Antarctic;Action, Adventure, Indie;0 - 20,000;1;2;-1;0;0;1
542030;RuneSage;Casual, Free to Play, Massively Multiplayer, Simulation, Sports;0 - 20,000;48;4;44;0;0;0
542050;Forgotton Anne;Indie;20,000 - 50,000;1455;143;1312;767;862;5
542100;Train Crisis;Violent, Sports;0 - 20,000;9;2;7;0;0;0
542110;FriendShip;Indie, Simulation;0 - 20,000;4;6;-2;0;0;0
542110;FriendShip;Action, Adventure, Indie;0 - 20,000;4;6;-2;0;0;0
542200;Animal Lover;Adventure, Casual, Indie;0 - 20,000;129;18;111;319;319;2
542210;Xemo : Robot Simulation;Adventure, Indie;0 - 20,000;24;21;3;0;0;0
542220;Rumpus;Action, Casual, Sports;0 - 20,000;24;0;24;0;0;0
542240;TZOMPANTLI;Indie, Sports;0 - 20,000;17;12;5;318;318;1
542260;The Herbalist;Casual, Indie, Simulation;50,000 - 100,000;585;36;549;485;648;1
542270;Project Alpha 002;Action, Adventure, Indie, Early Access;0 - 20,000;5;3;2;0;0;0
542280;Happy Maze;Adventure, Casual, Indie;50,000 - 100,000;64;19;45;258;267;0
542290;Da Capo 3 R;Action, Adventure, Casual, Indie;0 - 20,000;71;4;67;0;0;0
542310;Escape the Game;Action, Indie;100,000 - 200,000;1602;319;1283;21;24;0
542340;Slingshot people;Violent, Adventure;100,000 - 200,000;642;718;-76;174;202;6
542350;Castle of no Escape 2;Action, Adventure, Indie;50,000 - 100,000;292;87;205;293;321;2
542400;Pixel Gladiator;Adventure, Casual, Indie;20,000 - 50,000;307;67;240;163;218;24
542410;True Blades;Casual, Simulation;0 - 20,000;10;13;-3;0;0;0
542480;Therian Saga;Sexual Content, Adventure, Indie;100,000 - 200,000;339;140;199;561;676;28
542520;Lost in the Rift - Reborn;Adventure, Casual;0 - 20,000;35;7;28;0;0;0
542550;Plankton;Action, Adventure, Indie;20,000 - 50,000;59;33;26;356;431;2
542570;RunVR;Indie;0 - 20,000;16;4;12;0;0;0
542590;SoulSaverOnline;Action, Adventure, Casual, Indie, Simulation;50,000 - 100,000;177;98;79;2;2;57
542620;Lonelyland VR;Indie, RPG;0 - 20,000;6;3;3;0;0;0
542650;On the front line;Action, Adventure, Casual, Indie, RPG, Simulation;0 - 20,000;20;16;4;281;300;0
542660;Feral Fury;Action, Adventure, Casual, Indie;50,000 - 100,000;105;23;82;0;0;0
542670;Extreme Skiing VR;Indie;0 - 20,000;1;6;-5;0;0;0
542680;Super Puzzle Sisters;Action, Indie;0 - 20,000;8;11;-3;0;0;0
542690;Mahsung Deluxe;Action;50,000 - 100,000;31;39;-8;231;280;1
542710;Dessert Storm;Audio Production;50,000 - 100,000;39;56;-17;308;347;0
542720;Bubble Blowout;Action, Indie;50,000 - 100,000;58;78;-20;297;320;1
542730;Block Blowout;Action, Casual, Indie;50,000 - 100,000;40;75;-35;295;318;0
542740;Balloon Blowout;Action, Indie, Simulation;50,000 - 100,000;57;73;-16;313;343;0
542750;PIRATADO 1;Adventure, Casual, Indie;0 - 20,000;5;7;-2;0;0;0
542770;Castle Must Be Mine;Action, Adventure, Free to Play, Indie, RPG, Early Access;0 - 20,000;214;24;190;0;0;1
542780;Drift GEAR Racing Free;Indie;50,000 - 100,000;77;139;-62;1;1;1
542790;RacetronicVR;Action;50,000 - 100,000;3;3;0;0;0;0
542820;DemonicGuestVR;Violent, Gore, Action, Adventure, Indie;0 - 20,000;15;5;10;0;0;0
542850;Dystopy;Action, Adventure, Indie;0 - 20,000;15;7;8;0;0;0
542870;Biomydra;Action, Casual, Indie;0 - 20,000;8;7;1;0;0;0
542870;Biomydra;Casual, Indie, Simulation, Strategy;0 - 20,000;8;7;1;0;0;0
542880;Byte Family;Action, Adventure, Strategy;0 - 20,000;52;11;41;131;158;8
542880;Byte Family;Violent, Action, Adventure, Strategy;0 - 20,000;52;11;41;131;158;8
542910;Crumbled World;Adventure, Casual, RPG, Strategy, Early Access;0 - 20,000;4;4;0;0;0;0
542930;Painted Memories;Action, Indie;20,000 - 50,000;17;31;-14;291;306;0
542940;Kickoff Legends;Adventure, Indie;0 - 20,000;19;12;7;0;0;0
543010;Bush Hockey League;Casual, Indie;0 - 20,000;161;83;78;0;0;0
543030;Slap The Fly;Indie, Simulation;50,000 - 100,000;202;79;123;0;0;5
543040;ZHED - Puzzle Game;Adventure, Indie, RPG;0 - 20,000;13;0;13;0;0;0
543050;ARC Continuum;Action, Casual, Indie, Sports;0 - 20,000;4;6;-2;0;0;0
543070;Gray Skies, Dark Waters;Casual, Indie;0 - 20,000;29;4;25;0;0;0
543100;Beat The Game;Adventure, Indie;20,000 - 50,000;117;51;66;19;19;0
543110;Head It!: VR Soccer Heading Game;Indie;0 - 20,000;8;1;7;0;0;0
543120;HandPass VR;Adventure, Casual, Indie;0 - 20,000;0;1;-1;0;0;0
543140;Legend of Merchant;Sexual Content, Nudity, Violent, Gore, Action, Adventure, Indie, Early Access;20,000 - 50,000;527;109;418;106;106;1
543150;Guardian of The Demon Valley;Casual, Indie, Massively Multiplayer, RPG, Early Access;0 - 20,000;0;1;-1;0;0;0
543160;SuperMoose;Action, Indie, Racing;0 - 20,000;21;15;6;234;234;0
543170;Project: R.E.B.O.O.T;Adventure, Casual, Indie;0 - 20,000;39;28;11;218;220;10
543180;Infinite Tanks;Violent, Action, Casual, Racing;20,000 - 50,000;121;67;54;437;437;1
543240;√Letter - Root Letter -;Action, Indie;0 - 20,000;400;98;302;201;201;3
543260;Wonder Boy: The Dragon's Trap;Adventure, Indie, Simulation, Strategy;100,000 - 200,000;1872;304;1568;385;426;4
543280;VR Laser Harp;Violent, Action, Indie;0 - 20,000;6;2;4;0;0;0
543290;Void & Nothingness;Adventure, Casual, Indie, Simulation, Early Access;0 - 20,000;4;4;0;0;0;0
543300;Horizon Of History;Utilities, Video Production;0 - 20,000;2;1;1;0;0;0
543350;The Night The Carsons Disappeared;Casual, Simulation, Strategy;0 - 20,000;19;10;9;0;0;0
543360;Relaxation balls;Indie, Simulation, Sports, Strategy;50,000 - 100,000;51;49;2;353;401;0
543380;Empire of the Fallen Steel;Free to Play, Indie;0 - 20,000;7;5;2;0;0;0
543390;Aeon;Adventure, Indie, Simulation;0 - 20,000;171;64;107;0;0;1
543410;Crowe: The Drowned Armory;Action, Sports;0 - 20,000;14;4;10;0;0;0
543430;Brain Booster;Action, Indie, Simulation, Early Access;0 - 20,000;22;9;13;0;0;0
543440;Cold Iron - Quick Draw Western Duels;Action;;;;0;;;
543460;Dead Rising 4;Violent, Action;200,000 - 500,000;3527;2791;736;572;551;77
543510;SONAR Home Studio;Adventure, Casual, Indie;0 - 20,000;16;12;4;0;0;1
543530;Holo Impact : Prologue;Strategy;0 - 20,000;24;3;21;0;0;0
543540;Archer Guardian VR : The Chapter Zero;Action, Adventure, Sports;0 - 20,000;4;3;1;0;0;0
543580;Pipejob;Adventure, Casual;0 - 20,000;34;9;25;0;0;0
543600;Monster Maze VR;Adventure, Indie;0 - 20,000;27;8;19;0;0;0
543650;Last Days;Adventure, Casual, Indie;100,000 - 200,000;25;19;6;347;388;0
543710;Cogito;Casual, Strategy;0 - 20,000;11;5;6;0;0;0
543720;Damned Cold;Action;0 - 20,000;5;0;5;0;0;0
543740;Medieval Story;Adventure, Casual, Indie, Simulation, Strategy;0 - 20,000;3;2;1;0;0;0
543870;NARUTO SHIPPUDEN: Ultimate Ninja STORM 2;Action;50,000 - 100,000;2423;299;2124;335;367;55
543900;METAL GEAR SURVIVE;Free to Play, Indie, Strategy, Early Access;200,000 - 500,000;3348;1774;1574;2037;2338;53
543910;World of DASM, DASM Spell Quest;Adventure, Indie;0 - 20,000;12;0;12;0;0;0
543920;Weird creatures;Strategy;0 - 20,000;1;2;-1;0;0;0
543930;Koi Musubi;Adventure, Casual, Indie, RPG, Strategy;0 - 20,000;250;23;227;0;0;0
543930;Koi Musubi;Education;0 - 20,000;250;23;227;0;0;0
543940;Perso;Action, Free to Play, Indie, Early Access;0 - 20,000;4;1;3;0;0;0
543950;Z`code (VR for HTC Vive);Adventure, Indie;0 - 20,000;1;7;-6;0;0;0
543960;Rugby Challenge 4;Strategy;0 - 20,000;51;45;6;0;0;4
543980;Zombie Exodus: Safe Haven;Strategy;0 - 20,000;156;23;133;0;0;8
544000;Dream UniVRse;Strategy;0 - 20,000;2;0;2;0;0;0
544130;Whack-a-Vote: Hammering the Polls;Sexual Content, Nudity, Casual, Indie, Simulation;0 - 20,000;14;4;10;0;0;0
544140;Murder Mystery Adventure;Adventure, Casual, Indie;0 - 20,000;21;56;-35;178;185;0
544180;Orbox C;Action, Adventure, Indie, RPG, Simulation, Early Access;20,000 - 50,000;174;5;169;286;289;0
544190;Book Series - Alice in Wonderland;Action;0 - 20,000;70;24;46;0;0;0
544220;Damage: Sadistic Butchering of Humanity;Utilities;0 - 20,000;5;14;-9;0;0;0
544290;Tyto Online;Simulation, Sports;0 - 20,000;11;1;10;0;0;0
544310;Jumps;Action, Adventure, Indie;20,000 - 50,000;269;12;257;227;270;1
544330;Snake Pass;Action, Indie, Simulation, Early Access;200,000 - 500,000;2207;580;1627;181;201;7
544370;Dead Hand Drive;Casual, Sports;0 - 20,000;0;1;-1;0;0;0
544380;Tesla: The Weather Man;Action, Adventure, Indie;0 - 20,000;6;1;5;0;0;0
544390;NITE Team 4 - Military Hacking Division;Sports;;;;0;;;
544400;GUNGUNGUN;Action, Adventure, Indie, Strategy;0 - 20,000;20;0;20;0;0;0
544410;Potioneer: The VR Gardening Simulator;Action, Casual, Indie;0 - 20,000;10;8;2;0;0;0
544440;Next Stop 2;Casual, Indie, RPG, Simulation;0 - 20,000;33;6;27;0;0;1
544480;Draft Day Sports: Pro Basketball 2017;Sexual Content, Adventure, Casual;0 - 20,000;11;16;-5;0;0;1
544530;Escape Bloody Mary;Action, Indie;0 - 20,000;48;15;33;0;0;0
544540;The Fastest Fist;Adventure, Indie;0 - 20,000;37;10;27;0;0;0
544550;Stationeers;Adventure, Casual, Indie;200,000 - 500,000;4317;857;3460;1069;1307;505
544580;BULLET SOUL / バレットソウル - 弾魂 -;Action, Adventure, Casual, Indie;0 - 20,000;53;10;43;0;0;0
544580;BULLET SOUL / バレットソウル - 弾魂 -;Action, Casual, Indie;0 - 20,000;53;10;43;0;0;0
544590;Death Dojo;Casual, Indie;0 - 20,000;58;27;31;3;3;0
544600;Delicious - Emily's Christmas Carol;Adventure;0 - 20,000;149;17;132;0;0;3
544610;Battlestar Galactica Deadlock;Adventure, Casual, Indie, Simulation;100,000 - 200,000;2138;352;1786;203;115;91
544630;River City Melee : Battle Royal Special;Action, Adventure, Indie;20,000 - 50,000;57;59;-2;31;35;1
544650;Sacred Almanac Traces of Greed;Action, Casual, Free to Play, Indie;0 - 20,000;52;19;33;0;0;1
544680;Holy Avenger;Action, Casual, Indie;;;;0;;;
544680;Holy Avenger;Casual;;;;0;;;
544710;Delicious - Emily's New Beginning;Indie, RPG, Strategy;20,000 - 50,000;74;5;69;0;0;1
544730;Catan Universe;Adventure, Indie;1,000,000 - 2,000,000;5913;4839;1074;706;164;1635
544750;SOULCALIBUR VI;Adventure, Casual;500,000 - 1,000,000;9323;2031;7292;547;320;294
544790;Happy Empire - A Bouquet for the Princess;Free to Play, Indie, Simulation;0 - 20,000;44;26;18;0;0;0
544800;Driftwatch VR;Adventure, Casual, Indie;0 - 20,000;7;13;-6;0;0;0
544810;KARDS - The WWII Card Game;Adventure, Casual, Indie;1,000,000 - 2,000,000;21104;4598;16506;599;96;1360
544840;Children of Orc;Casual, Indie, Simulation;0 - 20,000;52;26;26;0;0;0
544870;Blood Ties;Adventure, Indie, RPG;20,000 - 50,000;42;25;17;220;220;0
544880;Limelight VR;Action, Adventure, Indie, RPG;0 - 20,000;1;3;-2;0;0;0
544920;Darwin Project;Action, Indie;500,000 - 1,000,000;15065;3473;11592;428;63;20
544970;Milkmaid of the Milky Way;Adventure, Casual, Indie;20,000 - 50,000;425;24;401;118;118;0
544990;NOBUNAGA'S AMBITION;Adventure, Casual, Free to Play;20,000 - 50,000;8;1;7;0;0;1
545000;Aoki Ookami to Shiroki Mejika;Casual, Indie, Simulation, Strategy;20,000 - 50,000;2;1;1;0;0;0
545010;Ishin no Arashi;Action, Adventure, Indie, Early Access;20,000 - 50,000;2;6;-4;0;0;1
545030;NSFW ~ Not a Simulator For Working;Adventure, Casual, Indie, RPG;0 - 20,000;92;8;84;304;304;1
545040;Feather;Action, Adventure, Casual;20,000 - 50,000;489;105;384;56;56;1
545050;Badiya: Desert Survival;Action, Adventure, Casual, Indie;20,000 - 50,000;167;160;7;0;0;1
545060;BULLET SOUL INFINITE BURST / バレットソウル - インフィニットバースト -;Adventure, Casual;0 - 20,000;45;16;29;0;0;1
545060;BULLET SOUL INFINITE BURST / バレットソウル - インフィニットバースト -;Simulation;0 - 20,000;45;16;29;0;0;1
545110;Driver Booster 4 for Steam;Simulation;500,000 - 1,000,000;622;196;426;478;756;3
545130;Pro Basketball Manager 2017;Simulation;0 - 20,000;22;26;-4;0;0;0
545150;Beastiarium;Casual, Simulation;20,000 - 50,000;60;59;1;213;207;0
545180;Muffled Warfare - Echolocation Shooter;Action, Adventure;0 - 20,000;90;15;75;6;6;0
545200;Super Blackjack Battle 2 Turbo Edition - The Card Warriors;Casual, Indie, Simulation, Sports, Strategy;0 - 20,000;22;16;6;0;0;0
545270;NBA Playgrounds;Action, Adventure, Casual, Indie, Simulation, Sports, Strategy;200,000 - 500,000;961;397;564;180;141;2
545330;AL･FINE;Action, Casual;0 - 20,000;17;27;-10;0;0;0
545340;Companion;Casual, Indie, Simulation;0 - 20,000;81;9;72;0;0;0
545400;Natural - Beyond Nature -;Adventure, Casual, Indie, RPG;0 - 20,000;20;5;15;0;0;0
545410;A Trip to Yugoslavia: Director's Cut;Action, Indie;50,000 - 100,000;214;69;145;251;266;4
545430;Bedfellows FRENZY;Action, Indie, Sports;0 - 20,000;85;13;72;0;0;2
545470;Hover Hazard;Adventure, Casual, Indie;20,000 - 50,000;37;25;12;223;216;16
545490;Akuya;Action, Adventure, Early Access;0 - 20,000;1;17;-16;0;0;0
545540;The Infectious Madness of Doctor Dekker;Action, Adventure, Indie;20,000 - 50,000;414;72;342;322;618;4
545570;PHAT PHROG;Casual, Indie;20,000 - 50,000;39;23;16;0;0;0
545570;PHAT PHROG;Action, Casual, Indie;20,000 - 50,000;39;23;16;0;0;0
545580;GO AWAY, THERE'S KUMIS OVER THERE!;Casual, Strategy;50,000 - 100,000;141;51;90;227;266;0
545600;Vigilantes;Action, Indie, Sports, Early Access;20,000 - 50,000;228;50;178;315;315;1
545620;Anamorphine;Adventure;0 - 20,000;25;18;7;0;0;0
545640;Shiver: Poltergeist Collector's Edition;Action;0 - 20,000;8;3;5;0;0;0
545650;High Profits;Adventure, Casual, Indie, Simulation;200,000 - 500,000;465;500;-35;1545;23;11
545660;Roofbot;Action, Casual, Indie;0 - 20,000;16;1;15;0;0;0
545670;Parallyzed;Action, Adventure, Casual, Indie;20,000 - 50,000;44;7;37;0;0;0
545690;VOI;Adventure, Simulation, Strategy;50,000 - 100,000;680;46;634;141;196;2
545700;The Land of Dasthir;Action, Adventure, Casual, Indie;50,000 - 100,000;38;62;-24;245;240;1
545720;Nother: an indie souls-like;Action, Casual, Free to Play, Indie;0 - 20,000;12;3;9;0;0;0
545750;Rise High;Action, Adventure, Casual, Indie;0 - 20,000;3;0;3;0;0;0
545800;Ghostdream;Casual, Indie;0 - 20,000;29;18;11;244;251;0
545820;Wanderland;Adventure, Indie, RPG, Strategy;100,000 - 200,000;191;127;64;1;1;21
545830;Princess of Tavern Collector's Edition;Indie;0 - 20,000;35;16;19;0;0;1
545840;Convicted Galaxy;Adventure;0 - 20,000;4;0;4;0;0;0
545850;Shady Brook - A Dark Mystery Text Adventure;Casual, Simulation;0 - 20,000;14;1;13;0;0;0
545860;Luke Sidewalker;Action, Indie;20,000 - 50,000;71;54;17;257;273;0
545880;Super Gear Quest;Action, Free to Play, Strategy;0 - 20,000;17;3;14;0;0;0
545890;Breaking Wheel;Indie, Racing, Sports, Early Access;0 - 20,000;9;3;6;0;0;0
545910;Redemption Cemetery: Bitter Frost Collector's Edition;Indie;0 - 20,000;3;0;3;0;0;0
545920;Hunting Unlimited 4;Action, Adventure, Massively Multiplayer;0 - 20,000;13;5;8;0;0;0
545930;Hunting Unlimited 2011;Action, Adventure, Indie;0 - 20,000;7;21;-14;0;0;0
545940;Hunting Unlimited 2009;Casual, Indie, Simulation;0 - 20,000;40;3;37;0;0;0
545960;Wild Animals - Animated Jigsaws;Action, Indie;20,000 - 50,000;130;18;112;170;170;2
545980;Voodoo Vince: Remastered;Action, Adventure, Indie, RPG, Strategy;20,000 - 50,000;424;33;391;113;128;3
546030;Fatal Gem VR(The First Match-3 VR Game);Casual, Indie, Simulation;0 - 20,000;5;8;-3;0;0;0
546040;Ancient Code VR( The Fantasy Egypt Journey);Strategy, Early Access;0 - 20,000;1;2;-1;0;0;0
546050;Puyo PuyoTetris;Action, Strategy;500,000 - 1,000,000;4300;837;3463;1595;2080;55
546070;Flower Design;Action, Indie;20,000 - 50,000;74;35;39;519;564;0
546070;Flower Design;Action, Adventure, Indie;20,000 - 50,000;74;35;39;519;564;0
546080;Coffin of Ashes;Casual, Early Access;100,000 - 200,000;655;48;607;243;243;3
546090;Trip to Vinelands;Adventure, Indie, RPG;20,000 - 50,000;181;22;159;0;0;0
546100;BOTOLO;Action, Indie;0 - 20,000;13;0;13;0;0;0
546110;画境(Picturesque) VR;Casual, Free to Play, Indie;0 - 20,000;14;3;11;0;0;0
546120;Pursuit of Power 2 : The Chaos Dimension;Adventure, Simulation;0 - 20,000;3;0;3;0;0;0
546150;Primordian;Indie;0 - 20,000;81;27;54;0;0;0
546160;Ladybug Quest;Action, Adventure, Indie;0 - 20,000;24;3;21;0;0;0
546170;Gem Forge;Animation & Modeling, Design & Illustration, Education, Video Production, Game Development, Early Access;20,000 - 50,000;51;6;45;248;248;4
546180;Starry Nights : Helix;Indie;0 - 20,000;16;13;3;0;0;1
546200;Gnomes Garden 3: The thief of castles;Adventure, Indie;20,000 - 50,000;101;14;87;253;287;1
546210;Unforgiven VR;Action, Adventure, Casual;0 - 20,000;22;19;3;0;0;0
546230;Xenus 2. White gold.;Action, Indie;50,000 - 100,000;182;71;111;6;6;1
546240;The Journey;Violent, Action, Indie, Early Access;0 - 20,000;6;8;-2;0;0;0
546330;SPACE MOUSE 35th Anniversary edition;Action, Adventure, Free to Play, Indie;0 - 20,000;26;2;24;0;0;0
546340;Dynamic Very, Very, Hard game!!;Design & Illustration, Education, Software Training, Utilities;50,000 - 100,000;55;70;-15;232;221;0
546350;Craft Keep VR;Casual, Indie;0 - 20,000;74;44;30;0;0;0
546390;Brief Karate Foolish;Adventure, Casual, Simulation;200,000 - 500,000;2488;150;2338;19;16;2
546400;Cavern Escape Extremely Hard game!!!;Action, Indie, Racing;50,000 - 100,000;152;247;-95;219;218;0
546410;Grab the Bottle;Casual;20,000 - 50,000;78;19;59;151;199;0
546430;Pathway;Massively Multiplayer, Racing, Simulation, Sports;200,000 - 500,000;1465;466;999;281;390;10
546440;Sluggish Morss: Days of the Purple Sun;Free to Play, Indie, Simulation;0 - 20,000;2;7;-5;0;0;0
546460;Baezult 2;Action;0 - 20,000;21;3;18;29;29;0
546490;Heart and Seoul;Adventure, Casual, Indie;50,000 - 100,000;38;48;-10;242;242;0
546550;Snowball!;Casual, Strategy;20,000 - 50,000;138;19;119;0;0;2
546560;Half-Life: Alyx;Action, Free to Play;2,000,000 - 5,000,000;77113;1236;75877;550;388;590
546600;Vanguards;Simulation;50,000 - 100,000;64;30;34;25;46;0
546610;Acro Storm;Casual, Free to Play, Indie, RPG, Simulation, Strategy, Early Access;0 - 20,000;11;21;-10;0;0;0
546650;Beat Boxer;Adventure, Indie;0 - 20,000;15;7;8;0;0;0
546660;Operation Breakout;Action;50,000 - 100,000;35;51;-16;290;297;0
546700;The Butterfly Sign;Action, Indie;100,000 - 200,000;122;70;52;270;263;0
546790;Comit the Astrodian;Action, Adventure, Indie, Early Access;0 - 20,000;25;7;18;0;0;1
546800;Tower in the Sky : Tactics Edition;Action, Casual, Free to Play, Indie;0 - 20,000;1;1;0;0;0;0
546870;Merchants & Mercenaries;Adventure;0 - 20,000;4;2;2;0;0;0
546900;Fear Effect Sedna;Casual, Simulation;0 - 20,000;75;98;-23;274;274;0
546930;Machine Hunt;Action, Adventure, Indie, Massively Multiplayer, RPG;200,000 - 500,000;273;258;15;146;200;41
546960;Mechatroniks Attack;Action, Adventure, Casual, Free to Play, Indie;0 - 20,000;2;12;-10;0;0;0
546980;Midnight Carnival;Action, Indie, Strategy;500,000 - 1,000,000;109;194;-85;239;232;1
546990;Town of Night;Sports;50,000 - 100,000;63;70;-7;299;292;9
547000;Septic Savages;Indie, Simulation;0 - 20,000;3;1;2;0;0;0
547010;Terminal Hacker;Violent, Action, Indie, Strategy, Early Access;100,000 - 200,000;88;74;14;973837;1947634;1
547040;Above - VR;Action, RPG;20,000 - 50,000;13;24;-11;337;281;0
547050;RYB;Action, Casual, Indie;0 - 20,000;56;8;48;0;0;0
547050;RYB;Action, Indie;0 - 20,000;56;8;48;0;0;0
547090;Halloween Mysteries;Indie, RPG, Strategy;0 - 20,000;13;10;3;392;394;0
547120;Simmetri;Adventure, Indie, RPG;0 - 20,000;18;1;17;0;0;0
547130;The Hero;Education;0 - 20,000;6;8;-2;0;0;0
547140;Owari;Action, Adventure, Indie, RPG, Simulation;0 - 20,000;10;2;8;0;0;0
547150;The Morgue Fissure Between Worlds;Casual, Indie;0 - 20,000;16;7;9;0;0;0
547200;Boo Breakers: The Ghostening;Action, Casual, Indie, Massively Multiplayer, RPG, Simulation;0 - 20,000;8;1;7;0;0;0
547210;Sullen;Action, Adventure;20,000 - 50,000;13;2;11;0;0;175
547250;Oscar Mike VR;Indie, Strategy;0 - 20,000;2;5;-3;0;0;0
547260;Mausoleum of the Medusa;Action;0 - 20,000;60;21;39;5;5;0
547280;Calcflow;Violent, Action, Indie, Early Access;0 - 20,000;19;1;18;0;0;0
547310;That's Mahjong!;Action, Indie;100,000 - 200,000;96;46;50;196;233;1
547340;LoveKami -Divinity Stage-;Action, Casual, Indie;20,000 - 50,000;464;105;359;178;178;3
547360;BREAK ARTS II;Violent, Action, Indie;100,000 - 200,000;504;177;327;642;642;4
547390;Mosaic: Game of Gods;Casual, Indie;20,000 - 50,000;70;6;64;96;96;1
547410;Peak Angle: Drift Online;Free to Play, Massively Multiplayer, RPG;50,000 - 100,000;537;336;201;176;176;0
547470;Apokalypsis;Adventure, Casual, Indie, RPG, Strategy;20,000 - 50,000;18;22;-4;354;399;0
547480;Carly and the Reaperman - Escape from the Underworld;Adventure, Casual, Indie;0 - 20,000;165;16;149;0;0;0
547520;Rapture - World Conquest;Indie;0 - 20,000;12;6;6;0;0;0
547540;panGEMic;Action, Adventure, Indie;0 - 20,000;86;15;71;0;0;0
547590;Pinball FX2 VR;Casual, Racing;50,000 - 100,000;299;50;249;133;133;2
547670;Musical Range;Adventure, Indie, RPG;0 - 20,000;7;0;7;0;0;0
547680;Guild Quest;Indie;200,000 - 500,000;1154;564;590;210;76;6
547710;Darkness Ahead;Action, Indie, Early Access;20,000 - 50,000;34;23;11;294;312;1
547730;Izanami's Dream Battle;Action, Casual, Indie, Racing, Sports;0 - 20,000;12;9;3;0;0;0
547740;Across;Action, Adventure, Casual, Indie, RPG;0 - 20,000;7;5;2;0;0;0
547750;Endless Night - Alpha;Action, Adventure, Indie;20,000 - 50,000;46;6;40;0;0;0
547820;Kitten Squad;Adventure, Casual, Indie, Simulation;20,000 - 50,000;93;75;18;0;0;0
547840;Interfectorem;Indie, RPG, Simulation, Strategy, Early Access;0 - 20,000;18;9;9;0;0;0
547850;Trump Simulator VR;Action, Adventure, Indie, RPG, Early Access;0 - 20,000;71;19;52;0;0;0
547860;Rend;Action, Indie;50,000 - 100,000;838;731;107;441;604;0
547870;Clown2Beat;Action, Adventure, Casual, Indie;0 - 20,000;31;16;15;1;1;0
547880;Alien Invasion Tower Defense;Action, Casual, Indie;0 - 20,000;6;9;-3;8;8;0
547900;Front Office Football Eight;Action, Adventure, Indie, Early Access;20,000 - 50,000;212;44;168;0;0;77
547910;The Survey;Design & Illustration, Photo Editing, Utilities;50,000 - 100,000;543;210;333;198;248;2
547920;Our Darkest Night;RPG;0 - 20,000;1;2;-1;0;0;0
547930;Precursors;Adventure, Strategy;0 - 20,000;47;31;16;0;0;0
547960;Space Beret;Action, Adventure, Indie, Early Access;200,000 - 500,000;331;318;13;212;218;0
547970;Celestial Breach;Action, Adventure;0 - 20,000;12;13;-1;0;0;0
547980;Equin: The Lantern;Action, Adventure;0 - 20,000;55;5;50;0;0;0
547980;Equin: The Lantern;Adventure, Casual, Indie;0 - 20,000;55;5;50;0;0;0
547990;Congresswolf;Violent, Action, Indie;0 - 20,000;7;6;1;0;0;0
548010;3D Organon VR Anatomy 2018;Simulation, Strategy;0 - 20,000;15;19;-4;0;0;0
548020;Warmada;Casual, Free to Play, Indie;0 - 20,000;24;24;0;0;0;0
548050;Runes;Action, Casual, Indie;0 - 20,000;28;4;24;0;0;0
548080;Space Merchants: Arena;Action, Adventure;50,000 - 100,000;17;7;10;255;268;0
548090;Alone in the Dark 1;Action, Strategy;0 - 20,000;220;20;200;0;0;0
548110;Star-Twine;Action, Strategy;0 - 20,000;12;0;12;0;0;0
548110;Star-Twine;Adventure, Casual;0 - 20,000;12;0;12;0;0;0
548130;Scribble Ships;Casual, Indie, Simulation;0 - 20,000;25;1;24;5;5;0
548170;Arena Master;Adventure, Indie;0 - 20,000;2;1;1;0;0;0
548220;Paladin;Casual, Indie, Racing;0 - 20,000;7;0;7;0;0;0
548230;SPINGUN;Casual, Indie;20,000 - 50,000;67;14;53;0;0;0
548260;Backfire;Simulation, Strategy;0 - 20,000;2;3;-1;0;0;0
548280;NeonBall;Action, Indie;20,000 - 50,000;36;30;6;44;72;0
548290;Dark Eden;Action, Indie, Strategy;50,000 - 100,000;125;134;-9;0;0;0
548320;Magical Mysteries: Path of the Sorceress;Action, Adventure, Indie;0 - 20,000;16;9;7;0;0;0
548330;Wheely;Action, Indie, Simulation;0 - 20,000;108;4;104;0;0;0
548340;Abode;Action, Casual, Indie, Strategy;50,000 - 100,000;337;28;309;48;51;0
548350;One Sole Purpose;Indie, Simulation;0 - 20,000;2;9;-7;0;0;0
548360;VR RunningJoe;Indie;0 - 20,000;11;4;7;15;15;0
548370;Rezrog;Action, Indie;20,000 - 50,000;143;179;-36;0;0;1
548390;Gimbal Gravity;Indie;0 - 20,000;8;2;6;0;0;0
548430;Deep Rock Galactic;Action, Casual;2,000,000 - 5,000,000;181848;5709;176139;3857;993;16295
548450;Foreveracers;Casual, Indie, Simulation;0 - 20,000;25;6;19;3;3;0
548470;First Impact: Rise of a Hero;Sports, Early Access;0 - 20,000;6;9;-3;0;0;0
548480;NightZ;Action;50,000 - 100,000;45;84;-39;370;370;0
548500;Payroll;Gore, Action, Adventure, Indie;0 - 20,000;49;6;43;0;0;0
548560;Manastorm: Champions of G'nar;Adventure, Casual, Free to Play;0 - 20,000;45;24;21;0;0;0
548570;RAGE 2;Violent, Action;500,000 - 1,000,000;9317;5774;3543;1281;1078;129
548650;Lightspeed Frontier;Action, Indie, Simulation;0 - 20,000;30;13;17;0;0;0
548680;Iron Crypticle;Animation & Modeling, Design & Illustration, Utilities;20,000 - 50,000;87;13;74;0;0;0
548710;Sandstorm;Action;50,000 - 100,000;11;13;-2;390;394;0
548720;Through the Mirror;Action, Adventure, Simulation;20,000 - 50,000;47;12;35;297;304;49
548740;Warpin: Creation (VR);Action, Indie, RPG;0 - 20,000;6;6;0;0;0;0
548760;CameraBag Photo;Casual, Indie;0 - 20,000;18;23;-5;1;1;0
548810;Operation Babel: New Tokyo Legacy;Action, Indie;0 - 20,000;68;16;52;875;875;2
548840;A Rose in the Twilight;Casual, Indie;20,000 - 50,000;385;58;327;140;251;2
548860;The Torus Syndicate;Adventure;0 - 20,000;21;7;14;0;0;0
548890;Alone in the Dark 2;Action, Adventure, Casual, Indie, Simulation;0 - 20,000;66;20;46;0;0;2
548900;Alone in the Dark 3;Action, Indie;0 - 20,000;51;13;38;0;0;0
548900;Alone in the Dark 3;Violent, Gore, Action, Adventure, Casual, Indie, Strategy;0 - 20,000;51;13;38;0;0;0
549000;Munch VR;Adventure, Casual;0 - 20,000;27;11;16;0;0;0
549030;SnipZ;Adventure, Casual, Indie, Strategy;0 - 20,000;8;26;-18;1;1;1
549040;Biotope;Adventure, Casual, Indie, RPG;0 - 20,000;94;115;-21;0;0;1
549080;Tank Warfare: Tunisia 1943;Adventure, Casual, Indie;0 - 20,000;276;57;219;261;261;5
549090;Counter Agents;Action, Casual, Indie;20,000 - 50,000;136;15;121;15;24;0
549100;GravNewton;Action, Adventure, Free to Play, Massively Multiplayer, RPG;20,000 - 50,000;289;83;206;161;170;0
549160;Army Men;Casual, Simulation;0 - 20,000;72;23;49;8;8;0
549170;Army Men II;Casual, Indie;0 - 20,000;70;38;32;24;24;0
549180;Army Men: Toys in Space;Casual, Indie;0 - 20,000;41;20;21;36;36;0
549190;Fetch;Adventure, Casual, Indie;0 - 20,000;23;2;21;0;0;0
549220;Dark Canvas: A Brush With Death Collector's Edition;Action, Casual, Indie, Racing, Simulation;0 - 20,000;1;0;1;0;0;0
549240;Beans: The Coffee Shop Simulator;Action, Free to Play, Early Access;50,000 - 100,000;103;44;59;284;326;0
549260;Alwa's Awakening;Action, Casual, Indie, Simulation;20,000 - 50,000;511;127;384;199;220;2
549280;Quiz Night Tonight!;Casual, Free to Play, Indie, Strategy, Early Access;0 - 20,000;4;4;0;0;0;0
549390;Storage Inc 2;Action, Indie;20,000 - 50,000;25;11;14;0;0;0
549660;Wondee;Casual;0 - 20,000;1;0;1;0;0;0
549670;The Thing: Tower Defense;Sexual Content, Nudity, Violent, Gore, Action, Adventure, Indie, RPG, Early Access;0 - 20,000;27;19;8;0;0;0
549700;Orphan;Adventure, Casual, Indie, Racing, Simulation;0 - 20,000;32;8;24;0;0;0
549740;Indie Game Sim;Casual, Indie;0 - 20,000;53;5;48;0;0;0
549760;Evolution VR;Action, Adventure, Free to Play, Massively Multiplayer, RPG;20,000 - 50,000;96;24;72;27;27;0
549770;Paranormal Teens;Action, Adventure, Simulation;0 - 20,000;31;47;-16;0;0;0
549780;Rainbow Rage Squad;Adventure, Casual, Indie;0 - 20,000;7;9;-2;0;0;0
549790;Glorch's Great Escape: Walking is for Chumps;Action, Adventure, Indie;0 - 20,000;4;2;2;0;0;0
549850;The Shadows of Pygmalion;Action, Indie, RPG;0 - 20,000;86;15;71;0;0;0
549850;The Shadows of Pygmalion;Action, Indie;0 - 20,000;86;15;71;0;0;0
549860;One Night Stand;Action, Indie;50,000 - 100,000;560;67;493;152;152;0
549880;RoboSports VR;Casual, Indie;0 - 20,000;10;7;3;1;1;0
549900;Leviathan Starblade;Adventure, Casual;20,000 - 50,000;25;20;5;153;153;0
549910;Locked Fears;Adventure, Casual;0 - 20,000;39;22;17;0;0;1
549920;VRchaeology: Prologue;Adventure, RPG, Strategy;20,000 - 50,000;33;4;29;1;1;0
549950;Vaccine;Action, Adventure, Strategy;0 - 20,000;21;8;13;0;0;0
550010;Happy Room;Nudity, Gore, Adventure, Casual, Indie;200,000 - 500,000;2268;253;2015;984;585;22
550060;Marmoset Toolbag 3;Adventure, Casual;0 - 20,000;161;5;156;862;862;19
550160;Street Champ VR;Animation & Modeling, Design & Illustration, Early Access;0 - 20,000;23;0;23;0;0;0
550170;RPG Fighter League;Adventure, Casual;0 - 20,000;26;0;26;0;0;1
550170;RPG Fighter League;Adventure, RPG;0 - 20,000;26;0;26;0;0;1
550180;Fiber Twig: Midnight Puzzle;Action, Indie;0 - 20,000;19;8;11;0;0;1
550200;World Destroyers;Casual, Simulation;0 - 20,000;6;0;6;0;0;1
550240;After Life - Story of a Father;Casual, Indie, Simulation;0 - 20,000;23;12;11;0;0;0
550310;Root Of Evil: The Tailor;Action, Indie;20,000 - 50,000;417;75;342;276;347;0
550320;art of rally;Adventure, Indie, RPG;200,000 - 500,000;3716;259;3457;535;661;43
550340;Umineko: Golden Fantasia;Action, Casual, Indie;20,000 - 50,000;323;34;289;26;26;3
550360;One Of The Last;Action, Casual, Indie, Early Access;0 - 20,000;31;19;12;0;0;0
550370;The Last Sin;Indie, Strategy;20,000 - 50,000;41;14;27;0;0;2
550400;Delicious - Emily's Hopes and Fears;Adventure, Indie, Simulation;0 - 20,000;63;4;59;0;0;3
550420;Stargazer Christmas;Casual, Indie;0 - 20,000;22;5;17;187;187;0
550440;Azkend 2: The World Beneath;Adventure, Indie;20,000 - 50,000;18;13;5;490;490;1
550450;Sparkle Unleashed;Action, Casual, Indie, Simulation;20,000 - 50,000;56;21;35;222;244;1
550470;NosTale - Anime MMORPG;Action, Indie;500,000 - 1,000,000;1952;798;1154;5741;2025;407
550520;B. Braun Future Operating Room;Action, Adventure, Indie;0 - 20,000;13;5;8;0;0;0
550560;Chilie;Action;0 - 20,000;7;0;7;0;0;0
550580;Sticker Craft;Violent, Gore, Adventure, Casual, Indie;50,000 - 100,000;78;19;59;233;291;0
550590;Archaica: The Path of Light;Action, Adventure, Indie;0 - 20,000;218;17;201;281;374;0
550600;Sphere Complex;Education;0 - 20,000;2;3;-1;0;0;0
550650;Black Squad;Adventure, Indie;10,000,000 - 20,000,000;60809;19012;41797;1420;65;1006
550670;What The Heck, Dude?;Adventure, Indie, Strategy, Early Access;50,000 - 100,000;138;181;-43;161;175;8
550740;Battles of the Valiant Universe CCG;Indie, Simulation, Sports;0 - 20,000;14;16;-2;0;0;0
550810;Abduction Bit;Accounting, Education, Software Training, Utilities, Early Access;50,000 - 100,000;162;19;143;93;65;1
550820;Kitten Cannon;Action, Casual, Indie;0 - 20,000;32;7;25;0;0;0
550840;Fresh Body;Indie, Strategy;50,000 - 100,000;987;307;680;655;655;1
550870;Tricky Trail RC;Adventure, Indie;0 - 20,000;2;1;1;0;0;0
550900;Metin2;Action, Indie, Simulation, Early Access;2,000,000 - 5,000,000;10302;4426;5876;1240;95;5
550930;Rocket Craze 3D;Simulation, Early Access;0 - 20,000;8;3;5;84;84;0
550990;Viktor, a Steampunk Adventure;Adventure, Casual, Free to Play, Indie, Massively Multiplayer, RPG, Strategy;20,000 - 50,000;52;5;47;0;0;1
551060;Creekside Creep Invasion;Casual, Indie, Simulation;0 - 20,000;11;3;8;0;0;0
551080;Rescue your chickens;Adventure, Casual, Indie, Simulation;20,000 - 50,000;95;39;56;215;230;0
551100;Oblivion's Edge;Action, Casual, Free to Play, Indie;0 - 20,000;9;3;6;0;0;0
551110;Wayout;Casual;50,000 - 100,000;937;116;821;148;190;7
551130;Tiki Brawl;Casual, Indie, Strategy;0 - 20,000;1;0;1;0;0;0
551150;Labyrinths of the World: Shattered Soul Collector's Edition;Action, Casual, Indie;0 - 20,000;12;0;12;0;0;0
551160;Spirit of Revenge: Cursed Castle Collector's Edition;Action, Casual, Indie;0 - 20,000;3;0;3;0;0;0
551170;Onmyoji;Action, Adventure, Strategy;500,000 - 1,000,000;2132;474;1658;2289;358;752
551190;123 Slaughter Me Street 2;Action, Casual, Indie, Sports;20,000 - 50,000;143;29;114;7;7;0
551320;Lord Darydikilkil;Casual, Simulation, Strategy;0 - 20,000;11;4;7;0;0;0
551330;Sea of Lies: Mutiny of the Heart Collector's Edition;Indie;0 - 20,000;2;1;1;0;0;0
551360;Myths of the World: Chinese Healer Collector's Edition;Adventure;0 - 20,000;7;0;7;0;0;1
551370;Gravity Sketch;Violent, Gore, Action, Adventure, Strategy;0 - 20,000;177;47;130;1001;1001;6
551380;Danse Macabre: The Last Adagio Collector's Edition;Indie, RPG;0 - 20,000;7;0;7;0;0;0
551440;Chiaro and the Elixir of Life;Indie;0 - 20,000;30;9;21;0;0;0
551450;Furious Angels;Action, Indie;20,000 - 50,000;332;49;283;56;96;0
551500;Star Fight;Adventure, Indie, RPG;20,000 - 50,000;22;20;2;261;292;4
551520;Last Days of Spring 2;Indie, Sports;20,000 - 50,000;43;12;31;266;266;0
551550;ASSASSINATION BOX;Action, Casual, Indie, Simulation;100,000 - 200,000;44;87;-43;202;206;0
551570;Sarab: Duji Tower;Adventure, Indie;0 - 20,000;21;2;19;0;0;0
551570;Sarab: Duji Tower;Casual, Indie;0 - 20,000;21;2;19;0;0;0
551610;Virtual Army: Revolution;Action, Adventure, Indie, RPG, Simulation;0 - 20,000;13;13;0;0;0;0
551620;Approaching Infinity;Action, Adventure, Indie;0 - 20,000;195;18;177;0;0;5
551630;Navalia;Action, Indie;0 - 20,000;17;20;-3;0;0;0
551650;The Bedtime Story;Action, Indie;0 - 20,000;12;7;5;0;0;0
551680;Bad birthday;Action;0 - 20,000;14;17;-3;267;272;0
551690;Counter Fight;Action, Adventure;0 - 20,000;174;38;136;27;27;0
551700;Gunheart;Indie, RPG;0 - 20,000;248;70;178;102;191;0
551700;Gunheart;Action, Adventure, Simulation;0 - 20,000;248;70;178;102;191;0
551720;Unearthed Inc: The Lost Temple;Adventure, Casual, Indie, RPG;0 - 20,000;25;9;16;0;0;0
551730;Toukiden 2;Adventure, Casual, Indie, RPG, Strategy;50,000 - 100,000;1066;271;795;314;314;19
551750;Survival VR;Adventure, Indie;0 - 20,000;16;3;13;0;0;0
551770;ECHO;Action, Adventure, Indie;200,000 - 500,000;1155;307;848;494;591;3
551840;Crystal Shard Adventure Bundle;RPG;0 - 20,000;8;2;6;0;0;0
551860;Abandon Ship;Action, Indie;50,000 - 100,000;805;287;518;277;277;187
551930;Skater 2D;Indie;50,000 - 100,000;46;29;17;208;220;0
551960;DatavizVR Demo;Adventure, Casual;0 - 20,000;13;1;12;0;0;0
552000;Blowhards;Casual, Indie, Sports, Early Access;0 - 20,000;4;1;3;0;0;0
552030;Artillerists;RPG;20,000 - 50,000;101;32;69;0;0;0
552060;EscapeVR: The Basement;Adventure, Indie, RPG;0 - 20,000;72;19;53;3;3;1
552080;IronWolf VR;Software Training;20,000 - 50,000;968;44;924;290;290;13
552100;Brick Rigs;Casual, Indie;1,000,000 - 2,000,000;28576;2091;26485;9859;1182;1425
552110;Puzzle Pirates: Dark Seas;Action, Adventure, Casual, Indie;100,000 - 200,000;371;128;243;4;4;1
552120;Orbit - Playing with Gravity;Adventure, Casual, Indie;0 - 20,000;8;3;5;0;0;0
552130;Whiplash - Crash Valley;Adventure, Casual, Indie;20,000 - 50,000;111;129;-18;126;199;0
552140;CAGE;Indie;50,000 - 100,000;101;17;84;16;21;0
552150;Willie's Haunted Hayride;Nudity, Violent, Strategy;0 - 20,000;0;1;-1;0;0;0
552160;Hade;Indie, Massively Multiplayer, Simulation;20,000 - 50,000;248;27;221;95;95;0
552180;Goblin.Life;Action, Indie;0 - 20,000;1;0;1;0;0;0
552200;peakvox Mew Mew Chamber for Steam;Action, Adventure, Casual, Indie, RPG;0 - 20,000;42;1;41;0;0;0
552200;peakvox Mew Mew Chamber for Steam;Action, Adventure, Indie;0 - 20,000;42;1;41;0;0;0
552210;peakvox Route Candle for Steam;Action, Free to Play, Massively Multiplayer, Simulation;0 - 20,000;3;0;3;0;0;1
552220;Invaders!;Adventure, Indie;0 - 20,000;1;0;1;0;0;0
552230;Doomsday Survival:Training;Action, Indie;0 - 20,000;9;5;4;0;0;0
552240;Fancy Trangram VR;Adventure, Casual, Indie, RPG;20,000 - 50,000;8;3;5;0;0;0
552240;Fancy Trangram VR;Adventure, Casual, Simulation;20,000 - 50,000;8;3;5;0;0;0
552270;Primitive Road;Casual, Simulation;0 - 20,000;4;5;-1;0;0;0
552280;Tayutama 2-you're the only one-;Casual, Racing, Sports;50,000 - 100,000;2211;101;2110;410;648;6
552300;Soldier Sortie :VR Agent 006;Adventure, Casual, Free to Play, Indie;0 - 20,000;7;6;1;0;0;0
552310;Anguished;Sexual Content, Violent, Gore, Adventure, Indie;0 - 20,000;3;4;-1;0;0;0
552330;Happy Birthday, Bernard;Adventure, Casual, Indie, Early Access;0 - 20,000;5;1;4;0;0;0
552340;Danger Room;Action, Casual, Indie;0 - 20,000;1;2;-1;0;0;0
552350;Unhappy Ever After;Action, Strategy;20,000 - 50,000;15;10;5;0;0;0
552370;Riders of Asgard;Strategy;0 - 20,000;17;2;15;0;0;0
552380;[ R.U.M.A ];Indie, Massively Multiplayer, Racing, Simulation, Sports;0 - 20,000;8;2;6;0;0;0
552390;Druid;Action, Indie, Sports;100,000 - 200,000;171;58;113;179;179;0
552400;Sweep'n'Sweep;Nudity, Violent, Gore, Action;0 - 20,000;32;2;30;0;0;0
552410;Project Abyss;Casual, Indie;0 - 20,000;39;26;13;0;0;0
552440;The Talos Principle VR;Casual, Indie;50,000 - 100,000;611;123;488;97;169;4
552450;Serious Sam VR: The First Encounter;Action, Indie;50,000 - 100,000;516;81;435;41;59;1
552480;Havoc Runner;Strategy;20,000 - 50,000;1;1;0;0;0;0
552500;Warhammer: Vermintide 2;Indie, Early Access;2,000,000 - 5,000,000;90899;16581;74318;2638;474;5124
552520;Far Cry 5;Action, Indie;2,000,000 - 5,000,000;106228;26379;79849;2109;1540;2193
552540;Lotia;Violent, Action, Indie;0 - 20,000;7;5;2;0;0;0
552550;Space Rift NON-VR - Episode 1;Adventure, Indie, Simulation, Strategy;0 - 20,000;0;6;-6;0;0;0
552570;The New Queen;Adventure, Casual, Indie, RPG;50,000 - 100,000;11;9;2;227;243;0
552590;The Sexy Brutale;Action, Early Access;100,000 - 200,000;3058;238;2820;188;250;9
552600;Outscape;Simulation;50,000 - 100,000;321;98;223;0;0;0
552610;Ninja Smasher!;Action, Adventure, Indie, RPG, Sports, Strategy, Early Access;0 - 20,000;18;3;15;0;0;0
552620;ATOM RPG: Post-apocalyptic indie game;Action, Indie, Strategy, Early Access;500,000 - 1,000,000;7858;1493;6365;4120;5042;190
552630;Keep Watching VR;Indie;0 - 20,000;8;5;3;0;0;0
552670;Rite of Passage: The Perfect Show Collector's Edition;Indie, Simulation, Sports;0 - 20,000;4;3;1;0;0;0
552690;Fantasy Fairways;Casual, Indie, Simulation, Strategy;0 - 20,000;5;0;5;0;0;0
552700;WORLD OF FINAL FANTASY;Simulation;100,000 - 200,000;2227;585;1642;660;496;24
552720;Saga of the North Wind;Action, Adventure, RPG;0 - 20,000;10;3;7;0;0;0
552780;Dexodonex;Action, Casual, Free to Play, Indie;0 - 20,000;70;18;52;207;211;1
552800;Swingin Swiggins;Casual, Indie, Strategy;0 - 20,000;4;4;0;0;0;0
552870;aMAZEing adventures;Action, Casual, Indie;0 - 20,000;5;8;-3;0;0;0
552880;STARDROP;Action, Adventure, Indie, Early Access;0 - 20,000;206;25;181;123;123;0
552900;Fields XY;RPG;0 - 20,000;35;7;28;529;560;76
552910;Tokyo Tattoo Girls;Action, Casual, Indie;0 - 20,000;24;28;-4;0;0;0
552920;Sailaway - The Sailing Simulator;Adventure, Indie;20,000 - 50,000;638;291;347;5590;5590;33
552940;Snakes - N - Ladders : Origins - Episode 1;Action, Adventure;0 - 20,000;1;1;0;0;0;0
552960;Fastigium;Action, Casual, Indie;20,000 - 50,000;25;22;3;5;5;0
552970;Sumoman;Indie, Strategy;50,000 - 100,000;427;104;323;122;142;1
552990;World of Warships;Action, Free to Play, Simulation;10,000,000 - 20,000,000;94378;22622;71756;3969;222;10304
553000;Escape Artist: The Trial;Action, Casual, Indie;0 - 20,000;8;16;-8;0;0;0
553040;BASMENT DWELLERS;Action, Indie;0 - 20,000;12;1;11;0;0;0
553050;Welcome Home, Love;Violent, Action, Adventure, Indie;0 - 20,000;11;6;5;0;0;0
553100;Timber! The Logging Experts;Casual, Simulation;0 - 20,000;7;16;-9;0;0;0
553110;Alpine Ski VR;Action, Casual, Indie;0 - 20,000;17;12;5;0;0;0
553130;Into The Unknown;Adventure, Indie;20,000 - 50,000;64;28;36;99;99;0
553140;Green Mirror;Casual, Indie, RPG;0 - 20,000;0;0;0;0;0;0
553150;VR Dungeon;Violent, Action, Indie;0 - 20,000;5;6;-1;0;0;0
553210;Warhammer 40,000: Space Wolf;;100,000 - 200,000;797;404;393;352;563;5
553260;Realpolitiks;Violent, Gore, Adventure, Casual, Indie;50,000 - 100,000;688;422;266;2939;2969;14
553290;Drift King: Survival;Action, Casual, Indie;0 - 20,000;28;42;-14;0;0;0
553310;Lethal League Blaze;Action, Casual;200,000 - 500,000;5279;171;5108;926;766;60
553320;SYREN;Simulation, Sports;0 - 20,000;20;17;3;0;0;0
553330;Clutter 7: Infinity, Joe's Ultimate Quest;Violent, Gore, Adventure, Indie, Early Access;0 - 20,000;5;0;5;0;0;2
553340;SolarGun;Adventure, Casual;50,000 - 100,000;168;31;137;144;165;0
553350;Space Ghost Pirate Zombie Slayer;Adventure, Indie, RPG, Early Access;0 - 20,000;3;2;1;0;0;0
553410;Pirate Defense;Strategy;0 - 20,000;5;5;0;0;0;0
553420;TUNIC;Adventure, Indie, RPG, Strategy;500,000 - 1,000,000;7374;551;6823;567;592;246
553430;Skill Master VR -- Learn Meditation;Violent, Gore, Action, Massively Multiplayer, Early Access;0 - 20,000;3;2;1;0;0;0
553440;R.A.T.S. (Regulatory Astro-Topographical Stabilizer);Action, Adventure;0 - 20,000;12;3;9;0;0;0
553450;The Purge Day;Adventure, Free to Play, Indie, RPG;0 - 20,000;24;18;6;0;0;0
553470;Destination Ares;Casual, Indie, Strategy;0 - 20,000;12;10;2;0;0;0
553480;The Pirate's Fate;Action, Casual, Indie;0 - 20,000;285;36;249;13;24;1
553490;Wild Game Hunter VR;Action, Simulation;0 - 20,000;1;2;-1;0;0;0
553520;Trainz Railroad Simulator 2019;RPG;50,000 - 100,000;1299;450;849;2945;2945;408
553530;Teratini VR;Adventure, Indie;0 - 20,000;1;1;0;0;0;0
553560;The Maestros;Violent, Gore, Action, Adventure, Indie, RPG, Early Access;0 - 20,000;12;1;11;0;0;0
553570;iFactor;Simulation, Sports;0 - 20,000;12;17;-5;0;0;0
553590;Hot Squat;Violent, Action, Adventure, RPG;20,000 - 50,000;130;13;117;0;0;0
553610;ArsonVille;Action, Casual, Indie;0 - 20,000;19;8;11;0;0;0
553630;Wipe Out VR;Adventure;0 - 20,000;1;2;-1;0;0;0
553640;ICEY;Video Production;1,000,000 - 2,000,000;21458;2200;19258;897;283;45
553660;PWND;Casual, Indie;100,000 - 200,000;633;263;370;67;48;0
553680;Hand Eye Cubination;Action, Adventure, Indie, Strategy, Early Access;0 - 20,000;0;1;-1;0;0;0
553690;Dustoff Heli Rescue 2;Action, Indie, Early Access;0 - 20,000;18;7;11;0;0;0
553740;Echo Lake;Action, Indie, Strategy, Early Access;0 - 20,000;16;1;15;0;0;0
553780;ARK BOX Unlimited;Casual, Indie;0 - 20,000;20;5;15;158;158;0
553790;Once in Yaissor;Casual, Indie, Simulation, Sports;200,000 - 500,000;948;161;787;210;266;452
553800;Lunar Stone - Origin of Blood;Action, Casual, Indie, Simulation, Sports;0 - 20,000;26;18;8;0;0;0
553820;DeathMetal;Simulation;20,000 - 50,000;32;15;17;266;275;0
553830;100 nya;Sexual Content, Violent, Action, Indie, Simulation;0 - 20,000;22;2;20;0;0;0
553880;Archangel: Hellfire - Enlist FREE;Casual, Indie;50,000 - 100,000;202;158;44;190;210;1
553910;Mystic Defense;Adventure, Indie;0 - 20,000;2;3;-1;0;0;0
553950;GRIDD: Retroenhanced;Violent, Gore, Action, Indie, Early Access;0 - 20,000;61;3;58;0;0;0
553960;Husk;Action, Casual, Simulation;20,000 - 50,000;280;364;-84;228;228;1
554140;Desert Ride Coaster;RPG, Strategy;20,000 - 50,000;31;20;11;14;8;1
554150;Frequent Flyer;Casual, Free to Play, Indie, Simulation;20,000 - 50,000;72;9;63;111;141;4
554180;Pale Spectrum - Part Two of the Book of Gray Magic;Adventure, Indie;0 - 20,000;33;5;28;0;0;0
554220;Oafmatch;Casual, Simulation, Strategy;0 - 20,000;53;10;43;0;0;0
554280;Time Carnage VR;Action, Adventure, Indie;0 - 20,000;68;22;46;0;0;0
554290;Himawari - The Sunflower -;Action, Casual, Indie;;;;0;;;
554310;Rage Wars;Adventure, Casual, Indie;50,000 - 100,000;1619;185;1434;168;209;3
554330;Choppa;Adventure, Casual, Indie;50,000 - 100,000;88;29;59;262;288;0
554470;BladeShield;Casual, Indie;0 - 20,000;24;2;22;0;0;0
554510;The Golf Club 2;Strategy;50,000 - 100,000;485;306;179;1469;1469;6
554530;CRACKHEAD;Action, Adventure, Indie, Early Access;100,000 - 200,000;650;423;227;232;227;2
554550;A Haunting : Witching Hour;Adventure, Casual, Indie, RPG, Strategy;0 - 20,000;4;7;-3;0;0;0
554560;Amaranthine Voyage: The Tree of Life Collector's Edition;Adventure, Indie, RPG;0 - 20,000;5;0;5;0;0;0
554570;Witanlore: Dreamtime;Action, Early Access;0 - 20,000;33;34;-1;0;0;0
554590;Little Kingdom 2;Violent, Action, RPG;0 - 20,000;5;0;5;0;0;0
554600;Learn Japanese To Survive! Katakana War;Indie, Simulation, Strategy;20,000 - 50,000;406;34;372;332;332;7
554610;Ultramegon;Adventure, Casual;0 - 20,000;0;0;0;0;0;0
554620;Life is Strange: Before the Storm;Action, Free to Play, Indie, Massively Multiplayer, RPG;1,000,000 - 2,000,000;33417;2448;30969;628;588;63
554660;Puzzle Poker;Action, Adventure, Casual, Indie;0 - 20,000;30;4;26;0;0;1
554670;Infektor;Action, Adventure, Indie;0 - 20,000;11;2;9;0;0;0
554680;Crazy Saloon VR;Action, Adventure, Indie;0 - 20,000;9;4;5;0;0;0
554690;Rotation Phonology: Break;Action, Adventure, Indie;0 - 20,000;8;0;8;0;0;0
554700;Viking Escape;Adventure, Casual, Indie, RPG;0 - 20,000;7;3;4;0;0;0
554710;Spell Cast;Casual, Indie;20,000 - 50,000;28;11;17;0;0;3
554770;Heavily Armed;Sexual Content, Nudity, Casual, Indie;0 - 20,000;9;27;-18;284;284;31
554800;Masky;Action, Adventure, Indie;100,000 - 200,000;119;29;90;206;242;0
554810;The Wild Eternal;Action, Adventure, Indie, Simulation;0 - 20,000;97;30;67;4;4;1
554820;VideoPad Video Editor;Action, Adventure, Indie;0 - 20,000;41;11;30;0;0;0
554870;SUPERHYPERCUBE;Action, Adventure, Indie;0 - 20,000;23;3;20;0;0;0
554920;0 Day;Action, Adventure, Indie;0 - 20,000;1;1;0;0;0;0
554940;VR Apocalypse;Action, Casual, Indie, Sports, Early Access;0 - 20,000;7;2;5;0;0;0
554980;LolliPop: The Best Indie Game;Action, Indie;0 - 20,000;17;2;15;0;0;0
555000;GOAT OF DUTY;Action, Adventure, Indie, Racing, Simulation;100,000 - 200,000;3050;470;2580;146;27;2
555010;M.E.R.C.;Adventure, Casual;0 - 20,000;39;19;20;0;0;0
555040;Fan Fun;Action, Casual, Indie, Massively Multiplayer;0 - 20,000;0;0;0;0;0;0
555050;Racket Fury: Table Tennis VR;Action, Casual, Indie, Simulation, Strategy, Early Access;0 - 20,000;235;48;187;0;0;0
555060;Final Soccer VR;Action, Indie, RPG, Strategy;0 - 20,000;93;26;67;0;0;2
555080;Isyium;Action, Adventure, Indie, RPG;0 - 20,000;4;5;-1;0;0;0
555130;Sonic Hunter VR;Gore, Action, Adventure, Indie;0 - 20,000;8;4;4;0;0;0
555150;The First Tree;Action, Adventure, Casual, Indie, RPG;200,000 - 500,000;3828;1212;2616;110;74;4
555160;Pavlov VR;Casual, Indie, Strategy;2,000,000 - 5,000,000;33232;2024;31208;819;295;685
555170;OneManVurgeR;Action;0 - 20,000;8;3;5;0;0;0
555180;InfinitasDM;Adventure, Casual, Indie, Early Access;0 - 20,000;26;22;4;0;0;1
555210;Trick and Treat - Visual Novel;Indie, RPG, Early Access;200,000 - 500,000;3180;373;2807;57;68;1
555220;Detention;Adventure, Casual, Indie;500,000 - 1,000,000;11038;2610;8428;221;181;9
555230;The table at war VR;Action, Casual, Indie;0 - 20,000;3;1;2;0;0;0
555260;The Butterfly Sign: Human Error;Action, Indie;50,000 - 100,000;39;38;1;278;254;0
555280;M.A.C.E.;Casual, Simulation, Early Access;20,000 - 50,000;29;25;4;0;0;0
555290;Little Briar Rose;Action, Indie;0 - 20,000;157;30;127;0;0;0
555290;Little Briar Rose;Action, Casual, Indie;0 - 20,000;157;30;127;0;0;0
555310;Satellite;Action, Adventure, Indie, RPG, Strategy, Early Access;0 - 20,000;44;9;35;0;0;0
555320;Never give up!;Action, Indie;20,000 - 50,000;106;32;74;336;336;0
555340;Bitlogic - A Cyberpunk Arcade Adventure;Casual;0 - 20,000;16;1;15;0;0;0
555370;1812: The Invasion of Canada;Action, Casual, Indie;0 - 20,000;16;20;-4;0;0;0
555400;Collision Course;Strategy;20,000 - 50,000;197;60;137;89;120;0
555410;Hearts of Chaos;Casual, Indie, Strategy;20,000 - 50,000;14;11;3;249;249;0
555450;Deus Ex: Breach;Action, Adventure, Casual, Indie, Racing, Sports;100,000 - 200,000;135;165;-30;92;82;0
555510;MachiaVillain;Action, Indie, Strategy;100,000 - 200,000;457;239;218;0;0;7
555520;Riddles of Fate: Wild Hunt Collector's Edition;Gore, Adventure, Indie;0 - 20,000;9;0;9;0;0;0
555570;Infestation: The New Z;Action, Casual, Indie;5,000,000 - 10,000,000;17768;15532;2236;1206;66;468
555580;The Legend of Dark Witch 2 （魔神少女エピソード２）;Indie, Simulation, Early Access;0 - 20,000;51;5;46;0;0;0
555600;Hopalong: The Badlands;Casual, Indie, Strategy;0 - 20,000;24;1;23;0;0;0
555610;Gunmetal Arcadia Zero;Indie, Simulation;50,000 - 100,000;88;31;57;114;114;0
555630;A Magical High School Girl / 魔法の女子高生;Sports;50,000 - 100,000;135;45;90;28;28;0
555640;Japanese School Life;Action, Adventure, Indie, RPG, Simulation, Early Access;50,000 - 100,000;234;53;181;134;157;0
555650;Love, Guitars, and the Nashville Skyline;Adventure, Casual, Indie;0 - 20,000;21;11;10;0;0;0
555660;Red Forest;Action, Strategy, Early Access;100,000 - 200,000;83;136;-53;462;612;34
555670;Infinitum;Action, Indie, Early Access;50,000 - 100,000;67;52;15;338;361;5
555710;Zolg;Action, Indie, Simulation, Early Access;50,000 - 100,000;142;44;98;184;226;2
555720;Grave Danger;Action, Casual, Indie, Simulation, Sports, Early Access;20,000 - 50,000;33;12;21;0;0;0
555730;Robot City Stadium;Action, Adventure, Indie;0 - 20,000;11;3;8;0;0;0
555750;Masked Forces;Racing;50,000 - 100,000;302;151;151;9;9;5
555810;Quicken WillMaker Plus 2017;Action, Adventure, Indie, RPG;20,000 - 50,000;1;0;1;0;0;0
555820;Grim Facade: Mystery of Venice Collector’s Edition;Utilities;0 - 20,000;2;12;-10;0;0;0
555830;Vecitas;Gore, Action, Indie, RPG, Early Access;0 - 20,000;13;15;-2;292;300;0
555830;Vecitas;Action, Casual, Indie;0 - 20,000;13;15;-2;292;300;0
555850;Galactic Landing;Free to Play, Indie, Strategy;20,000 - 50,000;22;15;7;458;463;1
555880;Sairento VR;Action, Adventure, Casual, Simulation;100,000 - 200,000;1382;238;1144;57;35;4
555890;Burgers 2;Early Access;0 - 20,000;21;10;11;0;0;0
555920;Dark Egypt;Utilities, Early Access;20,000 - 50,000;34;62;-28;237;259;0
555930;Madness;Indie, Simulation, Strategy;20,000 - 50,000;47;39;8;225;225;35
555950;Danganronpa Another Episode: Ultra Despair Girls;Action, Adventure, Casual, Indie;200,000 - 500,000;3876;541;3335;865;1110;100
555970;Awaken;Adventure, Casual, Indie;50,000 - 100,000;24;3;21;0;0;0
556000;Gold Crusader Remastered Edition;Indie, RPG;0 - 20,000;1;11;-10;0;0;0
556050;Hyper Jam;Action, Racing, Early Access;20,000 - 50,000;398;27;371;395;395;5
556060;Detective Gallo;Action, Casual;100,000 - 200,000;117;20;97;0;0;0
556090;FIGHTING SPACE;Adventure, Casual, Indie;0 - 20,000;1;0;1;0;0;0
556130;Drones, The Human Condition;Action, Indie;50,000 - 100,000;112;153;-41;2;3;0
556140;We Are Stars;Action, Adventure, Casual, Indie, Strategy;0 - 20,000;37;5;32;0;0;0
556160;PHAT STACKS;Simulation, Strategy;200,000 - 500,000;92;104;-12;218;217;2
556180;Mysterium: A Psychic Clue Game;Indie;100,000 - 200,000;587;157;430;387;553;19
556200;Blue Crystal;Indie, RPG, Simulation, Early Access;0 - 20,000;0;1;-1;0;0;0
556230;Off-Road Paradise: Trial 4x4;Action, Indie;0 - 20,000;60;35;25;19;19;0
556240;Disoriented;Adventure, Casual, Free to Play, Indie, RPG;50,000 - 100,000;293;60;233;49;49;0
556250;Final Core;RPG;0 - 20,000;17;6;11;0;0;0
556260;Gil's Lucid Dreams;Action, Indie;20,000 - 50,000;21;10;11;228;237;2
556280;Neon Prism;Violent, Action, Strategy, Early Access;200,000 - 500,000;226;115;111;227;255;1
556300;Age of Farming;Adventure;0 - 20,000;11;21;-10;0;0;0
556310;TMM: Entourage;Indie;0 - 20,000;5;5;0;0;0;0
556340;King Kaiju;Action, Adventure, Indie, Early Access;0 - 20,000;118;35;83;20;20;0
556440;Vicious Circle;Adventure, Casual, Indie;0 - 20,000;165;93;72;0;0;0
556480;Rugby League Live 4;Violent, Gore, Adventure, Indie, RPG;0 - 20,000;97;39;58;0;0;14
556520;Housekeeping VR;Action, Casual, Free to Play, Indie, Strategy;0 - 20,000;10;7;3;0;0;0
556530;Faerie Solitaire Dire;Action, Casual, Indie;0 - 20,000;32;10;22;0;0;2
556540;Pyramid VR;Adventure, Indie, RPG;0 - 20,000;7;6;1;0;0;0
556550;The Horus Heresy: Betrayal at Calth;Adventure, Casual;0 - 20,000;51;58;-7;8;8;0
556640;Gladius | Gladiator VR Sword fighting;Action, Casual, Indie;0 - 20,000;187;57;130;0;0;1
556680;INTRUDER - WAR AREAS;Action, Adventure, RPG;0 - 20,000;2;4;-2;0;0;0
556700;Heavy Impact;Adventure, Strategy;0 - 20,000;3;4;-1;0;0;0
556710;Marrow;Nudity, Violent, Gore, Adventure, Casual, Simulation;0 - 20,000;19;10;9;0;0;0
556720;Off-Road Super Racing;Free to Play, Indie, Massively Multiplayer, Simulation;0 - 20,000;38;46;-8;2;2;1
556740;LEGRAND LEGACY: Tale of the Fatebounds;Adventure, Indie;20,000 - 50,000;297;131;166;302;302;0
556750;SourVR Video Player;Free to Play;20,000 - 50,000;24;19;5;16;26;0
556770;Star Phoenix;Action, Indie;0 - 20,000;9;17;-8;1197;2125;0
556780;Neptune: Arena FPS;Casual;20,000 - 50,000;45;19;26;23;23;0
556820;Warbands: Bushido;Casual;100,000 - 200,000;799;351;448;9;11;6
556830;GemWars;Violent, Adventure, Casual, Free to Play, Indie;0 - 20,000;3;0;3;0;0;0
556840;The Dome;Casual, Free to Play, Indie;0 - 20,000;13;21;-8;0;0;0
556850;Handy Dice;Casual, Indie;0 - 20,000;1;2;-1;0;0;0
556860;Gladiator School;Casual, Indie, Sports;20,000 - 50,000;224;94;130;487;487;1
556870;Charlie's Adventure;Action, Adventure, Indie;100,000 - 200,000;215;131;84;241;269;0
556890;Dreamcage Escape;Adventure;0 - 20,000;52;14;38;0;0;0
556920;Equilibrium Of Divinity;Action, Casual;0 - 20,000;14;5;9;0;0;0
556960;Lost Wing;Action, Casual;0 - 20,000;26;6;20;0;0;0
556990;Rage Against The Zombies;Action, Adventure, Casual, Indie, Strategy;0 - 20,000;14;12;2;0;0;0
557030;Avenger Bird;Casual, Indie;20,000 - 50,000;71;27;44;285;200;1
557040;99Vidas;Violent, Free to Play, Indie, Strategy, Early Access;50,000 - 100,000;442;113;329;361;427;0
557180;League of Maidens;Adventure, Indie;500,000 - 1,000,000;3275;2742;533;299;48;69
557240;Afterlife;Racing, Sports;0 - 20,000;19;3;16;0;0;1
557260;iREC;Adventure;200,000 - 500,000;144;152;-8;226;269;0
557330;>//:System.Hack;Adventure, Casual;0 - 20,000;23;7;16;0;0;0
557340;My Friend Pedro;Adventure, Indie, RPG;500,000 - 1,000,000;24222;1035;23187;305;184;38
557400;Midas Gold Plus;Adventure, Indie;200,000 - 500,000;1477;225;1252;75;89;40
557410;Dream Quest;Action, Casual, Indie;0 - 20,000;241;26;215;0;0;1
557420;Kamio Recoil;Adventure, Indie;20,000 - 50,000;3;2;1;0;0;0
557460;ToledoVR;Adventure, Casual, Indie;0 - 20,000;4;3;1;0;0;0
557520;Torn;Violent, Action, Racing, Simulation;0 - 20,000;132;72;60;203;203;0
557570;Able Black;Action, Indie;0 - 20,000;28;0;28;0;0;1
557580;Ancient Guardian;Casual, Indie, Strategy, Early Access;100,000 - 200,000;103;37;66;249;301;0
557600;Gorogoa;Adventure, Indie, Simulation;200,000 - 500,000;13136;326;12810;110;110;25
557630;Hello Charlotte EP2: Requiem Aeternam Deo;Adventure, Casual;50,000 - 100,000;1060;30;1030;202;202;12
557670;Spooky Night;Free to Play, RPG, Early Access;0 - 20,000;30;3;27;0;0;0
557680;Germ Wars;Action, Indie, Strategy, Early Access;100,000 - 200,000;116;98;18;232;222;0
557700;Empyrean;Indie, Simulation, Early Access;0 - 20,000;11;5;6;0;0;0
557720;Love Chronicles: The Spell Collector's Edition;Casual, Sports;0 - 20,000;6;1;5;0;0;0
557730;I Hate Santa;Adventure, Casual, Indie;0 - 20,000;14;3;11;0;0;0
557750;Giants: Citizen Kabuto;Adventure, Casual;0 - 20,000;126;8;118;0;0;0
557760;Of Light and Darkness;Action, Adventure, RPG;0 - 20,000;1;0;1;0;0;0
557770;Pawn;Action, Indie;0 - 20,000;14;6;8;0;0;0
557780;Atom Fishing II;Sexual Content, Nudity, Action, Casual, Indie, RPG, Simulation, Strategy;200,000 - 500,000;1140;375;765;108;74;155
557790;Goblet of Maya;Indie, Simulation;20,000 - 50,000;14;1;13;255;285;0
557810;Clicker Guild;Free to Play, Simulation;100,000 - 200,000;340;286;54;308;295;4
557850;Magnificent Ships: Volume 1;Adventure, Casual, Indie;0 - 20,000;14;1;13;0;0;0
557860;Azurea Juncture;Adventure;0 - 20,000;15;1;14;0;0;0
557880;Say Goodbye;Action, RPG, Strategy;20,000 - 50,000;106;83;23;157;157;0
557890;Sunset's Ashes;Adventure, Indie;50,000 - 100,000;123;18;105;0;0;0
557900;A Walk in the Woods;Action, Casual, Simulation, Sports, Early Access;0 - 20,000;61;22;39;0;0;0
557940;The Muybridge Mausoleum;Action, Casual, Indie;0 - 20,000;7;1;6;0;0;0
557950;FATAL ERROR - RTS;Action, Indie;0 - 20,000;64;2;62;0;0;0
557960;Beach Bowling Dream VR;Adventure, Indie, RPG;0 - 20,000;11;10;1;0;0;0
557970;Teria;Adventure, Casual, Indie, Strategy;20,000 - 50,000;23;27;-4;145;205;84
558010;REVIVAL RESET;Action, Indie, RPG, Early Access;0 - 20,000;1;0;1;0;0;0
558020;JETPACK PORTER;Action, Indie, Strategy;0 - 20,000;2;1;1;0;0;0
558030;ROBUST ROAD ROLLER;Sports;0 - 20,000;2;0;2;0;0;0
558050;Princess Kidnapper VR;Indie, Massively Multiplayer, RPG, Simulation, Strategy;0 - 20,000;5;4;1;0;0;0
558060;Candy Island;Adventure, Indie;0 - 20,000;2;3;-1;0;0;0
558100;Art of War: Red Tides;Action, Indie, RPG;1,000,000 - 2,000,000;5274;1422;3852;237;57;44
558110;Odyssey - The Story of Science;Casual, Indie, RPG, Strategy;20,000 - 50,000;208;66;142;0;0;0
558260;Gravel;Action, Indie;100,000 - 200,000;671;239;432;351;351;2
558320;Among the Innocent: A Stricken Tale;Indie, RPG, Strategy;0 - 20,000;53;16;37;0;0;0
558340;Faces of Illusion: The Twin Phantoms;Sexual Content, Casual, Indie;50,000 - 100,000;99;62;37;158;158;1
558410;Cannonfire Concerto;Action;0 - 20,000;15;4;11;0;0;0
558420;Stories Untold;RPG;100,000 - 200,000;3911;563;3348;152;201;4
558440;The Night Christmas Ended;Action, Casual, Indie, Early Access;0 - 20,000;8;1;7;0;0;0
558450;Fibrillation HD;Violent, RPG;20,000 - 50,000;258;34;224;121;141;0
558490;Crossroad Mysteries: The Broken Deal;Adventure, Indie, Simulation;0 - 20,000;69;25;44;0;0;1
558660;it's always monday;Action, Indie, Racing;100,000 - 200,000;228;54;174;195;196;0
558670;The Agency of Anomalies: Cinderstone Orphanage Collector's Edition;Action;0 - 20,000;10;0;10;0;0;0
558680;KYOTO TANOJI QUEST;Indie, Simulation, Strategy;0 - 20,000;11;5;6;0;0;0
558720;Tribal Siege;Casual, Free to Play, Indie, Simulation;0 - 20,000;1;3;-2;0;0;0
558740;CRAFT: Work VR Shop;Casual, Indie;0 - 20,000;4;4;0;0;0;0
558750;Goaltender VR;Action, Adventure, Indie, Racing;0 - 20,000;20;1;19;0;0;0
558780;Sonya: The Great Adventure;Adventure, Casual;0 - 20,000;126;46;80;0;0;1
558790;Queen's Quest 2: Stories of Forgotten Past;Adventure, Free to Play, RPG;20,000 - 50,000;198;23;175;246;246;2
558850;Children of Colossus;Sexual Content, Nudity, Indie;0 - 20,000;19;9;10;227;268;0
558870;Club Naughty;Action, Indie, Strategy, Early Access;0 - 20,000;45;89;-44;0;0;0
558990;Opus Magnum;Action, Indie;200,000 - 500,000;4946;130;4816;520;331;53
559010;Cosmic Sugar VR;Action, Adventure, Casual, Indie;50,000 - 100,000;348;23;325;21;15;1
559030;Siege Saga;RPG;0 - 20,000;24;14;10;0;0;0
559070;Zak McKracken and the Alien Mindbenders;Action, Indie, Sports;20,000 - 50,000;86;9;77;5;5;9
559100;Phantom Doctrine;Action, Adventure;200,000 - 500,000;3028;1020;2008;637;211;67
559130;Inner Voices;Action, Indie;20,000 - 50,000;39;34;5;1;1;2
559140;Pinheads Bowling VR;Casual, Indie;0 - 20,000;1;4;-3;0;0;0
559150;Royal Detective: The Lord of Statues Collector's Edition;Indie;0 - 20,000;4;0;4;0;0;0
559170;Ready, Aim, Splat!;Adventure, Casual;0 - 20,000;4;3;1;0;0;0
559210;Rakuen;Sexual Content, Nudity, Adventure, Casual, Indie;200,000 - 500,000;5114;176;4938;242;396;7
559250;Ghostlight Manor;Free to Play, Indie;0 - 20,000;5;0;5;0;0;0
559260;Wayward Souls;Action, Adventure, Indie, RPG;0 - 20,000;139;43;96;244;244;1
559280;Snailiens;Casual, Indie, Racing, Simulation, Sports;0 - 20,000;5;3;2;0;0;0
559300;Thunder Spheres - Virtual Reality 3D Pool;Action, Simulation, Strategy;0 - 20,000;2;2;0;0;0;0
559310;Illyriad - Grand Strategy MMO;Violent, Action, Simulation;0 - 20,000;96;51;45;0;0;10
559330;A Fisherman's Tale;Action, Adventure, Casual, Free to Play, Massively Multiplayer, RPG, Simulation;20,000 - 50,000;1023;71;952;124;204;6
559340;Sunset Rangers;Action, Adventure;100,000 - 200,000;130;155;-25;5;5;0
559350;EURGAVA: Fight for Haaria;Action, Indie;0 - 20,000;14;10;4;211;211;0
559360;Brocat: the B Game;Indie, Strategy, Early Access;0 - 20,000;5;1;4;0;0;0
559450;Demented Pixie;Action, Indie;0 - 20,000;7;4;3;856;856;1
559610;Love Ribbon;Action, Strategy;100,000 - 200,000;1653;126;1527;527;532;4
559610;Love Ribbon;Action, Adventure, Casual, Indie, Strategy;100,000 - 200,000;1653;126;1527;527;532;4
559620;Outlaws + A Handful of Missions;Action, Casual, Indie;20,000 - 50,000;469;28;441;318;318;10
559620;Outlaws + A Handful of Missions;Adventure, Casual;20,000 - 50,000;469;28;441;318;318;10
559630;Kid Baby: Starchild;Adventure, Casual;0 - 20,000;2;2;0;0;0;0
559640;Betrayal Collection;Adventure, Casual;0 - 20,000;78;12;66;0;0;3
559640;Betrayal Collection;Adventure, Casual;0 - 20,000;78;12;66;0;0;3
559650;Witch It;Adventure, Casual;500,000 - 1,000,000;14680;1877;12803;270;133;192
559680;Vampire: The Masquerade - Redemption;Action, Adventure, RPG, Strategy;50,000 - 100,000;588;85;503;145;145;6
559850;Time Tenshi 2: Special Edition;Adventure;0 - 20,000;22;1;21;0;0;0
559870;PAKO - Car Chase Simulator;Adventure, Casual;20,000 - 50,000;117;44;73;0;0;1
559900;Gulman 4: Still alive;Casual, Indie, Simulation;0 - 20,000;99;35;64;0;0;0
559930;Causality;Video Production;0 - 20,000;31;1;30;0;0;0
559960;Power Hover;Casual, Indie, Simulation;50,000 - 100,000;270;26;244;179;229;2
559970;Shrouded Tales: The Spellbound Land Collector's Edition;Casual, Indie;0 - 20,000;2;0;2;0;0;0
559990;ERR - 001;Simulation;0 - 20,000;19;15;4;20;20;0
560000;Ladykiller in a Bind;Adventure, Casual, Indie;0 - 20,000;170;8;162;47;81;0
560010;Starship Survivor;Casual, Indie;0 - 20,000;6;4;2;0;0;0
560050;Xmas Shooting - Scramble!!;Adventure, Indie;20,000 - 50,000;106;10;96;6;6;0
560080;I was rebuilt;Action, Adventure;0 - 20,000;17;9;8;5;5;0
560130;Pillars of Eternity II: Deadfire;Action, Adventure;500,000 - 1,000,000;13981;1964;12017;1971;1038;747
560150;PLANNES;Action, Adventure;0 - 20,000;21;5;16;35;35;0
560170;STAR WARS SHADOWS OF THE EMPIRE;Indie;50,000 - 100,000;430;149;281;139;205;6
560180;World In Danger;Action, Casual, Indie, Simulation;0 - 20,000;9;0;9;0;0;0
560200;A Number's life;Indie;0 - 20,000;6;2;4;0;0;0
560220;Estiman;Casual, Indie, Simulation;0 - 20,000;39;7;32;0;0;0
560230;Black Swan;Action;20,000 - 50,000;17;51;-34;10;10;0
560250;Galaxy Girls;Animation & Modeling, Design & Illustration, Utilities, Web Publishing, Early Access;0 - 20,000;86;40;46;345;345;0
560260;Super Blue Boy Planet;Action, Casual, Indie, Simulation;200,000 - 500,000;2383;240;2143;42;61;0
560300;Thy Sword;Action, Indie, RPG;0 - 20,000;60;2;58;0;0;0
560340;Tower Ascent;Adventure, Indie;0 - 20,000;1;3;-2;0;0;0
560350;Police Quest: SWAT;Education;0 - 20,000;26;23;3;0;0;0
560370;SWAT 3: Tactical Game of the Year Edition;Action, Indie;50,000 - 100,000;183;112;71;0;0;5
560510;High Noon Revolver;Simulation, Sports;0 - 20,000;13;2;11;0;0;0
560550;void LINK;Racing, Simulation, Sports;0 - 20,000;20;1;19;0;0;0
560570;Breaking Bones;Racing, Simulation, Sports;0 - 20,000;6;7;-1;0;0;0
560600;PlanTechtor;Casual, Strategy;0 - 20,000;13;0;13;0;0;0
560640;The Cabin: VR Escape the Room;Action, Adventure, Indie;0 - 20,000;50;32;18;0;0;0
560710;Leap Up no jutsu;Casual, Indie, RPG, Strategy;20,000 - 50,000;87;32;55;197;217;30
560720;Dark Angels: Masquerade of Shadows;Sexual Content, Violent, Gore, Adventure, Indie;20,000 - 50,000;177;39;138;73;73;1
560730;The Esoterica: Hollow Earth;Action, Casual, Indie;20,000 - 50,000;61;60;1;0;0;0
560740;Shtriga: Summer Camp;Adventure, Free to Play, Indie;20,000 - 50,000;83;33;50;216;216;0
560750;World Keepers: Last Resort;Action, Free to Play, Massively Multiplayer;20,000 - 50,000;89;32;57;249;249;1
560760;Sacra Terra: Kiss of Death Collector’s Edition;Casual, Indie;20,000 - 50,000;63;65;-2;0;0;1
560770;Andoran Skye 1.5;Action, Indie, RPG;0 - 20,000;9;6;3;0;0;0
560790;Red Spider2: Exiled;Adventure, Casual, Indie;0 - 20,000;17;2;15;0;0;0
560820;The Saint: Abyss of Despair;Casual, Indie;20,000 - 50,000;65;26;39;0;0;0
560840;Tootinis;Casual, Indie;0 - 20,000;1;2;-1;0;0;0
560870;Singing Stones VR;Indie, Strategy;0 - 20,000;3;3;0;0;0;0
560920;Cyberlink PowerDVD 17 Ultra;Violent, Adventure, Indie;0 - 20,000;1;2;-1;0;0;0
560930;Marimba VR;Indie, RPG, Strategy;0 - 20,000;2;3;-1;0;0;0
560960;Magic Tavern;Action, Casual, Indie;20,000 - 50,000;5;6;-1;0;0;0
560970;Fireworks Desert Blast;Action, Casual, Indie, Early Access;0 - 20,000;23;7;16;0;0;0
561000;Delicious - Emily's Home Sweet Home;Adventure, Indie;0 - 20,000;79;5;74;0;0;2
561010;Spirit;Action, Indie, RPG;0 - 20,000;8;3;5;0;0;0
561080;The Price of Freedom;Action, Casual, Indie;20,000 - 50,000;361;27;334;29;35;0
561100;Disney's Aladdin;Violent, Gore, Adventure, Indie;0 - 20,000;35;14;21;0;0;0
561110;Disney's The Jungle Book;Adventure, Indie, RPG, Strategy;0 - 20,000;10;1;9;14;14;0
561120;Disney's The Lion King;;0 - 20,000;52;28;24;0;0;0
561190;Bamboo EP;Action, Casual, Indie;0 - 20,000;55;8;47;0;0;0
561190;Bamboo EP;Action, Adventure, Casual, Indie, Simulation;0 - 20,000;55;8;47;0;0;0
561230;Special Delivery;Action, Simulation, Strategy;0 - 20,000;14;9;5;0;0;0
561260;The Rabbit and The Owl;Casual, Indie, Simulation, Strategy;0 - 20,000;42;0;42;0;0;0
561260;The Rabbit and The Owl;Action, Indie;0 - 20,000;42;0;42;0;0;0
561340;Merlin adventurer store;Action, Indie;200,000 - 500,000;107;20;87;406;477;0
561360;VR Invaders;Adventure, Strategy;0 - 20,000;33;8;25;120;120;0
561390;BasementVR;Sexual Content, Nudity, Adventure, Casual;0 - 20,000;16;8;8;7;8;0
561420;Hot Plates;Action, Adventure, Indie;0 - 20,000;8;10;-2;331;331;0
561440;Graffiti Bombing;Indie, Strategy;20,000 - 50,000;33;20;13;0;0;0
561450;Mutant Fighting Cup 2;Design & Illustration;0 - 20,000;37;10;27;0;0;0
561480;96 Mill;Action, Casual, Indie;0 - 20,000;36;8;28;0;0;0
561490;House of Meditation;Free to Play, Strategy;0 - 20,000;2;6;-4;0;0;0
561510;DragoDino;Casual, Indie;0 - 20,000;17;2;15;0;0;0
561590;Cricket Captain 2017;Action, Casual, Free to Play, Indie, Massively Multiplayer;0 - 20,000;21;12;9;0;0;0
561590;Cricket Captain 2017;Casual, Indie;0 - 20,000;21;12;9;0;0;0
561600;MXGP3 - The Official Motocross Videogame;Adventure, Casual, Indie, RPG;100,000 - 200,000;788;125;663;3318;3477;14
561610;MotoGP17;Casual, Indie;20,000 - 50,000;402;110;292;43;43;7
561660;Decoherence;Adventure, Casual, Indie;0 - 20,000;5;0;5;0;0;0
561680;Santa's Christmas Solitaire;Action, Adventure, Casual, Indie;0 - 20,000;26;0;26;0;0;1
561680;Santa's Christmas Solitaire;Action, Adventure, Casual, Indie;0 - 20,000;26;0;26;0;0;1
561690;Emission VR;Action, Casual, Indie, Massively Multiplayer, Simulation, Sports;0 - 20,000;2;6;-4;0;0;0
561740;MidBoss;Action, Casual, Indie, Strategy, Early Access;20,000 - 50,000;223;36;187;41;41;1
561770;Just Ignore Them;Action, Adventure, Indie, RPG;50,000 - 100,000;448;126;322;188;222;2
561930;Sword of the Guardian;Casual, Indie, Simulation;0 - 20,000;38;3;35;0;0;0
561970;REALITY;Indie, Simulation, Early Access;0 - 20,000;65;33;32;10;10;0
561970;REALITY;Casual;0 - 20,000;65;33;32;10;10;0
562010;Tanki Online;Action, Adventure, Free to Play, Massively Multiplayer, RPG;500,000 - 1,000,000;3440;2012;1428;199;48;44
562050;Liquid Pinball;Action, Indie, Early Access;100,000 - 200,000;71;31;40;26;26;21
562090;Kronos;Action, Casual, Indie, Simulation, Strategy;0 - 20,000;12;7;5;0;0;0
562090;Kronos;Action, Indie;0 - 20,000;12;7;5;0;0;0
562160;The Inner Darkness;Casual, Indie;20,000 - 50,000;64;23;41;198;198;1
562210;Древняя Русь;Action, Sports;0 - 20,000;127;27;100;0;0;0
562230;Space Tyrant;Action, Indie, Sports;100,000 - 200,000;490;80;410;0;0;2
562240;The Spirit Underneath;Adventure, Indie;100,000 - 200,000;36;70;-34;270;230;0
562250;Beastmancer;Action, Adventure, Indie;0 - 20,000;59;18;41;0;0;1
562260;WAVESHAPER;Strategy;0 - 20,000;295;36;259;195;195;8
562270;Shot Shot Tactic;Adventure, Indie, RPG;200,000 - 500,000;204;251;-47;203;220;0
562280;＜/reality＞;Action;0 - 20,000;33;4;29;0;0;0
562290;Zahalia: The Knights of Galiveth;Adventure, RPG;0 - 20,000;13;11;2;409;409;1
562310;Spacecats with Lasers : The Outerspace;Casual, Indie;0 - 20,000;11;1;10;0;0;0
562320;Locked In VR;Casual, Indie;0 - 20,000;32;8;24;0;0;0
562330;Dwarflings;Casual, Indie;20,000 - 50,000;36;17;19;291;293;0
562340;Iron Wings;Casual, Indie, RPG, Simulation, Strategy, Early Access;20,000 - 50,000;35;54;-19;0;0;0
562360;Planes, Bullets and Vodka;Action, Casual, Indie;500,000 - 1,000,000;1291;237;1054;277;306;8
562410;Panty Party;Adventure, Indie;20,000 - 50,000;898;81;817;187;187;0
562420;Armor Clash II;Indie, Simulation, Strategy, Early Access;0 - 20,000;66;44;22;0;0;0
562430;Alien Hostage;Adventure, Free to Play, Indie;50,000 - 100,000;114;70;44;297;235;13
562450;Salvage Op;Action, Casual, Indie, RPG, Sports, Strategy, Early Access;0 - 20,000;6;15;-9;0;0;0
562460;Radium 2;Indie, Simulation;0 - 20,000;28;1;27;0;0;0
562470;Empire of Angels IV;RPG;50,000 - 100,000;256;138;118;595;595;4
562490;EvilMorph;Adventure;20,000 - 50,000;72;14;58;200;210;0
562500;Warstone TD;Action, Strategy, Early Access;100,000 - 200,000;2637;565;2072;8130;8206;14
562510;JugiPaint;Indie, Early Access;0 - 20,000;7;6;1;0;0;0
562520;Attempt[42];Casual, Simulation;20,000 - 50,000;105;91;14;210;213;2
562530;UniverseV: Star Domination;Action, Adventure, Casual, Indie;0 - 20,000;1;0;1;0;0;0
562540;Cabals: Card Blitz;Action, Free to Play;200,000 - 500,000;53;46;7;0;0;1
562570;Access Denied;Simulation, Sports;20,000 - 50,000;257;59;198;16;16;2
562590;Galactic Junk League;Action, Casual, Indie, Racing, Simulation, Sports;200,000 - 500,000;1229;550;679;89;36;0
562600;Our Wonderful World;Casual, Indie;50,000 - 100,000;20;11;9;264;264;10
562620;Robonauts;Simulation, Sports, Strategy;20,000 - 50,000;7;2;5;0;0;0
562640;Introvert Quest;Casual, RPG;100,000 - 200,000;80;32;48;248;234;2
562660;Pandarama: The Lost Toys;Adventure, Indie;20,000 - 50,000;49;9;40;0;0;0
562660;Pandarama: The Lost Toys;Adventure, Casual;20,000 - 50,000;49;9;40;0;0;0
562680;The Wizards Who Fell In A Hole;Adventure, Indie;0 - 20,000;8;2;6;0;0;0
562690;Immersion;Adventure, Casual, Indie, RPG, Strategy;20,000 - 50,000;15;34;-19;0;0;0
562700;Paintball 707;Casual, Simulation;0 - 20,000;26;25;1;0;0;0
562730;MechDefender - Tower Defense;Action, Indie;50,000 - 100,000;166;46;120;292;310;20
562740;Zombie Town VR;Action, Adventure, Indie;20,000 - 50,000;13;2;11;0;0;0
562810;MONOPOLY PLUS;Action, Adventure;500,000 - 1,000,000;5500;7154;-1654;382;292;251
562840;Dragon Blood;Action, Indie;20,000 - 50,000;54;60;-6;0;0;3
562860;Ion Fury;Adventure, Casual;200,000 - 500,000;6077;611;5466;648;895;23
563120;Desolate Wastes: Vendor Chronicles;Action, Adventure, Indie;500,000 - 1,000,000;92;74;18;241;250;0
563130;The Cows Are Watching;Indie, Strategy, Early Access;0 - 20,000;24;9;15;0;0;0
563150;interLOGIC;Action, Indie;50,000 - 100,000;36;11;25;233;275;0
563160;VR the Anime Girls Method / 全豚に告ぐ！これで痩せなきゃお前は終わりだ！;Action, Indie;0 - 20,000;1;5;-4;0;0;0
563170;Graveball;Action, Indie, Massively Multiplayer;0 - 20,000;11;2;9;0;0;0
563180;Dispersio;Simulation, Sports;20,000 - 50,000;59;7;52;0;0;0
563190;de Blob 2;Action;0 - 20,000;110;9;101;1017;1017;3
563200;Slay;Action, Indie;20,000 - 50,000;126;17;109;0;0;6
563250;Lemuria: Lost in Space;Action, Strategy;0 - 20,000;14;9;5;10;10;0
563260;Steel Empire;Casual;0 - 20,000;56;11;45;0;0;0
563270;In Vitra - JRPG Adventure;Violent, Gore, Action, Indie;0 - 20,000;36;18;18;0;0;0
563320;Mountain Trap: The Manor of Memories;Adventure, Casual;0 - 20,000;37;34;3;0;0;0
563330;Mountain Trap 2: Under the Cloak of Fear;Indie, Strategy;0 - 20,000;22;15;7;0;0;0
563340;Blue Tear;Action, Adventure, Casual, Indie;0 - 20,000;44;40;4;0;0;1
563370;Don't Touch The Zombies;Indie, Simulation;0 - 20,000;3;1;2;0;0;0
563380;Shadows;Simulation, Strategy;0 - 20,000;4;2;2;0;0;0
563390;Children of the Galaxy;Adventure, Casual, Indie;0 - 20,000;12;2;10;0;0;0
563400;Ludu;Casual, Free to Play, RPG;20,000 - 50,000;56;15;41;0;0;0
563410;Necroball;Action, Adventure, Casual, Indie, RPG, Strategy;0 - 20,000;13;1;12;0;0;0
563420;Obscura;Indie;0 - 20,000;18;11;7;0;0;0
563430;Void Pyramid;Action, Adventure, Indie;0 - 20,000;124;4;120;0;0;0
563470;Reaping Rewards;Indie;0 - 20,000;36;25;11;11;11;0
563490;Earth Liberation;Casual, Indie, Sports;0 - 20,000;21;15;6;0;0;0
563500;The 8th Day;Adventure, Indie;0 - 20,000;6;18;-12;0;0;0
563520;When Our Journey Ends - A Visual Novel;Simulation;20,000 - 50,000;33;11;22;250;272;0
563550;Nevrosa: Escape;RPG;0 - 20,000;88;20;68;0;0;1
563560;Alien Swarm: Reactive Drop;Violent, Action, Adventure, Simulation;2,000,000 - 5,000,000;17734;925;16809;226;77;739
563610;VR Squash 2017;Adventure, Casual, Indie;0 - 20,000;2;1;1;0;0;0
563680;DragonWingsVR;Action, Adventure, Free to Play, Massively Multiplayer, RPG;0 - 20,000;2;8;-6;0;0;0
563710;Loops of Zen;Casual, Free to Play, Indie, Racing, Simulation, Early Access;0 - 20,000;24;4;20;0;0;0
563740;Lemons Must Die;Adventure, Casual;0 - 20,000;4;7;-3;0;0;0
563810;Fumiko!;Action, Indie;100,000 - 200,000;76;16;60;299;299;0
563830;Historium VR - Relive the history of Bruges;Adventure, Indie;0 - 20,000;23;5;18;0;0;0
563840;LOST EMBER;Adventure, Casual;100,000 - 200,000;3767;480;3287;179;231;7
563860;The Edgelands;Action;0 - 20,000;14;4;10;0;0;0
563910;Guardian Of December;Action, Indie;0 - 20,000;16;8;8;0;0;0
564010;Stern Pinball Arcade;Action;20,000 - 50,000;81;156;-75;2;3;0
564040;ZANGEKI WARP;Adventure, Casual, Indie;0 - 20,000;31;6;25;0;0;0
564050;Bud Spencer & Terence Hill - Slaps And Beans;Action;50,000 - 100,000;1422;117;1305;199;212;5
564070;Troll and I;Action, Indie, Racing;0 - 20,000;13;24;-11;0;0;0
564080;Metagalactic Blitz;Action, Adventure;0 - 20,000;19;4;15;0;0;0
564090;Fierce Tales: The Dog's Heart Collector's Edition;Indie, Racing, Sports;0 - 20,000;8;0;8;0;0;1
564100;Deadly Edge;Adventure, RPG;0 - 20,000;2;3;-1;0;0;0
564140;Juniper Theory;Action, Indie, Simulation, Strategy, Early Access;0 - 20,000;0;1;-1;0;0;0
564150;Rosenkreuzstilette;Action, Indie;20,000 - 50,000;281;70;211;103;192;1
564160;Rosenkreuzstilette Freudenstachel;Violent, Gore, Action, Adventure, Casual, RPG;0 - 20,000;103;15;88;18;18;0
564210;Fishermurs;Adventure, Casual;50,000 - 100,000;63;39;24;258;269;8
564230;Fire Pro Wrestling World;Adventure, Casual;100,000 - 200,000;2459;309;2150;324;335;140
564280;Adventuring Gentleman;Casual, Indie;0 - 20,000;18;4;14;0;0;0
564310;Serious Sam Fusion 2017 (beta);Action, Adventure, Casual, Indie;100,000 - 200,000;3777;290;3487;163;29;66
564330;In Your Face TD;Action, Indie;0 - 20,000;142;7;135;0;0;0
564340;5-in-1 Pack - Monument Builders: Destination USA;Action, Sports, Early Access;0 - 20,000;11;3;8;0;0;0
564420;Santa's Special Delivery;Adventure, Casual, Indie;0 - 20,000;11;2;9;9;9;0
564450;Whispered Secrets: The Story of Tideville Collector's Edition;Sexual Content, Casual;0 - 20,000;5;3;2;0;0;0
564470;Battle for Orion 2;Adventure, Free to Play, Indie, Early Access;0 - 20,000;55;14;41;0;0;0
564480;The Great Wobo Escape;Action, Adventure, Indie, Racing;0 - 20,000;10;0;10;0;0;0
564530;Pharaoh + Cleopatra;Indie, Simulation, Early Access;200,000 - 500,000;1830;188;1642;309;469;183
564700;Scar of the Doll 人形の傷跡;Adventure, Indie, RPG;0 - 20,000;38;5;33;0;0;0
564710;Soda Dungeon;Strategy;500,000 - 1,000,000;5388;323;5065;4868;264;93
564720;Werther Quest;Action, Adventure, Casual, Indie, RPG, Simulation;0 - 20,000;8;4;4;0;0;0
564750;Dimension Jump;RPG;0 - 20,000;34;22;12;53;53;1
564810;Ticket;Education;0 - 20,000;43;1;42;8;8;0
564900;Space Hotel;Adventure, Casual, Strategy;0 - 20,000;22;35;-13;114;114;0
564920;Smoots Tennis Survival Zombie;Casual, Indie, Sports;0 - 20,000;1;2;-1;0;0;0
564940;Alone With You;Casual, Indie;0 - 20,000;63;13;50;333;333;1
564950;Starfighter Origins Remastered;Action, Adventure, Casual;0 - 20,000;18;21;-3;0;0;0
564960;Return to Krondor;Action, Adventure, Indie, Early Access;0 - 20,000;40;27;13;0;0;0
564980;Killer Klownz;Adventure, Indie;0 - 20,000;4;8;-4;0;0;0
564990;Olav: the story of one boy;Adventure, Indie, RPG, Strategy;50,000 - 100,000;6;3;3;282;282;0
565020;Global Adventures;Action, Casual, Indie;20,000 - 50,000;66;110;-44;0;0;0
565030;Blueshift;Action, Adventure;50,000 - 100,000;157;38;119;26;38;0
565100;Subliminal Realms: The Masterpiece Collector's Edition;Adventure, Casual, Indie;0 - 20,000;5;0;5;0;0;0
565110;Mobile Astro;Casual, Indie, Strategy;50,000 - 100,000;120;43;77;56;57;1
565110;Mobile Astro;Indie, Sports;50,000 - 100,000;120;43;77;56;57;1
565120;The Station;Adventure, Casual, Indie;50,000 - 100,000;807;135;672;605;605;1
565140;Chimeras: Tune of Revenge Collector's Edition;Adventure, Strategy;0 - 20,000;14;1;13;0;0;0
565170;Blade Strangers;Indie, RPG, Strategy, Early Access;0 - 20,000;186;60;126;55;55;2
565180;Dogurai;Action, Casual, Indie;0 - 20,000;61;4;57;0;0;1
565190;Spacecats with Lasers VR;RPG, Strategy;0 - 20,000;23;0;23;0;0;0
565200;Gem Monster;Indie, Simulation;0 - 20,000;20;7;13;307;347;0
565200;Gem Monster;Action, Adventure, Indie;0 - 20,000;20;7;13;307;347;0
565330;Twisted;Indie, Simulation, Sports, Early Access;0 - 20,000;1;2;-1;0;0;0
565380;Cargo Cult: Shoot'n'Loot VR;Casual;0 - 20,000;29;11;18;277;278;0
565390;Hyperun;Action, Casual, Indie, Strategy;0 - 20,000;75;7;68;0;0;0
565490;Tier 1;Violent, Gore, Action, Adventure, Indie;0 - 20,000;0;1;-1;0;0;0
565540;The Turkey of Christmas Past;Adventure, Indie, RPG, Early Access;0 - 20,000;10;3;7;0;0;0
565550;Redneck Rampage;Casual, Indie, Strategy;100,000 - 200,000;109;32;77;0;0;2
565600;Christmas Stories: Nutcracker Collector's Edition;Casual, Indie;20,000 - 50,000;40;5;35;0;0;2
565630;Christmas Eve: Midnight's Call Collector's Edition;Action, Adventure, Indie;0 - 20,000;10;0;10;0;0;0
565640;Colorful Life;Action, Casual, Indie, Sports;0 - 20,000;10;11;-1;0;0;0
565650;SWAM;Action, Indie, Early Access;0 - 20,000;6;3;3;0;0;0
565660;Akihabara - Feel the Rhythm;Action, Indie;0 - 20,000;50;25;25;180;246;0
565670;Kunlun Fight;Action, Adventure, RPG, Early Access;0 - 20,000;11;5;6;0;0;0
565690;Ayakashigami;Action, Indie, Simulation, Early Access;0 - 20,000;22;1;21;0;0;12
565720;Pretty Girls Panic!;Casual, Indie;20,000 - 50,000;341;72;269;271;326;5
565730;Sanctuary VR (Also contains non-VR version);Casual, Indie, Racing;0 - 20,000;10;8;2;0;0;0
565860;Tomato Way;Action, Free to Play, Indie;200,000 - 500,000;423;111;312;12077;239;1
565910;Trainscape;Casual;0 - 20,000;7;3;4;0;0;0
565980;Evertree Inn;Casual;0 - 20,000;28;7;21;0;0;0
566050;Zeus + Poseidon;Adventure, Indie;200,000 - 500,000;1273;53;1220;142;187;212
566090;The Bard's Tale IV: Barrows Deep;Action, Casual, Indie, Strategy;50,000 - 100,000;986;482;504;0;0;2
566130;Witly - language tutoring in VR;Racing, Sports;0 - 20,000;6;7;-1;0;0;0
566140;Holo-Graham;Indie, Racing, RPG, Simulation;20,000 - 50,000;1;0;1;0;0;0
566150;Bowling at the Lake;Adventure;0 - 20,000;12;9;3;4;4;0
566160;Zup! 6;Casual, Indie;100,000 - 200,000;2024;117;1907;119;117;1
566170;Elephant Express VR;Casual, Indie;0 - 20,000;0;2;-2;0;0;0
566180;Fractal;Casual, Indie, Sports;0 - 20,000;4;4;0;0;0;0
566190;The Search;Violent, Gore, Action, Indie;100,000 - 200,000;838;298;540;30;40;1
566200;Minions, Monsters, and Madness;Indie, RPG, Strategy, Early Access;0 - 20,000;4;1;3;0;0;0
566250;Project Almighty;Indie, Strategy;0 - 20,000;1;1;0;0;0;0
566270;Child Of Ault;Casual;0 - 20,000;36;8;28;0;0;0
566320;An Octonaut Odyssey;Casual;0 - 20,000;14;2;12;0;0;0
566350;Quizality;Casual, Strategy;0 - 20,000;9;3;6;0;0;0
566380;Speedball Arena;Adventure, Indie, RPG;0 - 20,000;30;9;21;0;0;0
566410;Once upon a time;Adventure, Indie, Simulation, Strategy;0 - 20,000;16;24;-8;0;0;0
566420;Marinatide;Adventure, Casual, Indie, Strategy;0 - 20,000;6;3;3;0;0;0
566440;Necromunda: Underhive Wars;Action, Adventure, Casual, Indie;100,000 - 200,000;1469;1110;359;1187;1706;16
566490;Keen: One Girl Army;Adventure, Casual;0 - 20,000;131;5;126;0;0;0
566530;Mass Exodus Redux;Action, Casual, Indie;0 - 20,000;218;61;157;47;47;1
566540;Labyrinth of Refrain: Coven of Dusk;Violent, Gore, Action, Indie;20,000 - 50,000;741;202;539;1682;3035;180
566550;Rule Your School;Action, Adventure, Casual, Indie, Early Access;0 - 20,000;37;48;-11;0;0;0
566560;Fighters Unleashed;Action, Casual, Indie;20,000 - 50,000;39;41;-2;389;389;0
566570;Hover Skate VR;Action, Casual, Indie;0 - 20,000;15;18;-3;2;2;0
566580;The Jigsaw Puzzle Garden;Action, Indie, Racing, Early Access;0 - 20,000;3;2;1;0;0;0
566640;DinoFense;Adventure, Casual, Indie, RPG, Strategy;0 - 20,000;1;0;1;0;0;0
566670;Save the Ninja Clan;Action;50,000 - 100,000;95;9;86;256;268;0
566690;Meriwether: An American Epic;Action, Adventure, Indie, RPG, Early Access;0 - 20,000;5;4;1;0;0;0
566700;Eye in the Sky;Action, Indie, Racing;0 - 20,000;85;8;77;0;0;0
566730;UMA-War VR;Gore, Action, Adventure, Indie;0 - 20,000;1;2;-1;0;0;0
566750;Crimson Trigger;Action, Casual, Indie;0 - 20,000;19;2;17;0;0;1
566780;Beats Fever;Action, Adventure, Indie;0 - 20,000;53;17;36;0;0;0
566800;AmaranTime Arena;Adventure, Indie, Early Access;0 - 20,000;0;1;-1;0;0;0
566810;Pixel bomb! bomb!!;Adventure;0 - 20,000;0;1;-1;0;0;0
566860;VR Dungeon Knight;Casual, Indie, Sports;50,000 - 100,000;1040;292;748;176;132;11
566870;VR Monster Awakens;Action, Indie;0 - 20,000;24;6;18;0;0;0
566880;Henry The Hamster Handler VR;Nudity, Casual, Indie, Simulation;0 - 20,000;30;2;28;0;0;0
566900;Wacky Wings VR;Adventure, Casual, Indie, RPG;0 - 20,000;21;0;21;0;0;0
566910;Zombie Vikings: Stab-a-thon;Action, Casual, Sports;20,000 - 50,000;43;16;27;4;4;0
566930;Rescue Team 6 Collector's Edition;Casual, Indie, RPG, Simulation;0 - 20,000;16;3;13;0;0;0
566940;Claws & Feathers 2;Action, Casual, Indie;0 - 20,000;15;2;13;0;0;0
566970;EscapeVR: Trapped Above the Clouds;Casual, Indie, Strategy;0 - 20,000;41;12;29;0;0;0
566980;Crashimals;Casual, Indie, Early Access;0 - 20,000;15;0;15;0;0;0
567020;TILE;Casual, Indie;0 - 20,000;8;22;-14;1;1;0
567030;Under Leaves;Action, Indie, Sports;0 - 20,000;554;21;533;296;296;0
567040;AffordaGolf Online;Casual, Indie;50,000 - 100,000;25;44;-19;552;552;0
567060;Putrefaction 2: Void Walker;Casual, RPG, Simulation;100,000 - 200,000;263;77;186;11;11;1
567080;Wizards and Warlords;Action, Adventure;0 - 20,000;186;28;158;0;0;7
567130;Boogeyman 2;Action, Indie;20,000 - 50,000;266;62;204;472;476;3
567140;Mahjong Magic Journey;Action, Indie;50,000 - 100,000;77;17;60;231;258;9
567150;Mosaics Galore;Action, Indie;50,000 - 100,000;77;21;56;272;364;1
567160;Katy and Bob: Safari Cafe;Action, Adventure, Indie;50,000 - 100,000;152;17;135;291;319;2
567200;Incorp Inc;Adventure, Casual;0 - 20,000;17;7;10;0;0;0
567210;Bunnyrama;Action, Adventure, Indie;20,000 - 50,000;50;11;39;250;243;0
567240;Drawn: Trail of Shadows Collector's Edition;Action, RPG, Early Access;0 - 20,000;23;8;15;0;0;0
567260;Super Death Arena;Casual, Indie;0 - 20,000;16;66;-50;0;0;0
567280;Cube Runner;Indie, Simulation;50,000 - 100,000;857;141;716;211;259;1
567290;Slash It;Action, Indie, Sports, Early Access;100,000 - 200,000;1003;143;860;218;240;0
567320;VThree;Action, Adventure, RPG;20,000 - 50,000;44;53;-9;0;0;0
567340;The Deal;Indie, Simulation;20,000 - 50,000;55;7;48;0;0;2
567370;Atomic 79;Action, Adventure, Simulation, Early Access;0 - 20,000;90;4;86;97;97;0
567380;Heartbound;Casual, Indie, Strategy;50,000 - 100,000;1381;46;1335;213;261;0
567430;Dodge Master;Indie;0 - 20,000;1;0;1;0;0;0
567480;HEPH;Adventure, Indie;0 - 20,000;13;6;7;0;0;0
567580;Duke of Alpha Centauri;Action, Indie, Strategy;100,000 - 200,000;350;100;250;199;265;0
567590;Altero;Action, Adventure, Indie, Early Access;0 - 20,000;31;0;31;0;0;0
567620;The Strayed;Violent, Gore, Action, Adventure, Casual, Indie;0 - 20,000;1;1;0;0;0;0
567630;Blood of Steel;Action, Casual, Indie;1,000,000 - 2,000,000;4800;1430;3370;560;627;410
567640;Danganronpa V3: Killing Harmony;Adventure, Casual, Indie;500,000 - 1,000,000;13753;2339;11414;1577;1470;431
567660;Baseball Riot;Adventure, Indie;0 - 20,000;20;8;12;450;450;0
567670;Serious Sam 3 VR: BFE;;50,000 - 100,000;436;73;363;105;59;3
567680;The Pasture;Action, Adventure, Indie;500,000 - 1,000,000;85;105;-20;232;240;0
567690;Songs of Araiah: Re-Mastered Edition;Casual, Indie;0 - 20,000;1;3;-2;268;268;0
567700;Mekside VR;Action, Adventure, Indie, RPG, Simulation, Strategy;0 - 20,000;0;1;-1;0;0;0
567750;Gamer Career Tycoon;Action, Free to Play, Massively Multiplayer, Simulation, Early Access;50,000 - 100,000;219;52;167;0;0;0
567780;Satellite Repairman;Action, Free to Play, Simulation, Sports;20,000 - 50,000;52;27;25;176;244;38
567800;12 Labours of Hercules VI: Race for Olympus (Platinum Edition);Adventure, Indie, RPG;0 - 20,000;192;24;168;1171;1544;3
567840;Brush Up VR;Design & Illustration, Early Access;0 - 20,000;4;3;1;0;0;0
567860;Passage 4;Action, Indie, RPG, Early Access;0 - 20,000;19;1;18;0;0;2
567890;Zero-G;Action, Casual, Indie, Early Access;0 - 20,000;19;5;14;0;0;1
567980;Santa Rockstar;Sexual Content, Nudity, Violent, Adventure, Casual, Indie;50,000 - 100,000;101;26;75;182;182;2
568020;Blind Love;Adventure, Casual, Indie, RPG, Simulation, Strategy;0 - 20,000;69;5;64;0;0;0
568030;Last Mage Standing;Free to Play, Indie, Simulation;0 - 20,000;16;2;14;0;0;0
568040;Macbat 64;Indie, Simulation, Strategy;20,000 - 50,000;299;27;272;272;272;1
568060;Hyper Void;Action, Adventure, Casual;0 - 20,000;9;0;9;0;0;0
568070;Mable & The Wood;Indie, RPG;0 - 20,000;43;35;8;0;0;1
568090;Tattletail;Action, Indie;200,000 - 500,000;2912;209;2703;44;50;10
568130;Gum Guy;Violent, Gore, Action, Casual, Strategy;20,000 - 50,000;16;7;9;448;476;0
568160;Mayan Prophecies: Ship of Spirits Collector's Edition;Indie, RPG, Simulation, Strategy;0 - 20,000;8;0;8;0;0;0
568180;SkyKeepers;Action, Adventure, Indie;0 - 20,000;11;1;10;0;0;0
568200;Duo;Adventure, Indie;20,000 - 50,000;27;4;23;0;0;0
568220;Lobotomy Corporation | Monster Management Simulation;Action, Casual, Indie, Racing, Simulation, Sports;1,000,000 - 2,000,000;22281;1311;20970;2401;743;1394
568240;Kung Fu Ping Pong;Adventure, Indie;0 - 20,000;3;1;2;0;0;0
568250;Wanderer: The Rebirth;Action, Casual, Indie;0 - 20,000;5;3;2;0;0;0
568300;The Sibling Experiment;Adventure, Casual;0 - 20,000;26;13;13;0;0;0
568310;TRESPASS - Episode 2;Adventure, Casual;0 - 20,000;11;1;10;0;0;0
568320;Pictopix;Animation & Modeling;50,000 - 100,000;973;35;938;1391;2059;61
568330;(VR)西汉帝陵 The Han Dynasty Imperial Mausoleums;Action, RPG, Simulation;0 - 20,000;10;5;5;0;0;0
568340;Behind the Memory;Sexual Content, Nudity, Adventure;0 - 20,000;46;35;11;211;211;0
568370;Castle Battles;Adventure;0 - 20,000;32;3;29;0;0;0
568400;Depths of Limbo;Adventure, Casual;0 - 20,000;45;16;29;0;0;0
568440;Not Dying Today;Action, Adventure, Indie;20,000 - 50,000;187;46;141;260;260;0
568460;Ghostory;Adventure, Casual, Indie, Simulation;0 - 20,000;46;4;42;0;0;1
568470;Waking the Glares - Chapters I and II;Action, Indie, Strategy;0 - 20,000;21;15;6;26;26;0
568480;Space Slam;Action, Indie;;;;0;;;
568490;Frog Hop;Casual, Free to Play, Indie;0 - 20,000;23;0;23;0;0;0
568500;Atomic Reconstruction;Adventure, Casual;50,000 - 100,000;29;7;22;0;0;2
568570;Force of Nature;Action, Indie;200,000 - 500,000;3024;950;2074;222;287;27
568580;GunFleet;Action, Casual, Indie, Sports;20,000 - 50,000;123;83;40;19;34;0
568600;Treehouse Basketball;Violent, Gore, Action, Adventure, Indie;0 - 20,000;13;9;4;0;0;0
568610;VERSUS: The Elite Trials;Indie, Simulation, Strategy;0 - 20,000;29;4;25;0;0;0
568640;Sketchbox;Action, Adventure, Indie;0 - 20,000;14;0;14;0;0;0
568670;Heroes of Dark Dungeon;Action, Adventure, Indie;0 - 20,000;12;3;9;320;330;0
568690;Smash Party VR;Adventure, Indie;0 - 20,000;44;4;40;0;0;0
568720;The Agony;Action, Indie;50,000 - 100,000;163;117;46;0;0;1
568750;甜点恋人 / Pastry Lovers;Action, Adventure, Indie, RPG;20,000 - 50,000;209;80;129;0;0;0
568770;Cinderella Phenomenon - Otome/Visual Novel;Action, Adventure, Indie;200,000 - 500,000;3611;119;3492;98;134;21
568780;Multishop Tycoon Deluxe;Action, Adventure, Casual, Indie;100,000 - 200,000;22;9;13;319;324;0
568800;Summer times Afternoon;Violent, Gore, Action, Indie, Strategy;0 - 20,000;15;5;10;0;0;0
568830;Witch of Ice Kingdom Ⅱ;Action, Adventure, RPG;0 - 20,000;78;8;70;0;0;1
568840;GunHero;Action, Free to Play, Indie;0 - 20,000;6;0;6;0;0;0
568860;Psycho on the loose;Indie;20,000 - 50,000;27;15;12;310;334;2
568910;Ambition of the Slimes;Indie, Early Access;20,000 - 50,000;41;5;36;94;94;0
568920;The Final Specimen: Arrival;Adventure, Indie;0 - 20,000;29;3;26;0;0;0
568930;The Land of Pain;Adventure, Indie;100,000 - 200,000;390;128;262;95;114;0
569010;Island Racer;Action, Casual, Indie;0 - 20,000;8;4;4;0;0;0
569050;Paul Pixel - The Awakening;Adventure, Indie;0 - 20,000;6;0;6;0;0;0
569130;Revenge Quest;Action, Indie;0 - 20,000;9;2;7;0;0;0
569140;Paranormal Pursuit: The Gifted One Collector's Edition;Casual, Indie, Sports, Strategy;0 - 20,000;8;0;8;0;0;0
569150;Dark Cases: The Blood Ruby Collector's Edition;Sexual Content, Adventure, Indie, RPG;0 - 20,000;4;0;4;0;0;0
569180;MakeVR Pro;Casual;0 - 20,000;4;8;-4;19;19;0
569200;Space Rogue Classic;Action;0 - 20,000;20;0;20;0;0;0
569210;Yozora Rhapsody;Casual, Indie;20,000 - 50,000;12;6;6;268;276;0
569220;Spycraft: The Great Game;Design & Illustration, Education, Utilities;0 - 20,000;20;1;19;0;0;1
569270;Sable Maze: Sullivan River Collector's Edition;Action, Adventure, Indie, Strategy;0 - 20,000;5;1;4;0;0;0
569290;Metamorfose S;Violent, Action, Adventure, Indie;20,000 - 50,000;103;34;69;356;360;19
569340;Thing-in-Itself;Action, Adventure, Casual;0 - 20,000;79;24;55;0;0;0
569350;RoboCritters;Sexual Content, Violent, Gore, Adventure, Indie;0 - 20,000;8;3;5;0;0;0
569360;Pivot Pilot;Violent, Indie, RPG;0 - 20,000;34;3;31;0;0;0
569370;Bitdude;Action, Simulation;0 - 20,000;13;2;11;2;2;0
569380;Alicia Griffith – Lakeside Murder;Indie, Sports;20,000 - 50,000;66;23;43;249;249;0
569390;Street of Sanctuary VR;Adventure, Casual, Indie;0 - 20,000;0;7;-7;0;0;0
569420;VRQB;Casual, Indie;0 - 20,000;13;1;12;0;0;0
569430;A Demon's Game - Episode 1;Sexual Content, Violent, Gore, Adventure, Indie, Early Access;0 - 20,000;26;16;10;0;0;0
569430;A Demon's Game - Episode 1;Adventure;0 - 20,000;26;16;10;0;0;0
569480;Kingdoms and Castles;Adventure;1,000,000 - 2,000,000;22165;1693;20472;1093;512;372
569500;Monkey Land 3D: Reaper Rush;Adventure, Casual, Indie, RPG, Simulation, Strategy;0 - 20,000;3;7;-4;0;0;0
569520;The Mine;Action, Indie;0 - 20,000;9;1;8;0;0;0
569530;Sky Noon;Adventure;20,000 - 50,000;506;92;414;241;241;0
569570;Light Apprentice - The Comic Book RPG;Nudity, Violent, Gore, Action, Indie;0 - 20,000;48;7;41;159;159;0
569590;The Legends of Owlia;Action, Adventure;0 - 20,000;7;2;5;0;0;0
569610;Distant Space;RPG;200,000 - 500,000;280;80;200;502;484;8
569630;Out of Ammo: Death Drive;RPG;0 - 20,000;63;26;37;0;0;0
569640;ZombieFight VR;Simulation;0 - 20,000;32;28;4;0;0;1
569720;TUNNEL DIVERS;Adventure, Indie, RPG;50,000 - 100,000;114;16;98;13;20;0
569770;StarShip Constructor;Free to Play;50,000 - 100,000;175;86;89;12;12;0
569800;LEAVES - The Journey;Violent, Gore, Action, Adventure, Indie, RPG, Strategy;50,000 - 100,000;422;101;321;161;161;3
569810;LEAVES - The Return;Action, Casual, Indie, Sports;20,000 - 50,000;241;38;203;250;281;3
569860;Thimbleweed Park;Action, Adventure, Indie;200,000 - 500,000;3308;219;3089;609;776;21
569870;Experiment Gone Rogue;Violent, Gore, Action, Indie;0 - 20,000;12;16;-4;0;0;0
569900;Timeless: The Forgotten Town Collector's Edition;Action;0 - 20,000;3;0;3;0;0;0
569940;Bocce Beach;Action, Adventure, Indie, RPG;0 - 20,000;5;2;3;0;0;0
569970;Chosen 2;Action, Casual, Indie;50,000 - 100,000;148;89;59;67;67;0
570000;Old Friend;Action, Adventure, Indie, Early Access;20,000 - 50,000;134;9;125;0;0;0
570050;Raiden V: Director's Cut | 雷電 V Director's Cut | 雷電V:導演剪輯版;Action, Casual, Indie;20,000 - 50,000;247;199;48;42;42;0
570060;TacoFace;Design & Illustration, Education, Photo Editing, Software Training, Utilities;0 - 20,000;4;1;3;0;0;0
570090;articy:draft 3;Casual, Indie, Simulation;0 - 20,000;79;9;70;0;0;20
570110;"Tim-Tim 2: ""The Almighty Gnome""";Nudity, Violent, Adventure;0 - 20,000;4;0;4;0;0;0
570150;Constellation Distantia;Casual, Indie, Racing;0 - 20,000;13;5;8;0;0;0
570230;Deathlike: Awakening;Casual, Simulation;20,000 - 50,000;10;7;3;1;1;0
570340;GoWings Safari;Action;0 - 20,000;0;1;-1;0;0;0
570350;Sorry. (Entschuldigung) ~ A Psychological Horror Visual Novel;Action, Adventure, Indie;0 - 20,000;22;17;5;0;0;0
570380;Death Penalty: Beginning;Casual, Indie;0 - 20,000;31;139;-108;0;0;0
570420;X Rebirth VR Edition;Violent, Gore, Action, Adventure, Indie;50,000 - 100,000;144;110;34;132;132;4
570420;X Rebirth VR Edition;Action, Free to Play, Indie;50,000 - 100,000;144;110;34;132;132;4
570460;Laser League;Action, Indie, Simulation, Sports;200,000 - 500,000;1306;328;978;211;358;3
570470;Escape the Bunker;Adventure, Simulation, Early Access;0 - 20,000;8;6;2;0;0;0
570490;SHENZHEN SOLITAIRE;Action, Adventure, Indie;0 - 20,000;172;4;168;196;196;7
570500;Child Phobia: Nightcoming Fears;Action, RPG;20,000 - 50,000;40;14;26;296;296;2
570540;Animal Planet: Amazon Odyssey;Adventure, Indie, RPG, Strategy;0 - 20,000;7;5;2;0;0;0
570580;Zork Anthology;Casual, Early Access;0 - 20,000;65;3;62;0;0;3
570590;Solitaire VR;Action, Indie;0 - 20,000;14;2;12;0;0;0
570600;Binary Trigger;Adventure, Casual, Indie, RPG, Strategy, Early Access;0 - 20,000;4;0;4;0;0;0
570680;Zork: Grand Inquisitor;Animation & Modeling, Video Production;0 - 20,000;69;2;67;0;0;1
570690;Xmas Zombie Rampage;Action, Adventure;0 - 20,000;7;30;-23;0;0;0
570710;Extinction;Casual, Indie, Simulation, Sports, Early Access;0 - 20,000;95;216;-121;0;0;0
570770;古剑奇谭二(GuJian2);Action, Casual, Indie;200,000 - 500,000;1899;549;1350;627;346;54
570780;古剑奇谭(GuJian);Action, Adventure, Indie;500,000 - 1,000,000;3703;914;2789;1445;1105;108
570790;New Frontier Days ~Founding Pioneers~;Violent, Adventure, Indie, RPG, Simulation;20,000 - 50,000;9;18;-9;0;0;0
570810;Rage Quest: The Worst Game;Animation & Modeling, Design & Illustration, Early Access;0 - 20,000;13;1;12;0;0;0
570820;Dusty Raging Fist;Action, Adventure, Indie;0 - 20,000;14;8;6;0;0;0
570840;家有大貓 Nekojishi;Sexual Content, Casual, Free to Play, Indie;200,000 - 500,000;3706;294;3412;354;577;16
570850;Metal Assault;Action, Adventure, Indie;0 - 20,000;9;4;5;0;0;0
570860;AudioBeats;Action, Casual, Indie, Simulation;0 - 20,000;43;11;32;0;0;0
570890;Fallen;Action, Adventure, Casual, Indie;50,000 - 100,000;44;24;20;251;251;15
570890;Fallen;Strategy;50,000 - 100,000;44;24;20;251;251;15
570900;Art Plunge;Casual, Indie, Simulation;0 - 20,000;106;4;102;0;0;0
570900;Art Plunge;Casual, Indie, Simulation, Sports, Early Access;0 - 20,000;106;4;102;0;0;0
570910;Crazy Max VR;Adventure, Indie;0 - 20,000;4;15;-11;0;0;0
570940;DARK SOULS: REMASTERED;Action, Casual, Indie;1,000,000 - 2,000,000;68024;7518;60506;2618;1816;2397
570950;Devilated;Action, Indie, Sports, Strategy, Early Access;0 - 20,000;49;6;43;0;0;1
570970;ARENA an Age of Barbarians story;Action, Adventure, Casual;0 - 20,000;108;62;46;0;0;0
570980;Tale of Fallen Dragons;Action, Indie;20,000 - 50,000;421;60;361;0;0;0
571020;Santa's Big Adventures;Strategy;20,000 - 50,000;63;30;33;222;247;0
571040;PD Artist 10;Violent, Adventure;0 - 20,000;6;3;3;0;0;0
571050;Santa Sling;Design & Illustration, Early Access;0 - 20,000;6;9;-3;0;0;0
571060;Zork Nemesis: The Forbidden Lands;Action, Simulation, Strategy;0 - 20,000;28;7;21;552;552;0
571080;FormulaNext;Action, Adventure, Indie, Simulation, Strategy;0 - 20,000;1;0;1;0;0;0
571180;Holiday Simulator : Wacky Sleigh Ride;Gore, Action, Adventure, Casual, Indie, Early Access;0 - 20,000;2;0;2;0;0;0
571230;Domino Craft VR;Action, Free to Play, Strategy, Early Access;0 - 20,000;11;1;10;0;0;0
571260;THE KING OF FIGHTERS XIV STEAM EDITION;Indie, Early Access;100,000 - 200,000;3106;640;2466;811;417;69
571310;SteamWorld Dig 2;Casual, Indie, Simulation, Strategy;;;;0;;;
571330;Idioctopus;Adventure, Casual, Strategy;0 - 20,000;8;0;8;0;0;0
571340;Seeking Evil: The Wendigo;Indie, Early Access;50,000 - 100,000;35;28;7;0;0;0
571350;DED;Nudity, Indie, RPG;100,000 - 200,000;516;112;404;17;16;0
571430;Drone Hero;Action, Free to Play, Indie, Strategy;0 - 20,000;51;6;45;0;0;0
571500;Magic Hour;Adventure;0 - 20,000;8;0;8;0;0;0
571520;Kalaban;Adventure;100,000 - 200,000;38;32;6;213;243;1
571530;Superdimension Neptune VS Sega Hard Girls;Adventure;50,000 - 100,000;838;59;779;591;757;6
571550;Hawks Tactical;Adventure;0 - 20,000;3;2;1;0;0;0
571630;Puzzle Island VR;Adventure;0 - 20,000;24;13;11;0;0;0
571660;Psyche Soldier VR;Casual;0 - 20,000;5;2;3;0;0;0
571680;Birthseederia;Action, Adventure, Casual, Indie;0 - 20,000;5;1;4;0;0;0
571690;Facerig Studio for Individual Creators;Action;0 - 20,000;4;6;-2;0;0;0
571740;Golf It!;Adventure, Casual, Indie;1,000,000 - 2,000,000;18848;2179;16669;710;370;1709
571860;Galactic Core: The Lost Fleet (VR);Adventure, Indie;0 - 20,000;10;10;0;0;0;0
571870;Little Jack's Adventures;Casual, Indie, Strategy;20,000 - 50,000;38;25;13;199;229;0
571880;Angels with Scaly Wings / 鱗羽の天使;Racing;20,000 - 50,000;1496;43;1453;123;123;4
571890;Shapelab;Adventure, Casual, Indie;0 - 20,000;140;14;126;755;755;3
572000;President Erect VR;Simulation, Early Access;0 - 20,000;92;26;66;5;7;0
572010;No Way Out;Strategy;100,000 - 200,000;42;63;-21;258;260;1
572020;Darwin's Demons;Adventure, Indie;0 - 20,000;35;3;32;8;8;0
572040;Felis;Adventure, Indie, RPG, Simulation, Strategy;0 - 20,000;20;11;9;0;0;0
572050;Call to Power II;Adventure, Indie;20,000 - 50,000;53;31;22;0;0;11
572130;Flock VR;Indie, RPG;0 - 20,000;10;0;10;0;0;0
572160;Golf for Workgroups;Action, Adventure, Casual, Indie, RPG;0 - 20,000;71;13;58;0;0;0
572170;DeadTruth: The Dark Path Ahead;Action, Adventure, Casual, Indie;0 - 20,000;8;10;-2;0;0;0
572180;Zap Zone;Adventure, Indie, RPG, Simulation;0 - 20,000;19;0;19;0;0;0
572220;MageQuit;Adventure, Casual, Sports;100,000 - 200,000;879;44;835;124;124;13
572240;Snake 3D Adventures;Action, Casual, Indie;20,000 - 50,000;20;7;13;0;0;0
572290;The Existence Abstract;Adventure, Indie, RPG;0 - 20,000;1;2;-1;0;0;0
572300;Nyheim;Action, Adventure, Casual, Indie;50,000 - 100,000;53;26;27;0;0;0
572330;The Fan;Adventure, Casual, Simulation, Strategy;0 - 20,000;75;45;30;0;0;1
572350;Craftmas;Casual, Indie;0 - 20,000;2;1;1;0;0;0
572410;Steel Division: Normandy 44;Action, Adventure, Indie, RPG;200,000 - 500,000;4388;1506;2882;1734;548;119
572430;Party Hard 2;Indie, Simulation, Strategy, Early Access;200,000 - 500,000;1752;410;1342;256;197;16
572480;Orbiz;Action, Adventure, Casual, Strategy, Early Access;0 - 20,000;4;1;3;0;0;0
572510;Superola Champion Edition;Simulation, Early Access;0 - 20,000;17;1;16;0;0;0
572520;Dropzone;Action, Adventure, Indie;200,000 - 500,000;598;262;336;218;143;0
572540;Tin Hearts;Adventure, Indie;0 - 20,000;47;5;42;0;0;0
572570;Weather Lord: Royal Holidays Collector's Edition;Action, Simulation, Sports;0 - 20,000;17;1;16;0;0;0
572580;Incredible Dracula II: The Last Call Collector's Edition;Action;0 - 20,000;31;8;23;46;46;0
572620;Pierhead Arcade 2;Action, Adventure, Casual, Indie, Simulation;0 - 20,000;114;21;93;136;136;0
572630;LyraVR;Casual;0 - 20,000;21;4;17;0;0;0
572640;Fake Happy End;Action, Adventure, Indie, RPG;0 - 20,000;7;1;6;0;0;0
572660;Nick;Adventure, Casual, Simulation, Strategy;50,000 - 100,000;62;16;46;9;9;0
572700;Nancy Drew: Sea of Darkness;Simulation;0 - 20,000;117;9;108;0;0;8
572710;Nancy Drew: Labyrinth of Lies;Adventure, Casual, Simulation, Strategy;0 - 20,000;49;13;36;0;0;4
572720;Nancy Drew: The Shattered Medallion;Adventure, Casual, Simulation, Strategy;0 - 20,000;32;30;2;0;0;5
572730;Nancy Drew: The Silent Spy;Casual, Simulation, Strategy;0 - 20,000;92;7;85;0;0;10
572740;Nancy Drew: The Secret of Shadow Ranch;Adventure, Casual, Simulation, Strategy;20,000 - 50,000;98;13;85;0;0;5
572760;Holiday Bonus GOLD;Adventure, Casual, Simulation, Strategy;20,000 - 50,000;29;11;18;1390;1390;1
572890;Pikuniku;Adventure, Casual, Simulation, Strategy;500,000 - 1,000,000;5977;259;5718;395;437;85
572980;Star Dust: The Book of Earth (VR);Adventure, Casual, Simulation, Strategy;0 - 20,000;0;8;-8;0;0;0
573040;School of Talent: SUZU-ROUTE;Adventure, Casual, Simulation, Strategy;0 - 20,000;97;13;84;228;270;0
573050;Wojdan - وجدان;Action, Adventure, Free to Play, RPG;0 - 20,000;22;2;20;0;0;0
573060;LOGistICAL;Action, Adventure, Indie, RPG;50,000 - 100,000;176;40;136;0;0;4
573070;BAFL - Brakes Are For Losers;Strategy;0 - 20,000;44;13;31;0;0;0
573080;Peregrin;Adventure, Free to Play, Indie, RPG;20,000 - 50,000;236;59;177;104;151;0
573090;Stormworks: Build and Rescue;Adventure, Casual;500,000 - 1,000,000;31458;2690;28768;7035;1255;2970
573100;Battlefleet Gothic: Armada 2;Casual, Indie, Sports;200,000 - 500,000;6170;1757;4413;1189;624;301
573110;AWAY: Journey to the Unexpected;Violent, Action, Indie;20,000 - 50,000;82;79;3;0;0;0
573120;Dead In Vinland;Action, RPG;100,000 - 200,000;1155;322;833;250;395;32
573130;Aporia: Beyond The Valley;Free to Play, Massively Multiplayer, Strategy, Early Access;50,000 - 100,000;550;106;444;11;16;2
573170;Fidel Dungeon Rescue;Violent, Gore, Action, Indie, Massively Multiplayer, RPG, Simulation, Strategy;50,000 - 100,000;357;21;336;0;0;1
573210;Mistwood Heroes;Action, Indie;50,000 - 100,000;29;23;6;253;265;0
573260;THOSE DAMN ALIENS! VR;Action, Adventure, Casual, Indie;0 - 20,000;3;9;-6;0;0;0
573270;Alcatraz: VR Escape Room;Adventure, Casual, Indie;0 - 20,000;27;6;21;0;0;0
573280;Island Getaway;Action, Casual;0 - 20,000;0;1;-1;0;0;0
573300;Monumental Failure;Action;0 - 20,000;23;4;19;0;0;0
573320;Underhero;Casual, Indie, Strategy;20,000 - 50,000;885;124;761;184;190;5
573330;Equilibrium VR;Casual;0 - 20,000;4;4;0;0;0;0
573340;Northern Tale 2;Action;0 - 20,000;15;2;13;0;0;0
573360;Warka Flarka Flim Flam;Action, Casual, Indie;0 - 20,000;20;1;19;0;0;0
573370;Tyler: Model 005;Adventure, Casual;0 - 20,000;44;28;16;0;0;0
573410;AI War 2;Adventure, Casual;100,000 - 200,000;1194;147;1047;59;56;14
573460;Perch;Adventure, Indie;0 - 20,000;5;4;1;0;0;0
573490;Interstellar Transport Company;Action, Indie;50,000 - 100,000;262;113;149;361;361;2
573520;Crowtel Renovations;Adventure, Indie;0 - 20,000;58;4;54;0;0;0
573530;Isolation;Action, Adventure, Casual, Free to Play, Indie, Simulation, Strategy;0 - 20,000;14;21;-7;0;0;0
573550;GoalkeepVr;Action, Adventure, Indie;0 - 20,000;20;4;16;0;0;0
573600;Think of the Children;Action, Adventure, Casual, Indie, Strategy;20,000 - 50,000;122;91;31;49;49;2
573610;DOOORS VR;Adventure, Casual, Indie;0 - 20,000;5;3;2;0;0;0
573660;AereA;RPG;20,000 - 50,000;25;31;-6;0;0;0
573670;Adelantado Trilogy. Book Two;Indie;0 - 20,000;16;0;16;0;0;0
573680;Real Farm;Action, Indie;20,000 - 50,000;118;170;-52;162;162;0
573690;Adelantado Trilogy. Book Three;Adventure, Indie, RPG;0 - 20,000;18;1;17;0;0;0
573700;Island Tribe 4;Violent, Gore, Indie;0 - 20,000;8;0;8;0;0;0
573710;Farm Mania 2;Adventure, Free to Play, Indie;0 - 20,000;51;6;45;1755;1755;3
573720;Viking Saga: Epic Adventure;Indie, Simulation, Strategy, Early Access;0 - 20,000;20;4;16;0;0;0
573730;Northern Tale 3;Casual;0 - 20,000;18;4;14;0;0;1
573740;Northern Tale 4;Action, Adventure, Indie, RPG;0 - 20,000;18;2;16;0;0;0
573750;Island Tribe 5;Casual, Indie;0 - 20,000;6;10;-4;30;30;0
573760;Roads of Rome: New Generation;Indie;0 - 20,000;27;8;19;0;0;0
573770;RED;Nudity, Action, Adventure;20,000 - 50,000;289;13;276;0;0;0
573780;Xenon Valkyrie;Action, Adventure, Indie;0 - 20,000;82;39;43;44;44;0
573780;Xenon Valkyrie;Action, Adventure, Indie;0 - 20,000;82;39;43;44;44;0
573790;Imperium Galactica;Adventure, Indie, Simulation;0 - 20,000;95;7;88;0;0;8
573800;Natari at the Bubble Planet;Action, Adventure, Indie;0 - 20,000;43;15;28;0;0;0
574010;Forestry;Action, Indie, Early Access;0 - 20,000;13;9;4;0;0;0
574030;Score a goal (Physical football);Action, Indie;20,000 - 50,000;152;88;64;299;283;0
574030;Score a goal (Physical football);Adventure, Indie;20,000 - 50,000;152;88;64;299;283;0
574040;Christmas Massacre VR;Adventure, Indie;0 - 20,000;2;2;0;0;0;0
574050;DRAGON QUEST HEROES II;Action, Adventure, Indie, Early Access;50,000 - 100,000;525;222;303;58;58;12
574070;Space Wars: Interstellar Empires;Casual, Indie, Early Access;50,000 - 100,000;148;74;74;1;1;3
574080;Fog of War;Action, Indie;50,000 - 100,000;381;408;-27;42;42;0
574090;MOTHERGUNSHIP;Indie, Strategy;100,000 - 200,000;1128;330;798;572;659;8
574120;Sausage Sports Club;Violent, Gore, Action, Adventure, Indie, Early Access;0 - 20,000;24;7;17;0;0;0
574140;Project LUX;Adventure, Free to Play, Simulation;20,000 - 50,000;317;36;281;20;20;1
574150;Samurai Sword VR;Adventure, Casual, Indie;0 - 20,000;8;4;4;0;0;0
574160;Senko no Ronde 2;Violent, Action, Indie;0 - 20,000;41;11;30;0;0;0
574160;Senko no Ronde 2;Casual, Simulation;0 - 20,000;41;11;30;0;0;0
574170;Love Engine;Design & Illustration, Photo Editing, Video Production;0 - 20,000;6;1;5;0;0;0
574180;Remnants;Adventure, Indie, Simulation;20,000 - 50,000;535;173;362;0;0;8
574190;VR Snowballs;Adventure, Indie, Simulation, Strategy;0 - 20,000;6;5;1;0;0;0
574200;EARTH DEFENSE FORCE 4.1 WINGDIVER THE SHOOTER;Action, Indie;20,000 - 50,000;121;55;66;2;2;0
574220;Ze VR;Indie, Racing, Simulation;0 - 20,000;5;0;5;0;0;0
574260;The Secret Order 5: The Buried Kingdom;Casual, Indie;20,000 - 50,000;150;34;116;211;239;5
574270;Lost Grimoires 2: Shard of Mystery;Indie, Simulation, Early Access;20,000 - 50,000;133;33;100;161;161;0
574310;The Mooseman;Action, Indie;20,000 - 50,000;906;109;797;15;19;1
574410;Demon Grade VR;Adventure, Indie, Strategy;0 - 20,000;1;0;1;0;0;0
574420;Dr. Doyle & The Mystery Of The Cloche Hat;Adventure, Casual;0 - 20,000;11;1;10;0;0;0
574440;Ripple Effect;Casual, Indie;50,000 - 100,000;42;20;22;4;7;0
574500;Gearend;Nudity, Adventure, Casual, Indie;0 - 20,000;11;1;10;0;0;0
574520;EnterVR;Action, Casual, Sports;0 - 20,000;2;4;-2;0;0;0
574560;Dude, Stop;Adventure, Indie, RPG, Strategy;100,000 - 200,000;1475;254;1221;131;144;19
574580;To The Capital;Sports;50,000 - 100,000;41;21;20;255;270;0
574590;Koloro;Action, Adventure, Indie, Simulation;20,000 - 50,000;71;4;67;272;272;1
574640;Unalive;Casual, Indie;100,000 - 200,000;134;60;74;392;428;6
574690;Mr. Triangle's Adventure;Casual, Indie;20,000 - 50,000;20;11;9;794;678;7
574710;Dark Shores;Gore, Action, Indie, RPG;0 - 20,000;4;5;-1;0;0;0
574720;Little Big Workshop;Casual, Indie;200,000 - 500,000;2401;429;1972;694;588;61
574740;Fausts Alptraum;Casual, Indie;100,000 - 200,000;915;67;848;222;238;2
574760;Starship Theory;Adventure;50,000 - 100,000;514;514;0;0;0;5
574780;Naughty Or Nice;Indie, RPG, Strategy;0 - 20,000;7;0;7;0;0;0
574820;Cat or Bread?;Casual, Indie;500,000 - 1,000,000;479;45;434;388;403;6
574860;Pale Moon Crisis;Adventure, RPG, Simulation, Strategy;0 - 20,000;12;14;-2;0;0;0
574890;Forgotten Chambers;Casual, Indie;0 - 20,000;25;5;20;0;0;0
574910;The Bits That Saved The Universe;Adventure, Indie;0 - 20,000;10;2;8;0;0;0
574910;The Bits That Saved The Universe;Action, Adventure, Free to Play, Massively Multiplayer, RPG, Strategy;0 - 20,000;10;2;8;0;0;0
574920;SpaceJourney VR;Action, Indie;0 - 20,000;3;1;2;0;0;0
574980;Them's Fightin' Herds;Adventure, Casual, Indie;100,000 - 200,000;3387;297;3090;297;330;28
575010;Celestial Crossing;Action, Adventure, Casual, Indie;0 - 20,000;91;35;56;1;1;0
575030;Baru and the Spirit Prince;Action, Adventure, Indie, RPG;0 - 20,000;4;1;3;0;0;0
575050;Little Triangle;Action, Adventure, Casual, Indie;20,000 - 50,000;484;44;440;0;0;2
575060;Nemo_D.O;Casual, Indie, Strategy;0 - 20,000;8;2;6;0;0;0
575080;Pleasure in Dream;Action, Casual, Indie, Early Access;0 - 20,000;0;1;-1;0;0;0
575090;Flame of Memory;Action, Indie;100,000 - 200,000;21;11;10;310;316;0
575100;Nukklerma: Robot Warfare;Action, Adventure, Indie, RPG;0 - 20,000;1;2;-1;0;0;0
575110;Magic Lantern;Adventure, Indie;500,000 - 1,000,000;24;3;21;163;176;0
575210;Happy Drummer VR;Indie, RPG, Strategy;0 - 20,000;42;7;35;0;0;0
575270;MAGIX Photostory 2017 Deluxe Steam Edition;Action, Adventure, Casual, Indie;0 - 20,000;10;3;7;0;0;0
575330;Oh...Sir! The Hollywood Roast;Action, Indie;20,000 - 50,000;290;46;244;233;345;13
575340;Chessaria: The Tactical Adventure (Chess);Action, Adventure, Casual, Indie, Strategy;0 - 20,000;87;25;62;0;0;0
575340;Chessaria: The Tactical Adventure (Chess);Casual, Strategy;0 - 20,000;87;25;62;0;0;0
575400;Try Hard Parking;Casual;0 - 20,000;68;12;56;256;256;0
575420;Chocolate;Action, Casual, Indie, Simulation;0 - 20,000;26;2;24;0;0;0
575430;VR Home;Action, Casual, Indie;0 - 20,000;19;14;5;9;9;0
575450;Graceful Explosion Machine;Indie, RPG;0 - 20,000;32;7;25;0;0;0
575480;WAGAMAMA HIGH SPEC;Action, Indie;0 - 20,000;307;30;277;0;0;4
575490;Let's Draw;Casual, Indie;200,000 - 500,000;325;296;29;218;242;0
575510;Sakura Agent;Strategy;50,000 - 100,000;401;151;250;160;248;2
575540;VR Golf Online;Casual, Indie, Simulation;0 - 20,000;11;13;-2;0;0;0
575550;Hell Girls;Casual, Indie;200,000 - 500,000;3462;470;2992;160;170;6
575560;Space Badminton VR;Violent, Adventure, Casual;0 - 20,000;2;5;-3;0;0;0
575570;ICED;Indie, Simulation;20,000 - 50,000;112;50;62;319;332;1
575580;Queen of Seas;Action, Adventure, Casual, Indie;50,000 - 100,000;92;25;67;260;279;0
575590;Balloon Popping Pigs: Deluxe;Action, Adventure, Indie, Early Access;0 - 20,000;44;3;41;0;0;0
575600;2017 VR;Action, Indie;0 - 20,000;90;41;49;0;0;0
575630;Permute;Adventure, Casual, Indie;50,000 - 100,000;27;27;0;253;222;0
575640;Zup! 3;Action, Casual, Indie;200,000 - 500,000;4678;517;4161;116;108;5
575650;Lily's Day Off;Adventure, Indie, Strategy;0 - 20,000;165;22;143;0;0;0
575680;Square n Fair;Action, Casual, Indie;20,000 - 50,000;63;10;53;272;217;10
575690;PARKAN: THE IMPERIAL CHRONICLES;Adventure, Casual, Indie;200,000 - 500,000;35;7;28;0;0;0
575700;Fruit Arranger;Casual, Indie, Simulation, Strategy, Early Access;100,000 - 200,000;168;100;68;202;209;0
575710;Jump, Step, Step;Simulation, Strategy;0 - 20,000;10;2;8;0;0;0
575720;Mighty Party;Action, Indie, RPG, Strategy;200,000 - 500,000;1351;917;434;9543;12420;250
575750;Magic Box;Indie, RPG, Strategy;20,000 - 50,000;48;29;19;244;210;0
575770;Dangerous Bullets;Adventure, Casual, Indie, Simulation;20,000 - 50,000;20;18;2;269;255;20
575780;Inner silence;Casual, Indie, Simulation, Strategy;100,000 - 200,000;90;43;47;213;211;1
575800;Arizona Rose and the Pharaohs' Riddles;Casual, Strategy;0 - 20,000;7;3;4;0;0;0
575810;４人打ちアクション麻雀 / ACTION MAHJONG;Casual, Indie, Strategy;0 - 20,000;18;3;15;0;0;0
575820;I Hate Running Backwards;Action, Adventure, Indie, RPG, Simulation;0 - 20,000;165;44;121;243;243;2
575830;rooMaze;Adventure, Casual;50,000 - 100,000;104;73;31;251;277;0
575840;NeverEnd;Adventure, Casual, Indie, Simulation;50,000 - 100,000;58;58;0;210;235;0
575850;Hartacon Tactics;Action, Adventure, Indie, RPG, Strategy;0 - 20,000;18;23;-5;0;0;1
575860;Tomb Joe;Adventure, Casual, Indie, Early Access;200,000 - 500,000;76;92;-16;240;235;2
575880;1979 Invasion Earth;Action, Indie, Early Access;0 - 20,000;26;8;18;0;0;0
575890;Katy and Bob Way Back Home;Adventure, Indie;50,000 - 100,000;77;21;56;236;260;2
575900;Mosaics Galore 2;Action, Casual, Indie;20,000 - 50,000;68;9;59;300;335;0
575920;Felix Jumpman;Action, Adventure, Casual, Indie, Strategy;20,000 - 50,000;39;44;-5;249;216;189
575940;The Tenth Line;Nudity, Casual, Simulation;20,000 - 50,000;104;18;86;0;0;5
575950;Blood Feed;Action, Adventure, Indie, Simulation;200,000 - 500,000;429;199;230;102;117;0
575960;The Wisbey Mystery;Action, Free to Play;0 - 20,000;57;34;23;0;0;0
575960;The Wisbey Mystery;Indie, Racing;0 - 20,000;57;34;23;0;0;0
575970;Golem Gates;Adventure, Indie, Strategy;0 - 20,000;92;18;74;0;0;1
575990;Knot;Indie;0 - 20,000;16;6;10;0;0;0
576020;Final Theosis;Simulation, Sports;0 - 20,000;7;11;-4;0;0;0
576030;MHRD;Action, Indie;20,000 - 50,000;331;37;294;0;0;3
576050;Other Worlds India;Action, Indie, Sports;50,000 - 100,000;64;41;23;301;314;4
576060;Faraway Islands;Action, Adventure, Indie;20,000 - 50,000;5;5;0;78;78;0
576090;Last Wings;Adventure, Casual, Indie, RPG, Strategy, Early Access;0 - 20,000;0;0;0;0;0;0
576100;Unknown Pharaoh;Animation & Modeling, Early Access;0 - 20,000;28;7;21;0;0;0
576110;Where is my Brain!?;Action, Adventure, Indie, RPG;0 - 20,000;3;9;-6;0;0;0
576120;Purgatory II;Action, Indie;200,000 - 500,000;13;24;-11;240;244;0
576130;State of Anarchy: Master of Mayhem;Casual, Indie;100,000 - 200,000;447;79;368;313;312;3
576160;A Long Road Home;Casual, Free to Play, Indie;100,000 - 200,000;33;2;31;367;415;0
576230;Home Tech VR;Gore, Adventure, Casual, Free to Play, Indie;0 - 20,000;0;1;-1;0;0;0
576260;Winds Of Trade;Action, Adventure, Casual, Indie, RPG, Simulation;0 - 20,000;104;62;42;0;0;1
576280;Arena Hero;Action, Free to Play, Strategy, Early Access;0 - 20,000;46;11;35;0;0;0
576290;Huckleberry Falls;Action, Indie, Early Access;0 - 20,000;4;2;2;0;0;0
576310;Oracle;Adventure, Casual, Indie, RPG, Simulation, Strategy;100,000 - 200,000;121;117;4;228;253;1
576320;Economic Conquest;Action, Casual, Indie;0 - 20,000;22;24;-2;20;20;0
576370;Cubians VR;Action, Indie, RPG, Strategy;0 - 20,000;10;3;7;0;0;0
576380;Abrix 2 - Diamond version;Sexual Content, Nudity, Violent, Gore, Action, Adventure, Casual, Indie, Simulation, Strategy;0 - 20,000;18;12;6;0;0;0
576390;365 Days;Casual, Indie;0 - 20,000;12;22;-10;777;828;0
576400;Elisa: the Innkeeper;Action, Indie, Racing;20,000 - 50,000;100;40;60;1;1;0
576410;Nihilist Simulator;Action, Casual, Indie;20,000 - 50,000;63;12;51;199;199;18
576420;The Curse Of Yendor;Indie, RPG, Strategy;20,000 - 50,000;67;4;63;0;0;0
576470;ANIMALITY;Action, Casual, Indie, Massively Multiplayer, Sports, Early Access;200,000 - 500,000;573;174;399;193;212;1
576480;Drunken Fight Simulator;Indie, Simulation, Strategy, Early Access;20,000 - 50,000;135;53;82;266;286;9
576500;Evergarden;Simulation;20,000 - 50,000;584;95;489;258;330;1
576500;Evergarden;Action, Adventure, Indie;20,000 - 50,000;584;95;489;258;330;1
576540;Brother Wings;Action, Indie, Simulation;20,000 - 50,000;73;31;42;201;212;7
576590;Puzzle Wishes;Casual;0 - 20,000;12;13;-1;0;0;0
576620;The Puzzle Room VR ( Escape The Room );Action, Casual, Indie;0 - 20,000;40;11;29;0;0;0
576650;Fovos VR;Adventure, Casual, Indie;50,000 - 100,000;69;41;28;4;5;3
576660;Snake Party;Action, Casual, Indie, Sports, Early Access;100,000 - 200,000;13;26;-13;222;215;0
576670;Sky Is Arrows;Action, Indie;20,000 - 50,000;12;5;7;274;274;0
576690;Chess: King of Crowns Chess Online;Free to Play, Simulation;20,000 - 50,000;3;6;-3;264;264;0
576700;Hollow Halls;Action, Indie, Early Access;0 - 20,000;0;5;-5;0;0;0
576720;Light and Dance VR - Music, Action, Relaxation;Casual;0 - 20,000;17;5;12;0;0;0
576730;Spirit of Maya;Action, Adventure, Indie, RPG;20,000 - 50,000;32;15;17;681;722;0
576740;FootRock 2;Adventure, Indie, RPG, Strategy, Early Access;0 - 20,000;46;11;35;174;201;0
576750;Ropes And Dragons VR;Adventure;20,000 - 50,000;44;9;35;226;233;0
576770;Low Magic Age;Strategy;200,000 - 500,000;2506;245;2261;1391;2161;81
576790;Mesh Maker VR;Action, Adventure, Indie;0 - 20,000;16;2;14;1;1;0
576800;Final Bravely;Indie, Strategy;20,000 - 50,000;25;4;21;211;256;0
576810;2 Ninjas 1 Cup;Action, Indie, Early Access;20,000 - 50,000;197;56;141;133;158;0
576810;2 Ninjas 1 Cup;Action, Adventure;20,000 - 50,000;197;56;141;133;158;0
576820;Colourise;Action, Casual, Indie, Early Access;0 - 20,000;4;0;4;0;0;0
576840;RAYGUN COMMANDO VR;Indie, Simulation;20,000 - 50,000;83;15;68;10;10;0
576860;Summer Nightmare;Action, Adventure, Indie;100,000 - 200,000;251;225;26;31;31;0
576940;Hunt For Gods;Action, Casual, Indie;50,000 - 100,000;62;33;29;1;1;0
576950;Westard;Casual, Indie, Simulation, Strategy;0 - 20,000;34;21;13;0;0;0
576960;;Adventure, Casual, Indie;20,000 - 50,000;110;26;84;17;17;2
576980;Western 1849 Reloaded;Indie, RPG;20,000 - 50,000;141;29;112;161;161;0
576980;Western 1849 Reloaded;Indie, Early Access;20,000 - 50,000;141;29;112;161;161;0
577000;Witchcraft;Simulation, Sports;0 - 20,000;6;0;6;0;0;0
577060;Everyday Anatomy VR;Simulation;0 - 20,000;3;1;2;0;0;0
577080;A Dump in the Dark;Action;100,000 - 200,000;235;112;123;590;590;1
577120;Archipelago: Navigable VR Comic;Action, Indie;0 - 20,000;1;1;0;0;0;0
577150;ICEBOX: Speedgunner;Action;0 - 20,000;18;0;18;0;0;0
577160;Skyling: Garden Defense;Action, Indie, Early Access;0 - 20,000;9;2;7;0;0;0
577180;Sin Castle;Violent, Action, Adventure, Strategy;0 - 20,000;77;20;57;0;0;0
577180;Sin Castle;Action, Racing, Sports;0 - 20,000;77;20;57;0;0;0
577210;Q.U.I.R.K.;Indie, Simulation, Sports, Strategy;0 - 20,000;26;12;14;3;3;0
577230;Three Kingdoms The Last Warlord;Action, Casual, Indie, Early Access;50,000 - 100,000;2455;967;1488;856;756;135
577270;VR Aquarium -雅-;Casual, Indie, Early Access;0 - 20,000;14;0;14;0;0;0
577290;Drunk or Dead;Action, Adventure, Massively Multiplayer;0 - 20,000;51;9;42;0;0;0
577320;Quantic Pinball;Violent, Gore, Action, Adventure;0 - 20,000;10;7;3;0;0;0
577320;Quantic Pinball;Action, Casual, Indie, Racing;0 - 20,000;10;7;3;0;0;0
577330;Road Fist;Action, Indie, Early Access;0 - 20,000;5;7;-2;0;0;0
577360;Luna and the Moonling;Action, Indie;0 - 20,000;22;6;16;0;0;0
577370;Boost;Action, Adventure;0 - 20,000;2;2;0;0;0;0
577380;Draw The Way;Action, Free to Play, Indie, Massively Multiplayer;50,000 - 100,000;20;1;19;0;0;0
577390;MAKE IT as an Artist;Adventure, Casual;0 - 20,000;86;22;64;12;12;0
577410;The Pit: Infinity;Action;20,000 - 50,000;184;95;89;306;306;0
577440;Kygo 'Carry Me' VR Experience;Indie, Strategy;0 - 20,000;25;4;21;0;0;0
577460;Zoop! - Hunter's Grimm;Adventure, Casual;200,000 - 500,000;170;123;47;195;187;0
577470;Last Days Of Tascaria;Action;0 - 20,000;21;5;16;0;0;0
577480;Higurashi When They Cry Hou - Ch. 5 Meakashi;Adventure, Indie;20,000 - 50,000;477;17;460;153;164;12
577490;Minos Strategos;Casual, Indie, Strategy;20,000 - 50,000;35;3;32;0;0;0
577530;Pixel Ripped 1989;RPG;0 - 20,000;138;28;110;0;0;1
577560;Wizard King;Action, Casual, Indie, Simulation;0 - 20,000;8;1;7;0;0;0
577570;Mage Guard: The Last Grimoire;Action, Indie, Strategy;0 - 20,000;2;5;-3;0;0;0
577580;Gladiator: Sword of Vengeance;Action, Casual, Indie, Sports;0 - 20,000;34;16;18;0;0;1
577640;Space Station Loma: OPERATIONS;Action, Indie, Early Access;0 - 20,000;4;2;2;0;0;0
577670;Demolish & Build 2018;RPG;100,000 - 200,000;1093;335;758;685;722;8
577690;Spooky's Jump Scare Mansion: HD Renovation;Action, Adventure, Indie;100,000 - 200,000;1869;85;1784;200;222;34
577700;THE VIDEOKID;Strategy;20,000 - 50,000;82;5;77;0;0;0
577710;Pirates of Everseas;Action, Indie, Strategy, Early Access;20,000 - 50,000;58;36;22;0;0;21
577730;Idle Evolution;Casual, Indie;0 - 20,000;135;43;92;237;237;2
577740;Winexy;Action, Adventure, Indie, RPG;50,000 - 100,000;102;57;45;294;349;3
577760;Tears of a Dragon;Adventure, Indie, RPG, Early Access;0 - 20,000;19;3;16;221;207;0
577780;Atramentum VR;Adventure, Casual, Indie, RPG, Simulation, Strategy;0 - 20,000;4;4;0;0;0;0
577800;NBA 2K18;Action, Indie;1,000,000 - 2,000,000;5490;13405;-7915;10181;5996;174
577850;Tiny Wheels;Indie, Strategy;0 - 20,000;23;5;18;0;0;0
577890;Arena: Blood on the Sand VR;Action, Adventure, Simulation;50,000 - 100,000;14;16;-2;0;0;228
577910;Ghost Blade HD;Adventure, Casual, Indie, RPG, Strategy;0 - 20,000;44;6;38;0;0;0
577940;Killer Instinct;Adventure, Casual, RPG, Simulation;100,000 - 200,000;3443;309;3134;214;241;42
577970;Punch Planet - Early Access;Adventure, Casual, Indie, Simulation, Strategy;0 - 20,000;157;8;149;0;0;1
577990;Ignition;Action, Indie;20,000 - 50,000;157;24;133;0;0;0
578010;Australian Football Coach;Simulation, Strategy;0 - 20,000;3;6;-3;0;0;0
578050;Siege And Destroy;Action;0 - 20,000;0;0;0;0;0;0
578060;Noda;Indie, Strategy;0 - 20,000;28;2;26;0;0;0
578080;PUBG: BATTLEGROUNDS;Indie, Simulation, Sports;50,000,000 - 100,000,000;1222630;921575;301055;22538;6309;440443
578190;Diesel Power;Action;0 - 20,000;11;1;10;0;0;0
578210;A-Tech Cybernetic VR;Action, Adventure, Indie, Simulation;20,000 - 50,000;443;278;165;19;34;1
578210;A-Tech Cybernetic VR;Action, Indie, Simulation;20,000 - 50,000;443;278;165;19;34;1
578310;BRAIN / OUT;Action, Casual, Indie;1,000,000 - 2,000,000;12544;2760;9784;482;55;61
578320;Dark Parables: Jack and the Sky Kingdom Collector's Edition;Action, Adventure, Casual, Indie, Simulation;0 - 20,000;17;1;16;0;0;1
578330;LEGO City Undercover;Action, RPG;500,000 - 1,000,000;5882;729;5153;1337;1050;236
578350;Element TD;Action, Adventure;0 - 20,000;53;16;37;0;0;1
578360;Dark Dimensions: City of Fog Collector's Edition;Casual, Indie;0 - 20,000;6;3;3;0;0;0
578390;Remnith;Action, Adventure, Indie, RPG;0 - 20,000;19;7;12;0;0;0
578420;Mars Underground;Adventure, Casual;0 - 20,000;35;1;34;0;0;0
578430;Puzzle Puppers;Adventure, Indie, RPG, Simulation, Early Access;0 - 20,000;89;8;81;288;288;0
578440;冒险村传说（Tales of Legends）;Violent, Gore, Adventure, Indie;50,000 - 100,000;35;51;-16;225;260;0
578470;Break Time!;Video Production;0 - 20,000;22;12;10;8;8;0
578540;Perfect Gold - Yuri Visual Novel;Casual, Indie, Simulation;20,000 - 50,000;794;11;783;0;0;1
578590;City Siege: Faction Island;Adventure, Indie;50,000 - 100,000;66;34;32;179;179;7
578610;Super Pixel Smash;Nudity, Violent, Gore, Action, Casual;0 - 20,000;11;1;10;0;0;0
578620;GORN;Adventure;200,000 - 500,000;7325;452;6873;247;160;23
578650;The Outer Worlds;Action, Adventure, Casual, Indie;500,000 - 1,000,000;18825;3276;15549;1122;596;510
578660;Kindled Cavern;Action, Adventure, RPG;0 - 20,000;14;2;12;0;0;0
578670;Conquest: Frontier Wars;Design & Illustration, Photo Editing, Web Publishing;0 - 20,000;8;0;8;0;0;0
578690;Dog Duty;Strategy;0 - 20,000;90;17;73;301;301;1
578720;A Mortician's Tale;Adventure;100,000 - 200,000;829;367;462;154;161;1
578740;SECLUSION;Adventure, RPG, Strategy;0 - 20,000;3;3;0;0;0;0
578800;Phantom;Adventure, Casual;0 - 20,000;57;114;-57;0;0;0
578830;Cavern of Time;Action, Indie, Strategy;50,000 - 100,000;47;28;19;243;268;11
578850;64.0;Action, Casual, Indie, Simulation, Early Access;50,000 - 100,000;1290;128;1162;49;66;1
578870;MegaGlest;Adventure, Indie, Simulation;0 - 20,000;52;4;48;0;0;0
578880;Embrace The Fear;Adventure, Indie;0 - 20,000;5;2;3;0;0;0
578890;Selatria: Advent of the Dakk'rian Empire;Action, Adventure, Indie, RPG;0 - 20,000;11;3;8;0;0;0
578900;Demonheart;Audio Production;20,000 - 50,000;581;40;541;0;0;1
578920;Demon Lord;Action, Adventure;0 - 20,000;12;9;3;0;0;0
578930;LOVE 2: kuso;Casual, Free to Play, Simulation;0 - 20,000;188;6;182;191;191;1
579020;Constructor;Gore, Action, Adventure, Casual, Indie;100,000 - 200,000;504;165;339;252;423;5
579030;GridVR;Adventure, Casual;0 - 20,000;0;1;-1;0;0;0
579040;DEFCON VR;Action, Adventure, Indie, Early Access;0 - 20,000;8;13;-5;10;10;0
579050;VRSailing by BeTomorrow;Adventure, Indie, Simulation;20,000 - 50,000;59;8;51;2;2;0
579080;Snow Games VR;Action, Adventure, Casual, Strategy;0 - 20,000;6;9;-3;1;1;0
579110;Interkosmos;Action, Adventure, Indie;100,000 - 200,000;312;54;258;10;20;1
579120;Unlucky Seven;Adventure, Indie;20,000 - 50,000;63;62;1;0;0;0
579130;LightStrike;Casual, Indie;0 - 20,000;9;7;2;0;0;0
579150;Riot of the numbers;Free to Play, Indie;50,000 - 100,000;40;21;19;218;255;13
579160;A God-Like Backhand!;Action, Casual, Indie, Racing;0 - 20,000;2;3;-1;0;0;0
579180;Ys VIII: Lacrimosa of DANA;Indie, Strategy;100,000 - 200,000;4029;556;3473;2165;3471;76
579210;Syndrome VR;Simulation;0 - 20,000;5;9;-4;0;0;0
579330;The Sorceress;Casual, Indie, Racing, Sports;0 - 20,000;3;13;-10;0;0;0
579490;RUSH: A Disney • PIXAR Adventure;Action, Adventure, Casual, Indie;20,000 - 50,000;177;65;112;0;0;10
579560;Sky Trader;Action, Indie;0 - 20,000;0;0;0;0;0;0
579580;The Source of Evil;Action, Casual, Indie;0 - 20,000;0;1;-1;0;0;0
579640;liquivid Video Fisheye Removal;Casual, Indie, Simulation;0 - 20,000;2;1;1;0;0;0
579720;Neverout;Violent, Action, RPG;50,000 - 100,000;78;56;22;95;96;1
579760;The Journey Down: Chapter Three;Violent, Action, Adventure;20,000 - 50,000;399;35;364;227;268;2
579780;Mental Asylum VR;Action, Adventure, RPG;0 - 20,000;23;13;10;0;0;0
579820;Robinson: The Journey;Action, Indie;50,000 - 100,000;245;205;40;0;0;1
579840;Bloody Trapland 2: Curiosity;Action, Adventure, Indie;20,000 - 50,000;613;127;486;92;93;16
579870;Biosupremacy;Action, Indie, Strategy;0 - 20,000;2;3;-1;0;0;0
579920;Swatcher;Action, Adventure, Indie;20,000 - 50,000;77;11;66;0;0;1
579940;Race for the Galaxy;Action, Adventure, Indie;20,000 - 50,000;319;29;290;0;0;15
579950;Marvel's Guardians of the Galaxy: The Telltale Series;Indie, Simulation, Strategy;200,000 - 500,000;1568;236;1332;145;187;1
579980;Lost Eden;Action, Adventure, Indie;0 - 20,000;67;4;63;0;0;0
580010;Mystery Case Files: The Black Veil Collector's Edition;Indie;20,000 - 50,000;23;6;17;0;0;1
580040;Formata;Adventure, RPG, Simulation, Strategy;50,000 - 100,000;533;256;277;95;99;2
580060;Cut Cut Buffet;Free to Play;0 - 20,000;0;1;-1;0;0;0
580170;My Lovely Daughter;Indie, Racing;100,000 - 200,000;779;311;468;241;241;3
580200;Yonder: The Cloud Catcher Chronicles;Casual, Indie;100,000 - 200,000;2394;508;1886;304;426;29
580300;Super Stone Legacy;Strategy, Early Access;0 - 20,000;19;1;18;0;0;0
580310;WavePad Audio Editor;Nudity, Action, Indie;0 - 20,000;10;2;8;0;0;0
580320;Ashworld;Adventure, Casual, Indie;0 - 20,000;14;10;4;0;0;0
580410;Destination: Pluto The VR Experience;Adventure;0 - 20,000;21;17;4;0;0;0
580420;Tourists Kidnapped a Little Bear;Violent, Action, Indie, Racing;50,000 - 100,000;61;20;41;280;324;0
580480;European Mystery: Scent of Desire Collector’s Edition;Action;0 - 20,000;3;0;3;0;0;0
580510;Mr. Donovan;Adventure, RPG, Strategy;0 - 20,000;8;2;6;0;0;0
580520;Water Planet;Adventure, Indie, Early Access;0 - 20,000;45;15;30;0;0;0
580540;MonkeyKing VR;Adventure, Casual, Indie, Simulation;0 - 20,000;3;2;1;0;0;0
580560;Hero Barrier;Adventure, Indie;20,000 - 50,000;25;23;2;0;0;0
580570;Lethis - Daring Discoverers;Action, Casual, Indie;0 - 20,000;15;13;2;0;0;0
580590;Cublast HD;Action, Casual, Indie, Simulation;0 - 20,000;43;2;41;0;0;0
580630;Dimensional Rift;Indie, Racing, Sports;0 - 20,000;33;1;32;0;0;0
580640;End State;Sexual Content, Nudity, Adventure, Casual, Simulation;0 - 20,000;62;24;38;0;0;1
580680;CYBER JOLT (VR);Casual, Indie, Simulation;0 - 20,000;9;10;-1;0;0;0
580710;Afghanistan '11;Action, Adventure, Indie;0 - 20,000;255;95;160;0;0;6
580720;Carrier Deck;;50,000 - 100,000;758;100;658;194;194;21
580820;Robot Soccer Challenge;Violent, Action, Casual;0 - 20,000;47;18;29;0;0;0
580870;Ballistic;Casual, Indie;0 - 20,000;11;5;6;0;0;0
580880;City of Rott: Streets of Rott;Simulation;0 - 20,000;13;8;5;0;0;0
580890;Arrow Heads;Action, Adventure, Casual, Indie;0 - 20,000;41;18;23;0;0;0
580910;idleBeer;Action, Adventure, Indie;200,000 - 500,000;16;37;-21;294;321;0
580930;Redneck Deer Huntin';Casual, Indie;0 - 20,000;6;10;-4;0;0;0
580940;Redneck Rampage Rides Again;Action, Adventure, Indie;0 - 20,000;24;6;18;0;0;0
580950;Arcane Maelstrom;Violent, Gore, Action, Indie;0 - 20,000;7;10;-3;0;0;0
581030;The Last Hope: Trump vs Mafia - North Korea;Indie, Simulation, Strategy, Early Access;50,000 - 100,000;228;200;28;219;227;1
581060;Jump To Die!!;Casual, Indie;0 - 20,000;66;24;42;0;0;0
581100;Langoth;Casual, Indie;100,000 - 200,000;29;35;-6;227;247;10
581120;Griptape Backbone;Action, Adventure, Indie;0 - 20,000;479;37;442;0;0;1
581130;Metal Waltz: Anime tank girls;Action, Adventure, Indie;200,000 - 500,000;1193;318;875;5505;28;37
581150;Project: Bits;Indie;0 - 20,000;0;0;0;0;0;0
581200;Nash Racing;Nudity, Violent, Adventure, Indie;100,000 - 200,000;68;89;-21;257;262;1
581210;Dungeon Manager ZV 2;Action, Casual, Strategy, Early Access;0 - 20,000;5;5;0;0;0;0
581220;News Tycoon;Sports;20,000 - 50,000;50;87;-37;0;0;0
581230;Soul Saber 2;Action, Casual, Indie;20,000 - 50,000;139;100;39;168;168;0
581270;Old Man's Journey;Casual, Indie, Simulation, Strategy;100,000 - 200,000;2833;414;2419;158;165;4
581300;Black Mirror;Action;50,000 - 100,000;250;260;-10;560;956;2
581310;Riskers;Action, Indie, RPG, Strategy;0 - 20,000;35;39;-4;0;0;0
581320;Insurgency: Sandstorm;Action, Indie, Early Access;2,000,000 - 5,000,000;90614;15641;74973;2424;825;2481
581370;Drizzlepath: Glass;Action, Casual, Sports;0 - 20,000;102;59;43;0;0;0
581380;Clockwise;Action, Adventure, RPG;0 - 20,000;27;15;12;270;294;0
581460;QuiVr Vanguard;Casual, Simulation;0 - 20,000;8;3;5;0;0;0
581520;Sakura Magical Girls;Simulation;0 - 20,000;193;70;123;361;488;1
581590;Retro Pinball;Design & Illustration, Utilities;0 - 20,000;19;10;9;0;0;1
581600;The Albatross;Racing;20,000 - 50,000;55;47;8;235;266;0
581630;Sword With Sauce;Casual, Indie, RPG, Simulation;200,000 - 500,000;4847;886;3961;191;109;11
581650;Once Upon an All Hallow's Eve;Casual, Indie;0 - 20,000;121;29;92;0;0;0
581660;Super Meat Boy Forever;Adventure, Early Access;20,000 - 50,000;423;356;67;0;0;7
581670;The Astral Hero;Casual, Indie, RPG, Strategy, Early Access;100,000 - 200,000;61;45;16;245;238;1
581730;Autumn Night 3D Shooter;Action, Casual, Indie;0 - 20,000;27;19;8;0;0;0
581740;HUNGER;Casual, Sports;0 - 20,000;1;11;-10;0;0;0
581760;True or False 2;Violent, Action, Adventure, Indie;0 - 20,000;126;17;109;32;43;0
581810;1166;Simulation, Sports, Early Access;0 - 20,000;16;14;2;0;0;0
581820;Judas;Action, Adventure, Casual, Indie;100,000 - 200,000;86;37;49;263;304;0
581840;Caliper;Gore, Indie;0 - 20,000;14;0;14;30;30;0
581910;Iron Armada;Action, Adventure, Free to Play;20,000 - 50,000;122;32;90;0;0;0
581920;Dunk It (VR Basketball);Utilities, Video Production;0 - 20,000;3;6;-3;0;0;0
581970;Zombie Ballz;Casual, RPG, Strategy;20,000 - 50,000;72;29;43;204;219;0
581980;Candy Machine;Casual, Indie, Simulation;20,000 - 50,000;14;32;-18;302;272;1
582010;Monster Hunter: World;Adventure, Casual;10,000,000 - 20,000,000;322497;52326;270171;10260;2952;24424
582030;Oblivion Tesseract VR;Adventure, Casual, Indie;0 - 20,000;15;2;13;0;0;0
582050;HVRGUN;Gore, Adventure, Indie;0 - 20,000;9;6;3;0;0;0
582110;Baskhead Training;Casual, Indie;0 - 20,000;0;0;0;0;0;0
582160;Assassin's Creed Origins;Action, Adventure, Massively Multiplayer, RPG, Simulation, Strategy;2,000,000 - 5,000,000;75099;11402;63697;2483;1953;1163
582200;The Physiology of the Eye;Action, Indie, Simulation;0 - 20,000;4;1;3;18;18;0
582210;VRemin (Virtual Reality Theremin);Action, Casual, Simulation;0 - 20,000;23;4;19;0;0;0
582220;Virtual Idea Area;Casual, Free to Play, Indie, Strategy;0 - 20,000;3;2;1;0;0;0
582260;Extreme-G 2;Indie, RPG;0 - 20,000;57;47;10;5;5;1
582270;Everything;Action, Adventure, Casual, Indie, Early Access;100,000 - 200,000;2801;556;2245;254;285;7
582330;Warriors: Rise to Glory;Action, Indie;20,000 - 50,000;721;169;552;346;346;3
582350;Zombie Killin';Indie, Strategy;0 - 20,000;17;0;17;0;0;0
582350;Zombie Killin';Action;0 - 20,000;17;0;17;0;0;0
582360;Spud Cricket VR;Action, Indie;0 - 20,000;2;1;1;0;0;0
582370;Snowflake's Chance;Casual, Indie, Simulation, Early Access;0 - 20,000;20;2;18;0;0;0
582390;Ski Sport: Jumping VR;Utilities;0 - 20,000;2;2;0;0;0;0
582440;Nine;Casual, Indie;0 - 20,000;3;1;2;0;0;0
582460;Epitaph;Simulation;0 - 20,000;3;0;3;0;0;0
582500;We Were Here;Action, Adventure, Casual, Indie, Strategy;1,000,000 - 2,000,000;19783;1827;17956;113;99;322
582510;liquivid Video Merge;Adventure, Casual, Indie;0 - 20,000;7;4;3;0;0;0
582530;Wacky Spores: The Chase;Casual, Racing, Sports;0 - 20,000;13;2;11;0;0;0
582550;Passpartout: The Starving Artist;Indie, Strategy;100,000 - 200,000;5015;714;4301;301;198;34
582560;The Invisible Hours;Education;0 - 20,000;429;29;400;770;770;0
582610;Z-End;Action, Indie;0 - 20,000;15;16;-1;0;0;0
582620;Copoka;Indie;20,000 - 50,000;190;55;135;744;744;1
582660;Black Desert;Action, Adventure, Indie;5,000,000 - 10,000,000;48591;15968;32623;6091;302;19202
582690;Toon Shooters 2: The Freelancers;Casual, Indie;0 - 20,000;13;0;13;0;0;0
582810;Awesome Metal Detecting;Action, Indie, Simulation, Strategy;20,000 - 50,000;237;128;109;364;536;2
582820;Gravity Vector;Education;0 - 20,000;14;2;12;0;0;0
582830;SYNCH;Casual, Simulation, Early Access;0 - 20,000;41;7;34;0;0;0
582830;SYNCH;Action, Adventure, Casual, Simulation;0 - 20,000;41;7;34;0;0;0
582840;20something;Strategy;0 - 20,000;6;7;-1;0;0;0
582890;Estranged: The Departure;Education;200,000 - 500,000;1816;269;1547;85;34;3
582920;From Shadows;Adventure, Indie;50,000 - 100,000;23;17;6;202;202;0
582960;LIT;Free to Play, Massively Multiplayer, Simulation;0 - 20,000;19;4;15;0;0;0
582990;Space Fist;Action, Adventure, Casual, Indie, Early Access;0 - 20,000;45;13;32;0;0;0
583000;Fly Away;Action, Casual, Indie;0 - 20,000;4;0;4;0;0;0
583010;VoiceAttack;Design & Illustration;100,000 - 200,000;848;32;816;1212;1909;88
583030;Eraser & Builder;Photo Editing;0 - 20,000;10;7;3;0;0;0
583040;Princess Maker Refine;Design & Illustration;50,000 - 100,000;216;118;98;0;0;3
583060;The Cavern;Action, Adventure, Indie;0 - 20,000;7;8;-1;0;0;0
583090;SeaBed;Casual;0 - 20,000;369;14;355;0;0;5
583150;KART CHASER : THE BOOST VR;Strategy;0 - 20,000;25;9;16;0;0;0
583190;The Astonishing Game;Casual, Indie;0 - 20,000;22;5;17;153;153;0
583200;Vision Therapy VR;Action, Sports;0 - 20,000;8;1;7;0;0;1
583240;Coffence;Casual, Indie, Simulation;0 - 20,000;20;8;12;0;0;0
583270;Cosmic Express;Sports;50,000 - 100,000;333;18;315;79;140;4
583470;The End Is Nigh;Casual, Free to Play, Indie;100,000 - 200,000;2476;169;2307;177;232;14
583490;InfiniPicross;Utilities;200,000 - 500,000;123;49;74;221;248;0
583500;Galaxis Wars;Casual, Indie;0 - 20,000;10;2;8;0;0;0
583510;Air Rage;Simulation, Strategy, Early Access;0 - 20,000;5;4;1;0;0;0
583530;Aquila Bird Flight Simulator;Adventure, Indie, Simulation;0 - 20,000;26;9;17;0;0;0
583570;1-2-Swift;Action, Adventure, Casual;0 - 20,000;2;2;0;0;0;0
583580;Brutal Warrior;Action, Casual, Indie;0 - 20,000;0;1;-1;0;0;0
583590;Arms Race - TCWE;Indie, RPG, Strategy;0 - 20,000;45;20;25;0;0;0
583620;3D Organon Anatomy;Violent, Action, Strategy;20,000 - 50,000;70;30;40;0;0;3
583740;AVATARIKA;Strategy;20,000 - 50,000;89;111;-22;0;0;1
583750;Skyclimbers;Casual, Free to Play, Indie;0 - 20,000;15;4;11;0;0;0
583760;Slash It 2;Casual, Indie, RPG, Simulation;100,000 - 200,000;1060;130;930;181;246;1
583850;Punch! Home & Landscape Design Essentials v19;Adventure, Casual, Simulation;0 - 20,000;12;8;4;0;0;0
583860;PhotoZoom Classic 6;Action, Casual, Indie;0 - 20,000;6;0;6;0;0;0
583870;Punch! Landscape Design for Mac v19;Action, Adventure, Indie;0 - 20,000;1;1;0;0;0;0
583890;Balthazar's Dream;Sexual Content, Adventure, Simulation;0 - 20,000;100;13;87;0;0;0
583930;Faerie Solitaire Remastered;Adventure, Indie;20,000 - 50,000;433;63;370;386;386;10
583950;Artifact;Violent, Gore, Action, Adventure, Indie;1,000,000 - 2,000,000;11563;13234;-1671;1904;461;32
584040;Journey: Benjamin's Adventures;Indie;0 - 20,000;7;0;7;0;0;0
584080;Proton Ball;Adventure, Simulation, Sports;0 - 20,000;1;0;1;0;0;0
584100;Mad Digger;Action, Adventure, Casual, Indie, RPG, Simulation, Strategy;100,000 - 200,000;130;61;69;268;258;1
584150;Casey Powell Lacrosse 18;Adventure, Indie, RPG;0 - 20,000;19;10;9;0;0;1
584170;Freedom Locomotion VR;Action, Casual, Indie;50,000 - 100,000;183;27;156;23;18;0
584220;RunningDead;Adventure, Indie;0 - 20,000;78;17;61;0;0;0
584280;Airport Master;Adventure;0 - 20,000;15;42;-27;0;0;0
584280;Airport Master;;0 - 20,000;15;42;-27;0;0;0
584370;The Trail: Frontier Challenge;Casual, Free to Play, Strategy;20,000 - 50,000;220;70;150;132;217;4
584400;Sonic Mania;Adventure, Indie, Strategy;500,000 - 1,000,000;20638;1472;19166;546;343;133
584600;Virus Crashers;Action, Casual, Indie, Strategy, Early Access;0 - 20,000;16;8;8;175;175;0
584760;Rayless;Free to Play, Design & Illustration;0 - 20,000;5;5;0;0;0;0
584780;Operation swat;Action, Casual, Indie, Strategy;50,000 - 100,000;32;31;1;282;286;158
584800;Civil War: Battle of Petersburg;Animation & Modeling, Design & Illustration, Education, Software Training, Utilities, Web Publishing, Game Development;50,000 - 100,000;137;34;103;243;266;2
584850;Power Solitaire VR;Action, Adventure, Indie, Racing, Simulation, Early Access;0 - 20,000;31;1;30;1;1;0
584860;Surfasaurus;Action, Adventure, Indie, RPG, Simulation;20,000 - 50,000;14;1;13;361;370;0
584880;Pixel Sand;Action, RPG;0 - 20,000;51;7;44;21;21;0
584890;Stayin' Alive;Action, Casual, Indie;50,000 - 100,000;202;73;129;158;186;0
584930;Conductor;Action, Casual, Indie, Simulation;20,000 - 50,000;271;18;253;75;75;0
584940;Amber's Magic Shop;Action, Adventure, Casual, Indie;0 - 20,000;26;15;11;0;0;0
584980;Late Shift;Casual, Indie;200,000 - 500,000;6945;1078;5867;252;221;32
584990;The Long Reach;Animation & Modeling, Design & Illustration, Education, Utilities, Web Publishing, Game Development;20,000 - 50,000;338;56;282;545;545;1
585020;Big Bia;Animation & Modeling, Design & Illustration, Education, Software Training, Utilities, Web Publishing, Game Development;20,000 - 50,000;989;296;693;150;150;0
585040;Dry Erase: Infinite VR Whiteboard;Animation & Modeling, Design & Illustration, Education, Software Training, Utilities, Web Publishing, Game Development;0 - 20,000;29;18;11;211;211;1
585080;Hunting Simulator;Action, Free to Play, Early Access;20,000 - 50,000;165;136;29;157;290;6
585090;Black River;Action, Adventure, Casual, Indie;20,000 - 50,000;19;18;1;205;211;1
585180;Open Sorcery;Action, Indie, Early Access;0 - 20,000;315;5;310;250;258;1
585190;A Gummy's Life;Action, Adventure, Indie;0 - 20,000;149;35;114;0;0;0
585240;Return to Zork;Action, Adventure, Indie;20,000 - 50,000;40;6;34;0;0;0
585260;Antagonist;Action, Indie, Strategy;20,000 - 50,000;61;5;56;0;0;0
585270;HeapVR;Indie, Strategy;0 - 20,000;11;5;6;5;5;0
585290;Lifeline;Action, Adventure, Indie, RPG, Strategy;0 - 20,000;87;48;39;0;0;0
585310;Beyond the City VR;Adventure, Indie;0 - 20,000;6;3;3;0;0;0
585340;SYMMETRY alpha;Action, Adventure, Indie;20,000 - 50,000;37;3;34;0;0;1
585360;Steampunk Syndicate;Casual, Free to Play, Indie;50,000 - 100,000;44;32;12;295;300;0
585410;GameMaker Studio 2 Desktop;Adventure, Casual, Indie;100,000 - 200,000;1734;321;1413;69946;128204;219
585420;Trailmakers;Adventure, Casual, RPG, Simulation;500,000 - 1,000,000;13551;1166;12385;1466;607;797
585430;Flatspace IIk;Action;0 - 20,000;14;7;7;0;0;0
585450;Shadows: Awakening;Casual, Indie;100,000 - 200,000;1674;539;1135;224;209;6
585500;Dick Wilde;Action, Casual, Early Access;0 - 20,000;37;3;34;0;0;0
585550;FEMINAZI: The Triggering;Casual, Indie;200,000 - 500,000;984;241;743;176;204;0
585560;Finnish Roller;Action, Casual, Indie;100,000 - 200,000;49;70;-21;241;223;8
585590;Emperor Kingdom;Adventure, Free to Play, Indie;20,000 - 50,000;1;0;1;0;0;0
585600;GameMaker Studio 2 Web;Action, Casual, Indie, Simulation;0 - 20,000;18;6;12;99;99;0
585610;GameMaker Studio 2 UWP;Free to Play, Strategy, Early Access;0 - 20,000;5;2;3;0;0;0
585620;GameMaker Studio 2 Mobile;Action, Adventure, Indie, Racing, Strategy;0 - 20,000;82;26;56;0;0;10
585630;Switchblade;Action, Adventure, RPG;50,000 - 100,000;131;72;59;0;0;0
585690;Minimalism;Action, Indie, Sports;1,000,000 - 2,000,000;1188;446;742;298;340;37
585710;Blazing Beaks;Action, Casual, Free to Play, Indie, RPG, Simulation, Strategy;200,000 - 500,000;1710;302;1408;147;124;23
585740;MORTEM;Casual, Free to Play, Massively Multiplayer, Early Access;0 - 20,000;6;6;0;0;0;0
585750;Chowdertwo;Casual, Indie, Racing;20,000 - 50,000;7;2;5;307;301;0
585770;Prism Collider;Action;20,000 - 50,000;10;2;8;219;257;0
585820;Leylines;Strategy;0 - 20,000;4;6;-2;0;0;0
585830;Ninja Stealth 2;Action, Indie;100,000 - 200,000;313;159;154;180;197;5
585840;Leaving Lyndow;Action, Indie;50,000 - 100,000;812;196;616;259;440;4
585860;Bunker 58;Action;100,000 - 200,000;42;94;-52;245;255;0
585880;Once on a windswept night;Utilities;20,000 - 50,000;135;16;119;0;0;0
585890;Sweetest Monster;Adventure, Casual;20,000 - 50,000;456;36;420;20;20;0
585900;Harvest Moon: Light of Hope Special Edition;Indie;20,000 - 50,000;813;243;570;340;340;23
585920;Puzzle One;Action, Casual, Indie, Simulation;0 - 20,000;9;1;8;0;0;0
585950;Wayout 2: Hex;Action, Adventure, Casual, Indie;100,000 - 200,000;302;44;258;105;192;3
585990;Echoes of the Fey Episode 0: The Immolation;Action, Indie, Strategy;20,000 - 50,000;54;11;43;1;1;0
586020;Flairtender;Action, Indie;0 - 20,000;30;4;26;0;0;0
586030;Shardbound;Action, Indie;200,000 - 500,000;920;287;633;39;60;0
586060;JET HERO;Action, Indie;0 - 20,000;33;20;13;0;0;0
586080;Age of Heroes (VR);Action, Casual, Simulation, Early Access;0 - 20,000;12;25;-13;0;0;0
586100;Heroes in the Sky-Origin;Adventure, Casual, Indie;0 - 20,000;0;21;-21;0;0;0
586110;Sansar;Indie, Strategy;100,000 - 200,000;322;280;42;0;0;4
586130;Survival Driver;Action, Adventure, Indie;100,000 - 200,000;34;40;-6;241;264;2
586140;BlazBlue Centralfiction;Action, Adventure, Indie;200,000 - 500,000;8058;533;7525;2167;361;332
586150;Armored Freedom;Indie, Simulation, Sports;0 - 20,000;6;17;-11;56;56;0
586160;Dash Fleet;Adventure, Indie;0 - 20,000;5;9;-4;268;292;0
586170;Mad Dojo;Adventure, Indie;0 - 20,000;26;13;13;239;275;0
586200;Street Fighter 30th Anniversary Collection;Action, Indie;200,000 - 500,000;1470;630;840;633;721;46
586210;OVRdrop;Action, Casual, Indie;100,000 - 200,000;354;172;182;617;895;5
586230;Kult of Ktulu: Olympic;Action, Adventure, Casual, Indie;0 - 20,000;13;0;13;0;0;0
586240;Soul Searching;Design & Illustration, Photo Editing, Utilities;0 - 20,000;234;26;208;0;0;0
586310;Gunman Taco Truck;Action, Indie;20,000 - 50,000;177;43;134;105;105;0
586320;UFO - Unfortunately Fortunate Organisms;Adventure, Indie, RPG;0 - 20,000;35;3;32;118;198;2
586340;Lamm;Casual, Indie;0 - 20,000;50;5;45;0;0;0
586350;UBERMOSH:WRAITH;Adventure, Casual, Indie;50,000 - 100,000;197;28;169;31;31;0
586360;Pyro VR;Casual, Indie;0 - 20,000;34;25;9;0;0;0
586380;VITATIO 2;Adventure, Casual;200,000 - 500,000;335;141;194;203;207;3
586390;Missile Cards;Adventure, Casual;0 - 20,000;51;5;46;0;0;0
586430;Spheroids;Nudity, Adventure, Casual;0 - 20,000;16;4;12;101;101;0
586450;HIKIBYOU2;Adventure, Casual;0 - 20,000;16;2;14;0;0;0
586460;Greyhound Manager 2 Rebooted;Adventure, Casual;0 - 20,000;11;6;5;0;0;0
586560;PhotoTangler Collage Maker;Indie, RPG, Strategy;0 - 20,000;4;2;2;0;0;0
586570;Metanet Hunter CD;Adventure, Casual, Simulation, Strategy;0 - 20,000;6;2;4;0;0;0
586600;The Adventures of Fluffy;Violent, Action, Strategy;50,000 - 100,000;17;26;-9;229;250;4
586620;OR;Action, Adventure, Casual, Simulation;200,000 - 500,000;58;106;-48;228;234;0
586660;Trackless;Action, Adventure, Casual, Indie;0 - 20,000;62;3;59;0;0;0
586670;A Foretold Affair;Casual, Indie, Sports, Early Access;0 - 20,000;19;4;15;0;0;0
586680;Awakening: The Golden Age Collector's Edition;Action, Indie, Strategy;0 - 20,000;5;16;-11;0;0;0
586690;Dead Reckoning: Silvermoon Isle Collector's Edition;Adventure, Casual;0 - 20,000;6;0;6;0;0;0
586700;Otherworld: Omens of Summer Collector's Edition;Action, Adventure;0 - 20,000;7;1;6;0;0;0
586710;Witches' Legacy: Slumbering Darkness Collector's Edition;Action, Adventure, Casual, Indie;0 - 20,000;6;3;3;0;0;0
586720;Surface: Reel Life Collector's Edition;Action, Casual, Indie;0 - 20,000;2;0;2;0;0;0
586740;Spirits of Mystery: Song of the Phoenix Collector's Edition;Action, Indie, Racing, Simulation, Sports;0 - 20,000;4;0;4;0;0;1
586750;Sonny;Action, Casual, Indie;50,000 - 100,000;226;159;67;0;0;3
586770;MEGALOMANIAC;Action, Indie, Strategy;0 - 20,000;16;3;13;0;0;0
586830;Mighty Monster Mayhem;Adventure, Casual, Indie;0 - 20,000;18;7;11;0;0;0
586880;Mini Ghost;;20,000 - 50,000;363;16;347;307;307;0
586890;Play with Balloon;Indie, Strategy;0 - 20,000;0;1;-1;0;0;0
586920;Empyrean Frontier;Action, Adventure, Casual, Indie, Strategy;0 - 20,000;12;5;7;0;0;0
586930;Taken Souls: Blood Ritual Collector's Edition;Action, RPG;0 - 20,000;16;42;-26;213;213;0
586950;The Wizards - Enhanced Edition;Action, RPG;20,000 - 50,000;384;106;278;81;105;3
586960;Upside Down;Action, Adventure, Indie;100,000 - 200,000;509;110;399;227;252;0
586970;Hungry Flame;Action, Adventure, Casual, Indie;200,000 - 500,000;180;82;98;239;274;1
586980;MadOut2 BigCityOnline [CLOSED];Casual, Indie;200,000 - 500,000;3272;1012;2260;193;205;68
586990;Just VR Slingshot Target Practice;Action, Adventure, Casual, Indie, Simulation;0 - 20,000;11;1;10;0;0;0
587000;First Strike: Classic;RPG;20,000 - 50,000;1137;198;939;325;325;3
587000;First Strike: Classic;Simulation;20,000 - 50,000;1137;198;939;325;325;3
587010;EZRA: The Stranger;Indie, RPG;0 - 20,000;3;3;0;0;0;0
587030;Bunker Busters Steamworks Test;Casual, Simulation;0 - 20,000;0;0;0;0;0;0
587070;PROTOThYPE _ a love story;Action, Casual, Indie;0 - 20,000;13;5;8;0;0;0
587100;Ys SEVEN;Action, Indie, Racing, Simulation, Sports;20,000 - 50,000;638;47;591;1495;1495;15
587110;Ys: Memories of Celceta;Action, Adventure, Casual, Indie, Racing;20,000 - 50,000;623;48;575;1356;1526;19
587160;Nose Goes;Indie;0 - 20,000;0;0;0;0;0;0
587180;Wulverblade;RPG, Simulation, Strategy;20,000 - 50,000;161;36;125;0;0;0
587220;Jet Island;Indie, Simulation, Early Access;50,000 - 100,000;1491;63;1428;271;271;3
587260;Tokyo Xanadu eX+;Casual, Free to Play, Strategy;50,000 - 100,000;1236;200;1036;540;1003;19
587290;The Thing With Mistletoes;Casual, Indie, Simulation;0 - 20,000;56;28;28;0;0;0
587310;Soma Spirits: Rebalance;Action, Casual, Indie;0 - 20,000;43;0;43;0;0;0
587330;MARS SIMULATOR - RED PLANET;Action, Adventure, Indie, RPG;0 - 20,000;6;11;-5;0;0;0
587390;LOR - League of Runners;Casual, Free to Play, Indie, Racing, Early Access;0 - 20,000;8;13;-5;393;459;0
587400;Snow Moto Racing Freedom;Adventure, Casual, Indie;0 - 20,000;48;15;33;0;0;1
587420;Cart Racer;Adventure, Free to Play;20,000 - 50,000;647;187;460;123;143;1
587430;I Expect You To Die;Indie, Simulation;200,000 - 500,000;2141;122;2019;232;227;17
587440;Galactic Keep;Action, Adventure, Casual, Indie, Simulation;0 - 20,000;16;4;12;0;0;1
587450;Saurian;Adventure;100,000 - 200,000;995;552;443;431;431;6
587460;Knightfall: Rivals;Adventure, Casual, Indie;50,000 - 100,000;58;41;17;9;13;0
587470;Chroma Lab;Action, Indie, Early Access;20,000 - 50,000;308;10;298;690;690;2
587480;elaine;Casual, Simulation;0 - 20,000;4;0;4;0;0;0
587490;Dark Throne;Indie, Racing;0 - 20,000;17;17;0;0;0;0
587490;Dark Throne;Action, Casual;0 - 20,000;17;17;0;0;0;0
587520;Dungeons of Sundaria;Casual, Indie;50,000 - 100,000;509;152;357;1032;1290;39
587540;Deliverace - Battle Racing;Action, Adventure, Casual, Indie, RPG;20,000 - 50,000;25;20;5;0;0;0
587560;Oodlescape - The Apocalypse;Adventure, Indie;0 - 20,000;7;3;4;0;0;0
587570;Elsewhere High: Chapter 1 - A Visual Novel;Adventure, Casual, Free to Play, Indie;20,000 - 50,000;47;23;24;0;0;0
587580;Nature Treks VR;Action, Adventure, Indie, RPG;50,000 - 100,000;236;42;194;5;5;1
587620;Okami HD;Violent, Gore, Action, Adventure, Indie, Early Access;200,000 - 500,000;6751;511;6240;851;602;87
587690;The Artist;Action, Casual, Indie, Strategy;0 - 20,000;3;2;1;0;0;0
587710;Xenobox VR;Indie, Simulation, Early Access;100,000 - 200,000;3;0;3;181;181;0
587730;Orbital Injection;Adventure, Casual, Indie;0 - 20,000;8;1;7;0;0;0
587770;4x4 Road Race;Casual, RPG, Simulation;0 - 20,000;9;10;-1;0;0;0
587790;Deadly Animal Duel;Action, Indie;200,000 - 500,000;9;37;-28;318;306;0
587810;Bang Bang Fruit;Strategy;20,000 - 50,000;87;81;6;293;319;1
587840;In the Darkness of the Sea;Casual, Indie;0 - 20,000;55;18;37;0;0;0
587840;In the Darkness of the Sea;Action, Indie;0 - 20,000;55;18;37;0;0;0
587860;Tales of Escape;Action, Adventure, Indie;200,000 - 500,000;1168;614;554;80;65;25
587920;Phantom Halls;Casual, Indie, Massively Multiplayer, Simulation, Early Access;0 - 20,000;34;10;24;0;0;0
587930;Under a Desert Sun;Action, Indie;0 - 20,000;30;9;21;0;0;0
587970;Dead Drop;Simulation, Strategy;20,000 - 50,000;60;14;46;76;115;0
588030;Derail Valley;Casual, Free to Play, Indie;200,000 - 500,000;2739;173;2566;1311;1744;134
588040;WILL: A Wonderful World / WILL：美好世界;Simulation;100,000 - 200,000;4811;335;4476;527;807;8
588050;You, With Me - A Kinetic Novel;Action, Indie, Early Access;0 - 20,000;9;18;-9;264;269;0
588070;BrotherZ;Action, Indie, Massively Multiplayer, Simulation, Early Access;0 - 20,000;4;10;-6;0;0;0
588080;Numantia;Adventure, Indie;0 - 20,000;25;6;19;329;329;0
588080;Numantia;Sexual Content, Simulation;0 - 20,000;25;6;19;329;329;0
588110;One Dog Story;Free to Play, Simulation, Sports;50,000 - 100,000;398;97;301;154;154;1
588120;Capsa;Action, Casual, Indie, Simulation;0 - 20,000;136;92;44;10;10;1
588140;ESCAPE FROM VOYNA: Dead Forest;Education;500,000 - 1,000,000;0;1;-1;0;0;0
588160;Pizza Connection 3;Action, Casual, Simulation, Sports;100,000 - 200,000;473;488;-15;472;686;28
588180;Totemori;Action, Casual, Indie;50,000 - 100,000;267;41;226;33;47;0
588190;Tower!3D Pro;Free to Play, RPG, Simulation;50,000 - 100,000;577;286;291;316;316;28
588200;MODSORK;Action, Racing, Sports;0 - 20,000;17;1;16;0;0;0
588210;HELLION;Indie;100,000 - 200,000;2238;1855;383;884;997;7
588230;Beckett;Violent, Action, Adventure, Early Access;0 - 20,000;94;40;54;0;0;1
588240;Frisky Business;Action, Indie;100,000 - 200,000;181;39;142;295;313;0
588290;Goalie Challenge VR;Adventure, Casual, Simulation;20,000 - 50,000;103;9;94;0;0;0
588340;Stolen Steel VR;Action, Adventure, Indie, Massively Multiplayer, Racing, Simulation;0 - 20,000;21;18;3;0;0;0
588350;VR Meditation SkyRun;Action, Indie;0 - 20,000;1;1;0;0;0;0
588410;Virtual Sports;Casual, Indie, Simulation;0 - 20,000;36;12;24;226;226;0
588410;Virtual Sports;Adventure, Indie;0 - 20,000;36;12;24;226;226;0
588430;Fallout Shelter;Violent, Adventure, Casual, Indie;5,000,000 - 10,000,000;50181;6520;43661;609;113;1616
588440;False Front;Indie, Racing, Simulation, Sports;100,000 - 200,000;280;79;201;0;0;632
588490;TrickStyle;Action, Adventure, Indie;0 - 20,000;27;8;19;19;19;0
588540;Super Lovely Planet;Action, Indie;0 - 20,000;20;10;10;0;0;0
588550;High Templar VR;Indie, RPG, Strategy;0 - 20,000;1;3;-2;0;0;0
588560;VRobot: VR Giant Robot Destruction Simulator;Adventure, Casual, Indie, RPG, Simulation, Strategy;0 - 20,000;52;36;16;0;0;0
588560;VRobot: VR Giant Robot Destruction Simulator;Adventure, RPG, Simulation;0 - 20,000;52;36;16;0;0;0
588620;Mary Le Chef - Cooking Passion;Casual, Indie;0 - 20,000;83;10;73;0;0;2
588630;Draw Rider 2;Casual, Indie, Simulation;0 - 20,000;64;21;43;0;0;6
588650;Dead Cells;Action, Adventure, Indie, Early Access;2,000,000 - 5,000,000;121698;3557;118141;1694;760;3411
588690;Peace, Death!;RPG, Strategy;50,000 - 100,000;1827;116;1711;156;232;6
588710;Neighboring Islands;Action, Adventure, Indie;50,000 - 100,000;78;25;53;311;359;1
588720;Easy German Platinum;Indie;0 - 20,000;1;1;0;0;0;0
588730;Majotori;Indie, Simulation, Strategy;50,000 - 100,000;1454;39;1415;74;79;4
588750;King Of Dirt;Action, Casual, Indie;0 - 20,000;15;15;0;0;0;0
588800;HEVN;Action;0 - 20,000;10;11;-1;0;0;0
588880;Crush;Action, Casual;0 - 20,000;18;3;15;0;0;1
588890;Heroes of Arca;Action, Casual, Indie;0 - 20,000;45;21;24;0;0;0
588920;BADASS;Adventure, Indie;0 - 20,000;15;14;1;0;0;0
588930;King 'n Knight;Action, Adventure, Indie;0 - 20,000;47;12;35;0;0;0
588950;Kingsway;Casual, Free to Play, Simulation;100,000 - 200,000;1290;109;1181;79;128;7
588970;Oik;Action, Simulation, Early Access;50,000 - 100,000;1433;164;1269;97;129;1
588980;Speed and Scream;Indie;0 - 20,000;8;9;-1;95;95;0
588990;The Homestead Invasion;Adventure, Casual, Indie;0 - 20,000;15;5;10;0;0;0
589040;Fujii;Action, Simulation, Sports;0 - 20,000;89;5;84;0;0;0
589060;Trapper Knight, Sharpshooter Princess;Action, Indie, Early Access;20,000 - 50,000;25;5;20;0;0;0
589080;Enigma Sphere :Enhanced Edition;Adventure, Indie;0 - 20,000;1;4;-3;0;0;0
589100;The Moonstone Equation;Action, Indie;0 - 20,000;16;3;13;0;0;0
589110;Constricted VR;Adventure, RPG;0 - 20,000;10;9;1;0;0;0
589150;Viking Rage;Action, Indie;0 - 20,000;19;20;-1;0;0;0
589160;Zombie Apocalypse;Indie;0 - 20,000;46;26;20;0;0;1
589170;Panzer Panic VR;Action, Casual, Indie, Simulation;0 - 20,000;9;17;-8;0;0;0
589180;Defuser VR;Action, Indie, Massively Multiplayer;0 - 20,000;0;1;-1;0;0;0
589200;Dreadhalls;Action, Adventure, Casual, Indie;0 - 20,000;296;17;279;412;412;0
589220;UAYEB: The Dry Land - Episode 1;Violent, Action, Casual, Free to Play, Indie;0 - 20,000;52;29;23;470;470;0
589240;Jaguar I-PACE Concept | Virtual Reality Experience;Action, Indie, RPG;20,000 - 50,000;7;11;-4;0;0;0
589250;PowersVR;Gore, Adventure, Casual, Indie;0 - 20,000;37;22;15;0;0;0
589260;Nice Slice;Action, Adventure, Indie;0 - 20,000;13;7;6;0;0;0
589270;xoEl Empire;Violent, Adventure;0 - 20,000;11;0;11;0;0;0
589280;Stunt Kite Masters VR;Violent, Gore, Adventure, Indie;0 - 20,000;58;3;55;31;31;0
589280;Stunt Kite Masters VR;Gore, Adventure, Indie;0 - 20,000;58;3;55;31;31;0
589290;Holdfast: Nations At War;Action, Indie, Strategy;500,000 - 1,000,000;19539;2126;17413;2076;500;753
589300;Legend of the Skyfish;Early Access;0 - 20,000;28;14;14;18;18;0
589320;Catch a Lover;Action, Adventure, Casual, Indie;20,000 - 50,000;223;172;51;102;173;4
589360;Ni no Kuni II: Revenant Kingdom;Adventure, Casual;500,000 - 1,000,000;8241;1524;6717;1541;1079;151
589380;VRog;Adventure, Indie;0 - 20,000;13;6;7;1;1;0
589410;Dammerlicht;Action, Adventure, Indie, RPG;0 - 20,000;9;5;4;0;0;0
589420;Grass Cutter - Mutated Lawns;Action, Indie, Racing, Simulation;50,000 - 100,000;266;32;234;306;308;2
589430;Killer Elite – Time to Die;Violent, Action, Adventure, Indie, Early Access;50,000 - 100,000;4;21;-17;328;363;1
589450;Where Cards Fall;Nudity, Violent, Adventure, Indie;0 - 20,000;29;8;21;0;0;0
589460;Covert Syndrome;Adventure, Casual, Indie;20,000 - 50,000;96;47;49;80;158;0
589470;Myrne: The Quest;Adventure, Casual, Indie;0 - 20,000;24;4;20;14;14;0
589480;The Falconers: Moonlight;Action, Casual, Free to Play, Indie, Simulation, Strategy;0 - 20,000;60;8;52;0;0;1
589500;Shovel Knight: Shovel of Hope;Action, Adventure, Indie;20,000 - 50,000;593;33;560;1053;1053;10
589510;Shovel Knight: Specter of Torment;Action, Adventure, Indie, Simulation;0 - 20,000;383;24;359;740;740;8
589530;Hakuoki: Kyoto Winds;Adventure, Indie;50,000 - 100,000;1283;110;1173;0;0;35
589590;Kindergarten;Casual, Free to Play, Indie, Simulation;200,000 - 500,000;5740;240;5500;187;157;67
589620;It Lurks in the Woods;Action, Casual, Indie;20,000 - 50,000;45;20;25;96;96;0
589640;Spoids;Indie, RPG, Simulation, Strategy;20,000 - 50,000;55;23;32;109;199;0
589670;Double Kick Heroes;Action, Adventure, Casual, Indie;0 - 20,000;179;33;146;397;397;0
589680;Chainless;Nudity, Adventure;0 - 20,000;20;0;20;0;0;0
589690;Queen's Quest 3: The End of Dawn;Adventure;20,000 - 50,000;111;34;77;69;69;1
589730;Tyd wag vir Niemand (Time waits for Nobody);Casual, Indie, Simulation;20,000 - 50,000;28;27;1;329;501;0
589740;Blue Horizon;Action, Indie, Strategy;0 - 20,000;33;36;-3;69;69;1
589760;Revhead;Action, Adventure, Casual;20,000 - 50,000;439;74;365;0;0;8
589770;Green Elephant 2D;Action, Adventure, Indie, RPG, Early Access;50,000 - 100,000;310;27;283;233;257;0
589780;The Red Strings Club;Action, Indie;200,000 - 500,000;8781;525;8256;201;183;10
589850;Leashed Soul;Action, Casual, Indie, Simulation, Early Access;0 - 20,000;26;3;23;150;150;0
589860;SoulSet;Simulation, Strategy, Early Access;0 - 20,000;121;10;111;0;0;0
589870;Learn to Fly 3;Action, Indie, Racing, Sports;500,000 - 1,000,000;6995;445;6550;476;182;207
590250;The Frontier Outskirts VR;Action, Indie;0 - 20,000;6;11;-5;0;0;0
590270;Catsby;Action, Indie;0 - 20,000;16;7;9;0;0;0
590280;Canvas The Gallery;Adventure, Indie, RPG;50,000 - 100,000;273;23;250;22;22;0
590370;Tiny Troopers 2;Action, Casual, Indie, Early Access;20,000 - 50,000;51;8;43;0;0;1
590380;Into the Breach;Action, Adventure, Indie, Strategy;1,000,000 - 2,000,000;15890;894;14996;632;545;368
590430;BeefeaterXO;Free to Play, Indie, Strategy;20,000 - 50,000;14;7;7;0;0;0
590440;Carlos III y la difusión de la antigüedad;RPG;100,000 - 200,000;9;2;7;0;0;0
590510;SoundSelf: A Technodelic;Casual, Indie;0 - 20,000;116;28;88;0;0;0
590530;World Builder;Nudity, Violent, Gore, Action, Adventure, Indie;0 - 20,000;16;4;12;0;0;0
590560;Filthy, Stinking, Orcs!;Action, Adventure, Indie, Simulation, Strategy;0 - 20,000;5;13;-8;0;0;0
590570;Paper Quest;Action, Casual, Indie;0 - 20,000;0;1;-1;0;0;0
590580;Dragon of Legends;Indie;0 - 20,000;5;28;-23;0;0;0
590590;Remnants of Naezith;Action, Adventure, Indie;50,000 - 100,000;508;63;445;118;197;6
590600;LifeBase;Adventure, Casual;0 - 20,000;1;2;-1;0;0;0
590660;Shop Tycoon The Boss;Violent, Gore, Action, Indie;0 - 20,000;4;6;-2;0;0;0
590670;Epic Card Game;Action, Indie, Sports, Early Access;20,000 - 50,000;82;27;55;0;0;1
590690;Sprint Vector;Casual, Indie;20,000 - 50,000;567;103;464;33;41;1
590720;Cobalt WASD;Casual, Free to Play, Simulation;20,000 - 50,000;153;30;123;136;136;0
590770;Vectonic;Indie, Simulation, Strategy;0 - 20,000;9;3;6;0;0;0
590790;Snowballer;Casual, Indie, Simulation, Strategy;0 - 20,000;13;7;6;0;0;0
590800;Rainbow Dreams;Action, Indie;;;;0;;;
590820;Pixel Stories of Dungeon;Casual, Indie;0 - 20,000;8;3;5;0;0;0
590840;Attack of the Giant Mutant Lizard;Simulation, Early Access;0 - 20,000;24;2;22;0;0;1
590850;Night Lights;Adventure, Casual;20,000 - 50,000;49;5;44;0;0;1
590870;Planetoid;Action, Casual, Free to Play, Massively Multiplayer, Strategy;20,000 - 50,000;21;30;-9;296;300;0
590910;炎黄战纪之三国烽烟;Action, Indie;100,000 - 200,000;185;95;90;16;16;0
590950;Toaster Jam;Adventure, Casual;20,000 - 50,000;126;2;124;0;0;2
590970;Hollow;Action, Indie;0 - 20,000;111;177;-66;15;15;0
590970;Hollow;Action, Adventure, Indie, RPG;0 - 20,000;111;177;-66;15;15;0
591000;Deep Sixed;Action, Indie;0 - 20,000;83;14;69;0;0;0
591020;山贼;Violent, Gore, Casual, Indie;0 - 20,000;0;0;0;0;0;0
591090;Bestseller: Curse of the Golden Owl;Indie, Simulation;0 - 20,000;2;0;2;0;0;0
591130;Bunny Madness Anarchy;Action, Free to Play;0 - 20,000;4;3;1;0;0;0
591140;Disc League;Adventure, Indie;0 - 20,000;1;1;0;0;0;0
591350;Escape the Mazes;Action, Casual, Indie, Sports;20,000 - 50,000;50;20;30;0;0;0
591360;Dreams of Dali;Action, Indie, Strategy, Early Access;50,000 - 100,000;117;21;96;115;116;0
591370;Production Line : Car factory simulation;Simulation, Sports, Strategy;200,000 - 500,000;2601;523;2078;668;793;24
591380;Bomb Squad Academy;Casual, Simulation;20,000 - 50,000;374;60;314;74;74;0
591390;a nifty game;Indie, Strategy, Early Access;0 - 20,000;2;0;2;0;0;0
591420;Zup! 4;Adventure, Indie, RPG;200,000 - 500,000;2470;264;2206;144;165;2
591460;Parkasaurus;Indie, Strategy;200,000 - 500,000;2451;141;2310;389;306;20
591470;Dark Realm: Queen of Flames Collector's Edition;Adventure, Free to Play, RPG, Strategy;0 - 20,000;6;1;5;0;0;0
591560;Red Death;Violent, Gore, Adventure, Indie;100,000 - 200,000;90;18;72;249;247;0
591580;Mystery Tales: The Lost Hope Collector's Edition;Action, Adventure, Indie, Racing, Sports;0 - 20,000;5;3;2;0;0;0
591610;Deep End;Action, Indie, Simulation;0 - 20,000;1;1;0;0;0;0
591630;Candleman: The Complete Journey;Action, Casual, Indie, Strategy;20,000 - 50,000;995;79;916;199;199;4
591640;Light It | てらし鬼;Adventure, Casual, Indie, RPG, Simulation, Strategy;0 - 20,000;5;0;5;0;0;0
591660;Final Rest;Indie, Strategy;0 - 20,000;6;7;-1;0;0;0
591680;Taphouse VR;Indie;20,000 - 50,000;199;14;185;52;84;0
591740;Sniper Fury;Action, Adventure, Indie;500,000 - 1,000,000;1212;1308;-96;122;38;140
591750;Solo;Adventure, Indie, RPG;0 - 20,000;78;12;66;0;0;0
591760;HyperBrawl Tournament;Action;100,000 - 200,000;136;17;119;0;0;0
591790;BREACH IT;Design & Illustration, Early Access;20,000 - 50,000;96;96;0;61;61;0
591910;World Basketball Manager 2;Action, Indie;0 - 20,000;18;16;2;0;0;0
591920;Power Tools VR;Indie, Racing;0 - 20,000;4;3;1;0;0;0
591930;Genesia Legacy: Ultimate Domain;Action, Adventure, Indie, Strategy;0 - 20,000;50;19;31;0;0;1
591940;The Normal Day;Action, Casual, Sports;0 - 20,000;2;0;2;0;0;0
591960;Animation Throwdown: The Quest for Cards;Casual, Indie;200,000 - 500,000;2541;832;1709;522;132;66
591990;Cosmic Awakening VR;Animation & Modeling;50,000 - 100,000;17;9;8;0;0;0
592020;SmuggleCraft;Adventure;0 - 20,000;23;2;21;0;0;0
592040;Energia;Action, Adventure, Indie;0 - 20,000;6;1;5;0;0;0
592060;Sons of Triskelion;Action, Indie;0 - 20,000;17;15;2;158;205;0
592100;Flotilla 2;Casual, Indie, Sports, Early Access;200,000 - 500,000;21;7;14;0;0;0
592120;Glyphs Apprentice;Adventure, Casual, Indie, Simulation;0 - 20,000;10;4;6;0;0;0
592130;NakedMan VS The Clothes;Education;0 - 20,000;16;9;7;0;0;0
592200;Super Army of Tentacles 3: The Search for Army of Tentacles 2;Indie, Simulation, Strategy;50,000 - 100,000;14;6;8;397;408;0
592240;Jupiteration;Indie;0 - 20,000;19;6;13;0;0;0
592260;Dungeon Painter Studio;Adventure, Indie;100,000 - 200,000;2151;322;1829;685;701;85
592270;Neko Navy;Sports;20,000 - 50,000;128;3;125;0;0;0
592300;Slowdrive;Sports;0 - 20,000;75;3;72;0;0;0
592320;The Ruins: VR Escape the Room;Action, Adventure;0 - 20,000;21;14;7;0;0;0
592330;Roomscale Coaster;Simulation, Sports, Early Access;0 - 20,000;12;9;3;269;269;0
592340;Mall Empire;Casual, Indie;50,000 - 100,000;51;40;11;0;0;0
592350;Nvil;Action, Casual, Indie;0 - 20,000;34;7;27;0;0;1
592360;Violet's Dream VR;Action, Casual, Indie, Simulation, Strategy;0 - 20,000;0;1;-1;0;0;0
592380;Apocalypse Cow;Adventure, Indie, RPG;0 - 20,000;0;0;0;0;0;0
592390;Radline: Quarantine;Sexual Content, Violent, Gore, Adventure, Indie;0 - 20,000;70;54;16;300;300;1
592400;Courtyard Broomball;Casual, Indie, Racing, Sports, Early Access;0 - 20,000;16;2;14;0;0;0
592410;Spacetours VR - Ep1 The Solar System;Free to Play, Indie, Strategy;0 - 20,000;21;10;11;0;0;0
592450;FERIT Simulator;Utilities, Video Production;0 - 20,000;5;2;3;0;0;0
592550;Seasteader;Adventure, RPG;0 - 20,000;16;17;-1;0;0;0
592560;Hoop Route;Strategy;0 - 20,000;4;1;3;0;0;0
592570;Wild Unknown;Action, Casual, Indie;0 - 20,000;4;4;0;0;0;0
592580;PRO EVOLUTION SOCCER 2018;Design & Illustration;100,000 - 200,000;2539;1543;996;5728;4579;79
592600;PRO EVOLUTION SOCCER 2018 LITE;Adventure, Indie;500,000 - 1,000,000;782;771;11;1731;293;2
592620;Trajectory;Adventure, Indie, RPG, Simulation;0 - 20,000;10;7;3;0;0;0
592640;Stream Games Deluxe;Adventure, Indie;0 - 20,000;1;0;1;0;0;0
592660;Zen Garden;Action, Casual, Indie, Simulation;20,000 - 50,000;87;32;55;326;326;0
592720;Paulo's Wing;Action, Casual, Indie, Sports;0 - 20,000;5;4;1;0;0;0
592730;Aerial Destruction;Action, Casual, Indie;100,000 - 200,000;79;43;36;338;488;0
592740;Drift 7 Islands (survival);Action, Adventure, Casual, Indie;0 - 20,000;5;3;2;0;0;0
592750;SPACE-FRIGHT;Action, Adventure, Indie, RPG;0 - 20,000;25;3;22;0;0;0
592780;Bang Bang Car;Action, Adventure, Indie;0 - 20,000;21;14;7;0;0;0
592780;Bang Bang Car;Adventure, Indie;0 - 20,000;21;14;7;0;0;0
592890;Insidia;Action, Casual, Indie;50,000 - 100,000;145;77;68;3;4;0
592920;Inception VR;Casual, Free to Play, Simulation;0 - 20,000;14;12;2;0;0;0
592990;ChemCaper: Act I - Petticles in Peril;Casual, Indie, Strategy;0 - 20,000;3;4;-1;0;0;0
593030;Strategic Command WWII: War in Europe;Casual, Indie, RPG, Simulation, Strategy;0 - 20,000;280;30;250;0;0;104
593060;Squishies;Action;0 - 20,000;9;2;7;0;0;0
593090;GIPHY Museum of GIF Art;Casual, Indie, Strategy;0 - 20,000;24;1;23;0;0;0
593100;There Is a Way;Action, Adventure, Indie, RPG;0 - 20,000;12;4;8;0;0;0
593150;Ooblets;Action, Adventure, Casual, Massively Multiplayer, RPG, Strategy, Early Access;0 - 20,000;0;0;0;0;0;0
593200;The Adventures of Fei Duanmu 端木斐异闻录;Violent, Gore, Action, Free to Play, Indie, Massively Multiplayer;20,000 - 50,000;1563;154;1409;683;683;4
593210;Counter Fight: Samurai Edition;Action, Casual, Indie;0 - 20,000;72;7;65;79;79;0
593240;VR SUPER SPORTS;Action, Indie;0 - 20,000;63;45;18;0;0;0
593250;Voxel Shot VR;Action, Adventure, Indie;0 - 20,000;24;3;21;0;0;0
593260;Planet Defender;Nudity, Violent, Gore, Indie, Early Access;0 - 20,000;5;3;2;0;0;0
593280;Cat Quest;Violent, Gore, Action, Adventure, Indie, RPG;500,000 - 1,000,000;6553;330;6223;464;370;26
593330;Algotica Iterations;Action, Adventure, Indie, RPG;50,000 - 100,000;92;80;12;0;0;0
593400;Float Gallery;Adventure, Casual;0 - 20,000;11;5;6;1;1;0
593410;Elven Legend;Action, Adventure, RPG, Simulation;0 - 20,000;27;11;16;0;0;0
593490;Empire Architect;Action, Casual, Simulation, Strategy;20,000 - 50,000;114;57;57;0;0;0
593530;Jelly in the sky;Action, Indie, RPG, Simulation, Strategy;20,000 - 50,000;69;61;8;0;0;1
593540;Elven Legend 2: The Bewitched Tree;Casual, Indie, Simulation, Strategy;0 - 20,000;13;5;8;0;0;0
593560;The Last Cargo;Action, Adventure, Indie;20,000 - 50,000;17;13;4;0;0;0
593600;PixARK;Indie, Early Access;200,000 - 500,000;7641;2930;4711;1698;672;179
593620;The Last Conflict;Adventure, Indie, RPG, Early Access;50,000 - 100,000;167;60;107;7;9;0
593640;Papetura;Action, Casual, Indie;20,000 - 50,000;778;62;716;102;102;0
593670;Sponchies;Action;100,000 - 200,000;41;5;36;217;276;1
593680;Rocking Pilot;Action, Indie;0 - 20,000;45;2;43;0;0;0
593700;Tower Fortress;Action, Adventure, Free to Play, Indie;0 - 20,000;88;6;82;0;0;2
593720;Dangerous Games: Prisoners of Destiny Collector's Edition;Adventure, Free to Play, Indie, RPG;0 - 20,000;2;0;2;0;0;0
593730;Ouroboros: Prelude;Adventure, Casual, Indie;0 - 20,000;3;4;-1;0;0;0
593740;Dragon Climax;Action, Adventure, Indie, Simulation, Early Access;50,000 - 100,000;37;7;30;0;0;0
593850;Davyria: Heroes of Eternity;Adventure, Casual, Indie, Simulation;0 - 20,000;52;22;30;0;0;0
593900;Tender Loving Care;Casual, Indie, Simulation, Early Access;0 - 20,000;98;31;67;0;0;0
593950;世阳教你学防灾Shiyang teaches you to learn disaster prevention;Action, Casual, Indie, Sports;0 - 20,000;6;6;0;0;0;0
593960;Lorelai;Action, Adventure, Indie, Racing, Early Access;20,000 - 50,000;1022;122;900;134;134;2
593970;Clash of Vessels VR;Action, Adventure, Casual;0 - 20,000;3;0;3;0;0;0
593980;Gluon;Action, Adventure, RPG, Simulation, Sports, Strategy;0 - 20,000;2;4;-2;0;0;0
594000;Shadows and Lies;Violent, Action, Simulation, Strategy;0 - 20,000;8;8;0;0;0;0
594030;Afterglitch;Action, Strategy;0 - 20,000;9;2;7;0;0;0
594040;SERIES MAKERS TYCOON;Indie;50,000 - 100,000;346;138;208;57;90;1
594050;Red Alliance;Action, Early Access;0 - 20,000;180;54;126;481;481;0
594120;Fort Awesome;Adventure, Indie, RPG;0 - 20,000;1;3;-2;0;0;0
594130;Winds of Change;Action, Adventure, Casual, Indie;20,000 - 50,000;475;14;461;0;0;2
594150;airRevo VR;Casual, Indie, Simulation, Strategy;0 - 20,000;3;4;-1;0;0;0
594200;Don't Get Hit In The Face;Indie;0 - 20,000;13;0;13;0;0;0
594220;The Living Remain;Action, Indie, Early Access;0 - 20,000;124;35;89;0;0;0
594310;Reflection of a Fallen Feather;Action, Indie;0 - 20,000;21;7;14;0;0;1
594320;Return of Red Riding Hood Enhanced Edition;Action, Indie;0 - 20,000;46;5;41;0;0;114
594330;Visage;Adventure, Casual, Indie;200,000 - 500,000;6399;995;5404;363;342;41
594350;Attack Helicopter Dating Simulator;Action, Adventure, Casual, Indie, Racing, Simulation;0 - 20,000;129;13;116;0;0;1
594360;Sort 'Em;Action, Adventure, Casual;0 - 20,000;9;3;6;0;0;0
594370;Crazy Fishing;Action, Indie;0 - 20,000;57;49;8;0;0;2
594370;Crazy Fishing;Action, Adventure, Indie;0 - 20,000;57;49;8;0;0;2
594380;Dragon Audit;Violent, Adventure, RPG;0 - 20,000;43;1;42;0;0;0
594410;Western Bank VR;Casual;0 - 20,000;6;1;5;0;0;0
594490;Deadly Hunter VR;Action, Adventure;0 - 20,000;214;51;163;23;32;2
594490;Deadly Hunter VR;Action, Adventure, Indie, RPG;0 - 20,000;214;51;163;23;32;2
594550;Arma: Cold War Assault Mac/Linux;Violent, Gore, Action;50,000 - 100,000;106;21;85;0;0;0
594570;Total War: WARHAMMER II;Action, Adventure, Indie, Massively Multiplayer, RPG, Early Access;5,000,000 - 10,000,000;110567;8385;102182;12576;3141;5382
594650;Hunt: Showdown;Gore, Action, Indie;5,000,000 - 10,000,000;128266;26351;101915;6780;794;18101
594660;Runt of the Litter;Casual, Simulation;0 - 20,000;41;9;32;0;0;0
594680;Shuyan Saga;Action, Indie;20,000 - 50,000;418;79;339;160;160;0
594720;Star Merchant;Casual;100,000 - 200,000;66;42;24;240;248;158
594750;Tiles;Adventure, Casual;0 - 20,000;43;8;35;0;0;0
594760;Zombie in my city;Action, Indie;0 - 20,000;0;1;-1;0;0;0
594770;Legends of Aria;Indie, Early Access;20,000 - 50,000;909;707;202;347;576;4
594810;Color Jumper;Indie, RPG, Strategy;0 - 20,000;19;2;17;0;0;0
594820;An Oath to the Stars;Adventure, Indie;0 - 20,000;12;7;5;0;0;0
594950;The Witches' Tea Party;Action, Indie, Simulation;0 - 20,000;95;3;92;0;0;0
594980;Super Amazeballs;Action, Indie, Simulation, Early Access;0 - 20,000;32;6;26;0;0;0
595010;Violet Cycle;Indie, Simulation, Sports, Strategy;0 - 20,000;15;8;7;0;0;0
595030;Please;Action, Indie, Strategy, Early Access;0 - 20,000;5;13;-8;0;0;0
595060;Lionheart: Legacy of the Crusader;Casual, Indie;200,000 - 500,000;84;16;68;156;156;1
595070;Keep Balance VR;Casual, Indie, Simulation;0 - 20,000;6;4;2;0;0;0
595080;Silver Grapple;Action, Sports, Early Access;0 - 20,000;25;2;23;0;0;0
595090;Prevent The Fall;Action, Adventure, Casual, Indie;0 - 20,000;57;34;23;0;0;0
595100;CTHON;Utilities;20,000 - 50,000;59;23;36;3;3;0
595110;Gran Skrea Online;RPG;20,000 - 50,000;188;71;117;0;0;0
595120;Cold Space;Action, Adventure, Casual, Indie;20,000 - 50,000;100;34;66;147;147;0
595130;My Vet Practice;Adventure, RPG;0 - 20,000;26;6;20;0;0;0
595140;Immortal Redneck;Action;100,000 - 200,000;2671;256;2415;542;740;7
595150;My Vet Practice – Marine Patrol;Adventure, Casual, Indie, Simulation, Strategy;0 - 20,000;5;4;1;0;0;0
595160;My Boyfriend – He loves me, he loves me not;Indie, Strategy;0 - 20,000;10;15;-5;0;0;0
595260;Heat Guardian: Re-Frozen Edition;Indie, Massively Multiplayer, Simulation;0 - 20,000;70;30;40;0;0;0
595270;Million to One Hero;Sexual Content, Nudity, Adventure, Casual, Indie;50,000 - 100,000;30;0;30;0;0;0
595280;Throne of Lies: Medieval Politics;Action;200,000 - 500,000;2094;634;1460;371;453;1
595300;VR2: Vacate 2 Rooms (Virtual Reality Escape);Action, Indie, RPG, Strategy;0 - 20,000;19;7;12;0;0;0
595320;Polterheist;Action, Adventure, Indie, RPG;200,000 - 500,000;83;155;-72;74;93;1
595360;NIGHTSTAR: Rogue Wings;Nudity, Violent, Action, Adventure, Indie;0 - 20,000;20;12;8;0;0;0
595420;Franchise Hockey Manager 4;Casual, Indie, Simulation, Early Access;20,000 - 50,000;93;52;41;0;0;2
595430;Sky Knights;Action, Adventure, Sports;50,000 - 100,000;374;21;353;180;180;1
595440;CPU Invaders;Casual, Indie;100,000 - 200,000;573;111;462;201;215;1
595460;Flix and Chill;Sports, Early Access;100,000 - 200,000;189;36;153;399;402;0
595470;Shadow Circuit;Adventure, Indie;0 - 20,000;0;2;-2;0;0;0
595490;LookVR;Design & Illustration, Photo Editing;0 - 20,000;9;1;8;1;1;0
595520;FINAL FANTASY XII THE ZODIAC AGE;Action, Indie, Simulation;500,000 - 1,000,000;5760;643;5117;2205;1451;335
595550;Mastema: Out of Hell;Action, Adventure, Indie, RPG, Simulation, Strategy;50,000 - 100,000;73;45;28;158;217;1
595560;Legend of Hand;Violent, Gore, Action, Adventure, Indie;0 - 20,000;76;4;72;0;0;0
595630;Neon8;Action, Indie;0 - 20,000;1;2;-1;0;0;0
595640;Robo Do It;Adventure, Casual;20,000 - 50,000;22;11;11;276;283;0
595650;Fatal Passion: Art Prison Collector's Edition;Indie, Simulation, Strategy, Early Access;0 - 20,000;3;0;3;0;0;1
595660;Lux Alliance;Casual, Indie;20,000 - 50,000;48;13;35;0;0;0
595690;One Hour One Life;Action, Indie;20,000 - 50,000;2739;688;2051;229;267;99
595730;Ascendant Hearts;Action, Casual, Indie;0 - 20,000;102;12;90;10;10;0
595740;SAMURAI WARRIORS: Spirit of Sanada;Adventure, Casual;0 - 20,000;477;100;377;0;0;3
595770;AirMech Wastelands;Adventure, Free to Play, Indie;20,000 - 50,000;239;102;137;199;199;3
595780;Rogue Port - Blue Nightmare;RPG;100,000 - 200,000;35;13;22;338;341;31
595790;Hell is Other Demons;Adventure, Indie, RPG;0 - 20,000;274;18;256;5;5;0
595920;Death Point;Violent, Gore, Action, Adventure;0 - 20,000;19;22;-3;0;0;0
595930;Steam: Rails to Riches;Casual, Indie;20,000 - 50,000;82;19;63;0;0;2
595990;Princess Kidnapper 2 - VR;Action, Racing;0 - 20,000;4;2;2;0;0;0
596000;The Shattering;Indie;0 - 20,000;196;29;167;0;0;0
596000;The Shattering;Action, Adventure, Indie, Simulation;0 - 20,000;196;29;167;0;0;0
596050;Martha Madison: Optics;Adventure, Free to Play;0 - 20,000;0;0;0;0;0;0
596070;Skills Hockey VR;Action, Adventure, Indie, RPG;0 - 20,000;2;8;-6;0;0;0
596080;Embers of Mirrim;Adventure, Casual, Free to Play, Indie;50,000 - 100,000;27;4;23;93;93;0
596140;Photo & Graphic Designer 12 Steam Edition;Adventure;0 - 20,000;17;9;8;0;0;0
596200;Blood 'n Bikinis;Action, Indie, RPG;0 - 20,000;26;9;17;0;0;1
596240;Apocryph: an old-school shooter;Casual, Indie;20,000 - 50,000;153;139;14;0;0;0
596260;S-COPTER: Trials of Quick Fingers and Logic;Adventure, Indie;0 - 20,000;5;0;5;0;0;0
596270;Tales of Terror: Crimson Dawn;Video Production;0 - 20,000;3;2;1;0;0;1
596280;You Are God;Adventure, Indie, RPG;0 - 20,000;8;33;-25;0;0;0
596370;Turn;Adventure, Indie, RPG;0 - 20,000;14;0;14;0;0;0
596380;Coffee Crisis;Casual, Free to Play, Indie;20,000 - 50,000;116;51;65;244;244;0
596390;Over My Dead Body (For You);Casual, Indie, Simulation;0 - 20,000;14;0;14;0;0;0
596400;Azada: Elementa Collector's Edition;Adventure, Indie, RPG;0 - 20,000;7;1;6;0;0;1
596470;Cartesian;Action, Casual, Indie;0 - 20,000;40;1;39;1;1;0
596470;Cartesian;Simulation, Sports, Early Access;0 - 20,000;40;1;39;1;1;0
596530;Chaos Drift;Action, Casual, Simulation;0 - 20,000;11;0;11;0;0;0
596540;The Lost Heir 3: Demon War;Indie, Racing;0 - 20,000;19;15;4;0;0;1
596560;MARS VR(全球使命VR);Indie;0 - 20,000;30;19;11;0;0;0
596590;Linked;Casual, Indie;20,000 - 50,000;341;23;318;261;235;1
596590;Linked;Adventure, Casual, Indie;20,000 - 50,000;341;23;318;261;235;1
596620;Gas Guzzlers: Combat Carnage;Action, Adventure, Indie;0 - 20,000;78;12;66;0;0;0
596630;Ricochet Kills: Noir;Action, Indie, Early Access;0 - 20,000;49;4;45;0;0;0
596640;Lost in the Ocean VR;Action, Casual, Indie;0 - 20,000;20;14;6;0;0;0
596650;Tap Adventure: Time Travel;Indie, Strategy;100,000 - 200,000;553;374;179;63;90;6
596730;Mountaineer;Adventure, Casual, Indie;0 - 20,000;0;1;-1;0;0;0
596740;Origin Space;Adventure, Indie, RPG;0 - 20,000;13;14;-1;0;0;0
596810;Save Their Souls;Action, Indie, RPG;50,000 - 100,000;52;12;40;125;162;1
596870;Drop Hunt - Adventure Puzzle;Action, Adventure, Casual, Free to Play, Indie, RPG;50,000 - 100,000;277;46;231;248;236;2
596880;VEGAS DVD Architect Steam Edition;Adventure, Casual;0 - 20,000;3;5;-2;0;0;0
596890;Life of a Mobster;Action;0 - 20,000;33;2;31;0;0;0
596910;Life of a Wizard;Strategy;0 - 20,000;55;12;43;0;0;0
596940;Hide and Seek;Action, Casual, Sports;100,000 - 200,000;147;221;-74;9;12;0
596950;Rat Simulator;Action, Adventure, Indie;0 - 20,000;144;37;107;268;268;2
596970;Sunless Skies: Sovereign Edition;Action, Indie, Racing;500,000 - 1,000,000;2482;443;2039;867;315;60
596990;Mini Rollers;Adventure, Indie;0 - 20,000;4;3;1;0;0;0
597020;All-Star Fielding Challenge VR;Early Access;0 - 20,000;5;2;3;0;0;0
597030;Aircraft Evolution;Adventure, Casual, Indie, RPG, Strategy;0 - 20,000;195;37;158;0;0;0
597040;Dumbass Drivers!;Animation & Modeling, Design & Illustration, Photo Editing, Utilities;0 - 20,000;41;31;10;125;196;2
597060;Numina;Action, Adventure, Indie;0 - 20,000;22;3;19;0;0;1
597090;Comit the Astrodian 2;Action, Indie;20,000 - 50,000;6;1;5;0;0;0
597090;Comit the Astrodian 2;Design & Illustration, Education, Utilities;20,000 - 50,000;6;1;5;0;0;0
597120;The Filmmaker - A Text Adventure;Action, Adventure, Indie, Simulation, Early Access;0 - 20,000;21;1;20;0;0;0
597150;Hyper Knights;Indie, Strategy;50,000 - 100,000;653;85;568;308;281;0
597170;Clone Drone in the Danger Zone;Action, Adventure, Casual, Indie;500,000 - 1,000,000;20580;635;19945;1160;868;308
597180;Old World;Action, Adventure, Indie;50,000 - 100,000;1561;407;1154;528;710;508
597190;Lunaform;Adventure, Casual;0 - 20,000;8;2;6;0;0;0
597210;Bayou Island - Point and Click Adventure;Action, Indie, RPG, Early Access;20,000 - 50,000;35;40;-5;0;0;0
597220;West of Loathing;Action, Adventure, Casual, Indie, Simulation;500,000 - 1,000,000;8046;188;7858;529;550;116
597230;Shotgun Legend;Violent, Gore, Adventure, Indie, Simulation;100,000 - 200,000;688;69;619;167;184;1
597240;johnsgame;Action, Adventure, Casual, Free to Play, Indie, Early Access;20,000 - 50,000;19;23;-4;0;0;0
597240;johnsgame;Design & Illustration, Early Access;20,000 - 50,000;19;23;-4;0;0;0
597280;Witch Hunters: Stolen Beauty Collector's Edition;Adventure, Indie;0 - 20,000;4;0;4;0;0;0
597590;Attack of the Bugs;Action, Casual, Indie, Simulation, Strategy, Early Access;0 - 20,000;42;4;38;0;0;0
597640;Buccaneers, Bounty & Boom!;Casual, Indie, Simulation, Strategy, Early Access;0 - 20,000;1;0;1;0;0;0
597670;Exterminator;Action;0 - 20,000;3;1;2;0;0;0
597700;OVIVO;Action, Adventure, Casual, Indie, Strategy;20,000 - 50,000;393;42;351;48;48;0
597720;Stunt Toys;Violent, Gore, Action, Adventure, Indie;0 - 20,000;15;8;7;0;0;0
597730;Dark Grim Mariupolis;Action;0 - 20,000;46;10;36;0;0;0
597760;Yuppie Psycho: Executive Edition;Action, Adventure, Casual, Indie, RPG;200,000 - 500,000;5478;287;5191;338;354;49
597770;VINDICTA;Violent, Gore, Action, Adventure, Indie;0 - 20,000;63;23;40;0;0;0
597810;Shining Plume 2;Indie, RPG;20,000 - 50,000;32;8;24;173;203;7
597820;BIOMUTANT;Action, Indie;200,000 - 500,000;11431;5621;5810;653;432;98
597840;Live Wallpaper Master;Action, Free to Play, Indie;100,000 - 200,000;405;154;251;2166;3637;36
597860;Nightmare Boy;Action, Adventure, Indie;0 - 20,000;24;14;10;0;0;0
597900;Eternum EX;Adventure, Casual, Indie;0 - 20,000;34;3;31;0;0;0
597910;Quantum Engine;Casual, Indie, Strategy;0 - 20,000;6;3;3;0;0;0
597920;Survivalizm - The Animal Simulator;Casual, Indie;0 - 20,000;9;21;-12;0;0;0
597970;Age of Rivals;Action, Casual, Indie, Sports;20,000 - 50,000;189;30;159;0;0;2
597990;I'm Titanium;Utilities;0 - 20,000;3;3;0;274;294;0
597990;I'm Titanium;Adventure, Casual, Simulation, Strategy;0 - 20,000;3;3;0;274;294;0
598030;REVOLT 1917;Massively Multiplayer, RPG, Strategy;0 - 20,000;3;19;-16;0;0;0
598050;Ominous Objects: Family Portrait Collector's Edition;Action, Adventure, Casual, Indie, Early Access;0 - 20,000;1;0;1;0;0;0
598060;Slasher's Keep;Action, Adventure, Indie, RPG;200,000 - 500,000;1585;286;1299;247;212;27
598070;Nevrosa: Prelude;Action, Adventure, Simulation, Early Access;50,000 - 100,000;181;25;156;17;26;0
598090;Absent Mind;Casual, Strategy;0 - 20,000;4;9;-5;0;0;0
598170;Super;Free to Play, Simulation, Strategy;0 - 20,000;21;17;4;1;1;0
598180;Arcane Mapper;Action;0 - 20,000;22;27;-5;0;0;0
598230;Ascender;Video Production;0 - 20,000;8;0;8;0;0;0
598240;Stupid Raft Battle Simulator;Action, Indie;0 - 20,000;19;23;-4;0;0;0
598330;SimAirport;Casual, Indie, Simulation;200,000 - 500,000;2794;748;2046;1130;708;97
598340;Lament;Indie, Simulation, Strategy, Early Access;0 - 20,000;30;9;21;2;2;0
598350;Alien Insanity;Adventure, Casual, Indie, Simulation, Early Access;0 - 20,000;34;6;28;0;0;0
598400;Starship Commander: Arcade;Simulation, Strategy;0 - 20,000;33;16;17;0;0;0
598430;Ergastulum: Dungeon Nightmares III;Simulation, Strategy;0 - 20,000;52;10;42;0;0;0
598440;Roots of Insanity;Simulation, Strategy;20,000 - 50,000;285;127;158;197;205;0
598450;Slice, Dice & Rice;Indie, Massively Multiplayer, Strategy, Early Access;50,000 - 100,000;442;247;195;43;83;1
598450;Slice, Dice & Rice;Free to Play, Massively Multiplayer, RPG;50,000 - 100,000;442;247;195;43;83;1
598480;World of One;Simulation;0 - 20,000;66;24;42;0;0;0
598490;Healer's Quest;Action, Indie, Simulation, Early Access;20,000 - 50,000;219;37;182;292;292;1
598500;Startide;Casual, Indie;0 - 20,000;11;7;4;1;1;0
598530;Naev;Adventure, Indie;50,000 - 100,000;132;36;96;1;1;5
598550;HUNTDOWN;Adventure, Indie, RPG, Simulation;100,000 - 200,000;2260;118;2142;130;179;25
598590;Escape 2042 - The Truth Defenders;Adventure, Simulation;0 - 20,000;9;2;7;17;17;0
598610;Avalon Legends Solitaire;Action, Adventure, Indie, RPG, Strategy;0 - 20,000;17;9;8;0;0;2
598620;Mystery Riddles;Action, Indie;0 - 20,000;4;4;0;0;0;0
598640;Wonder Wickets;Free to Play, Indie, Strategy;0 - 20,000;41;2;39;0;0;0
598660;Plevr;Action, Casual, Indie;0 - 20,000;19;19;0;18;18;0
598670;Otome Romance Jigsaws - Midnight Cinderella & Destined to Love;Action, Indie, Massively Multiplayer, Early Access;0 - 20,000;24;1;23;0;0;0
598690;Dark Legion VR;Adventure, Casual, Indie, RPG, Simulation;0 - 20,000;88;38;50;0;0;0
598700;The Vagrant;Adventure, Indie;200,000 - 500,000;6404;669;5735;436;361;31
598720;Country of One;Action, Indie, RPG, Early Access;0 - 20,000;12;9;3;0;0;0
598730;Shakedown: Hawaii;Indie, Strategy;20,000 - 50,000;302;33;269;346;346;3
598740;HORIZON VANGUARD;Adventure, Casual;0 - 20,000;24;2;22;0;0;0
598780;Boreal Blade;Violent, Simulation;50,000 - 100,000;344;188;156;62;119;1
598810;Carcassonne - Tiles & Tactics;Indie;200,000 - 500,000;1610;299;1311;455;348;197
598820;Aloha Paradise Hotel;Casual, Simulation, Strategy;20,000 - 50,000;44;44;0;0;0;0
598840;Ninja Shodown;Indie, Simulation, Strategy;0 - 20,000;16;11;5;0;0;0
598860;MAGIX Video Pro X8 Steam Edition;Action, Adventure, Indie, Strategy;0 - 20,000;17;6;11;0;0;1
598880;Domiverse;Adventure, Indie;0 - 20,000;52;4;48;0;0;0
598940;Doodle Mafia;Violent, Action, Indie;20,000 - 50,000;83;41;42;0;0;1
598960;Mashinky;Action, Adventure, Casual, Indie, RPG, Simulation, Strategy;100,000 - 200,000;2113;333;1780;1808;2029;80
598980;The Coin Game;Violent, Gore, Adventure, Indie;500,000 - 1,000,000;4078;156;3922;372;546;40
598990;Pizza Connection;Action, Adventure, Indie, Simulation, Sports, Early Access;0 - 20,000;41;18;23;0;0;0
599000;Pizza Connection 2;Adventure;20,000 - 50,000;168;57;111;92;92;7
599010;Hanse - The Hanseatic League;Violent, Action, Adventure, Indie;20,000 - 50,000;28;80;-52;0;0;0
599040;Win That War!;Simulation, Sports, Strategy, Early Access;0 - 20,000;22;13;9;0;0;0
599060;Age of Heroes: Conquest;Casual, Free to Play, RPG;0 - 20,000;20;26;-6;0;0;0
599070;Umpire Simulator;Sexual Content, Violent, Gore, Action, Casual, Free to Play, Indie, Strategy;0 - 20,000;3;1;2;0;0;0
599080;The Blackout Club;Casual, Indie, Strategy;100,000 - 200,000;2076;518;1558;366;379;6
599140;Graveyard Keeper;Adventure, Casual;1,000,000 - 2,000,000;26532;4240;22292;1539;932;1503
599150;Prana;Action, Indie, Strategy, Early Access;0 - 20,000;0;0;0;0;0;0
599160;Skeletal Dance Party;Sports, Early Access;0 - 20,000;52;6;46;0;0;0
599180;Mister Mart;Casual, Indie, RPG;0 - 20,000;6;1;5;0;0;0
599390;Battle for Wesnoth;Action, Indie;500,000 - 1,000,000;3895;245;3650;1039;371;220
599420;The Raiders;Action, Indie, RPG, Strategy, Early Access;0 - 20,000;2;0;2;0;0;0
599430;War of Castle VR;Adventure, Indie, Simulation;0 - 20,000;7;0;7;0;0;0
599460;Weapon Shop Fantasy;Indie, Simulation, Strategy;200,000 - 500,000;1274;309;965;1596;1472;29
599480;Flamel's miracle（弗拉梅尔的奇迹）;Adventure, Indie, RPG, Strategy;0 - 20,000;96;48;48;12002;12002;1
599480;Flamel's miracle（弗拉梅尔的奇迹）;Action, Indie;0 - 20,000;96;48;48;12002;12002;1
599490;Bounty Killer;Violent, Gore, Action;0 - 20,000;0;0;0;0;0;0
599510;SpaceDweller;Action, Adventure, Casual, Indie;0 - 20,000;15;11;4;0;0;0
599560;Ghost Files: The Face of Guilt;Adventure, Indie;50,000 - 100,000;181;75;106;166;166;3
599590;Volleyball Fever;Action, Free to Play, Indie;0 - 20,000;57;5;52;0;0;1
599600;Constructor Classic 1997;Simulation;0 - 20,000;55;6;49;33;33;0
599600;Constructor Classic 1997;Casual, Strategy;0 - 20,000;55;6;49;33;33;0
599610;Lost Words: Beyond the Page;Action, Casual, Indie, Simulation, Strategy;20,000 - 50,000;451;18;433;240;240;0
599630;Mountain Mind - Headbanger's VR;Indie;0 - 20,000;26;7;19;0;0;0
599670;Chess3D;Violent, Gore, Action, Indie, Strategy;0 - 20,000;8;2;6;0;0;0
599750;Crisis in the Kremlin;Indie, Simulation, Strategy;200,000 - 500,000;1063;197;866;428;448;12
599800;Easy Magic;Casual, Indie, Sports, Strategy;0 - 20,000;4;0;4;0;0;0
599840;Planet RIX-13;Action, Adventure, Indie;0 - 20,000;87;2;85;0;0;16
599880;Tequila Zombies 3;Action, Adventure, Casual, Indie;20,000 - 50,000;65;25;40;206;206;2
599900;Tower Defense - Fantasy Legends Tower Game;Casual;0 - 20,000;22;20;2;0;0;0
600000;The St Christopher's School Lockdown;Casual, Simulation;0 - 20,000;8;1;7;0;0;0
600080;Unto The End;Action, Adventure, Indie, RPG;0 - 20,000;260;101;159;0;0;2
600090;The Coma: Recut;Action, Adventure, Indie, RPG;50,000 - 100,000;1383;240;1143;121;134;12
600100;Executive Hockey;Casual, Indie;0 - 20,000;4;4;0;0;0;0
600120;Life Forge - Reborn ORPG;Indie;100,000 - 200,000;238;116;122;8;8;0
600130;Valfaris;Indie, Early Access;100,000 - 200,000;1580;271;1309;51;63;7
600140;Belko VR: An Escape Room Experiment;Action, Indie;100,000 - 200,000;561;91;470;23;28;0
600150;Warpaint;Racing, Sports;0 - 20,000;21;10;11;0;0;0
600170;Off The Record: The Art of Deception Collector's Edition;Indie, Strategy;0 - 20,000;6;0;6;0;0;0
600180;Light Strike Array;Adventure, Free to Play, RPG, Strategy;0 - 20,000;0;1;-1;0;0;0
600190;Ski Jump VR;Action, Casual, Simulation, Early Access;0 - 20,000;10;6;4;0;0;0
600200;Smintheus;Adventure, Indie;0 - 20,000;7;1;6;0;0;1
600230;Epsilon Jump Prime;Adventure, Indie, RPG;0 - 20,000;2;0;2;0;0;0
600250;Art of Guile;Nudity, Violent, Gore, Adventure, Indie, RPG, Early Access;0 - 20,000;30;9;21;0;0;0
600260;Jungle Dino VR;Action;0 - 20,000;0;1;-1;0;0;0
600280;Supreme Ruler The Great War;Action, Indie, Strategy;50,000 - 100,000;69;39;30;429;429;6
600290;The Forgotten Void;Adventure, Casual, Indie;0 - 20,000;4;3;1;242;242;0
600310;Rogue'n Roll;Indie, Early Access;0 - 20,000;25;9;16;293;333;1
600330;CONTRACTED;Action, Casual, Indie;20,000 - 50,000;20;6;14;0;0;1
600350;VectorWars VR;Action;0 - 20,000;6;3;3;0;0;0
600370;Paradigm;Indie, Racing, Simulation, Sports;100,000 - 200,000;1355;82;1273;194;181;2
600410;HERO-E;Action, Adventure, Indie;20,000 - 50,000;28;9;19;0;0;0
600420;Mob Rule Classic;Action, Adventure, Indie, Strategy, Early Access;0 - 20,000;158;37;121;426;426;5
600420;Mob Rule Classic;Casual, Indie;0 - 20,000;158;37;121;426;426;5
600430;Ticket to Ride: First Journey;Adventure, Indie, RPG;20,000 - 50,000;192;100;92;213;411;0
600440;Cyber Complex;Indie;0 - 20,000;3;1;2;0;0;0
600460;Dustwind;Casual, Indie, Simulation, Early Access;20,000 - 50,000;243;78;165;219;298;1
600480;Megaquarium;Action, Indie;100,000 - 200,000;2488;144;2344;1434;324;65
600500;LASER STRIKERS;Action, Adventure, Indie, Early Access;0 - 20,000;1;1;0;0;0;0
600520;Cryogear;Violent, Action, Adventure, Casual, Indie, RPG, Early Access;0 - 20,000;9;0;9;0;0;0
600530;Kautic - The Bald Wizard;Adventure, Casual;0 - 20,000;30;5;25;0;0;1
600550;Save Our Souls - Episode I;Action, Adventure;0 - 20,000;11;28;-17;0;0;0
600580;Dark Mechanism - Virtual reality;Adventure, Casual, Strategy;20,000 - 50,000;4;5;-1;0;0;0
600580;Dark Mechanism - Virtual reality;Adventure, Indie, RPG, Simulation, Early Access;20,000 - 50,000;4;5;-1;0;0;0
600600;"""MakeThatMoney""";Free to Play, Strategy;0 - 20,000;19;22;-3;276;277;0
600610;The Hand of Merlin;Action, Casual, Indie;20,000 - 50,000;217;79;138;19;19;4
600630;Spaceship Looter;Adventure, Casual, Indie;20,000 - 50,000;140;63;77;0;0;0
600640;Trapped Summoner;RPG, Strategy;0 - 20,000;10;3;7;0;0;0
600650;OK Bob;Indie;0 - 20,000;21;2;19;0;0;0
600670;Descending;Sexual Content, Casual, Indie, Simulation;0 - 20,000;4;6;-2;0;0;0
600690;TROID BLASTER;Action, Casual, Indie, Racing, Simulation, Sports;0 - 20,000;3;2;1;0;0;0
600720;Trackmania² Lagoon;Design & Illustration, Early Access;20,000 - 50,000;169;98;71;1242;1242;2
600740;Land Doctrine;Action, Indie;20,000 - 50,000;12;11;1;0;0;0
600740;Land Doctrine;Indie;20,000 - 50,000;12;11;1;0;0;0
600750;Star Trek Timelines;Action, Indie, Early Access;200,000 - 500,000;760;415;345;22;35;238
600980;Master Shot VR;Action, Casual, Indie, Simulation, Early Access;0 - 20,000;4;4;0;0;0;0
600990;The Gardens Between;Indie, Simulation;20,000 - 50,000;2114;137;1977;107;194;9
601010;Hotel Anatolia;Action, Indie, Sports;100,000 - 200,000;215;92;123;194;268;0
601020;Seed Of The Arcane , Episode 1;Utilities;0 - 20,000;12;26;-14;0;0;0
601050;Attack on Titan 2 - A.O.T.2;Action, Adventure, Indie, RPG;200,000 - 500,000;4895;403;4492;1072;1546;91
601080;TRANCE VR;Action;0 - 20,000;3;2;1;0;0;0
601110;Twin Roads;Violent, Gore, Action, Adventure, Indie;0 - 20,000;2;2;0;0;0;0
601120;Brain Machine;Animation & Modeling, Design & Illustration, Education, Photo Editing, Software Training, Video Production;0 - 20,000;39;2;37;21;21;0
601130;Spark;Casual, Indie;0 - 20,000;14;3;11;0;0;0
601150;Devil May Cry 5;Action, Adventure, Casual, Indie;2,000,000 - 5,000,000;91812;4450;87362;1116;570;2289
601170;ZiL Truck RallyCross;Action, Adventure, Casual;20,000 - 50,000;45;35;10;0;0;0
601180;Doug and Lily;Simulation;20,000 - 50,000;33;9;24;240;312;2
601200;Pix;Action, Adventure, Casual, Indie;0 - 20,000;6;1;5;0;0;0
601220;Zup! F;Casual, Indie, Simulation;200,000 - 500,000;7476;211;7265;152;116;6
601250;Micronomicon: Heroes;Casual, Indie;0 - 20,000;14;4;10;0;0;0
601320;Schlocks;Action, Casual, Indie;0 - 20,000;7;1;6;0;0;0
601380;The Last One;Action, Indie, Early Access;20,000 - 50,000;46;87;-41;507;507;0
601400;qb;Indie, Simulation, Web Publishing;0 - 20,000;38;14;24;0;0;0
601420;Dark Parables: Requiem for the Forgotten Shadow Collector's Edition;Action, Indie;0 - 20,000;6;1;5;0;0;0
601430;The Evil Within 2;Action, Adventure;1,000,000 - 2,000,000;22341;1834;20507;779;649;275
601490;Passengers: Awakening VR Experience;Casual, Free to Play, Indie, Early Access;0 - 20,000;8;10;-2;0;0;0
601500;Lost in Nature;Action, Adventure;0 - 20,000;10;11;-1;0;0;0
601510;Yu-Gi-Oh! Duel Links;Action, Strategy;2,000,000 - 5,000,000;32832;6289;26543;3766;159;3343
601520;Sirius: Age of the Free Agents;Action, Adventure, Indie;0 - 20,000;3;0;3;0;0;0
601530;Darkarta: A Broken Heart's Quest Collector's Edition;Casual, Simulation, Strategy, Early Access;50,000 - 100,000;809;59;750;271;277;3
601540;Veil of Crows;Action, Adventure, Casual, Indie;20,000 - 50,000;254;203;51;0;0;0
601550;Don't Look Back;Action, Adventure, Indie;0 - 20,000;3;5;-2;0;0;0
601570;Fix Me Fix You;Casual, Indie, Simulation, Strategy;0 - 20,000;39;7;32;261;273;0
601590;BattleTrucks;Adventure, Indie;0 - 20,000;23;29;-6;0;0;11
601620;Room Designer VR;Action, Adventure, Casual, Indie;0 - 20,000;2;7;-5;0;0;0
601700;JETBROS;Sports, Strategy, Early Access;0 - 20,000;7;0;7;0;0;0
601750;Range Day VR;Strategy;0 - 20,000;15;13;2;0;0;1
601760;VR Audio Visualizer;Sexual Content, Nudity, Casual, Indie;0 - 20,000;0;1;-1;0;0;0
601770;Sparc;Action, Adventure, Indie, RPG, Early Access;20,000 - 50,000;341;87;254;112;112;0
601780;VoiceWarrior;Action, Casual, Indie, Early Access;0 - 20,000;23;7;16;0;0;1
601790;Eternal Lore;Adventure, Indie;0 - 20,000;33;9;24;0;0;0
601810;Spark the Electric Jester;Casual, Indie, Simulation;50,000 - 100,000;869;70;799;0;0;7
601840;Griftlands;Indie, Strategy;200,000 - 500,000;11892;649;11243;1626;1058;134
601870;Biotoxin: The Dark Days;Action, Adventure, Casual, Indie, RPG;0 - 20,000;14;9;5;0;0;0
601890;PD Howler 11;Adventure, Casual, Indie;0 - 20,000;14;3;11;10;10;0
601920;Adjacency;Simulation;0 - 20,000;11;2;9;0;0;0
601930;Trianguluv;Action, Adventure, Indie;50,000 - 100,000;49;5;44;260;293;0
601940;Fancy Fishing VR;Indie, Simulation;0 - 20,000;4;4;0;0;0;0
601990;Perspectives: Aleppo-Helsinki;Adventure, Indie;0 - 20,000;19;9;10;0;0;0
602000;Uplands Motel: VR Thriller;Indie, Early Access;0 - 20,000;6;8;-2;0;0;0
602010;Plank not included;Casual, Indie;0 - 20,000;40;7;33;0;0;1
602040;Rota Craze;Adventure, Casual, Indie, RPG;0 - 20,000;0;1;-1;0;0;0
602070;Plasma Puncher;Action, Indie, Simulation, Strategy, Early Access;0 - 20,000;65;5;60;0;0;0
602080;Solaroids;Action, Simulation;20,000 - 50,000;41;2;39;0;0;0
602090;Janus VR;Action, Indie;20,000 - 50,000;39;24;15;0;0;0
602120;Molemen Must Die!;Casual, Indie;0 - 20,000;51;2;49;125;125;0
602130;Violent killer VR;Action, Indie, RPG;0 - 20,000;5;3;2;0;0;0
602140;The Uncertain: VR Experience;Adventure, Casual, Indie;20,000 - 50,000;25;10;15;0;0;0
602150;Desert Battle;Violent, Gore, Action, Adventure, Indie;0 - 20,000;0;1;-1;0;0;0
602160;Alchemist Defender VR;Action, Adventure, Casual, RPG;0 - 20,000;11;4;7;0;0;0
602180;Free Towns;Indie, RPG;0 - 20,000;0;3;-3;0;0;0
602200;Dreamlike Worlds;Adventure, Indie;0 - 20,000;21;11;10;0;0;0
602240;Metacell: Genesis ARCADE;Action, Indie;0 - 20,000;10;1;9;0;0;1
602270;Alienautics;Casual;0 - 20,000;6;2;4;0;0;0
602300;Alter Army;Action, Indie;0 - 20,000;22;8;14;0;0;0
602320;Train Valley 2;Casual, Free to Play, Indie, Simulation;200,000 - 500,000;2038;205;1833;597;461;203
602430;Yono and the Celestial Elephants;Strategy;20,000 - 50,000;195;29;166;180;180;3
602480;Kartong - Death by Cardboard!;Action, Indie;0 - 20,000;59;7;52;0;0;0
602490;Blood Bowl: Death Zone;Action, Adventure, Casual, Indie;0 - 20,000;35;105;-70;0;0;0
602510;Gettysburg: The Tide Turns;Violent, Gore, Action, Indie;0 - 20,000;41;21;20;0;0;3
602520;NEKOPARA Vol. 3;Action, Adventure, Casual, Indie, Strategy;200,000 - 500,000;11263;332;10931;2182;81;20
602540;The Ancient Remains;Action, Casual, Indie, Simulation, Sports;0 - 20,000;3;6;-3;0;0;0
602550;Space Conquest;Action, Adventure, Indie, RPG;0 - 20,000;11;1;10;0;0;0
602590;Saucer-Like;Adventure, Casual, Indie, Strategy;0 - 20,000;34;11;23;0;0;0
602630;Diorama Worlds;Action, Indie, RPG, Strategy;0 - 20,000;31;3;28;50;50;0
602700;Chippy;Violent, Gore, Action, Adventure, Indie;50,000 - 100,000;826;82;744;169;134;7
602770;Clatter;Action, Casual, Indie;50,000 - 100,000;525;95;430;119;145;4
602790;Fated Souls 3;Casual, Indie;50,000 - 100,000;21;16;5;201;207;1
602860;Ironclads 2: Boshin War;Indie;0 - 20,000;14;2;12;0;0;0
602860;Ironclads 2: Boshin War;Adventure, Casual, Indie;0 - 20,000;14;2;12;0;0;0
602880;Powernaut VANGARDT;Action, Adventure, Indie, RPG;20,000 - 50,000;13;2;11;215;221;0
602890;hack_me 2;Action, Adventure, Casual, Indie;200,000 - 500,000;540;236;304;189;210;1
602910;One Wish;Action, Indie;50,000 - 100,000;89;59;30;265;381;30
602920;Sketch! Run!;Strategy;0 - 20,000;6;0;6;0;0;0
602930;Wordlase;Action, Adventure, Casual, Indie;20,000 - 50,000;38;35;3;221;249;0
602960;Barotrauma;Violent, Gore, Action, Indie;1,000,000 - 2,000,000;38496;2931;35565;1613;408;4448
602970;Stunt Island;Casual, Simulation, Sports;0 - 20,000;4;1;3;0;0;1
603000;Hillbilly Apocalypse;Casual, Indie, Simulation;20,000 - 50,000;20;14;6;0;0;0
603010;Chill;Action, Indie, Early Access;50,000 - 100,000;138;37;101;0;0;6
603020;Skautfold: Usurper;Casual, Simulation, Sports, Early Access;50,000 - 100,000;208;86;122;0;0;0
603030;Lamp Head;Adventure, Indie;100,000 - 200,000;320;82;238;192;229;1
603060;Tarim: Guardians;Adventure, Casual, Indie, RPG, Strategy;20,000 - 50,000;53;16;37;232;251;1
603080;Chronicles of a Dark Lord: Tides of Fate Remastered;Violent, Gore, Action, Adventure, Indie, RPG;0 - 20,000;3;5;-2;0;0;0
603090;Dream Stone;Casual, Indie;20,000 - 50,000;31;28;3;238;250;1
603100;ATOMINE;Adventure, Indie;20,000 - 50,000;236;78;158;64;64;6
603110;Grizzland;Action, Adventure, Indie;0 - 20,000;29;3;26;0;0;0
603120;Happy Campers;Strategy;0 - 20,000;28;31;-3;0;0;0
603130;Masked Shooters;Indie;20,000 - 50,000;93;41;52;320;578;0
603140;Connected Hearts - Visual novel;Adventure, Indie;20,000 - 50,000;256;31;225;0;0;0
603150;Defence to death;Adventure, Casual, Free to Play;20,000 - 50,000;111;101;10;343;401;0
603190;Tank Destroyer;Action, Adventure, Indie, RPG, Strategy;50,000 - 100,000;241;72;169;206;220;10
603220;ROTii;Action, Casual, Indie, RPG;20,000 - 50,000;13;3;10;266;258;0
603230;The Wendigo;Action, Indie;0 - 20,000;23;7;16;0;0;0
603250;My Own Little Planet;Adventure, Indie, Simulation, Strategy;20,000 - 50,000;18;13;5;220;220;0
603260;The Cat Games;Action, Indie;50,000 - 100,000;824;94;730;8;8;1
603280;TAROTICA VOO DOO;Adventure, Indie;0 - 20,000;24;2;22;0;0;0
603320;Age of Defense;Casual, Indie, Simulation;50,000 - 100,000;422;118;304;0;0;1
603330;Blasted Road Terror;Indie, Strategy;20,000 - 50,000;74;13;61;0;0;0
603340;Demon Blade VR;Adventure, Indie, RPG, Strategy;0 - 20,000;1;1;0;0;0;0
603350;Don't cut your hand;Casual, Indie, Simulation, Strategy, Early Access;20,000 - 50,000;172;37;135;7;7;0
603360;CryptoMoneya;Adventure, Casual, Indie;200,000 - 500,000;109;57;52;387;440;1
603380;Dragon Essence - Color My World -;Casual, Indie, Strategy, Early Access;0 - 20,000;15;9;6;0;0;0
603390;Stone Story RPG;;0 - 20,000;584;55;529;910;910;16
603400;FOX n FORESTS;Sexual Content, Nudity, Adventure, Casual, Simulation;20,000 - 50,000;121;39;82;23;23;0
603420;Caveman Warriors;Action, Free to Play, Massively Multiplayer, RPG;0 - 20,000;42;17;25;0;0;0
603420;Caveman Warriors;Adventure, Indie, RPG;0 - 20,000;42;17;25;0;0;0
603460;King and Assassins;Action, Indie;20,000 - 50,000;23;55;-32;38;69;0
603490;Star Hunter VR;Casual, Indie;0 - 20,000;1;4;-3;0;0;0
603530;A Robot Named Fight!;Adventure, Indie;50,000 - 100,000;671;93;578;0;0;3
603550;Schlag den Star - Das Spiel;Adventure, Casual;0 - 20,000;30;47;-17;307;307;0
603560;One Night In The House;Adventure, Indie;0 - 20,000;2;1;1;0;0;0
603610;AEGIS 2186;Adventure, Casual, Indie, Early Access;0 - 20,000;9;1;8;0;0;0
603630;Rubber Ball VR;Action, Free to Play, Simulation;0 - 20,000;27;7;20;14;19;0
603660;Women of Xal;Casual, Free to Play, Massively Multiplayer, Early Access;0 - 20,000;19;0;19;0;0;0
603700;The Low Road;Adventure, Early Access;20,000 - 50,000;149;51;98;303;303;1
603700;The Low Road;Action, Adventure, Casual, Indie, Massively Multiplayer, Simulation, Early Access;20,000 - 50,000;149;51;98;303;303;1
603730;Something To Do With Love;Action, Casual, Indie;0 - 20,000;26;14;12;0;0;0
603750;- Arcane Raise -;Action, Indie, Racing;50,000 - 100,000;88;118;-30;259;233;3
603790;Ninja Avenger Dragon Blade;Casual, Indie;0 - 20,000;13;9;4;0;0;0
603800;ReThink;Action, Adventure, Casual, Indie;0 - 20,000;203;48;155;137;137;1
603810;A Girls Fabric Face;Adventure, Indie;0 - 20,000;157;27;130;9;9;0
603840;Randall;Action, Casual, Indie;0 - 20,000;15;4;11;0;0;0
603850;Age of History II;RPG;1,000,000 - 2,000,000;26779;3557;23222;3834;1099;2001
603870;A Tale of Two Kingdoms;Action, Casual, Free to Play, Indie;20,000 - 50,000;23;3;20;0;0;0
603880;Sounds of Her Love;Casual;50,000 - 100,000;637;61;576;229;229;0
603910;MECCHA ZOMBIES;Action, Adventure, Indie;0 - 20,000;6;2;4;0;0;0
603930;Battle Princess Madelyn;Action, Racing, Early Access;0 - 20,000;103;37;66;0;0;0
603940;Pixel Shopkeeper;Violent, Gore, Action, Casual, Indie;0 - 20,000;123;34;89;0;0;0
603960;Monolith;Action, Casual, Indie;100,000 - 200,000;1597;29;1568;310;619;9
603970;Shoot Loop VR;Sexual Content, Nudity, Violent, Adventure, Casual, Indie, Simulation;0 - 20,000;0;1;-1;0;0;0
603990;Memory Eater;Sexual Content, Nudity, Casual, Indie;0 - 20,000;1;2;-1;0;0;0
604000;Like Clay;Indie, Strategy;0 - 20,000;86;15;71;0;0;0
604010;Chimpology;Action, Adventure, Indie;50,000 - 100,000;76;12;64;151;151;1
604040;Legion Tale;Action, Indie;50,000 - 100,000;12;4;8;483;659;0
604060;Goblin Harvest - The Mighty Quest;Indie, Massively Multiplayer, Simulation, Early Access;20,000 - 50,000;8;3;5;0;0;0
604110;Heart. Papers. Border.;Action, Adventure, Casual, Indie;0 - 20,000;8;2;6;0;0;0
604140;Broccoli Bob;Adventure, Simulation;20,000 - 50,000;52;21;31;275;354;0
604150;Bomb Royale;Casual, Indie, RPG;20,000 - 50,000;70;48;22;0;0;4
604170;Libra of the Vampire Princess;Action, Indie;0 - 20,000;36;5;31;0;0;0
604190;Storm Riders;Action, Casual, Indie;50,000 - 100,000;60;307;-247;1;1;0
604230;Unlasting Horror;Adventure;0 - 20,000;65;45;20;0;0;0
604240;Shotgun Farmers: Grow Your Guns;Casual, Indie;500,000 - 1,000,000;8686;651;8035;278;362;64
604300;Show Must Go On;Action, Indie, Sports;20,000 - 50,000;30;11;19;0;0;0
604330;The Crown of Leaves;Action, Adventure, Indie;50,000 - 100,000;1585;55;1530;502;727;7
604340;Web of Deceit: Black Widow Collector's Edition;Adventure, Casual, Free to Play;0 - 20,000;4;0;4;0;0;0
604450;Another Adventure;Indie, Simulation, Early Access;100,000 - 200,000;3943;375;3568;113;127;0
604490;Running Through Russia;Racing, Simulation, Sports, Early Access;100,000 - 200,000;1005;394;611;19;19;1
604500;Tank Force;Indie;200,000 - 500,000;1273;733;540;131;171;214
604510;Empires in Ruins;Adventure, Casual;;;;0;;;
604530;EmbodyMe Beta;Violent, Gore, Action, Adventure, Indie;0 - 20,000;15;6;9;11;11;0
604540;Empire of Sin;Casual, Indie;200,000 - 500,000;2577;2798;-221;906;1470;106
604550;Reality Incognita;Casual;0 - 20,000;4;4;0;0;0;0
604630;Build It;Action, Adventure, Casual, Indie;0 - 20,000;5;1;4;0;0;0
604640;Outer Rim;Action, Indie, Racing, Simulation;0 - 20,000;5;3;2;0;0;0
604740;Danger Zone;Adventure, Casual, Indie, Simulation;20,000 - 50,000;113;49;64;32;42;0
604770;Dark Prospect;Action, Adventure, Indie, RPG;0 - 20,000;41;9;32;0;0;0
604780;aMAZE;Animation & Modeling, Utilities, Video Production;100,000 - 200,000;572;124;448;233;247;1
604830;All Alone: VR;Action;20,000 - 50,000;57;23;34;207;225;4
604920;Dark Blood Chronicles;Casual, Indie;0 - 20,000;15;1;14;0;0;0
604950;RGBverse;Action, Adventure, Indie, RPG;0 - 20,000;15;10;5;0;0;0
604980;Travel Riddles: Trip To India;Action, Free to Play, Indie, Massively Multiplayer, RPG, Early Access;0 - 20,000;17;2;15;0;0;0
604990;Stratside;Action, Adventure, Indie;200,000 - 500,000;6;0;6;0;0;1
605040;Zarya and the Cursed Skull;Utilities;0 - 20,000;4;2;2;0;0;0
605100;Renzo Racer;Action, Indie;0 - 20,000;30;30;0;0;0;0
605140;Kings of Lorn: The Fall of Ebris;Indie, RPG, Strategy, Early Access;0 - 20,000;30;19;11;0;0;0
605160;Perfect Plan;Casual;0 - 20,000;3;3;0;0;0;0
605180;Theory of Fear;Action, Adventure, RPG;0 - 20,000;39;18;21;269;269;0
605190;Getaway Island;Casual, Indie, Strategy;20,000 - 50,000;103;43;60;205;277;4
605210;The Last Tree;Action, Adventure, Casual, Indie;0 - 20,000;24;10;14;241;270;40
605230;Grey Hack;Action, Indie;50,000 - 100,000;936;101;835;381;529;37
605250;Cluckles' Adventure;RPG;0 - 20,000;29;2;27;0;0;0
605310;Unearthing Mars VR;Adventure, Casual, Indie, RPG;0 - 20,000;38;20;18;126;126;0
605410;Fear the Dead;Casual, Indie, Racing, Simulation, Sports;0 - 20,000;1;2;-1;0;0;0
605410;Fear the Dead;Action, Adventure, Indie, RPG, Early Access;0 - 20,000;1;2;-1;0;0;0
605450;In Death;Nudity, Violent, Adventure, Casual;100,000 - 200,000;808;143;665;15;18;2
605490;One Hit KO;Violent, Adventure, Casual;0 - 20,000;8;2;6;0;0;0
605610;Dawn;Action, Indie, Sports, Early Access;100,000 - 200,000;700;70;630;0;0;1
605740;Flashing Lights - Police, Firefighting, Emergency Services Simulator;Action, RPG;100,000 - 200,000;10363;2084;8279;254;189;138
605760;gRally;Sexual Content, Indie;0 - 20,000;32;61;-29;0;0;0
605770;Luna;Adventure, RPG;0 - 20,000;95;16;79;0;0;0
605790;Queen's Tales: The Beast and the Nightingale Collector's Edition;Action, Casual, Indie, Sports;0 - 20,000;4;0;4;0;0;0
605800;Skelattack;Action;0 - 20,000;62;35;27;0;0;0
605830;Organ Quarter;Action, Indie, Strategy, Early Access;20,000 - 50,000;249;29;220;15;15;0
605850;Pinball Inside: A VR Arcade Game;Casual, Indie, Simulation, Strategy, Early Access;0 - 20,000;48;14;34;15;15;0
605850;Pinball Inside: A VR Arcade Game;Indie, Simulation, Sports;0 - 20,000;48;14;34;15;15;0
605860;Paper Toss VR;Adventure, Casual, Indie;0 - 20,000;0;4;-4;0;0;0
605920;VOLTED;Action, RPG, Early Access;0 - 20,000;118;23;95;0;0;0
605990;Heart's Medicine - Hospital Heat;Action, Adventure, RPG, Strategy;0 - 20,000;318;12;306;0;0;3
605990;Heart's Medicine - Hospital Heat;Casual, Indie, Audio Production, Early Access;0 - 20,000;318;12;306;0;0;3
606000;Die for Valhalla!;Strategy;20,000 - 50,000;95;33;62;144;144;0
606010;Weelco VR;Strategy;0 - 20,000;5;4;1;0;0;0
606030;Meganoid;Action, Adventure, Indie, Simulation;0 - 20,000;7;5;2;0;0;0
606060;Dark Tower;Adventure, Casual, Indie, RPG, Strategy;0 - 20,000;14;5;9;0;0;0
606140;Survived By;Adventure, Casual, Indie, RPG, Strategy;200,000 - 500,000;769;482;287;54;45;1
606150;Moonlighter;Adventure, Casual, Indie, RPG, Strategy;1,000,000 - 2,000,000;12360;2501;9859;525;362;151
606180;Viveport Video;Indie, Strategy;20,000 - 50,000;71;60;11;247;451;3
606190;Nighthaw-X3000;Simulation, Strategy;0 - 20,000;18;2;16;0;0;0
606230;Thea 2: The Shattering;Action, Casual, Indie, Early Access;100,000 - 200,000;1526;432;1094;364;404;66
606270;Chess and Checkers VR;Action, Adventure, Casual, Indie;0 - 20,000;2;3;-1;0;0;0
606280;Darksiders III;Violent, Action, Adventure, Casual, RPG, Early Access;1,000,000 - 2,000,000;9850;3107;6743;1260;920;146
606300;Divine Ascent;Action, Free to Play, Massively Multiplayer;0 - 20,000;11;2;9;0;0;0
606330;Shadows 2: Perfidia;Violent, Gore, Action, Adventure;200,000 - 500,000;197;54;143;273;258;0
606360;Mech Skeleton;Casual, Indie;0 - 20,000;9;3;6;0;0;0
606370;Romancing SaGa 2;Indie;20,000 - 50,000;150;79;71;0;0;21
606480;Flood of Light;Action, Indie;0 - 20,000;235;17;218;0;0;1
606490;Duck Life: Space;Adventure, Casual, Indie;0 - 20,000;89;14;75;0;0;1
606500;HellSign;Action, Casual, Early Access;200,000 - 500,000;1433;626;807;1319;2067;4
606510;Grisaia Phantom Trigger Vol.1;Utilities;20,000 - 50,000;296;21;275;0;0;1
606520;Grisaia Phantom Trigger Vol.2;Action, Indie;0 - 20,000;130;4;126;0;0;0
606670;Crowd Smashers;Indie;0 - 20,000;6;0;6;0;0;0
606680;Silver;Action, Early Access;20,000 - 50,000;599;50;549;310;310;2
606690;Ecchi Sketch: Draw Cute Girls Every Day!;Action, Indie;0 - 20,000;57;10;47;298;305;1
606710;Sphinx and the Cursed Mummy;Audio Production, Utilities;100,000 - 200,000;440;31;409;20;20;3
606720;Cosmic Kites;Simulation;0 - 20,000;6;0;6;0;0;0
606730;Sine Mora EX;Adventure, Indie, Simulation;50,000 - 100,000;341;177;164;84;104;3
606790;Battle Bolts;Casual, Indie, RPG;0 - 20,000;12;2;10;0;0;0
606800;Startup Company;Casual;200,000 - 500,000;4604;1048;3556;1279;554;80
606850;VR Batting;Utilities;0 - 20,000;2;1;1;0;0;0
606860;Nephise;;50,000 - 100,000;318;123;195;53;59;0
606870;MetaMorph: Dungeon Creatures;Casual, Indie, Simulation, Sports;50,000 - 100,000;51;37;14;84;48;0
606880;GreedFall;Action, Indie, Early Access;500,000 - 1,000,000;13101;3746;9355;800;537;274
606890;Masters of Anima;Indie, Simulation;20,000 - 50,000;259;50;209;0;0;0
606920;EXA: The Infinite Instrument;Indie, RPG;0 - 20,000;86;2;84;0;0;0
606920;EXA: The Infinite Instrument;Indie, RPG;0 - 20,000;86;2;84;0;0;0
606940;Cyborg Tower Defense;Casual, Free to Play, Simulation;0 - 20,000;34;9;25;0;0;0
606950;Army General;Nudity, RPG;0 - 20,000;29;23;6;0;0;0
606960;CRIMSON METAL Classic 1999;Action, Adventure, Casual, RPG;50,000 - 100,000;140;123;17;167;215;0
606980;Potentia;Education;0 - 20,000;247;119;128;375;375;0
607020;Last Heroes 4;Action, Indie;20,000 - 50,000;24;10;14;362;506;37
607030;Jade's Journey 2;Adventure, Casual;20,000 - 50,000;18;14;4;202;202;8
607040;Grimoire Chronicles;Action, Casual, Indie, Simulation, Sports;20,000 - 50,000;52;15;37;217;225;6
607050;Wargroove;Action, Adventure, Casual, Indie;500,000 - 1,000,000;3856;713;3143;432;312;69
607080;Psychonauts 2;Action, Casual, Indie;200,000 - 500,000;8417;213;8204;557;924;142
607120;Police Quest: SWAT 2;Action, Adventure, Indie;0 - 20,000;53;20;33;0;0;0
607160;Luxin Time;Action, Casual, Indie;0 - 20,000;2;0;2;0;0;0
607190;Dark: Frontier;Action, Adventure, Indie;0 - 20,000;6;3;3;0;0;0
607210;Possessed;Action, Adventure, Early Access;20,000 - 50,000;78;42;36;227;210;75
607230;ClockwiZZZe;Action, Adventure, Indie;0 - 20,000;1;0;1;179;179;0
607260;McOsu;Adventure, Indie, Racing, Simulation, Sports;500,000 - 1,000,000;4852;568;4284;85;11;165
607330;Rangi;Casual, Indie, Simulation;0 - 20,000;19;0;19;0;0;0
607350;Battlestage;Action, Adventure, Indie, Simulation;0 - 20,000;1;7;-6;0;0;0
607360;COG (Center Of Gravity);Adventure, Casual, Indie, Simulation;0 - 20,000;7;2;5;0;0;0
607380;Fences 3;Adventure, Indie;50,000 - 100,000;395;304;91;7;10;5
607400;Necrosphere;Design & Illustration;0 - 20,000;126;11;115;91;91;0
607440;Escape: VR;Casual, Indie, Simulation, Strategy, Early Access;100,000 - 200,000;129;30;99;246;256;0
607460;Epic Snails;Action, Simulation, Sports;20,000 - 50,000;284;26;258;8;8;0
607490;HAUNTED: Halloween '86 (The Curse Of Possum Hollow);Adventure, Indie, Strategy;0 - 20,000;25;1;24;0;0;0
607560;VRCURATOR;Action, Indie;0 - 20,000;10;2;8;0;0;0
607590;Earthquake Simulator VR;Action, RPG;0 - 20,000;8;3;5;0;0;0
607660;21 Days;Casual, Indie, Simulation, Early Access;0 - 20,000;46;15;31;0;0;0
607670;Puzzle Guardians;Action, Adventure, Indie;0 - 20,000;4;2;2;0;0;0
607680;Popap;Action, Adventure, Free to Play, Racing, Sports, Early Access;20,000 - 50,000;17;7;10;210;271;0
607690;SourVR Video Player Deluxe Edition;Adventure, Casual, Indie, Simulation, Strategy, Early Access;0 - 20,000;2;7;-5;0;0;0
607720;VR Darts;Action, Adventure, Indie;0 - 20,000;6;3;3;0;0;0
607760;CyberDrifter;Adventure, Indie;0 - 20,000;12;2;10;0;0;0
607770;Moonatees;Action, Adventure, Indie;0 - 20,000;12;1;11;0;0;0
607780;Toymaker;Adventure, Indie, RPG;0 - 20,000;5;0;5;0;0;0
607820;Infinite Adventures;Casual, Free to Play, Massively Multiplayer, Strategy;0 - 20,000;100;8;92;0;0;2
607860;Kira;Action, Indie, Strategy;0 - 20,000;20;10;10;3;3;0
607880;Accel World VS. Sword Art Online Deluxe Edition;Free to Play, RPG, Strategy;50,000 - 100,000;777;260;517;463;482;1
607890;Sword Art Online: Hollow Realization Deluxe Edition;Action, Casual, Simulation, Strategy, Early Access;200,000 - 500,000;5714;1435;4279;1381;606;56
608110;Null Vector;Adventure, Casual;20,000 - 50,000;259;9;250;242;243;0
608120;AFTERBURN;Violent, Adventure, Indie;20,000 - 50,000;252;35;217;0;0;2
608190;Frontier VR;Action, Indie;0 - 20,000;7;8;-1;0;0;0
608370;Drums Hero;Casual, Indie, Strategy;0 - 20,000;59;23;36;0;0;0
608440;Volatile Triangle;Action;0 - 20,000;7;0;7;0;0;0
608530;TARTARUS;Action, Casual, Indie, RPG, Strategy, Early Access;20,000 - 50,000;109;97;12;0;0;0
608540;Blastercell;Action, Adventure, Indie, Early Access;0 - 20,000;10;5;5;194;275;0
608580;Empires;Action, Casual, Indie, Simulation;0 - 20,000;17;22;-5;0;0;0
608630;PIXEL ZUMBI;Adventure, Casual, Indie, RPG;20,000 - 50,000;28;7;21;449;449;0
608660;Psebay;Audio Production, Design & Illustration, Utilities, Video Production, Web Publishing;20,000 - 50,000;103;11;92;189;193;1
608670;Miracle Mia;Casual, Indie;0 - 20,000;23;2;21;0;0;0
608760;Doodle Devil;Casual, Indie;50,000 - 100,000;115;25;90;233;254;1
608800;Guns of Icarus Alliance;Action, Adventure, Casual, Indie, Simulation, Strategy;100,000 - 200,000;1035;320;715;301;50;1
608870;Phantasma VR Director's Cut;Action, Casual, Indie;0 - 20,000;31;6;25;0;0;0
608980;Arch Virtual HQ;Action, Indie;0 - 20,000;10;1;9;12;19;0
608990;The Archotek Project;Adventure, Indie;200,000 - 500,000;447;355;92;93;42;1
609010;Mech League Boxing;Adventure, Indie, RPG;0 - 20,000;10;4;6;0;0;0
609100;Gold Rush! 2;Adventure, Casual;50,000 - 100,000;13;8;5;341;353;0
609110;Blazing Chrome;Adventure, Indie, RPG;50,000 - 100,000;1227;153;1074;156;202;4
609150;STAR OCEAN - THE LAST HOPE - 4K & Full HD Remaster;Action, Adventure, Indie;50,000 - 100,000;928;381;547;417;736;31
609170;Drummer Talent VR;Casual, Indie;0 - 20,000;27;20;7;0;0;0
609320;FAR: Lone Sails;Indie, Racing, Simulation;500,000 - 1,000,000;12517;734;11783;211;216;91
609340;Twilight Phenomena: The Lodgers of House 13 Collector's Edition;Adventure, Casual, Indie, RPG, Early Access;0 - 20,000;2;0;2;0;0;0
609360;Gravity Garden;Action, Casual, Simulation;0 - 20,000;3;0;3;0;0;0
609400;City Rush;Action, Adventure, Indie, Early Access;0 - 20,000;0;1;-1;0;0;0
609410;Iron Tides;Adventure, Indie, RPG;0 - 20,000;56;17;39;0;0;0
609420;Never Give Up;Sexual Content, Nudity, Adventure, Casual, Indie;0 - 20,000;112;15;97;0;0;3
609490;Minit;Action, Racing, Simulation, Sports;100,000 - 200,000;1951;217;1734;239;263;3
609720;Tyr: Chains of Valhalla;Adventure, Casual, Indie, Simulation;0 - 20,000;19;11;8;0;0;0
609760;The Eagle's Heir;Action, Indie;0 - 20,000;27;4;23;0;0;0
609850;Slinger VR;Action, Adventure, Strategy;0 - 20,000;37;14;23;0;0;1
609920;Hotshot Racing;Action, Adventure, Indie;100,000 - 200,000;1033;366;667;37;20;6
609940;KROSMAGA;Action;200,000 - 500,000;716;250;466;76;76;10
609990;BeeFense;Action, Adventure, Indie, RPG;0 - 20,000;21;12;9;0;0;0
610080;Realm Grinder;Adventure, Indie;1,000,000 - 2,000,000;5290;785;4505;3965;197;869
610090;Gnomelings: Migration;Action, Free to Play, Massively Multiplayer;0 - 20,000;7;0;7;0;0;0
610110;Love Story: Letters from the Past;Casual, Indie, Simulation, Strategy;0 - 20,000;3;0;3;0;0;0
610120;Little Kite;Adventure, Casual, Indie;20,000 - 50,000;111;16;95;293;308;0
610130;UltraGoodness;Action, Adventure, Indie, Simulation;100,000 - 200,000;161;52;109;243;252;0
610160;Aeronautica Imperialis: Flight Command;Action, Casual, Indie, Early Access;0 - 20,000;82;107;-25;7;7;1
610180;The Jackbox Party Pack 4;Casual, Free to Play, Simulation;200,000 - 500,000;2540;132;2408;383;187;172
610210;Planetes;Free to Play;0 - 20,000;8;17;-9;0;0;0
610250;Glitch's Trip;Violent, Action, Casual, Indie;0 - 20,000;30;2;28;0;0;0
610260;American VR Coasters;Action, Adventure, RPG, Early Access;0 - 20,000;4;2;2;0;0;0
610310;Star Story: The Horizon Escape;Racing;0 - 20,000;150;30;120;244;244;0
610340;CyberLink ScreenRecorder 3 Deluxe;Action, Adventure, Indie, Early Access;0 - 20,000;12;5;7;0;0;0
610350;Poker Show VR;Action, Free to Play, Indie, Sports, Early Access;0 - 20,000;24;28;-4;0;0;0
610360;Zup! Zero;Action, Indie, Strategy, Early Access;100,000 - 200,000;2309;158;2151;192;215;0
610370;Desperados III;Casual, Indie, Strategy;200,000 - 500,000;10781;360;10421;1710;1371;264
610380;Ratty Catty;Action, Indie;50,000 - 100,000;629;332;297;232;340;3
610410;PAWARUMI;Adventure, Casual, Indie;0 - 20,000;66;5;61;0;0;0
610410;PAWARUMI;Action, Free to Play, Early Access;0 - 20,000;66;5;61;0;0;0
610460;Rise of Balloons;Action, Adventure, Indie;0 - 20,000;3;1;2;0;0;0
610500;Willy-Nilly Knight;Action, Adventure, Casual, Indie, Strategy;20,000 - 50,000;214;70;144;498;498;2
610550;Hidden Expedition: The Pearl of Discord Collector's Edition;Violent, Gore, Indie;0 - 20,000;5;0;5;0;0;0
610560;Tales of the Lumminai;Violent, RPG;20,000 - 50,000;7;8;-1;300;300;0
610570;Paradox Soul;RPG;20,000 - 50,000;35;38;-3;0;0;0
610610;PacaPlus;Action, Indie;0 - 20,000;56;7;49;0;0;0
610620;Too Loud: Chapter 1;RPG;0 - 20,000;28;2;26;0;0;0
610660;Russian Roads;Action, Indie, Simulation, Sports, Early Access;20,000 - 50,000;111;43;68;261;261;0
610670;Alchemyland;Action, Indie;200,000 - 500,000;59;83;-24;411;415;0
610680;Starway Fleet;Action, Adventure, Casual, Indie;0 - 20,000;72;34;38;0;0;0
610680;Starway Fleet;Adventure, Indie;0 - 20,000;72;34;38;0;0;0
610730;The Chosen Warriors;Action, Indie, Early Access;20,000 - 50,000;67;24;43;288;309;3
610740;SuperCluster: Void;Adventure, Indie;0 - 20,000;18;4;14;0;0;0
610750;Games&Girls;Adventure, Casual, Indie, Simulation, Early Access;20,000 - 50,000;201;67;134;253;264;0
610780;Crazy Buggy Racing;Indie, Massively Multiplayer, Racing, Simulation, Early Access;50,000 - 100,000;38;78;-40;232;234;3
610810;Your Friend Hana;Violent, Gore, Action, Adventure, Casual, Indie;50,000 - 100,000;405;202;203;146;146;0
610840;JASEM: Just Another Shooter with Electronic Music;Action, Adventure, Indie, RPG;20,000 - 50,000;117;43;74;295;295;3
610860;Shogo: Mobile Armor Division;Action, Indie, Massively Multiplayer;0 - 20,000;117;39;78;28;40;0
610900;Sumatra: Fate of Yandi;Action, Indie;20,000 - 50,000;116;2;114;0;0;1
610940;iStorm;Action, Adventure, Indie;0 - 20,000;48;67;-19;0;0;0
610940;iStorm;Action, Casual, Indie, Simulation;0 - 20,000;48;67;-19;0;0;0
610960;红石遗迹 - Red Obsidian Remnant;Action, Indie, RPG, Early Access;50,000 - 100,000;690;130;560;976;1070;4
610980;The Midnight Sanctuary;Casual, Indie;0 - 20,000;24;1;23;0;0;0
611020;CityBattle | Virtual Earth;Violent, Action, Casual, Early Access;200,000 - 500,000;1056;519;537;0;0;0
611040;Tube Tycoon;Casual, Free to Play, Indie, Strategy;100,000 - 200,000;414;127;287;582;582;2
611050;Moriarty: Endgame VR;Simulation;0 - 20,000;5;2;3;0;0;0
611060;ECHOPLEX;Free to Play, Simulation;0 - 20,000;47;10;37;0;0;0
611080;Gappo's Legacy VR;Nudity, Violent, Adventure, Indie, RPG;0 - 20,000;2;0;2;0;0;0
611090;Boofle's Home;Casual, Indie;0 - 20,000;16;6;10;1;1;0
611120;IKEA VR Pancake Kitchen;Sexual Content, Adventure, Casual, Indie;20,000 - 50,000;225;96;129;67;107;3
611140;Dark Passenger;Nudity, Violent, Action, Adventure, Indie;0 - 20,000;17;13;4;411;411;0
611160;Karnage Chronicles;Adventure, Indie;50,000 - 100,000;1041;178;863;200;253;0
611160;Karnage Chronicles;Action, Indie, Strategy;50,000 - 100,000;1041;178;863;200;253;0
611180;Super Street: The Game;Action;20,000 - 50,000;159;184;-25;115;133;1
611190;ROGUE SHIFT;Adventure, Indie;0 - 20,000;24;1;23;45;45;0
611230;Heathen - The sons of the law;Violent, Gore, Action, Adventure, Indie, Simulation;0 - 20,000;74;13;61;366;366;1
611260;Mad Machines;Action, Adventure, RPG, Early Access;20,000 - 50,000;160;50;110;0;0;0
611300;Task Force;Action, Indie, Simulation, Early Access;0 - 20,000;326;78;248;9;9;0
611320;Think To Die 3;Strategy;0 - 20,000;65;16;49;13;13;0
611320;Think To Die 3;Casual, Indie, Simulation, Strategy;0 - 20,000;65;16;49;13;13;0
611350;Evil Tag;Violent, Action, Racing;50,000 - 100,000;445;210;235;72;98;2
611390;Anicon - Animal Complex - Sheep's Path;Casual, Indie, Strategy;0 - 20,000;6;1;5;0;0;0
611500;Quake Champions;Action, Indie;1,000,000 - 2,000,000;26524;9683;16841;434;72;691
611550;Underground Keeper 2;Action, Casual, Indie, Racing, Sports;0 - 20,000;5;1;4;0;0;0
611620;TheNightfall;Casual, Free to Play;20,000 - 50,000;99;33;66;233;233;0
611630;Grave Chase;Gore, Indie, Simulation, Strategy;0 - 20,000;42;4;38;0;0;0
611640;Mono;Casual, Indie, Strategy;0 - 20,000;28;7;21;0;0;0
611660;Fallout 4 VR;Strategy;500,000 - 1,000,000;4356;2650;1706;692;352;83
611670;The Elder Scrolls V: Skyrim VR;Strategy;500,000 - 1,000,000;6970;2233;4737;728;234;327
611690;Invicta Beam;Indie, Strategy, Early Access;0 - 20,000;2;4;-2;0;0;1
611710;Kaiju Big Battel: Fighto Fantasy;Casual, Free to Play, Indie;0 - 20,000;39;0;39;0;0;0
611720;Practisim VR;Action, Indie, Simulation, Sports, Early Access;0 - 20,000;30;13;17;0;0;1
611730;Galactic Feud;Action, Free to Play, Indie, Early Access;0 - 20,000;10;1;9;0;0;0
611750;Welcome to Hanwell;Adventure, Casual, Free to Play, Indie;0 - 20,000;143;133;10;149;149;0
611760;Don't Escape: 4 Days to Survive;Action, Adventure, Indie, RPG;100,000 - 200,000;1619;34;1585;282;412;7
611770;Void Source;Indie, RPG, Simulation, Strategy, Early Access;20,000 - 50,000;83;22;61;279;279;0
611790;House Party;Adventure, Indie;500,000 - 1,000,000;11625;1653;9972;559;373;177
611800;Jidousha Shakai;Strategy;0 - 20,000;149;137;12;0;0;0
611810;THE LAST HUNT;Free to Play;0 - 20,000;3;9;-6;0;0;0
611820;Xenosis: Alien Infection;Action, Adventure, Casual, RPG;0 - 20,000;0;0;0;0;0;0
611830;Park Bound;Action, RPG;0 - 20,000;90;10;80;281;281;0
611850;Tragedy of Prince Rupert;Casual, Indie, Simulation;20,000 - 50,000;52;6;46;3;3;0
611860;Aborigenus;Action;20,000 - 50,000;94;26;68;0;0;0
611960;Pilam Sky;Casual, Indie;20,000 - 50,000;40;8;32;315;365;0
611970;TimeToDie;Action, Indie;0 - 20,000;1;3;-2;0;0;0
611980;Oik 2;Adventure, Indie;100,000 - 200,000;1163;85;1078;141;173;1
612010;Duel VR;Action, Adventure, Indie;0 - 20,000;2;1;1;0;0;0
612020;Zombidle : REMONSTERED;Adventure, Casual, Indie;200,000 - 500,000;1394;223;1171;4562;6831;122
612030;Harvest Simulator VR;Casual, Indie;0 - 20,000;7;5;2;0;0;0
612060;Indie Dream;Indie, Simulation;0 - 20,000;80;13;67;0;0;0
612100;These nights in Cairo;Strategy;20,000 - 50,000;231;19;212;0;0;1
612110;Sweet fantasy;Action;50,000 - 100,000;374;77;297;252;270;0
612120;Darwin's bots: Episode 1;Action, Adventure, Indie, RPG;0 - 20,000;9;8;1;0;0;0
612140;Weebish Mines;Action, Casual, Indie;0 - 20,000;14;1;13;0;0;0
612150;Conran - The dinky Raccoon;Casual, Indie, Strategy;0 - 20,000;5;3;2;0;0;0
612160;Splinter Zone;;0 - 20,000;20;1;19;0;0;0
612170;One Eyed Kutkh;Action, Adventure, RPG;200,000 - 500,000;103;22;81;429;431;0
612190;Fastigium: Dead End;Action, Adventure, Indie, Simulation;0 - 20,000;11;5;6;0;0;0
612220;Chaos Edge;Casual, Indie, Simulation;0 - 20,000;1;5;-4;0;0;0
612250;Eastwood VR;Action, Adventure, Indie, RPG, Early Access;20,000 - 50,000;6;10;-4;338;357;0
612300;Sudden Strike Gold;Violent, Gore, Adventure, Indie, RPG;50,000 - 100,000;299;43;256;411;817;37
612310;GORB;RPG;0 - 20,000;32;1;31;0;0;1
612370;PAKO 2;Action, Adventure, RPG;20,000 - 50,000;305;16;289;0;0;1
612380;Cryptocracy;Action, Casual, Indie;0 - 20,000;5;3;2;0;0;0
612390;Dandara: Trials of Fear Edition;Indie;50,000 - 100,000;745;189;556;42;77;5
612440;The Cable Center - Virtual Archive;Adventure, Indie;0 - 20,000;10;2;8;0;0;0
612470;Bio Inc. Redemption;Violent, Gore, Action, Indie, Early Access;100,000 - 200,000;1545;179;1366;441;380;14
612510;The Far Frontier;Free to Play, Indie, Strategy, Early Access;0 - 20,000;32;17;15;282;277;0
612520;Sudden Strike 2 Gold;Sexual Content, Nudity, Violent, Gore, Action, Adventure, Indie, RPG;50,000 - 100,000;205;37;168;1073;1073;22
612540;Sudden Strike 3;Action, Indie, Early Access;50,000 - 100,000;107;52;55;4;4;21
612570;Fort Triumph;Casual, Simulation, Strategy;50,000 - 100,000;692;179;513;502;502;6
612590;Mouse Playhouse;Action, Adventure, Casual, Simulation;20,000 - 50,000;43;7;36;13;22;0
612600;Drone Fighters;Action, Adventure, Indie, Simulation, Early Access;0 - 20,000;15;0;15;4;4;0
612610;Bombinator;Action, Adventure, Free to Play, Indie;20,000 - 50,000;38;65;-27;30;31;0
612620;Detective Butler: Maiden Voyage Murder;RPG;50,000 - 100,000;190;44;146;1;1;0
612640;Dunk Lords;Action, Indie, Racing, RPG, Simulation, Strategy;0 - 20,000;43;6;37;0;0;0
612670;Moonfall;Indie, Simulation, Strategy;0 - 20,000;36;9;27;0;0;0
612720;SAELIG;Simulation;50,000 - 100,000;478;113;365;24;24;5
612740;Bokida - Heartfelt Reunion;Action, Adventure, Indie, RPG, Early Access;0 - 20,000;113;34;79;60;60;0
612750;Scorb VR;Action, Adventure;0 - 20,000;0;0;0;0;0;0
612790;INFINITI VR;Action, Indie;20,000 - 50,000;41;20;21;0;0;0
612810;VALIANT KNIGHTS Typing Battle;Adventure, Casual, Indie, RPG, Strategy;0 - 20,000;14;16;-2;0;0;0
612820;Fallen Legion: Rise to Glory;Action;0 - 20,000;48;26;22;0;0;1
612840;Boxplosion;Free to Play, Indie, Strategy;0 - 20,000;10;1;9;0;0;0
612880;Wolfenstein II: The New Colossus;Simulation, Strategy;1,000,000 - 2,000,000;28634;7323;21311;829;608;398
612890;Link Twin;Adventure, Indie;0 - 20,000;16;2;14;0;0;0
612930;Fight of Gods;Action, Casual, Indie;50,000 - 100,000;671;121;550;44;44;2
613010;Secret in Story;Action, Indie;500,000 - 1,000,000;71;34;37;254;260;0
613020;Gem Hunter;Casual, Free to Play;0 - 20,000;11;2;9;0;0;0
613040;A Lost Room;Violent, Gore, Action, Adventure;0 - 20,000;9;6;3;0;0;0
613050;Laser Grid;Adventure, Casual;0 - 20,000;0;0;0;0;0;0
613100;House Flipper;Action, Adventure;2,000,000 - 5,000,000;67206;4491;62715;1710;826;3427
613120;Tank Battle: East Front;Indie, Simulation, Strategy;20,000 - 50,000;20;6;14;0;0;1
613130;Mega Overload VR;Action, Casual, Indie, Early Access;0 - 20,000;34;1;33;0;0;1
613190;Unworthy;Adventure, Indie, Simulation;20,000 - 50,000;540;122;418;160;160;2
613200;Dead Days;Action;0 - 20,000;12;2;10;0;0;0
613210;BlobCat;Adventure, Casual, Indie, Simulation;0 - 20,000;57;4;53;0;0;0
613220;Steam 360 Video Player;Adventure, Casual;100,000 - 200,000;68;58;10;0;0;6
613240;Stonekeep;Indie, Strategy;0 - 20,000;94;4;90;17;17;0
613270;Dinosis Survival;Violent, Action, Indie;0 - 20,000;153;135;18;0;0;0
613270;Dinosis Survival;Indie;0 - 20,000;153;135;18;0;0;0
613330;Blackjack Bailey VR;Action, Casual;0 - 20,000;6;6;0;0;0;0
613350;Punished Talents: Seven Muses Collector's Edition;Casual, Indie, Simulation;0 - 20,000;4;0;4;0;0;0
613370;Upside-Down Dimensions;Action, Casual, Indie;0 - 20,000;2;2;0;0;0;0
613390;DUNGEONS OF CHAOS;Massively Multiplayer, RPG, Early Access;0 - 20,000;143;17;126;5;5;6
613400;Sakeretsu;Strategy;0 - 20,000;5;2;3;0;0;0
613410;Delphinia Chronicle;Casual, Indie, Strategy;0 - 20,000;4;11;-7;0;0;0
613420;BOROS;Action, Casual, Indie;0 - 20,000;25;1;24;0;0;0
613450;Please Knock on My Door;Casual, Indie;20,000 - 50,000;208;14;194;0;0;0
613470;The Inner World - The Last Wind Monk;Action, Free to Play, Indie, Early Access;20,000 - 50,000;283;31;252;239;239;2
613470;The Inner World - The Last Wind Monk;Action, Indie;20,000 - 50,000;283;31;252;239;239;2
613580;The DRG Initiative;Action, Casual, Indie;0 - 20,000;16;11;5;0;0;0
613590;Dungeon Of Zaar - Open Beta;Action, Casual, Massively Multiplayer, Racing, Simulation, Sports, Early Access;20,000 - 50,000;90;40;50;0;0;0
613610;Silver Island;Action, Adventure, Indie, RPG;0 - 20,000;9;0;9;0;0;0
613620;Hoverloop;Free to Play, Indie, Strategy;0 - 20,000;23;12;11;0;0;0
613670;The Chronicles of Dragon Wing - Reborn;Casual, Massively Multiplayer, Simulation, Sports, Early Access;20,000 - 50,000;172;42;130;13007;13007;5
613730;Need For Drink;Casual, Indie;100,000 - 200,000;745;256;489;91;129;0
613790;RED CUBE VR;Indie, RPG, Strategy;0 - 20,000;22;12;10;0;0;0
613800;Space Epic Untitled - Season 1;Action, Indie, Early Access;20,000 - 50,000;11;22;-11;0;0;0
613830;CHRONO TRIGGER;Adventure, Indie, RPG, Early Access;200,000 - 500,000;6225;914;5311;776;824;144
613850;Radiant Crusade;Adventure, Indie, RPG;0 - 20,000;8;4;4;0;0;0
613860;Tank On Tank Digital  - West Front;Adventure, Casual, Indie;0 - 20,000;28;15;13;0;0;0
613880;Zoo Tycoon: Ultimate Animal Collection;Action, Strategy;100,000 - 200,000;1008;598;410;247;301;36
613900;Museum of Other Realities;Action, Adventure, Indie;50,000 - 100,000;334;29;305;30;43;1
613970;Bravery: Rise of The Last Hero;Action, Adventure, Indie, Simulation, Sports;0 - 20,000;5;12;-7;0;0;0
613980;Top Secret;Adventure, Casual, Free to Play;0 - 20,000;5;8;-3;0;0;0
614030;Rhythm Rush!;Adventure, Casual;0 - 20,000;117;44;73;428;525;0
614050;Clumsy Knight 2;Action, Indie;0 - 20,000;7;11;-4;0;0;0
614090;Deadbeat Heroes;Action, Casual, Free to Play, Simulation, Strategy;50,000 - 100,000;57;29;28;0;0;1
614100;Heroes of Paragon;Simulation;20,000 - 50,000;41;46;-5;6;6;0
614130;Command: Chains of War;Sexual Content, Violent, Action, Casual, Indie;0 - 20,000;27;2;25;0;0;2
614140;Illusoria;Action, Indie, RPG;0 - 20,000;14;22;-8;0;0;0
614150;Train Harder;Casual, Indie;0 - 20,000;10;0;10;0;0;0
614160;Bug Invaders;Action, Casual, Indie;0 - 20,000;3;2;1;0;0;0
614250;Carrier;Action, Simulation, Strategy;20,000 - 50,000;31;7;24;0;0;0
614260;Gates Of Nowhere;Free to Play, Simulation, Sports;0 - 20,000;40;19;21;0;0;0
614380;Haunted Manor: Lord of Mirrors Collector's Edition;Adventure, Casual, Indie;0 - 20,000;2;1;1;0;0;1
614450;Bellatia;Adventure, Casual, Indie, RPG, Strategy;0 - 20,000;17;26;-9;0;0;0
614460;Amber Tail Adventure;Adventure;100,000 - 200,000;49;27;22;189;234;0
614530;Garden Tale;Adventure;20,000 - 50,000;5;7;-2;0;0;0
614530;Garden Tale;Adventure;20,000 - 50,000;5;7;-2;0;0;0
614550;Golden Panic;Action, Indie, Simulation, Sports, Early Access;0 - 20,000;11;1;10;0;0;0
614560;Battleship Bishojo;Adventure, Indie, Strategy;0 - 20,000;4;8;-4;0;0;0
614570;Dishonored: Death of the Outsider;Action, Adventure, Indie;1,000,000 - 2,000,000;8777;1235;7542;550;466;103
614630;Tiny Rails;Casual, Indie;50,000 - 100,000;401;119;282;99;177;9
614650;Midnight Calling: Anabel Collector's Edition;Adventure, Casual, Indie;0 - 20,000;2;0;2;0;0;0
614700;Nightmare Grotto;Action, Casual, Indie, Early Access;0 - 20,000;13;4;9;0;0;0
614770;Beachhead: DESERT WAR;;0 - 20,000;14;12;2;0;0;0
614830;ViveSpray 2;Adventure, Casual, Indie;0 - 20,000;26;8;18;0;0;0
614850;Power Fist VR;Action, Free to Play, Indie;0 - 20,000;2;1;1;0;0;0
614860;XAOC;Casual, Sports;20,000 - 50,000;143;53;90;11;11;0
614880;Battle for Enlor;Action, Adventure, Indie, RPG, Simulation;0 - 20,000;8;14;-6;348;348;0
614890;Cuit;Nudity, Adventure, RPG, Strategy, Early Access;0 - 20,000;99;28;71;24;24;0
614900;Devade;Action;0 - 20,000;39;27;12;202;202;0
614910;#monstercakes;Action, Indie, Sports;200,000 - 500,000;691;95;596;209;210;20
614940;The Misfits;Violent, Gore, Action, Adventure, Indie, Simulation, Strategy;100,000 - 200,000;181;160;21;0;0;0
614950;Shootout on Cash Island;Action, Casual, Indie, Early Access;20,000 - 50,000;279;47;232;184;202;0
614960;NEONomicon;Action, Free to Play, Indie, Racing, Early Access;20,000 - 50,000;88;23;65;298;272;1
614960;NEONomicon;Sexual Content, Adventure, Casual, Indie;20,000 - 50,000;88;23;65;298;272;1
614970;Qbike: Cyberpunk Motorcycles;Action, Indie, Early Access;0 - 20,000;32;26;6;0;0;0
615010;Runic Rampage - Action RPG;Action, Casual, Indie, Simulation, Early Access;0 - 20,000;170;24;146;0;0;0
615010;Runic Rampage - Action RPG;Casual, Indie, Simulation, Early Access;0 - 20,000;170;24;146;0;0;0
615070;Dealey Plaza Paintball;Action, Adventure, Indie;0 - 20,000;2;1;1;0;0;0
615080;Runaway Train;Animation & Modeling, Utilities, Early Access;0 - 20,000;11;2;9;202;202;0
615090;Royal Offense;Adventure, Casual, Indie;50,000 - 100,000;67;24;43;373;396;1
615120;COMPOUND;Indie, Strategy;100,000 - 200,000;1684;41;1643;213;212;26
615150;Twist of Destiny;Video Production;0 - 20,000;31;11;20;0;0;1
615160;The Adventures of Alvis;Casual, Indie;0 - 20,000;7;6;1;0;0;0
615180;Firewood;Action, Indie;0 - 20,000;107;33;74;0;0;0
615270;Star Rage VR;Action, Casual, Indie, Sports;0 - 20,000;28;3;25;0;0;0
615330;Happy Penguin VR;Sexual Content, Violent, Adventure, Indie, Simulation;0 - 20,000;22;2;20;0;0;0
615340;Mystic Journey: Tri Peaks Solitaire;Action, Adventure, Casual, Indie, RPG, Simulation, Early Access;50,000 - 100,000;76;67;9;0;0;5
615350;Scarlett Mysteries: Cursed Child;Action;20,000 - 50,000;204;26;178;0;0;4
615390;Encounter of Galaxies;Adventure, Indie;0 - 20,000;0;4;-4;0;0;0
615400;Make It Rain: Love of Money;Action, Indie;50,000 - 100,000;104;125;-21;0;0;2
615460;Bitcoin VR;Casual, Indie;0 - 20,000;8;4;4;0;0;0
615490;I'm Awesome;Violent, Action, Adventure;0 - 20,000;12;7;5;110;110;0
615530;Love, Money, Rock'n'Roll;Action, Adventure, Indie;200,000 - 500,000;4351;999;3352;1086;1165;132
615550;StratoBash;Free to Play, RPG, Strategy;0 - 20,000;5;2;3;0;0;0
615590;Solaright;Design & Illustration, Utilities;0 - 20,000;6;4;2;0;0;0
615610;Orbt XL;Action, Casual, Indie;200,000 - 500,000;3118;98;3020;113;104;1
615630;The Sniper VR;Casual, Indie;0 - 20,000;20;14;6;0;0;0
615650;The Professor Presents: #GotHandles;Action, Adventure, Casual, Indie;0 - 20,000;18;4;14;1;1;0
615670;SOLITUNE;Indie, RPG, Strategy;20,000 - 50,000;97;24;73;0;0;4
615680;Vagrant Hearts Zero;Utilities, Video Production;20,000 - 50,000;10;17;-7;199;204;0
615690;Inferno;Animation & Modeling, Design & Illustration;20,000 - 50,000;9;4;5;0;0;0
615700;A Plunge into Darkness;Audio Production, Utilities;50,000 - 100,000;12;5;7;0;0;0
615730;Nancy Drew: The Final Scene;Design & Illustration, Photo Editing;20,000 - 50,000;77;16;61;0;0;11
615770;Nancy Drew: Message in a Haunted Mansion;Action, Adventure, Indie;20,000 - 50,000;112;29;83;0;0;3
615770;Nancy Drew: Message in a Haunted Mansion;Free to Play, Indie, Simulation;20,000 - 50,000;112;29;83;0;0;3
615780;Nancy Drew: Treasure in the Royal Tower;Casual, Simulation;20,000 - 50,000;111;26;85;0;0;3
615910;Katana X;Adventure, Casual, Indie;0 - 20,000;78;28;50;0;0;0
615970;Displaced;Adventure, Casual, Indie, Strategy;0 - 20,000;102;79;23;74;74;2
616000;Riptale;Adventure, Indie;0 - 20,000;96;12;84;20;20;0
616030;Eventide Night;Casual, Indie;100,000 - 200,000;25;1;24;293;299;0
616040;Tales of the Tiny Planet;Action, Indie, Simulation, Sports;0 - 20,000;27;5;22;23;23;0
616050;Hello inc VR;Adventure, Casual, Indie, Racing;0 - 20,000;1;0;1;0;0;0
616090;龙魂时刻;Casual, Indie, Simulation, Strategy;200,000 - 500,000;474;864;-390;22;26;0
616110;SPACEPLAN;Action, Casual, Indie;100,000 - 200,000;2150;209;1941;565;562;10
616220;Hide vs. Seek;Action, Adventure, Free to Play, Massively Multiplayer, RPG, Simulation;200,000 - 500,000;223;393;-170;15;23;0
616240;Premium Pool Arena;Action, Indie, Simulation, Strategy, Early Access;20,000 - 50,000;57;59;-2;1400;2071;0
616250;Crystalline;Adventure, Indie;50,000 - 100,000;1270;65;1205;97;97;5
616330;埋葬 DIG A BOO;Action, Indie;0 - 20,000;27;8;19;0;0;0
616490;Post War Dreams;Action, Adventure, Indie, RPG, Simulation, Strategy, Early Access;0 - 20,000;7;8;-1;0;0;0
616520;Cheap Golf;Adventure, Casual, Indie;20,000 - 50,000;125;26;99;258;275;0
616560;Ultimate Epic Battle Simulator;Adventure, Indie;500,000 - 1,000,000;8722;2781;5941;174;38;59
616570;Gritty Bit VR;Action, Adventure, Indie, RPG, Strategy;0 - 20,000;0;0;0;0;0;0
616610;GetMeBro!;Action, Indie;50,000 - 100,000;106;23;83;0;0;0
616620;Forest Fortress;Violent, Free to Play, Indie, Strategy;20,000 - 50,000;117;29;88;51;51;0
616640;B-12;Action, Adventure, Casual, Indie;0 - 20,000;18;5;13;0;0;0
616650;RetroFighter VR;Casual, Indie, Racing;0 - 20,000;0;3;-3;0;0;0
616660;VR Coaster Extreme;Action, Casual, Indie;0 - 20,000;9;12;-3;0;0;0
616680;Monster Showdown;Action, Indie;0 - 20,000;25;7;18;0;0;0
616690;BRKÖUT;Action, Adventure, Casual, Indie;0 - 20,000;13;3;10;0;0;0
616700;Rage of Car Force: Car Crashing Games;Adventure, Indie;50,000 - 100,000;669;209;460;19;19;6
616720;Live2DViewerEX;Adventure, Indie, RPG, Strategy;100,000 - 200,000;2728;211;2517;1852;232;150
616740;克莉丝的炎之信仰 Cryste: the Faith of Fire Vol.1;Adventure, Casual, Indie, Simulation, Strategy;0 - 20,000;263;34;229;350;350;0
616750;1943 Deadly Desert;Action, Indie;20,000 - 50,000;46;30;16;0;0;2
616810;Maski VR;Casual, Indie;0 - 20,000;9;4;5;0;0;0
616820;District Steel;Action, Adventure, Indie;0 - 20,000;13;1;12;0;0;2
616830;Cartoon Strike;Casual;100,000 - 200,000;301;162;139;0;0;3
616860;Magic Heroes: Save Our Park;Nudity, Violent, Casual, Indie, Simulation;0 - 20,000;3;1;2;0;0;0
616880;No Stick Shooter;Adventure, Casual, Indie;0 - 20,000;21;3;18;0;0;0
616890;VR Slugger: The Toy Baseball Field;Action, Casual, Indie;0 - 20,000;27;4;23;14;14;0
616920;BatMUD;Action, Indie, Early Access;0 - 20,000;122;25;97;0;0;26
617020;OMEGA PATTERN - VISUAL NOVEL;Action, Indie;0 - 20,000;5;4;1;0;0;0
617030;Landless;Action;0 - 20,000;88;103;-15;0;0;0
617060;Virush;Casual, Indie;0 - 20,000;9;2;7;3;3;0
617160;Home Sweet Home;Action, Adventure, Casual, Indie, Simulation;100,000 - 200,000;2761;393;2368;436;429;33
617230;Trapped Within;Action;0 - 20,000;1;2;-1;0;0;0
617270;Hoggy 2;;0 - 20,000;12;3;9;0;0;0
617290;Remnant: From the Ashes;Action, Indie, Racing;2,000,000 - 5,000,000;37018;6549;30469;2599;995;615
617350;Samurai Forge;Action, Indie, Early Access;0 - 20,000;0;0;0;0;0;0
617360;Station Architect;Action, Indie;0 - 20,000;14;2;12;0;0;0
617420;Animal Rivals;Action, Indie;0 - 20,000;27;25;2;419;482;0
617430;A Butterfly in the District of Dreams;Action, Indie;0 - 20,000;20;2;18;0;0;0
617440;Arcade Mayhem Juanito;RPG;50,000 - 100,000;304;22;282;4;4;1
617450;Trollskog;Adventure, Casual, Indie;0 - 20,000;26;13;13;0;0;0
617480;Tower of Time;Action, Casual, Indie, Early Access;50,000 - 100,000;1732;302;1430;138;213;34
617550;Prism;Adventure, Indie, RPG, Simulation, Strategy;0 - 20,000;3;2;1;0;0;0
617560;DreamPlan;Adventure, Casual, Indie, RPG, Strategy;0 - 20,000;5;0;5;0;0;1
617570;Switch;Action, Adventure, Casual, Indie, RPG, Early Access;0 - 20,000;9;0;9;0;0;0
617580;PhotoPad;Indie;0 - 20,000;6;1;5;0;0;0
617590;Affliction;Adventure, Indie;50,000 - 100,000;34;26;8;0;0;2
617610;Japanese Women - Animated Jigsaws;Action, Adventure;20,000 - 50,000;133;10;123;547;547;23
617620;Disturbed: Beyond Aramor;Casual, Indie, Simulation, Strategy;20,000 - 50,000;33;1;32;312;312;0
617630;Shadow Mist;Action, Indie, Simulation;0 - 20,000;18;8;10;0;0;0
617640;Forged of Blood;Adventure, Indie;0 - 20,000;78;38;40;16;16;0
617640;Forged of Blood;Action, Adventure, Free to Play;0 - 20,000;78;38;40;16;16;0
617670;Zup! S;Action, Casual, Indie;200,000 - 500,000;10555;265;10290;142;98;11
617680;Drunk-Fu: Wasted Masters;Casual, Indie, Simulation, Strategy;0 - 20,000;28;11;17;0;0;0
617690;Endless Winter;Indie, Simulation;0 - 20,000;38;5;33;0;0;1
617700;Weed Shop 2;Indie, Simulation;20,000 - 50,000;736;114;622;355;355;6
617710;Cannons-Defenders: Steam Edition;Casual, Indie;50,000 - 100,000;83;49;34;228;248;1
617750;Neurowake;Casual, Indie, Strategy, Early Access;0 - 20,000;8;10;-2;0;0;0
617820;7 days with Death;Education;0 - 20,000;54;3;51;0;0;0
617830;SUPERHOT VR;Action, Adventure, Indie;500,000 - 1,000,000;6371;2296;4075;212;128;64
617850;Jaws Of Extinction;Indie, Simulation, Sports, Strategy;0 - 20,000;201;135;66;0;0;1
617970;Love Bites;Free to Play, Indie, Massively Multiplayer, Strategy;0 - 20,000;14;9;5;0;0;0
617980;Summer In Trigue;Indie, Simulation;0 - 20,000;16;4;12;4;4;6
618050;To The Light;Adventure, Casual, Indie, Early Access;20,000 - 50,000;61;72;-11;0;0;0
618070;Jet Buster;Adventure, Indie;0 - 20,000;38;4;34;254;254;0
618080;Martial Arts Brutality;Casual, Indie, Strategy;50,000 - 100,000;577;103;474;87;124;4
618100;Feral Blue;Action, Adventure, Casual, Indie;0 - 20,000;130;99;31;0;0;0
618140;Barro;Indie, Strategy, Early Access;200,000 - 500,000;2978;844;2134;251;29;22
618190;People Eater;Action, Indie;0 - 20,000;7;0;7;0;0;0
618200;Skylands;Action, Indie;0 - 20,000;11;14;-3;0;0;0
618210;Lanternium;Violent, Gore, Action, Adventure, Indie;0 - 20,000;43;7;36;0;0;0
618260;Endurance;Adventure, Indie, Early Access;0 - 20,000;6;4;2;254;263;0
618270;Spiritlands;Action, Adventure, Indie;0 - 20,000;19;10;9;0;0;0
618310;AFTERGRINDER;Casual, Indie, Simulation;0 - 20,000;67;21;46;135;135;0
618350;Personal Disco VR;Casual, Indie, Simulation;0 - 20,000;33;4;29;0;0;0
618360;Aesthetic Melody;Action, Free to Play;0 - 20,000;49;9;40;0;0;0
618370;Rescue Quest Gold;Action, Casual, Indie, Early Access;20,000 - 50,000;36;6;30;0;0;1
618430;Episicava - Vol. 1;Action, Indie, RPG, Early Access;;;;0;;;
618470;Qbik;Action, Racing;0 - 20,000;97;7;90;298;298;2
618470;Qbik;Casual, Indie, Racing, Strategy;0 - 20,000;97;7;90;298;298;2
618490;Mr Blaster;Adventure, Indie;50,000 - 100,000;37;23;14;139;183;0
618500;Hailstorm VR;Action, Adventure, Indie, RPG;0 - 20,000;14;6;8;0;0;0
618510;Battle Bruise;Adventure, Casual, Indie, Simulation;50,000 - 100,000;390;39;351;209;241;0
618550;Chess of Blades;Casual, Indie;0 - 20,000;94;11;83;0;0;0
618570;Pixel Arcade;Action, Indie;0 - 20,000;16;4;12;0;0;0
618590;Zombie Buster VR;Action;0 - 20,000;19;5;14;0;0;0
618610;Endless Horde;Violent, Action, Massively Multiplayer;50,000 - 100,000;110;55;55;276;307;0
618620;Naval Armada: Fleet Battle;Casual;50,000 - 100,000;79;57;22;7;7;8
618630;Astral Traveler;Accounting, Animation & Modeling, Audio Production, Design & Illustration, Education, Photo Editing, Software Training, Utilities, Video Production, Web Publishing;0 - 20,000;10;6;4;100;100;0
618640;The Crowded Party Game Collection;Utilities;0 - 20,000;16;11;5;0;0;1
618650;Pixel Gear;Action, Free to Play, Indie, Racing, Strategy;0 - 20,000;6;2;4;0;0;0
618670;One Bullet left;Sexual Content, Nudity, Adventure;0 - 20,000;4;3;1;0;0;0
618690;Gorescript;Action, Indie, RPG;0 - 20,000;60;5;55;7;7;0
618710;Elminage ORIGINAL - Priestess of Darkness and The Ring of the Gods;Casual, Simulation, Sports;0 - 20,000;53;7;46;0;0;2
618720;1bitHeart;Action, Indie, Simulation, Strategy;50,000 - 100,000;652;59;593;815;981;3
618740;Beat Hazard 2;Action, Indie;100,000 - 200,000;1806;265;1541;88;99;5
618750;Choose Wisely;Action, Casual, Indie, Simulation, Strategy, Early Access;50,000 - 100,000;67;26;41;117;120;9
618760;IronBorn;Sexual Content, Violent, Indie;20,000 - 50,000;25;12;13;0;0;49
618840;Samhain World;Adventure, Casual, Indie;0 - 20,000;1;5;-4;206;206;0
618850;Pumpkin Days;Action, Adventure, Indie, RPG;20,000 - 50,000;418;73;345;4031;4031;11
618850;Pumpkin Days;Action, Adventure, Casual, Indie;20,000 - 50,000;418;73;345;4031;4031;11
618920;Dungeon Escape VR;Action, Casual, Indie, Early Access;20,000 - 50,000;145;29;116;4;4;0
618950;Agatha Knife;Action, Adventure, Casual, Indie;20,000 - 50,000;403;23;380;0;0;0
618970;Outcast - Second Contact;Action, Adventure, Casual, Indie, Racing, Simulation;50,000 - 100,000;589;156;433;1178;1354;11
618990;Into Oblivion;Casual, Indie, Strategy;0 - 20,000;13;2;11;0;0;0
619000;Riley Short: Analog Boy - Episode 1;Casual, Indie, Strategy;0 - 20,000;1;2;-1;0;0;0
619010;Arkaia: The Enigmatic Isle;Adventure, Casual, Free to Play, Indie;0 - 20,000;13;8;5;0;0;0
619080;SOS;Indie, Simulation;200,000 - 500,000;1925;4956;-3031;844;45;0
619100;Spirit Guide Crucible;Adventure, Casual, Indie;0 - 20,000;1;3;-2;0;0;0
619140;Station 21 - Space Station Simulator;Strategy;0 - 20,000;5;12;-7;0;0;0
619150;while True: learn();Strategy;500,000 - 1,000,000;5815;511;5304;391;438;14
619210;4D Toys;Strategy;0 - 20,000;158;25;133;151;151;2
619220;GoBlock's Impossible Medley;Casual, Indie;0 - 20,000;17;2;15;0;0;0
619230;VEmpire - The Kings of Darkness;Action, Adventure;0 - 20,000;18;7;11;0;0;0
619250;Gonio VR;Action, Indie, Early Access;0 - 20,000;8;1;7;0;0;0
619270;Wolf's Fury;Action, Adventure, Indie;0 - 20,000;8;1;7;0;0;0
619280;Gloom;Action, Adventure, Indie;20,000 - 50,000;465;95;370;865;1261;1
619290;Out of the Park Baseball 19;Action, Adventure, Indie, Racing;100,000 - 200,000;631;108;523;0;0;15
619310;Ways of History;Casual, Indie, Simulation, Sports;50,000 - 100,000;118;118;0;18;27;7
619320;Skatemasta Tcheco;Action, Indie;0 - 20,000;103;6;97;0;0;1
619330;Duck Hunting;Casual, Indie;0 - 20,000;11;10;1;258;273;0
619340;EGOS - Tales of Fallen Souls;Indie, Early Access;200,000 - 500,000;41;31;10;348;403;2
619350;Sandra and Woo in the Cursed Adventure;Action, Indie, Sports;0 - 20,000;18;7;11;0;0;0
619380;The little vampir;Action, Indie, Racing, Sports;0 - 20,000;5;1;4;1;1;0
619390;Oddworld: Soulstorm Enhanced Edition;Action, Casual, Indie;0 - 20,000;169;74;95;0;0;18
619400;Fluffy Creatures VS The World;Indie, Simulation;200,000 - 500,000;106;156;-50;245;225;1
619430;World of Castles;Action, Adventure, Indie, RPG, Strategy, Early Access;0 - 20,000;64;86;-22;0;0;0
619430;World of Castles;Adventure, Casual;0 - 20,000;64;86;-22;0;0;0
619470;Boss Defiance - Heroic Edition;Adventure, Casual;0 - 20,000;9;7;2;224;224;0
619480;Rock, Ken, Bo;RPG;0 - 20,000;5;2;3;0;0;0
619490;Fear of Clowns;Action, Casual, Indie;0 - 20,000;118;57;61;12;12;0
619500;cyubeVR;Adventure, Indie, RPG, Simulation, Strategy;100,000 - 200,000;783;68;715;244;359;7
619550;Vision;Action, Early Access;0 - 20,000;46;15;31;0;0;0
619590;CubeBall VR;Utilities;0 - 20,000;1;0;1;0;0;0
619600;Wrecked: Get Your Ship Together;Design & Illustration, Early Access;20,000 - 50,000;29;13;16;0;0;0
619610;Ultratank;Action, Indie, RPG;50,000 - 100,000;2;1;1;0;0;0
619620;Cellz;Action, Adventure, Casual, Indie, Racing, Simulation;0 - 20,000;1;1;0;0;0;0
619670;Huge Bang Bang;Action, Adventure, Indie, RPG, Strategy;0 - 20,000;19;5;14;0;0;0
619700;Steel Rats;Racing;200,000 - 500,000;711;476;235;103;111;3
619740;The Inevitability;Action, Casual, Indie;100,000 - 200,000;56;38;18;365;365;18
619780;The Swords of Ditto: Mormo's Curse;Action, Free to Play, Massively Multiplayer, RPG;100,000 - 200,000;1352;820;532;496;743;8
619810;Fabulous - Angela's High School Reunion;Indie, Strategy;0 - 20,000;57;5;52;0;0;1
619870;Omegaland;Action, Indie, Strategy;0 - 20,000;83;6;77;0;0;0
619880;ATOMEGA;Action, Casual, Indie, Racing, Sports;50,000 - 100,000;1069;308;761;221;242;3
619890;Evil Glitch;Adventure, Indie;20,000 - 50,000;30;3;27;273;282;0
619910;Just Cause 3: Multiplayer Mod;Racing;200,000 - 500,000;1952;545;1407;181;43;17
619930;Spring Bonus;Action, Casual, Indie, Simulation, Early Access;0 - 20,000;47;11;36;158;158;1
620040;Multiplicity;Casual, Indie, Simulation;0 - 20,000;13;15;-2;1;1;0
620050;Start10;Violent, Adventure, Indie, RPG, Strategy;0 - 20,000;38;27;11;1;1;0
620070;Vroom Kaboom;Adventure, Casual;100,000 - 200,000;60;52;8;0;0;1
620080;A Clockwork Ley-Line: The Borderline of Dusk;Action;0 - 20,000;46;5;41;0;0;1
620130;Chaos Town;Adventure, Casual;20,000 - 50,000;38;7;31;316;323;1
620140;Bottle Flip Challenge VR;Action;0 - 20,000;3;2;1;0;0;0
620170;Icarus Starship Command Simulator;Action, Indie, Simulation, Strategy, Early Access;0 - 20,000;42;5;37;0;0;0
620180;Nerepis;Casual, Indie;0 - 20,000;0;1;-1;0;0;0
620190;Gunsmith;Utilities, Video Production, Early Access;50,000 - 100,000;709;229;480;250;250;21
620210;Fatal Twelve;Free to Play, Simulation;0 - 20,000;702;35;667;828;1136;6
620220;Catmaze;Casual, Free to Play, Massively Multiplayer, Simulation, Strategy;20,000 - 50,000;389;64;325;0;0;1
620280;Freefall;Action, Adventure, Indie;0 - 20,000;14;0;14;0;0;0
620310;Bonny's Adventure;Action, Adventure, Indie;20,000 - 50,000;11;1;10;528;462;0
620330;Scrapper;Adventure, Casual, Free to Play, RPG;0 - 20,000;4;1;3;0;0;0
620340;Cubrick;Indie, RPG, Simulation, Early Access;0 - 20,000;22;1;21;0;0;0
620350;Dark Hope: A Puzzle Adventure;Simulation, Strategy;200,000 - 500,000;9;8;1;0;0;0
620360;Toy Clash;Action, Indie, Strategy;0 - 20,000;42;1;41;0;0;0
620570;Tower!2011:SE;Action, Adventure, Free to Play, Indie, Massively Multiplayer, Racing, RPG, Strategy, Early Access;0 - 20,000;7;11;-4;0;0;0
620580;Calico & Co.;Action, Adventure, Indie;0 - 20,000;7;5;2;123;123;0
620590;Ancestors Legacy;Casual, Indie, Strategy;500,000 - 1,000,000;5664;1472;4192;604;442;54
620640;Lightning: D-Day;Indie, Early Access;0 - 20,000;9;11;-2;0;0;0
620650;Puzzle With Your Friends;Adventure, Indie, Early Access;0 - 20,000;135;20;115;0;0;1
620660;Jack Spriggan;Adventure, Casual;0 - 20,000;7;1;6;0;0;0
620670;The Cursed Revolver;Nudity, Violent, Gore, Action, Indie, Early Access;0 - 20,000;12;2;10;0;0;0
620700;EVIL POSSESSION;Adventure, Casual;20,000 - 50,000;59;42;17;36;36;0
620710;TankBlitz;Action, Indie;0 - 20,000;37;6;31;0;0;0
620790;The Slopes;Adventure, Indie, RPG, Strategy, Early Access;0 - 20,000;2;7;-5;0;0;0
620800;Big Hit VR Baseball;Indie, Strategy;0 - 20,000;19;2;17;0;0;0
620890;Wizard Bros;Indie, Simulation, Strategy;0 - 20,000;25;6;19;0;0;0
620900;Witchinour;Action, Adventure, Indie;0 - 20,000;54;3;51;0;0;0
620940;Invisibox;Action, Indie;20,000 - 50,000;58;6;52;337;363;10
620980;Beat Saber;Action, Casual, Indie;2,000,000 - 5,000,000;64637;2681;61956;2595;932;1176
621000;异常 | Exception;Strategy;50,000 - 100,000;1638;41;1597;875;115;0
621010;Headmaster;Action, Indie, Early Access;0 - 20,000;31;2;29;0;0;0
621020;Antigraviator;Violent, Adventure, Indie;20,000 - 50,000;153;76;77;215;246;0
621050;Crazy Veggies;Action, Casual, Indie;50,000 - 100,000;25;30;-5;140;229;0
621060;PC Building Simulator;Adventure, Indie, RPG;1,000,000 - 2,000,000;44022;2803;41219;1365;353;396
621070;Legends of Ellaria;Nudity, Violent, Action, Adventure, Indie, Racing, Simulation, Early Access;20,000 - 50,000;481;306;175;116;116;1
621080;Persian Nights: Sands of Wonders;Adventure, Casual, Indie;0 - 20,000;216;18;198;0;0;2
621090;Elixir of Immortality II: The League of Immortality;Indie;0 - 20,000;3;4;-1;0;0;0
621140;EGG HUNT VR;Casual, Simulation, Sports;0 - 20,000;3;0;3;0;0;0
621150;False Shelter;Adventure, Casual, Indie;20,000 - 50,000;44;24;20;265;225;0
621170;Winter's Empty Mask - Visual novel;Adventure, Casual, Simulation;0 - 20,000;24;0;24;0;0;0
621220;Nantucket;Racing, Sports;100,000 - 200,000;630;158;472;4585;4585;7
621290;The Hunted;Casual;0 - 20,000;1;5;-4;0;0;0
621300;Wing Pro 6;Casual, Indie, Strategy;0 - 20,000;13;0;13;0;0;0
621500;TrueScale;Casual;0 - 20,000;15;22;-7;0;0;0
621780;Virtually Impossible;Massively Multiplayer, RPG, Early Access;0 - 20,000;12;8;4;0;0;0
621810;Strain Tactics;Action, Adventure, Casual, Indie;20,000 - 50,000;171;30;141;0;0;3
621830;WRC 7 FIA World Rally Championship;Adventure, Casual;200,000 - 500,000;3972;1203;2769;392;228;95
621850;Maze Bandit;Action, Indie, Massively Multiplayer, RPG, Simulation, Early Access;0 - 20,000;16;6;10;0;0;0
621880;Phoenix Dynasty 2;Indie, Simulation, Early Access;50,000 - 100,000;167;235;-68;42;42;0
621930;Attack of the Earthlings;Adventure, Casual;20,000 - 50,000;287;48;239;255;255;2
621930;Attack of the Earthlings;Adventure, Casual;20,000 - 50,000;287;48;239;255;255;2
621940;Unleash;Action, Indie, Early Access;0 - 20,000;49;13;36;139;139;0
621970;Trailblazers;Casual, Indie;0 - 20,000;41;32;9;0;0;0
622010;The Fall of Lazarus;Action, Casual, Indie, Simulation, Sports;0 - 20,000;60;36;24;99;181;0
622020;ATV Drift & Tricks;Action, Casual, Indie;0 - 20,000;34;33;1;0;0;0
622020;ATV Drift & Tricks;Action, Adventure, Indie;0 - 20,000;34;33;1;0;0;0
622040;Zooicide;Indie;20,000 - 50,000;270;137;133;26;33;0
622060;XOXO Droplets;Casual, Indie, Simulation, Strategy, Early Access;20,000 - 50,000;196;64;132;1;1;6
622080;Plague Road;Action, Adventure, Indie, Early Access;0 - 20,000;10;18;-8;0;0;0
622150;Bridge to Another World: Burnt Dreams Collector's Edition;Adventure, Casual, Indie;0 - 20,000;6;0;6;0;0;1
622170;Offensive Combat: Redux!;Adventure, Indie;50,000 - 100,000;214;142;72;268;268;0
622200;Cursery: The Crooked Man and the Crooked Cat Collector's Edition;Casual, Free to Play, Indie;0 - 20,000;18;0;18;0;0;0
622220;Fate/EXTELLA LINK;Simulation, Sports, Strategy;100,000 - 200,000;3573;259;3314;1189;2053;19
622270;Show It 2 Me;Action, Massively Multiplayer, Racing, Simulation;0 - 20,000;120;2;118;30;30;0
622290;1 multi screen media player gallery video wall photo slideshow wizard app;Sports, Early Access;0 - 20,000;13;7;6;0;0;0
622300;theViewer;Strategy;0 - 20,000;4;3;1;0;0;0
622310;Amigo VR;Adventure, Indie;0 - 20,000;20;21;-1;8;8;0
622320;Nano Project;Adventure, Indie, RPG;0 - 20,000;8;7;1;0;0;0
622370;Freaky Awesome;Video Production, Web Publishing;50,000 - 100,000;129;101;28;166;218;0
622380;RETNE;Action, Indie;0 - 20,000;36;10;26;0;0;0
622420;Stay Alive: Apocalypse;Action, Simulation;0 - 20,000;87;75;12;0;0;0
622440;Pandemic: The Board Game;Adventure, RPG;50,000 - 100,000;383;254;129;58;59;21
622460;Steampunk Tower 2;Action, Adventure, Simulation;50,000 - 100,000;243;71;172;136;136;3
622470;Road Dogs;Simulation, Sports;50,000 - 100,000;68;67;1;17;17;0
622480;Gus Track Adventures VR;Simulation, Sports;0 - 20,000;10;2;8;0;0;0
622510;Lootfest Wars;Adventure, Indie;0 - 20,000;4;1;3;0;0;0
622540;The Frost;Action, Adventure, Indie;0 - 20,000;8;17;-9;3;3;0
622550;Final Cut: Encore Collector's Edition;Action, Casual, Indie;0 - 20,000;5;0;5;0;0;0
622610;Cult: Fear Inside;Action, Adventure, Simulation;0 - 20,000;7;4;3;0;0;0
622620;Nightmare Adventures: The Turning Thorn;Indie, Audio Production;0 - 20,000;10;4;6;0;0;0
622650;Bendy and the Ink Machine;Action, Adventure, RPG;1,000,000 - 2,000,000;19240;2542;16698;365;59;94
622670;Huusuienbu - Chapter spring and Summer;Action, Indie;0 - 20,000;79;16;63;0;0;1
622680;Mayhem in Single Valley;Action, Indie, Simulation;100,000 - 200,000;219;25;194;0;0;0
622700;War Heroes: Invasion;Sports;0 - 20,000;18;12;6;0;0;0
622720;Weedcraft Inc;Action, Indie;50,000 - 100,000;1092;246;846;802;648;18
622770;Hacktag;Action, Indie, Strategy;20,000 - 50,000;268;119;149;159;254;5
622810;Invasion;Casual, Indie;0 - 20,000;28;1;27;0;0;0
622830;Battle Chess;Action, Casual, Indie;0 - 20,000;53;14;39;0;0;1
622870;Within the blade;Action, Indie, RPG, Simulation, Strategy, Early Access;50,000 - 100,000;291;42;249;283;291;0
622880;Sweven;Violent, Action, Adventure, RPG;0 - 20,000;26;12;14;146;146;0
622890;NecroWorm;Action, Adventure, Indie, RPG, Early Access;20,000 - 50,000;105;106;-1;113;197;0
622910;The trial of witch;Action, Casual;0 - 20,000;29;3;26;0;0;0
622920;P-Walker's Simulation;Adventure, Free to Play, Indie;20,000 - 50,000;32;38;-6;229;237;0
622930;Magic Masks;Action, Strategy;0 - 20,000;5;0;5;0;0;0
622980;TrainClicker Idle Evolution;Action, Adventure, Casual, Indie;0 - 20,000;39;20;19;40161;40161;1
623040;Crystal Vibes feat. Ott.;Action, Adventure, RPG, Early Access;20,000 - 50,000;7;2;5;0;0;0
623050;CyberClub-2077;Action, Adventure, Casual, Indie, Strategy;0 - 20,000;8;4;4;0;0;0
623080;planetarian HD;Design & Illustration;20,000 - 50,000;2068;22;2046;90;95;2
623090;BAJA: Edge of Control HD;Design & Illustration, Utilities;20,000 - 50,000;276;69;207;0;0;9
623160;Zombie Solitaire 2 Chapter 1;Action, Adventure, Indie;0 - 20,000;60;17;43;0;0;1
623160;Zombie Solitaire 2 Chapter 1;Casual, Free to Play, Massively Multiplayer, RPG;0 - 20,000;60;17;43;0;0;1
623170;Zombie Solitaire 2 Chapter 2;Action, Indie;0 - 20,000;44;4;40;0;0;2
623180;Zombie Solitaire 2 Chapter 3;Casual, Indie, Simulation;0 - 20,000;31;5;26;0;0;0
623280;Dungeons & Dragons: Dark Alliance;Education;100,000 - 200,000;2271;2289;-18;1706;1805;29
623310;Arcfall;Adventure, Casual, Indie, Simulation;20,000 - 50,000;192;148;44;11;11;0
623320;Button Button Up!;Action, Casual, Indie, Simulation;0 - 20,000;165;7;158;94;94;0
623340;Stars End;Adventure, Indie;20,000 - 50,000;796;367;429;396;606;15
623360;Grim Tales: The Legacy Collector's Edition;Action, Adventure, Casual, Indie;0 - 20,000;17;6;11;0;0;2
623370;xDrive VR;Casual, Free to Play, Indie, Simulation;0 - 20,000;5;2;3;0;0;0
623380;Cybermotion;Action, Casual;0 - 20,000;60;11;49;0;0;0
623460;Haunted Legends: The Bronze Horseman Collector's Edition;Action, Free to Play, Indie;0 - 20,000;1;2;-1;0;0;1
623470;League of Light: Wicked Harvest Collector's Edition;Animation & Modeling, Education, Software Training, Utilities, Video Production, Early Access;0 - 20,000;5;0;5;0;0;0
623540;Late For Work;Adventure, Indie;0 - 20,000;67;9;58;0;0;0
623550;Timen runner;Action, Indie, RPG, Strategy, Early Access;100,000 - 200,000;59;46;13;287;312;16
623570;PingBall VR;Action, Adventure, Indie;0 - 20,000;11;5;6;0;0;0
623580;POBEDA;Action, Indie;200,000 - 500,000;65;63;2;344;366;493
623640;Mulaka;Action, Adventure, Indie, RPG;0 - 20,000;138;14;124;0;0;0
623670;Moe Mekuri SP;Casual, Indie, Simulation, Sports, Strategy;0 - 20,000;14;5;9;0;0;0
623700;Rec Center Tycoon - Management Simulator;Indie, Simulation, Strategy;20,000 - 50,000;207;34;173;242;242;0
623800;Everything Must Fall;Action, Indie;0 - 20,000;16;1;15;0;0;0
623810;Rabbit Story;Nudity, Action, Casual;20,000 - 50,000;87;31;56;0;0;0
623820;Icesolation;Adventure, Indie, RPG;0 - 20,000;1;5;-4;0;0;0
623840;Ambre - a heartbreaking kinetic novel;Violent, Gore, Action, Adventure, Strategy, Early Access;50,000 - 100,000;459;145;314;0;0;0
623860;Handball Manager - TEAM;Indie, RPG, Strategy;0 - 20,000;10;7;3;0;0;0
623880;World of Speed;Action, Indie, Early Access;20,000 - 50,000;320;203;117;0;0;0
623900;Table Football Pro;Casual, Free to Play, Indie, RPG;0 - 20,000;13;11;2;0;0;0
623920;Chicago 1930 : The Prohibition;RPG;20,000 - 50,000;87;42;45;0;0;0
623930;Solaria Moon;Action, Adventure, Indie, Sports;0 - 20,000;41;23;18;148;148;0
623940;HIVESWAP: ACT 1;Action, Adventure, Casual, Indie, Simulation;200,000 - 500,000;3544;270;3274;279;304;4
623970;Pixvana SPIN Play;Casual;0 - 20,000;2;4;-2;0;0;0
624050;Lazer Cops;Adventure, Strategy;0 - 20,000;13;1;12;0;0;0
624060;Shattered Steel;Adventure, Indie, RPG;50,000 - 100,000;7;2;5;0;0;0
624070;Dragon Wars;Free to Play, Simulation;100,000 - 200,000;11;3;8;0;0;0
624080;Cyberia;Action, Adventure, Indie, RPG, Early Access;100,000 - 200,000;32;0;32;0;0;0
624120;Football Manager Touch 2018;Action, Adventure, Indie, RPG, Early Access;20,000 - 50,000;128;56;72;1087;1612;26
624270;The Painscreek Killings;Casual, Indie, Simulation;200,000 - 500,000;2823;288;2535;1298;1854;26
624320;Loyalty and Blood: Viktor Origins;Action, Adventure, Indie;0 - 20,000;49;9;40;0;0;0
624330;Renamer;Action;0 - 20,000;5;5;0;0;0;0
624410;Prank Bros / 欢乐兄弟;Action, Adventure, Indie, RPG, Simulation, Early Access;0 - 20,000;64;26;38;0;0;0
624430;AI Rebellion VR;Indie, Early Access;0 - 20,000;9;9;0;0;0;0
624460;Fantasynth One;Adventure, Casual, Simulation;50,000 - 100,000;436;16;420;7;9;0
624550;Spiritual Warfare & Wisdom Tree Collection;Action, Adventure, Casual, RPG, Strategy;20,000 - 50,000;27;29;-2;0;0;0
624560;Medusa's Labyrinth VR;Casual, Indie, Simulation, Early Access;0 - 20,000;1;8;-7;0;0;0
624610;RUN;RPG;0 - 20,000;3;2;1;0;0;0
624630;TennisVR;RPG, Strategy;0 - 20,000;2;12;-10;0;0;0
624680;Promethium;Racing, Simulation;0 - 20,000;15;8;7;0;0;0
624690;NEXT JUMP: Shmup Tactics;Action, Adventure, Indie, RPG;50,000 - 100,000;62;17;45;0;0;0
624710;Cow Milking Simulator;Adventure, Casual;0 - 20,000;35;2;33;0;0;0
624780;Cornflower Corbin;Adventure, Indie;0 - 20,000;4;1;3;0;0;0
624830;Battle Summoners VR;Free to Play, Indie, Racing, Sports;0 - 20,000;31;4;27;0;0;0
624870;Preta: Vendetta Rising;Action, RPG;0 - 20,000;37;22;15;0;0;0
624890;Adventure Craft;Casual, Free to Play;20,000 - 50,000;139;27;112;0;0;3
624900;COMET STRIKE;Casual, Indie, Early Access;0 - 20,000;1;0;1;0;0;0
624920;Trapped With the Dolls VR;Action, Casual, Indie, Simulation;20,000 - 50,000;43;11;32;0;0;0
624970;Battlezone: Combat Commander;Adventure, Casual;100,000 - 200,000;633;74;559;448;643;18
624990;The Mimic;Adventure, Casual;0 - 20,000;10;0;10;0;0;0
625000;Knightfall;Action, Indie, Early Access;0 - 20,000;14;1;13;0;0;0
625040;Ophidia;Action;0 - 20,000;14;8;6;0;0;0
625080;FlatOut 4: Total Insanity Workshop Tool;Action, Adventure, Casual, Indie;0 - 20,000;6;7;-1;0;0;0
625100;TileSetGenerator;Adventure, Indie;0 - 20,000;4;0;4;0;0;0
625120;Last Hours Of Jack;Sports;0 - 20,000;30;5;25;0;0;0
625140;Ragnarok Journey;Action, Indie;50,000 - 100,000;118;204;-86;39;40;0
625160;Scrollonoid;Casual, Animation & Modeling, Design & Illustration;0 - 20,000;6;4;2;0;0;0
625180;Elevator VR;Action, Adventure, Indie, RPG, Early Access;0 - 20,000;2;9;-7;0;0;0
625190;Great Pyramid VR;Indie, Simulation, Strategy;0 - 20,000;5;4;1;0;0;0
625220;Building Blocks / Master Builder of Egypt;Action, Indie;0 - 20,000;2;0;2;0;0;0
625320;No Clue VR;Action, Adventure, Free to Play, Indie, Strategy, Early Access;0 - 20,000;15;7;8;0;0;0
625340;XERA: Survival;Casual, Indie;500,000 - 1,000,000;4728;2211;2517;287;91;108
625370;A SECOND BEFORE US;Action, Indie, Early Access;20,000 - 50,000;57;41;16;296;333;0
625410;Anomie;Action, Adventure;0 - 20,000;9;0;9;0;0;0
625430;Doodle God Blitz;RPG;100,000 - 200,000;479;231;248;31;28;9
625460;Assassination ClassroomVR Balloon Challenge Time/暗殺教室VR バルーンチャレンジの時間;Strategy;0 - 20,000;8;2;6;0;0;0
625470;The Red Stare;Strategy;100,000 - 200,000;354;45;309;31;21;2
625480;LIV: VIVR;Strategy;0 - 20,000;15;7;8;42;59;0
625560;The Overdreamer;Strategy;0 - 20,000;13;1;12;0;0;0
625580;The Cleansing - Versus;Strategy;0 - 20,000;7;4;3;0;0;0
625630;Journey of Johann;Strategy;0 - 20,000;5;0;5;0;0;0
625680;Way of the Passive Fist;Strategy;0 - 20,000;158;38;120;224;224;0
625690;归墟纪·寂夜  FINAL WORLD;Strategy;0 - 20,000;5;1;4;0;0;0
625700;Global Soccer: A Management Game 2017;Strategy;0 - 20,000;15;12;3;0;0;0
625730;Cefore;Strategy;0 - 20,000;41;13;28;1;1;0
625740;Rifter;Strategy;0 - 20,000;105;4;101;0;0;1
625770;Smashing The Battle VR;Strategy;0 - 20,000;19;2;17;0;0;0
625780;Magic Wand;Strategy;0 - 20,000;58;3;55;0;0;0
625800;Tomb Guard VR;RPG;0 - 20,000;5;1;4;0;0;0
625820;Bionic Battle Mutants;Strategy;50,000 - 100,000;32;5;27;174;174;0
625830;BattleSky VR;RPG;0 - 20,000;25;3;22;0;0;0
625860;God Awe-full Clicker;Simulation;100,000 - 200,000;241;122;119;0;0;14
625900;Ashes of Kanaka;Free to Play, RPG, Strategy;20,000 - 50,000;4;2;2;0;0;1
625910;Time Recoil;Action, Indie, RPG, Strategy;0 - 20,000;83;23;60;171;303;0
625940;Tomato Jones 2;Action, Indie, RPG;20,000 - 50,000;58;16;42;195;195;19
625960;Stoneshard;Action, Indie, Strategy;1,000,000 - 2,000,000;17617;5577;12040;1177;686;734
625980;Yomawari: Midnight Shadows;Action, Adventure, Indie;20,000 - 50,000;614;32;582;850;850;9
625990;Welcome to Moreytown;Action, Indie;0 - 20,000;36;8;28;0;0;0
626010;Office Space: Idle Profits;Action, Casual, Free to Play, Indie;50,000 - 100,000;200;140;60;50;50;0
626020;Shadows in the Darkness;Casual;0 - 20,000;5;3;2;0;0;0
626130;Dungeons of Tal'Doria;Casual, Indie;0 - 20,000;6;2;4;0;0;0
626160;Awesome Machine;Action, Adventure, Indie, Simulation;0 - 20,000;14;6;8;0;0;0
626170;Apocalypse Night;Indie, Simulation, Sports;0 - 20,000;24;6;18;0;0;0
626200;Dead Alliance;Action, Adventure;20,000 - 50,000;46;81;-35;41;41;0
626250;Consortium: THE TOWER;Casual, Indie, Early Access;0 - 20,000;24;21;3;0;0;0
626500;30th Century Post Office;Casual, Indie;0 - 20,000;0;2;-2;0;0;0
626510;LoveKami -Useless Goddess-;Casual, Indie, Strategy;20,000 - 50,000;302;69;233;229;314;1
626550;Prodigy Tactics;Action, Casual;0 - 20,000;76;123;-47;0;0;0
626570;Microcosm;Adventure, Free to Play, Indie;0 - 20,000;6;0;6;0;0;0
626580;Spellspire;Action, Adventure, Casual, Indie, RPG, Strategy;0 - 20,000;67;26;41;105;121;0
626600;Lost Dimension;Action;20,000 - 50,000;152;37;115;0;0;1
626610;TT Isle of Man: Ride on the Edge;Adventure, Casual, Free to Play, Indie;200,000 - 500,000;872;347;525;246;350;8
626630;Two Worlds II HD - Call of the Tenebrae;Casual, Indie;20,000 - 50,000;29;26;3;297;301;1
626640;Lost Lands: The Wanderer;Adventure, Casual, Indie, RPG;0 - 20,000;70;2;68;0;0;5
626640;Lost Lands: The Wanderer;Indie, RPG;0 - 20,000;70;2;68;0;0;5
626660;Flipping Death;Action, Indie;20,000 - 50,000;173;20;153;0;0;1
626680;Kreedz Climbing;Adventure, Casual, Indie, Strategy;200,000 - 500,000;766;175;591;151;49;2
626690;Sword Art Online: Fatal Bullet;Action, Indie;500,000 - 1,000,000;14143;3589;10554;1664;758;153
626700;Clark | HOOVA VR;Indie;0 - 20,000;15;4;11;0;0;0
626730;The Incredible VR Game Show;;0 - 20,000;5;3;2;0;0;0
626760;VRtender;Simulation;0 - 20,000;4;8;-4;0;0;0
626780;Botanica: Into the Unknown Collector's Edition;Indie, Strategy;0 - 20,000;1;0;1;0;0;0
626840;Shadow Wolf Mysteries: Curse of the Full Moon Collector's Edition;Sexual Content, Nudity, Casual, Indie, Simulation;0 - 20,000;7;0;7;0;0;0
627070;inVokeR;Adventure, Casual, Indie;0 - 20,000;52;11;41;0;0;0
627070;inVokeR;Adventure, Casual, Indie, Simulation, Early Access;0 - 20,000;52;11;41;0;0;0
627220;Food Truck VR;Adventure, Indie;0 - 20,000;14;5;9;0;0;0
627270;Injustice 2;Adventure, Casual, Indie;500,000 - 1,000,000;14300;2262;12038;631;326;999
627350;London Detective Mysteria;Indie, Simulation;0 - 20,000;97;19;78;0;0;1
627410;BlackEye;Adventure, Casual;20,000 - 50,000;46;25;21;200;208;4
627420;Sorgina: A Tale of Witches;Adventure, Casual;0 - 20,000;5;3;2;0;0;0
627450;RUGBY 18;Adventure, Casual;0 - 20,000;52;51;1;0;0;0
627460;THORNYWAY;Action, Adventure, Indie;0 - 20,000;9;9;0;0;0;0
627530;Strata inStudio VR;Adventure, Indie, Simulation;20,000 - 50,000;15;1;14;0;0;0
627570;VentureVerse: Legend of Ulora;Indie;0 - 20,000;12;1;11;0;0;0
627620;Intelligent Design: An Evolutionary Sandbox;Indie, RPG;20,000 - 50,000;64;75;-11;0;0;0
627670;Rocket Wars;Violent, Gore, Indie;50,000 - 100,000;46;4;42;0;0;1
627690;Idle Champions of the Forgotten Realms;Casual, Indie, Simulation;1,000,000 - 2,000,000;9308;2447;6861;2090;88;5169
627820;England Exchange;Action, Indie;20,000 - 50,000;62;50;12;214;214;0
627890;Reventa;Action, Casual, Indie, Strategy;0 - 20,000;45;11;34;0;0;0
627890;Reventa;Indie;0 - 20,000;45;11;34;0;0;0
627910;Bubsy: The Woolies Strike Back;Indie;0 - 20,000;103;77;26;0;0;0
627950;1914: Prelude to Chaos;Action, Casual;50,000 - 100,000;54;61;-7;406;303;0
628020;Romance of the Three Kingdoms VI with Power Up Kit;Audio Production, Utilities;0 - 20,000;13;10;3;0;0;0
628030;Romance of the Three Kingdoms VII with Power Up Kit;Action, Indie;20,000 - 50,000;67;25;42;0;0;18
628050;Romance of the Three Kingdoms IX with Power Up Kit;Action, Adventure, Indie;50,000 - 100,000;310;58;252;19869;39428;52
628060;Romance of the Three Kingdoms X with Power Up Kit;Violent, Action, Adventure, Indie, Massively Multiplayer, Racing, RPG, Simulation, Sports, Strategy;100,000 - 200,000;365;77;288;550;550;36
628070;Romance of the Three Kingdoms XI with Power Up Kit;Adventure;100,000 - 200,000;2290;191;2099;3389;1552;866
628080;Romance of the Three Kingdoms XII with Power Up Kit;Action, Adventure, Indie, RPG;20,000 - 50,000;170;66;104;18818;18818;70
628090;NOBUNAGA'S AMBITION: Haouden with Power Up Kit;Action, Indie;20,000 - 50,000;8;6;2;0;0;7
628100;NOBUNAGA’S AMBITION: Shouseiroku with Power Up Kit;Action, Adventure, Indie, RPG, Simulation, Early Access;0 - 20,000;22;8;14;0;0;58
628110;NOBUNAGA'S AMBITION: Reppuden with Power Up Kit;Adventure, Casual, Indie;0 - 20,000;28;10;18;0;0;73
628120;NOBUNAGA'S AMBITION: Ranseiki with Power Up Kit;Action, Indie, Sports;0 - 20,000;25;12;13;0;0;3
628130;NOBUNAGA'S AMBITION: Soutenroku with Power Up Kit;Casual;20,000 - 50,000;36;21;15;0;0;5
628140;NOBUNAGA'S AMBITION: Tenkasousei with Power Up Kit;Adventure, Indie;20,000 - 50,000;75;32;43;0;0;52
628150;Sangokushi Eiketsuden;Action, Adventure;0 - 20,000;40;11;29;0;0;2
628160;Genghis Khan II: Clan of the Gray Wolf;Action, Adventure, Casual, Indie, RPG, Simulation, Strategy, Early Access;20,000 - 50,000;10;7;3;0;0;0
628170;Uncharted Waters II;Adventure, Casual;0 - 20,000;66;25;41;0;0;13
628180;Winning Post;Casual, Simulation, Early Access;0 - 20,000;7;1;6;0;0;5
628190;決戰亞爾薩/Heroes of Arzar;Indie, Simulation;20,000 - 50,000;41;35;6;0;0;0
628200;The Invisible Hand;Action;100,000 - 200,000;308;67;241;29;29;7
628290;All Walls Must Fall - A Tech-Noir Tactics Game;Action, Indie, Sports, Early Access;20,000 - 50,000;178;70;108;0;0;0
628320;Roah;Casual, Strategy;0 - 20,000;50;17;33;0;0;1
628330;Warlocks 2: God Slayers;Adventure, Indie, RPG;0 - 20,000;38;30;8;0;0;2
628350;Lazaretto;Action, Casual, Indie, Simulation;0 - 20,000;70;21;49;0;0;1
628440;Multiplayer FPS Demo;Action, Casual, Simulation, Sports;100,000 - 200,000;108;92;16;7;7;0
628450;Magnificent Ships: Volume 2;Action, Free to Play, Massively Multiplayer, RPG;0 - 20,000;7;1;6;0;0;0
628460;Lily of the Valley;Free to Play, Massively Multiplayer, Strategy;0 - 20,000;65;5;60;0;0;0
628530;Blobby Tennis;Action, Indie;0 - 20,000;36;13;23;5;5;0
628550;Crypt Stalker;Adventure;0 - 20,000;65;6;59;0;0;0
628550;Crypt Stalker;Adventure, Casual;0 - 20,000;65;6;59;0;0;0
628560;Bebop and Tempo;Indie;0 - 20,000;5;4;1;0;0;0
628570;Trivia Night;Animation & Modeling, Video Production, Early Access;0 - 20,000;26;18;8;226;226;0
628580;Miniballist;Action, Adventure;0 - 20,000;41;16;25;0;0;1
628650;A New World: Kingdoms;Indie, Simulation, Strategy;0 - 20,000;0;9;-9;0;0;0
628660;Lode Runner Legacy;Casual;50,000 - 100,000;114;26;88;0;0;4
628670;Hellpoint;Action, Indie, Early Access;200,000 - 500,000;2787;962;1825;535;496;22
628700;The Flaws of Gravity;Action, Indie;50,000 - 100,000;142;92;50;3;3;0
628710;Hell Warders;Casual;0 - 20,000;80;57;23;225;244;3
628720;GODS Remastered;Education, Software Training;20,000 - 50,000;123;29;94;0;0;2
628730;Adolescent Santa Claus;Adventure;100,000 - 200,000;1020;190;830;1;1;0
628750;aMAZE 2;Casual, Indie;100,000 - 200,000;640;106;534;273;288;0
628760;The Adventurer - Episode 1: Beginning of the End;Action, Indie, Racing;100,000 - 200,000;160;123;37;233;250;1
628770;Tangledeep;Adventure, Casual, Early Access;100,000 - 200,000;1106;210;896;332;432;14
628800;Super Hydorah;Casual;0 - 20,000;167;16;151;0;0;1
628820;ALaLa: Wake Mi Up!;Action, Indie, RPG;0 - 20,000;7;4;3;0;0;0
628830;Ultra Hat Dimension;;0 - 20,000;24;0;24;0;0;0
628890;NOBUNAGA'S AMBITION: Taishi;Adventure, Casual;200,000 - 500,000;434;472;-38;1815;1815;214
628900;Terra Mystica;Adventure, Casual, Indie;20,000 - 50,000;130;91;39;0;0;9
628920;Tomboys Need Love Too!;Design & Illustration, Utilities;0 - 20,000;152;22;130;0;0;0
628940;LIZ: Before the Plague;Violent, Gore, Action, Adventure, Indie;0 - 20,000;3;0;3;0;0;0
628950;Nephise Begins;Casual, Indie, Utilities;50,000 - 100,000;718;426;292;1855;3641;0
628960;Journey to Alien Worlds;Animation & Modeling, Design & Illustration;0 - 20,000;7;1;6;0;0;0
629000;Lydia;Casual;20,000 - 50,000;487;62;425;26;26;0
629030;Employee Recycling Center;Adventure, Casual;100,000 - 200,000;38;92;-54;240;253;0
629040;Skytropolis;Casual;0 - 20,000;27;7;20;0;0;0
629080;Beyond: Light Advent Collector's Edition;Adventure, Casual;0 - 20,000;7;1;6;0;0;0
629090;Horace;Adventure, Casual;50,000 - 100,000;479;117;362;0;0;1
629100;Cadenza: Music, Betrayal and Death Collector's Edition;Adventure, Casual;0 - 20,000;17;0;17;0;0;0
629110;Dark Parables: Ballad of Rapunzel Collector's Edition;Action, Casual, Indie;0 - 20,000;34;1;33;0;0;0
629210;Extra Terrestrial Perception;Action;0 - 20,000;6;11;-5;0;0;0
629220;Rise of Insanity;Action, Adventure, Indie, RPG;50,000 - 100,000;811;216;595;10;10;1
629230;The StoryTale;Indie, Simulation, Strategy;0 - 20,000;58;7;51;0;0;1
629240;Toilet Run;Adventure;0 - 20,000;17;3;14;0;0;0
629340;Possession;Casual, Free to Play, Sports, Strategy;0 - 20,000;14;1;13;0;0;0
629360;The Falling Nights ;Casual, Indie;0 - 20,000;2;4;-2;0;0;0
629380;Cosmic Pioneer;Casual, Indie, Simulation;50,000 - 100,000;17;28;-11;264;257;0
629400;Mall Mayhem;Casual, Indie;0 - 20,000;8;5;3;0;0;0
629410;VectorWave;Action, Adventure;0 - 20,000;25;4;21;0;0;0
629420;Super Perspective;Adventure, Casual, Indie, Early Access;0 - 20,000;30;2;28;0;0;0
629430;The Last Birdling;Action, Indie;0 - 20,000;61;1;60;0;0;3
629440;Graze Counter;Adventure, Early Access;0 - 20,000;250;9;241;273;273;1
629520;Soundpad;Action, Adventure, Indie, RPG;1,000,000 - 2,000,000;48759;1798;46961;10507;4012;18477
629540;Alien Arena: Warriors Of Mars;Violent, Adventure, Indie, Strategy;20,000 - 50,000;116;33;83;241;241;0
629550;Placebo Effect;Casual, Indie, Strategy;0 - 20,000;8;3;5;0;0;0
629550;Placebo Effect;Adventure, Casual, Indie, RPG, Strategy;0 - 20,000;8;3;5;0;0;0
629640;Sea Battle VR;Casual, Indie, Simulation;0 - 20,000;2;7;-5;0;0;0
629650;Symphonic Rain;Action, Casual, Indie, Strategy;20,000 - 50,000;609;21;588;0;0;7
629690;Vaporum;Adventure, Indie;50,000 - 100,000;710;108;602;164;211;3
629720;Fuzecat;Casual, Indie, Simulation;0 - 20,000;14;7;7;0;0;0
629730;Blade and Sorcery;Action, Adventure, Indie, RPG;1,000,000 - 2,000,000;37778;1299;36479;1516;391;1134
629760;MORDHAU;Action, Indie, RPG;5,000,000 - 10,000,000;85408;20225;65183;4160;1016;2269
629770;Tiny Echo;Action, Indie;50,000 - 100,000;525;77;448;509;509;0
629780;WizzBall;Action, Adventure, Casual, Indie;0 - 20,000;10;3;7;0;0;0
629810;Galact Quest;Casual, Indie, Sports;0 - 20,000;8;4;4;0;0;0
629820;Maneater;Indie;200,000 - 500,000;9388;1099;8289;307;252;89
629840;Caligo;Sexual Content, Adventure, Casual, Indie;20,000 - 50,000;692;240;452;85;164;1
629860;Spelunker Party!;Adventure, Indie, RPG, Simulation, Early Access;0 - 20,000;56;4;52;0;0;0
629910;Clicker Heroes 2;RPG;200,000 - 500,000;1514;1162;352;5695;8154;68
629960;夏花的轨迹——A summer promise to forever;Action, Indie, Early Access;20,000 - 50,000;230;72;158;307;307;0
629970;Beast Pets;Indie, Strategy;0 - 20,000;20;1;19;0;0;0
630020;The First Class VR;RPG;;;;0;;;
630030;War Tech Fighters;Casual, Indie;50,000 - 100,000;243;70;173;333;358;0
630040;JackHammer: Demolition Dodgeball;Software Training, Early Access;0 - 20,000;0;0;0;4;4;0
630050;Dead Exit;Audio Production;0 - 20,000;22;9;13;0;0;0
630060;Consummate:Missing World 寇莎梅特：困世迷情;Action, Adventure, Casual, Indie, RPG, Strategy;20,000 - 50,000;946;45;901;175;223;1
630070;Tengutana;Sexual Content, Adventure, Casual;0 - 20,000;15;4;11;0;0;0
630080;EggTime 2;Utilities, Video Production;0 - 20,000;18;2;16;0;0;0
630100;SoulWorker - Anime Action MMO;Sexual Content, Nudity, Adventure, Indie;2,000,000 - 5,000,000;11548;2973;8575;4498;165;2
630140;Sky Clash: Lords of Clans 3D;Casual;20,000 - 50,000;152;42;110;0;0;30
630160;Super Rocket Shootout;Casual;0 - 20,000;18;6;12;0;0;0
630170;Murder In Tehran's Alleys 1933;Action, Indie, Early Access;0 - 20,000;6;9;-3;0;0;0
630240;Nevertales: Smoke and Mirrors Collector's Edition;Adventure, Casual, Indie;0 - 20,000;4;1;3;0;0;0
630260;Tilted Mind;RPG;0 - 20,000;8;0;8;0;0;0
630280;StageX;Adventure, Indie, Simulation;0 - 20,000;10;2;8;0;0;0
630310;The Mummy Demastered;Action, Free to Play, Indie, RPG, Early Access;20,000 - 50,000;449;112;337;657;657;3
630360;Megacity Builder;Racing;0 - 20,000;7;14;-7;0;0;0
630390;Safari Venture;Action, Indie;0 - 20,000;6;3;3;0;0;0
630460;Fist's Elimination Tower;Action;0 - 20,000;38;2;36;0;0;0
630470;Solitaire Club;Casual, Indie, Education;0 - 20,000;12;5;7;0;0;0
630490;Storm Area 51: September 20th 2019;Casual, Free to Play, Indie, Simulation;0 - 20,000;23;33;-10;0;0;0
630510;PsychLabVR;Casual, Indie;0 - 20,000;5;1;4;0;0;0
630610;Disneyland Adventures;Action, Adventure, Indie;50,000 - 100,000;459;50;409;2489;2489;11
630630;Apex;Adventure, Indie, Racing;0 - 20,000;33;11;22;8;8;0
630640;SEQUENCE STORM;Action, Indie;0 - 20,000;135;6;129;0;0;1
630670;Call of the Ocean;Action, Indie;0 - 20,000;3;4;-1;0;0;0
630690;Interplay Solitaire;Action, Indie, Strategy;0 - 20,000;6;10;-4;0;0;0
630720;Mana Spark;Photo Editing, Utilities, Video Production;20,000 - 50,000;462;116;346;327;449;3
630790;PSYCHO-PASS;Adventure, Indie, RPG;0 - 20,000;0;0;0;0;0;1
630830;The Legacy: Forgotten Gates;Adventure, Indie, RPG;0 - 20,000;76;6;70;0;0;3
630870;Chuusotsu! 1st Graduation: Time After Time;Strategy;0 - 20,000;56;4;52;0;0;0
630900;Illwinter's Floorplan Generator;Action, Adventure;50,000 - 100,000;381;30;351;0;0;10
631120;RAYBEEM - Live in Your Music;Action, Indie, Strategy;0 - 20,000;6;0;6;0;0;0
631130;Strata Design 3D SE;Action, Adventure, RPG;0 - 20,000;14;2;12;0;0;0
631220;Puzzle Showdown 4K;Action, Adventure, Indie, RPG;0 - 20,000;3;5;-2;0;0;0
631240;Haunted Train: Spirits of Charon Collector's Edition;Action, Adventure, Indie, Early Access;0 - 20,000;1;2;-1;0;0;0
631250;Double Clue: Solitaire Stories;Simulation, Early Access;0 - 20,000;3;2;1;0;0;0
631260;PuppetShow: Souls of the Innocent Collector's Edition;Action, Free to Play, Indie, Early Access;0 - 20,000;7;0;7;0;0;0
631270;Haunted Hotel II: Believe the Lies;Action, Adventure, Indie, RPG;0 - 20,000;5;7;-2;0;0;0
631280;Redemption Cemetery: The Island of the Lost Collector's Edition;Adventure, Indie;0 - 20,000;0;0;0;0;0;0
631490;Son of Scoregasm;Action, Strategy;0 - 20,000;26;4;22;0;0;0
631510;Devil May Cry HD Collection;Adventure, Casual, Indie, RPG, Simulation;500,000 - 1,000,000;6976;659;6317;827;374;323
631540;Community Inc;Adventure, Casual, Indie;20,000 - 50,000;79;111;-32;0;0;0
631570;Whispers of a Machine;Strategy;200,000 - 500,000;1411;96;1315;220;304;3
631660;Immersion Chess;Action, Adventure, Indie, Simulation;50,000 - 100,000;80;40;40;15;15;0
631770;Pixplode;Casual, Indie;20,000 - 50,000;94;38;56;59;59;0
631810;Galactic Gallery;Action, Adventure, Indie;0 - 20,000;22;3;19;0;0;0
631830;Sarcophag;Action, Adventure, Indie, Early Access;50,000 - 100,000;168;70;98;209;223;1
631900;Airtone;Action, Casual, Indie;0 - 20,000;199;11;188;0;0;0
631920;Somewhere on Zibylon;Action, Indie, Simulation;0 - 20,000;20;8;12;190;190;0
631950;Caelum: Into the Sky;Action, Racing;0 - 20,000;0;2;-2;0;0;0
631980;Immortal Planet;Action, Indie, RPG;100,000 - 200,000;230;125;105;0;0;0
631990;Remember, Remember;Casual, Indie, Simulation;0 - 20,000;26;12;14;0;0;0
632000;CrossCells;Adventure, Indie, Strategy;100,000 - 200,000;565;97;468;119;200;2
632020;Necromancer Returns;Adventure, Indie;0 - 20,000;76;28;48;0;0;0
632020;Necromancer Returns;Violent, Gore, Action, Adventure, Indie, RPG;0 - 20,000;76;28;48;0;0;0
632040;VR Sand;Massively Multiplayer, Racing, Simulation, Sports;0 - 20,000;9;0;9;0;0;0
632050;The Village;Action, Adventure, Indie, RPG, Strategy;200,000 - 500,000;56;52;4;243;245;6
632070;The Fidelio Incident;Violent, Gore, Action, Casual, Sports;50,000 - 100,000;641;183;458;144;172;0
632080;Kinese;Adventure, Indie;0 - 20,000;10;1;9;0;0;0
632100;The Last Sigil;Action, Adventure, Indie;0 - 20,000;22;13;9;0;0;0
632110;Crimson Keep;Adventure, Casual, Indie;0 - 20,000;12;8;4;0;0;0
632110;Crimson Keep;Action, Simulation;0 - 20,000;12;8;4;0;0;0
632130;Set 'N Det;Adventure, Casual;0 - 20,000;1;0;1;0;0;0
632170;Spartan Fist;Action;0 - 20,000;29;17;12;0;0;1
632200;Kuro survival;Action, Indie;50,000 - 100,000;35;17;18;25;25;0
632240;Gunball;Gore, Adventure, Casual, Indie;0 - 20,000;2;0;2;0;0;0
632250;DERU - The Art of Cooperation;Action, RPG;0 - 20,000;44;7;37;0;0;3
632290;The Grand Ball;Adventure, Casual, Indie;0 - 20,000;19;8;11;0;0;0
632300;Hobo: Tough Life;Adventure, Indie, RPG;200,000 - 500,000;5443;1106;4337;1642;436;191
632350;Cyberdimension Neptunia: 4 Goddesses Online;Adventure, Indie;500,000 - 1,000,000;3983;576;3407;526;400;19
632360;Risk of Rain 2;Casual, Indie;5,000,000 - 10,000,000;219425;8652;210773;2917;1394;9801
632380;Bionic Attack;Action, Adventure, Indie;0 - 20,000;3;2;1;0;0;0
632470;Disco Elysium - The Final Cut;Action, Indie, Sports;1,000,000 - 2,000,000;67938;4384;63554;1013;393;1564
632510;Blockle;Adventure, Casual, Simulation;0 - 20,000;50;22;28;0;0;0
632520;WiseMind;Action, Indie;0 - 20,000;11;4;7;0;0;0
632590;The Tale of Doris and the Dragon - Episode 2;Casual;20,000 - 50,000;31;1;30;0;0;0
632620;Tombé Drums VR;Casual;0 - 20,000;4;8;-4;0;0;0
632710;Princess Evangile W Happiness - Steam Edition;Casual;0 - 20,000;56;3;53;139;139;0
632750;StarPlayerVR;Adventure, Free to Play, Indie, Massively Multiplayer;0 - 20,000;11;5;6;0;0;0
632800;Beyond Eden;Casual;0 - 20,000;70;9;61;0;0;0
632820;Ricky Raccoon;Violent, Action, Adventure, Indie;0 - 20,000;15;2;13;0;0;0
632830;Aztec Venture;Action, Indie, RPG;0 - 20,000;12;5;7;0;0;0
632830;Aztec Venture;Action, Adventure, Casual, Indie;0 - 20,000;12;5;7;0;0;0
632840;CYBER VR;Adventure, Casual, Indie;0 - 20,000;14;11;3;0;0;0
632880;The Majesty of Colors Remastered;Casual, Indie, Strategy;0 - 20,000;44;1;43;0;0;0
632900;Serment - Contract with a Devil;Adventure, Indie, Strategy;0 - 20,000;59;14;45;0;0;1
633060;Orwell: Ignorance is Strength;Adventure, Indie;200,000 - 500,000;1138;336;802;259;265;5
633080;Relic Hunters Legend;RPG, Strategy;0 - 20,000;0;0;0;12;12;0
633110;FAST BEAT LOOP RACER GT | 環狀賽車GT;Action, Adventure, Indie;50,000 - 100,000;369;183;186;73;73;0
633130;Nongünz;RPG;20,000 - 50,000;251;164;87;71;136;0
633150;Mythlink;Indie, RPG, Strategy;0 - 20,000;10;0;10;0;0;0
633230;NARUTO TO BORUTO: SHINOBI STRIKER;Adventure, Casual, Indie;1,000,000 - 2,000,000;43921;7443;36478;946;379;686
633300;GlobalMap Astro;Action;0 - 20,000;5;4;1;0;0;0
633320;Spirit Realm;Action, Casual, Indie;0 - 20,000;21;10;11;1;1;0
633360;Remothered: Tormented Fathers;Simulation, Sports;50,000 - 100,000;1399;467;932;108;134;6
633430;Trail of Destruction;Indie;0 - 20,000;3;0;3;0;0;0
633440;Unit 4;Action, Indie, Early Access;20,000 - 50,000;26;33;-7;114;114;0
633460;Tannenberg;Action, Adventure, Indie, Early Access;200,000 - 500,000;7531;1193;6338;256;254;73
633490;MovingPictures: VR Video and Image Viewer;Adventure, Indie;0 - 20,000;1;2;-1;0;0;0
633580;Neighbourhood Necromancer;Free to Play, RPG, Strategy;0 - 20,000;14;7;7;0;0;0
633580;Neighbourhood Necromancer;RPG;0 - 20,000;14;7;7;0;0;0
633600;Creatures Such as We;Violent, Gore, Action, Free to Play, Indie;0 - 20,000;29;2;27;0;0;0
633930;Yeah Jam Fury: U, Me, Everybody!;Casual, Simulation;0 - 20,000;28;0;28;0;0;0
633940;Vision Origin;Action, Simulation, Strategy, Early Access;0 - 20,000;12;9;3;0;0;0
633950;Fall of Light: Darkest Edition;Action, Indie, Sports, Early Access;50,000 - 100,000;167;134;33;298;298;0
633970;Heroes Never Die;Adventure, Casual, Indie;0 - 20,000;3;12;-9;0;0;0
634060;ObserVRtarium;Adventure, Indie;0 - 20,000;11;2;9;0;0;0
634070;Murnatan;Indie, Simulation;50,000 - 100,000;69;41;28;6;6;0
634090;Suncore Chronicles: The Tower;Action, Casual, Indie;0 - 20,000;17;15;2;0;0;0
634090;Suncore Chronicles: The Tower;Adventure, Casual, Free to Play, Simulation;0 - 20,000;17;15;2;0;0;0
634120;Inmates;Action, Indie;20,000 - 50,000;160;115;45;0;0;0
634150;ReSizE;Action, Adventure, Indie;0 - 20,000;4;6;-2;0;0;0
634160;Cattails | Become a Cat!;Action, Simulation, Early Access;100,000 - 200,000;2124;89;2035;26;26;42
634180;Darkarta: A Broken Heart's Quest Standard Edition;Gore, Action, Indie, Racing, Early Access;0 - 20,000;62;17;45;0;0;2
634180;Darkarta: A Broken Heart's Quest Standard Edition;Adventure, Casual;0 - 20,000;62;17;45;0;0;2
634200;Tanks vs Aliens;Gore, Adventure, Indie, Simulation;0 - 20,000;26;6;20;361;397;0
634230;Project First Contact;Action, Adventure, Strategy;0 - 20,000;92;93;-1;259;279;1
634340;Legend of Himari;Action, Adventure;50,000 - 100,000;305;40;265;249;261;81
634410;A Story Beside;Action, Casual, Indie;0 - 20,000;197;4;193;0;0;9
634700;PLUTONIUM;Casual, Indie, Strategy;20,000 - 50,000;95;114;-19;0;0;0
635040;Freeze Climbing;Action, Indie;0 - 20,000;8;4;4;0;0;0
635050;DESPOILER;Action, Indie;0 - 20,000;8;7;1;0;0;0
635060;Castle of no Escape;Action, Adventure, Indie, RPG;20,000 - 50,000;75;44;31;212;237;0
635190;Puppy Doge VR;RPG;0 - 20,000;4;5;-1;0;0;0
635200;Distrust: Polar Survival;Action, RPG;200,000 - 500,000;1574;583;991;183;183;9
635220;The Naked Game;Adventure, Free to Play, Indie, RPG;0 - 20,000;20;10;10;14;14;0
635250;Evil Genome 光明重影;Indie;50,000 - 100,000;352;155;197;0;0;1
635260;CarX Drift Racing Online;Casual;1,000,000 - 2,000,000;55408;2650;52758;2341;815;3489
635270;Through The Dark: Prologue;Action, Adventure, Indie;0 - 20,000;1;1;0;0;0;0
635310;Ski Sniper;Casual, Indie, Simulation, Strategy;20,000 - 50,000;200;36;164;95;95;0
635320;Last Day of June;Casual, Indie, Simulation, Strategy;100,000 - 200,000;3380;507;2873;338;519;5
635390;Thief of Thieves;Casual, Indie, Simulation, Strategy;20,000 - 50,000;112;35;77;161;161;0
635410;The Adventurer and His Backpack;Simulation;0 - 20,000;55;17;38;0;0;0
635430;Blue Angels Aerobatic Flight Simulator;Casual, Indie, Simulation, Sports;0 - 20,000;8;3;5;0;0;0
635520;Phantasmat: The Endless Night Collector's Edition;Massively Multiplayer, Strategy;0 - 20,000;11;3;8;0;0;0
635550;Nocturnal Hunt;Adventure, Indie, RPG, Strategy, Early Access;0 - 20,000;47;12;35;0;0;0
635590;Vulture Strike;Action, Indie, Simulation, Strategy;0 - 20,000;6;2;4;0;0;0
635670;EMPORIUM;Casual, Free to Play, Simulation;0 - 20,000;92;41;51;18;18;0
635730;Dragonia;Sexual Content, RPG;200,000 - 500,000;4868;902;3966;154;140;5
635790;How to Fool a Liar King;Indie, Simulation, Strategy;0 - 20,000;36;5;31;0;0;0
635830;Demon Mark: A Russian Saga;Adventure, Casual;0 - 20,000;4;3;1;0;0;0
635850;Sentience: The Android's Tale;Adventure, Casual;100,000 - 200,000;105;12;93;208;325;3
635880;Chicken Labyrinth Puzzles;Education;100,000 - 200,000;130;60;70;209;211;0
635900;Tunnels of Despair;Action, Indie;0 - 20,000;44;21;23;69;69;0
635930;DOGO;Software Training;0 - 20,000;3;0;3;0;0;0
635940;Little Busters! English Edition;RPG;0 - 20,000;680;9;671;0;0;11
635980;Break The Food Chain;Adventure, Casual, Indie, Strategy;0 - 20,000;6;0;6;0;0;0
636010;Chateau Garden;Action, Adventure, Indie;0 - 20,000;7;6;1;0;0;0
636020;India Garden;Adventure, Casual, Indie, RPG, Strategy;0 - 20,000;6;3;3;0;0;0
636030;Ricky Raccoon 2 - Adventures in Egypt;Action, Indie;0 - 20,000;14;5;9;0;0;0
636030;Ricky Raccoon 2 - Adventures in Egypt;Action, Adventure, Indie, RPG, Early Access;0 - 20,000;14;5;9;0;0;0
636040;Pixel Worlds: MMO Sandbox;Action, Adventure, Indie, Simulation, Early Access;500,000 - 1,000,000;4043;1350;2693;1161;56;296
636050;5 Star Rio Resort;Strategy;0 - 20,000;21;8;13;0;0;0
636100;Tesla vs Lovecraft;Casual, Free to Play, Massively Multiplayer, Education;100,000 - 200,000;978;107;871;380;380;6
636150;Cyberhunt;Nudity, Adventure;200,000 - 500,000;1174;230;944;294;282;8
636170;Reaching for Petals;Action, Adventure, RPG;0 - 20,000;107;40;67;0;0;0
636220;CubeWorks;Adventure, Simulation;0 - 20,000;19;0;19;0;0;0
636230;Safe House;Adventure;0 - 20,000;13;20;-7;0;0;0
636310;Concurrency;Casual, Animation & Modeling, Video Production;0 - 20,000;14;6;8;232;232;0
636320;Depth of Extinction;Action, Indie, Racing, Sports, Early Access;20,000 - 50,000;144;50;94;392;392;3
636330;The God Paradox;Casual, Indie, Strategy, Early Access;0 - 20,000;21;14;7;0;0;0
636330;The God Paradox;Adventure, Indie, Early Access;0 - 20,000;21;14;7;0;0;0
636360;Silent Gentlemen;Violent, Action, Adventure, Casual, Indie, Simulation;20,000 - 50,000;4;4;0;0;0;0
636370;The Sun Never Sets;Action, Adventure, Casual, Indie, Simulation, Strategy, Early Access;20,000 - 50,000;17;8;9;288;293;1
636390;Ticket to Earth;Indie, RPG, Simulation, Sports, Strategy;0 - 20,000;92;9;83;0;0;1
636400;CUBOTS The Origins;Indie;20,000 - 50,000;34;14;20;291;339;0
636430;Zombie Kill;Software Training;0 - 20,000;3;2;1;0;0;0
636460;Rugby League Team Manager 2018;Action, Casual, Indie;0 - 20,000;36;11;25;0;0;2
636480;Ravenfield;Action, Adventure, Casual, Indie, RPG, Strategy;1,000,000 - 2,000,000;55178;1687;53491;1466;964;1117
636490;Ka Mate;Action, Adventure, Indie, RPG;0 - 20,000;14;21;-7;0;0;0
636520;Gevaudan;Adventure;0 - 20,000;81;56;25;0;0;0
636560;Runewards: Strategy Card Game;Indie;20,000 - 50,000;32;27;5;1;1;1
636570;Nights of Azure 2: Bride of the New Moon;Action, Casual, Free to Play, Indie;0 - 20,000;249;79;170;207;207;0
636580;Primal Reign;Violent, Gore, Action, Indie;50,000 - 100,000;37;15;22;0;0;0
636590;VR SUSHI BAR;Violent, Adventure;0 - 20,000;6;5;1;0;0;0
636620;Tanks VR;Indie;0 - 20,000;17;9;8;0;0;0
636720;Bring to Light;Action, Casual, Indie;20,000 - 50,000;26;11;15;0;0;0
636740;Akihabara - Feel the Rhythm Remixed;Action, Casual, Indie;0 - 20,000;7;3;4;0;0;0
636910;Geoid;Casual, Indie, Simulation, Strategy, Early Access;0 - 20,000;9;1;8;0;0;0
636930;Soundscape VR;Casual, Indie;20,000 - 50,000;70;31;39;17;17;0
636950;MarksmanVR;Simulation;0 - 20,000;16;3;13;0;0;0
636970;Tales Of Glory;Violent, Gore, Action, Adventure, Indie;0 - 20,000;695;162;533;0;0;7
637040;RoadkillerZ;Adventure, Indie;0 - 20,000;4;12;-8;0;0;0
637050;Spire of Sorcery;Action, Adventure, Indie;20,000 - 50,000;64;48;16;0;0;1
637060;Tiny Tales: Heart of the Forest;Adventure, Free to Play, Indie, RPG, Early Access;20,000 - 50,000;150;43;107;169;169;5
637070;End of the Road VR;Adventure, Casual, Indie, RPG;0 - 20,000;3;3;0;0;0;1
637090;BATTLETECH;Action, Adventure, Casual, Indie, Early Access;1,000,000 - 2,000,000;22878;4703;18175;7274;2655;2749
637100;Sonic Forces;Action, Casual, Indie;200,000 - 500,000;3984;2546;1438;241;323;32
637110;Runes of Avalon - Path of Magic;Action, Adventure, Early Access;0 - 20,000;2;0;2;0;0;0
637120;Space God;Violent, Gore, Action, Casual, Indie, Early Access;0 - 20,000;16;2;14;0;0;0
637310;Stream Service;Action, Indie, Early Access;100,000 - 200,000;30;35;-5;0;0;0
637330;Stack;Action, Indie;50,000 - 100,000;20;11;9;167;247;38
637340;Solar Core;Action, Adventure, Indie, RPG;0 - 20,000;0;0;0;0;0;0
637410;Disputed Space;Action;20,000 - 50,000;60;34;26;0;0;1
637640;The Glade;Action, Indie, Early Access;0 - 20,000;3;2;1;0;0;0
637650;FINAL FANTASY XV WINDOWS EDITION;Adventure, Indie, Early Access;1,000,000 - 2,000,000;36723;7709;29014;1735;724;602
637670;Secret of Mana;Animation & Modeling, Design & Illustration, Utilities;200,000 - 500,000;1618;693;925;450;450;17
637850;Confess My Love;Action;200,000 - 500,000;4102;287;3815;83;97;5
637860;斩毒：黑与白（Narcotics Police:Black and White）;Action, Indie, Simulation;0 - 20,000;95;63;32;0;0;0
637870;Slice&Dice;RPG;0 - 20,000;5;1;4;0;0;0
637880;I wanna be The Cat;Indie, Strategy;0 - 20,000;149;11;138;315;315;0
637920;Weather Lord;Action, Indie;0 - 20,000;5;3;2;0;0;0
637930;Weather Lord: Hidden Realm;Action, Indie;0 - 20,000;2;1;1;0;0;0
637940;Weather Lord: In Search of the Shaman;Action, Casual, Indie;0 - 20,000;4;2;2;0;0;1
637960;ProjectM : Dream;Adventure;20,000 - 50,000;65;12;53;0;0;0
638000;When Ski Lifts Go Wrong;Casual;20,000 - 50,000;620;89;531;302;157;4
638020;Castle Wars VR;Racing;0 - 20,000;12;9;3;0;0;0
638060;Majestic Trials;Casual, Indie, Simulation;50,000 - 100,000;9;1;8;0;0;0
638070;Murderous Pursuits;Action, Casual, Indie, Simulation, Strategy;1,000,000 - 2,000,000;1763;1012;751;1030;303;3
638110;Desert Bus VR;Action, Racing, Simulation, Sports;100,000 - 200,000;1393;186;1207;54;20;0
638130;Sweet Surrender VR;Action, Casual, Indie, Strategy;0 - 20,000;79;14;65;0;0;2
638160;Moero Chronicle;Casual, Indie, Strategy;50,000 - 100,000;398;174;224;674;708;3
638200;Capitalism 2;Action, Casual, Indie, Racing;20,000 - 50,000;339;72;267;21;21;5
638230;Journey;Indie, RPG, Early Access;500,000 - 1,000,000;22842;1285;21557;144;124;52
638240;Calavera: Day of the Dead Collector's Edition;Action, Casual, Indie, Sports, Early Access;0 - 20,000;2;3;-1;0;0;0
638250;Sea of Lies: Nemesis Collector's Edition;Action, Adventure, Indie;0 - 20,000;2;0;2;0;0;1
638260;Myths of the World: Stolen Spring Collector's Edition;Indie, Simulation, Strategy;0 - 20,000;3;2;1;0;0;0
638270;Rite of Passage: Child of the Forest Collector's Edition;Action, Adventure, Casual;0 - 20,000;4;2;2;0;0;0
638290;Grim Facade: Sinister Obsession Collector’s Edition;Casual, Simulation;0 - 20,000;3;1;2;0;0;0
638310;Family Tree Heritage Platinum 15 – Windows;Sexual Content, Casual, Indie, Simulation;0 - 20,000;2;1;1;0;0;0
638470;Eggggg - The platform puker;Action, Adventure, Casual, Indie, Simulation, Sports;0 - 20,000;9;2;7;0;0;0
638490;Soldat;Casual, Indie, Sports;200,000 - 500,000;1523;85;1438;46;56;12
638610;Professor Teaches Business Planning;Casual, Free to Play, Indie, Simulation, Early Access;0 - 20,000;2;1;1;0;0;0
638650;Sword Art Online Re: Hollow Fragment;Casual;100,000 - 200,000;1455;372;1083;302;141;21
638720;Final Battle;Casual, Indie, Strategy;0 - 20,000;37;10;27;0;0;0
638740;The Seeker;Violent, Indie;0 - 20,000;2;4;-2;0;0;0
638780;Reflector: Bug Hunt;Action;0 - 20,000;4;0;4;0;0;0
638830;VR Scape;Action, Indie;0 - 20,000;3;3;0;0;0;0
638850;Animallica;Casual, Indie;0 - 20,000;611;236;375;218;218;7
638850;Animallica;Casual, Indie;0 - 20,000;611;236;375;218;218;7
638900;Defenders of the Realm VR;Simulation;0 - 20,000;5;0;5;0;0;0
638920;BeanVR—The Social VR APP;Action, Adventure, Casual, Strategy, Early Access;50,000 - 100,000;21;27;-6;4;4;0
638930;Dal Segno;Action, Adventure, Casual, Indie, Simulation;0 - 20,000;112;12;100;0;0;1
638970;Yakuza 0;Violent, Action;1,000,000 - 2,000,000;54583;2694;51889;2123;962;1253
638990;UNDYING;Indie, Racing, Simulation, Early Access;100,000 - 200,000;727;105;622;121;121;9
639130;Ultrawings;Indie, Simulation, Audio Production, Early Access;0 - 20,000;351;43;308;395;470;0
639180;Time, Space and Matter;Sexual Content, Nudity, Violent, Action, Adventure, Indie;0 - 20,000;6;3;3;0;0;0
639190;Sankhara;Adventure, Casual, Simulation, Design & Illustration;0 - 20,000;10;6;4;1;1;0
639220;Throttle Powah VR;Adventure, Indie;0 - 20,000;38;10;28;7;7;0
639230;Rival Books of Aster;Action, Indie;20,000 - 50,000;37;15;22;0;0;0
639240;CodeRed: Agent Sarah's Story - Day one;Free to Play, Indie;0 - 20,000;6;3;3;0;0;0
639270;Operation Warcade VR;;0 - 20,000;278;13;265;0;0;1
639280;Lander 8009 VR;Sports;0 - 20,000;9;3;6;0;0;0
639300;Age of Gladiators II: Death League;Action, Casual, Indie, Strategy;0 - 20,000;59;28;31;0;0;0
639320;Fading;Action;0 - 20,000;6;1;5;0;0;0
639370;Professor Teaches Accounting Fundamentals;Action;0 - 20,000;7;0;7;0;0;0
639460;Zombie Riot;Gore, Casual, Indie, Simulation;20,000 - 50,000;59;19;40;20;20;0
639470;Original Journey;Adventure, Casual, Indie, RPG, Simulation, Early Access;50,000 - 100,000;135;49;86;0;0;0
639490;Umineko When They Cry - Answer Arcs;Adventure, Indie, Simulation;20,000 - 50,000;755;35;720;11629;11629;31
639560;Spacescape;Action, Indie, Early Access;20,000 - 50,000;50;12;38;0;0;0
639650;1982;Adventure, Indie;50,000 - 100,000;707;48;659;16;21;2
639720;A Bloody Night;Action, Adventure, Indie;0 - 20,000;74;16;58;283;283;0
639730;Murder In Tehran's Alleys 2016;Indie, Sports;0 - 20,000;8;6;2;0;0;0
639770;UNTITLED;Indie, RPG, Strategy;0 - 20,000;36;3;33;0;0;0
639780;Deep Space Waifu: FLAT JUSTICE;Adventure, RPG, Early Access;50,000 - 100,000;1449;67;1382;124;150;1
639790;DEEP SPACE WAIFU;Simulation;200,000 - 500,000;7222;252;6970;135;143;7
639840;FIELD BREAKING;Indie, Strategy;0 - 20,000;20;17;3;1;1;0
639920;Escape The Gray;Action, Adventure, Indie;0 - 20,000;1;4;-3;0;0;0
639960;OzGrind Virtual Reality Showroom;Free to Play, Indie, RPG, Strategy;0 - 20,000;7;1;6;0;0;0
640050;Soldiers of the Universe;Casual, Indie, Racing, Sports, Early Access;50,000 - 100,000;204;242;-38;6;6;0
640080;Vrifier;Casual, Indie;0 - 20,000;7;0;7;0;0;0
640090;Zarya-1: Mystery on the Moon;Adventure, Casual, Indie;0 - 20,000;86;7;79;0;0;1
640120;Youropa;Action, Adventure, Indie, Massively Multiplayer, Simulation;100,000 - 200,000;491;71;420;37;37;0
640150;Tale of Toast;Action, Adventure;200,000 - 500,000;390;362;28;19;19;2
640210;Just One Line;Indie;0 - 20,000;80;33;47;105;105;1
640250;Kitty Hawk;Action, Adventure;0 - 20,000;6;1;5;0;0;0
640290;Super Multitasking;Action, Adventure, Indie;0 - 20,000;26;1;25;0;0;0
640300;Run Of Mydan;Adventure, Casual, Indie;0 - 20,000;61;20;41;0;0;0
640310;Drive-By Hero;Action, Adventure, Early Access;50,000 - 100,000;119;118;1;87;87;0
640340;Serious Sam: Tormental;Action, Adventure, Indie;0 - 20,000;163;37;126;0;0;1
640380;UBERMOSH Vol.5;Violent, Gore, Action, Indie;20,000 - 50,000;293;18;275;3;3;0
640590;The LEGO NINJAGO Movie Video Game;Action, Adventure, Indie;1,000,000 - 2,000,000;4858;798;4060;352;55;76
640600;Bleeding Kansas;Strategy;0 - 20,000;0;3;-3;0;0;0
640690;Super Tony Land;Casual, Indie, Simulation;0 - 20,000;10;4;6;0;0;0
640700;Narvas;Action, Indie;0 - 20,000;18;3;15;0;0;0
640720;CAD XR;Violent, Gore, Action, Adventure, Indie, RPG;0 - 20,000;1;3;-2;0;0;0
640760;Code51:Mecha Arena;Action, Indie;0 - 20,000;24;9;15;0;0;0
640820;Pathfinder: Kingmaker - Enhanced Plus Edition;Adventure;1,000,000 - 2,000,000;22966;6314;16652;2673;1242;1746
640850;AZORIAN KINGS;Adventure, Casual, Indie, RPG, Simulation, Strategy;0 - 20,000;89;44;45;0;0;0
640860;Stone Rage;Adventure, Indie, RPG;0 - 20,000;87;75;12;0;0;0
640880;Hyper Sentinel;Adventure, Indie, RPG;0 - 20,000;47;7;40;0;0;0
640890;Will Glow the Wisp;Action, Indie;50,000 - 100,000;204;33;171;2;2;1
640970;In Game Adventure: Legend of Monsters;Action, Casual, Indie, Simulation, Sports, Early Access;0 - 20,000;93;30;63;0;0;0
640990;Fashioning Little Miss Lonesome;Action;20,000 - 50,000;257;51;206;0;0;3
641050;StroodleDoodle;Indie, Simulation;0 - 20,000;2;0;2;0;0;0
641080;Trials Rising;Violent, Action, Simulation, Early Access;200,000 - 500,000;1498;796;702;552;541;42
641320;Cooking Simulator;Adventure, Casual, Simulation;500,000 - 1,000,000;12914;2410;10504;466;381;278
641590;Perplexigon;Simulation;0 - 20,000;3;1;2;0;0;0
641780;The Drone Racing League Simulator;Action, Adventure, Indie, Sports;200,000 - 500,000;2703;500;2203;170;99;91
641860;Trenches of War;Simulation, Sports;0 - 20,000;55;6;49;0;0;0
641860;Trenches of War;Action, Adventure, Indie;0 - 20,000;55;6;49;0;0;0
641870;symeCu8e;Strategy, Early Access;0 - 20,000;1;6;-5;0;0;0
641910;Bike Rush;Casual, Indie;0 - 20,000;32;36;-4;1;1;0
641910;Bike Rush;Indie;0 - 20,000;32;36;-4;1;1;0
641950;Last Stonelord;Action, Indie;0 - 20,000;15;7;8;0;0;0
641960;BOXVR;Free to Play, Simulation, Sports;200,000 - 500,000;1261;322;939;11;11;6
641980;Block Survival: Legend of the Lost Islands;Adventure;0 - 20,000;64;12;52;756;756;0
641990;The Escapists 2;Adventure, Indie;2,000,000 - 5,000,000;23246;2490;20756;496;337;320
642000;Regenesis Arcade Lite;Violent, Gore, Action, Adventure;50,000 - 100,000;30;14;16;0;0;0
642070;VR Theme Park Rides;Simulation;0 - 20,000;12;18;-6;0;0;1
642090;Coming Out on Top;Casual, Indie;20,000 - 50,000;1116;50;1066;2703;2703;8
642170;Legendary Hunter VR;Action, Indie, RPG;0 - 20,000;41;14;27;0;0;0
642190;Beer Pong League;Adventure, Casual, Indie;0 - 20,000;22;10;12;0;0;0
642390;Blocksworld;Adventure, Casual, Indie;100,000 - 200,000;444;293;151;1410;2818;1
642520;Trio;Adventure, Casual, Indie;0 - 20,000;56;43;13;0;0;0
642560;Art Of Gravity;Adventure, Casual, Indie;20,000 - 50,000;554;49;505;108;215;1
642570;Flame of Mirrors;Action, Casual, Indie, Massively Multiplayer, Simulation, Strategy;0 - 20,000;0;1;-1;0;0;0
642580;Cally's Caves 4;Action, Adventure, Indie, Racing;20,000 - 50,000;107;23;84;0;0;0
642600;Burst Fighter;Action, Adventure;0 - 20,000;17;0;17;0;0;0
642610;Shape of the World;Casual, Indie, Simulation;0 - 20,000;261;50;211;89;89;1
642650;Pepper's Puzzles;Racing, Simulation;0 - 20,000;117;6;111;0;0;2
642660;VRemedies - MRI Procedure Experience;Action, Casual, Indie, Early Access;0 - 20,000;1;1;0;0;0;0
642680;Treasure Bolt;Adventure, Indie, RPG;0 - 20,000;0;2;-2;0;0;0
642700;The Murder Room VR;Nudity, Utilities;0 - 20,000;7;7;0;0;0;0
642710;Iron Defense VR;Action, Adventure, Casual;0 - 20,000;0;0;0;0;0;0
642730;Virtual SlotCars;RPG;0 - 20,000;46;7;39;0;0;1
642770;Vinyl Reality - DJ in VR;Adventure, Casual, Indie, RPG, Simulation, Sports;0 - 20,000;127;8;119;0;0;0
642830;Milanoir;Casual, Indie;20,000 - 50,000;78;34;44;0;0;1
642840;Red Bull Doodle Art - Global VR Gallery;Action, Indie, Strategy;0 - 20,000;10;0;10;0;0;0
643260;Break Stuff With Coins;Indie;0 - 20,000;21;0;21;0;0;0
643270;OLDTV;Action, Free to Play, Massively Multiplayer, Strategy;200,000 - 500,000;5031;273;4758;28;12;4
643570;Avatar of the Wolf;Violent, Action, Adventure, RPG, Early Access;0 - 20,000;24;0;24;0;0;0
643590;Everyday Golf VR;Action, Indie, RPG;0 - 20,000;35;50;-15;0;0;0
643610;Mortal Blitz;Action, Early Access;0 - 20,000;51;20;31;0;0;0
643620;Night Trap - 25th Anniversary Edition;Casual;50,000 - 100,000;140;24;116;288;288;0
643700;Fix Me Up Doc! – Dark Humor;Adventure, Indie;0 - 20,000;193;32;161;21;21;0
643700;Fix Me Up Doc! – Dark Humor;Action, Indie;0 - 20,000;193;32;161;21;21;0
643810;Fugl;Action, Adventure, Indie;50,000 - 100,000;432;84;348;122;163;1
643820;ShadowSide;Simulation, Sports, Strategy;20,000 - 50,000;229;129;100;196;276;0
643830;Botlike - a robot's rampage;Casual, Sports;0 - 20,000;52;9;43;0;0;0
643870;Kitten Adventures in City Park;Action, Indie, RPG;20,000 - 50,000;479;35;444;12;14;0
643880;Strikey Sisters;Indie;20,000 - 50,000;652;74;578;173;173;2
643900;Alvora Tactics;Action, Indie, Early Access;20,000 - 50,000;108;9;99;0;0;0
643930;拯救大魔王3 Falsemen3;Adventure, Casual, Indie, RPG, Simulation, Strategy;0 - 20,000;0;0;0;0;0;0
643940;Jim is Moving Out!;Action, Casual, Indie;0 - 20,000;13;2;11;0;0;0
643950;A Handful of Keflings;Action, Adventure, Indie;0 - 20,000;4;8;-4;0;0;0
643960;Cursed Treasure 2;Adventure, Simulation;100,000 - 200,000;340;58;282;2790;2790;12
643970;Return to Planet X;Adventure, Casual;0 - 20,000;12;7;5;0;0;0
644000;INTERSTELLAR PRIME;Indie, Simulation;0 - 20,000;28;20;8;0;0;0
644010;Racing Glider;Adventure;0 - 20,000;34;14;20;0;0;0
644080;Alphabear: Hardcover Edition;Adventure, Indie;20,000 - 50,000;85;17;68;0;0;1
644110;Lone Pirate VR;Casual, Indie, Sports;0 - 20,000;10;10;0;0;0;0
644130;Foxus;Utilities;0 - 20,000;9;33;-24;0;0;0
644150;Smogpunk 湮霾之地;Violent, Gore, Action, Adventure, Indie;0 - 20,000;14;4;10;0;0;0
644160;Reflecting Fate;Action, Indie, Simulation, Sports;0 - 20,000;29;20;9;8;8;0
644200;Starlight of Aeons;Action, Indie;50,000 - 100,000;280;53;227;1180;2297;2
644290;MEMORIES OF MARS;Casual, Indie, Strategy;50,000 - 100,000;1007;635;372;164;164;16
644330;In The Dark;Indie, Simulation, Strategy;0 - 20,000;1;1;0;0;0;0
644370;Howard Phillips Lovecar;Casual;0 - 20,000;31;6;25;0;0;0
644380;Hegis' Grasp: Evil Resurrected;Indie, Strategy;0 - 20,000;21;19;2;26;26;0
644390;D&D Lords of Waterdeep;Adventure, Indie, RPG;50,000 - 100,000;1234;83;1151;2060;2060;83
644400;RoboTraps;Adventure, Casual, Simulation, Strategy;0 - 20,000;5;0;5;0;0;0
644420;Xion;Free to Play, Massively Multiplayer, RPG, Strategy;0 - 20,000;35;18;17;11;11;0
644480;Outbreak: The New Nightmare;Casual;0 - 20,000;177;88;89;0;0;0
644530;The Maid_san's Caving Adventure - メイドさん洞窟探検 -;Action, Massively Multiplayer, Racing;0 - 20,000;7;8;-1;0;0;0
644540;Dies irae ~Amantes amentes~;Adventure, Indie;50,000 - 100,000;428;70;358;18;24;7
644550;篱笆庄秘闻 / Mysteries of Fence;Action, Free to Play, Indie, Strategy;0 - 20,000;259;29;230;377;377;0
644560;Mirror;Action, Adventure, Casual, Indie, Strategy;2,000,000 - 5,000,000;80419;2554;77865;634;326;224
644570;Material Girl;Adventure, Casual;200,000 - 500,000;7359;688;6671;1508;213;7
644580;Slash or Die 2;Adventure, Casual;0 - 20,000;26;2;24;0;0;0
644610;Drums Hero PC;Action, Adventure, Indie;0 - 20,000;23;11;12;227;276;0
644640;Band of Defenders;Action, Indie, Early Access;50,000 - 100,000;198;187;11;757;1339;0
644660;Lathe Safety Simulator;Strategy;0 - 20,000;18;5;13;0;0;0
644670;DEUS VULT | Online VR sword fighting;Violent, Gore, Indie;50,000 - 100,000;94;54;40;179;245;0
644680;"Libra of the Vampire Princess: Lycoris & Aoi in ""The Promise"" PLUS Iris in ""Homeworld""";Action, Massively Multiplayer, RPG, Early Access;0 - 20,000;6;3;3;0;0;0
644710;Gary Grigsby's War in the West;Adventure, Indie;0 - 20,000;123;20;103;0;0;9
644740;VRun;Action, Sports;0 - 20,000;1;0;1;0;0;0
644760;Streetball VR;Animation & Modeling, Video Production;0 - 20,000;17;15;2;0;0;0
644830;The Surge 2;Action, Indie, Massively Multiplayer, Strategy;500,000 - 1,000,000;5203;1531;3672;668;397;55
644860;The Lightbringers;Animation & Modeling, Design & Illustration, Game Development;0 - 20,000;0;2;-2;0;0;0
644870;Fortress of Hell;Action, Indie;0 - 20,000;7;1;6;0;0;0
644890;DarkLast;Action;0 - 20,000;13;27;-14;0;0;0
644930;They Are Billions;Simulation;1,000,000 - 2,000,000;35705;6236;29469;2840;1703;3751
645090;Zup! 5;Adventure, Casual;100,000 - 200,000;2400;158;2242;119;124;0
645150;Unborne;Adventure, Casual;0 - 20,000;3;5;-2;0;0;0
645200;Lethal Running;Adventure, Casual;0 - 20,000;10;2;8;0;0;0
645230;RUCKBALL;Adventure, Casual;20,000 - 50,000;67;29;38;0;0;0
645260;Trophy Fishing 2;Adventure, Indie, Early Access;200,000 - 500,000;650;255;395;49;33;245
645270;30 days to survive;Indie, Strategy;0 - 20,000;77;28;49;0;0;0
645280;MYSTIC VR;Indie, Simulation, Strategy;0 - 20,000;6;3;3;0;0;0
645290;Mechanism;Casual, Simulation;20,000 - 50,000;96;40;56;0;0;0
645320;SCARF;Adventure, Indie, RPG;0 - 20,000;170;22;148;242;242;1
645320;SCARF;Indie, Racing, Early Access;0 - 20,000;170;22;148;242;242;1
645330;Frontline Heroes VR;;0 - 20,000;6;13;-7;0;0;0
645340;Relax Walk VR;Violent, Gore, Action, Adventure, Indie, Massively Multiplayer;0 - 20,000;27;29;-2;0;0;0
645340;Relax Walk VR;Violent, Adventure, Indie;0 - 20,000;27;29;-2;0;0;0
645360;Cube XL;Casual, Indie;0 - 20,000;7;15;-8;0;0;0
645380;Heroes of Umbra;Action, Indie, Simulation;0 - 20,000;33;5;28;0;0;0
645410;Ominous Tales: The Forsaken Isle;Action, Adventure, Indie, Racing;0 - 20,000;19;13;6;0;0;0
645420;Entwined: Strings of Deception;Strategy;0 - 20,000;31;6;25;0;0;0
645440;Tearstone;Simulation, Strategy;0 - 20,000;3;15;-12;0;0;0
645450;Gravity Quest;Action, Casual, Indie;20,000 - 50,000;60;25;35;9;9;0
645460;Mind Maze;Adventure, Casual, Free to Play, Indie;0 - 20,000;59;18;41;0;0;0
645470;LOG the game;Free to Play, Strategy;0 - 20,000;5;4;1;0;0;0
645500;Cat Sorter VR;Action, Adventure, Indie;0 - 20,000;26;7;19;0;0;0
645630;Car Mechanic Simulator 2018;Adventure, Indie, RPG;1,000,000 - 2,000,000;41018;4160;36858;2197;945;601
645650;Chickens Madness;Adventure, Indie, RPG;0 - 20,000;11;11;0;0;0;0
645690;Fantasia of the Wind - 风之幻想曲;Action, Adventure, Indie;50,000 - 100,000;341;47;294;770;1460;0
645700;第502統合戦闘航空団 ブレイブウィッチーズ VR-Operation Baba_yaga-雪中迎撃戦;Violent, Gore, Action;0 - 20,000;8;10;-2;33;33;0
645720;Fabular: Once Upon a Spacetime;Adventure;20,000 - 50,000;97;16;81;613;613;0
645730;RESONANCE OF FATE/END OF ETERNITY 4K/HD EDITION;;50,000 - 100,000;589;145;444;1;1;8
645750;Rule with an Iron Fish - A Pirate Fishing Adventure;Free to Play;0 - 20,000;30;2;28;0;0;0
645780;Robot Pirates;Action;0 - 20,000;7;6;1;0;0;0
645790;Home Wars;Adventure, Casual, Indie, RPG;20,000 - 50,000;614;194;420;3;3;12
645820;Odysseus Kosmos and his Robot Quest (Complete Season);Adventure, Indie, Strategy;0 - 20,000;127;24;103;49;49;1
645830;Son Korsan;Casual, Indie, Strategy;20,000 - 50,000;35;81;-46;87;87;0
645860;Spartan VR;Adventure, Indie, Simulation, Early Access;0 - 20,000;7;7;0;0;0;0
645920;Dreamstones;Action, Racing, Strategy;0 - 20,000;71;15;56;0;0;1
645930;Zero Killed;Animation & Modeling;20,000 - 50,000;32;29;3;0;0;0
645940;OneScreen Solar Sails;Action, Indie;0 - 20,000;26;11;15;0;0;0
645940;OneScreen Solar Sails;Indie, Simulation;0 - 20,000;26;11;15;0;0;0
646010;Golem;Action, Indie;0 - 20,000;22;11;11;0;0;0
646050;Past Cure;Action, Simulation, Sports;20,000 - 50,000;19;39;-20;0;0;0
646050;Past Cure;Casual, Indie, Strategy, Early Access;20,000 - 50,000;19;39;-20;0;0;0
646100;Woodlands;Action, Indie;20,000 - 50,000;92;216;-124;11;14;0
646150;Winter Wolves Classic Games Collection;Adventure;0 - 20,000;2;0;2;0;0;0
646180;Nightcrawler VR Bowling;Action, Casual, Indie, Sports;0 - 20,000;5;3;2;0;0;0
646200;Dead Effect 2 VR;Indie, Simulation, Strategy;50,000 - 100,000;941;221;720;23;27;1
646210;The Mind's Eclipse;Casual, Indie, Strategy, Early Access;0 - 20,000;38;4;34;0;0;0
646240;Bacon May Die;Action, Indie;100,000 - 200,000;657;36;621;0;0;3
646270;60 Parsecs!;Adventure, Indie;200,000 - 500,000;2415;359;2056;277;227;30
646280;Too Many Weapons;Action, Adventure, Casual, Indie;0 - 20,000;24;7;17;0;0;0
646300;ChainMan;Casual, Indie, Racing, Sports;0 - 20,000;8;4;4;0;0;0
646310;ProjectM : Daydream;Sexual Content, Nudity, Adventure, Simulation;0 - 20,000;64;25;39;0;0;0
646310;ProjectM : Daydream;RPG;0 - 20,000;64;25;39;0;0;0
646350;Tracon!2012:SE;Casual;0 - 20,000;8;8;0;0;0;0
646360;El Ministerio del Tiempo VR: El tiempo en tus manos;Adventure, Casual, Strategy;50,000 - 100,000;15;3;12;0;0;0
646370;Vesta;Indie, Sports;0 - 20,000;26;1;25;0;0;0
646380;Uphill Skiing;Violent, Gore, Action, Adventure, Indie, Early Access;0 - 20,000;11;2;9;0;0;0
646400;Postity;Action, Adventure, Indie;0 - 20,000;2;10;-8;0;0;0
646430;HARP Vefa;Adventure, Casual, Indie, Simulation;0 - 20,000;12;20;-8;0;0;0
646440;Redfoot Bluefoot Dancing;Action, Casual, Massively Multiplayer, Simulation, Strategy;0 - 20,000;4;7;-3;0;0;0
646460;CompliKATed;Free to Play, Indie, Strategy, Early Access;0 - 20,000;13;1;12;0;0;0
646470;Alicia Quatermain: Secrets Of The Lost Treasures;Casual, Indie, Simulation;0 - 20,000;115;17;98;0;0;2
646500;Egypt: Old Kingdom;Adventure, Simulation;100,000 - 200,000;896;133;763;220;326;13
646530;Hop Step Sing! kiss×kiss×kiss (HQ Edition);Action, Adventure, Indie;0 - 20,000;52;4;48;0;0;0
646570;Slay the Spire;Violent, Action, Casual, Indie, Massively Multiplayer, Racing;2,000,000 - 5,000,000;124445;2692;121753;4148;2071;9828
646600;Baobabs Mausoleum Ep.1: Ovnifagos Don´t Eat Flamingos;Casual, Indie, Simulation;20,000 - 50,000;99;35;64;0;0;1
646680;Roman Adventures: Britons. Season 1;Adventure, Casual, Free to Play, Indie;0 - 20,000;27;2;25;0;0;4
646820;Might & Mayhem;;20,000 - 50,000;48;37;11;1;1;1
646830;Blood of Darkness;Casual, Indie;0 - 20,000;10;1;9;0;0;0
646890;Distant Nightmare - Virtual reality;Violent, Gore, Action;20,000 - 50,000;1;6;-5;0;0;0
646910;The Crew 2;Violent, Gore, Action, Adventure, Indie;2,000,000 - 5,000,000;51939;12158;39781;2400;985;920
646960;Three Twenty One;Action, Adventure;0 - 20,000;23;22;1;0;0;0
647000;RoBros;Accounting, Animation & Modeling, Audio Production, Design & Illustration, Education, Photo Editing, Software Training, Utilities, Video Production, Web Publishing, Game Development;50,000 - 100,000;39;38;1;3;3;1
647040;Riaaf The Spider;Simulation;0 - 20,000;134;22;112;25;35;1
647050;Super Hardcore;Violent, Action, Indie, Simulation;0 - 20,000;16;20;-4;1;1;0
647080;Haunted Halls: Green Hills Sanitarium Collector's Edition;Indie, Simulation, Strategy;0 - 20,000;17;1;16;0;0;0
647090;Maestro: Music of Death Collector's Edition;RPG;0 - 20,000;8;0;8;0;0;0
647280;Pixel Shooter;Action, Adventure, Casual, Indie, Simulation, Strategy;20,000 - 50,000;55;112;-57;1;1;0
647430;Game of Emperors;Indie, Simulation, Early Access;0 - 20,000;3;5;-2;0;0;0
647500;Near Death Experience;Indie, RPG, Strategy;0 - 20,000;18;10;8;0;0;0
647530;Prime Arena;Education;0 - 20,000;58;33;25;0;0;0
647570;Transference;Action, Indie;20,000 - 50,000;282;110;172;139;139;1
647590;Space Junkies;Action;0 - 20,000;220;131;89;0;0;0
647640;ShockRods;Adventure, Indie;0 - 20,000;33;10;23;0;0;0
647650;Space Avenger – Empire of Nexx;Indie, Early Access;0 - 20,000;14;5;9;0;0;0
647670;Grand Expanse;Indie, Strategy;0 - 20,000;7;2;5;1;1;0
647740;Airmen;Adventure, Indie, RPG;50,000 - 100,000;260;58;202;0;0;3
647790;Holomeld;Casual, Indie;0 - 20,000;1;0;1;0;0;0
647810;Verto Studio VR;Adventure, Casual, Indie, Simulation;0 - 20,000;13;2;11;0;0;0
647820;Order No. 227: Not one step back!;Adventure, Casual, Free to Play, Indie;0 - 20,000;28;47;-19;0;0;0
647830;LEGO Marvel Super Heroes 2;Action, Casual, Indie;200,000 - 500,000;6037;913;5124;1775;722;215
647840;Ironclads 2: Caroline Islands War 1885;Adventure, Casual, Indie;0 - 20,000;12;3;9;0;0;0
647850;Royal Detective: Queen of Shadows Collector's Edition;Action, Strategy;0 - 20,000;3;0;3;0;0;0
647890;The Agency of Anomalies: The Last Performance Collector's Edition;Adventure, RPG, Strategy;0 - 20,000;6;3;3;0;0;1
647900;Riddles of Fate: Into Oblivion Collector's Edition;Action, Adventure, Indie;0 - 20,000;3;0;3;0;0;0
647910;Amaranthine Voyage: The Living Mountain Collector's Edition;;0 - 20,000;6;1;5;0;0;0
647930;Danse Macabre: Crimson Cabaret Collector's Edition;Action, Adventure, Casual, Indie, RPG;0 - 20,000;4;1;3;0;0;0
647950;Kitty Nigiri;Violent, Action, Indie, Early Access;0 - 20,000;2;0;2;0;0;0
647960;Rusted Warfare - RTS;Adventure, Casual, Indie;200,000 - 500,000;3306;87;3219;1320;1019;119
647980;Trojan Inc.;Adventure, Casual, Strategy;0 - 20,000;14;20;-6;0;0;0
647990;Batter Up! VR;Indie, RPG;0 - 20,000;20;3;17;0;0;0
648020;The Fleet;Adventure, Casual, Indie, Sports, Early Access;0 - 20,000;8;5;3;0;0;0
648050;Super Pilot;Action, Indie;20,000 - 50,000;122;12;110;0;0;1
648060;Nucvivor;Casual, Indie, Simulation;;;;0;;;
648070;CrisisActionVR;Casual, Indie;0 - 20,000;14;10;4;0;0;0
648100;Raging Loop;Action, Casual, Indie, Simulation, Strategy;50,000 - 100,000;3614;119;3495;2047;2047;103
648120;Pixel Painter;Casual, Simulation;1,000,000 - 2,000,000;741;255;486;317;394;1
648150;Arcsaber VR;Free to Play, Massively Multiplayer, Simulation;0 - 20,000;1;0;1;0;0;0
648190;Aliens In The Yard;Action, Adventure, Indie;0 - 20,000;8;1;7;0;0;0
648340;Harald: A Game of Influence;Action, Casual, Indie;0 - 20,000;7;17;-10;55;55;0
648350;Jurassic World Evolution;Adventure, Free to Play, Indie, RPG, Early Access;2,000,000 - 5,000,000;43697;6739;36958;1657;912;518
648380;Bullet Dodge;Video Production;0 - 20,000;0;2;-2;0;0;0
648390;Marie's Room;Casual, Indie;200,000 - 500,000;5584;355;5229;66;56;6
648410;Colony Ship: A Post-Earth Role Playing Game;Indie;20,000 - 50,000;613;110;503;0;0;24
648430;Hand of the Gods;Action, Casual, Indie, Simulation, Early Access;200,000 - 500,000;737;545;192;128;116;0
648440;Pixel Devil and the Broken Cartridge;Casual, Free to Play, Strategy;0 - 20,000;64;41;23;0;0;0
648510;Choice of the Star Captain;Adventure, Casual, Free to Play, Indie;0 - 20,000;8;3;5;0;0;0
648530;Reckless Space Pirates;Action, Adventure, Casual, Indie;0 - 20,000;1;2;-1;0;0;0
648550;Choice;Casual, Strategy;0 - 20,000;16;4;12;0;0;0
648570;Hell Dimension VR;Action, Casual, Indie, Racing;0 - 20,000;15;3;12;0;0;0
648580;428: Shibuya Scramble;Action, Massively Multiplayer, RPG, Strategy;50,000 - 100,000;1384;79;1305;288;549;62
648590;428 〜封鎖された渋谷で〜;Action, Indie;0 - 20,000;0;0;0;3;3;16
648600;FINAL FANTASY XV WINDOWS EDITION MOD ORGANIZER;Action, Indie, Strategy, Early Access;50,000 - 100,000;17;27;-10;0;0;0
648630;Damascus Gear Operation Tokyo HD;Adventure, Indie;0 - 20,000;13;17;-4;0;0;0
648640;Antiquia Lost;Indie, RPG, Simulation, Strategy;0 - 20,000;22;6;16;0;0;0
648750;Tokaido;Action, Adventure, Indie, RPG;0 - 20,000;84;40;44;0;0;0
648780;It's Quiz Time;Sports;0 - 20,000;145;54;91;339;339;7
648800;Raft;Indie;10,000,000 - 20,000,000;241310;16138;225172;1418;864;11159
648810;Vehicle VR;Action, Indie;50,000 - 100,000;22;9;13;6;10;0
648870;Intel 5G VR Experience;Violent, Casual, Indie, Strategy;0 - 20,000;9;12;-3;0;0;0
648880;Guano Gladiators;Action, Indie, Strategy;0 - 20,000;11;0;11;0;0;0
648890;DMT: Dynamic Music Tesseract;Indie, RPG;20,000 - 50,000;161;17;144;22;22;2
649000;You Shall Not Jump: PC Master Race Edition;Action, Indie;0 - 20,000;4;4;0;0;0;0
649040;Isle in the Sky;Adventure, RPG, Early Access;0 - 20,000;1;0;1;0;0;0
649120;Magician's Gambit;Action, Indie;0 - 20,000;11;0;11;0;0;0
649150;Phobia;Casual, Indie;0 - 20,000;16;42;-26;0;0;0
649170;The Seasons;Action, Casual, Indie;0 - 20,000;43;15;28;0;0;0
649190;Blast Zone! Tournament;Adventure, Indie;500,000 - 1,000,000;522;370;152;0;0;0
649240;RADtv;Adventure, Indie;0 - 20,000;28;10;18;0;0;0
649300;Wisdom of War;Action, Adventure, Casual, Indie, Early Access;0 - 20,000;3;9;-6;0;0;0
649360;Yesterday;Violent, Gore, Action, Adventure, Casual, Indie, Simulation, Strategy, Video Production;0 - 20,000;24;5;19;0;0;0
649450;Deadly Escape;Action, Indie;0 - 20,000;49;26;23;0;0;0
649460;Space Panic: Room Escape (VR);Adventure, Casual, Indie, Simulation;0 - 20,000;9;8;1;0;0;0
649510;Bullet VR;Action, Adventure, Indie, Simulation, Strategy;0 - 20,000;8;12;-4;0;0;0
649570;Dash Dash Run!;Casual, Indie;0 - 20,000;9;3;6;0;0;0
649580;Twins of the Pasture;Adventure, Casual, Indie, Racing, Simulation, Sports;20,000 - 50,000;224;80;144;281;281;1
649600;Swords and Sandals 2 Redux;Indie, RPG;50,000 - 100,000;335;96;239;113;113;3
649620;VR Battleship YAMATO;Casual;0 - 20,000;76;6;70;0;0;0
649630;DarkMaze;Action, Adventure, Free to Play, Indie, Early Access;0 - 20,000;1;6;-5;0;0;0
649640;Ashes Cricket;Casual, Indie;50,000 - 100,000;352;80;272;0;0;7
649660;LIBERTY VR;Action, Casual, Indie;0 - 20,000;8;6;2;0;0;0
649670;ZHUST - THE ILLUSION SOUL;Casual, Indie;0 - 20,000;19;17;2;17;17;0
649730;OfficeBots: Reality Bytes [VR];Action, Indie, RPG;0 - 20,000;5;3;2;0;0;0
649740;CRAFT BATTLE SIMULATOR;Indie, Strategy;0 - 20,000;2;6;-4;0;0;0
649770;Coregrounds;Indie;0 - 20,000;51;21;30;0;0;0
649790;Harvest Life;Action, Indie, Simulation;20,000 - 50,000;127;124;3;0;0;0
649810;Windstorm: Start of a Great Friendship;Casual, Indie, RPG;0 - 20,000;96;32;64;339;339;2
649820;Slime-san: Blackbird's Kraken;Indie, Simulation, Strategy;0 - 20,000;7;0;7;0;0;0
649870;NitroRage;Action, Indie;0 - 20,000;41;43;-2;0;0;0
649880;Disco Time 80s VR;Indie, Simulation;0 - 20,000;41;28;13;0;0;0
649890;Caliban Below;Action, Adventure, RPG;50,000 - 100,000;193;15;178;0;0;0
649900;Mini Guns - Omega Wars;Indie, RPG, Early Access;;;;0;;;
649950;Ashen;Casual, Indie;100,000 - 200,000;1995;894;1101;700;840;24
649970;Hero's Story;Adventure, Indie;0 - 20,000;6;2;4;0;0;0
649990;Writers;Indie;0 - 20,000;25;2;23;0;0;0
650000;DOOM VFR;Action, Indie, Simulation, Sports, Strategy;200,000 - 500,000;1453;1158;295;60;63;3
650010;Mob Stadium;Adventure, Casual, Indie;0 - 20,000;4;3;1;0;0;0
650070;OVERTURN;Action, Adventure, Casual, Indie, RPG, Simulation;0 - 20,000;62;13;49;0;0;0
650090;VeeR VR:VR Video and Movie Platform;Violent, Gore, Action, Adventure, Strategy;50,000 - 100,000;119;25;94;33;33;1
650120;Shots Fired;Action, Adventure, Indie;0 - 20,000;0;0;0;0;0;0
650220;Interplanetary: Enhanced Edition;Adventure, RPG;100,000 - 200,000;632;112;520;302;335;14
650310;Journey of the Sword;Action, Indie;0 - 20,000;0;3;-3;0;0;0
650330;Sanator: Scarlet Scarf;Action, Indie;20,000 - 50,000;355;35;320;132;187;0
650340;TublerVR;Casual, Indie, Strategy;0 - 20,000;0;2;-2;0;0;0
650350;Machine World 2;Action, Adventure, Indie;0 - 20,000;96;89;7;317;317;1
650440;Warbanners;Action;50,000 - 100,000;373;144;229;197;197;2
650460;After Solitary;Action, Indie;0 - 20,000;20;0;20;0;0;0
650490;Dinosaur Hunt First Blood;Adventure;20,000 - 50,000;85;92;-7;0;0;0
650510;ZONE OF THE ENDERS THE 2nd RUNNER : M∀RS / アヌビス ゾーン・オブ・エンダーズ : マーズ;Casual, Free to Play, Indie, Simulation;20,000 - 50,000;571;222;349;39;66;7
650510;ZONE OF THE ENDERS THE 2nd RUNNER : M∀RS / アヌビス ゾーン・オブ・エンダーズ : マーズ;Adventure, Casual, Indie, RPG, Strategy;20,000 - 50,000;571;222;349;39;66;7
650570;Code 7: A Story-Driven Hacking Adventure;Indie, Simulation, Strategy;0 - 20,000;98;7;91;216;216;0
650580;Be Quiet!;Action, Casual, Indie;20,000 - 50,000;2;6;-4;0;0;0
650600;Greece Defense TD;Action, Casual, Indie;0 - 20,000;2;3;-1;0;0;0
650670;Grimoire : Heralds of the Winged Exemplar (V2);Action, Free to Play, Massively Multiplayer, Early Access;20,000 - 50,000;410;181;229;9;9;1
650680;Golem Creation Kit;Indie;0 - 20,000;47;15;32;0;0;0
650690;Plumber 3D;Adventure, Indie;0 - 20,000;0;0;0;0;0;0
650700;Yume Nikki;Action, Casual, Free to Play, Indie;500,000 - 1,000,000;5100;343;4757;101;54;61
650720;SlipDrive;Adventure, Indie;50,000 - 100,000;1;3;-2;0;0;0
650730;Weeping Skies;Action, Indie;0 - 20,000;12;10;2;0;0;0
650740;Leap of Champions;Casual;0 - 20,000;23;13;10;0;0;0
650750;HYPERNOVA: Escape from Hadea;Adventure, Indie, RPG;20,000 - 50,000;62;13;49;29;29;0
650760;侠客风云传前传(Tale of Wuxia:The Pre-Sequel);Action, Indie, Strategy;20,000 - 50,000;1893;525;1368;2372;2174;131
650770;Time Gun / 时间枪;Action, Indie;0 - 20,000;5;2;3;0;0;0
650780;AngerForce: Reloaded;Action;50,000 - 100,000;332;32;300;0;0;1
650810;Imperatum;Casual, Indie, Simulation;0 - 20,000;8;17;-9;0;0;0
650820;Psychic Isolation;Indie, RPG, Strategy;0 - 20,000;3;2;1;0;0;0
650860;Wrath of Loki VR Adventure;Adventure, Indie;20,000 - 50,000;36;25;11;0;0;0
650880;Beyond the Invisible: Evening;Action, Indie;0 - 20,000;14;14;0;0;0;0
650940;Rogue Empire: Dungeon Crawler RPG;Simulation;0 - 20,000;306;41;265;992;992;5
650980;Naklua VR;Action, Casual, Indie;0 - 20,000;2;3;-1;0;0;0
650990;Run Jump Die Repeat;Action, Indie;0 - 20,000;1;1;0;0;0;0
651010;Nurbits;Action, Adventure, Indie;0 - 20,000;6;3;3;0;0;0
651080;Moon Landing VR;Action, Indie, RPG, Simulation, Strategy;0 - 20,000;5;3;2;0;0;0
651090;Aces High III;Casual, Indie, Simulation, Strategy;100,000 - 200,000;206;139;67;33;57;5
651120;Diesel Express VR;Adventure;0 - 20,000;12;6;6;0;0;0
651150;Quantum League;Action, Adventure, Casual, Indie, RPG, Simulation;200,000 - 500,000;1745;561;1184;261;246;2
651170;Deep Horizon;Action, Casual, Sports;0 - 20,000;5;2;3;0;0;0
651320;VRTGO;Action;0 - 20,000;5;2;3;0;0;0
651340;Shephy;Action, Casual;20,000 - 50,000;115;39;76;72;72;0
651360;Eskimo Bob: Starring Alfonzo;Indie, Strategy;0 - 20,000;12;0;12;0;0;0
651380;BANG! BANG! Totally Accurate Redneck Simulator;Casual, Indie, Strategy;0 - 20,000;221;18;203;0;0;0
651470;Onirim - Solitaire Card Game;Action;50,000 - 100,000;168;37;131;64;64;1
651490;No Longer Home;Adventure, Indie, RPG;0 - 20,000;181;52;129;80;80;0
651500;My Memory of Us;Casual, Indie;0 - 20,000;658;55;603;150;171;0
651520;Castle Defender;Adventure, Casual, Indie, RPG, Strategy;20,000 - 50,000;9;12;-3;0;0;0
651550;ConcPerfect 2017;Action, Adventure, Casual;0 - 20,000;17;7;10;70;70;0
651560;Clash of Robots;Indie, RPG, Simulation;0 - 20,000;4;7;-3;0;0;0
651610;Booty Diver;Action, Adventure, Indie, Strategy;0 - 20,000;1;0;1;0;0;0
651640;The Spook Inspectors;Indie, Strategy;0 - 20,000;14;2;12;0;0;0
651650;Dunia: Masters;Action, Indie, Strategy;0 - 20,000;6;7;-1;0;0;0
651660;Halcyon 6: Starbase Commander (LIGHTSPEED EDITION);Casual;100,000 - 200,000;600;151;449;195;233;12
651670;Star Renegades;Adventure;200,000 - 500,000;1885;338;1547;315;318;42
651680;Shalnor Legends: Sacred Lands;Casual, Indie;0 - 20,000;32;14;18;0;0;0
651690;Double Play: 2-Player VR Baseball;Indie;0 - 20,000;4;1;3;0;0;0
651820;Little Miss Lonely;Action, Casual, Indie;0 - 20,000;3;2;1;0;0;0
651970;NEON GALAXY;Action, Casual, Indie;0 - 20,000;2;2;0;0;0;0
651990;The Montana Chronicles: Montana's Croatoa;Action, Indie;0 - 20,000;1;0;1;0;0;0
652000;Quantum Pilot;Action, Indie;0 - 20,000;7;1;6;0;0;0
652030;Tessa's Ark;RPG;0 - 20,000;23;14;9;0;0;0
652040;Children of Apollo;Casual, Simulation;0 - 20,000;7;3;4;0;0;0
652050;The Labyrinth;Action, Adventure, Casual, Indie, Strategy;0 - 20,000;24;3;21;0;0;0
652060;Curse of the Great Forest;Casual, Indie;0 - 20,000;2;2;0;0;0;0
652070;Bump+Smack;Free to Play, Indie, Strategy;0 - 20,000;3;2;1;0;0;0
652090;Blockara;Action, Adventure, Indie, Strategy, Early Access;0 - 20,000;3;1;2;0;0;0
652120;Humble Abode;Action, Adventure, Casual, Indie, Early Access;0 - 20,000;4;1;3;0;0;0
652130;Lupus in Fabula;Action, Adventure, Indie;0 - 20,000;8;1;7;0;0;0
652140;Echo Nine;Action, Adventure, Indie, Early Access;0 - 20,000;1;0;1;0;0;0
652150;Oats Studios - Volume 1 Assets;Action, Casual, Indie;50,000 - 100,000;157;11;146;1;1;0
652160;DC Wonder: Unlimited;Casual, Indie;0 - 20,000;1;0;1;0;0;0
652180;VR Guest;Action, Adventure, Indie, Strategy;0 - 20,000;2;2;0;0;0;0
652190;Emily Wants to Play Too;Indie;20,000 - 50,000;315;66;249;0;0;1
652200;Chromaestro;Casual, Indie;0 - 20,000;3;0;3;0;0;0
652230;CrazyCar;Violent, Gore, Casual, Indie, Simulation, Sports;0 - 20,000;27;60;-33;1;1;0
652250;Pond Wars;Action, Indie;0 - 20,000;3;0;3;0;0;0
652270;Dark and Bright;Casual, Indie, Simulation;20,000 - 50,000;10;1;9;0;0;0
652280;Unimersiv;Casual, Indie;0 - 20,000;1;2;-1;0;0;0
652310;Khufu's Delivery Service;Indie;0 - 20,000;1;0;1;0;0;0
652330;HereAfter;Casual, Indie;0 - 20,000;26;7;19;31;31;0
652340;Flagsplosion;Indie, Simulation, Early Access;0 - 20,000;49;4;45;0;0;0
652360;BFF or Die;Action, Indie;20,000 - 50,000;42;15;27;0;0;0
652390;Mr Rabbit's Alphabet Forest Adventure;Casual, Indie;0 - 20,000;13;8;5;0;0;0
652410;Brigand: Oaxaca;Casual, Indie;1,000,000 - 2,000,000;296;12;284;135;135;0
652460;Fragmentum;Action, Adventure, Indie, Simulation;0 - 20,000;5;1;4;0;0;0
652470;Hex Tunnel;Action, Indie;0 - 20,000;2;4;-2;0;0;0
652480;Killbox;Action, Indie;0 - 20,000;41;23;18;0;0;0
652510;ESCAPE Room: Reality;Casual, Indie, Simulation, Strategy;0 - 20,000;13;1;12;0;0;0
652520;MarionetteAI;Action, Casual, Indie;0 - 20,000;4;1;3;0;0;0
652530;Potentia;Action, Adventure, Indie, Simulation;0 - 20,000;9;1;8;0;0;0
652540;Mocove Arts VR;Adventure, Casual, Indie;0 - 20,000;4;3;1;0;0;0
652550;Vickinachi;Casual, Indie;20,000 - 50,000;34;172;-138;1;1;0
652560;Beached;Casual, Indie;0 - 20,000;5;12;-7;0;0;0
652570;Mystika 3 : Awakening of the dragons;Action, Adventure, Indie;0 - 20,000;59;5;54;0;0;3
652600;Descent - Silence of Mind;Action, Adventure, Indie;20,000 - 50,000;56;31;25;79;79;0
652610;Stick Nightmare;Adventure, Free to Play, Indie, Simulation;0 - 20,000;6;1;5;0;0;0
652660;ESport Manager;Casual, Indie;20,000 - 50,000;67;103;-36;0;0;1
652700;Equivoque;Casual, Indie;0 - 20,000;22;3;19;0;0;0
652730;Z-Aftershock;Action, Indie, Simulation, Sports, Early Access;0 - 20,000;0;0;0;0;0;0
652750;Polygon Hero;Violent, Gore, Action, Adventure, Indie;0 - 20,000;39;10;29;0;0;0
652760;Watchlist;Action, Adventure, Indie;20,000 - 50,000;12;1;11;0;0;0
652760;Watchlist;Action, Casual, Indie, Sports;20,000 - 50,000;12;1;11;0;0;0
652770;Zofia;Adventure, Casual, Indie;0 - 20,000;3;0;3;0;0;0
652780;The Mutational;Action, Indie;0 - 20,000;20;4;16;0;0;0
652800;Sojourner;Action, Adventure, Indie, RPG, Simulation, Early Access;0 - 20,000;22;1;21;0;0;0
652810;Grabity;Casual, Indie, Strategy;0 - 20,000;48;1;47;5;5;0
652830;Lost Legends: The Pharaoh's Tomb;Action, Casual, Indie;0 - 20,000;7;6;1;0;0;0
652880;Samsara;RPG, Early Access;0 - 20,000;28;1;27;0;0;0
652890;Vanguard Knights;Action, Indie;0 - 20,000;24;2;22;0;0;0
652900;The Mechanical Room VR;Action, Indie;0 - 20,000;0;0;0;0;0;0
652910;Delay;Action, Adventure, Indie;0 - 20,000;21;6;15;3;3;0
652950;Maggie's Apartment;Indie, Strategy;0 - 20,000;100;3;97;0;0;0
652950;Maggie's Apartment;Action, Casual, Simulation;0 - 20,000;100;3;97;0;0;0
652980;Loading Screen Simulator;Action, Casual, Simulation;500,000 - 1,000,000;7289;1105;6184;84;33;14
652990;Eternal Maze;Action, Casual, Indie;20,000 - 50,000;7;1;6;0;0;0
653050;Undertaker's;Action, Adventure, Casual, Indie;0 - 20,000;10;9;1;0;0;0
653080;Inflatality;Strategy;0 - 20,000;15;3;12;0;0;1
653100;Puzzle Bloc Invasion;Action, Adventure, Indie;0 - 20,000;1;0;1;0;0;0
653120;RockShot;Action, Free to Play, Sports;50,000 - 100,000;169;198;-29;40;67;0
653190;spaceBOUND;Education;0 - 20,000;21;7;14;17;17;0
653210;Prisoner;Casual, Indie, Strategy;0 - 20,000;22;15;7;1;1;0
653220;Chroma Blast;Indie, Racing, Sports;50,000 - 100,000;210;47;163;3;3;1
653530;Return of the Obra Dinn;Action, Indie, Early Access;500,000 - 1,000,000;18426;595;17831;527;473;121
653550;Spin the Beat;Action, Indie, Sports;0 - 20,000;0;0;0;0;0;0
653760;Crushing Blow;Action, Sports;0 - 20,000;15;14;1;0;0;0
653760;Crushing Blow;Action, Indie;0 - 20,000;15;14;1;0;0;0
653770;The First Time I Died;Action, Adventure, Indie;0 - 20,000;2;0;2;0;0;0
653780;Defend Your Kingdom;Action, Indie;0 - 20,000;8;2;6;0;0;0
653870;Cavern Crumblers;Action, Adventure, Indie;0 - 20,000;2;3;-1;0;0;0
653920;Darkest Wave;Action;0 - 20,000;2;0;2;0;0;0
653930;Tiny Town VR;Sexual Content, Violent, Adventure, Indie, Simulation;100,000 - 200,000;580;47;533;329;444;9
653940;Zafehouse Diaries 2;Action, Adventure, Indie, RPG, Early Access;20,000 - 50,000;86;32;54;17;17;1
653960;DinoBlaster;Action, Indie, Simulation;0 - 20,000;3;0;3;0;0;0
653970;Virtual Temple: Order of the Golden Dawn;Action, Casual, Indie;0 - 20,000;8;1;7;0;0;0
654000;A Quick Death;Indie, Strategy;0 - 20,000;5;0;5;0;0;0
654010;Project MALLOW;Action, Adventure, Indie, Strategy, Early Access;0 - 20,000;9;0;9;0;0;0
654020;Ben The Exorcist;Action, Indie;0 - 20,000;32;5;27;0;0;0
654050;JYDGE;Violent, Action, Adventure, Indie, Strategy;50,000 - 100,000;619;93;526;103;150;0
654060;War Chariots: Royal Legion;Adventure, Casual, Indie, Simulation;0 - 20,000;0;0;0;0;0;0
654070;Escape Room;Adventure, Indie;0 - 20,000;6;8;-2;0;0;0
654080;Der einzig wahre Auserwählte;Adventure, Casual, Indie;0 - 20,000;17;2;15;0;0;0
654080;Der einzig wahre Auserwählte;Casual, Indie, Simulation;0 - 20,000;17;2;15;0;0;0
654090;High clear VR;Action, Free to Play, Indie;0 - 20,000;43;15;28;0;0;0
654100;Rival Megagun;Action;0 - 20,000;58;6;52;0;0;0
654110;Fisher Fans VR;Indie, RPG;0 - 20,000;1;1;0;0;0;0
654200;Seven: Reboot;Action, Adventure, Indie, RPG;0 - 20,000;0;0;0;0;0;0
654220;Flash Point: Fire Rescue;Action, Adventure, Indie;0 - 20,000;119;26;93;0;0;1
654240;Xenoslaive Overdrive;Casual, Indie;0 - 20,000;6;3;3;0;0;0
654250;Catacombs 1: Demon War;Action, Adventure, Casual, Indie, RPG, Strategy;0 - 20,000;16;13;3;0;0;0
654260;旧手表 - Old Watch;Action, Indie;20,000 - 50,000;552;92;460;644;644;1
654300;Darkest Hunters;Indie, Simulation, Sports, Strategy, Early Access;0 - 20,000;54;51;3;248;248;0
654390;Dialogue: A Writer's Story;Casual, Indie, Strategy;0 - 20,000;2;1;1;0;0;0
654400;Shank n' Bake;Indie;0 - 20,000;31;3;28;0;0;0
654430;STATUS: INSANE;Action, Adventure, Indie, RPG, Simulation, Early Access;0 - 20,000;43;2;41;0;0;0
654440;Isotiles - Isometric Puzzle Game;Action, Indie, Early Access;20,000 - 50,000;149;22;127;15;15;0
654450;Exorcise The Demons;Action, Casual, Indie, Simulation;0 - 20,000;21;4;17;0;0;0
654500;Super XYX;Casual, Indie, Simulation, Sports;0 - 20,000;71;5;66;0;0;0
654520;Travel Riddles: Trip To Greece;Action, Adventure, Casual, Indie, RPG, Simulation;0 - 20,000;15;0;15;0;0;0
654520;Travel Riddles: Trip To Greece;Action, Casual, Indie, Early Access;0 - 20,000;15;0;15;0;0;0
654550;Football Game;Action, Casual, Indie;50,000 - 100,000;215;18;197;0;0;1
654570;History2048 - 3D puzzle number game;Casual;0 - 20,000;21;11;10;0;0;1
654580;Senalux;Adventure, Casual, Indie;0 - 20,000;24;0;24;0;0;0
654600;PowBall Renaissance;Action, Casual, Indie, Racing;0 - 20,000;21;3;18;0;0;0
654610;Mr. Dubstep;Action, Casual, Indie, Strategy;50,000 - 100,000;102;53;49;2;4;0
654630;Dreamblaster;Casual, Indie, Simulation, Strategy;0 - 20,000;3;0;3;0;0;0
654640;7 Pillars;Casual, Indie;0 - 20,000;5;2;3;0;0;0
654660;Pharmakon - Tactical Puzzle;Action, Indie, Strategy;0 - 20,000;14;11;3;0;0;0
654670;RPS Runner;Action, Casual, Indie;0 - 20,000;11;1;10;0;0;0
654680;Ziggurat 3D Chess;Casual, Indie;0 - 20,000;15;11;4;0;0;0
654690;Bermuda - Lost Survival;Indie, Simulation, Strategy;20,000 - 50,000;280;206;74;136;136;2
654700;Unearthing Process;Simulation;0 - 20,000;4;8;-4;0;0;0
654710;Ashes;Indie, Simulation, Sports, Strategy, Early Access;0 - 20,000;37;22;15;0;0;0
654740;STICK ENGINE;Action, Adventure, Indie;0 - 20,000;11;5;6;0;0;0
654750;Square x Square;Casual, Indie, Simulation;0 - 20,000;11;3;8;0;0;0
654770;Ballway;Adventure, Indie;0 - 20,000;52;5;47;0;0;0
654800;Guts and Syringes;Action, Adventure, Indie;0 - 20,000;10;2;8;0;0;0
654810;A Snake's Tale;Action, Casual, Indie;0 - 20,000;27;1;26;0;0;0
654820;Akin Vol 2;Sexual Content, Nudity, Violent, Gore, Action, Indie;0 - 20,000;25;20;5;204;204;0
654840;I Want Toilet!!!!!!;Action, Indie;0 - 20,000;11;8;3;0;0;0
654850;Masked Forces: Zombie Survival;Violent, Gore, Action, Adventure, Indie;20,000 - 50,000;276;112;164;28;28;0
654850;Masked Forces: Zombie Survival;Action, Casual, Indie;20,000 - 50,000;276;112;164;28;28;0
654880;Dream Daddy: A Dad Dating Simulator;Casual, Indie;500,000 - 1,000,000;5002;456;4546;585;607;41
654890;Grand Tactician: The Civil War (1861-1865);Casual, Indie, Strategy;20,000 - 50,000;1271;337;934;1344;1344;175
654900;qop;Action, Adventure, Casual, Indie;20,000 - 50,000;852;78;774;125;183;0
654910;YANKAI'S PEAK.;Action, Indie;0 - 20,000;54;5;49;28;28;0
654910;YANKAI'S PEAK.;Action, Adventure, Casual, Indie;0 - 20,000;54;5;49;28;28;0
654940;RXE;Action, Adventure, Massively Multiplayer, Racing, Simulation;0 - 20,000;1;3;-2;0;0;0
654950;Labyrinth Escape;Action, Indie, RPG;0 - 20,000;12;20;-8;0;0;0
654970;Numberline 2;Animation & Modeling, Design & Illustration, Education;20,000 - 50,000;8;21;-13;0;0;0
654980;Inferno Puzzle;Action, Casual, Racing;0 - 20,000;11;31;-20;0;0;0
654990;Dude Simulator;Sexual Content, Casual, Indie, Simulation, Sports;500,000 - 1,000,000;1144;756;388;100;127;3
655000;Masked Forces 2: Mystic Demons;Action, Casual, Indie, Simulation;0 - 20,000;48;18;30;0;0;0
655020;Unreal Estate;Action, Casual, Indie;0 - 20,000;30;13;17;0;0;0
655030;Simple Light Cycles;Casual, Strategy;0 - 20,000;14;6;8;0;0;0
655040;Deltaplan Simulator;Adventure, Indie;0 - 20,000;10;6;4;0;0;0
655080;Crazy Ball Adventures;Casual, Indie;20,000 - 50,000;148;28;120;0;0;0
655100;Oik 3;Adventure, Casual, Indie;50,000 - 100,000;670;87;583;220;237;2
655120;Space Hero Line;Action, Adventure, Indie;0 - 20,000;57;36;21;2;2;0
655160;welcome to heaven;Casual, Free to Play;50,000 - 100,000;381;137;244;12;14;0
655170;Telepathy Zero;Action, Indie;0 - 20,000;20;36;-16;0;0;0
655180;ThinkAhead;Adventure, Casual;0 - 20,000;9;4;5;0;0;0
655200;Arena;Casual, Indie, Simulation;0 - 20,000;5;0;5;0;0;0
655220;Freedom: A Time to Reckon;Adventure, Casual, Indie;0 - 20,000;5;4;1;0;0;0
655250;Insectophobia : Episode 1;Action, Casual, Indie, Racing, Early Access;0 - 20,000;11;22;-11;0;0;0
655270;EPONYMOUS;Indie, RPG, Strategy;0 - 20,000;36;14;22;0;0;0
655270;EPONYMOUS;Casual, Strategy;0 - 20,000;36;14;22;0;0;0
655280;Ping;Casual, Indie, Simulation;0 - 20,000;23;6;17;0;0;0
655290;Escape The Pacific;Action, Early Access;20,000 - 50,000;440;167;273;14;14;16
655340;Daath Origins;Massively Multiplayer, RPG, Utilities, Early Access;0 - 20,000;0;0;0;0;0;0
655360;Aftermath Y2K;Simulation;0 - 20,000;2;1;1;0;0;0
655370;Train Bandit;Casual;0 - 20,000;56;6;50;0;0;0
655380;Dig Dog;Indie, Racing, Simulation, Early Access;0 - 20,000;58;15;43;0;0;1
655420;Simple RTS;Action;0 - 20,000;12;3;9;0;0;0
655430;Tiger Hunt;Audio Production, Utilities, Early Access;0 - 20,000;11;3;8;0;0;0
655440;Panzer Killer;Indie;0 - 20,000;10;5;5;0;0;0
655460;Hooligan Vasja: Halloween;Indie, Racing;50,000 - 100,000;23;50;-27;0;0;0
655480;Solar Settlers;Adventure, Indie, RPG;20,000 - 50,000;262;11;251;0;0;2
655490;Geneticognito;Action, Adventure, Casual, Indie;0 - 20,000;7;0;7;0;0;1
655500;MX Bikes;Indie, Simulation;500,000 - 1,000,000;10208;625;9583;3055;4805;1947
655550;NOKBAK;Adventure, Indie;100,000 - 200,000;238;85;153;12;17;0
655580;Micro Cosmic Worlds;Simulation;0 - 20,000;4;2;2;0;0;0
655600;PHAT STACKS 2;Strategy;50,000 - 100,000;1;3;-2;0;0;0
655610;Horse Racing 2016;Indie;0 - 20,000;10;25;-15;0;0;0
655620;Krieg;Casual, Indie;0 - 20,000;22;7;15;0;0;0
655630;Paddle Battle;Indie, Sports, Early Access;0 - 20,000;11;7;4;88;88;0
655640;HOCKEY SPACE;Action, Casual, Indie;0 - 20,000;0;2;-2;0;0;0
655650;Mahjong Masters: Temple of the Ten Gods;Casual, Indie, Simulation;0 - 20,000;1;1;0;0;0;0
655660;Screaming Eagles;Action, Adventure, Casual, Indie, RPG, Simulation, Strategy;0 - 20,000;10;2;8;0;0;0
655700;F.E.X (Forced Evolution Experiment);Adventure, Casual, Indie;0 - 20,000;6;50;-44;211;211;0
655710;tick-hunter;Free to Play, RPG, Strategy, Early Access;0 - 20,000;5;11;-6;0;0;0
655730;This Strange Realm Of Mine;Casual, Indie, Strategy;0 - 20,000;414;80;334;146;207;2
655740;Tallowmere 2: Curse of the Kittens;Action, Casual, Indie;50,000 - 100,000;263;46;217;0;0;3
655760;Beast Mode: Night of the Werewolf;Racing;0 - 20,000;28;12;16;0;0;0
655760;Beast Mode: Night of the Werewolf;Casual, Indie, Strategy;0 - 20,000;28;12;16;0;0;0
655770;Crimson Gray;Action, Adventure, Indie, RPG;0 - 20,000;345;12;333;173;173;1
655780;Project 5: Sightseer;;20,000 - 50,000;327;135;192;115;115;11
655790;Fly Simulator;Action, Adventure, Indie;20,000 - 50,000;494;265;229;18;27;2
655910;BULLET PARTY;Action, Indie;20,000 - 50,000;74;3;71;7;7;0
655930;Merri Puzzle;Action, Adventure, Indie, Early Access;20,000 - 50,000;12;30;-18;0;0;0
655940;Elo Hell;RPG;0 - 20,000;11;8;3;0;0;0
655950;Exocomets;Casual, Indie, RPG, Simulation, Strategy;0 - 20,000;6;4;2;0;0;0
655980;Wonfourn;Violent, Gore, Action;0 - 20,000;2;11;-9;0;0;0
656020;Beta Runner;Casual, Indie;0 - 20,000;9;4;5;0;0;0
656030;The Lost Legends of Redwall: The Scout Act 1;Action, Indie;0 - 20,000;89;29;60;0;0;1
656040;The Wolf's Bite;Action, Adventure, Casual, Indie;0 - 20,000;42;7;35;0;0;0
656060;SkiFy;Casual, Indie;0 - 20,000;10;9;1;0;0;0
656070;Better Off Tread;Action, Indie;50,000 - 100,000;56;33;23;3;3;0
656120;Fantasya Final Definitiva REMAKE;Action, Strategy, Early Access;50,000 - 100,000;99;6;93;145;155;0
656130;King Erik;RPG;0 - 20,000;4;2;2;0;0;0
656140;PLANETS OF WAR;Free to Play, Indie, Strategy;20,000 - 50,000;117;101;16;7;7;0
656170;RadianVR;Indie;0 - 20,000;0;0;0;0;0;0
656190;THE HOUCHI PLAY -THE 放置プレイ-;Adventure;0 - 20,000;11;1;10;0;0;0
656200;电竞俱乐部/ESports Club;Casual, Simulation;200,000 - 500,000;826;723;103;586;766;1
656220;Sorcerer's Dream;Casual, Simulation, Sports, Strategy;20,000 - 50,000;4;4;0;0;0;0
656240;Heat;Adventure, Casual, Indie, Massively Multiplayer, RPG, Strategy;100,000 - 200,000;1422;1443;-21;2078;2314;14
656260;APEX Tournament;Casual, Indie, Strategy;0 - 20,000;7;2;5;0;0;0
656300;RD's Adventure Mini Golf;Action;0 - 20,000;1;3;-2;0;0;0
656320;Planet Protector VR;Action, Casual;0 - 20,000;7;2;5;0;0;0
656330;Outpost L5;Action, Casual, Indie, Massively Multiplayer, Strategy;0 - 20,000;13;3;10;0;0;0
656350;UnderMine;Racing, Simulation, Early Access;200,000 - 500,000;7284;589;6695;2127;956;134
656360;BOUNCED;Action, Indie, Sports;0 - 20,000;4;3;1;0;0;0
656380;Chicken Daddy;Free to Play, Massively Multiplayer, RPG;0 - 20,000;8;0;8;0;0;0
656400;Attrition: Tactical Fronts;Violent, Adventure, Casual;0 - 20,000;26;15;11;0;0;0
656440;Explomania;Casual, Indie;0 - 20,000;13;8;5;0;0;0
656450;Alien Hallway 2;Casual, Indie;20,000 - 50,000;93;44;49;0;0;1
656460;Vostok Inc.;Racing, Simulation, Sports;0 - 20,000;56;38;18;0;0;2
656460;Vostok Inc.;Adventure, Casual, Indie;0 - 20,000;56;38;18;0;0;2
656480;Hidden Animals: English - Spanish;Indie, Simulation;0 - 20,000;14;6;8;0;0;0
656490;Automobile Tycoon;RPG, Strategy;0 - 20,000;34;22;12;0;0;0
656510;Epic Car Factory;Adventure, Casual;20,000 - 50,000;131;80;51;0;0;1
656530;Pro Gamer Manager 2;Action, RPG, Early Access;0 - 20,000;25;142;-117;0;0;0
656550;Shadow Bug;Indie, Simulation, Strategy;0 - 20,000;98;5;93;0;0;0
656560;Castaway Home Designer;Action, Adventure, Indie;0 - 20,000;10;6;4;0;0;0
656570;In the Raven Shadow – Ve stínu havrana;Racing;20,000 - 50,000;71;12;59;0;0;0
656580;Claws of Furry;Action, Adventure, Indie, Strategy;0 - 20,000;13;12;1;0;0;0
656590;Eight-Minute Empire;Adventure, Indie;0 - 20,000;80;18;62;0;0;0
656600;Slash It Ultimate;Indie, Strategy;100,000 - 200,000;398;156;242;215;264;1
656610;Red Wake Carnage;Action, Casual, Indie;100,000 - 200,000;162;150;12;171;235;2
656620;Circuit Warz;Action, Adventure, Casual, Indie;0 - 20,000;11;9;2;0;0;0
656630;Dead of Night;Action, Adventure, Indie;0 - 20,000;10;1;9;0;0;0
656640;Kalzor: 2000;Casual, Indie;0 - 20,000;0;0;0;0;0;0
656660;Fantasy Mosaics 15: Ancient Land;Indie;0 - 20,000;9;0;9;0;0;1
656680;Bomb Defense;Indie, Simulation, Strategy;20,000 - 50,000;20;89;-69;0;0;0
656690;Medieval Steve;Casual, Indie;0 - 20,000;7;2;5;0;0;0
656700;RICO;Casual, Indie, Sports;0 - 20,000;279;128;151;125;136;2
656730;Block Robot Mini Survival Game;Casual, Free to Play, Indie, Massively Multiplayer, RPG, Simulation;0 - 20,000;0;5;-5;0;0;0
656770;Douarnenez VR;Action, Indie, Massively Multiplayer, RPG, Early Access;0 - 20,000;12;0;12;0;0;0
656780;Bullyparade - DER Spiel;Action, Adventure, Indie;0 - 20,000;6;15;-9;4;4;0
656830;Body of Evidence;Action, Indie, RPG, Early Access;0 - 20,000;6;9;-3;0;0;1
656880;Cybercube;Action, Indie;20,000 - 50,000;149;40;109;0;0;2
656890;Jewel Venture;Indie, RPG, Simulation, Strategy;0 - 20,000;5;5;0;0;0;0
656900;RHEM I SE: The Mysterious Land;Action, Indie;0 - 20,000;34;9;25;0;0;1
656910;Space Hit;Violent, Gore, Action, Indie;20,000 - 50,000;5;5;0;0;0;0
656940;The Theodore Adventures;Action, Adventure;0 - 20,000;18;16;2;0;0;0
656970;MagiCat;Casual, Indie, Simulation, Strategy;20,000 - 50,000;483;42;441;26;26;4
657000;Rising Hell;;0 - 20,000;243;22;221;19;19;2
657000;Rising Hell;Action, Casual, Indie;0 - 20,000;243;22;221;19;19;2
657010;Lucky Night: Texas Hold'em VR;Casual, Indie, Strategy;100,000 - 200,000;141;36;105;0;0;0
657020;Save Dash;Casual, Indie;0 - 20,000;3;0;3;0;0;0
657040;The Myth Seekers: The Legacy of Vulcan;Adventure, Indie, Early Access;20,000 - 50,000;150;26;124;18;18;2
657050;Humanity Must Perish;Adventure, Casual, Indie;0 - 20,000;176;35;141;0;0;0
657060;Himegimi Detective;Adventure, Indie, RPG;20,000 - 50,000;2;0;2;0;0;0
657070;Dream Hills: Captured Magic;Indie;0 - 20,000;51;14;37;0;0;1
657080;Project Taurus;Action, Casual, Indie, Massively Multiplayer;0 - 20,000;0;0;0;0;0;0
657110;2 Planets Fire and Ice;Action, Indie, Massively Multiplayer;0 - 20,000;12;9;3;0;0;0
657120;Flix and Chill 2: Millennials;Action, Adventure, Indie;0 - 20,000;42;7;35;13;13;0
657170;Shoot 'm Up;Violent, Gore, Adventure;0 - 20,000;7;3;4;0;0;0
657180;The Adliberum Engine (ADLENGINE);Action, Adventure, Indie;0 - 20,000;8;4;4;0;0;0
657200;Hand Simulator;Indie, RPG, Simulation, Strategy, Early Access;1,000,000 - 2,000,000;29584;5606;23978;207;108;75
657230;Spirit of the Ancient Forest;Casual, Indie, Strategy;0 - 20,000;7;32;-25;1;1;1
657240;Tracks - The Train Set Game;Action, Adventure, Indie;50,000 - 100,000;1065;68;997;890;1021;22
657260;救う(SHE SAVE);Action, Free to Play, Indie, Strategy;0 - 20,000;36;7;29;0;0;0
657280;Rytmik Studio;Action, Adventure, Indie, Early Access;0 - 20,000;223;38;185;17;20;6
657290;Blind Men;Violent, Action, Adventure, Indie, RPG, Strategy;0 - 20,000;53;10;43;0;0;0
657300;Party Crashers;Action, Indie, RPG;0 - 20,000;16;2;14;0;0;0
657320;Reverse Fantasy Legend;Indie;0 - 20,000;21;17;4;0;0;0
657400;Mimic Hunter;Action, Casual, Indie;0 - 20,000;2;5;-3;0;0;0
657410;Electronics Circuits Simulator;Action, Adventure;0 - 20,000;18;10;8;39;39;0
657440;Burn It Down;Strategy;0 - 20,000;56;13;43;0;0;0
657470;Take Off - The Flight Simulator;Casual, Indie, Strategy;20,000 - 50,000;49;61;-12;0;0;2
657480;Dark Skies: The Nemansk Incident;Casual, Indie;0 - 20,000;47;18;29;0;0;0
657500;Hold the Line: The American Revolution;Free to Play, Indie, Strategy;0 - 20,000;8;11;-3;0;0;0
657510;TUBELIVE;Indie, Simulation, Strategy, Early Access;0 - 20,000;52;3;49;0;0;0
657530;Impresja;Casual;0 - 20,000;28;12;16;0;0;0
657550;quadrantica;Casual;0 - 20,000;6;1;5;0;0;0
657560;Dodgeball;Casual, Indie;0 - 20,000;6;3;3;0;0;0
657590;Grav Blazer;Casual, Indie;0 - 20,000;58;56;2;0;0;0
657630;Fidget Spinner;Action, Indie;0 - 20,000;544;119;425;118;118;3
657690;The Caribbean Sail;Action, Adventure, Casual, Indie;20,000 - 50,000;397;22;375;142;142;1
657700;The Automatician;Indie, Simulation;0 - 20,000;13;8;5;0;0;0
657730;Wolflord - Werewolf Online;Simulation, Strategy;100,000 - 200,000;148;26;122;197;197;239
657780;Rome Circus Maximus: Chariot Race VR;Indie, Simulation, Strategy;0 - 20,000;3;4;-1;0;0;0
657790;Defense of Roman Britain;Adventure, Casual, Indie, Simulation;0 - 20,000;31;17;14;3;3;0
657810;Blessed Surface;Action, Casual, Indie;20,000 - 50,000;23;10;13;0;0;0
657860;Dragon's Prophet Turkiye;Casual, Indie;0 - 20,000;0;0;0;0;0;1
657930;Spartaga;Action, Adventure, Indie;0 - 20,000;41;1;40;0;0;0
657990;Crafting Dead;Action, Indie, Strategy;0 - 20,000;80;62;18;0;0;2
658050;The Dragons' Twilight;Action, Adventure, Free to Play, Massively Multiplayer, RPG;20,000 - 50,000;46;3;43;0;0;0
658060;Valentine Panic;Action, Free to Play, Indie;0 - 20,000;25;13;12;0;0;0
658090;Galaxy Crash;Indie, Sports;0 - 20,000;2;3;-1;0;0;0
658120;Mad Sector;Violent, Action, Adventure, Indie;0 - 20,000;11;10;1;0;0;0
658140;Sakura Sakura;Action, Adventure, Indie, Massively Multiplayer, RPG;0 - 20,000;39;6;33;0;0;0
658150;Skeleton Boomerang;Action, Free to Play, Indie, Simulation;0 - 20,000;130;5;125;0;0;1
658160;ClickRaid;Indie, Simulation, Sports, Early Access;20,000 - 50,000;233;55;178;127;127;1
658210;Mega Maze;RPG;0 - 20,000;7;4;3;0;0;0
658230;Chambered;Indie, Massively Multiplayer, Simulation, Strategy, Early Access;0 - 20,000;28;6;22;0;0;0
658250;Xtrike;Casual, Indie;0 - 20,000;0;1;-1;0;0;0
658260;BLUE REFLECTION;Casual, Indie;20,000 - 50,000;927;233;694;586;586;5
658320;Oldage;Action, Free to Play, Massively Multiplayer, Strategy, Early Access;100,000 - 200,000;204;89;115;2;4;0
658330;Triplicity;;0 - 20,000;18;2;16;0;0;0
658360;SUMMER VACATION;Adventure, Indie, Strategy;0 - 20,000;35;66;-31;0;0;0
658390;Tunnel Runner VR;Action, Adventure, Indie, RPG, Early Access;0 - 20,000;0;1;-1;0;0;0
658400;Baseball Mogul 2017;Violent, Gore, Action, Adventure, Indie;0 - 20,000;10;2;8;0;0;0
658420;Agents of Aggro City Online;Indie;100,000 - 200,000;4;6;-2;75;84;0
658430;Professor Watts Word Search: Into The Ocean;Violent, Gore, Action, Indie;0 - 20,000;31;36;-5;1;1;0
658440;Enshrouded World: Home Truths;Casual, Indie;0 - 20,000;1;2;-1;0;0;0
658450;Lil' Blue Buddy;Action, Casual, Indie;0 - 20,000;3;2;1;0;0;0
658470;Mini Battlegrounds;Adventure, Casual, Indie;100,000 - 200,000;368;207;161;21;33;0
658480;Starfighter General;Action, Casual, Indie, Early Access;20,000 - 50,000;11;1;10;0;0;0
658490;Drive Isle;Casual, Indie;0 - 20,000;57;36;21;0;0;0
658500;Ultra Space Battle Brawl;Adventure, Casual, Indie;0 - 20,000;73;7;66;0;0;0
658510;Dark Eden Origin;;20,000 - 50,000;32;47;-15;1;1;0
658530;Grisaia Phantom Trigger Vol.3;Indie;0 - 20,000;127;4;123;0;0;0
658550;Zup! Zero 2;Action, Adventure, Indie, RPG;100,000 - 200,000;917;50;867;229;268;3
658560;Zup! 7;Violent, Gore, Adventure, Indie, RPG;100,000 - 200,000;1860;86;1774;105;114;2
658570;FURIDASHI: Drift Cyber Sport;Action, Indie;200,000 - 500,000;995;213;782;105;105;1
658590;She and the Light Bearer;Action, Indie;0 - 20,000;220;30;190;0;0;0
658600;Lawnmower Game;Casual, Indie, Simulation;0 - 20,000;370;82;288;0;0;1
658610;位面穿越者-三国传(A Bit Crosser-Three Kingdoms);Action, Indie;20,000 - 50,000;31;68;-37;0;0;0
658620;Wonderful Everyday Down the Rabbit-Hole;;20,000 - 50,000;1107;63;1044;0;0;9
658630;Anonymous ME;Violent, Action, Adventure, Indie;20,000 - 50,000;155;140;15;0;0;0
658660;Way of Defector;Action, Casual, Indie;0 - 20,000;30;25;5;0;0;0
658660;Way of Defector;Casual, Indie, Strategy;0 - 20,000;30;25;5;0;0;0
658690;Rage in Peace;Action, Indie;0 - 20,000;289;31;258;0;0;1
658700;V-Rally 4;Casual, Indie;50,000 - 100,000;474;263;211;61;80;7
658710;Pine Seekers;Action, Casual, Indie, Early Access;0 - 20,000;0;1;-1;0;0;0
658760;Teal;Action, Adventure, Indie;20,000 - 50,000;3;0;3;0;0;0
658770;Dreamals: Dream Quest;Action, Adventure, Indie;0 - 20,000;7;1;6;0;0;0
658780;Bomb Chicken;Action, Indie, Strategy;0 - 20,000;231;18;213;539;539;1
658790;Samurai Riot Definitive Edition;Action, Adventure, Simulation;0 - 20,000;55;14;41;0;0;0
658800;Fantasy Mosaics 16: Six Colors in Wonderland;Sexual Content, Violent, RPG;0 - 20,000;9;1;8;0;0;0
658810;Flux8;Adventure, Casual, Indie;0 - 20,000;14;2;12;0;0;0
658830;Artificer: Science of Magic;Casual, Indie;0 - 20,000;51;23;28;0;0;0
658850;Do Not Feed the Monkeys;Adventure, RPG;500,000 - 1,000,000;7276;487;6789;435;309;72
658870;EXIT 2 - Directions;Casual, Free to Play, Indie;0 - 20,000;10;0;10;0;0;0
658880;Jammerball;Casual, Indie, Strategy;0 - 20,000;0;4;-4;0;0;0
658890;Arthurian Legends;Indie;20,000 - 50,000;328;22;306;0;0;1
658970;CasinoRPG;RPG;50,000 - 100,000;147;88;59;19;19;18
658980;Valnir Rok Survival RPG;Action, Casual, Indie;20,000 - 50,000;444;496;-52;43;43;1
658990;Icycle: On Thin Ice;Adventure;0 - 20,000;77;5;72;0;0;0
659000;Meta Star;Indie;0 - 20,000;10;6;4;0;0;0
659040;Intrusion Protocol;Action, Adventure, Indie;0 - 20,000;14;1;13;0;0;0
659060;Omega Racers;Action, Indie;0 - 20,000;8;1;7;0;0;0
659110;Vicious Attack Llama Apocalypse;Adventure, Casual, Indie;0 - 20,000;51;15;36;0;0;0
659120;Survive;Violent, Gore, Action, Adventure, RPG;0 - 20,000;21;37;-16;0;0;0
659160;Rain of Pumpkins;Adventure, Indie;;;;0;;;
659170;Super Flipside;Indie, Simulation, Strategy;0 - 20,000;8;0;8;0;0;0
659180;Medieval Mystery Match;Action, Casual, Indie, Early Access;0 - 20,000;7;0;7;0;0;0
659190;Sorry, James;Violent, Adventure, Indie, RPG;50,000 - 100,000;613;158;455;228;239;0
659220;PROJECT MAZE;Casual, Indie, Simulation;0 - 20,000;15;5;10;0;0;0
659260;Canvas Quest;Adventure, Free to Play;0 - 20,000;19;2;17;0;0;0
659320;Pixel Pursuit;Action, Indie;0 - 20,000;4;0;4;0;0;0
659460;RiotZ;Action, Adventure, Indie;50,000 - 100,000;7;10;-3;239;231;0
659480;The Initiate;Action, Adventure, Indie;20,000 - 50,000;154;42;112;977;977;0
659490;Devil In The Capital;Casual, Indie, Strategy;0 - 20,000;6;9;-3;2;2;0
659500;A Mining Game;;20,000 - 50,000;115;60;55;0;0;2
659510;Ghostie Quest;Action, Casual, Indie;0 - 20,000;3;1;2;0;0;0
659540;Warsim: The Realm of Aslona;Action, Casual, Free to Play, Indie;20,000 - 50,000;1024;28;996;175;175;19
659560;VITATIO;Action, Casual, Indie;0 - 20,000;23;6;17;0;0;0
659570;LQVE: Lion Quest Versus Expanded;Action, Casual, Indie;0 - 20,000;5;1;4;0;0;0
659630;Tiny Toyfare;Indie, Sports;50,000 - 100,000;27;11;16;0;0;0
659720;Xenocite Clad;Free to Play, Indie;0 - 20,000;4;0;4;0;0;0
659780;Darkness and a Crowd;Free to Play, Massively Multiplayer, Strategy;0 - 20,000;1;1;0;0;0;0
659790;Hero of the Galactic Core;Action, Casual, Indie, Strategy;0 - 20,000;1;2;-1;0;0;0
659810;bead;Nudity, Action;0 - 20,000;3;7;-4;0;0;0
659860;作业本战记（exercise book epic）;Adventure, Casual;0 - 20,000;23;2;21;0;0;0
659870;Don't Die!;Casual, Indie;0 - 20,000;1;1;0;0;0;0
659890;Fantasy Mosaics 17: New Palette;Action, Adventure, Casual, Indie, RPG, Strategy;0 - 20,000;8;0;8;0;0;1
659900;Aetherspace;Casual, Free to Play, Indie, Massively Multiplayer, Simulation, Sports, Strategy;20,000 - 50,000;45;26;19;2;2;1
659910;Loptice;Action, Adventure, Indie;0 - 20,000;2;3;-1;0;0;0
659920;Transports;Adventure, Casual, Indie, Simulation;0 - 20,000;68;31;37;0;0;0
659940;Travel Riddles: Trip To France;Violent, Gore, Action, Adventure, Casual, Free to Play, Massively Multiplayer;0 - 20,000;17;1;16;0;0;0
659950;Travel Riddles: Trip To Italy;Adventure, Casual, Indie;0 - 20,000;13;6;7;0;0;0
659960;隐世神剑传;Action, Adventure, Indie;0 - 20,000;349;198;151;0;0;0
660030;Fantasy Mosaics 18: Explore New Colors;Adventure, Casual;0 - 20,000;10;0;10;0;0;0
660040;Diving Trunks;Action, Adventure, Simulation, Strategy;0 - 20,000;8;0;8;0;0;0
660070;Chromatic;Casual, Indie;0 - 20,000;21;3;18;0;0;0
660110;DepthMera;Casual, Free to Play, Indie;0 - 20,000;4;1;3;0;0;0
660120;Lunch Truck Tycoon 2;Adventure, Indie, RPG, Simulation;0 - 20,000;2;8;-6;0;0;0
660170;Haunted Hotel: Stay in the Light;Indie, RPG, Strategy;0 - 20,000;6;9;-3;0;0;0
660180;Seduction 誘惑;Action, Indie;0 - 20,000;11;59;-48;0;0;0
660270;Space Scumbags;Strategy;0 - 20,000;5;8;-3;0;0;0
660280;Keep It Safe 2;Action, Indie;0 - 20,000;1;3;-2;0;0;0
660290;Dungeons & Geese;Action, Indie;20,000 - 50,000;32;20;12;5;5;0
660320;M.A.C.E. Tower Defense;Racing;0 - 20,000;35;14;21;0;0;0
660330;Ragnarok RE:START;Adventure, Indie;20,000 - 50,000;73;116;-43;0;0;0
660340;Robot King Part I: Rebooted and Ready;Sexual Content, Nudity, Violent, Action, Indie;0 - 20,000;21;28;-7;0;0;0
660390;RageBall;Indie, Simulation, Strategy, Early Access;0 - 20,000;4;18;-14;12;12;0
660400;SQUAREHEAD;Indie;0 - 20,000;8;5;3;0;0;0
660450;Orbs;Casual, Free to Play, Indie, Simulation;0 - 20,000;6;2;4;0;0;0
660520;The IOTA Project;Casual, Indie;20,000 - 50,000;63;22;41;8;8;0
660560;Fishing on the Fly;Action, Indie, Strategy, Early Access;0 - 20,000;4;4;0;0;0;0
660570;Million Arthur VR: Character Command RPG;Action, RPG, Strategy;0 - 20,000;9;5;4;0;0;0
660730;Ventura Inc;Action, Adventure, Casual, Indie, RPG;0 - 20,000;10;4;6;0;0;0
660760;Bouncing Odyssey;Action, Indie;0 - 20,000;3;0;3;0;0;0
660820;Retro Block VR;Adventure, Casual, Indie, RPG, Simulation, Early Access;0 - 20,000;0;1;-1;0;0;0
660830;Tanks2.DE;Action, Indie, Strategy;0 - 20,000;56;31;25;0;0;0
660830;Tanks2.DE;Action, Indie, Strategy;0 - 20,000;56;31;25;0;0;0
660880;b;Action;;;;0;;;
660900;Dark Mystery;Indie, Simulation, Strategy;0 - 20,000;8;6;2;0;0;0
660920;The Warhorn;Adventure, Indie;0 - 20,000;182;130;52;0;0;2
660940;Law Mower;Action, Adventure, Indie, RPG;0 - 20,000;5;3;2;0;0;0
660970;Persian: The Great Lamp Heist;Action, Adventure, Indie, Simulation;0 - 20,000;1;0;1;0;0;0
660980;Quantum Wizard;Indie, Simulation;0 - 20,000;7;0;7;0;0;0
660990;Dead Purge: Outbreak;Casual, Indie, Racing;0 - 20,000;39;48;-9;56;56;0
661000;Flow:The Sliding;Free to Play, Massively Multiplayer, RPG;20,000 - 50,000;222;66;156;9;10;0
661030;Aliens&Asteroids;Action, Indie, Simulation;0 - 20,000;15;1;14;0;0;0
661040;Time Trap - Hidden Objects Puzzle Game;Action, Adventure, Indie, Massively Multiplayer, RPG;20,000 - 50,000;102;40;62;0;0;0
661050;Quadrablaze;Adventure, Casual;0 - 20,000;5;2;3;0;0;0
661070;Perigee;Action;0 - 20,000;2;0;2;0;0;0
661100;Abraxas Interactive's PUSH;Adventure, Casual, Indie;0 - 20,000;1;0;1;0;0;0
661110;Shattered God - Quest for the Divine Relic;Violent, Gore, Action, Adventure, Indie, RPG, Simulation, Strategy, Early Access;0 - 20,000;2;10;-8;0;0;0
661120;Mercury: Cascade into Madness;Strategy;0 - 20,000;38;8;30;106;181;0
661130;ChilloutVR;Casual, Simulation;200,000 - 500,000;1840;345;1495;134;155;81
661180;Simplefield;Casual, Simulation;;;;0;;;
661190;UNDEFINED;Casual, Indie, Strategy;20,000 - 50,000;0;6;-6;0;0;0
661200;Cymatically Muffed;Action, Adventure;0 - 20,000;20;0;20;0;0;0
661220;Cutthroat Gunboat;Adventure, Casual, Indie;0 - 20,000;18;2;16;0;0;0
661230;Progress Bar Simulator;Simulation;0 - 20,000;76;10;66;0;0;1
661240;Visitors: Marine Invasion;Action, Adventure, Indie, RPG;0 - 20,000;12;13;-1;0;0;0
661250;Jarheads;Action, Indie;0 - 20,000;0;0;0;0;0;0
661260;Bad Thoughts;Action, Adventure, Casual, Indie, RPG;0 - 20,000;10;6;4;0;0;0
661270;Valhall 2000;Adventure, Casual, Indie;0 - 20,000;4;0;4;0;0;0
661280;Dresden Files Cooperative Card Game;Adventure, RPG, Strategy;0 - 20,000;86;21;65;246;246;0
661290;Arizona Derby;Casual, Indie, Massively Multiplayer, Strategy;0 - 20,000;459;148;311;0;0;0
661300;Radical Spectrum: Volume 2;RPG;20,000 - 50,000;8;10;-2;168;168;0
661330;Layers;Action, Casual, Indie;0 - 20,000;5;1;4;0;0;0
661340;TYRED;Adventure, Indie, RPG;0 - 20,000;3;0;3;0;0;0
661360;Glitchbuster;Indie;0 - 20,000;6;0;6;0;0;1
661380;Orbit Defender;Action, Adventure, Casual, Indie;0 - 20,000;4;2;2;0;0;0
661380;Orbit Defender;Adventure, Casual, Indie;0 - 20,000;4;2;2;0;0;0
661410;The Unclogging: An Unsanitary Saga;Action, Indie, Early Access;0 - 20,000;0;1;-1;0;0;0
661420;Run For Coins;Adventure, Indie, RPG;0 - 20,000;1;1;0;0;0;0
661430;LineWay;Action, Casual, Indie, Massively Multiplayer, Simulation;20,000 - 50,000;421;28;393;130;235;2
661440;Prelude for a Dream;Casual, Indie;0 - 20,000;8;3;5;0;0;0
661450;The Lighthouse;Adventure, Indie, RPG, Simulation, Early Access;20,000 - 50,000;35;5;30;0;0;0
661460;Thin Judgment;Casual, Indie;0 - 20,000;13;13;0;0;0;0
661470;The Gateway Trilogy;Action, Casual, Indie;0 - 20,000;26;14;12;0;0;0
661480;UniOne;Casual, Indie;0 - 20,000;23;2;21;0;0;0
661490;Insert Paper;Adventure;0 - 20,000;13;20;-7;0;0;0
661500;Rekindling;Casual, Indie;0 - 20,000;23;6;17;0;0;0
661520;Archangel;Violent, Gore, Action, Adventure, Indie, Early Access;0 - 20,000;8;16;-8;0;0;0
661530;Gold Rush In The Oort Cloud;Action, Casual, Indie;20,000 - 50,000;7;14;-7;0;0;0
661550;Space Geekz - The Crunchy Flakes Conspiracy;Casual, Indie, Simulation, Strategy;0 - 20,000;2;0;2;0;0;0
661560;Audioship;Casual, Indie;0 - 20,000;2;2;0;0;0;0
661610;Yama;Casual, Indie;0 - 20,000;1;4;-3;0;0;0
661650;Roll Out;Casual, Indie;0 - 20,000;2;1;1;0;0;0
661660;Blood Ancestors;Casual, Indie, Strategy;0 - 20,000;16;8;8;0;0;0
661670;Renegade Grounds: Episode 1;Casual, Indie;0 - 20,000;7;5;2;1;1;0
661680;Growbot;Casual, Indie, RPG, Simulation;0 - 20,000;92;10;82;0;0;0
661690;Primal Lands;Casual, Indie, Strategy;20,000 - 50,000;1;3;-2;0;0;0
661700;心の闇の先に Trial VersionⅡ;Casual, Indie, Simulation, Strategy;0 - 20,000;15;8;7;0;0;0
661730;Dawn of H'btakh;Indie, RPG;0 - 20,000;3;1;2;0;0;0
661740;Morphite;Action, Indie;20,000 - 50,000;72;29;43;0;0;2
661790;Witch Hunt;Casual, Indie;200,000 - 500,000;1779;233;1546;233;325;7
661820;I.F.O;Simulation, Sports;0 - 20,000;30;0;30;0;0;0
661830;Lunarsea;Adventure, Indie, Simulation;0 - 20,000;47;18;29;86;86;0
661900;Planetbound;Indie;0 - 20,000;5;4;1;0;0;0
661920;Claybook;Action, Adventure, Casual, Simulation;0 - 20,000;170;71;99;38;38;0
661920;Claybook;Action, Indie;0 - 20,000;170;71;99;38;38;0
661940;Regular Human Basketball;Adventure, Indie, RPG;50,000 - 100,000;289;65;224;99;136;1
661950;FlyingRock: Arena;Casual, Indie;20,000 - 50,000;28;22;6;12;13;1
661950;FlyingRock: Arena;Adventure, Casual;20,000 - 50,000;28;22;6;12;13;1
661960;Dragon Lords: 3D Strategy;Adventure, Indie, RPG;20,000 - 50,000;84;31;53;14;14;3
661990;Arcana Heart 3 LOVEMAX SIXSTARS!!!!!! XTEND;Sexual Content, Violent, Gore, Adventure, Casual, Indie;50,000 - 100,000;227;45;182;249;249;5
662170;Secrets of the Past: Mother's Diary;Casual, Indie;0 - 20,000;3;0;3;0;0;1
662180;Signals of Chaos;Adventure, Casual, Indie, Simulation;0 - 20,000;0;1;-1;0;0;0
662190;The Secret Order 6: Bloodline;Action, Adventure, Casual, Indie;20,000 - 50,000;155;15;140;141;150;3
662200;Swim Out;Indie, Sports;0 - 20,000;32;6;26;0;0;0
662210;Metal as Phuk;Casual, Indie, Simulation;0 - 20,000;236;11;225;0;0;0
662230;Trendpoker 3D: Texas Hold'em Poker;Action, Adventure, Casual, Indie, Simulation, Early Access;0 - 20,000;58;24;34;0;0;4
662240;Epitasis;Action, Adventure, Indie, Simulation;20,000 - 50,000;106;34;72;0;0;1
662260;On Earth As It Is In Heaven - A Kinetic Novel;Adventure, Casual, Indie, RPG, Simulation;0 - 20,000;14;1;13;0;0;0
662320;METRO CONFLICT: THE ORIGIN;Adventure, RPG;200,000 - 500,000;816;688;128;106;101;0
662380;Project X;Action, Adventure, Indie;0 - 20,000;5;11;-6;0;0;0
662390;Squish and the Corrupted Crystal;Action;0 - 20,000;2;0;2;0;0;0
662400;Steampunk Action Battle Simulator;Adventure;0 - 20,000;3;5;-2;0;0;0
662410;Circuit Dude;Adventure, Indie;0 - 20,000;16;0;16;0;0;0
662470;SoundLites;Action, Adventure, Massively Multiplayer, Strategy, Early Access;20,000 - 50,000;18;8;10;2;2;0
662500;Vault Resort;Action, Adventure, Indie;0 - 20,000;3;3;0;0;0;0
662540;Haque;Design & Illustration, Utilities, Web Publishing, Early Access;0 - 20,000;133;19;114;0;0;0
662550;Beraltors;Casual, Indie, Strategy;0 - 20,000;4;0;4;0;0;0
662570;United Tactics;Simulation;0 - 20,000;0;0;0;0;0;0
662610;SpaceMerc;Action, Adventure, Indie, RPG;0 - 20,000;5;2;3;0;0;0
662620;Speedway Challenge League;Action, Casual, Indie, Simulation, Sports;0 - 20,000;32;3;29;0;0;0
662660;Dirty Fighter 2;Violent, Gore, Adventure, Casual, Indie;0 - 20,000;3;2;1;0;0;0
662680;Beetle Uprising;Casual, Indie, Simulation;0 - 20,000;51;14;37;0;0;0
662690;Fos;Adventure, Indie, RPG;0 - 20,000;4;1;3;0;0;0
662700;Chop and Drop VR;Animation & Modeling, Design & Illustration;20,000 - 50,000;42;17;25;156;307;0
662780;Crystal Reign;Casual, Indie, Simulation, Sports;0 - 20,000;12;2;10;0;0;0
662830;Bombix;Indie, Sports;200,000 - 500,000;931;411;520;5366;5374;20
662840;Abo Khashem;Action, Adventure, Indie, RPG;0 - 20,000;36;11;25;0;0;0
662870;The Cerberus Project: Horde Arena FPS;Action, Indie;0 - 20,000;8;2;6;0;0;0
662910;Cash Crop;Animation & Modeling, Audio Production, Design & Illustration, Utilities, Video Production, Web Publishing;0 - 20,000;25;8;17;0;0;0
662920;WESTSLINGERS;Strategy;0 - 20,000;32;6;26;0;0;0
662930;Dominari Empires;Action, Indie, Simulation, Sports, Strategy;0 - 20,000;63;1;62;0;0;1
662940;Never Not Shooting;Action, Casual;0 - 20,000;1;0;1;0;0;0
662950;CloudCity VR;Action;0 - 20,000;1;12;-11;0;0;0
662950;CloudCity VR;Casual, Indie, Simulation;0 - 20,000;1;12;-11;0;0;0
662960;Mysteria ~Occult Shadows~;Casual, Indie, Simulation;100,000 - 200,000;2135;1064;1071;384;176;2
662990;Eddy紫 ~Eddy Violet~;Strategy;0 - 20,000;53;12;41;0;0;0
663020;Cutlass;Design & Illustration, Photo Editing, Video Production;0 - 20,000;1;3;-2;0;0;0
663060;Cycle (轮回);Free to Play, Indie;0 - 20,000;13;19;-6;0;0;0
663080;RectRacer;Adventure, Casual, Indie;0 - 20,000;1;0;1;0;0;0
663090;Granado Espada;Casual, Indie, Sports;100,000 - 200,000;651;416;235;36;67;1803
663100;Thrust & Shoot : Flight School;Adventure, Casual, Indie;20,000 - 50,000;11;6;5;0;0;0
663110;Sunrise: survival;Action, Adventure, Indie, Simulation, Sports;;;;0;;;
663120;The Rosebud Condominium;Action, Indie, Early Access;0 - 20,000;12;5;7;0;0;0
663130;Game Tengoku CruisinMix Special;Casual, Indie, Simulation, Strategy, Early Access;0 - 20,000;56;16;40;0;0;0
663140;Robby's Adventure;Action, Indie;0 - 20,000;10;5;5;0;0;0
663160;Pocket Universe : Create Your Community;Action, Indie, Early Access;0 - 20,000;6;9;-3;0;0;0
663170;Prime Shift;Animation & Modeling, Design & Illustration;0 - 20,000;3;2;1;0;0;0
663190;Dream Coaster VR Remastered;Indie, Simulation, Sports;0 - 20,000;44;35;9;30;30;2
663200;Rift Coaster HD Remastered VR;Free to Play, Indie;0 - 20,000;32;48;-16;0;0;0
663210;12 Labours of Hercules VII: Fleecing the Fleece (Platinum Edition);Indie;0 - 20,000;134;14;120;1555;1555;6
663220;Bottle_Shooter;Action, Adventure, Indie;0 - 20,000;0;2;-2;0;0;0
663240;All You Can Eat;Action, Adventure, Simulation, Strategy;20,000 - 50,000;272;68;204;0;0;0
663250;Professional Farmer: American Dream;;0 - 20,000;3;4;-1;0;0;1
663290;Dead by Death;Adventure, Casual, Indie;0 - 20,000;9;14;-5;0;0;0
663300;Enlightenment;Casual, Early Access;20,000 - 50,000;296;158;138;0;0;0
663370;The Zwuggels - A Beach Holiday Adventure for Kids;Action, Indie;0 - 20,000;78;3;75;1592;1592;0
663380;Tales from Candlekeep: Tomb of Annihilation;Indie, Racing;200,000 - 500,000;1351;586;765;437;437;2
663390;Rento Fortune: Online Dice Board Game (大富翁);Indie, Simulation;200,000 - 500,000;1461;1445;16;460;339;44
663410;Circle Up;Indie, Simulation;0 - 20,000;5;6;-1;0;0;0
663430;This is not RPG;Indie, Strategy;0 - 20,000;5;4;1;0;0;0
663480;Fungoids - Steam version;Adventure, Casual, Indie, RPG, Simulation, Early Access;0 - 20,000;3;2;1;0;0;0
663530;Dragon's Lunch;Action, Adventure, RPG, Early Access;0 - 20,000;2;2;0;0;0;0
663540;Murder...;Adventure, Casual, Indie, Strategy;0 - 20,000;14;8;6;0;0;0
663590;Foxfolk;Action, Adventure, Indie;0 - 20,000;24;4;20;0;0;0
663600;Genie;Adventure, Indie;0 - 20,000;1;0;1;0;0;0
663670;Killer Queen Black;Indie, RPG;50,000 - 100,000;492;42;450;108;108;1
663690;Rival Rampage;Casual, Indie, RPG, Simulation, Strategy;0 - 20,000;43;8;35;467;886;0
663760;Outgun;Action, Simulation;100,000 - 200,000;15;3;12;0;0;0
663830;George VS Bonny PP Wars;Violent, Action, Casual, Simulation;0 - 20,000;48;25;23;0;0;0
664000;HammerHelm;Violent, Gore, Action, Adventure;0 - 20,000;256;58;198;0;0;3
664030;Time To Walk Alone;Adventure, Casual, Indie, RPG, Simulation;20,000 - 50,000;2;3;-1;0;0;0
664040;Staff Wars: Wizard Rumble;Casual, Indie;0 - 20,000;4;2;2;0;0;0
664050;StopTime Drive;Action, Casual, Free to Play, Indie;20,000 - 50,000;5;1;4;3;3;0
664050;StopTime Drive;Action, Adventure, Casual, Indie, Sports;20,000 - 50,000;5;1;4;3;3;0
664060;Willful;Adventure, Indie;0 - 20,000;8;2;6;0;0;0
664080;Turn your Destiny;Action, Indie, Early Access;0 - 20,000;0;1;-1;0;0;0
664090;Eternity Warriors VR;Action, Adventure, Indie;20,000 - 50,000;257;56;201;11;11;1
664110;Void Wisp;Violent, Gore, Action, Adventure, Casual, Indie;0 - 20,000;1;0;1;0;0;0
664120;Wildlife Park Gold Reloaded;Action, Indie;20,000 - 50,000;4;13;-9;0;0;0
664130;僕と彼の危険な同居生活;Action, Casual, Indie;0 - 20,000;11;15;-4;0;0;0
664160;Shn!p;Indie, Simulation, Strategy;0 - 20,000;6;0;6;0;0;0
664190;Slide!!;Action, Indie, Early Access;20,000 - 50,000;8;1;7;0;0;0
664210;Boxed In;Indie, Simulation, Strategy;0 - 20,000;10;1;9;0;0;0
664240;RetroWar: 8-bit Party Battle;Action, Indie, Sports, Early Access;0 - 20,000;9;0;9;0;0;0
664250;EquiMagic - Galashow of Horses;Action, Adventure, Casual, Indie, RPG, Simulation, Strategy;0 - 20,000;15;5;10;0;0;0
664290;The Mexican Dream;Casual, Indie, Simulation;0 - 20,000;79;48;31;190;190;0
664320;Holy Potatoes! What the Hell?!;Violent, Action, Adventure, Indie, RPG;20,000 - 50,000;65;64;1;87;87;5
664340;Indeep | The casual dungeon crawler;Action, Adventure, Indie;0 - 20,000;5;7;-2;0;0;0
664350;German Fortress 3D;Adventure, Strategy;0 - 20,000;19;34;-15;0;0;0
664420;Girls and Quiz;Indie;0 - 20,000;11;10;1;0;0;0
664430;WWE 2K18;Indie, RPG, Strategy, Early Access;200,000 - 500,000;1155;1010;145;1702;2405;11
664440;Cognizant Protocol;Action, Adventure;0 - 20,000;5;0;5;0;0;0
664450;Manifest 99;Indie;0 - 20,000;58;8;50;41;41;0
664460;Ultimate Summer;Adventure, Casual, Indie, Simulation, Sports, Strategy;20,000 - 50,000;26;1;25;0;0;0
664510;Infernal Racket;Action, Indie;0 - 20,000;12;6;6;0;0;0
664530;Legends of Iskaria: Days of Thieves;Action, Casual, Indie, Simulation, Strategy;0 - 20,000;37;8;29;0;0;0
664560;DreamTank;Adventure, Casual, Indie;0 - 20,000;5;2;3;0;0;0
664570;My Personal Angel;Adventure, Free to Play, Massively Multiplayer, RPG;0 - 20,000;11;13;-2;0;0;0
664590;Airi's World;Action, Adventure, Indie;0 - 20,000;5;2;3;0;0;0
664600;Memories of Home;Action, Adventure, Indie, RPG;0 - 20,000;0;2;-2;0;0;0
664610;Gelu;Adventure, Casual, Indie;0 - 20,000;96;23;73;12;12;0
664620;Pink Rage Otome;Action, Adventure, Indie;0 - 20,000;32;23;9;0;0;0
664630;Tupã;Strategy;0 - 20,000;6;10;-4;0;0;0
664650;Canadian Football 2017;Violent, Action, Casual, Indie;0 - 20,000;22;12;10;0;0;1
664660;Against the Gradient;Casual, Indie, Strategy;0 - 20,000;2;0;2;0;0;0
664720;VRange;Violent, Gore, Action, Adventure, Casual, Indie, Massively Multiplayer, RPG, Early Access;0 - 20,000;0;8;-8;0;0;0
664750;Wrongworld;Action, Adventure, Indie;20,000 - 50,000;418;24;394;3954;3954;1
664780;Alter Ego;Design & Illustration, Education, Utilities, Early Access;0 - 20,000;25;14;11;0;0;0
664820;Ether Awakening;Adventure, Free to Play, Indie, RPG;0 - 20,000;7;0;7;0;0;0
664830;Zombotron;Casual, Indie, Simulation;100,000 - 200,000;2054;252;1802;404;524;12
664840;Heavy Fire: Red Shadow;Casual, Free to Play, Indie;0 - 20,000;0;0;0;0;0;0
664850;8-bit Adventure Anthology: Volume I;Action, Indie, Early Access;20,000 - 50,000;50;6;44;34;34;0
664870;Forgotten Faces;Casual, Indie;0 - 20,000;4;12;-8;0;0;0
664890;Undoing;Adventure, Casual, Indie;0 - 20,000;5;4;1;0;0;0
665030;Zeran's Folly;Indie;0 - 20,000;51;16;35;0;0;0
665040;Visual Novel Engine;Casual, Indie;20,000 - 50,000;78;29;49;3;3;1
665060;Triangulate;Action, Casual, Indie;20,000 - 50,000;1;1;0;0;0;0
665080;Stunt Corgi VR;Adventure, Indie;0 - 20,000;10;5;5;0;0;0
665090;The Initial;Action, Casual, Indie;200,000 - 500,000;1454;449;1005;186;226;0
665120;Jetman Go;Violent, Gore, Adventure, Indie;0 - 20,000;141;35;106;0;0;0
665140;Midnight at the Red Light : An Investigation;Action, Adventure, Indie;0 - 20,000;10;11;-1;0;0;0
665160;Puzzle Mania;Action, Adventure, Indie;0 - 20,000;1;0;1;0;0;0
665180;Dark Elf;Simulation, Early Access;200,000 - 500,000;4470;515;3955;201;198;6
665200;imos VR LOFT;Action, Casual, Free to Play, Indie, Simulation, Sports;0 - 20,000;7;12;-5;0;0;0
665210;Hoop Shot VR;Action, Indie;0 - 20,000;3;1;2;0;0;0
665240;Fateholders of Tetsoidea;Action, Indie;0 - 20,000;9;4;5;0;0;0
665270;弹幕音乐绘 ～风雷幻奏曲～ / Barrage Musical  ~A Fantasy of Tempest~;Action, Indie, Strategy, Early Access;20,000 - 50,000;319;12;307;0;0;0
665300;Stream Avatars;Action, Indie, Racing;100,000 - 200,000;1502;71;1431;8415;9362;1283
665310;Tank Battle: Pacific;Action, Indie;0 - 20,000;18;6;12;0;0;0
665310;Tank Battle: Pacific;Indie, Sports, Strategy;0 - 20,000;18;6;12;0;0;0
665330;Wrestling Revolution 3D;Gore;20,000 - 50,000;331;48;283;0;0;1
665340;Ancient Amuletor VR;Action, Adventure, Indie;0 - 20,000;19;2;17;0;0;0
665350;Mayhem Above;Adventure, Indie, Simulation;0 - 20,000;8;1;7;0;0;0
665360;Comedy Night;Casual, Indie, Simulation;500,000 - 1,000,000;6049;2012;4037;209;221;37
665370;Mutilate-a-Doll 2;Adventure, Casual, Indie;100,000 - 200,000;1387;96;1291;878;1626;35
665440;Civil War: Gettysburg;Action, Casual, Indie;0 - 20,000;27;5;22;0;0;3
665450;MAGIX Photostory 2018 Deluxe Steam Edition;Action, RPG;0 - 20,000;4;5;-1;0;0;0
665490;The Monster Inside;Casual, Simulation;100,000 - 200,000;1389;193;1196;7;8;1
665510;Vengeance: Lost Love;Indie, Simulation, Strategy;0 - 20,000;18;36;-18;0;0;0
665550;Death Runner;Free to Play, Indie, RPG, Strategy;0 - 20,000;6;2;4;0;0;0
665560;Skyward;Casual, Indie;0 - 20,000;3;3;0;0;0;0
665590;DOG GONE GOLFING;Action, Free to Play, Massively Multiplayer;20,000 - 50,000;37;9;28;18;18;0
665620;Zombie Hobby VR;Nudity, Violent, Gore, Action, Adventure, Casual, Indie, RPG, Simulation, Strategy;0 - 20,000;11;6;5;0;0;0
665630;Marble Masters: The Pit;Casual, Indie, Simulation, Strategy;0 - 20,000;2;0;2;0;0;0
665640;SpaceWorms;Action, Adventure, Indie, Sports;0 - 20,000;12;3;9;0;0;0
665670;Enlysia;Action, Indie, Simulation, Early Access;0 - 20,000;4;7;-3;0;0;0
665680;Fighter Creator;Action, Simulation, Sports;0 - 20,000;2;8;-6;0;0;0
665730;Fight Sparring VR;Education;0 - 20,000;5;3;2;0;0;0
665740;Book Of Potentia 2;Action, Free to Play, Indie, Racing, Simulation, Sports, Early Access;20,000 - 50,000;77;28;49;16;25;0
665740;Book Of Potentia 2;Casual, Indie;20,000 - 50,000;77;28;49;16;25;0
665780;Juke;Adventure, Indie, Simulation;0 - 20,000;1;0;1;0;0;0
665790;Dragon Drop;Action, Adventure, Casual, Indie;0 - 20,000;7;0;7;0;0;0
665840;To The Sea : The Courier;Casual, Indie, Simulation;0 - 20,000;16;2;14;0;0;0
665880;Survivor VR;Action, Adventure, Casual, Indie, Strategy, Early Access;0 - 20,000;2;5;-3;0;0;0
665890;Jay Fighter: Remastered;Action, Indie;;;;0;;;
665900;火箭星战 Star-Rocket Strike;Action, Indie, RPG;0 - 20,000;2;0;2;0;0;0
665920;SHOWMAKER;Adventure;0 - 20,000;59;9;50;9;9;0
665930;Rock 'N Roll;Action, Indie, Racing, Simulation, Sports, Early Access;0 - 20,000;17;4;13;0;0;0
665950;Creepy Races;Animation & Modeling, Design & Illustration, Education, Utilities;0 - 20,000;3;2;1;0;0;0
665960;Lobster Empire;Action, Adventure, Casual, Indie, Simulation, Sports;0 - 20,000;21;21;0;0;0;0
665980;Aquaponics Life;Violent, Action;0 - 20,000;0;0;0;0;0;0
666010;Refract;Adventure, Casual, Indie;0 - 20,000;29;3;26;0;0;0
666020;Shark Dating Simulator XL+;Action, Casual, Indie;20,000 - 50,000;788;107;681;44;60;1
666040;Underdone;Adventure, Casual, Indie;0 - 20,000;5;3;2;0;0;0
666050;Rescue Team 7;Action, Indie, Strategy;0 - 20,000;37;4;33;0;0;2
666060;Derelict Fleet;Indie;0 - 20,000;0;2;-2;0;0;0
666080;伝創記IV ~if~;Adventure, Casual, Indie;0 - 20,000;0;3;-3;0;0;0
666090;Bad Government;Animation & Modeling, Design & Illustration, Education, Utilities;20,000 - 50,000;3;6;-3;0;0;0
666100;Shooty Fruity;Indie;0 - 20,000;171;19;152;0;0;5
666110;Break The Cookie;Casual, Indie, RPG;0 - 20,000;1;1;0;0;0;0
666120;Dawn of the killer zombies;Adventure, Casual, Indie, RPG, Strategy;0 - 20,000;1;6;-5;146;146;0
666120;Dawn of the killer zombies;Adventure, Free to Play, Simulation;0 - 20,000;1;6;-5;146;146;0
666140;My Time At Portia;Adventure, Indie;1,000,000 - 2,000,000;36360;2948;33412;2207;645;848
666150;Prehistoric Kingdom;Action, Casual, Indie, Massively Multiplayer;100,000 - 200,000;1392;292;1100;81;136;40
666170;Space Betrayers;Action, Indie;0 - 20,000;1;0;1;0;0;0
666220;CS2D;Action, Indie, Strategy, Early Access;1,000,000 - 2,000,000;7728;852;6876;68;22;28
666250;Equalizer;Action, Indie;0 - 20,000;37;55;-18;0;0;0
666260;Formless Adventure;Casual;0 - 20,000;18;15;3;195;359;0
666270;Endure;;0 - 20,000;0;0;0;0;0;0
666290;Virus Z;Casual, Indie, Simulation;0 - 20,000;37;26;11;11;11;0
666310;Space of Darkness;Action, Adventure, Indie;0 - 20,000;50;53;-3;10;10;0
666320;Watergate Xtreme;Action, Adventure;0 - 20,000;5;7;-2;0;0;0
666330;Inertia;Indie, Strategy;50,000 - 100,000;514;91;423;56;86;2
666340;Inescapable VR: Underground;Nudity, Indie;0 - 20,000;30;3;27;0;0;0
666560;No Mans Land;Indie, RPG;0 - 20,000;4;9;-5;0;0;0
666570;Infectonator 3: Apocalypse;Indie, Simulation, Strategy;100,000 - 200,000;682;147;535;775;893;6
666590;Jetball;Action, Adventure, Indie;0 - 20,000;6;0;6;0;0;0
666600;Zombie Town;Action, Indie, Racing;0 - 20,000;12;2;10;0;0;0
666610;Endless ATC;Action, Indie;20,000 - 50,000;303;8;295;0;0;14
666620;BEHIND THESE EYES: A Short Horror Story;Action, Adventure, Indie, RPG, Strategy;0 - 20,000;9;15;-6;0;0;0
666630;The Captives: Plot of the Demiurge;Indie, Strategy;0 - 20,000;18;1;17;0;0;0
666640;Empire - Wargame of new Century;Action, Adventure, Indie, RPG;0 - 20,000;6;4;2;0;0;1
666660;Castles;Adventure, Free to Play, Indie;0 - 20,000;7;5;2;0;0;0
666730;This Merchant Life;Casual, Indie;20,000 - 50,000;117;39;78;0;0;1
666780;4th of July VR;Indie, RPG, Strategy, Early Access;0 - 20,000;1;0;1;0;0;0
666790;Knossos;Action, Casual, Indie;0 - 20,000;2;0;2;0;0;0
666800;Solitaire - Cat Pirate Portrait;Action, Adventure, Casual, Indie;20,000 - 50,000;21;11;10;0;0;0
666800;Solitaire - Cat Pirate Portrait;Action, Free to Play, Indie, Massively Multiplayer;20,000 - 50,000;21;11;10;0;0;0
666810;Luna;Adventure;0 - 20,000;10;0;10;0;0;0
666850;Beyond the Horizon;Action, Adventure, Indie;0 - 20,000;4;1;3;0;0;0
666860;Bit Heroes;Adventure, Indie;500,000 - 1,000,000;2174;511;1663;1612;192;250
666910;Malfunction;Adventure, Indie;0 - 20,000;5;1;4;0;0;0
666930;Luxocraft;Action, Casual, Indie;0 - 20,000;6;8;-2;0;0;0
666940;Welcome Back To 2007;Action, Adventure, Indie, Early Access;20,000 - 50,000;138;44;94;0;0;0
666960;Cowboy's Adventure;Adventure, Casual, Indie;20,000 - 50,000;36;46;-10;0;0;0
667000;Casus Belli: Battle Of Annihilation;Action, Casual, Indie;0 - 20,000;9;2;7;0;0;0
667010;Dracula: Vampires vs. Zombies;Casual, Indie;0 - 20,000;26;2;24;0;0;0
667030;Archimedes: Eureka!;Action, Adventure, Indie;0 - 20,000;10;6;4;0;0;0
667040;Alicia Quatermain 2: The Stone of Fate;Sexual Content, Nudity, Violent, Adventure, Indie, RPG;0 - 20,000;67;5;62;0;0;3
667050;SojournVR;Action, Casual, Indie;0 - 20,000;4;7;-3;0;0;0
667060;No Escape;Action, Adventure, Indie;0 - 20,000;4;3;1;0;0;0
667110;Altar Show;Casual, Indie;0 - 20,000;9;2;7;0;0;0
667120;iTownGamePlay UNIVERSE;Action, Indie, RPG;20,000 - 50,000;22;26;-4;0;0;0
667130;Clumsy Fred;Indie;0 - 20,000;35;17;18;0;0;0
667160;Sphere Frustration;Action, Indie, Sports, Early Access;0 - 20,000;19;3;16;0;0;0
667170;Undead Souls;Action, Casual, Simulation;0 - 20,000;1;10;-9;0;0;0
667220;Ayo: A Rain Tale;Action, Adventure, Indie;0 - 20,000;25;7;18;0;0;0
667240;Vintage Hero;Action, Indie;0 - 20,000;13;1;12;12;12;0
667270;The Miserable Crimson Hooded Girl;Adventure, Indie;0 - 20,000;12;2;10;0;0;0
667300;aMAZE 3D;Action, Adventure, Casual, Indie;0 - 20,000;70;59;11;0;0;0
667310;Animal Herding;Casual;0 - 20,000;7;15;-8;0;0;0
667340;Anxiety;Action, Adventure, Indie, Early Access;0 - 20,000;2;4;-2;0;0;0
667360;Hooligan Vasja: Christmas;RPG, Strategy;50,000 - 100,000;23;39;-16;1;1;0
667400;Mazeglaser;Casual, Indie;0 - 20,000;1;0;1;0;0;0
667410;The Nose;Violent, Action, Indie;0 - 20,000;1;2;-1;0;0;0
667420;Redium;Action, Casual, Indie, Early Access;20,000 - 50,000;35;34;1;17;17;0
667450;Fire Fighter;Adventure, Indie, RPG, Early Access;0 - 20,000;0;1;-1;0;0;0
667510;The Elmian Warrior;Violent, Action;20,000 - 50,000;2;2;0;0;0;0
667530;Drunken Wrestlers 2;Adventure, Casual, Indie;500,000 - 1,000,000;9180;1064;8116;141;47;121
667550;PION;Casual, Free to Play, Indie, Simulation, Sports;0 - 20,000;22;3;19;0;0;1
667600;Sky Force Reloaded;Action, Adventure, Indie;200,000 - 500,000;1761;123;1638;0;0;22
667610;Ancient Cities;Action, Adventure, Indie;20,000 - 50,000;547;399;148;24;24;31
667620;HEXION;Action;0 - 20,000;20;7;13;0;0;0
667630;Snake Charmer - TPS Snek;Adventure;0 - 20,000;0;1;-1;0;0;0
667660;Photon Rush;Indie;0 - 20,000;6;0;6;0;0;0
667670;Expanse;Indie, RPG;0 - 20,000;2;1;1;0;0;0
667690;Bedlamball;Action, Indie;0 - 20,000;14;0;14;0;0;0
667720;Red Faction Guerrilla Re-Mars-tered;Action, Adventure, Casual, Indie, Simulation;500,000 - 1,000,000;2665;656;2009;252;148;64
667760;Super Lumi Live;Adventure, Casual, Indie, Early Access;0 - 20,000;30;0;30;0;0;0
667770;Nano Shift;Audio Production;0 - 20,000;17;4;13;0;0;0
667780;Rosebaker's Icy Treats - The VR Iceman Sim;Video Production;0 - 20,000;24;1;23;0;0;0
667790;Downbreak;Video Production;0 - 20,000;25;6;19;0;0;1
667800;Loco Dojo;Indie, Simulation, Strategy, Early Access;0 - 20,000;48;6;42;0;0;0
667810;Next Up Hero;Racing, Simulation, Sports;20,000 - 50,000;100;81;19;172;334;0
667840;Dungeon Builder S;Action, Indie;0 - 20,000;7;8;-1;0;0;0
667870;MINDNIGHT;Action, Adventure, Indie, Simulation, Early Access;200,000 - 500,000;2498;457;2041;703;421;17
667880;Dog Theatre;Casual, Indie;0 - 20,000;6;2;4;0;0;0
667890;Dead Maze;Action, Indie, Racing;1,000,000 - 2,000,000;3266;1120;2146;185;43;133
667900;Brave;Action, Casual, Indie;0 - 20,000;1;3;-2;0;0;0
667920;Survival Tycoon;Adventure, Casual, Indie;0 - 20,000;35;34;1;1;1;0
667930;StickDodgeVR;Action, Indie;0 - 20,000;3;3;0;0;0;0
667970;VTOL VR;Violent, Gore, Action, Indie;500,000 - 1,000,000;10205;213;9992;558;460;420
668010;Goalie VR;Indie, Simulation, Strategy, Early Access;0 - 20,000;11;2;9;7;7;0
668020;Hindenburg 3D;Casual, Free to Play;0 - 20,000;2;0;2;0;0;0
668030;Blue Flame VR;Adventure, Casual, Indie;0 - 20,000;2;1;1;0;0;0
668170;Incline;Racing;100,000 - 200,000;227;219;8;18;21;1
668190;Wordabeasts;Action, Simulation;0 - 20,000;7;4;3;0;0;0
668200;Four Horsemen;Action, Adventure, Casual, Indie;0 - 20,000;8;3;5;0;0;0
668210;Super Fancy Pants Adventure;Indie, RPG;100,000 - 200,000;1350;132;1218;112;149;6
668220;Breadwinner VR;Action, Adventure, Indie;0 - 20,000;2;1;1;0;0;0
668230;SLI-FI: 2D Planet Platformer;RPG;0 - 20,000;28;0;28;0;0;0
668280;BackSlash;Action, Adventure, Indie;0 - 20,000;18;2;16;0;0;0
668290;From Orbit;Casual, Indie;0 - 20,000;5;5;0;0;0;0
668300;Chinese Souls-Hua Garden/华夏园;Action, Casual;0 - 20,000;20;17;3;0;0;0
668320;Perilous Warp;Action, Casual, Indie, Strategy;0 - 20,000;207;64;143;162;162;1
668350;Higurashi When They Cry Hou - Ch.6 Tsumihoroboshi;Casual, Indie, RPG, Simulation, Sports, Strategy;20,000 - 50,000;431;6;425;0;0;3
668360;Bokuten - Why I Became an Angel;Action, Strategy;0 - 20,000;66;12;54;0;0;1
668430;V-Racer Hoverbike;Animation & Modeling, Design & Illustration;0 - 20,000;209;23;186;26;26;1
668490;VR conference;Adventure, Indie, Strategy;0 - 20,000;4;4;0;0;0;0
668510;Kartofank VR;Adventure, Casual, Indie;0 - 20,000;6;0;6;0;0;0
668520;ExZeus 2;Adventure, Casual, Indie, RPG, Simulation, Strategy;0 - 20,000;4;2;2;0;0;0
668550;8Doors: Arum's Afterlife Adventure;Action, RPG;100,000 - 200,000;721;200;521;475;475;11
668570;Jack & the cat;Casual, Indie;0 - 20,000;3;0;3;0;0;0
668590;Omen Exitio: Plague;Action, Indie, Racing, Strategy;20,000 - 50,000;400;57;343;251;251;1
668600;Pixelum;Casual, Free to Play, Massively Multiplayer, RPG, Sports, Early Access;20,000 - 50,000;25;32;-7;0;0;0
668610;Lords of War;Adventure, Indie;0 - 20,000;28;16;12;0;0;0
668620;1Dimensional Desperado;Casual, Racing;0 - 20,000;0;0;0;0;0;0
668630;Tricolour Lovestory;Casual, Indie;1,000,000 - 2,000,000;22319;3271;19048;598;166;67
668650;Hookbots;Indie, Simulation, Strategy, Early Access;0 - 20,000;22;0;22;0;0;0
668660;CUR3D Steam Edition;Action, Indie, Early Access;0 - 20,000;38;6;32;0;0;1
668670;Glasswinged Ascension;Adventure, Casual, Indie;0 - 20,000;9;17;-8;0;0;0
668680;鬼畜大冒险 Gui Chu Da Mao Xian;Adventure, RPG;0 - 20,000;169;52;117;27;27;0
668730;Legends Of Iona RPG (2007);Action, Adventure, RPG;0 - 20,000;11;11;0;0;0;0
668770;Solarium;Indie;50,000 - 100,000;86;41;45;5;6;0
668780;The Puppet of Tersa: Episode One;Action, Casual, Indie;0 - 20,000;19;3;16;0;0;0
668790;Chicken Wars;Action, Casual, Indie, Strategy;0 - 20,000;11;1;10;0;0;0
668800;OtterBash;Casual;0 - 20,000;5;0;5;0;0;0
668830;Raid On Coasts;Violent, Gore, Action, Indie, Simulation, Sports, Strategy;0 - 20,000;27;28;-1;0;0;0
668840;Dead Moon - Revenge on Phobos -;Action, Adventure, Indie;0 - 20,000;10;10;0;0;0;0
668850;The Istrys;Action, Casual, Indie;0 - 20,000;8;3;5;0;0;0
668860;Christmastry;Casual;0 - 20,000;0;0;0;0;0;0
668890;Hiking Simulator 2017;Action, Free to Play, Massively Multiplayer, Strategy;0 - 20,000;31;36;-5;0;0;0
668910;Breeze of Death;Action, Adventure, Indie;0 - 20,000;3;9;-6;0;0;0
668960;Esper - Make You Live Again;Casual, Free to Play, Indie, Simulation;0 - 20,000;8;0;8;0;0;0
668970;Space Waver;Action, Casual, Indie, Simulation, Sports;0 - 20,000;11;1;10;0;0;0
668980;Forsaken Remastered;Indie;0 - 20,000;155;19;136;0;0;1
669000;Six-ear Macaque;Violent, Gore, Adventure, Casual, Indie, Strategy;0 - 20,000;6;5;1;0;0;0
669040;Whispered Secrets: Into the Beyond Collector's Edition;Action, Adventure, Indie, RPG;0 - 20,000;5;0;5;0;0;0
669050;Mutiny!!;Adventure, Casual, Indie, Racing, RPG, Simulation, Sports, Strategy;0 - 20,000;218;30;188;1;1;0
669280;Les Quatre Alices;Action, Adventure, Indie;0 - 20,000;21;0;21;0;0;0
669290;Espire 1: VR Operative;Action, Indie, Massively Multiplayer, Simulation, Early Access;100,000 - 200,000;261;231;30;77;90;1
669310;Brave Path;Action, Indie;0 - 20,000;9;1;8;0;0;0
669320;NationWar:Chronicles | 国战:列国志传;Action, Indie, RPG;20,000 - 50,000;307;135;172;161;161;0
669340;The Royal Cosmonautical Society;Adventure, Indie;0 - 20,000;16;1;15;0;0;0
669350;Outracer;Adventure, Casual, Indie, Simulation;0 - 20,000;5;3;2;0;0;0
669360;Infested Nation;Nudity, Violent, Adventure, Indie;0 - 20,000;3;2;1;0;0;0
669380;Astoria: The Holders of Power Saga;Adventure, Indie, RPG;0 - 20,000;71;8;63;0;0;1
669390;Lethal Laser;Action, Adventure, Indie, Early Access;0 - 20,000;31;6;25;0;0;0
669410;Exatron Quest L'Epée de Sang;Violent, Action, Casual, Indie, Sports;0 - 20,000;9;0;9;0;0;0
669440;IKAROS;Action, Casual, Indie;20,000 - 50,000;27;9;18;0;0;0
669440;IKAROS;Action, Indie, Early Access;20,000 - 50,000;27;9;18;0;0;0
669490;BlockDude;Action, Indie;0 - 20,000;6;3;3;0;0;0
669500;Himeko Sutori;Adventure, Indie;0 - 20,000;163;49;114;21;21;2
669520;Mino Saga;RPG;0 - 20,000;3;3;0;0;0;0
669570;MicroSpy;Gore, Action, Adventure, Casual, Indie, Simulation, Strategy;0 - 20,000;2;4;-2;0;0;0
669580;The Ultimatest Battle;Indie, Strategy;200,000 - 500,000;405;109;296;10;13;0
669600;Light in the dark;Casual;0 - 20,000;62;31;31;0;0;0
669630;Hollowed;Action, Casual, Indie;50,000 - 100,000;116;30;86;101;101;0
669650;Tiny Thief;Adventure, Casual, Indie;0 - 20,000;2;4;-2;0;0;0
669660;Debris;Action, Adventure, Casual, Indie, Strategy, Early Access;20,000 - 50,000;85;41;44;0;0;0
669690;Funny Fingers;Sexual Content, Violent, Gore, Adventure, Indie;0 - 20,000;1;0;1;0;0;0
669700;PROJECT AZRIEL;Indie, RPG;0 - 20,000;3;1;2;0;0;0
669710;Outburst;Action, Adventure, Indie, RPG;0 - 20,000;31;5;26;0;0;0
669710;Outburst;Adventure, Indie, Simulation;0 - 20,000;31;5;26;0;0;0
669730;Mind Trap;Adventure, Indie;0 - 20,000;4;9;-5;0;0;0
669740;Tower Bombarde;Adventure, Casual, Indie;0 - 20,000;7;1;6;0;0;0
669750;Brain Storm : Tower Bombarde;Casual, Indie;0 - 20,000;16;18;-2;0;0;0
669760;One Bit;Indie, Massively Multiplayer, RPG, Strategy;0 - 20,000;1;0;1;0;0;0
669770;Strangers in a Strange Land;Action, Indie, Simulation, Early Access;0 - 20,000;51;38;13;0;0;0
669830;Asteroids Millennium;Adventure, Casual, Indie, Simulation;0 - 20,000;23;5;18;0;0;1
669910;Miles & Kilo;Action, Adventure, Casual, Indie;0 - 20,000;61;3;58;0;0;0
669950;BDSM: Big Drunk Satanic Massacre;Action, Indie;50,000 - 100,000;922;117;805;268;296;2
669960;The Dungeon Power;RPG;0 - 20,000;12;4;8;0;0;0
669990;Crucial Throw;Action, Adventure, Indie, RPG, Simulation, Strategy, Early Access;0 - 20,000;2;0;2;0;0;0
670020;Solar System Journey VR;Action, Indie;0 - 20,000;1;1;0;0;0;0
670060;Defenders of Ekron;Racing, Early Access;0 - 20,000;21;0;21;0;0;0
670080;SuperLuminauts;Casual, Simulation;0 - 20,000;3;6;-3;0;0;0
670090;FallenCore;Adventure, Indie, RPG, Strategy;0 - 20,000;22;14;8;0;0;0
670100;Mint;Indie, Simulation, Strategy, Early Access;20,000 - 50,000;41;35;6;0;0;0
670130;Jam Studio VR;Action, Free to Play, Simulation;0 - 20,000;11;2;9;0;0;0
670140;Destiny of a Wizard;Sexual Content, Violent, Free to Play;0 - 20,000;5;0;5;0;0;0
670160;D'LIRIUM;Action, Adventure, Casual, Indie, Racing, Strategy;20,000 - 50,000;845;43;802;0;0;2
670180;Castles II: Siege & Conquest;Free to Play, Massively Multiplayer, Simulation, Strategy;0 - 20,000;20;4;16;0;0;2
670210;Otto the Odd Ostrich;Action, Indie;0 - 20,000;3;0;3;0;0;0
670230;Omega Extinction;Simulation, Strategy;0 - 20,000;3;0;3;0;0;0
670240;Snappy Turtle Ultimate;Casual;0 - 20,000;6;2;4;0;0;0
670260;Solace Crafting;Free to Play, Indie;20,000 - 50,000;543;173;370;829;829;12
670270;Wings of Peace VR: DayBreak;Education, Utilities;0 - 20,000;3;3;0;0;0;0
670280;In Dungeon;Action, Indie, Simulation, Strategy;0 - 20,000;15;2;13;0;0;0
670290;Real Pool 3D - Poolians;Action, Adventure, Indie;500,000 - 1,000,000;6530;1731;4799;239;84;595
670320;PAPA'S TIME MACHINE;Action, Indie, Early Access;0 - 20,000;8;4;4;0;0;0
670330;Flight 732;Simulation;0 - 20,000;5;4;1;0;0;0
670340;Mysterious Adventure of Michael;Action, Casual, Indie;0 - 20,000;4;2;2;0;0;0
670350;The Free Ones;Action, Casual, Indie;50,000 - 100,000;594;159;435;196;202;1
670370;Fallen Cube;Adventure, Indie, RPG;0 - 20,000;6;26;-20;0;0;0
670400;Malatzshia;Indie, Strategy;0 - 20,000;10;2;8;0;0;0
670410;Citadale: The Legends Trilogy;Sexual Content, Nudity, Violent, Gore, Adventure, Indie, Simulation, Strategy;0 - 20,000;7;10;-3;0;0;0
670430;Colorless Life;Adventure, RPG;0 - 20,000;22;21;1;0;0;0
670430;Colorless Life;Nudity, Violent, Gore, Action, Indie;0 - 20,000;22;21;1;0;0;0
670440;Obscure - Challenge Your Mind;Adventure, Casual, Indie;0 - 20,000;12;12;0;2;2;0
670450;MAGIX Audio Cleaning Lab 2017 Steam Edition;Action, Casual, Indie;0 - 20,000;5;2;3;0;0;0
670460;MAGIX Video deluxe 2017 Steam Edition;Casual, Indie, Strategy, Early Access;0 - 20,000;22;15;7;0;0;3
670470;MAGIX Video deluxe 2018 Steam Edition;Adventure, Indie;0 - 20,000;13;11;2;19123;19123;1
670490;Rise of Man;Violent, Action, Adventure, Free to Play, RPG, Simulation;20,000 - 50,000;26;114;-88;0;0;0
670500;RC Plane 3;Action, Early Access;50,000 - 100,000;137;86;51;266;331;5
670610;Swaps and Traps;Action, Indie, Racing, Simulation;0 - 20,000;69;2;67;0;0;0
670620;SURV;Action, Indie, Racing, Sports;0 - 20,000;7;6;1;7;7;0
670630;Slingshot Puzzle;Adventure, Indie, Simulation, Early Access;0 - 20,000;17;3;14;0;0;0
670720;Stealthscape;Adventure, Casual, Indie, Early Access;0 - 20,000;28;1;27;0;0;0
670730;Sure Footing;Action, Indie;0 - 20,000;12;21;-9;0;0;0
670750;0°N 0°W;Action, Casual, Indie, Sports;20,000 - 50,000;243;39;204;0;0;1
670780;Albert Mort - Desert Heat;Action, Casual, Indie, Massively Multiplayer;0 - 20,000;5;7;-2;0;0;0
670820;Civitatem;Action, Indie, Racing;0 - 20,000;78;42;36;0;0;3
670830;VR Trivia Battle;Action, Adventure, Indie;20,000 - 50,000;16;11;5;0;0;0
670850;Sokoban Land DX;Violent, Gore, Action, Adventure;0 - 20,000;15;3;12;0;0;0
670900;NASCAR Heat 2;Action, Adventure, Indie;20,000 - 50,000;246;131;115;12;12;1
670910;AHTS Ship Simulator;Violent, Gore, Action, Casual;0 - 20,000;2;9;-7;0;0;0
670940;The Voice in the Void;Design & Illustration;0 - 20,000;1;0;1;0;0;0
670950;Band of Outlaws;Casual, Free to Play;0 - 20,000;20;3;17;0;0;0
670970;Res Judicata: Vale of Myth;Action, Adventure, Casual, Indie;0 - 20,000;0;0;0;0;0;0
671050;XMinutes: Wings;Indie, Strategy;0 - 20,000;5;2;3;0;0;0
671090;Oik Memory;Action, Indie;0 - 20,000;166;24;142;177;177;0
671120;Spaceship Trucker;Indie, Simulation, Strategy;0 - 20,000;7;1;6;0;0;0
671150;Explosive Dinosaurs;Action, Casual, Indie;0 - 20,000;8;0;8;0;0;1
671170;Great eSports Manager;Free to Play, Indie, Sports, Early Access;0 - 20,000;100;19;81;0;0;0
671180;Elementals Reborn;Action, Indie, Simulation;0 - 20,000;4;4;0;0;0;0
671190;Pro Motion NG;Adventure, Simulation, Early Access;0 - 20,000;114;10;104;114;114;15
671200;GAIA 2200;Casual;0 - 20,000;23;12;11;0;0;0
671230;Spirits: Ciel Bleu;Indie, Simulation;0 - 20,000;3;1;2;0;0;0
671240;七个小矮人2 / Seven boys 2;Indie, Simulation, Strategy, Early Access;20,000 - 50,000;67;27;40;1;1;0
671260;GOKEN;Free to Play, Indie, Simulation, Strategy;20,000 - 50,000;53;25;28;0;0;0
671270;Stophat;Adventure, Indie, RPG;0 - 20,000;14;3;11;0;0;0
671290;Deadliners;Action, Indie;0 - 20,000;2;1;1;0;0;0
671310;Pararea--Social VR for Everyone (Beta);Violent, Action, Adventure, Early Access;50,000 - 100,000;22;16;6;1;1;0
671330;Lit the Torch;Action, Indie;0 - 20,000;20;0;20;0;0;0
671370;Flight of Light;Action, Indie, Early Access;0 - 20,000;2;0;2;0;0;0
671390;Metropolis: Lux Obscura;Action, Casual, Indie;20,000 - 50,000;336;89;247;0;0;0
671440;Rise of Industry;Action, Indie;200,000 - 500,000;2798;927;1871;368;256;62
671470;CARSTEROIDS;;0 - 20,000;5;0;5;0;0;0
671480;MokMok;Casual, Indie;0 - 20,000;3;1;2;0;0;0
671490;Princess Sahirah is a Spoiled Brat!;Adventure, Casual, Indie;0 - 20,000;0;2;-2;0;0;0
671510;DESOLATE;Racing;200,000 - 500,000;4934;2385;2549;273;199;55
671540;Pizza Hunt! How to hunt pizza (And Not Die Doing It);Action, Racing;0 - 20,000;5;1;4;0;0;0
671550;Brickochet;Adventure, Indie;0 - 20,000;87;2;85;0;0;1
671560;Iggy's Zombie A-Pug-Alypse;Action, Indie, Simulation;0 - 20,000;10;0;10;0;0;0
671580;NeoCube;Strategy;20,000 - 50,000;5;4;1;0;0;0
671600;Ashes of Oahu;Casual, Free to Play, Indie, Racing;0 - 20,000;32;18;14;0;0;0
671610;Warfork;Casual;200,000 - 500,000;1395;169;1226;0;0;9
671620;Beast Battle Simulator;Action, Adventure, Free to Play, Massively Multiplayer, RPG;50,000 - 100,000;875;136;739;393;425;10
671630;STRIPPER ANYA DEMON SLAYER;Casual, Indie, Simulation;0 - 20,000;12;10;2;0;0;0
671640;Deadburg;Indie, Simulation, Early Access;0 - 20,000;73;10;63;0;0;0
671650;Mad Age & This Guy;Action, Adventure, Indie;20,000 - 50,000;90;14;76;22;22;0
671670;Village Of Souls;Action, Adventure, Indie;0 - 20,000;7;9;-2;0;0;0
671690;[MARS] Total Warfare;Action, Indie, Early Access;0 - 20,000;72;27;45;0;0;2
671700;Dead Horizon;Gore, Adventure, Indie, Early Access;0 - 20,000;312;18;294;9;9;0
671720;Robin;Free to Play, Indie, Simulation, Strategy;50,000 - 100,000;517;76;441;19;17;0
671740;VR SHOOT AROUND - Realistic basketball simulator -;Adventure;0 - 20,000;34;8;26;0;0;0
671750;ColorCode;Action;0 - 20,000;2;0;2;0;0;0
671800;Run!ZombieFood!;Action, Casual, Indie, Racing, Sports;50,000 - 100,000;900;203;697;98;117;17
671810;The Adventures of Capitano Navarro;Indie;0 - 20,000;18;36;-18;3;3;0
671810;The Adventures of Capitano Navarro;Strategy;0 - 20,000;18;36;-18;3;3;0
671840;Eat, Sleep, Bet, Repeat;Action, Adventure, Indie, RPG;0 - 20,000;12;3;9;0;0;0
671850;Dormant World;Casual, Indie;0 - 20,000;0;3;-3;0;0;0
671860;BattleBit Remastered;Adventure;0 - 20,000;0;0;0;0;0;0
671880;Tower Offence!;Action, Indie, RPG, Early Access;0 - 20,000;4;1;3;0;0;0
671900;Devoid of Shadows;Indie;0 - 20,000;120;74;46;0;0;0
671900;Devoid of Shadows;Indie, Strategy;0 - 20,000;120;74;46;0;0;0
671920;Dead Secret Circle;Casual, Indie;0 - 20,000;45;18;27;0;0;0
671970;Junkyard Simulator;Indie, Simulation, Strategy, Early Access;50,000 - 100,000;609;501;108;1008;2013;15
671980;Close Me;Sexual Content, Nudity, Adventure, Casual, Indie, RPG, Simulation;20,000 - 50,000;81;23;58;0;0;0
671990;B99;Adventure, Indie;0 - 20,000;5;1;4;0;0;0
672000;System Goose Overload;Violent, Action, Casual, Free to Play, Indie, Strategy;0 - 20,000;64;8;56;0;0;0
672000;System Goose Overload;Action, Adventure;0 - 20,000;64;8;56;0;0;0
672010;CANARI;Casual, Indie;0 - 20,000;2;0;2;0;0;0
672020;Hold My Beer;Action, Adventure;0 - 20,000;43;5;38;0;0;1
672030;Swap Blocks;Action, Indie;0 - 20,000;6;1;5;0;0;0
672040;WarFallen;Action, Adventure, Indie;0 - 20,000;28;17;11;0;0;0
672050;Super Mr. Kake;Action, Casual, Indie, RPG;0 - 20,000;5;14;-9;0;0;0
672080;Cube Creatures;Action, Simulation, Sports;0 - 20,000;4;0;4;0;0;0
672100;An Occasional Dream;Free to Play;0 - 20,000;7;0;7;0;0;0
672130;Damned Hours;Indie;0 - 20,000;3;5;-2;0;0;0
672140;Battle For Korsun;Action, Indie;0 - 20,000;5;12;-7;0;0;0
672150;LOGistICAL 3: Earth;Action, Indie;0 - 20,000;103;16;87;0;0;17
672160;OldMaidGirl;Adventure, Casual, Indie;0 - 20,000;53;22;31;0;0;0
672220;Unlimited;Violent, Gore, RPG, Early Access;0 - 20,000;3;3;0;0;0;0
672230;I fell from Grace;Action, Casual, Indie, Sports;0 - 20,000;52;18;34;0;0;0
672240;Dreams of Greatness;Action, Adventure, Indie, Simulation;0 - 20,000;10;4;6;0;0;0
672250;Plexus;Casual, Indie, Simulation, Strategy, Early Access;0 - 20,000;18;7;11;0;0;0
672280;Gates of Horn and Ivory;Action, Casual, Indie;0 - 20,000;6;1;5;0;0;0
672290;Magic Forest;Violent, Gore, Action, Indie;0 - 20,000;27;10;17;0;0;0
672300;Air Traffic Disruptor;Action, Casual, Indie;0 - 20,000;2;0;2;0;0;0
672310;Kingdoms Of Marazia: Classic;Action, Indie, RPG, Strategy;0 - 20,000;16;5;11;0;0;0
672320;The Last Sorcerer;Sexual Content, Nudity, Violent, Action, Indie;0 - 20,000;2;4;-2;0;0;0
672380;Ameline and the Ultimate Burger;Simulation;0 - 20,000;5;8;-3;0;0;0
672410;Access;Violent, Gore, Action, Indie;0 - 20,000;3;0;3;0;0;0
672430;Koe (声);Casual, RPG, Strategy;0 - 20,000;0;0;0;0;0;0
672450;Z ViRus: V.I.R.M Uprising;Action, Adventure, Indie;0 - 20,000;1;0;1;0;0;0
672460;Genetic Disaster;Action, Adventure, Indie, Simulation, Early Access;0 - 20,000;63;36;27;0;0;0
672480;Mini Hockey VR;Action, Adventure, Indie;0 - 20,000;1;2;-1;0;0;0
672490;DeDrive;Action, Casual, Indie, Early Access;0 - 20,000;13;2;11;899;899;0
672570;The Western Hunter;Action, Indie, Simulation;0 - 20,000;1;1;0;0;0;0
672590;Azure Saga: Pathfinder;Adventure, Indie, RPG;0 - 20,000;67;20;47;0;0;1
672630;Academia : School Simulator;Action, Indie;200,000 - 500,000;2000;351;1649;323;390;44
672640;War Robots VR: The Skirmish;Action, Indie;200,000 - 500,000;603;145;458;9;10;0
672650;MONITOR: The Game;Adventure, Casual, Free to Play, Massively Multiplayer, RPG;0 - 20,000;54;10;44;9;9;0
672670;Hover Bots VR;Casual;0 - 20,000;2;1;1;0;0;0
672680;Call of War: World War 2;Adventure;500,000 - 1,000,000;2843;1245;1598;856;261;552
672690;The Nothing;Action, Adventure, Indie;0 - 20,000;11;2;9;0;0;0
672710;Traffic Giant;Adventure;0 - 20,000;87;26;61;0;0;12
672730;Find You;Casual, Indie;50,000 - 100,000;362;18;344;0;0;3
672760;Oneiric Masterpieces - Paris;Action, Adventure, Indie;0 - 20,000;1;1;0;0;0;0
672770;Poseidon - Project Dark Sky;Action, Indie, RPG;0 - 20,000;1;3;-2;0;0;0
672780;Sweet Magic Madness;;0 - 20,000;0;0;0;0;0;0
672790;Elemental Combat;Violent, Action, Adventure, Indie;0 - 20,000;26;5;21;0;0;0
672860;StellarHub;Action, Adventure, Casual, Indie;50,000 - 100,000;90;73;17;267;363;6
672870;ScreenPlay;Free to Play, Massively Multiplayer, RPG, Simulation, Strategy;100,000 - 200,000;439;108;331;0;0;351
672880;SuperWurfels;Adventure, Casual, Indie;0 - 20,000;5;3;2;0;0;0
672910;Hangry Bunnies From Mars;Casual, Free to Play, Indie;0 - 20,000;14;3;11;0;0;0
672920;The Bounty V2;Adventure, Casual, Indie, RPG, Simulation;20,000 - 50,000;11;0;11;0;0;0
672940;Galaxy of Drones;Violent, Gore, Action, Adventure, Indie;20,000 - 50,000;0;7;-7;0;0;0
672970;Swords and Sandals Medieval;Action, Adventure, Casual, Indie, RPG, Strategy;0 - 20,000;31;10;21;0;0;1
673000;High Hell;Action, Casual, Indie;50,000 - 100,000;1123;175;948;55;82;5
673010;WILOO;Adventure, Indie, Simulation;0 - 20,000;7;4;3;0;0;0
673040;Acorns Above: A World Gone Nuts;Casual;0 - 20,000;2;0;2;0;0;0
673050;StarBallMadNess;Free to Play, Indie, Strategy;0 - 20,000;6;2;4;0;0;0
673060;Floor Plan: Hands-On Edition;Indie;20,000 - 50,000;85;7;78;0;0;1
673070;The Ranger: Lost Tribe;Action, Indie;200,000 - 500,000;284;72;212;58;87;0
673130;AMID EVIL;Casual, Simulation;1,000,000 - 2,000,000;5155;254;4901;116;136;24
673140;Infinite Skyline;Action, Adventure, Indie;0 - 20,000;3;2;1;0;0;0
673190;All-Star Fruit Racing;Action, Casual, Indie;50,000 - 100,000;150;63;87;24;24;1
673210;Frontier Pilot Simulator;Strategy;20,000 - 50,000;554;246;308;391;439;6
673210;Frontier Pilot Simulator;Action, Adventure, Casual, Indie;20,000 - 50,000;554;246;308;391;439;6
673220;Joumee The Hedgehog;Casual, Indie;20,000 - 50,000;35;25;10;4;4;0
673230;Galaxy Annihilation;Casual, Indie, RPG;0 - 20,000;7;0;7;0;0;0
673240;Room 54;Action, Casual, Indie;0 - 20,000;53;31;22;0;0;0
673250;Exterminator: Escape!;Violent, Adventure, Free to Play, Indie, RPG, Early Access;0 - 20,000;2;0;2;0;0;0
673260;Starblast;Adventure, Indie, RPG;50,000 - 100,000;615;128;487;79;79;45
673280;GyroSphere Trials;Violent, Action, Sports;0 - 20,000;7;1;6;0;0;0
673300;Alien Splatter Redux;Indie;0 - 20,000;122;10;112;55;104;0
673310;Adam Waste;Action, Strategy, Early Access;0 - 20,000;5;7;-2;0;0;0
673360;Black Mist;Action, Adventure, Casual, Indie;0 - 20,000;1;0;1;0;0;0
673380;SPECIAL FORCE VR;Violent, Action, Adventure, Indie, RPG, Simulation;0 - 20,000;6;1;5;0;0;0
673400;Home Architect - Design your floor plans in 3D;Adventure, Indie;0 - 20,000;2;10;-8;0;0;0
673430;Mahjong Magic Islands;Action, Adventure, Indie;20,000 - 50,000;54;22;32;19;19;3
673450;Time Lock VR 1;Casual, Indie;20,000 - 50,000;434;158;276;1;1;0
673480;Timbertales;Adventure, Indie, RPG;0 - 20,000;12;7;5;2;2;0
673530;Zaba The Frog;Adventure, Casual;0 - 20,000;6;3;3;0;0;0
673540;Mogo Invasion;Casual, Indie;0 - 20,000;5;1;4;0;0;0
673550;Legendary Arcane;Casual, Indie;0 - 20,000;3;0;3;0;0;0
673560;IOSoccer;Action, Indie;200,000 - 500,000;1750;384;1366;380;36;320
673570;Squadron: Sky Guardians;Casual, Indie;0 - 20,000;2;6;-4;0;0;0
673580;Hamlet;Action, Adventure, Indie, RPG, Early Access;0 - 20,000;0;1;-1;0;0;0
673590;Amazing Thailand VR Experience;Adventure, Casual, Indie;0 - 20,000;5;6;-1;0;0;0
673600;Prison Boss VR;Indie;0 - 20,000;209;26;183;0;0;6
673610;Airport CEO;Free to Play, Indie, Strategy;200,000 - 500,000;5236;951;4285;1398;570;259
673620;Slizer Battle Management System;Action, Adventure, Casual, Indie, RPG, Simulation, Strategy, Early Access;50,000 - 100,000;46;12;34;5;5;1
673630;Heaven And Earth;Action, Adventure;0 - 20,000;1;1;0;0;0;0
673660;Neon Hardcore;Action, Adventure, Casual, Free to Play, Strategy;20,000 - 50,000;99;59;40;1;1;0
673720;Police Adventure;Action, Indie, Early Access;0 - 20,000;1;6;-5;0;0;0
673730;Aurrery;Action, Casual, Simulation, Early Access;0 - 20,000;1;1;0;0;0;0
673740;Space Battlecruiser;Action, Casual, Indie, Sports;0 - 20,000;53;13;40;0;0;1
673750;Super Bunny Man;Action, Indie, Simulation, Strategy;200,000 - 500,000;3421;539;2882;341;190;229
673800;Zup! XS;Indie;50,000 - 100,000;960;144;816;98;130;3
673810;Infinite Sunshine Dust;Adventure;0 - 20,000;1;0;1;0;0;0
673820;Master of ABC;Action, Indie, Simulation;0 - 20,000;15;13;2;0;0;0
673830;VR STOCK CAR RACERS;Action, Casual, Indie;0 - 20,000;8;7;1;0;0;0
673840;VR Formula;Adventure, Simulation;0 - 20,000;17;8;9;0;0;0
673850;Neofeud;Action, Indie, Strategy;20,000 - 50,000;175;32;143;0;0;0
673870;Math Combat Challenge;Action, Adventure, Casual, Indie, Strategy;0 - 20,000;6;0;6;0;0;0
673880;Warhammer 40,000: Mechanicus;Adventure, Indie;500,000 - 1,000,000;10110;866;9244;658;449;152
673900;Avem33;Adventure, Indie, Early Access;50,000 - 100,000;22;15;7;5;7;5
673920;Maso Marble;Adventure, Casual, Free to Play, Indie;0 - 20,000;3;0;3;0;0;0
673940;Dragon Glory;Adventure, Casual, Indie, RPG;20,000 - 50,000;36;45;-9;1;1;2
673950;Farm Together;Adventure, Casual, Indie;1,000,000 - 2,000,000;17943;1110;16833;3339;1719;1309
673970;MuX;Adventure, Indie, RPG, Strategy;0 - 20,000;10;1;9;0;0;0
673980;Spears 'n' Spades;Action, Adventure, Indie, Simulation, Early Access;0 - 20,000;40;1;39;0;0;0
673980;Spears 'n' Spades;Action, Adventure, Indie;0 - 20,000;40;1;39;0;0;0
674010;TerkEngine;Action, Adventure;0 - 20,000;0;2;-2;0;0;0
674020;World War 3;Indie, Strategy;1,000,000 - 2,000,000;27216;22412;4804;776;135;1194
674090;Sky Haven Tycoon - Airport Simulator;Action, Adventure, Indie;20,000 - 50,000;678;253;425;17;17;41
674120;Cruentis The Murderer vol.1;Action, Casual, Indie, Racing, Sports, Early Access;0 - 20,000;4;1;3;0;0;0
674130;Bare Metal;Action, Adventure;0 - 20,000;69;14;55;4;4;0
674140;Bugsnax;Casual, Indie, Simulation, Sports;100,000 - 200,000;2999;67;2932;1002;1092;84
674150;Simon the Sorcerer: 25th Anniversary Edition;Adventure, Casual;0 - 20,000;66;28;38;0;0;4
674160;Slasher VR;Casual, Indie, Simulation, Strategy;0 - 20,000;5;4;1;0;0;0
674170;DriftForce;Adventure, Indie;0 - 20,000;41;16;25;0;0;0
674180;AliveInVR;Casual;0 - 20,000;3;1;2;0;0;0
674190;Conquest of the New World;Indie, Simulation;0 - 20,000;64;3;61;109;109;15
674190;Conquest of the New World;Action, Indie, RPG;0 - 20,000;64;3;61;109;109;15
674210;Rush to Adventure;Adventure, Casual, Indie;0 - 20,000;30;5;25;0;0;0
674220;ClickBit;Action, Indie, Early Access;0 - 20,000;18;25;-7;0;0;0
674220;ClickBit;Action, Indie;0 - 20,000;18;25;-7;0;0;0
674230;Light of the Mountain;Action, Adventure, Indie, RPG, Early Access;0 - 20,000;10;4;6;0;0;0
674250;Resurgence: Earth United;Casual;0 - 20,000;23;5;18;0;0;0
674310;THE 2048;Casual, Indie;;;;0;;;
674320;Brimstone;Violent, Gore, Action, Indie, Early Access;0 - 20,000;2;0;2;0;0;0
674330;Defend the Cake;Action, Indie;0 - 20,000;37;2;35;0;0;0
674360;Orb Flo;Animation & Modeling, Design & Illustration;0 - 20,000;0;1;-1;0;0;0
674370;CoffeeBiz Tycoon;Adventure;0 - 20,000;39;21;18;33;33;0
674380;Delude - Succubus Prison;Accounting, Utilities;0 - 20,000;8;14;-6;0;0;0
674390;Bildo;Action, Adventure, Indie;0 - 20,000;11;4;7;0;0;0
674400;Einar;Indie, Strategy;200,000 - 500,000;895;562;333;13;9;0
674420;Piece of Memory;Casual, Indie, Simulation, Early Access;0 - 20,000;5;9;-4;0;0;0
674440;Skipper - Puzzle Across The Sea;Adventure, Indie, RPG, Simulation, Early Access;0 - 20,000;44;5;39;0;0;0
674450;Blind Witch -Peek Window-;Action, Adventure, Indie, Simulation, Early Access;0 - 20,000;8;0;8;0;0;0
674480;Unformed 破妄;Action, Casual, Indie;0 - 20,000;36;9;27;0;0;0
674500;Total Tank Simulator;Strategy;200,000 - 500,000;4838;1358;3480;379;157;87
674520;Fight'N Rage;Action, Indie, Strategy;100,000 - 200,000;2243;193;2050;261;326;19
674550;SweetBed;Action, Indie;0 - 20,000;0;6;-6;0;0;0
674570;Bear Football;Adventure, Casual, Indie;0 - 20,000;80;33;47;0;0;0
674580;Fare Thee Well;Casual, Indie;0 - 20,000;118;9;109;1;1;0
674630;Town;Sexual Content, Nudity, Adventure, Casual, Indie, RPG;0 - 20,000;1;1;0;0;0;0
674690;Project Xandata;Action, Adventure, Simulation;200,000 - 500,000;90;40;50;0;0;0
674730;MRAK;Adventure, Indie;0 - 20,000;6;9;-3;0;0;0
674750;Yet Another Zombie Defense HD;Indie, Simulation, Strategy;200,000 - 500,000;2047;355;1692;114;85;25
674800;Tailwind;Adventure, Indie;0 - 20,000;24;4;20;0;0;0
674840;The Essence Reaper Ritual;Violent, Action, Adventure, Indie, Simulation, Early Access;0 - 20,000;3;2;1;0;0;0
674850;2MD: VR Football Classic;Casual;0 - 20,000;138;12;126;0;0;0
674860;Bystander;Action, Adventure, Indie, RPG;0 - 20,000;9;31;-22;0;0;0
674890;Mechsprofit: Mech Tycoon Simulator;Action, Indie, Strategy, Early Access;0 - 20,000;11;3;8;0;0;0
674900;Toys Gun Fire Boom;Action, Indie;0 - 20,000;2;1;1;0;0;0
674910;Testbed Terror;Action, Casual, Indie;0 - 20,000;7;1;6;0;0;0
674940;Stick Fight: The Game;Action, Casual, Indie, Simulation;2,000,000 - 5,000,000;99330;6622;92708;452;220;771
674960;Gods of the Fallen Land;Adventure, Free to Play, Indie;20,000 - 50,000;92;19;73;0;0;0
674980;Dirty Fighter 1;Indie, Simulation;0 - 20,000;4;3;1;0;0;0
675010;MudRunner;Adventure, Casual, Indie, Simulation;1,000,000 - 2,000,000;24619;2682;21937;2117;380;581
675030;Super Samurai Rampage;Casual, Indie, Simulation, Sports;0 - 20,000;39;6;33;2;2;0
675110;KILL YOUR FRIENDS;Action, Indie;0 - 20,000;7;2;5;0;0;1
675120;Crusader Crash;Action, Indie;0 - 20,000;7;1;6;0;0;0
675130;AEGYPTUS;Action, Adventure, Casual, Indie;0 - 20,000;15;21;-6;0;0;0
675140;Laika 2.0 - Sekret Pravda;Casual, Indie, Simulation;0 - 20,000;8;1;7;0;0;0
675160;Soldier Killer;Adventure, Casual;0 - 20,000;4;1;3;0;0;0
675170;303 Squadron: Battle of Britain;Adventure, Casual;20,000 - 50,000;226;144;82;512;512;0
675180;Choice of Zombies;Adventure, Casual;0 - 20,000;4;4;0;0;0;0
675210;CastleMiner Warfare;Action, Casual, Indie, Massively Multiplayer, Simulation, Sports;0 - 20,000;39;44;-5;0;0;0
675220;SoulFrost;Action, Indie, Simulation;0 - 20,000;15;9;6;3;3;0
675230;Secondhand Lands;Action, Adventure, Casual, Racing, Simulation, Sports;0 - 20,000;77;30;47;1;1;0
675240;Shining Song Starnova;Action, Adventure, Indie, Simulation;50,000 - 100,000;283;16;267;235;457;7
675260;Batman: The Enemy Within - The Telltale Series;Action, Casual, Indie;200,000 - 500,000;6298;600;5698;657;741;45
675270;Rockets are Super Hard;Action, Casual, Indie;0 - 20,000;13;2;11;0;0;0
675330;Space Crawl;Indie, RPG;0 - 20,000;0;0;0;0;0;0
675360;Forbidden Love;Action, Sports;0 - 20,000;7;9;-2;29;29;0
675370;Gulu;Strategy;20,000 - 50,000;3;2;1;0;0;0
675480;Witch Thief;Casual, Indie;0 - 20,000;12;7;5;0;0;0
675490;Artifact Adventure Gaiden;Adventure, Indie;0 - 20,000;42;6;36;0;0;0
675500;ACT IT OUT XL! A Charades Party Game;Simulation;0 - 20,000;41;11;30;0;0;0
675510;Kingdom City Drowning Episode 1 - The Champion;Adventure;0 - 20,000;8;9;-1;0;0;0
675560;NAVYFIELD;Action, Indie;200,000 - 500,000;482;235;247;10;10;125
675620;Alter Cosmos;Action, Adventure, Casual, Indie;0 - 20,000;13;8;5;0;0;0
675630;Super POTUS Trump;Action, Free to Play, RPG;50,000 - 100,000;264;183;81;8;8;0
675640;The Lonely Gorilla;Indie, Simulation;0 - 20,000;17;12;5;0;0;0
675660;Relic Keepers;Adventure;0 - 20,000;1;12;-11;0;0;0
675690;Tribal Wars;Indie;100,000 - 200,000;390;128;262;0;0;46
675720;Direct;;20,000 - 50,000;41;23;18;0;0;0
675730;Katharsis;Action, Adventure, Indie;0 - 20,000;34;12;22;0;0;0
675750;GameDevDan vs Life;Simulation, Strategy;0 - 20,000;2;0;2;0;0;0
675810;Bang! Howdy;Adventure, Indie;20,000 - 50,000;79;26;53;0;0;0
675830;Pulses - Crystal Journeys;Action, Casual, Indie, Strategy;0 - 20,000;4;1;3;0;0;0
675870;Ruby Hunter;RPG;0 - 20,000;4;3;1;0;0;1
675890;Within a Rose;Action;0 - 20,000;25;5;20;0;0;0
675910;Visual Out;Adventure, Casual;0 - 20,000;12;2;10;0;0;0
675950;Peninsular War Battles;Action;20,000 - 50,000;15;15;0;0;0;2
675960;Matryoshka Strike;Action, Adventure, Simulation, Early Access;0 - 20,000;11;7;4;0;0;0
675970;Powerslide;Action, Adventure, Indie, RPG, Strategy, Early Access;0 - 20,000;15;0;15;0;0;0
675980;Atomic Sky;Action, Adventure, Indie, RPG;0 - 20,000;3;0;3;0;0;0
675990;Questr;Action, Indie, Early Access;0 - 20,000;22;7;15;0;0;0
676000;Bloody Mice;Design & Illustration, Utilities, Early Access;20,000 - 50,000;32;14;18;0;0;0
676030;Eternal Starlight VR;Adventure, Casual, Indie;0 - 20,000;55;3;52;0;0;1
676070;an Orc's Tale: Kriegsruf;Free to Play, Strategy;0 - 20,000;26;7;19;14;26;0
676070;an Orc's Tale: Kriegsruf;Action, Casual, Indie, Racing, Simulation, Sports, Early Access;0 - 20,000;26;7;19;14;26;0
676120;Sango Guardian Chaos Generation Steamedition;Adventure, Casual, Indie;0 - 20,000;10;10;0;0;0;0
676130;Without Within 3 (初衷);Indie, Racing, Simulation, Early Access;0 - 20,000;64;2;62;0;0;0
676170;Ungrounded: Ripple Unleashed VR;Action, Adventure, Indie, Massively Multiplayer, RPG, Early Access;0 - 20,000;2;0;2;0;0;0
676180;Spaceguard 80;Casual, Indie;0 - 20,000;29;0;29;0;0;0
676210;Story of the Survivor : Prisoner;Indie, Early Access;0 - 20,000;9;5;4;0;0;0
676240;TAURONOS;Free to Play, Indie, Strategy, Early Access;20,000 - 50,000;52;4;48;0;0;0
676310;Deadly Zone;Action, Indie;0 - 20,000;3;5;-2;0;0;0
676320;Letter-Setter;Indie, Strategy;0 - 20,000;2;1;1;0;0;0
676340;Undarkened;Action, Adventure, Casual, Indie, RPG;0 - 20,000;9;3;6;0;0;1
676410;Embrace of Ocean: Story of Hope;Indie, RPG;0 - 20,000;6;2;4;0;0;0
676420;SiNKR;Violent, Gore;20,000 - 50,000;387;18;369;0;0;1
676420;SiNKR;Adventure, Indie, RPG, Early Access;20,000 - 50,000;387;18;369;0;0;1
676430;PUSH;Indie;50,000 - 100,000;521;76;445;27;39;0
676440;Trash Squad;Action, Adventure, Casual, Indie, Strategy;20,000 - 50,000;114;22;92;125;125;0
676450;Double Memory;Casual, Indie, Strategy;0 - 20,000;21;8;13;0;0;0
676460;Sellsword VR;Design & Illustration, Photo Editing, Utilities;0 - 20,000;1;4;-3;0;0;0
676470;Sommad;Photo Editing;0 - 20,000;28;6;22;6;6;0
676480;Jettomero: Hero of the Universe;Audio Production, Design & Illustration, Utilities, Video Production, Web Publishing;20,000 - 50,000;96;19;77;0;0;0
676490;Heroes of Civilizations;Video Production;20,000 - 50,000;15;38;-23;0;0;0
676500;Time Warpers;Adventure, Simulation;20,000 - 50,000;434;72;362;1981;3149;16
676510;Industrial Petting;Action, Casual, Racing;0 - 20,000;65;4;61;0;0;1
676520;Piece of Memory 2:Prologue;Casual, Indie;0 - 20,000;2;0;2;0;0;0
676540;Mercfighter;Casual, Indie, Simulation, Strategy;0 - 20,000;0;0;0;0;0;0
676550;Crash Test Billy;Casual, Indie, RPG;0 - 20,000;3;11;-8;0;0;0
676570;Crazy Bowling;Action, Casual, Indie;0 - 20,000;2;1;1;0;0;0
676580;NEO Impossible Bosses;Violent, Indie;0 - 20,000;13;0;13;130;130;0
676600;Fuzzy's Quest;Simulation, Sports;0 - 20,000;1;0;1;0;0;0
676620;Robots: create AI;Adventure, Casual, Indie, Simulation;0 - 20,000;13;2;11;0;0;0
676630;Attentat 1942;Action, Adventure, Indie, RPG;50,000 - 100,000;320;19;301;0;0;3
676660;逮到你了!;Adventure, Casual, Indie;0 - 20,000;2;3;-1;0;0;0
676680;Mircron Wars XR;Action, Casual, Indie;0 - 20,000;5;1;4;0;0;0
676690;VR Escape The Puzzle Room;Action, Adventure, Casual, Indie;0 - 20,000;7;4;3;0;0;0
676700;Heroes of Delum;Indie;0 - 20,000;30;6;24;0;0;0
676720;Bug Killers;Adventure, Casual, Indie, RPG;0 - 20,000;16;21;-5;0;0;0
676730;Behind The Door;Adventure, Casual, Indie, Sports, Strategy;0 - 20,000;54;37;17;0;0;0
676760;Noise;Action, Casual, RPG, Strategy;20,000 - 50,000;142;111;31;0;0;0
676770;Island Dash;Action, Adventure, Casual, Indie;100,000 - 200,000;416;79;337;15;22;0
676800;Dark Descent: The Blue Rose;Action, Adventure, Casual, Indie, RPG;0 - 20,000;15;3;12;0;0;0
676800;Dark Descent: The Blue Rose;Action, Adventure, Casual, Free to Play, Indie, Massively Multiplayer, Racing, Simulation, Sports, Early Access;0 - 20,000;15;3;12;0;0;0
676820;Subsurface Circular;Action, Casual, Indie;50,000 - 100,000;1613;95;1518;113;114;1
676830;Xenomarine;Action, Indie, Early Access;0 - 20,000;46;7;39;0;0;0
676840;Contagion VR: Outbreak;Casual, Free to Play, Simulation;20,000 - 50,000;422;226;196;430;430;1
676850;Guardian;Adventure, Indie, RPG;0 - 20,000;13;4;9;0;0;0
676880;Tales of Glacier (VR);Action, Indie, RPG;0 - 20,000;0;3;-3;0;0;0
676910;Magic Potion Destroyer;Action, Adventure, Indie;0 - 20,000;23;5;18;0;0;2
676930;TwinCop;Casual, Indie, Simulation;0 - 20,000;30;3;27;0;0;0
676960;Hotlap Heroes;Action, Adventure, Indie, RPG, Simulation, Strategy;0 - 20,000;16;3;13;0;0;0
676990;The Stone;Violent, Gore, Action, Indie;0 - 20,000;6;8;-2;0;0;0
677010;Darts VR;Action, Adventure, Indie;0 - 20,000;0;2;-2;0;0;0
677020;Eventide 3: Legacy of Legends;Animation & Modeling, Utilities, Video Production, Early Access;20,000 - 50,000;193;37;156;0;0;3
677030;Draw Souls;Action, Casual, Indie;0 - 20,000;24;4;20;6;6;0
677040;Cloudborn;Violent, RPG;0 - 20,000;22;20;2;18;34;0
677060;Into the Rhythm VR;Action, Adventure, Indie, RPG, Early Access;20,000 - 50,000;33;16;17;0;0;0
677080;Dungeon Manager ZV: Resurrection;Action, Adventure, Indie;0 - 20,000;8;0;8;0;0;0
677120;Heroes of Hammerwatch;Casual, Indie, Simulation;500,000 - 1,000,000;7040;949;6091;1526;830;306
677160;We Were Here Too;Action, Casual, Indie;200,000 - 500,000;5041;1202;3839;241;184;78
677180;Pantropy;Action, Casual, Simulation;0 - 20,000;139;157;-18;3462;3462;0
677190;HATCHICK;Adventure, Indie;0 - 20,000;14;1;13;0;0;0
677210;Gift to Humanity: Alpha;Action, Adventure, Indie;0 - 20,000;13;11;2;1;1;0
677220;Silver Tale;Action, Adventure;20,000 - 50,000;55;23;32;0;0;1
677230;Around the Words;Adventure, Free to Play, Indie;0 - 20,000;2;5;-3;0;0;0
677240;Trespassers;Adventure, Casual, Indie;0 - 20,000;16;4;12;0;0;0
677260;Nuclear Wipeout;Action, Indie;0 - 20,000;16;1;15;0;0;0
677280;Sigi - A Fart for Melusina;Indie, Simulation, Strategy;0 - 20,000;99;14;85;0;0;0
677290;VRCAT;Action, Casual, Indie, Strategy;0 - 20,000;8;2;6;2;3;0
677300;Ghosts of Miami;Casual, Indie;0 - 20,000;49;4;45;0;0;0
677310;MyMoney;Action, Indie, Early Access;20,000 - 50,000;19;9;10;0;0;0
677330;Theseus;Casual, Indie, Simulation, Sports, Early Access;0 - 20,000;51;12;39;0;0;0
677340;The Colonists;Action, Indie, Sports, Strategy, Early Access;50,000 - 100,000;819;127;692;17;17;9
677380;Disco Destruction;Adventure, Indie;0 - 20,000;48;5;43;163;215;0
677450;Medieval Shopkeeper Simulator;Action, Indie;20,000 - 50,000;152;88;64;8;8;0
677450;Medieval Shopkeeper Simulator;Action, Adventure, Indie, Early Access;20,000 - 50,000;152;88;64;8;8;0
677480;Outpost Zero;Violent, Action, Casual;20,000 - 50,000;410;398;12;40;45;4
677480;Outpost Zero;Casual, Indie, Simulation;20,000 - 50,000;410;398;12;40;45;4
677520;Guilt Battle Arena;Violent, Gore, Action, Casual, Early Access;0 - 20,000;28;6;22;0;0;0
677590;Hope;Adventure, Casual, Indie;0 - 20,000;3;1;2;0;0;0
677610;Penn & Teller VR: Frankly Unfair, Unkind, Unnecessary, & Underhanded;Action, Adventure, Indie;0 - 20,000;6;3;3;0;0;0
677620;Splitgate: Arena Warfare;Adventure, Casual, Indie, RPG;5,000,000 - 10,000,000;98892;9189;89703;473;186;605
677650;Brass;Action, Adventure, Indie;0 - 20,000;23;15;8;122;122;0
677680;DEFENDER OF EARTH VS THE ALIEN ARMADA;Action, Casual;0 - 20,000;2;2;0;0;0;0
677700;Attack of the Gooobers;Action, Adventure, Casual, Indie, Racing, Sports, Early Access;0 - 20,000;4;0;4;0;0;0
677710;Little Einar;Violent, Action, Free to Play, Indie, Massively Multiplayer;0 - 20,000;7;3;4;0;0;0
677720;Tangrams Deluxe;Action, Adventure, Indie, RPG;0 - 20,000;50;10;40;0;0;0
677730;Karmasutra;English;0 - 20,000;13;6;7;0;0;0
677770;Easy Game Creator;Nudity, Gore, Action, Indie;0 - 20,000;3;3;0;0;0;0
677780;Interplanetary Hunter;Action, Racing, Sports, Early Access;0 - 20,000;3;0;3;0;0;0
677790;SOULS;Action, Casual, Indie, Racing;0 - 20,000;118;9;109;0;0;0
677810;Wing of Misadventure;Action, Indie, Simulation, Strategy;50,000 - 100,000;225;158;67;0;0;0
677820;BusinessMan;Casual;0 - 20,000;9;11;-2;0;0;0
677850;Eselmir and the five magical gifts;Action, Adventure, Casual, Indie, RPG, Simulation, Strategy;0 - 20,000;28;7;21;0;0;0
677870;Gamers Unknown Survival;Action, Casual, Simulation;0 - 20,000;4;10;-6;0;0;0
677880;Draw Your Game;Adventure, Casual, Indie, RPG, Early Access;0 - 20,000;18;52;-34;0;0;0
677910;Life on Mars Remake;Action, Indie, RPG, Early Access;0 - 20,000;37;3;34;0;0;1
677920;Acucalypse;Indie;0 - 20,000;4;9;-5;0;0;0
678010;Temporal Storm X: Hyperspace Dream;Adventure, Indie, RPG;0 - 20,000;9;2;7;0;0;0
678030;FAST & FURIOUS CROSSROADS;Casual, Indie;0 - 20,000;70;82;-12;113;113;0
678030;FAST & FURIOUS CROSSROADS;Action, Indie;0 - 20,000;70;82;-12;113;113;0
678060;Super Ultra Monster Smash!;Free to Play;0 - 20,000;20;18;2;0;0;0
678090;Symploke: Legend of Gustavo Bueno (Chapter 1);Casual, Indie;20,000 - 50,000;57;12;45;0;0;0
678100;VR Crane Master;Action, Indie;0 - 20,000;4;1;3;0;0;0
678150;JMPR;Action, Adventure, Indie;0 - 20,000;10;1;9;0;0;0
678190;King of Bali;Action, Adventure, Indie, Simulation, Early Access;0 - 20,000;78;87;-9;12;12;0
678200;VR Table Sports;Action, Casual, Indie, Strategy;0 - 20,000;9;5;4;0;0;0
678230;Abstract Arena;Casual, Indie;0 - 20,000;16;13;3;0;0;0
678240;Destroyer: Invasion;Action, Indie;0 - 20,000;13;9;4;0;0;0
678290;Ezy;Action, Adventure, Free to Play, Massively Multiplayer, RPG;20,000 - 50,000;21;5;16;0;0;0
678290;Ezy;Action, Indie, Early Access;20,000 - 50,000;21;5;16;0;0;0
678310;Pinball Deluxe: Reloaded;Action;0 - 20,000;130;6;124;0;0;5
678390;Office Management 101;Action, Adventure, Indie, RPG, Strategy;0 - 20,000;54;8;46;0;0;2
678400;Dark Tales: Edgar Allan Poe's The Fall of the House of Usher Collector's Edition;Action, Adventure, Simulation;0 - 20,000;8;1;7;0;0;0
678410;Chimeras: The Signs of Prophecy Collector's Edition;Violent, Gore, Action, Adventure, Indie, Simulation;0 - 20,000;4;1;3;0;0;0
678420;Fierce Tales: Marcus' Memory Collector's Edition;Action, Adventure, Indie;0 - 20,000;2;0;2;0;0;0
678430;Mayan Prophecies: Cursed Island Collector's Edition;Action, Casual, Indie;0 - 20,000;2;0;2;0;0;0
678440;Dark Parables: Queen of Sands Collector's Edition;RPG;0 - 20,000;17;0;17;0;0;0
678450;Full-On Paintball;RPG;0 - 20,000;13;20;-7;0;0;0
678460;Tekling;RPG;0 - 20,000;5;0;5;0;0;0
678470;Pirates of corsairs;RPG;0 - 20,000;7;6;1;0;0;0
678500;The Climber;Action, Indie, Early Access;0 - 20,000;1;2;-1;0;0;0
678520;Gal*Gun VR;Casual, Indie;20,000 - 50,000;388;72;316;0;0;0
678530;Plexarium;Action, Simulation;0 - 20,000;10;0;10;0;0;0
678540;Bad School Boy;Action, Indie, Simulation;0 - 20,000;20;4;16;2;2;0
678570;VR Fitness;Violent, Adventure, Casual, Indie, RPG, Simulation, Strategy;0 - 20,000;0;1;-1;0;0;0
678620;Battle Chess II: Chinese Chess;Adventure, Casual, Indie, RPG, Simulation, Strategy;0 - 20,000;9;1;8;0;0;0
678750;Gravity Tunnel VR;Casual, Indie, Strategy, Early Access;0 - 20,000;0;0;0;0;0;0
678760;Simon the Sorcerer - Mucusade: 25th Anniversary Edition;Indie, Strategy;20,000 - 50,000;33;15;18;0;0;1
678800;SAS: Zombie Assault 4;Action, Indie, RPG, Strategy;500,000 - 1,000,000;6284;1029;5255;265;64;210
678820;Gun-Running War Dogs;Action, RPG;0 - 20,000;39;20;19;16;31;0
678850;Uurnog Uurnlimited;Casual, Indie;0 - 20,000;80;19;61;0;0;0
678870;EatWell;Action, Adventure, Indie;0 - 20,000;21;0;21;0;0;0
678880;Solmec: Hollow Planet;Action, Adventure, Indie;0 - 20,000;2;0;2;0;0;0
678890;Airport Simulator 2019;Utilities, Web Publishing;20,000 - 50,000;38;100;-62;338;338;1
678900;Farmer's Dynasty;Action, Indie, Simulation, Early Access;100,000 - 200,000;2510;825;1685;741;1063;85
678910;BombGears;Action, Adventure, Casual, Indie;0 - 20,000;2;0;2;0;0;0
678920;Symploke: Legend of Gustavo Bueno (Chapter 2);Casual, Simulation;20,000 - 50,000;14;1;13;239;276;0
678930;Square Route;Action, Indie;0 - 20,000;2;0;2;0;0;0
678940;Nox Dei;Action, Casual, Indie, Strategy;0 - 20,000;30;2;28;0;0;0
678950;DRAGON BALL FighterZ;Casual, Indie;2,000,000 - 5,000,000;53538;5705;47833;2233;492;1641
678960;CODE VEIN;Action, Indie;2,000,000 - 5,000,000;40453;6467;33986;1857;900;917
678970;Modern Tales: Age of Invention;Casual, Indie;0 - 20,000;198;22;176;174;174;2
679030;HELI-COMMANDO 2017;Action, Free to Play, Massively Multiplayer, Early Access;0 - 20,000;10;1;9;0;0;0
679070;Fapic;Casual, Indie, Simulation;0 - 20,000;9;4;5;0;0;0
679080;Toy Goblins;Action, Adventure, Casual, Indie;0 - 20,000;2;2;0;0;0;0
679090;9th Dawn Classic - Clunky controls edition;English, Simplified Chinese;0 - 20,000;21;4;17;0;0;0
679100;Aequitas Orbis;Action, Casual, Indie;0 - 20,000;2;0;2;0;0;0
679110;Werewolf: The Apocalypse - Earthblood;Action, Free to Play, Indie, Early Access;20,000 - 50,000;248;97;151;549;549;4
679120;DEEP SPACE ANOMALY;Action, Indie, Early Access;0 - 20,000;84;22;62;0;0;0
679160;CollabHub;Action;0 - 20,000;3;2;1;0;0;0
679190;The Hunting God;Adventure, Casual, Indie, RPG, Simulation, Strategy;0 - 20,000;79;39;40;0;0;0
679200;Forbidden Game;Adventure, Casual, Indie, RPG, Simulation, Strategy;0 - 20,000;0;0;0;0;0;0
679230;Tell a Demon;Adventure, Casual, Indie, RPG, Simulation, Strategy;0 - 20,000;24;1;23;0;0;0
679270;Antaria Online;Adventure, Casual, Indie, RPG, Simulation, Strategy;20,000 - 50,000;219;122;97;62;62;0
679300;PATHOS;Indie, Strategy;0 - 20,000;20;4;16;0;0;0
679390;Topdown Showdown;Nudity, Violent, Gore, Action;0 - 20,000;1;1;0;0;0;0
679400;Relik;Action, Indie;20,000 - 50,000;140;32;108;21;21;0
679410;The Adventures of Clive McMulligan on Planet Zeta Four;Indie, Strategy;0 - 20,000;11;0;11;0;0;0
679430;Skyraine;Free to Play, Massively Multiplayer, Strategy, Early Access;0 - 20,000;27;11;16;0;0;0
679480;生死线 Dead Line;Action, Adventure, Casual, Indie, Strategy;0 - 20,000;3;3;0;0;0;0
679490;Lisa's Memory - 丽莎的记忆;Action, Adventure, Casual;0 - 20,000;256;43;213;2;2;0
679500;Campfire Cooking;Adventure, Casual, Indie, RPG, Simulation, Strategy;0 - 20,000;43;0;43;0;0;0
679510;Steel Punk Ball;Adventure, Indie, RPG;0 - 20,000;19;11;8;0;0;0
679530;Professor Watts Memory Match: Shapes And Colors;Casual, Indie;0 - 20,000;27;26;1;1;1;0
679540;CyberLink PhotoDirector 9 Deluxe - Photo editor, photo editing software;Indie;0 - 20,000;1;3;-2;0;0;0
679550;CyberLink PhotoDirector 9 Ultra;Casual, Indie;0 - 20,000;9;1;8;0;0;0
679560;CyberLink PowerDirector 16 Ultra;Indie, Strategy;0 - 20,000;21;1;20;0;0;6
679570;CyberLink PowerDirector 16 Ultimate;Action, Indie, Sports;0 - 20,000;9;2;7;0;0;0
679620;Rollercoaster Xperience;Casual, Indie, Strategy, Early Access;0 - 20,000;12;7;5;0;0;0
679640;C64 & AMIGA Classix Remakes Sixpack;;0 - 20,000;2;4;-2;0;0;0
679660;aMAZE ZER0;Adventure, Indie;0 - 20,000;197;40;157;1;1;1
679670;Miniature TD - VR;Indie;0 - 20,000;5;4;1;0;0;0
679690;SwapQuest;Action, Free to Play, Indie;0 - 20,000;4;5;-1;0;0;0
679700;Dead Shits;Action, Adventure, Indie;0 - 20,000;0;1;-1;0;0;0
679720;Mad Farm VR;Indie;0 - 20,000;2;0;2;0;0;0
679740;Totally Mayhem;Action, Casual, Strategy;0 - 20,000;28;22;6;0;0;1
679750;Catch & Release;Action, Casual, Indie;20,000 - 50,000;294;34;260;0;0;1
679770;Dr. Cares - Pet Rescue 911;Gore, Action, Adventure, RPG, Early Access;0 - 20,000;56;4;52;0;0;0
679780;Lemuria: Lost in Space - VR Edition;Adventure, Casual, Indie, RPG, Simulation, Early Access;0 - 20,000;1;8;-7;0;0;0
679820;Solitaire Mystery: Stolen Power;Action, Indie;0 - 20,000;15;13;2;0;0;1
679830;Village Monsters;Casual, Indie, Simulation;0 - 20,000;17;4;13;0;0;0
679860;ZAP Master;Action, Adventure, Indie;0 - 20,000;22;19;3;0;0;0
679860;ZAP Master;Action, Casual, RPG;0 - 20,000;22;19;3;0;0;0
679900;Swords & Souls: Neverseen;Adventure, RPG, Strategy;200,000 - 500,000;3433;251;3182;1028;1283;56
679930;36 Fragments of Midnight;Adventure, Indie;0 - 20,000;4;7;-3;0;0;0
679960;Brain Crush;Action;0 - 20,000;1;0;1;0;0;0
680030;Gone Viral;Action, Indie;0 - 20,000;51;11;40;0;0;0
680040;Kukui;Nudity, Casual, Indie, Strategy;20,000 - 50,000;12;10;2;0;0;0
680070;Puzzle: Underwater World;Simulation;0 - 20,000;4;4;0;0;0;0
680100;Heroes of Myths - Warriors of Gods;Action, Casual, Indie, Simulation;20,000 - 50,000;3;15;-12;0;0;0
680140;Tetsoidea Eternal;Action, Adventure, Casual, RPG;0 - 20,000;0;3;-3;0;0;0
680170;VR Triber;Casual, Simulation, Sports, Strategy;20,000 - 50,000;8;15;-7;1;1;0
680190;Interstellar Invaders;Adventure, Indie, RPG;0 - 20,000;6;0;6;0;0;0
680250;The Mirage : Illusion of wish;Indie;0 - 20,000;1;0;1;0;0;0
680310;Poker World - Single Player;Casual, Free to Play, Indie;100,000 - 200,000;146;166;-20;178;178;9
680320;The Heiress;Indie, Simulation, Strategy, Early Access;200,000 - 500,000;1376;208;1168;244;232;3
680330;Elium - Prison Escape;Action, Indie;0 - 20,000;30;12;18;0;0;0
680340;Omega Strike;Casual, Indie, RPG;20,000 - 50,000;261;63;198;3516;3516;1
680350;Hurl VR;Indie, Simulation, Strategy, Early Access;0 - 20,000;13;2;11;1;1;0
680360;Regions Of Ruin;Action, Indie, Racing, Sports;200,000 - 500,000;3745;543;3202;246;93;9
680380;Night Call;Action, Adventure, Casual, Indie;20,000 - 50,000;386;137;249;0;0;0
680390;Hidden Dragon: Legend;Action, Casual, Indie;0 - 20,000;69;9;60;0;0;0
680400;Light Tracer (VR & NON-VR);Casual, Indie, Strategy;0 - 20,000;30;2;28;0;0;0
680420;OUTRIDERS;Action, Adventure, Indie;1,000,000 - 2,000,000;38547;20041;18506;2749;2141;459
680440;Wallpaper Transformer;Design & Illustration, Education, Software Training, Utilities, Early Access;0 - 20,000;16;41;-25;0;0;0
680450;DAMN!;Indie, Strategy;0 - 20,000;5;2;3;5;5;0
680480;ICY: Frostbite Edition;Simulation, Strategy;20,000 - 50,000;311;50;261;138;138;0
680500;ShadowCalls 暗影召唤;Indie, Strategy, Early Access;0 - 20,000;1;1;0;0;0;0
680550;Zombie Waiting;Adventure, Casual, Free to Play, Indie;0 - 20,000;17;10;7;0;0;0
680560;VR2Space;Adventure, Casual, Indie, Strategy;0 - 20,000;0;1;-1;0;0;0
680590;Minotaur;Adventure, Casual, Indie;0 - 20,000;307;13;294;0;0;0
680620;Bouncy Bob;Indie, RPG, Early Access;0 - 20,000;49;9;40;7;7;0
680640;ChefU;Simulation, Strategy;0 - 20,000;17;44;-27;0;0;0
680680;All Haze Eve;Casual;0 - 20,000;7;3;4;0;0;0
680690;Kama Bullet Heritage;Adventure, Indie, RPG;0 - 20,000;54;34;20;0;0;0
680700;OK K.O.! Let’s Play Heroes;Violent, Gore, Action, Massively Multiplayer, RPG, Simulation;0 - 20,000;116;8;108;0;0;2
680700;OK K.O.! Let’s Play Heroes;Casual, Indie, Strategy;0 - 20,000;116;8;108;0;0;2
680750;Destination Primus Vita - Ep. 1;Free to Play, Indie, Early Access;20,000 - 50,000;72;22;50;6;6;1
680780;DEATH TRAIN - Warning: Unsafe VR Experience;Adventure, Free to Play, Indie;500,000 - 1,000,000;17;15;2;148;198;0
680830;Wait! Life is beautiful!;Indie;0 - 20,000;154;52;102;0;0;1
680850;Sixteen;Casual, Free to Play, Indie, Strategy;0 - 20,000;1;0;1;0;0;0
680860;Evil Labs;Violent;0 - 20,000;57;23;34;208;208;0
680890;Where the Money Is;Indie, Simulation;0 - 20,000;6;0;6;0;0;0
680930;Fairy Lands: Rinka and the Fairy Gems;Action, Casual, Indie;0 - 20,000;21;7;14;0;0;1
680940;Riot Street;Action, Casual, Indie;0 - 20,000;10;20;-10;0;0;0
680950;Let's Bowl VR - Bowling Game;Animation & Modeling, Utilities;0 - 20,000;31;11;20;0;0;0
680970;Kingdom Watcher;Action, Adventure, Indie, Early Access;0 - 20,000;8;4;4;0;0;0
680980;HEADLINER;Utilities, Video Production;50,000 - 100,000;642;184;458;88;90;1
681000;OM6N;Violent, Action, Indie, Massively Multiplayer;0 - 20,000;10;2;8;0;0;0
681020;Throne of the Dead;Simulation, Strategy;0 - 20,000;1;1;0;0;0;0
681030;Dark Empire;Action, Casual, Indie, Strategy;0 - 20,000;0;1;-1;0;0;0
681060;Shooty Squad;Indie;0 - 20,000;49;9;40;0;0;0
681090;Funtoon's World;Adventure, Indie;0 - 20,000;7;5;2;0;0;0
681100;Supermagical;Action, Casual, Indie;0 - 20,000;36;9;27;0;0;0
681110;Eagle Island Twist;Action, Adventure, Indie;0 - 20,000;168;40;128;0;0;0
681140;Last Soldier;Action, Adventure, Indie;20,000 - 50,000;28;35;-7;0;0;0
681150;Rainbow Duck;Action, Casual, Indie;0 - 20,000;12;10;2;0;0;0
681160;Breach of Contract Online;Action, Casual, Indie, Early Access;0 - 20,000;13;21;-8;0;0;0
681190;Secrets of Arcadia;Adventure, RPG, Strategy;0 - 20,000;11;1;10;18;18;0
681240;Dujanah;Adventure, Indie, RPG, Simulation, Strategy;20,000 - 50,000;201;19;182;0;0;0
681260;Red Number: Prologue;Adventure, Indie, RPG;0 - 20,000;4;5;-1;0;0;0
681280;Descenders;Action, Casual, Racing;200,000 - 500,000;12553;759;11794;481;282;252
681290;Hare;Action, Indie, Strategy;0 - 20,000;11;1;10;0;0;0
681330;Helium Rain;Casual, Indie;20,000 - 50,000;183;47;136;874;874;1
681340;ARRAYNIUM;Design & Illustration;0 - 20,000;19;2;17;0;0;0
681350;Battlefield Alliance（战地联盟）;Action, Casual, Indie, Massively Multiplayer;0 - 20,000;7;2;5;0;0;0
681360;Song Samurai;;0 - 20,000;1;2;-1;0;0;0
681380;The Balloonist: Beyond the Clouds.;Action, Adventure, Casual, Indie, Sports;0 - 20,000;4;0;4;0;0;0
681390;ZomDay;Action, Casual, Indie, Sports;50,000 - 100,000;690;119;571;51;51;2
681410;Adventures of the Worm;Action, Adventure, Indie;0 - 20,000;32;2;30;0;0;0
681410;Adventures of the Worm;Casual, Indie;0 - 20,000;32;2;30;0;0;0
681460;Cendric;Adventure, Casual, Indie, Massively Multiplayer, Strategy, Early Access;0 - 20,000;22;5;17;0;0;0
681490;dontbegrey;Casual, Indie, Strategy;0 - 20,000;20;7;13;0;0;0
681500;Lumber King;Action, Adventure, Casual, RPG, Early Access;20,000 - 50,000;55;92;-37;3;5;0
681520;The Rodinia Project;Casual, Indie;0 - 20,000;28;17;11;0;0;0
681530;NOISZ;Casual, Indie;0 - 20,000;65;5;60;0;0;1
681550;Maze Run VR;Action, Adventure, Casual, Indie, Simulation;0 - 20,000;12;9;3;0;0;0
681580;DragonCrash;Casual, Indie;0 - 20,000;0;1;-1;0;0;0
681610;Anti Zombie AI - Tower Defense (Azai - TD);Action, Indie;0 - 20,000;5;4;1;0;0;0
681620;Cube Link;Casual, Indie;20,000 - 50,000;70;26;44;0;0;0
681630;Voxel Interceptor;Indie, Strategy;0 - 20,000;12;4;8;0;0;0
681640;World of Contraptions;Action, Free to Play, Indie, Early Access;0 - 20,000;72;7;65;0;0;0
681660;Bless Online;Action, Indie;1,000,000 - 2,000,000;3761;6282;-2521;476;159;0
681670;Elly The Jelly;Casual, Indie, Simulation, Early Access;0 - 20,000;1;4;-3;0;0;0
681690;Order：VR;Design & Illustration, Utilities, Game Development, Early Access;0 - 20,000;1;1;0;0;0;0
681720;BoxMaker;Casual, Free to Play, Strategy;0 - 20,000;31;70;-39;0;0;0
681730;Nowhere Prophet;Action, Adventure, Indie, RPG, Simulation, Strategy, Early Access;50,000 - 100,000;717;269;448;41;41;5
681740;Liberator TD;Adventure, Casual, Indie, Strategy;0 - 20,000;0;0;0;0;0;0
681750;Voxelaxy [Remastered];Action, Indie;0 - 20,000;31;19;12;119;119;0
681760;DIVER - SEA SURVIVAL SIMULATOR;Action, Indie;0 - 20,000;1;2;-1;0;0;0
681780;Distorted Reality;Free to Play, Indie, Strategy, Early Access;20,000 - 50,000;14;52;-38;4;4;0
681790;ViKubb;Adventure, Casual, Indie;0 - 20,000;21;1;20;0;0;0
681800;Fur Up;Action, Early Access;0 - 20,000;26;2;24;0;0;0
681800;Fur Up;Indie, Strategy, Early Access;0 - 20,000;26;2;24;0;0;0
681820;(Chinese PaladinSword and Fairy 4);Simulation;20,000 - 50,000;492;108;384;1189;988;261
681830;(Chinese PaladinSword and Fairy 5);Action, Adventure, Casual, Simulation;0 - 20,000;76;36;40;2609;3586;14
681840; Chinese PaladinSword and Fairy 5 Prequel;Action, Casual, Indie;20,000 - 50,000;90;31;59;2553;3137;103
681840; Chinese PaladinSword and Fairy 5 Prequel;Action, Casual, Indie, Simulation, Sports;20,000 - 50,000;90;31;59;2553;3137;103
681900;ionAXXIA;Action, Indie;0 - 20,000;4;1;3;0;0;0
681920;Slingshot Cowboy VR;Casual;0 - 20,000;0;1;-1;0;0;0
681950;AddForce;Casual;0 - 20,000;6;5;1;0;0;0
681970;The Tavern;Action, Indie;0 - 20,000;17;5;12;0;0;0
681980;Lycah;Action, Indie, Early Access;0 - 20,000;13;8;5;0;0;0
681990;Battle Squares;Action, Indie;0 - 20,000;16;0;16;0;0;0
682000;Solmec: Among Stars;Indie, Simulation, Strategy, Early Access;0 - 20,000;0;1;-1;0;0;0
682010;Solmec: Colony Adrift;Adventure, Casual, Indie;0 - 20,000;0;2;-2;0;0;0
682020;Karradash - The Lost Dungeons;Casual, Indie, Simulation;0 - 20,000;10;3;7;0;0;0
682080;Pato Box;Casual, Indie;0 - 20,000;91;19;72;549;549;1
682100;All Evil Night;Action, Adventure, Indie;0 - 20,000;12;12;0;0;0;0
682130;Discord Bot Maker;Casual, Indie, Strategy;100,000 - 200,000;2112;262;1850;1302;546;167
682140;Undead Development;Indie, RPG;0 - 20,000;249;66;183;79;125;4
682160;Butterbies;Adventure;0 - 20,000;5;2;3;0;0;0
682170;Witchkin;Action, Indie;0 - 20,000;53;8;45;0;0;0
682180;Tile Battle;Action, Adventure, Indie, Massively Multiplayer, RPG, Early Access;0 - 20,000;7;3;4;0;0;0
682230;Sidewords;Casual, Indie;0 - 20,000;32;1;31;0;0;0
682230;Sidewords;Action, Indie;0 - 20,000;32;1;31;0;0;0
682250;Mayas' Virtual Brush;Adventure, Indie;0 - 20,000;3;0;3;0;0;0
682270;Gender Bender;Indie, RPG;0 - 20,000;2;2;0;0;0;0
682280;Code 9;Action, Casual, Indie, Simulation, Strategy;0 - 20,000;3;0;3;0;0;0
682290;Zeus' Battlegrounds;Casual, Indie;200,000 - 500,000;511;399;112;0;0;0
682340;Slice&Dice;Action;0 - 20,000;1;0;1;0;0;0
682350;Gnome Light;Indie, Simulation, Strategy;20,000 - 50,000;5;16;-11;0;0;0
682360;Deadly Rescue;Adventure, Free to Play, Indie;0 - 20,000;3;3;0;0;0;0
682370;Pooper Scooper;Action, Casual, Indie;0 - 20,000;1;4;-3;0;0;0
682420;DimensionsVS;Violent, Gore, Adventure, Free to Play, Indie;20,000 - 50,000;73;47;26;0;0;0
682470;真实幻象 / Behind The Truth;Action, Adventure, Indie;0 - 20,000;52;7;45;0;0;1
682470;真实幻象 / Behind The Truth;Violent, Gore, Action, Adventure, Indie;0 - 20,000;52;7;45;0;0;1
682480;恒水中学连环虐杀 / The untold story of hengshui school;Action, Adventure, Indie, RPG, Simulation;20,000 - 50,000;331;61;270;441;441;5
682490;鬼山 / A Ghost Around Me;Action, Adventure, Indie;0 - 20,000;58;29;29;0;0;0
682500;绝望游戏 / Desperate game;Casual, Indie;0 - 20,000;20;12;8;0;0;0
682510;以罪之名 / In the name of sin;Adventure;0 - 20,000;16;6;10;0;0;0
682530;MarZ: Tactical Base Defense;Action, Casual, Indie;50,000 - 100,000;596;162;434;201;295;5
682570;SG/ZH: School Girl/Zombie Hunter;Casual, Strategy;0 - 20,000;307;147;160;0;0;1
682590;Dungeon Marathon;Action, Casual, Indie, Simulation, Strategy;0 - 20,000;33;9;24;6;6;0
682610;iubes:2;Casual, Indie, Strategy;0 - 20,000;26;8;18;0;0;0
682630;Box Maze 2 : Agent Cubert;Action, Adventure, Casual, Indie, Strategy;0 - 20,000;19;7;12;0;0;0
682670;初颜 - The Prototype;Action, Indie, Massively Multiplayer, Early Access;0 - 20,000;29;5;24;0;0;0
682730;Hearing;Action, Adventure, Casual, Indie, Strategy;0 - 20,000;14;18;-4;0;0;0
682740;Data Thief;Casual, Indie;0 - 20,000;7;2;5;0;0;0
682780;Breaking Good;Casual, Indie;0 - 20,000;97;13;84;0;0;1
682790;Escape the Omnochronom!;Action, Early Access;0 - 20,000;6;7;-1;0;0;0
682810;GUTS;Indie, Simulation, Strategy, Early Access;0 - 20,000;26;8;18;0;0;0
682820;Metronix Lab;Action, Adventure, RPG;0 - 20,000;0;1;-1;0;0;0
682910;No Lights;Casual, Indie;50,000 - 100,000;59;56;3;1;1;0
682920;Downloaded: Fragments of a Forgotten Soul;Free to Play, Indie, Early Access;0 - 20,000;3;3;0;0;0;0
682960;Purgation;Casual, Indie, Simulation, Strategy;0 - 20,000;11;5;6;0;0;0
682970;MineFight;Indie;100,000 - 200,000;45;105;-60;3;5;0
682990;Drug Dealer Simulator;Casual, Strategy, Early Access;500,000 - 1,000,000;12825;1902;10923;1087;526;415
683000;Evasion;Casual, Free to Play, Simulation;0 - 20,000;46;18;28;0;0;0
683000;Evasion;Adventure;0 - 20,000;46;18;28;0;0;0
683070;Trundle;Action, Adventure, Indie;0 - 20,000;1;0;1;0;0;0
683080;A Mazeing Tower Defense;Free to Play, Strategy;0 - 20,000;5;11;-6;0;0;0
683130;EXON: The Impossible Challenge;Action, Indie;0 - 20,000;4;2;2;0;0;0
683150;Inferno: Deathfield;Action;0 - 20,000;3;5;-2;0;0;0
683180;Corona Borealis;Action, Indie, Strategy;0 - 20,000;16;7;9;0;0;0
683210;Apez;Indie;0 - 20,000;15;12;3;0;0;0
683220;Business-hooiznes;Casual, Indie, Simulation;0 - 20,000;35;32;3;0;0;0
683220;Business-hooiznes;Action, Adventure, Indie;0 - 20,000;35;32;3;0;0;0
683230;Defendoooooor!!;Casual, Indie, Simulation, Strategy;0 - 20,000;22;29;-7;58;58;0
683240;Apocalypse Knights 2.0 - The Angel Awakens;Casual, Indie, Simulation, Strategy;0 - 20,000;6;5;1;0;0;0
683260;Inops;Action, Casual, Indie;0 - 20,000;15;5;10;0;0;1
683310;Cecconoid;Action, Adventure, Casual, Indie;0 - 20,000;13;5;8;0;0;0
683320;GRIS;RPG, Strategy;1,000,000 - 2,000,000;58974;2061;56913;204;146;80
683340;Disassembled;Action, Casual, Sports;0 - 20,000;4;0;4;0;0;0
683430;ASSASSINATION STATION;Casual, Indie;0 - 20,000;6;0;6;0;0;0
683440;BootyBuns & 21;Indie, Strategy;0 - 20,000;10;5;5;0;0;0
683490;Formula E: Grand Prix;Adventure, Indie;0 - 20,000;1;0;1;0;0;0
683530;FreeFly Burning;Adventure, Casual, Free to Play, Strategy;20,000 - 50,000;31;43;-12;31;31;0
683600;Football Mogul 18;Action, Adventure, Indie, RPG, Strategy, Early Access;20,000 - 50,000;5;13;-8;0;0;0
683620;Excursion;Indie, RPG, Simulation, Strategy;0 - 20,000;2;0;2;0;0;0
683630;Half Past Disaster;Adventure, Indie;0 - 20,000;5;0;5;0;0;0
683670;BLOKDODGE;Casual, Simulation;0 - 20,000;35;8;27;0;0;0
683690;Supermarket Tycoon;;0 - 20,000;22;24;-2;433;433;0
683730;CrownFall;Adventure;0 - 20,000;11;9;2;0;0;0
683770;Rover Builder;Action;0 - 20,000;50;16;34;0;0;2
683790;Tractorball;Gore, Adventure, Indie, RPG;0 - 20,000;13;6;7;0;0;0
683810;The Dark Age I : Zordon's Empire;Action, Free to Play, Sports;0 - 20,000;1;2;-1;0;0;0
683830;Weable;Utilities;200,000 - 500,000;200;60;140;263;286;7
683840;Galaxia Conquestum;Action, Adventure, Casual, Indie;20,000 - 50,000;3;1;2;0;0;0
683870;Quest of Vidhuraa;Adventure, Indie;0 - 20,000;22;4;18;60;60;1
683880;VR Robotics Simulator;Sexual Content, Nudity, Casual, Indie;0 - 20,000;13;0;13;0;0;0
683890;Operation Sheep Defense;Action;0 - 20,000;19;2;17;0;0;1
683900;RollerCoaster Tycoon Classic;Free to Play, Indie, RPG;200,000 - 500,000;1572;184;1388;1545;2672;269
683910;System Siege;Adventure, Indie, RPG;0 - 20,000;5;4;1;0;0;0
683930;A Wonder;Casual, Indie, Simulation;100,000 - 200,000;59;57;2;1;1;0
683940;Lawgivers;Indie, Simulation;20,000 - 50,000;290;55;235;92;92;3
683960;Tower And Guardian 塔与守护者;Indie, Simulation, Strategy, Early Access;20,000 - 50,000;0;1;-1;0;0;0
683970;Entwined: The Perfect Murder;Adventure, Casual, Indie, Strategy;0 - 20,000;17;12;5;0;0;1
684000;Wooden Ocean;Casual, Indie;0 - 20,000;21;2;19;0;0;0
684040;Logos;Action, Adventure, Casual, Indie;0 - 20,000;20;12;8;0;0;0
684050;Achievement Idler: Black;Casual;20,000 - 50,000;261;53;208;1;1;1
684060;The Hero Unmasked!;Indie, Racing;0 - 20,000;20;2;18;0;0;0
684130;Crimson Tide: Operation Online;Casual, Strategy;0 - 20,000;6;13;-7;0;0;0
684170;Hexlide;Indie;0 - 20,000;6;3;3;0;0;0
684200;Icons: Legacy Edition;Casual, Indie;100,000 - 200,000;413;575;-162;59;59;0
684210;7;Indie, Massively Multiplayer, Strategy, Early Access;20,000 - 50,000;138;36;102;0;0;1
684230;Madcap Castle;Adventure, Indie;0 - 20,000;17;1;16;0;0;0
684250;月之暗面 The Dark Side Of The Moon;Adventure;20,000 - 50,000;33;24;9;0;0;0
684260;Phantom Warfare;Action, Adventure, Casual, Indie, Simulation, Early Access;0 - 20,000;6;0;6;0;0;0
684270;Silicon Zeroes;Indie, RPG, Strategy, Early Access;0 - 20,000;211;22;189;657;657;1
684320;HOT PINK;Action, Adventure, Casual, Indie;0 - 20,000;21;1;20;0;0;0
684330;Impromptu Vector Field Painter;Indie, RPG;0 - 20,000;5;0;5;0;0;0
684340;"""Project Whateley""";Action, Casual, Strategy;0 - 20,000;3;1;2;0;0;0
684350;Tank Tactics - TDS;Action, Indie, Simulation;50,000 - 100,000;4;0;4;0;0;0
684380;MermaidVR Video Player;Action, Adventure, Indie;50,000 - 100,000;97;36;61;81;97;3
684400;Power War:The First Men;Action, RPG;0 - 20,000;8;4;4;0;0;0
684410;Bridge Constructor Portal;Action;200,000 - 500,000;4059;357;3702;464;245;28
684420;Steampunk Syndicate 2;Action, Free to Play, Indie, Strategy, Early Access;0 - 20,000;6;8;-2;0;0;0
684430;JU;Adventure, Casual, Indie;0 - 20,000;20;0;20;0;0;0
684450;Surviving the Aftermath;Casual, Indie;100,000 - 200,000;2509;1045;1464;337;426;217
684460;Project Lucie;Action, Casual, Indie, Racing, Simulation;0 - 20,000;39;22;17;0;0;0
684470;Super Blockbreak 3D;Action, Adventure, Indie, RPG;0 - 20,000;2;3;-1;0;0;0
684510;Orn the tiny forest sprite;Casual, Indie, RPG, Strategy;0 - 20,000;2;7;-5;0;0;0
684530;Lance A Lot: Enhanced Edition;Action, Indie, Simulation;0 - 20,000;73;2;71;0;0;0
684530;Lance A Lot: Enhanced Edition;Free to Play, RPG;0 - 20,000;73;2;71;0;0;0
684560;Beyond the Wall;Adventure, Indie, RPG;0 - 20,000;6;9;-3;0;0;0
684570;Dr. Dungeon's MADMAN!;Indie;0 - 20,000;4;1;3;0;0;0
684570;Dr. Dungeon's MADMAN!;Action, Adventure, Indie;0 - 20,000;4;1;3;0;0;0
684580;Shoppe Keep 2;Adventure, Casual, Indie, RPG, Early Access;200,000 - 500,000;1204;892;312;392;365;8
684590;Tale of Enki: Pilgrimage;Action, Casual, Indie;0 - 20,000;16;2;14;0;0;0
684620;JetX VR;Action;0 - 20,000;43;11;32;0;0;0
684650;Turret Sector;Action, Casual, Indie;0 - 20,000;2;3;-1;0;0;0
684680;Polygoneer;Violent, Gore, Action, Casual, Indie, Early Access;200,000 - 500,000;1186;301;885;84;23;1
684690;Grid Cartographer;Action, Adventure, Early Access;0 - 20,000;52;2;50;0;0;2
684700;Celestian Tales: Realms Beyond;Action, Casual, Indie, Racing, Early Access;0 - 20,000;19;9;10;0;0;0
684720;Battlegun;Adventure, Indie, Massively Multiplayer, RPG, Strategy;20,000 - 50,000;191;88;103;3;3;0
684720;Battlegun;Action, Casual, Free to Play, Indie;20,000 - 50,000;191;88;103;3;3;0
684740;Dungeons 3 Beta;Action, Indie;0 - 20,000;0;0;0;0;0;0
684770;Fall Fear Fly Redemption;Action, Adventure, Casual, Indie, Strategy;0 - 20,000;2;1;1;0;0;0
684800;Log Jammers;Action, Indie;0 - 20,000;4;0;4;0;0;0
684820;Singularity Roller;Action, Casual, Indie, Racing;0 - 20,000;9;30;-21;0;0;0
684840;Days Of Purgatory;Violent, Indie;0 - 20,000;13;0;13;0;0;2
684870;Spiral Splatter;Action, Adventure, Indie;20,000 - 50,000;62;28;34;0;0;1
684930;Fantasy ERA;Adventure, Indie, RPG;0 - 20,000;6;10;-4;0;0;0
684940;LOGistICAL: British Isles;Action, Adventure, Indie;0 - 20,000;17;3;14;0;0;0
684970;Rules of Destruction;Free to Play, Simulation;0 - 20,000;4;2;2;0;0;0
684980;Sudokube;Action, Adventure, Indie;0 - 20,000;8;1;7;0;0;0
685040;Mr Rabbit's Jigsaw Puzzle;Action, Indie, Early Access;0 - 20,000;9;9;0;0;0;0
685050;Spartan;Indie;0 - 20,000;17;4;13;0;0;0
685110;Metachromium;Indie, Simulation, Strategy;0 - 20,000;12;1;11;0;0;0
685120;Geometry World;Casual, Indie, Simulation, Strategy;0 - 20,000;4;0;4;0;0;0
685130;Radar Defense;Adventure, Indie, Simulation;0 - 20,000;6;1;5;0;0;0
685200;Seconds to Square;Casual, Indie, Sports, Strategy;20,000 - 50,000;46;14;32;0;0;0
685230;Alienzix;Casual, Indie, Racing;20,000 - 50,000;36;18;18;1;1;0
685240;Paradiddle;Action, Casual, Indie;0 - 20,000;376;30;346;73;73;13
685300;Portrait Wizard;Casual, Indie, Strategy;0 - 20,000;56;9;47;87;87;0
685310;Transport Defender;Action, Indie;200,000 - 500,000;313;81;232;1441;2152;30
685330;Lost Connection;Adventure, Casual, Indie;0 - 20,000;0;1;-1;0;0;0
685340;Delivery from the Pain:Survival / 末日方舟:生存;Casual, Free to Play, Indie;50,000 - 100,000;747;174;573;462;583;17
685370;Jewels of the Mysterious Woodland;Adventure, Casual, Indie, RPG, Simulation, Strategy;0 - 20,000;3;8;-5;0;0;0
685400;Skelly Selest;Action, Adventure, Indie;20,000 - 50,000;247;15;232;0;0;0
685420;Grace of Zordan;Action, Adventure, Indie, RPG, Strategy, Early Access;50,000 - 100,000;87;70;17;0;0;0
685430;Run Crabby Run - adventure;Action, Indie, Early Access;0 - 20,000;4;4;0;0;0;0
685450;Cobos;Software Training, Utilities;0 - 20,000;7;2;5;0;0;0
685570;TurretMaster;Casual, Indie, Simulation, Early Access;0 - 20,000;4;0;4;0;0;0
685670;Know by heart;Action, Casual, Indie;0 - 20,000;511;68;443;0;0;1
685680;Sakura Gamer;Violent, Action, Indie, Simulation;0 - 20,000;339;64;275;95;135;1
685690;Guns'n'Stories: Bulletproof VR;Adventure, Indie;0 - 20,000;350;44;306;27;39;3
685700;Asteroid Hunter;Violent, Adventure;0 - 20,000;1;0;1;0;0;0
685730;VR Darts Zone;Adventure, Indie, Strategy;0 - 20,000;0;1;-1;0;0;0
685750;The soldier in the mine;Casual;20,000 - 50,000;50;42;8;0;0;0
685760;Stones of Rome;Casual;0 - 20,000;6;1;5;0;0;0
685770;2D Mahjong Temple;Casual, Indie, Simulation;0 - 20,000;5;3;2;0;0;0
685790;Ruthless Safari;Audio Production, Video Production;20,000 - 50,000;131;125;6;121;121;0
685800;Tough Story: Big Hell;Adventure, Indie;0 - 20,000;10;1;9;0;0;0
685870;Homelesshood;Action, Free to Play, Early Access;0 - 20,000;0;0;0;0;0;0
685910;Battlefleet Engineer;Utilities;0 - 20,000;11;2;9;0;0;0
685920;Angry Gnome;Casual, Indie;0 - 20,000;6;1;5;0;0;0
685950;Joy Pony;Adventure, Indie;0 - 20,000;145;73;72;0;0;0
685970;Martha Madison: Forces;Casual, Indie;0 - 20,000;0;1;-1;0;0;0
685990;Forgotten Land;Action, Casual, Indie;0 - 20,000;39;72;-33;44;44;0
686000;Lightwire;Action, Indie, Early Access;0 - 20,000;1;0;1;0;0;0
686010;The Hunt - Rebuilt;Free to Play, Indie;0 - 20,000;23;2;21;0;0;0
686030;Digital Domain’s Monkey King;Action, Indie;0 - 20,000;14;3;11;0;0;0
686040;ReallyGoodBattle;Adventure, Casual, Indie;0 - 20,000;4;2;2;0;0;0
686090;Bloodlines of Prima;Action, Casual, Indie;0 - 20,000;35;33;2;0;0;0
686100;CanBoom VR;Action, Adventure, Indie, RPG, Strategy;0 - 20,000;0;2;-2;0;0;0
686110;Robot Heroes;Action, Adventure, Indie;0 - 20,000;55;13;42;2;3;0
686110;Robot Heroes;Action, Indie, Early Access;0 - 20,000;55;13;42;2;3;0
686180;Cat Girl;Action;20,000 - 50,000;278;198;80;47;66;0
686190;Killing Time;Action, Casual, Indie, Simulation, Strategy;200,000 - 500,000;900;306;594;136;159;3
686200;Door Kickers: Action Squad;Action;500,000 - 1,000,000;8244;460;7784;395;153;266
686240;Gunducky Industries++;Action, Casual, Indie, Strategy;0 - 20,000;4;3;1;0;0;0
686240;Gunducky Industries++;Audio Production, Utilities;0 - 20,000;4;3;1;0;0;0
686260;Forged Battalion;Action;100,000 - 200,000;618;434;184;238;249;3
686270;Kiitsu;Action, Casual, Indie, Early Access;0 - 20,000;3;1;2;0;0;0
686290;RADical ROACH: Infinity;Action, Adventure, Indie;0 - 20,000;1;1;0;0;0;0
686300;Neon Coliseum;Action, Indie, Early Access;0 - 20,000;2;0;2;0;0;0
686340;Insanity VR: Last Score;Action, Indie;50,000 - 100,000;145;29;116;57;57;0
686360;Dungeons & Treasure VR;Action, Massively Multiplayer;0 - 20,000;51;17;34;0;0;1
686380;Nightmare at the lighthouse;Free to Play, Indie, Strategy;0 - 20,000;2;6;-4;0;0;0
686440;Hard Time;Action, Indie, RPG, Early Access;0 - 20,000;193;26;167;109;109;0
686450;The Little Ball That Could;Action, Indie;0 - 20,000;26;3;23;0;0;0
686490;ArkanoidSmoking;Indie, RPG;0 - 20,000;5;7;-2;0;0;0
686500;Sylvio 2;Casual, Indie, Racing;20,000 - 50,000;40;26;14;0;0;0
686510;Fatty Rabbit Hole;Action, Adventure, Simulation;0 - 20,000;11;0;11;0;0;0
686520;Gnomes Garden New home;Adventure, Free to Play, Indie;0 - 20,000;37;5;32;0;0;1
686550;Trivia Vault: Mixed Trivia;Action, Adventure, Indie;0 - 20,000;37;37;0;1;2;0
686550;Trivia Vault: Mixed Trivia;Indie;0 - 20,000;37;37;0;1;2;0
686570;Freedom Defender;Adventure, Casual, Indie, RPG, Simulation, Sports, Strategy;0 - 20,000;90;49;41;0;0;0
686580;Storms of Shambhala;Utilities;0 - 20,000;4;0;4;0;0;0
686600;Rapture Rejects;Action, Indie;100,000 - 200,000;703;1049;-346;38;40;0
686610;Sobreviva;Casual, Indie;0 - 20,000;5;5;0;0;0;0
686620;3D Mahjong worlds;Audio Production, Utilities, Video Production;0 - 20,000;7;5;2;0;0;0
686630;Bricks In The Box;Racing, Simulation, Sports;0 - 20,000;2;0;2;0;0;0
686640;Space Panic Arena;Action;0 - 20,000;4;6;-2;0;0;0
686680;Computer Tycoon;Action, Indie, RPG;50,000 - 100,000;716;128;588;139;258;7
686720;SaGa SCARLET GRACE: AMBITIONS;Indie, Simulation, Strategy, Early Access;0 - 20,000;150;42;108;0;0;22
686740;Haunted Dungeons: Hyakki Castle;Casual, Indie;0 - 20,000;15;10;5;0;0;0
686770;The Wind and Wilting Blossom;Action, Adventure, Indie, Strategy;0 - 20,000;157;8;149;0;0;1
686810;Hell Let Loose;Action, Casual, Indie;2,000,000 - 5,000,000;78703;13237;65466;2282;715;7261
686870;Lost Items;Free to Play, Indie;20,000 - 50,000;26;9;17;3;6;20
686900;Bronze Age - HD Edition;Adventure, Indie, Racing, Strategy, Early Access;100,000 - 200,000;212;68;144;187;187;1
686910;Delirium;Violent, Gore, Action, Free to Play, Indie, Massively Multiplayer;0 - 20,000;10;9;1;0;0;0
686940;Captivus;Action, Indie;0 - 20,000;6;2;4;0;0;0
686950;AESCULAP OrthoPilotElite VR Palpation;Action, Casual, Indie;0 - 20,000;13;5;8;0;0;0
687260;Tokyo Dark;Sexual Content, Nudity, Casual;20,000 - 50,000;1029;166;863;106;206;2
687270;Divide;Casual, Indie;0 - 20,000;5;6;-1;0;0;0
687280;The Awakening;Animation & Modeling, Audio Production, Utilities;20,000 - 50,000;28;27;1;0;0;0
687310;Xenia;Action, Casual, Indie;0 - 20,000;18;4;14;0;0;0
687320;MINE!;Adventure, Indie;0 - 20,000;10;5;5;0;0;0
687360;Doodle Jamboree;Action, Adventure, Casual, Indie;0 - 20,000;16;1;15;0;0;0
687390;Huedango;Action, Indie;0 - 20,000;2;3;-1;0;0;0
687420;Lone Vessel;Action, Indie, Simulation;0 - 20,000;1;0;1;0;0;0
687420;Lone Vessel;Action, Adventure, Indie, Early Access;0 - 20,000;1;0;1;0;0;0
687480;Trivia Vault: Science & History Trivia;Adventure, Casual, Indie;0 - 20,000;43;40;3;5;9;0
687490;Trivia Vault: Super Heroes Trivia;Casual, Indie;0 - 20,000;55;44;11;1;1;0
687510;WireNet;Adventure, Casual, Indie;0 - 20,000;23;11;12;2;2;0
687540;Tasty Planet;Action, Free to Play;0 - 20,000;168;32;136;47;47;2
687560;Avoid The Monsters;Action, Casual, Indie;0 - 20,000;21;8;13;0;0;0
687590;Juniper's Knot;Adventure, Casual, Indie, Simulation;0 - 20,000;246;13;233;16;16;0
687590;Juniper's Knot;Action, Adventure;0 - 20,000;246;13;233;16;16;0
687600;Magic Pixel Picross;Adventure, Casual, Indie, RPG, Strategy;0 - 20,000;8;15;-7;0;0;0
687610;Cat vs. Corgis;Action, Indie, RPG;0 - 20,000;5;1;4;0;0;0
687630;Epic Cards Battle 2 (TCG);Action, Casual, Indie, RPG, Simulation;50,000 - 100,000;69;48;21;27;27;0
687640;Infinity Assassin (VR);Adventure, Casual, Indie, Racing;0 - 20,000;0;3;-3;0;0;0
687650;Childhood grocery 辣条杂货店 学校小卖部 :令人感动的童年回忆，经典策略模拟经营解密;Violent, Gore, Action, Adventure, Indie;20,000 - 50,000;169;144;25;31;31;0
687720;Baobabs Mausoleum Ep.2: 1313 Barnabas Dead End Drive;Casual, Indie, Early Access;0 - 20,000;12;4;8;0;0;0
687730;My Way VR;Adventure, Indie, RPG, Strategy;0 - 20,000;3;3;0;0;0;0
687750;Yandere School;Action;;;;0;;;
687760;Occultus - Mediterranean Cabal;Action, Indie;0 - 20,000;32;17;15;0;0;1
687830;Transparent Black;Free to Play, Racing, Simulation, Early Access;0 - 20,000;228;11;217;152;152;1
687850;Head Goal: Soccer Online;Action, Indie;50,000 - 100,000;547;146;401;60;64;13
687870;CINEVR;Casual, Simulation, Strategy;20,000 - 50,000;19;39;-20;0;0;0
687890;Runaway VR;English;0 - 20,000;16;4;12;4;4;0
687900;unWorded;Adventure, Indie, RPG, Strategy;0 - 20,000;25;9;16;0;0;0
687920;Tropical Liquor;Action, Adventure, Indie, RPG;20,000 - 50,000;574;138;436;88;145;2
687950;Suburban Scavengers;Indie, Racing;0 - 20,000;0;0;0;0;0;0
687980;Mothlight;Action;20,000 - 50,000;361;20;341;0;0;0
688000;Trials of the Thief-Taker;Indie, Strategy, Early Access;0 - 20,000;6;4;2;0;0;0
688020;Kitchen Simulator 2;Action, Adventure, Casual, RPG;0 - 20,000;36;44;-8;0;0;0
688050;BoidWatch;Action, Adventure, Casual, Free to Play, Indie;0 - 20,000;1;0;1;0;0;0
688060;Odd Realm;Indie, RPG, Simulation;20,000 - 50,000;667;74;593;1007;1007;4
688070;Legendary Gary;Casual, Indie, Simulation;0 - 20,000;37;2;35;0;0;1
688110;BlockGame;Sports;0 - 20,000;11;1;10;0;0;0
688120;TOXICANT;Nudity, Casual, Free to Play, Indie, Massively Multiplayer, Strategy, Early Access;0 - 20,000;10;2;8;0;0;0
688130;Pogostuck: Rage With Your Friends;Indie;200,000 - 500,000;4182;774;3408;475;375;117
688140;Tempest 4000;Adventure, Indie;0 - 20,000;97;48;49;0;0;0
688150;JUMPER : SPEEDRUN;Action, Indie;0 - 20,000;8;14;-6;0;0;0
688170;Denki Gaka's Bombshell;Indie, Simulation, Strategy;20,000 - 50,000;4;0;4;0;0;0
688180;80.08;Action, Casual, Indie;0 - 20,000;1;0;1;0;0;0
688200;Cassandra's Fabulous Foray;Casual, Indie;0 - 20,000;2;1;1;0;0;0
688210;Deathlands;Casual, Indie;0 - 20,000;3;0;3;0;0;0
688260;Morph Girl;Adventure, Indie, RPG, Simulation, Strategy;0 - 20,000;52;24;28;0;0;0
688330;Zombie Commando 3D;Adventure, Free to Play;0 - 20,000;3;1;2;0;0;0
688350;Wrath of the Goliaths: Dinosaurs;Action, Adventure, Indie;0 - 20,000;7;13;-6;0;0;0
688370;Cyberoque;Action, Casual, Indie, Sports;0 - 20,000;11;6;5;0;0;0
688380;Restoration;Casual;20,000 - 50,000;30;5;25;0;0;0
688400;Geostorm - Turn Based Puzzle Game;Education;20,000 - 50,000;29;7;22;0;0;0
688420;Bad North: Jotunn Edition;Indie, Massively Multiplayer, Simulation, Early Access;500,000 - 1,000,000;7103;582;6521;329;237;72
688450;Old Adventure;Action, Adventure, Indie;0 - 20,000;11;8;3;0;0;0
688470;汉匈决战/Han Xiongnu Wars;Action, Casual, Indie;500,000 - 1,000,000;2269;1557;712;3822;6311;189
688480;EVE: Valkyrie – Warzone;Action, Adventure, Casual, Indie;20,000 - 50,000;232;172;60;0;0;0
688500;Rise of One;Adventure, RPG, Strategy;20,000 - 50,000;52;35;17;0;0;0
688570;Romance with Chocolate - Hidden Object in Paris. HOPA;Action, Casual, Indie;0 - 20,000;31;26;5;0;0;0
688620;Tiny Force Deluxe;Action, Casual, Indie, Sports, Early Access;20,000 - 50,000;4;3;1;0;0;0
688630;Nightork Adventures 2 - Legacy of Chaos;Action, Indie;50,000 - 100,000;11;28;-17;0;0;0
688650;You Doesn't Exist;Violent, Gore, Action, Adventure, Casual, Indie, RPG, Early Access;20,000 - 50,000;41;25;16;1;1;0
688660;Her Majesty's Ship;Adventure, Indie;0 - 20,000;53;55;-2;0;0;0
688680;Oswald's Adventure;Action, Adventure, Indie, Strategy;0 - 20,000;20;7;13;0;0;0
688690;YOBA;Action, Adventure, Indie, RPG;0 - 20,000;66;22;44;0;0;0
688720;Infinity Fall;Action, Adventure, RPG;0 - 20,000;7;0;7;0;0;0
688740;Fractured Minds;Adventure, Indie;20,000 - 50,000;243;61;182;0;0;1
688750;MineDrill Redux;Casual, Indie;0 - 20,000;1;4;-3;0;0;0
688770;TETRUX: Online;Sexual Content, Nudity, Casual, Free to Play, Indie, RPG;20,000 - 50,000;92;12;80;0;0;0
688780;Taras Bulba and platforms of Hoolion;Violent, Gore, Action, Adventure, Indie;0 - 20,000;2;0;2;0;0;0
688790;Nebula Nuker;Action, Casual, Indie;0 - 20,000;4;0;4;0;0;0
688800;Paralysis;Adventure, Casual, Indie;0 - 20,000;19;6;13;0;0;0
688880;Cynoclept: The Game;Action, Indie;0 - 20,000;16;14;2;0;0;0
688900;Endless Reality;Adventure, Indie;0 - 20,000;2;0;2;0;0;0
688910;CUBE-C: VR Game Collection;Casual, Indie, Racing;0 - 20,000;0;0;0;0;0;0
688930;City of Ages: Picture Supportive Text MUD (server and client included);Adventure, Early Access;0 - 20,000;14;4;10;0;0;0
688940;Steve's Pub - Soda on tap;Adventure, Casual, Indie, Sports;0 - 20,000;6;3;3;0;0;0
689000;Vulture;Adventure, Casual, Indie;0 - 20,000;14;3;11;0;0;0
689020;final m00n - Defender of the Cubes;Action, Adventure, Early Access;0 - 20,000;10;4;6;0;0;0
689030;Infection Rate;Casual, Indie;0 - 20,000;6;4;2;0;0;0
689040;Scuttlers;Action, Casual, Indie;0 - 20,000;20;4;16;0;0;0
689050;Next Stop: Zombie;Adventure, Indie, RPG;0 - 20,000;4;4;0;0;0;0
689070;Asyula 方舟之链;Action, Adventure, Indie;50,000 - 100,000;213;25;188;0;0;1
689090;Microtransaction Simulator;Violent, Action, Casual, Indie, Early Access;20,000 - 50,000;697;109;588;36;54;3
689100;Ravager;Action, Casual, Indie;0 - 20,000;11;14;-3;21;21;0
689120;Scuffle Scoundrels;Violent, Gore, Action, Adventure, Casual, Indie, RPG, Strategy;0 - 20,000;3;0;3;0;0;0
689160;Eruption;Action, Casual, Indie, Early Access;0 - 20,000;14;4;10;0;0;0
689170;Potemkin;Action, Adventure, Indie, Simulation;0 - 20,000;13;2;11;0;0;0
689180;Trivia Vault: 1980's Trivia;Strategy;0 - 20,000;56;39;17;15;23;0
689210;The Museum of ThroughView;Casual, Indie;0 - 20,000;1;0;1;0;0;0
689270;Chessia;Action, Adventure, Indie;0 - 20,000;3;4;-1;0;0;0
689290;My RC Buggy! VR;Indie, Simulation, Strategy, Early Access;0 - 20,000;20;1;19;0;0;0
689300;Monsteria;Casual, Indie, Strategy;200,000 - 500,000;5;0;5;0;0;0
689340;LOGistICAL: USA - Florida;Action, Indie, Strategy;0 - 20,000;8;2;6;0;0;0
689350;Ruin City Gasolina;Indie, Simulation;0 - 20,000;29;58;-29;1;2;0
689350;Ruin City Gasolina;Action, Adventure, Indie;0 - 20,000;29;58;-29;1;2;0
689360;The Thirst of Hearts;Action, Adventure, Casual, Indie, Simulation, Strategy;20,000 - 50,000;47;87;-40;1;1;0
689400;Madu Maths;Early Access;20,000 - 50,000;122;23;99;91;91;2
689470;Chromasia - Rock Paper Tactics;Action, Adventure, Free to Play, Indie, Simulation, Strategy;0 - 20,000;18;1;17;0;0;0
689480;Leon's crusade (La cruzada de León);Action, Casual, Indie;0 - 20,000;5;7;-2;0;0;0
689520;★ Fallalypse ★;Action, Adventure, Indie, Early Access;0 - 20,000;13;41;-28;0;0;0
689580;TurnSignal;Action, Casual, Indie, Simulation, Strategy;1,000,000 - 2,000,000;561;53;508;11518;11518;31
689600;Little Earth;Casual, Indie, Simulation, Strategy;0 - 20,000;1;0;1;0;0;0
689610;Hunt 'n Sneak;Action;0 - 20,000;2;2;0;0;0;0
689620;Alpha Mike Foxtrot VR - AMF VR;Adventure, Indie, Racing, RPG, Simulation, Early Access;0 - 20,000;52;39;13;26;26;0
689650;Les Fleursword;Design & Illustration, Early Access;20,000 - 50,000;160;145;15;0;0;0
689660;Without A Roof (W.A.R.);Action, Adventure, Indie, RPG;0 - 20,000;2;5;-3;0;0;0
689680;Memories;Action, Adventure;0 - 20,000;7;1;6;0;0;0
689700;Mad Crown;Casual, Free to Play, Simulation;0 - 20,000;118;31;87;0;0;0
689710;Hop Step Sing! Kimamani☆Summer vacation (HQ Edition);Action, Indie;0 - 20,000;95;3;92;0;0;0
689710;Hop Step Sing! Kimamani☆Summer vacation (HQ Edition);Action, Casual, Indie;0 - 20,000;95;3;92;0;0;0
689720;Gangsta Underground : The Poker;Action, Adventure, Indie, Simulation, Early Access;20,000 - 50,000;43;10;33;0;0;0
689740;Mystery Loss;Adventure, Casual, Free to Play, Indie;0 - 20,000;13;5;8;0;0;0
689740;Mystery Loss;Adventure, Indie;0 - 20,000;13;5;8;0;0;0
689790;VEGAS Pro 15 Edit Steam Edition;Adventure;0 - 20,000;151;88;63;53;53;11
689830;DUELEUM;Adventure;20,000 - 50,000;12;7;5;1;1;0
689850;DlodloVRPlayer;Adventure, Casual, Indie, Simulation, Early Access;0 - 20,000;0;1;-1;0;0;0
689880;Bee Aware! 2.0;Casual, Indie;0 - 20,000;4;0;4;0;0;0
689900;Darkestville Castle;Action, Indie, Strategy, Early Access;20,000 - 50,000;431;29;402;257;259;2
689910;Another Lost Phone: Laura's Story;Adventure, Casual, Indie;20,000 - 50,000;656;56;600;68;111;1
689980;Car Trader Simulator;Action, Strategy;20,000 - 50,000;341;118;223;152;229;5
690000;Slimebrawl;Casual;0 - 20,000;2;1;1;0;0;0
690040;SUPERHOT: MIND CONTROL DELETE;Casual, Free to Play, Indie, Simulation;500,000 - 1,000,000;8449;1490;6959;283;194;60
690060;SORE;Casual, Indie;100,000 - 200,000;188;105;83;1;1;0
690080;Deadly Traps;Early Access;0 - 20,000;13;8;5;0;0;0
690120;Inked: A Tale of Love;Casual, Indie, Early Access;20,000 - 50,000;156;28;128;0;0;0
690130;FlatFatCat;Action, Massively Multiplayer, Early Access;0 - 20,000;20;5;15;0;0;0
690140;Sword Legacy: Omen;Violent, Gore, Indie;50,000 - 100,000;418;219;199;176;262;4
690150;Fossil Hunters;;20,000 - 50,000;60;10;50;0;0;0
690200;Capsular;Casual, Indie, Simulation;20,000 - 50,000;67;9;58;0;0;0
690220;Call Me Skyfish;Casual, Indie;0 - 20,000;7;8;-1;0;0;0
690240;Trivia Vault: Classic Rock Trivia;Action, Indie, Early Access;0 - 20,000;53;37;16;10;20;0
690250;Judge Dredd 95;Action, Adventure, Indie;20,000 - 50,000;9;9;0;7;7;0
690260;Tower Miners;Adventure, Casual, Indie;0 - 20,000;3;1;2;0;0;0
690280;ASMR Universe 2;Action, Adventure, Indie, RPG;0 - 20,000;7;4;3;0;0;0
690310;SiegeVR;Casual, Indie;0 - 20,000;9;3;6;0;0;0
690350;Endless Combat;Adventure, Indie, Strategy;0 - 20,000;54;15;39;20;20;0
690350;Endless Combat;Adventure, Indie, RPG;0 - 20,000;54;15;39;20;20;0
690370;Cantata;Casual, Indie, Simulation;20,000 - 50,000;60;11;49;0;0;0
690400;Rainbow Step;Indie, Simulation, Sports, Strategy;0 - 20,000;42;5;37;0;0;0
690410;Twisted: Enhanced Edition;Action, Adventure, Indie;0 - 20,000;2;0;2;0;0;0
690420;Quickscoper Doge: The Dank Illuminati Memes;;0 - 20,000;189;6;183;0;0;0
690440;Korvae in space;Action, Adventure, Indie, RPG, Early Access;0 - 20,000;2;0;2;0;0;0
690460;Sky Hunter;Casual, Indie;0 - 20,000;16;22;-6;0;0;0
690510;Immortal Soul: Black Survival;Action, Adventure, Indie, RPG;500,000 - 1,000,000;4149;986;3163;433;102;2
690530;灵魂筹码 Soul at Stake;Indie;500,000 - 1,000,000;6335;2026;4309;2057;105;113
690550;Pogo;Action, Indie, Simulation;0 - 20,000;17;1;16;0;0;0
690560;I Am Overburdened;Action, Adventure, Indie, RPG;20,000 - 50,000;131;18;113;0;0;1
690570;Drone Racer: Canyons;Action, Casual, Indie;0 - 20,000;10;1;9;0;0;0
690580;Evil Spirits;Casual, Indie, Simulation, Strategy;0 - 20,000;18;28;-10;0;0;0
690610;MagiCats Builder (Crazy Dreamz);Indie, RPG, Simulation;50,000 - 100,000;122;72;50;36;40;0
690620;Downward Spiral: Horus Station;RPG;0 - 20,000;100;27;73;0;0;0
690630;Light Fantastik;Action;0 - 20,000;27;3;24;0;0;0
690640;Trine 4: The Nightmare Prince;Violent, Action, Indie, Early Access;1,000,000 - 2,000,000;9490;979;8511;593;512;141
690670;Klondike Solitaire Kings;Nudity, Violent, Indie, Massively Multiplayer, Early Access;0 - 20,000;3;5;-2;0;0;1
690690;NEUTRANS;Adventure, Casual, Free to Play, Early Access;0 - 20,000;5;1;4;0;0;0
690710;HEIANKYO ALIEN / 平安京エイリアン;Sexual Content, Nudity, Adventure, RPG;0 - 20,000;24;3;21;0;0;0
690740;BOOKS;Action, Casual, Indie, Strategy, Early Access;20,000 - 50,000;86;52;34;74;74;0
690770;SOUND FORGE Audio Studio 12 Steam Edition;Casual, Indie, Strategy;0 - 20,000;51;12;39;0;0;3
690790;DiRT Rally 2.0;Adventure, Casual, Indie, Strategy;1,000,000 - 2,000,000;27613;4267;23346;1306;504;1540
690810;Killing Floor: Incursion;Action, Casual, Indie;20,000 - 50,000;481;429;52;294;311;4
690820;The Sunset 2096;Adventure, Casual, RPG, Simulation, Strategy;0 - 20,000;2;3;-1;0;0;0
690830;Foundation;Adventure, Casual;500,000 - 1,000,000;11081;1675;9406;818;683;1417
690840;Martha Madison: Simple Machines Volume 1;Adventure, Casual;0 - 20,000;0;1;-1;0;0;0
690850;Magibot;Adventure, Casual;0 - 20,000;11;2;9;0;0;0
690860;Pirate Jump 2;Action, Casual, Indie;0 - 20,000;0;3;-3;0;0;0
690930;Evening Surprise;Adventure, Casual;20,000 - 50,000;572;71;501;15;16;0
690950;Skeleton Sprint;Adventure, Casual;0 - 20,000;4;0;4;0;0;0
690980;TO4: Tactical Operations;Adventure, Casual;20,000 - 50,000;185;67;118;0;0;0
691020;Fog Of War - Free Edition;Adventure, Casual;200,000 - 500,000;896;831;65;25;15;4
691080;3D Hardcore Cube;Adventure, Casual;20,000 - 50,000;93;72;21;0;0;0
691090;Fates Call: A New Beginning;Indie, Strategy;0 - 20,000;2;6;-4;0;0;0
691150;Saku Saku: Love Blooms with the Cherry Blossoms;Action, Indie;50,000 - 100,000;239;22;217;247;247;2
691160;Electronauts - VR Music;Casual, Indie, Simulation, Strategy;20,000 - 50,000;423;31;392;139;174;2
691190;Desktop Audio Visualizer;Action, Adventure, Casual, Indie, Simulation, Strategy;0 - 20,000;32;20;12;0;0;3
691220;Parkour;Casual, Free to Play, Indie, Simulation, Strategy;0 - 20,000;1;2;-1;0;0;0
691240;Going Nowhere: The Dream;Action;0 - 20,000;21;4;17;0;0;0
691250;Charlie the Duck;Violent, Gore, Action;0 - 20,000;22;4;18;0;0;0
691260;POPULATION: ONE;Adventure, Casual, Indie;200,000 - 500,000;1957;365;1592;180;251;44
691280;SINNER: Sacrifice for Redemption;Violent, Gore, Action, Adventure, Indie;0 - 20,000;516;263;253;0;0;1
691320;Gun Club VR;Adventure, Indie, Simulation, Early Access;20,000 - 50,000;476;123;353;133;181;2
691390;Alchemage;Adventure, Indie;0 - 20,000;185;79;106;468;468;2
691390;Alchemage;RPG;0 - 20,000;185;79;106;468;468;2
691420;Continuous Girl;Action, Casual, Indie, Massively Multiplayer, RPG, Simulation, Early Access;0 - 20,000;7;5;2;0;0;0
691430;Firebird - The Unfinished;Casual, Indie, Strategy;0 - 20,000;32;1;31;0;0;0
691450;Misao: Definitive Edition;Indie, Strategy, Early Access;100,000 - 200,000;1496;53;1443;305;305;9
691540;Space Fighter;Indie, Simulation;50,000 - 100,000;69;37;32;2;3;1
691570;Wingless;Violent, RPG;0 - 20,000;3;1;2;0;0;0
691580;Maggie's Movies - Camera, Action!;Casual, Indie, Racing;0 - 20,000;20;15;5;0;0;0
691590;KryptCrawler;Indie, Simulation;0 - 20,000;11;18;-7;0;0;0
691600;Mission 1545;Adventure, Casual, Indie;0 - 20,000;5;6;-1;0;0;0
691620;Death Rings of Jupiter;Casual, Indie, Sports;0 - 20,000;8;1;7;0;0;0
691630;STELLATUM;Action, Indie;20,000 - 50,000;99;57;42;0;0;0
691640;RoadRunner VR;Violent, Gore, Action, RPG;0 - 20,000;1;1;0;0;0;0
691650;Kaet Must Die!;Adventure, Indie;0 - 20,000;9;3;6;0;0;0
691680;Ganbatte;Action, Indie;0 - 20,000;2;1;1;0;0;0
691690;Ash of Gods: Redemption;Action, Casual, Indie, Simulation;500,000 - 1,000,000;2293;776;1517;427;526;5
691700;Triton Wing;Adventure, Indie;0 - 20,000;1;1;0;0;0;0
691720;RetroGunX VR;Sexual Content, Nudity, Casual, Indie, RPG;0 - 20,000;12;2;10;0;0;0
691730;FPV Drone Simulator;Indie, Early Access;100,000 - 200,000;245;118;127;9;10;1
691750;Andromeda Wing;Adventure, Casual, Indie;0 - 20,000;12;6;6;0;0;0
691770;Eiyu*Senki – The World Conquest;Action, Adventure, Indie;20,000 - 50,000;625;69;556;64;64;8
691830;Avernum 3: Ruined World;Simulation;20,000 - 50,000;225;46;179;183;323;9
691850;The Mines of Morseph;RPG;0 - 20,000;1;1;0;0;0;0
691860;Watch Out;Indie, Simulation, Strategy;0 - 20,000;3;2;1;0;0;0
691890;Machine Crisis (陨星危机);Action, Indie;0 - 20,000;14;2;12;0;0;0
691910;Fishing Maniacs (TD/RTS);Action;0 - 20,000;10;1;9;0;0;0
691930;MSI Electric City: Core Assault;Action, Adventure, Casual, RPG;50,000 - 100,000;71;7;64;1;1;1
691980;Fortune's Tavern - Remastered;Action, Adventure, Casual;0 - 20,000;1;7;-6;0;0;0
691990;Cat's Lover;Adventure, Casual, Free to Play, Indie;0 - 20,000;2;0;2;0;0;0
692030;Tennis World Tour;Action, Adventure, Casual, Indie, Simulation, Strategy;0 - 20,000;260;407;-147;15;15;2
692030;Tennis World Tour;Action, Indie;0 - 20,000;260;407;-147;15;15;2
692060;Casinopia: The Blackjack;Action, Indie;0 - 20,000;6;8;-2;0;0;0
692090;Robin of Loxley the Legend of Sherwood;Action, Indie, Simulation;0 - 20,000;3;2;1;0;0;0
692100;Infliction;Action, Adventure, Casual, Indie, RPG;20,000 - 50,000;537;103;434;125;125;7
692110;ArchRobo - Robotic Annihilation;Adventure, Indie;0 - 20,000;11;3;8;0;0;0
692170;Virtual Robots - Robot programming simulator;Adventure, Casual, Indie;0 - 20,000;0;5;-5;0;0;0
692190;Pixel Puzzle Picross;Action, Casual, Indie;0 - 20,000;5;1;4;0;0;0
692200;aMAZE Dark Times;Strategy;0 - 20,000;138;59;79;0;0;1
692310;REPULSE: Galactic Rivals;Adventure, Casual, Indie, Racing, Simulation, Early Access;0 - 20,000;7;2;5;0;0;0
692360;Tales of Wedding Rings VR;Indie, Strategy;0 - 20,000;61;19;42;0;0;0
692500;PianoBoard Server;Action, Indie, RPG, Early Access;0 - 20,000;3;2;1;0;0;0
692530;Community Garden;Racing, Simulation, Sports;200,000 - 500,000;2;8;-6;117;160;0
692610;Two Escapes;Action, Casual, Indie, Early Access;0 - 20,000;2;1;1;0;0;0
692630;Beetlejuice: Bad as Can;Casual, Free to Play;0 - 20,000;0;4;-4;0;0;0
692660;Invictus: In the Shadow of Olympus;Action, Adventure, Indie, Massively Multiplayer, Racing, RPG, Simulation, Early Access;200,000 - 500,000;4;1;3;0;0;0
692680;Don't Explode;Casual, Indie;0 - 20,000;6;0;6;0;0;0
692690;Dance Collider;Adventure;0 - 20,000;141;28;113;0;0;1
692710;Astron Jump Baby;Action, Indie;0 - 20,000;14;2;12;0;0;0
692780;Olorun: Theocracy;Casual, Early Access;0 - 20,000;40;31;9;0;0;0
692790;春风 | Spring Breeze;Casual, Indie;0 - 20,000;32;27;5;0;0;0
692830;Fear Of Nightmares: Madness Descent;Action, Adventure, Casual, Indie;0 - 20,000;36;14;22;0;0;0
692840;Underworld Ascendant;Action, Indie, Simulation;20,000 - 50,000;348;662;-314;128;143;2
692850;Bloodstained: Ritual of the Night;Action, Adventure, Casual, Indie, Strategy;1,000,000 - 2,000,000;31601;1762;29839;1851;1219;276
692860;Prisoner;Animation & Modeling, Video Production;0 - 20,000;1;0;1;0;0;0
692890;Roboquest;Action, Indie;500,000 - 1,000,000;5184;307;4877;284;228;199
692920;XXZ;Violent, Gore, Adventure, Indie, RPG;50,000 - 100,000;463;172;291;31;52;1
692930;DreadEye VR;Adventure;0 - 20,000;111;29;82;0;0;1
692950;The Dew;Action, Indie;0 - 20,000;24;0;24;0;0;0
693020;Space Commander 9;Action, Casual, Indie, Simulation, Strategy, Early Access;0 - 20,000;0;0;0;0;0;0
693030;Neo Angle;Casual, Indie, Strategy;0 - 20,000;13;0;13;0;0;0
693050;Dumb Stone Card Game;Action, Casual, Free to Play, Indie;0 - 20,000;2;7;-5;163;163;0
693090;Star Waker;Indie;0 - 20,000;5;3;2;0;0;0
693150;Martha Madison: Electricity;Action, Indie;0 - 20,000;1;0;1;0;0;0
693150;Martha Madison: Electricity;Adventure, Indie;0 - 20,000;1;0;1;0;0;0
693180;Slice of Life;Casual, Indie;0 - 20,000;16;9;7;0;0;0
693190;Survival driver 2: Heavy vehicles;Action, Adventure, Indie, Simulation;20,000 - 50,000;15;18;-3;0;0;1
693210;Grimtale Island;Violent, Action, Adventure, Indie;0 - 20,000;24;15;9;0;0;0
693240;Mahjong Challenge;Action, Adventure, Indie, RPG, Simulation;0 - 20,000;3;6;-3;0;0;0
693250;Panda Run;Casual, Indie;0 - 20,000;76;43;33;0;0;1
693280;Zombies Berserk;Action, Casual, Indie;0 - 20,000;0;2;-2;0;0;0
693300;Unbalance;Adventure, Casual, Indie, Racing;20,000 - 50,000;2;2;0;0;0;0
693310;Bomsy;Action, Indie, Sports;0 - 20,000;4;2;2;0;0;0
693320;Chinomikon;Adventure;0 - 20,000;2;0;2;0;0;0
693330;Fake World VR;Casual, Sports;0 - 20,000;8;1;7;0;0;0
693380;Neckbeards: Basement Arena;Sexual Content, Nudity, Action, Adventure, RPG;0 - 20,000;5;1;4;0;0;0
693400;Taking Valhalla VR;Casual, Indie, Simulation;0 - 20,000;1;3;-2;0;0;0
693400;Taking Valhalla VR;Adventure, Indie;0 - 20,000;1;3;-2;0;0;0
693430;The Simple Apocalypse;Indie, Strategy;0 - 20,000;3;3;0;0;0;0
693450;Clad in Iron: Gulf of Mexico 1864;Action, Casual, Indie;0 - 20,000;15;0;15;0;0;0
693500;Castle Demolition VR;Action, Adventure, Indie, RPG;0 - 20,000;0;1;-1;0;0;0
693560;After Rain: Phoenix Rise;Action, Casual, Early Access;0 - 20,000;6;2;4;0;0;0
693650;LOGistICAL: Italy;Adventure, Indie, Early Access;0 - 20,000;11;0;11;0;0;0
693670;Molten Armor;Racing, Simulation, Sports;0 - 20,000;36;19;17;0;0;0
693700;Prime Mover;Indie, RPG, Strategy;0 - 20,000;170;20;150;78;78;1
693700;Prime Mover;Action, Adventure, Indie, Early Access;0 - 20,000;170;20;150;78;78;1
693710;PolyKat;Action, Adventure, Indie, RPG;0 - 20,000;1;1;0;0;0;0
693750;Galactic Crew;Adventure, Indie;20,000 - 50,000;77;68;9;0;0;0
693790;Crypt Hunter;Action, Adventure, Casual, Indie, Simulation;0 - 20,000;13;14;-1;0;0;0
693800;Loco Parentis / 孤女咒怨;Action, Casual, Free to Play, Indie;20,000 - 50,000;262;207;55;36;45;2
693810;Treasure At The Top;Adventure, Indie, Sports;0 - 20,000;15;8;7;0;0;0
693820;The Ragdoll;Casual, Free to Play, Indie;0 - 20,000;2;3;-1;0;0;0
693830;Containment Corps;Action, Adventure, Casual, Indie, Simulation;0 - 20,000;26;18;8;9;9;0
693880;Trivia Vault: 1980's Trivia 2;Casual, Indie, Simulation;0 - 20,000;46;46;0;1;1;0
693890;Trivia Vault: Classic Rock Trivia 2;Action, Adventure, Casual, Indie, RPG, Early Access;0 - 20,000;44;34;10;1;1;0
693950;カニマン VS メカモンキー;Action, Casual, Indie;0 - 20,000;24;0;24;0;0;0
693960;Just Ride：Apparent Horizon 狂飙：极限视界;Adventure, Simulation;0 - 20,000;131;50;81;0;0;0
693990;STYLY：VR PLATFORM FOR ULTRA EXPERIENCE;;0 - 20,000;15;3;12;2;2;0
693990;STYLY：VR PLATFORM FOR ULTRA EXPERIENCE;Action, Casual, Indie;0 - 20,000;15;3;12;2;2;0
694060;Ignis Universia: Eternal Sisters Saga DX;Action, Indie, Early Access;20,000 - 50,000;157;14;143;0;0;0
694070;BadLands RoadTrip;Action, Adventure, Casual;0 - 20,000;8;5;3;0;0;0
694090;Apex Construct;Adventure, Indie, Early Access;0 - 20,000;153;59;94;106;106;0
694090;Apex Construct;Free to Play, Massively Multiplayer, Strategy, Early Access;0 - 20,000;153;59;94;106;106;0
694130;My Free Zoo;Adventure, Casual, Indie, Simulation;100,000 - 200,000;314;189;125;87;90;82
694140;Undercity;Action, Casual, Strategy, Early Access;0 - 20,000;9;4;5;0;0;0
694150;Abyssal Fall;Action, Indie;0 - 20,000;7;3;4;0;0;0
694160;Guardians of Life VR;Casual;0 - 20,000;1;1;0;0;0;0
694180;MobileZombie;Indie, RPG, Strategy, Early Access;0 - 20,000;17;9;8;0;0;0
694280;Zombie Army 4: Dead War;Casual, Indie;500,000 - 1,000,000;4659;858;3801;866;620;193
694370;Space Pilgrim Academy: Year 1;Action, Indie;20,000 - 50,000;100;8;92;0;0;0
694400;Diminutive;Action, Casual, Indie, Simulation;0 - 20,000;2;4;-2;0;0;0
694420;Alimardan's Mischief;Strategy, Early Access;0 - 20,000;6;5;1;0;0;0
694430;Alimardan Meets Merlin;Action, Indie, Early Access;0 - 20,000;1;7;-6;0;0;0
694440;Man of Law | Judge simulator;Adventure, Casual, Indie;0 - 20,000;6;12;-6;0;0;0
694470;Guitar Hardness;Action, Casual, Indie;0 - 20,000;2;6;-4;0;0;0
694480;DOTFI;Action, Adventure, Indie, RPG, Early Access;0 - 20,000;29;19;10;0;0;0
694490;Quad Hopping;Action, Adventure, Casual, Indie, RPG;0 - 20,000;34;38;-4;0;0;0
694500;Army Men RTS;Action, Adventure, Indie;100,000 - 200,000;683;98;585;162;223;27
694520;His Chuunibyou Cannot Be Cured!;Adventure, Casual, Indie, Simulation;0 - 20,000;11;1;10;0;0;0
694550;Audio Forager;Action, Adventure, Indie, RPG, Strategy, Early Access;0 - 20,000;12;0;12;0;0;0
694610;Lumak's Wraptiles;Action, Casual, Indie, Simulation, Strategy;0 - 20,000;0;0;0;0;0;0
694660;End of Days;Casual, Indie, Strategy;0 - 20,000;6;1;5;0;0;0
694670;Charpi;Action, Adventure, Indie, RPG;0 - 20,000;7;0;7;0;0;0
694680;Santa Claws;Casual, Indie, Massively Multiplayer, Early Access;50,000 - 100,000;66;22;44;0;0;0
694720;Not My Car – Battle Royale;Gore, Adventure, Indie;100,000 - 200,000;619;735;-116;0;0;0
694730;Evil Park;Adventure, Strategy, Early Access;0 - 20,000;19;10;9;0;0;0
694760;Sweaty Palms;Strategy;;;;0;;;
694770;Vestaria Saga I: War of the Scions;Casual, Indie, Racing;20,000 - 50,000;741;112;629;300;300;13
694790;The Botanist;Sexual Content, Nudity, Casual, Indie;0 - 20,000;22;8;14;0;0;0
694830;Give It Up! Plus / 永不言弃 PLUS;Casual, Simulation, Strategy;0 - 20,000;22;8;14;0;0;2
694870;All Contact Lost;Adventure, Casual;0 - 20,000;22;5;17;0;0;0
694930;Lost God;Action;0 - 20,000;18;4;14;0;0;0
694950;Oure;Action, Indie, Early Access;0 - 20,000;36;6;30;0;0;0
694960;Zenethics Lab : Outbreak;Indie;0 - 20,000;5;1;4;0;0;0
694980;Fjong;Strategy;0 - 20,000;69;23;46;1;1;0
695050;Rain of Reflections: Set Free;Strategy;20,000 - 50,000;242;70;172;0;0;0
695100;Smoke and Sacrifice;Strategy;20,000 - 50,000;294;88;206;46;55;3
695290;The Golf Club 2019 featuring PGA TOUR;Indie, Simulation, Strategy;50,000 - 100,000;1769;575;1194;1196;1274;54
695320;Jobous the alien R;Indie, RPG;0 - 20,000;8;0;8;0;0;0
695330;SEASON: A letter to the future;Casual, Indie, Simulation;20,000 - 50,000;566;38;528;3;3;55
695360;Veritex;Casual, Indie, Simulation;0 - 20,000;56;88;-32;43;84;0
695360;Veritex;Action, Casual, Indie, Simulation, Strategy;0 - 20,000;56;88;-32;43;84;0
695420;Hex: Origins;Utilities;0 - 20,000;8;0;8;0;0;0
695440;Dark Dimensions: Wax Beauty Collector's Edition;Video Production;0 - 20,000;3;2;1;0;0;0
695450;Kingdom of the Dragon;Action, Adventure, Massively Multiplayer, RPG, Simulation, Early Access;0 - 20,000;27;9;18;0;0;0
695460;Coffee Pixes;Action, Casual, Indie;0 - 20,000;3;0;3;0;0;0
695490;Operation Chromite 1950 VR;Action, Indie, Sports;0 - 20,000;5;4;1;0;0;0
695510;Rena And Elin;Action, Adventure, Casual, Indie;0 - 20,000;37;13;24;0;0;0
695510;Rena And Elin;Free to Play;0 - 20,000;37;13;24;0;0;0
695560;Building Block Heroes;Action, Indie;0 - 20,000;1;0;1;0;0;0
695570;PyroMind;Action, Free to Play;0 - 20,000;27;0;27;0;0;0
695600;This Grand Life;Action, Indie, Early Access;20,000 - 50,000;166;54;112;11;11;1
695630;Chinese Paladin：Sword and Fairy;Action, Adventure, Casual, Indie, RPG, Simulation;200,000 - 500,000;928;991;-63;1393;2348;47
695650;猎人物语;Action, Indie;0 - 20,000;65;37;28;0;0;0
695650;猎人物语;Action, Adventure, Casual, Indie;0 - 20,000;65;37;28;0;0;0
695660;Saloon Showdown VR;Adventure, Indie, RPG;0 - 20,000;28;3;25;0;0;0
695690;Ancient Siberia;Action, Free to Play, Simulation, Strategy;0 - 20,000;84;168;-84;0;0;0
695720;Matchville - Match 3 Puzzle;Casual, Indie, Strategy;0 - 20,000;46;59;-13;0;0;1
695760;Girls and Dungeons;Adventure, RPG;;;;0;;;
695810;HORDE ATTACK;Action, Adventure, Indie;0 - 20,000;8;6;2;0;0;0
695830;Captain Backwater;Action, Adventure, Casual, Indie, Racing, Early Access;0 - 20,000;20;4;16;0;0;0
695880;The Flying Turtle Jewel Quest;Action, Casual, Indie, RPG, Simulation;0 - 20,000;2;1;1;0;0;0
695910;The Relentless;Free to Play, Indie, Strategy;0 - 20,000;6;2;4;0;0;0
695920;Super Seducer : How to Talk to Girls;;200,000 - 500,000;1348;267;1081;190;311;12
695940;Love Chronicles: The Sword and the Rose;Action, Adventure, Indie, Early Access;0 - 20,000;4;2;2;0;0;1
695950;European Mystery: The Face of Envy Collector's Edition;Action, Indie;0 - 20,000;4;0;4;0;0;0
695960;Awakening: The Goblin Kingdom Collector's Edition;Adventure, Indie;0 - 20,000;13;1;12;0;0;0
695970;Treadnauts;Action, Adventure, Casual, Sports;20,000 - 50,000;160;19;141;511;511;0
695980;Labyrinths of the World: Forbidden Muse Collector's Edition;Casual, Indie, Strategy;0 - 20,000;8;2;6;0;0;1
695990;Dead Reckoning: Brassfield Manor Collector's Edition;Action, Adventure, RPG;0 - 20,000;1;0;1;0;0;0
696000;Witches' Legacy: The Dark Throne Collector's Edition;Action;0 - 20,000;7;2;5;0;0;0
696010;Otherworld: Shades of Fall Collector's Edition;Casual;0 - 20,000;9;0;9;0;0;0
696020;Surface: Game of Gods Collector's Edition;Action, Indie, Massively Multiplayer, Racing;0 - 20,000;5;0;5;0;0;0
696040;Tactera;Violent, Gore, Action, Adventure, Casual, Indie;0 - 20,000;10;2;8;11;11;0
696050;The Final Days: Eternal Night;Adventure, Casual, Indie;0 - 20,000;1;0;1;0;0;0
696060;Live;Adventure, Indie, RPG;0 - 20,000;41;8;33;0;0;0
696110;Backgammon;Violent, Gore, Strategy;0 - 20,000;6;14;-8;0;0;0
696140;No Heroes Here;Casual, Indie;50,000 - 100,000;386;40;346;109;109;14
696160;Necromancer Accountant;Casual, Early Access;0 - 20,000;51;21;30;0;0;0
696160;Necromancer Accountant;Action, Simulation;0 - 20,000;51;21;30;0;0;0
696170;SENRAN KAGURA Peach Beach Splash;Free to Play, Massively Multiplayer;200,000 - 500,000;2941;726;2215;571;1100;15
696180;Bullet Witch;Adventure, Casual, Indie;20,000 - 50,000;359;164;195;0;0;3
696180;Bullet Witch;Action, Indie;20,000 - 50,000;359;164;195;0;0;3
696190;Vacant;Action, Indie, Racing, Early Access;0 - 20,000;3;8;-5;0;0;0
696200;Mike Dies;Nudity, Free to Play, Simulation;0 - 20,000;41;0;41;0;0;0
696220;Folklore Hunter;Adventure, Indie, Simulation, Strategy;20,000 - 50,000;724;251;473;296;296;4
696250;Lost Shipwreck;Casual, Early Access;0 - 20,000;17;11;6;0;0;0
696280;SOLE;Casual, Indie;0 - 20,000;17;4;13;0;0;0
696310;The Ghost of Joe Papp;Action, Adventure, Indie, RPG;0 - 20,000;6;6;0;0;0;0
696360;Chinese Paladin：Sword and Fairy 6;Action, Indie;20,000 - 50,000;175;150;25;271;271;5
696370;BROKE PROTOCOL: Online City RPG;Action, Indie;500,000 - 1,000,000;2153;737;1416;649;423;39
696400;NeoBoom;Sexual Content, Nudity, Adventure, Casual;0 - 20,000;25;41;-16;9;9;0
696410;Toy Generals;Indie;0 - 20,000;11;3;8;0;0;0
696430;Progetto Ustica;Casual, Indie, Simulation, Sports;0 - 20,000;17;10;7;0;0;0
696440;FARIA: Starfall;Action, Indie;0 - 20,000;2;1;1;0;0;0
696460;Pixel Traffic: Circle Rush;Action, Adventure, Indie, Racing, RPG, Strategy;20,000 - 50,000;99;26;73;0;0;0
696470;House Dating VR: Cute Korean Girl, Sehyun;Action;0 - 20,000;2;5;-3;0;0;0
696480;The Norwood Suite;Adventure, Indie, Strategy;50,000 - 100,000;874;128;746;316;420;5
696490;TOTOBALL;Action, Indie;0 - 20,000;44;11;33;1;1;0
696500;Soldiers Of Freedom;Adventure, Indie;0 - 20,000;2;13;-11;0;0;0
696510;Hero of Light VR: Episode 1;Action, Adventure, Casual, Indie;0 - 20,000;10;4;6;0;0;0
696530;Lake Ridden;Action;20,000 - 50,000;206;70;136;498;986;0
696540;60 Second Strike;Action, Casual, Indie;0 - 20,000;5;7;-2;10;10;0
696560;Bouncing Duck Simulator;Action, Indie;0 - 20,000;110;13;97;0;0;1
696580;The Tower;Adventure, Indie;0 - 20,000;7;7;0;0;0;0
696590;XXZ: XXL;Action, Casual, Indie, Strategy;0 - 20,000;155;39;116;420;420;0
696600;星球之间/Between Planets;Indie;0 - 20,000;57;22;35;0;0;0
696630;Exo;Action, Indie;0 - 20,000;4;0;4;0;0;0
696650;BLACK DAY;Adventure;0 - 20,000;202;119;83;0;0;0
696710;The Surprising Adventures of Munchausen;Casual, Indie;0 - 20,000;19;6;13;0;0;0
696810;EMPYRE: Lords of the Sea Gates;Adventure, Casual, Indie, Simulation;0 - 20,000;9;4;5;0;0;0
696840;PRESim;Action, Indie;0 - 20,000;6;7;-1;0;0;0
696860;900;Indie, Early Access;0 - 20,000;3;1;2;0;0;0
696880;2D Paintball;Adventure, Casual, Indie, Racing;0 - 20,000;10;2;8;0;0;0
696910;The Legend of the Dragonflame High School;Adventure, Casual, Indie, Strategy;0 - 20,000;6;2;4;0;0;0
696940;DreamWorks Voltron VR Chronicles;Adventure, Casual, Indie;0 - 20,000;44;16;28;0;0;0
696990;Fear For Freedom;Action, Simulation;20,000 - 50,000;81;83;-2;36;36;0
697000;YOU ARE KING;Indie, Simulation, Strategy, Early Access;0 - 20,000;1;2;-1;0;0;0
697010;Until None Remain: Battle Royale PC Edition;Action;0 - 20,000;81;79;2;7;7;0
697020;Until None Remain: Battle Royale VR;Action;0 - 20,000;6;13;-7;0;0;0
697130;The 9th Gate;Action, Indie;0 - 20,000;22;9;13;0;0;0
697160;Pixel To The West;Action, Adventure, Free to Play, Indie, RPG;0 - 20,000;3;3;0;0;0;0
697250;Beyond Enemy Lines 2 Enhanced Edition;Casual, Indie, Massively Multiplayer, RPG, Early Access;0 - 20,000;17;22;-5;0;0;0
697320;Kung Fu All-Star VR;Casual, Indie, RPG, Strategy;0 - 20,000;2;3;-1;0;0;0
697370;Linx Battle Arena;Action, Adventure, Indie;0 - 20,000;24;10;14;0;0;0
697430;Differently Fast;Adventure, RPG;0 - 20,000;21;1;20;0;0;0
697450;Piatka;Indie;0 - 20,000;1;0;1;0;0;0
697490;Space Wrangler;Action;0 - 20,000;0;7;-7;0;0;0
697530;PARSE;Casual;0 - 20,000;9;13;-4;0;0;0
697550;It Lurks Below;Casual, Indie;20,000 - 50,000;1037;170;867;2058;2058;6
697580;Screamer;Free to Play, Massively Multiplayer, RPG, Strategy;0 - 20,000;23;10;13;5;5;0
697600;Auto-Staccato;Casual, Indie;0 - 20,000;9;0;9;0;0;0
697610;Idle Bouncer;Sexual Content, Violent, Action, Indie, Massively Multiplayer, Racing, RPG, Simulation;50,000 - 100,000;302;48;254;3038;5637;35
697630;WARMA;Casual, Racing;50,000 - 100,000;121;108;13;0;0;2
697650;The 25th Ward: The Silver Case;Indie;0 - 20,000;246;21;225;0;0;4
697660;Jump Gunners;Adventure, Indie;0 - 20,000;35;5;30;5;5;0
697670;Journey of Haha;Action, Casual, Indie;0 - 20,000;11;2;9;0;0;0
697680;Marblesared;Adventure, Casual, Indie;0 - 20,000;4;0;4;0;0;0
697710;Ophidian;Action;0 - 20,000;12;1;11;0;0;0
697730;Escape Fantasy;RPG;0 - 20,000;1;1;0;0;0;0
697800;One Night You're Crazy;Action, Free to Play, Indie;0 - 20,000;32;7;25;0;0;0
697810;The Haunting: Blood Water Curse (EARLY ACCESS);RPG;0 - 20,000;4;10;-6;0;0;0
697850;FPS - Fun Puzzle Shooter;Action;0 - 20,000;22;39;-17;0;0;0
697850;FPS - Fun Puzzle Shooter;Action;0 - 20,000;22;39;-17;0;0;0
697860;Cathodemer;Adventure, Casual, Indie, RPG;0 - 20,000;100;14;86;0;0;5
697870;Cruz Brothers;Casual, Indie;0 - 20,000;8;9;-1;0;0;0
697890;Empty Handed;Adventure, Indie;0 - 20,000;1;0;1;0;0;0
697900;Bounty Below;RPG;50,000 - 100,000;101;22;79;0;0;12
697910;Temple Raid VR;Simulation, Early Access;0 - 20,000;12;0;12;0;0;0
697930;Brutal Runner;Adventure, Casual, Indie, Simulation;0 - 20,000;53;43;10;0;0;0
697950;Tank Wars: Anniversary Edition;Casual;0 - 20,000;13;2;11;0;0;0
697960;Cute Monsters Battle Arena;Utilities;0 - 20,000;14;10;4;0;0;0
697970;Pyramaze: The Game;Action, Casual, Indie, Racing, Simulation;20,000 - 50,000;21;6;15;0;0;0
698030;Comit the Astrodian 3;Free to Play, Indie, Massively Multiplayer, Strategy;20,000 - 50,000;1;2;-1;0;0;0
698040;Legends of the Universe - Cosmic Bounty;Action, Adventure, Indie;0 - 20,000;20;8;12;0;0;0
698050;All Our Asias;Action, Casual, Indie, Simulation;0 - 20,000;115;32;83;0;0;0
698080;Escape Dead Earth;Action;0 - 20,000;4;3;1;0;0;0
698080;Escape Dead Earth;Action;0 - 20,000;4;3;1;0;0;0
698100;Protagon VR;Action, Casual, Indie;0 - 20,000;4;2;2;0;0;0
698110;Reficul VR;Casual, Indie;0 - 20,000;18;10;8;0;0;0
698160;DinosaurIsland;Action, Indie;0 - 20,000;1;7;-6;0;0;0
698260;Star Shelter;Action, Casual, Indie;50,000 - 100,000;313;86;227;5;5;0
698300;Find this!;Casual, Indie;20,000 - 50,000;114;32;82;15;15;0
698320;NanoScape;Action, Free to Play, Indie, RPG, Strategy, Early Access;0 - 20,000;5;8;-3;0;0;0
698330;Z Runaway;Animation & Modeling, Design & Illustration, Photo Editing, Utilities;0 - 20,000;93;31;62;0;0;0
698340;沙漠飞车 Desert Racer;Violent, Action, Strategy;0 - 20,000;0;1;-1;0;0;0
698360;Within Whispers: The Fall;Violent, Action, Strategy;0 - 20,000;4;3;1;0;0;0
698410;Ski Hard: Lorsbruck 1978;Action, Casual, Indie, Simulation;0 - 20,000;5;3;2;0;0;0
698480;Hippo Sports;Action, Indie, RPG;0 - 20,000;5;2;3;0;0;0
698500;Guppy;Free to Play, Simulation;0 - 20,000;24;16;8;0;0;0
698520;A Writer And His Daughter;Utilities, Early Access;0 - 20,000;15;4;11;0;0;0
698540;Dungeon Warfare 2;Indie, Simulation, Strategy, Early Access;50,000 - 100,000;804;86;718;1413;2316;23
698570;WackIt;Action, Casual, Indie, Strategy;0 - 20,000;4;1;3;0;0;0
698590;DemonsTier;Action, Casual, Indie, Simulation, Strategy;0 - 20,000;31;8;23;0;0;0
698600;Tooth and Claw;Action, Casual, Indie;0 - 20,000;0;2;-2;0;0;0
698610;Through Blocks;Casual, Indie;0 - 20,000;12;25;-13;2;2;0
698610;Through Blocks;Action, Adventure, Indie;0 - 20,000;12;25;-13;2;2;0
698620;Screamer 2;Sexual Content, Nudity, Action, Casual, Indie;0 - 20,000;17;5;12;0;0;0
698640;Deep Sky Derelicts;Action, Indie;100,000 - 200,000;1768;581;1187;409;561;12
698650;Neon the Ninja;Action, Adventure, Indie;0 - 20,000;12;0;12;0;0;0
698670;Scorn;Adventure, Indie, Simulation;200,000 - 500,000;7485;2313;5172;439;500;36
698700;Rise of the Third Power;Action, Indie;20,000 - 50,000;301;31;270;0;0;26
698740;Loot'N Shoot;Violent, Gore, Adventure;0 - 20,000;80;41;39;44;44;0
698770;Watch Me Jump;Casual, Indie, Simulation, Strategy;0 - 20,000;32;4;28;0;0;1
698780;Doki Doki Literature Club!;Action, Casual, Indie, Simulation;5,000,000 - 10,000,000;178706;6349;172357;239;118;593
698790;PAPER FIRE ROOKIE (Formerly Paperville Panic);Casual, Indie, Simulation;0 - 20,000;40;16;24;0;0;0
698830;Puzzle Dating;Action, Indie;0 - 20,000;34;20;14;171;171;0
698870;Metaverse Keeper / 元能失控;Action, Adventure, Indie, Simulation;100,000 - 200,000;619;158;461;4708;4724;4
698880;Slash/Dots.;Casual, Indie;0 - 20,000;8;1;7;25;25;0
698910;Cliffstone Manor;Action, Indie, Strategy;0 - 20,000;28;6;22;0;0;0
698920;王国出击;Casual, Indie;0 - 20,000;0;0;0;0;0;0
698950;Chaos and the White Robot;Action, Free to Play, Sports;0 - 20,000;19;7;12;0;0;0
698960;Battlemage Training;Action, Adventure, Casual, Free to Play, Massively Multiplayer, Simulation, Sports;0 - 20,000;1;0;1;0;0;0
698980;sWORD MASTER;Adventure, RPG;0 - 20,000;11;4;7;0;0;0
699010;Unsettled;Adventure, Casual, Indie, RPG, Simulation;0 - 20,000;9;9;0;0;0;0
699040;Millidor;Indie, Early Access;20,000 - 50,000;97;57;40;0;0;0
699080;Jake's Love Story;Casual, Indie, Simulation, Early Access;20,000 - 50,000;109;17;92;0;0;0
699100;Megaton: Total Destruction;Casual, Free to Play, Indie, Simulation, Strategy;0 - 20,000;12;20;-8;0;0;0
699130;World War Z: Aftermath;Action, Indie, Massively Multiplayer;500,000 - 1,000,000;9945;1956;7989;761;434;2383
699150;Rex: Another Island;Action, Casual, Strategy, Early Access;0 - 20,000;106;9;97;4;4;0
699150;Rex: Another Island;Action, Adventure, Casual, Indie;0 - 20,000;106;9;97;4;4;0
699160;A Plot Story;Adventure, Indie, RPG;20,000 - 50,000;20;46;-26;21;41;0
699170;Fell Seal: Arbiter's Mark;Action, Adventure, Racing, RPG;200,000 - 500,000;4644;559;4085;1286;1227;101
699180;Human-powered spacecraft;Simulation, Sports;20,000 - 50,000;549;43;506;0;0;0
699230;Birdcakes;Action, Adventure;0 - 20,000;11;0;11;0;0;0
699240;Keyboard Killers;Simulation;100,000 - 200,000;190;195;-5;3;6;0
699330;The Iron Oath;Action, Indie;100,000 - 200,000;350;76;274;408;408;5
699370;The market trader;Action, Casual;0 - 20,000;0;2;-2;0;0;0
699390;Knife Club;Action, Adventure, Simulation;0 - 20,000;43;6;37;0;0;0
699410;Labyrinthian;Adventure, Casual, Indie, Strategy;0 - 20,000;13;2;11;0;0;0
699470;Brindilyl Legends: The Story of Landon;Action, Casual, Early Access;0 - 20,000;0;1;-1;0;0;0
699480;The Doorbreaker;Casual, Indie;20,000 - 50,000;12;30;-18;0;0;0
699510;The New California;RPG;0 - 20,000;8;2;6;0;0;0
699540;Argonus and the Gods of Stone;Casual, Indie, Simulation, Strategy;0 - 20,000;97;10;87;0;0;0
699570;The Legendary Player - Make Your Reputation - OPEN BETA;Casual, Indie;0 - 20,000;0;3;-3;0;0;0
699590;Trivia Vault: Science & History Trivia 2;Casual, Indie, Simulation, Strategy;0 - 20,000;45;40;5;1;1;0
699670;Feudal Alloy;Casual, Indie, Simulation, Strategy;50,000 - 100,000;488;197;291;188;199;2
699680;Monopolka;Casual, Indie, RPG;0 - 20,000;21;15;6;20;20;0
699700;DYING: Reborn;Indie, Simulation, Strategy, Early Access;0 - 20,000;161;49;112;0;0;0
699720;Timension;Action, Indie, RPG, Simulation, Strategy, Early Access;0 - 20,000;22;5;17;0;0;0
699740;BANNERMEN;Indie, RPG, Simulation, Strategy;20,000 - 50,000;155;133;22;77;77;0
699750;Pixel Traffic: Risky Bridge;Adventure, Casual, Indie;0 - 20,000;45;18;27;0;0;0
699760;Triple Otakus Puzzle;Adventure, Indie;0 - 20,000;26;50;-24;0;0;0
699770;RideOp - Thrill Ride Simulator;Gore, Casual, Indie, Simulation, Strategy;0 - 20,000;66;53;13;0;0;0
699780;Endless Fables 2: Frozen Path;Adventure, Casual, Indie;0 - 20,000;163;13;150;0;0;1
699790;Pegasus Door;Casual, Indie;0 - 20,000;2;2;0;0;0;0
699820;Mustdashe;Action, Adventure, Indie;0 - 20,000;7;5;2;0;0;0
699830;Dummy Life;Action, Indie;0 - 20,000;6;1;5;0;0;0
699850;Medieval Battle: Europe;Indie, RPG, Simulation, Sports, Strategy, Early Access;0 - 20,000;12;2;10;0;0;0
699870;Commands & Colors: Ancients;Action, Indie;20,000 - 50,000;36;46;-10;0;0;1
699920;Despotism 3k;Action, Adventure, Indie, Simulation;200,000 - 500,000;2284;635;1649;182;175;30
699930;Freshly fried shrimps seemed hot additionally named noth;Adventure, Casual, Indie;0 - 20,000;2;0;2;0;0;0
699940;MEMETYPER;Action, Early Access;0 - 20,000;56;15;41;0;0;0
699970;Breath;Sexual Content, Nudity, Violent, Action, Casual;0 - 20,000;2;3;-1;0;0;0
699990;VirtuGO;Casual, Indie;0 - 20,000;4;6;-2;0;0;0
700010;MAGIX PC Check & Tuning 2018 Steam Edition;Action, Adventure, Indie, RPG;0 - 20,000;15;10;5;0;0;1
700020;MAGIX Video deluxe 2018 Plus Steam Edition;Action, Indie, Strategy;0 - 20,000;38;23;15;0;0;2
700030;Life is Feudal: MMO;Action, Casual, Indie;200,000 - 500,000;2807;3731;-924;7908;323;1
700050;Bees Knees;Indie, Sports, Strategy;0 - 20,000;0;1;-1;0;0;0
700060;Space Station Continuum;Action;20,000 - 50,000;8;28;-20;0;0;0
700060;Space Station Continuum;Violent, Gore, Action, Adventure, Indie;20,000 - 50,000;8;28;-20;0;0;0
700100;Spooky Station;Casual, Indie, Racing;0 - 20,000;311;47;264;0;0;4
700140;FROG X BIRD;Action, Casual, Indie, Simulation, Strategy;0 - 20,000;7;0;7;0;0;0
700160;Semblance;Action, Adventure, Indie, RPG, Strategy, Early Access;20,000 - 50,000;257;33;224;0;0;1
700160;Semblance;Adventure, Casual, Indie, Strategy;20,000 - 50,000;257;33;224;0;0;1
700170;Deserving Life;Adventure, Indie, RPG;20,000 - 50,000;103;20;83;2;2;0
700200;20 Minute Metropolis - The Action City Builder;Casual, Indie, Simulation;0 - 20,000;28;13;15;0;0;0
700240;Project Genesis;Animation & Modeling, Education, Utilities, Video Production;0 - 20,000;99;20;79;0;0;1
700270;Boratium Wars;Action, Casual, Indie, Racing;0 - 20,000;2;1;1;0;0;0
700310;Music Racer 2000;Adventure, Free to Play, Indie, RPG, Strategy;20,000 - 50,000;20;21;-1;0;0;0
700330;SCP: Secret Laboratory;Sexual Content, Action, Indie;5,000,000 - 10,000,000;141285;12914;128371;937;76;6338
700360;KnightOut;Action, Casual, Indie;0 - 20,000;16;5;11;0;0;0
700400;Planet Bash;Casual, Indie;0 - 20,000;8;1;7;0;0;0
700440;Jellyfish;Indie, Simulation;0 - 20,000;30;23;7;0;0;0
700450;Silentium 2D;Action, Indie, RPG;0 - 20,000;2;0;2;0;0;0
700460;Nine Worlds - A Viking saga;Adventure, Casual, Indie;0 - 20,000;5;2;3;0;0;0
700480;Microsoft Allegiance;Adventure, Casual, Indie;100,000 - 200,000;121;35;86;10;10;2
700490;玄龙棋MysteryChess;Action, Adventure, Casual, Free to Play, Indie;0 - 20,000;9;1;8;0;0;0
700510;岚零之风 - Wind Horizon;Action, Indie, Simulation;0 - 20,000;11;1;10;0;0;0
700520;Shift Quantum - A Cyber Noir Puzzle Platformer;Adventure, Indie, Strategy, Early Access;0 - 20,000;59;3;56;0;0;0
700540;Derora;Action, Casual, Indie, Simulation, Strategy;0 - 20,000;3;1;2;0;0;0
700560;Druid's Tale: Crystal Cave;Violent, Gore, Action, Indie, Sports, Strategy;0 - 20,000;4;4;0;6;6;0
700570;Beyond the Void;Action, Casual, Indie, Simulation, Strategy;50,000 - 100,000;73;53;20;16;16;0
700580;Rust - Staging Branch;Action, Casual, Indie, Simulation, Strategy;0 - 20,000;0;0;0;124;21;5
700590;Ghostly Horizon;Action, Casual, Indie, Simulation;0 - 20,000;14;4;10;0;0;0
700600;Evil Genius 2: World Domination;Action, Adventure, Indie;500,000 - 1,000,000;6997;3453;3544;1406;1172;250
700610;DungeonGOGO;Casual, Indie, Simulation, Strategy;0 - 20,000;0;1;-1;0;0;0
700620;Temple of Aluxes;Action, Indie;0 - 20,000;35;11;24;0;0;0
700650;Adventure Golf VR;Adventure, Indie;0 - 20,000;7;2;5;0;0;0
700660;Dice Tower Defense;Action, Indie, RPG;50,000 - 100,000;115;57;58;0;0;0
700730;Dungeoneer;Action, Indie;0 - 20,000;8;0;8;0;0;0
700740;Teenage Mutant Ninja Turtles: Portal Power;Indie, Strategy;0 - 20,000;47;27;20;0;0;1
700750;The Battle Of Mahjong;Action, Casual, Indie;20,000 - 50,000;10;12;-2;0;0;0
700770;ZoneDriver;Action, Casual, Indie;0 - 20,000;26;32;-6;0;0;0
700820;TFM: The First Men;Violent, Gore, Action, Indie;20,000 - 50,000;211;80;131;0;0;13
700830;Immersive Poetry;Action, Casual, Indie;0 - 20,000;13;6;7;0;0;0
700880;Kingdom: The Far Reaches;Strategy;100,000 - 200,000;3;1;2;0;0;0
700880;Kingdom: The Far Reaches;Indie, RPG;100,000 - 200,000;3;1;2;0;0;0
700910;Royal Agents: Sweet Zombie;Action, Indie;20,000 - 50,000;3;0;3;0;0;0
700920;Placement;Action, Indie;0 - 20,000;28;8;20;0;0;0
700920;Placement;Free to Play, Indie, Massively Multiplayer, Strategy;0 - 20,000;28;8;20;0;0;0
700940;TangramsVR;Video Production;0 - 20,000;5;5;0;0;0;0
700990;Gunship Battle2 VR: Steam Edition;Violent, Gore, Action, Casual, Indie;0 - 20,000;7;6;1;0;0;0
701010;Gurugedara;Casual, Early Access;0 - 20,000;7;1;6;0;0;0
701010;Gurugedara;Adventure, Casual, Indie;0 - 20,000;7;1;6;0;0;0
701020;Brinko;Indie, Early Access;0 - 20,000;1;2;-1;0;0;0
701040;CometStriker DX;Adventure;0 - 20,000;51;1;50;0;0;2
701080;Supersonic Tank Cats;Action, Casual, Indie, RPG, Strategy, Early Access;0 - 20,000;28;6;22;0;0;0
701100;Amoreon NightClub;RPG, Early Access;20,000 - 50,000;50;17;33;3;5;0
701160;Kingdom Two Crowns;Casual, Indie, Simulation;1,000,000 - 2,000,000;6244;819;5425;763;459;871
701280;Askutron Quiz Show;Casual, Indie;0 - 20,000;15;7;8;0;0;0
701290;Legendary Mahjong;Casual, Indie;0 - 20,000;31;5;26;0;0;2
701370;Pop Pop Boom Boom VR;Action, Casual, Indie;0 - 20,000;1;1;0;0;0;0
701380;El Tango de la Muerte;Action, Adventure, Casual, Indie;0 - 20,000;234;8;226;9;9;0
701420;Ne no Kami - The Two Princess Knights of Kyoto Part 2;Action, Adventure, Casual, Indie;0 - 20,000;111;9;102;0;0;0
701440;Phantom Jump;Indie;0 - 20,000;43;5;38;6;6;0
701460;Billiards;Action, Casual, Indie, Simulation, Strategy;0 - 20,000;15;12;3;0;0;1
701470;TTV2;Action, Casual, Indie, Simulation, Strategy;50,000 - 100,000;156;17;139;12;12;1
701540;EVIL STAR;Indie, RPG;20,000 - 50,000;33;27;6;0;0;0
701580;Ninja Goemon and Immortal Jewels;Casual, Indie, Strategy;0 - 20,000;0;1;-1;0;0;0
701610;Dungeons of the Fallen;Casual, Indie, Strategy;0 - 20,000;24;11;13;0;0;0
701680;The Legend of Slime;Casual, Indie, Strategy;0 - 20,000;0;4;-4;0;0;0
701720;2D Neon Cube;;0 - 20,000;132;69;63;10;10;0
701730;Yi and the Thousand Moons;Action, Indie;0 - 20,000;137;29;108;0;0;0
701740;Modest Kind;Adventure, Casual, Indie;0 - 20,000;11;7;4;0;0;0
701760;L.S.S;Action, Casual, Indie;0 - 20,000;24;11;13;0;0;0
701800;Triplicata;Action, Adventure;0 - 20,000;5;2;3;1;1;0
701810;Epic Dumpster Bear: Dumpster Fire Redux;Indie, Strategy;0 - 20,000;28;1;27;0;0;0
701820;GIF: The Game of Inevitable Frustration;Indie, RPG;0 - 20,000;2;0;2;0;0;0
701860;The Witch's Isle;Action, Adventure, Casual, Indie, Early Access;0 - 20,000;48;7;41;0;0;0
701870;Swarm Queen;Action, Indie;0 - 20,000;158;21;137;0;0;6
701880;Rocka Feller;Adventure, Indie, Early Access;0 - 20,000;1;0;1;0;0;0
701890;Starzine;Adventure, Indie;0 - 20,000;3;0;3;0;0;0
701900;Splat the Blob;Action, Casual, Indie;200,000 - 500,000;85;8;77;0;0;0
701910;Dawn of a Soul;Casual, Indie, Strategy;0 - 20,000;15;1;14;0;0;0
701930;Short Stories Collection of Class Tangerine;Indie, Strategy;0 - 20,000;824;28;796;525;525;0
701940;Champions of Aerial;Action, Casual, Indie;0 - 20,000;7;0;7;0;0;0
701950;Survival Simulator VR;Action, Free to Play, Indie;0 - 20,000;7;4;3;0;0;0
701960;Fish's Trip;Casual, Indie;0 - 20,000;4;9;-5;0;0;0
701970;Sliding Blocks;Action, Indie, Massively Multiplayer, RPG, Early Access;0 - 20,000;19;1;18;0;0;0
701990;Edmonton Trolley Car;Action, Adventure, RPG;0 - 20,000;1;1;0;0;0;0
702030;Starbear: Taxi;Adventure;0 - 20,000;30;6;24;0;0;1
702050;The Song of Saya;Casual, Indie, Simulation, Sports, Strategy;100,000 - 200,000;3702;295;3407;123;215;9
702080;My Factory 我的工厂;Indie, Strategy;0 - 20,000;43;37;6;671;671;0
702110;THE LAST BLADE 2;Action, Casual, Indie;50,000 - 100,000;233;21;212;0;0;5
702120;THE KING OF FIGHTERS '97 GLOBAL MATCH;Education;50,000 - 100,000;776;246;530;76;140;50
702150;Project Mercury;Action;50,000 - 100,000;286;203;83;114;159;0
702160;Rocketboat - Pilot;Action, Indie;0 - 20,000;43;11;32;0;0;0
702180;Mafia is Alive;Animation & Modeling, Design & Illustration, Utilities;0 - 20,000;3;2;1;0;0;0
702190;Hero Rush: Mad King;Action;0 - 20,000;27;20;7;0;0;0
702200;Lost with Dinosaurs;Action, Casual, Indie, Simulation, Strategy;0 - 20,000;49;68;-19;0;0;0
702210;Princess Serena ~Raid of Demon Legion~;Casual, Simulation;0 - 20,000;100;39;61;0;0;0
702220;Touch My Spinner;Action, Adventure, Indie, Early Access;0 - 20,000;17;7;10;0;0;0
702270;DevWill;Strategy;0 - 20,000;14;1;13;0;0;0
702300;Number World Adventure;Action, Casual, Indie;0 - 20,000;7;0;7;0;0;0
702310;Tricks and Treats;Violent, Action, Adventure, Indie;0 - 20,000;6;2;4;0;0;0
702320;March of Empires;Indie;200,000 - 500,000;865;429;436;37;14;1621
702360;Hunters Life;Casual, Strategy, Early Access;0 - 20,000;4;0;4;0;0;0
702430;SCHOOL SIMULATOR MULTIPLAYER;Adventure, Casual, Indie, Sports, Strategy;0 - 20,000;16;18;-2;0;0;0
702510;Mille Bornes;Free to Play, Indie, Sports;0 - 20,000;20;28;-8;0;0;1
702510;Mille Bornes;Action, Adventure, Casual, Indie, RPG, Strategy;0 - 20,000;20;28;-8;0;0;1
702550;EZ4u;Casual, Simulation;0 - 20,000;2;2;0;0;0;0
702600;Indygo;Action, Simulation, Strategy;0 - 20,000;51;4;47;0;0;0
702620;Wrecking Towers;Adventure, Casual, Indie, Strategy;0 - 20,000;0;0;0;0;0;0
702670;Donut County;Indie, Simulation, Strategy, Early Access;200,000 - 500,000;6560;671;5889;301;177;26
702680;Wattam;Adventure, Casual, Indie;20,000 - 50,000;315;59;256;0;0;8
702700;Super Bomberman R;Adventure, Casual, Indie;20,000 - 50,000;303;250;53;370;370;10
702790;午餐13;Adventure, Casual, Indie;0 - 20,000;15;2;13;0;0;0
702810;Shooty Skies;Action, Casual, Free to Play, Indie;200,000 - 500,000;1264;113;1151;293;53;2
702820;By Any Means Necessary;Animation & Modeling, Design & Illustration, Utilities, Early Access;0 - 20,000;3;0;3;0;0;0
702890;BlazBlue: Cross Tag Battle;Action, Casual, Indie;100,000 - 200,000;3167;807;2360;1453;1023;27
702900;Time Barbarian Extreme!!;Casual, Strategy;0 - 20,000;2;0;2;0;0;0
702930;Packet Queen #;Adventure, Indie;0 - 20,000;0;0;0;0;0;0
702940;Paper Shakespeare: To Date Or Not To Date?;Indie;0 - 20,000;10;2;8;0;0;0
703000;Beer, Babes and Dragons;Adventure, Casual, Indie;0 - 20,000;4;0;4;0;0;0
703030;NewTypes;Action, Casual, Indie;0 - 20,000;9;2;7;0;0;0
703050;iHUGU;Action, Adventure, Casual, Strategy;0 - 20,000;9;2;7;0;0;0
703060;connect - Virtual Home (3D or VR);Casual, Indie;0 - 20,000;30;29;1;0;0;0
703080;Planet Zoo;Adventure, Indie, RPG, Simulation, Early Access;2,000,000 - 5,000,000;59302;6209;53093;1433;410;4614
703090;冒险之路(Adventure Road);Action, Casual, Indie, Simulation;0 - 20,000;15;14;1;0;0;0
703100;Parabolus;Violent, Gore, Action, Adventure;0 - 20,000;0;0;0;0;0;0
703120;Keeplanet;Action, Free to Play, Indie, Strategy;0 - 20,000;14;8;6;0;0;0
703140;Codename: Phantom;Adventure, Indie;0 - 20,000;8;3;5;0;0;0
703180;Ben 10;Violent, Gore, Action, Adventure, Indie, RPG;0 - 20,000;226;63;163;134;134;1
703200;Jumphobia Classic;Action, Adventure, Indie;0 - 20,000;7;3;4;0;0;0
703210;My Little Worms;Action, Casual, Free to Play, Indie, Massively Multiplayer;0 - 20,000;21;16;5;0;0;0
703210;My Little Worms;Action, Adventure, Casual, Simulation;0 - 20,000;21;16;5;0;0;0
703250;AstroShift;Adventure;0 - 20,000;6;1;5;0;0;0
703260;Blast;Indie, RPG, Simulation;0 - 20,000;0;2;-2;0;0;0
703280;Zeal;Action, Adventure, Casual, Free to Play, Indie, Early Access;50,000 - 100,000;312;127;185;0;0;0
703300;NORMALIZATOR;Action, Casual, Indie;0 - 20,000;23;21;2;24;24;0
703310;Hidden & Dangerous: Action Pack;Casual, Indie, Simulation, Sports, Strategy;20,000 - 50,000;80;24;56;0;0;2
703310;Hidden & Dangerous: Action Pack;Casual, Indie;20,000 - 50,000;80;24;56;0;0;2
703320;Hidden & Dangerous 2: Courage Under Fire;Adventure, Casual, Indie, RPG, Strategy;100,000 - 200,000;591;29;562;39;39;35
703360;Stickman Annihilation 2;Action, Indie;0 - 20,000;5;4;1;0;0;0
703400;Enoch: Underground;Action, Adventure, Casual, Indie, RPG, Simulation;0 - 20,000;21;14;7;0;0;0
703430;Star Rangers VR - Free Demo;Action, Indie;0 - 20,000;15;10;5;0;0;0
703480;Virtual Space;Casual, Indie;20,000 - 50,000;25;14;11;34;34;0
703490;Flat Worlds;Action, Adventure, Indie;0 - 20,000;11;1;10;0;0;0
703500;ReThink | Evolved;Action, Casual, Indie, Early Access;0 - 20,000;56;6;50;0;0;1
703510;Wooden Battles;Action, Indie;100,000 - 200,000;316;99;217;277;534;6
703530;Grav Blazer Squared;Casual, Massively Multiplayer, Simulation, Strategy;0 - 20,000;23;37;-14;0;0;0
703540;Algorithm;Action, Adventure, Casual, Indie, Massively Multiplayer, Racing, RPG, Simulation, Sports, Strategy;0 - 20,000;14;6;8;0;0;0
703600;ASTRAL;Indie, RPG, Strategy;0 - 20,000;77;57;20;0;0;0
703620;Clash Force;Action, Adventure, Casual, Indie, RPG, Early Access;0 - 20,000;108;21;87;0;0;0
703630;The Quarter Game;Action, Adventure, Simulation;0 - 20,000;68;3;65;8;8;0
703700;Our End of the World;Adventure, Indie;100,000 - 200,000;3432;871;2561;177;199;8
703720;ERSATZ;Adventure, Free to Play, Indie;20,000 - 50,000;15;2;13;0;0;0
703730;Sorcery Jokers All Ages Version;Action, Adventure, Casual, Indie;0 - 20,000;73;6;67;0;0;0
703760;Chopper: Attack helicopters;Casual, Indie, Strategy;0 - 20,000;11;14;-3;2;2;0
703800;All Cows In;Action, Adventure, Casual, Indie;0 - 20,000;4;0;4;0;0;0
703820;Pixel Killers - The Showdown;Indie, Simulation, Strategy, Early Access;0 - 20,000;0;1;-1;0;0;0
703840;Animal Super Squad;Action, Adventure, Casual, Indie, Simulation, Strategy;20,000 - 50,000;435;93;342;90;107;2
703860;GRID;Action, Indie, Simulation;200,000 - 500,000;3956;1875;2081;721;139;71
703870;Make a word!;Adventure, Indie, RPG, Strategy;20,000 - 50,000;33;15;18;0;0;0
703880;Swords and Soldiers 2 Shawarmageddon;Adventure, Casual;20,000 - 50,000;174;74;100;16;16;4
703920;Bang Bang Fruit 2;Adventure, Casual;50,000 - 100,000;38;59;-21;0;0;0
703940;Ball 2D: Soccer Online;Violent, Action, Indie, Simulation;50,000 - 100,000;268;82;186;75;80;1
703950;Just Fishing;Action, Casual, Indie, Early Access;200,000 - 500,000;695;230;465;39;39;1
703960;MORDER;Action, Casual, Indie, Racing;0 - 20,000;3;0;3;0;0;0
703970;Protoball;Adventure, Casual, Indie, RPG, Strategy;50,000 - 100,000;67;36;31;0;0;0
703980;Star Wars: Imperial Assault - Legends of the Alliance;Casual, Indie, Simulation;50,000 - 100,000;130;22;108;103;99;2
704010;LongStory;Action, Indie;0 - 20,000;71;23;48;0;0;0
704010;LongStory;Adventure, Casual, Free to Play, Indie, RPG;0 - 20,000;71;23;48;0;0;0
704020;Master Arena;Adventure, Casual, Indie, Strategy;0 - 20,000;104;51;53;0;0;1
704030;Professional Farmer: Cattle and Crops;Casual;50,000 - 100,000;1155;531;624;588;595;5
704040;Castle Clicker : Building Tycoon;Adventure, Casual, Indie, RPG, Strategy;100,000 - 200,000;433;201;232;4;4;40
704070;Robots.io;Action, Casual, Indie;0 - 20,000;5;6;-1;0;0;0
704110;Gunhouse;Casual, Indie, Strategy;0 - 20,000;14;7;7;0;0;0
704140;Edge Of Existence;Indie;0 - 20,000;6;6;0;0;0;0
704190;Bitcoin Collector;Adventure, Casual, Indie, Sports, Strategy;50,000 - 100,000;85;65;20;0;0;0
704200;The Chronicles of Nyanya;Action, Adventure, Indie;0 - 20,000;144;9;135;923;923;0
704210;BLOCK WARRIORS: Classic Edition;Adventure, Indie;20,000 - 50,000;336;325;11;14;14;0
704230;Pro Cycling Manager 2018;Indie, RPG, Strategy;100,000 - 200,000;300;97;203;0;0;69
704270;Generation Zero;Action, Adventure, Indie;1,000,000 - 2,000,000;20842;9323;11519;902;318;903
704300;Bartender VR Simulator;Action, Casual;20,000 - 50,000;49;24;25;0;0;0
704310;Lumberjack VR;Action, Indie;0 - 20,000;10;7;3;4;4;0
704350;Captain 13 Beyond the Hero;Casual, Indie, Simulation;0 - 20,000;1;1;0;0;0;0
704350;Captain 13 Beyond the Hero;Adventure, Casual, Indie, Simulation;0 - 20,000;1;1;0;0;0;0
704360;SACRALITH : The Archer`s Tale;Action, Indie;20,000 - 50,000;217;36;181;0;0;0
704370;Water Pipeline;Violent, Gore, Action, Adventure, Casual, Indie, Racing, Sports;0 - 20,000;3;3;0;0;0;0
704430;Space Survivors I: The Reckoning;Action, Casual, Indie, Early Access;0 - 20,000;4;1;3;0;0;0
704440;Nimble Fish;Action, Indie, Simulation;0 - 20,000;57;15;42;0;0;0
704450;Neverwinter Nights: Enhanced Edition;Sexual Content, Nudity, Violent, Gore, RPG, Early Access;500,000 - 1,000,000;5954;718;5236;886;306;1085
704470;VR Furballs - Demolition;Violent, Gore, Action, Indie, Simulation;20,000 - 50,000;140;7;133;0;0;2
704480;Durak!;Indie, Simulation, Strategy;0 - 20,000;48;17;31;0;0;1
704510;Mercury Fallen;Action, Adventure, Casual, Indie;20,000 - 50,000;164;30;134;0;0;1
704520;Battle Buddies VR;Indie;0 - 20,000;0;0;0;0;0;0
704640;Evolution of Ages: Settlements;Adventure, Casual, Indie, Strategy;20,000 - 50,000;240;39;201;680;680;0
704660;Maze Trials;;0 - 20,000;1;0;1;0;0;0
704680;AMPLITUDE: A Visual Novel;Action, Indie;0 - 20,000;36;12;24;0;0;0
704690;Elisa: Seduce the Innkeeper;Violent, Gore, Adventure, Indie;20,000 - 50,000;128;49;79;1;1;0
704700;TRYON;Action, Free to Play, Indie;0 - 20,000;7;3;4;0;0;0
704750;Uplands Motel;Action, Casual, Indie, Simulation, Strategy;0 - 20,000;2;3;-1;0;0;0
704760;Grimrush;Action, Casual, Indie, Simulation, Strategy;0 - 20,000;11;3;8;0;0;0
704830;Esports Life: Ep.1 - Dreams of Glory;Action, Adventure, Indie, RPG;0 - 20,000;107;96;11;30;30;1
704840;The Walking Vegetables;Indie;20,000 - 50,000;162;15;147;0;0;1
704850;Thief Simulator;Action, Indie, RPG;1,000,000 - 2,000,000;17887;2539;15348;636;248;377
704860;Keepsake;Casual, Indie;50,000 - 100,000;234;45;189;0;0;2
704880;Trident's Wake;Action, Adventure, Indie, Early Access;100,000 - 200,000;43;59;-16;0;0;0
704910;Tenta Shooter;Indie, Racing, Early Access;0 - 20,000;132;11;121;308;308;0
704920;Magic Rampage;Action, Adventure, Casual, Indie, Simulation;20,000 - 50,000;694;45;649;0;0;32
704940;BOX IT;Casual, Indie, Simulation;0 - 20,000;0;4;-4;0;0;0
704950;Scarlett's Dungeon;Casual, Indie, Sports;0 - 20,000;32;11;21;0;0;0
704990;OSES;Sexual Content, Education, Utilities;0 - 20,000;7;2;5;0;0;0
705000;OctorSpace;Adventure, Indie;0 - 20,000;0;0;0;0;0;0
705020;Bottom of the 9th;Strategy;0 - 20,000;41;8;33;0;0;0
705050;Apocalypse: Legacy Edition;Action, Adventure, RPG;0 - 20,000;7;15;-8;1;1;0
705060;Infernales;Action, Adventure, Casual, Indie;20,000 - 50,000;25;40;-15;0;0;0
705070;FEMINAZI: 3000;Action, Adventure, Indie;20,000 - 50,000;38;41;-3;0;0;0
705090;Trivia Vault: Super Heroes Trivia 2;Action, Indie, Racing, Simulation;0 - 20,000;42;31;11;1;1;0
705090;Trivia Vault: Super Heroes Trivia 2;Indie;0 - 20,000;42;31;11;1;1;0
705100;Marshmallow Melee;Adventure, Casual, Indie, RPG;0 - 20,000;67;15;52;0;0;0
705120;Death Coming/死神来了;Action, Adventure, Casual, Indie, Early Access;200,000 - 500,000;2861;311;2550;154;205;8
705130;Foundation of Nightmares;Action, Indie;0 - 20,000;0;0;0;0;0;0
705150;Rhythm World - Master Project;Casual, Racing, Simulation;0 - 20,000;58;19;39;0;0;0
705150;Rhythm World - Master Project;Action, Adventure, Indie;0 - 20,000;58;19;39;0;0;0
705160;Moon VR Video Player;Casual;20,000 - 50,000;146;65;81;2;2;0
705210;Cube Racer;Action;200,000 - 500,000;980;93;887;349;162;513
705220;Tactical Monsters Rumble Arena;Action;500,000 - 1,000,000;4030;496;3534;865;287;87
705230;InGame.exe;Action, Adventure, Simulation;0 - 20,000;2;5;-3;0;0;0
705240;Boom Box Blue!;Action, Casual, Indie;0 - 20,000;37;6;31;0;0;0
705250;Cross Set Infinity;Adventure, Indie;0 - 20,000;17;8;9;0;0;0
705260;Waste Cleaner;Indie, Strategy;0 - 20,000;10;8;2;0;0;0
705280;Hakoniwa Explorer Plus;Casual, Indie, Simulation;20,000 - 50,000;410;67;343;22;41;3
705290;Strange Telephone;Casual, Indie, Simulation;20,000 - 50,000;257;50;207;68;68;1
705300;Suicide Adventures;Action, Indie;0 - 20,000;33;27;6;12;12;1
705340;Kofi Quest: Alpha MOD;Casual, Indie;0 - 20,000;190;8;182;0;0;1
705370;The Cursed Tower;Casual, Indie, Simulation, Sports;20,000 - 50,000;58;34;24;8;13;0
705380;Galactic Shipwright;Action, Indie, Strategy;0 - 20,000;20;3;17;0;0;0
705390;Aya's Journey;Adventure, Casual, Indie, Simulation, Sports, Strategy;0 - 20,000;12;19;-7;0;0;0
705410;World War Party: Game Of Trump;Violent, Action, Indie, RPG, Strategy;0 - 20,000;18;18;0;0;0;0
705410;World War Party: Game Of Trump;Casual, Indie;0 - 20,000;18;18;0;0;0;0
705440;Onager!;Casual, Indie;0 - 20,000;3;2;1;0;0;0
705450;Wunderdoktor;Casual, Indie;0 - 20,000;76;9;67;273;273;0
705500;Tiny Bubbles;Casual, Indie;0 - 20,000;47;3;44;0;0;1
705510;Picture Builder;Casual, Indie;0 - 20,000;0;3;-3;0;0;0
705530;Wizard Hunter 2348;Action, Adventure, Casual, Indie, RPG, Simulation, Strategy;0 - 20,000;7;0;7;0;0;0
705550;Burgle Bros.;Casual, Indie;50,000 - 100,000;29;5;24;0;0;1
705610;Where They Cremate The Roadkill;RPG;0 - 20,000;54;19;35;0;0;0
705620;HELLMUT: The Badass from Hell;Indie;0 - 20,000;37;10;27;0;0;0
705640;BACK TO THE EGG! Tower Defense;Casual, Indie, Simulation;0 - 20,000;16;14;2;0;0;0
705670;Ballz: Farm;Action, Adventure, RPG;0 - 20,000;63;12;51;0;0;0
705700;Stripper Anya 2 X-MiGuFighters;Adventure, Indie, RPG;0 - 20,000;9;10;-1;0;0;0
705710;Sense of The Devil;Action, Indie;20,000 - 50,000;50;81;-31;0;0;0
705740;Car Demolition Clicker;Action, Indie, Early Access;0 - 20,000;87;54;33;0;0;5
705750;American Patriots: Boston Tea Party;Action, Adventure, Casual, Indie;20,000 - 50,000;73;12;61;0;0;1
705770;The Donnerwald Experiment;Action, Adventure, Casual, Indie, Simulation;50,000 - 100,000;25;0;25;0;0;0
705780;Ancient Future;Adventure, Indie, RPG;0 - 20,000;6;1;5;0;0;0
705800;Astroe;Adventure, Indie, RPG;0 - 20,000;8;6;2;0;0;0
705810;Wuxing Master 五行师(CCG);Action, Adventure, Free to Play, Indie;50,000 - 100,000;169;53;116;0;0;7
705830;万视VR;Adventure, Casual, Indie;0 - 20,000;7;5;2;0;0;0
705860;SpaceWalker;Action, Casual, Indie, Strategy, Early Access;0 - 20,000;17;5;12;0;0;0
705870;Echo Grotto;Action, Adventure, Casual, Indie;0 - 20,000;58;7;51;74;74;0
705920;Empress of Gold;Action, Adventure, Indie, RPG, Strategy;0 - 20,000;3;0;3;0;0;0
705930;The Trace;Action, Adventure;0 - 20,000;1;1;0;0;0;0
706010;The Unseen;Indie;0 - 20,000;1;2;-1;0;0;0
706010;The Unseen;Casual;0 - 20,000;1;2;-1;0;0;0
706020;Fade to Silence;Action, Adventure, Casual, Indie;50,000 - 100,000;748;440;308;592;614;6
706030;Parking Cop Simulator;Action, Indie;0 - 20,000;8;5;3;0;0;0
706130;Far from Noise;Violent, Action, Adventure, Indie, Simulation, Strategy;0 - 20,000;136;20;116;0;0;0
706210;Haul Asteroid;Action, Casual, Indie, Strategy;0 - 20,000;0;1;-1;0;0;0
706240;Gravity Light;Violent, Gore, Action, Indie;0 - 20,000;21;8;13;0;0;0
706270;Space Zombies Invasion;Adventure, Casual, Indie;0 - 20,000;3;0;3;0;0;0
706280;Devil in the Pines;Casual, Free to Play, Indie;0 - 20,000;22;5;17;0;0;0
706320;Trivia Vault: Mini Mixed Trivia;Action, Adventure, Casual, Indie, Massively Multiplayer;0 - 20,000;43;35;8;1;1;0
706330;Trivia Vault: Mini Mixed Trivia 2;Action, Adventure, Indie, RPG, Strategy;0 - 20,000;42;33;9;1;1;0
706350;Mari and the Black Tower;Adventure, Casual, Indie;0 - 20,000;13;1;12;0;0;0
706370;LOGistICAL: USA - Oregon;Racing, Simulation, Sports;0 - 20,000;8;1;7;0;0;1
706380;LOGistICAL: Norway;Casual, Simulation, Strategy;0 - 20,000;3;1;2;0;0;0
706390;LOGistICAL: Chile;Action, Adventure, Free to Play, Indie, RPG, Simulation, Early Access;0 - 20,000;10;3;7;0;0;0
706440;Cyborg Arena;Action, Casual, Indie;0 - 20,000;14;24;-10;0;0;0
706440;Cyborg Arena;Adventure, Casual;0 - 20,000;14;24;-10;0;0;0
706480;The Man in the Cape: Special Edition;Adventure, Casual, Indie;0 - 20,000;0;0;0;0;0;0
706510;SOMOS;Action, Adventure, Casual, Indie;0 - 20,000;24;0;24;0;0;0
706520;BlackShield: Upora Story;Casual, Indie, Strategy;0 - 20,000;34;14;20;0;0;0
706550;Kaya;Adventure, Indie, RPG;0 - 20,000;0;0;0;0;0;0
706560;Jimmy and the Pulsating Mass;Indie, Strategy;20,000 - 50,000;401;27;374;0;0;1
706570;The Seven Stages;Action, Adventure, RPG;0 - 20,000;3;2;1;0;0;0
706690;Megatronic Void;Adventure, Casual, Indie;0 - 20,000;6;26;-20;0;0;0
706710;Close Your Eyes;;0 - 20,000;25;3;22;0;0;0
706840;Castaway VR;Adventure, RPG;0 - 20,000;13;34;-21;0;0;0
706850;Devader;Violent, Gore, Action, Casual, Indie, Strategy, Early Access;0 - 20,000;52;1;51;0;0;0
706850;Devader;Action, Strategy;0 - 20,000;52;1;51;0;0;0
706880;Austen Translation;Action, Casual, Indie, Simulation, Strategy, Early Access;;;;0;;;
706920;战术狂想1(Chimera of Tactics 1);Action, Indie;0 - 20,000;33;4;29;0;0;0
706950;Chupacabra;Action, Adventure, Indie, RPG, Simulation;0 - 20,000;1;7;-6;0;0;0
706960;Super Slime Arena;Action, Casual, Indie;0 - 20,000;41;12;29;0;0;0
706990;BLOCKPOST;Indie, Massively Multiplayer, Strategy;1,000,000 - 2,000,000;11599;4005;7594;0;0;64
707000;Aw Nutz;Action, Adventure, Casual, Indie;0 - 20,000;3;4;-1;0;0;0
707010;Will To Live Online;Casual, Indie;500,000 - 1,000,000;10255;3970;6285;1381;94;1702
707030;POSTAL 4: No Regerts;Sexual Content, Free to Play, Indie, RPG;200,000 - 500,000;6911;2381;4530;209;219;54
707040;Robosoul;Casual;0 - 20,000;1;1;0;0;0;0
707060;Beast Quest;Action, Indie;0 - 20,000;20;31;-11;116;164;0
707110;Anahita;Adventure, Indie;20,000 - 50,000;18;5;13;0;0;0
707140;Chess;Adventure, Indie;0 - 20,000;1;18;-17;0;0;0
707220;The Base;Adventure, Indie;0 - 20,000;5;4;1;0;0;0
707230;Prison Chainball Massacre;Action, Indie, Simulation, Strategy;0 - 20,000;10;4;6;0;0;0
707280;ResumeMaker Professional Deluxe 20;Adventure, Indie;0 - 20,000;2;4;-2;0;0;0
707300;Hatsune Miku VR;Action, Casual, Indie;50,000 - 100,000;423;159;264;1;1;1
707320;Keatz: The Lonely Bird;Adventure, Indie, Simulation;0 - 20,000;11;10;1;0;0;0
707320;Keatz: The Lonely Bird;Action, Indie;0 - 20,000;11;10;1;0;0;0
707340;Awakening;Action, Free to Play, Indie;0 - 20,000;10;2;8;0;0;0
707350;Damascus Gear Operation Osaka HD Edition;Adventure, Casual, Indie;0 - 20,000;12;9;3;0;0;0
707400;Attack Of Insects;Action, Adventure, Indie;0 - 20,000;64;19;45;814;814;0
707450;March to Glory;Adventure, Indie, RPG;0 - 20,000;16;15;1;0;0;0
707470;JumpFist;Action, Casual, Indie;0 - 20,000;2;1;1;0;0;0
707560;Crucible Trails : Initial Rupture;Indie;0 - 20,000;4;1;3;0;0;0
707580;AFFECTED: The Manor - The Complete Edition;Simulation, Strategy;20,000 - 50,000;129;32;97;0;0;3
707610;Food Mahjong;Adventure, Indie;0 - 20,000;7;3;4;0;0;0
707680;Slapshot;Casual, Indie, Strategy, Early Access;200,000 - 500,000;2204;412;1792;139;104;1
707720;Ragna Maya;Action, Casual, Indie, Sports;0 - 20,000;6;6;0;0;0;0
707750;DrumSim;Casual, Indie;0 - 20,000;2;9;-7;0;0;0
707770;Tactics 2: War;Adventure, Casual, Free to Play;0 - 20,000;3;6;-3;0;0;0
707860;The Power Factory;Action;0 - 20,000;2;4;-2;0;0;0
707870;Hoo-Boy;Adventure, Indie;20,000 - 50,000;115;43;72;24;24;0
707920;Analemma;Action, Indie;0 - 20,000;14;17;-3;0;0;0
707950;Tank Warz!;Casual, Indie, Simulation, Strategy;20,000 - 50,000;3;0;3;0;0;0
707960;I was here;Action, Adventure, Indie;0 - 20,000;9;11;-2;0;0;0
708100;A Boy and His Beard;Casual, Indie, Simulation;20,000 - 50,000;47;17;30;1;1;0
708120;Printer Forge 3D;Adventure, Casual, Indie, RPG;0 - 20,000;5;8;-3;0;0;0
708140;TriElement;Action, Adventure, Casual, Indie;0 - 20,000;2;0;2;0;0;0
708150;Lost Artifacts - Ancient Tribe Survival;Racing, Simulation, Sports, Early Access;20,000 - 50,000;79;7;72;0;0;1
708160;Yokai Mask;Indie, RPG;0 - 20,000;43;1;42;0;0;0
708190;Code World;Action, Indie;0 - 20,000;30;9;21;0;0;0
708190;Code World;Adventure;0 - 20,000;30;9;21;0;0;0
708250;Lava Rolling Kid;Action, Adventure, Indie, Strategy;0 - 20,000;3;2;1;0;0;0
708260;Text Wormhole;Action, Adventure, Casual, Indie, Early Access;0 - 20,000;44;7;37;0;0;0
708280;Bobbi_Cities;Adventure, Casual, Indie;0 - 20,000;2;0;2;0;0;0
708300;Fluffy Friends;Action, Adventure;0 - 20,000;47;12;35;0;0;0
708310;Infinite Gravity;Casual, Indie;0 - 20,000;38;14;24;33;33;0
708340;Shark Simulator;Action, Indie, Strategy, Early Access;50,000 - 100,000;391;58;333;122;122;2
708370;Reboant Demo;Action;0 - 20,000;34;22;12;0;0;0
708420;Broken Ground;Casual, Indie, Simulation, Early Access;200,000 - 500,000;306;115;191;282;296;0
708430;Kamikaze Cube;Racing, Simulation, Sports, Early Access;0 - 20,000;29;54;-25;0;0;0
708450;Pembrey;Action, Indie, RPG;50,000 - 100,000;32;23;9;140;220;1
708510;The Promethium Effect - The Idle Clicker MMO;Indie;0 - 20,000;4;10;-6;0;0;0
708580;The Exorcist: Legion VR - Chapter 1: First Rites;Action, Casual, Indie, Early Access;20,000 - 50,000;200;70;130;21;21;1
708590;Battle Master;Casual, Indie, Racing;20,000 - 50,000;2;0;2;0;0;0
708630;Little Adventurer II;Casual, Indie, Racing;0 - 20,000;2;11;-9;0;0;0
708640;Nudist Beach Survival Simulator;Adventure, Casual, Indie;0 - 20,000;43;7;36;0;0;0
708680;Octopus Bar;Action, Adventure, Casual, Indie, Simulation;50,000 - 100,000;111;11;100;2;2;0
708710;Defend Your Castle;Adventure, Casual, Indie, Racing, Simulation, Sports, Early Access;20,000 - 50,000;23;16;7;0;0;1
708720;Gridiron;Sexual Content, Adventure, Free to Play, Indie;200,000 - 500,000;1618;398;1220;0;0;0
708760;Social Club VR : Casino Nights;Casual, Indie;0 - 20,000;39;11;28;0;0;0
708780;Slam Fighter II;Action, Indie;0 - 20,000;14;0;14;0;0;0
708820;Baby Hands;Casual, Indie, Simulation;0 - 20,000;47;14;33;0;0;2
708830;The Armament Project;Action, Casual, Indie, Simulation, Early Access;0 - 20,000;2;3;-1;0;0;0
708850;Reverie;Casual, Indie;0 - 20,000;33;7;26;0;0;0
708870;Reginald Does His Thang;Indie, Strategy;0 - 20,000;7;0;7;0;0;0
708890;BEATris;Adventure, Casual;0 - 20,000;38;12;26;0;0;0
708910;Hordiaz;Indie;0 - 20,000;1;0;1;0;0;0
708920;I Can See the Future;Action, Indie;0 - 20,000;59;11;48;165;165;0
708930;Diceonline.net;Action, Casual, Indie;0 - 20,000;14;20;-6;0;0;0
708930;Diceonline.net;Sexual Content, Nudity, Indie, RPG, Simulation;0 - 20,000;14;20;-6;0;0;0
708950;Steam Tactics;Action, Adventure, Casual, Free to Play, Indie, Simulation, Early Access;20,000 - 50,000;47;6;41;0;0;0
708970;GOD STARFIGHTER;Adventure, Free to Play, Indie, RPG, Early Access;0 - 20,000;29;6;23;0;0;0
709020;VIRUS OF SURVIVORS:LIFE SIMULATOR;Action, Adventure, Indie, Massively Multiplayer, Strategy;0 - 20,000;0;1;-1;0;0;0
709050;GHOUL;Action, Adventure, Indie, Early Access;0 - 20,000;3;21;-18;0;0;0
709080;The Bears And The Bees;Action;0 - 20,000;19;2;17;0;0;0
709140;A Dream For Aaron;Animation & Modeling;0 - 20,000;16;8;8;0;0;0
709190;God of Failure;Adventure, Indie;0 - 20,000;15;15;0;0;0;0
709240;Ingnomia;Action, Casual, Indie, Racing;100,000 - 200,000;156;54;102;0;0;1
709280;Island Build Masters;Action, Indie;0 - 20,000;4;7;-3;2;2;0
709290;Rage Quest;Action, Adventure, Indie, RPG;0 - 20,000;2;0;2;0;0;0
709340;Spirits of Mystery: The Dark Minotaur Collector's Edition;Animation & Modeling, Design & Illustration;0 - 20,000;2;0;2;0;0;0
709350;Dark Realm: Princess of Ice Collector's Edition;Action, Adventure, Casual, Indie;0 - 20,000;5;0;5;0;0;1
709370;BadRobots VR;Action, Casual, Indie;0 - 20,000;1;0;1;0;0;0
709380;Circularity;Adventure, Indie, Strategy;0 - 20,000;26;17;9;0;0;0
709390;Chewbrick;Adventure, Casual, Indie;0 - 20,000;0;0;0;0;0;0
709400;Low Desert Punk;Action;0 - 20,000;3;0;3;0;0;0
709410;AZURA;Action, Adventure, Indie;20,000 - 50,000;168;95;73;9;9;0
709440;Override: Mech City Brawl;Adventure, Indie;50,000 - 100,000;620;170;450;52;22;3
709450;Towards The Pantheon: Escaping Eternity;Adventure, Casual, Indie, Strategy;20,000 - 50,000;109;11;98;17;17;0
709470;Mirrors;Adventure, Free to Play;0 - 20,000;6;1;5;0;0;0
709480;麻将VR;Adventure, Free to Play;20,000 - 50,000;0;2;-2;0;0;0
709490;Mutiny Island;Casual, Indie;;;;0;;;
709510;Towards The Pantheon;Action, Casual, Indie, Simulation;0 - 20,000;41;2;39;0;0;0
709520;WHERE'S PHANTOM THIEF;Action, Adventure, Casual, Indie, Simulation;0 - 20,000;3;0;3;0;0;0
709550;Tic Tac Toe LOUNGE;Adventure, Casual, Indie, RPG;20,000 - 50,000;5;0;5;0;0;0
709560;Until the last;Adventure, Free to Play;0 - 20,000;10;13;-3;0;0;0
709610;Mahjong Match;Casual;20,000 - 50,000;0;6;-6;0;0;0
709620;Squareboy vs Bullies: Arena Edition;Action, Casual, Indie;0 - 20,000;22;8;14;0;0;0
709670;Clarent Saga: Tactics;Action, Adventure, Casual, Indie, Massively Multiplayer, Strategy;0 - 20,000;43;4;39;0;0;0
709700;The Thing: Space X;Indie, Simulation;0 - 20,000;33;41;-8;3;3;0
709710;Jung's Labyrinth;Violent, Adventure, Free to Play, Indie;0 - 20,000;43;15;28;0;0;0
709720;YAGZZ!;Indie;0 - 20,000;15;10;5;1;1;0
709750;IRO HERO;Action, Casual, Indie;0 - 20,000;1;1;0;0;0;0
709780;Crazy Scientist;Casual, Indie, Simulation;20,000 - 50,000;38;75;-37;0;0;0
709790;The Red Front;Action, Casual, Indie;0 - 20,000;7;6;1;0;0;0
709800;Hardcore ZBoy;Adventure, Casual;20,000 - 50,000;23;44;-21;0;0;0
709820;Wasted Pizza;Action, Indie;50,000 - 100,000;43;84;-41;0;0;0
709840;Bloody Glimpse;Action, Casual, Indie;0 - 20,000;76;98;-22;1;1;0
709850;AMBUSH tactics;Strategy;0 - 20,000;6;9;-3;0;0;0
709870;West of Red;Strategy;20,000 - 50,000;41;49;-8;2;2;0
709880;Panzer Doctrine;Action, Adventure, Indie;0 - 20,000;22;11;11;0;0;0
709890;Crazy Mob;Action, Free to Play, Massively Multiplayer, Strategy;0 - 20,000;3;1;2;0;0;0
709920;Tametsi;Action, Adventure, Casual, Indie, Simulation, Strategy;20,000 - 50,000;747;25;722;21768;21768;26
709940;Weapon and Armor: Mahjong;Action, Adventure, Casual, Indie, Simulation, Sports, Strategy;0 - 20,000;7;0;7;0;0;0
709970;SwapQuest Demo;Violent, Gore, Action, Adventure, Indie, RPG, Early Access;0 - 20,000;0;0;0;0;0;0
710030;Cinderella Escape 2 Revenge;Action, Indie;50,000 - 100,000;318;39;279;128;128;0
710070;Helltown;Adventure, Indie, RPG;0 - 20,000;44;12;32;88;88;0
710090;Annual;Indie, Strategy;0 - 20,000;15;28;-13;0;0;0
710120;Trivia Vault: Mini Mixed Trivia 4;Adventure, Indie;0 - 20,000;45;43;2;1;1;0
710130;(Hidden Dragon Legend: Shadow Trace);Adventure, Indie;0 - 20,000;0;0;0;0;0;1
710160;Mula: The Cycle of Shadow;Adventure, Casual, Free to Play, Indie;0 - 20,000;3;2;1;0;0;0
710170;The Broken Seal;Casual, Indie, Simulation, Strategy;0 - 20,000;183;22;161;0;0;0
710190;谜题姐妹 Puzzle Sisters;Adventure, Indie;0 - 20,000;52;17;35;0;0;0
710220;DreadStar: The Quest for Revenge;Adventure, Indie;0 - 20,000;33;9;24;0;0;1
710240;Interworlds;Sexual Content, Nudity, Adventure, Casual;0 - 20,000;5;3;2;0;0;0
710250;Pet Squad Racing;Adventure, Casual, Indie, RPG;0 - 20,000;11;5;6;0;0;0
710280;Musician;Violent, Gore, Action, Adventure, Indie, RPG, Early Access;0 - 20,000;1;0;1;0;0;0
710310;Hopscotch;Utilities;0 - 20,000;3;0;3;0;0;0
710360;Personality Psychology Premium;Violent, Gore, Action, Indie;0 - 20,000;11;3;8;0;0;0
710400;TERRAGEARTH;Action, Adventure, Casual, Indie;0 - 20,000;5;0;5;92;92;0
710460;Rush on Rome;Simulation;0 - 20,000;3;4;-1;0;0;0
710470;Little Witch Academia: Chamber of Time;Strategy;50,000 - 100,000;984;280;704;213;305;8
710480;Extreme Real Reality HD Remix;Casual, Indie;0 - 20,000;12;3;9;0;0;0
710480;Extreme Real Reality HD Remix;Adventure, Casual, Indie, Simulation;0 - 20,000;12;3;9;0;0;0
710520;Super Trashforce;Action, Indie;0 - 20,000;16;11;5;0;0;0
710520;Super Trashforce;Action, Indie;0 - 20,000;16;11;5;0;0;0
710550;Cubion;Casual, Indie, Strategy;0 - 20,000;6;2;4;0;0;0
710600;Red Bow;Indie, Simulation;0 - 20,000;156;31;125;0;0;0
710610;Don't Sink;Action, Casual, Indie, Early Access;20,000 - 50,000;149;54;95;2;2;0
710620;Wira & Taksa: Against the Master of Gravity;Violent, Gore, Action, Adventure, Indie, RPG, Strategy;0 - 20,000;6;0;6;0;0;0
710630;GOLDRUSHERS;Violent, Action, Adventure, Indie, RPG, Early Access;0 - 20,000;9;0;9;0;0;0
710640;PRO DRIFT RELOADED 2020;Casual, Indie;0 - 20,000;8;18;-10;0;0;0
710650;Conquest of Gerazania;Casual, Strategy;0 - 20,000;0;1;-1;0;0;0
710670;Reprogram;Casual, Strategy;0 - 20,000;0;1;-1;0;0;0
710670;Reprogram;Casual, Indie, Racing;0 - 20,000;0;1;-1;0;0;0
710690;The Path of Motus;Design & Illustration, Education;0 - 20,000;15;2;13;0;0;0
710700;Paperback: The Game;Action, Adventure, Indie;20,000 - 50,000;32;15;17;0;0;2
710710;Pizza Game;Casual;0 - 20,000;280;3;277;68;68;1
710740;Sniper Rust VR;Animation & Modeling, Design & Illustration;0 - 20,000;10;6;4;0;0;0
710760;High Noon VR;Action, Casual, Indie, Strategy;0 - 20,000;45;19;26;0;0;0
710780;Sky Jump;Adventure, Indie;0 - 20,000;191;62;129;34;34;0
710820;BELPAESE: Homecoming;Action, Casual, Indie, Early Access;20,000 - 50,000;15;3;12;0;0;0
710880;Dark Rising;Action, Adventure, Free to Play, Indie;0 - 20,000;4;11;-7;155;155;0
710920;Darksiders Genesis;Casual, Indie;500,000 - 1,000,000;8665;1735;6930;851;755;146
710940;Owl's Midnight Journey;Violent, Casual, Indie;0 - 20,000;3;0;3;0;0;0
710950;Pinewood Island;Adventure, Indie;0 - 20,000;36;7;29;0;0;0
710960;Enceladus;Casual;0 - 20,000;1;0;1;0;0;0
710970;Learn (Japanese) Kana The Fun Way!;Indie;0 - 20,000;2;8;-6;0;0;0
710990;KENDAMVR - Virtual Reality Kendama;Casual, Indie, Simulation, Early Access;0 - 20,000;0;1;-1;0;0;0
711000;Ancient Tower;Gore, Action;0 - 20,000;1;2;-1;0;0;1
711010;Corrupt - Political Simulator;Action, Indie;0 - 20,000;56;29;27;0;0;0
711050;Walking Heavy;Indie, Simulation;0 - 20,000;4;4;0;0;0;0
711070;Kim Jong-Boom;Action, Casual, Indie;20,000 - 50,000;38;57;-19;22;32;0
711130;God of Light: Remastered;Indie, Racing, Sports;20,000 - 50,000;42;4;38;0;0;0
711130;God of Light: Remastered;Strategy;20,000 - 50,000;42;4;38;0;0;0
711140;Forsaken Generation;Indie, Simulation, Strategy, Early Access;0 - 20,000;1;1;0;0;0;0
711150;Brick Breaker Ultimate;Adventure, Casual, Indie;0 - 20,000;24;29;-5;0;0;0
711190;Color Sudoku;Action, Adventure, Indie, Racing, Sports;0 - 20,000;1;0;1;0;0;0
711210;StepX;Action, Indie;0 - 20,000;73;18;55;0;0;0
711230;Titus the Fox;Action, Indie;0 - 20,000;14;2;12;0;0;0
711240;Grand Academy for Future Villains;Action, Adventure, Indie;0 - 20,000;14;6;8;0;0;0
711260;BHB: BioHazard Bot;Indie, Strategy;0 - 20,000;2;0;2;0;0;0
711300;Bit Storm VR: First Loop;Action, Adventure, Indie, RPG, Early Access;0 - 20,000;7;0;7;0;0;0
711310;SPIIIDERS;Adventure, Casual, Indie, Strategy;0 - 20,000;0;1;-1;0;0;0
711320;Battle of Frigates;Casual, Indie;50,000 - 100,000;61;46;15;0;0;0
711330;Trial of the Demon Hunter;Action, Indie;0 - 20,000;2;3;-1;0;0;0
711350;Captive of Fortune;Adventure;0 - 20,000;0;3;-3;0;0;0
711380;Code of Princess EX;Casual;0 - 20,000;24;15;9;0;0;1
711380;Code of Princess EX;Casual, Indie, Racing;0 - 20,000;24;15;9;0;0;1
711390;Anti Gravity Warriors VR;Action, Adventure, Free to Play, RPG, Early Access;0 - 20,000;10;12;-2;5;5;0
711430;Miss Fisher and the Deathly Maze;Action, Casual, Indie;0 - 20,000;44;7;37;0;0;1
711440;Mortars VR;Adventure, Indie, Simulation, Strategy, Early Access;20,000 - 50,000;98;64;34;32;44;0
711450;Orb The Ball;Violent, Action;20,000 - 50,000;18;18;0;0;0;0
711460;Duel Survival;Action, Free to Play;0 - 20,000;0;2;-2;0;0;0
711480;Room 42;Action, Indie;0 - 20,000;8;2;6;0;0;0
711500;Dr. Fizzgigious' Fantabulous Carbon Dating Simulacrum;Action, Indie;0 - 20,000;3;0;3;0;0;0
711530;Butterfly Moment;Animation & Modeling, Design & Illustration;0 - 20,000;12;10;2;0;0;0
711540;Lonely Mountains: Downhill;Action, Adventure;100,000 - 200,000;1707;147;1560;196;282;17
711550;GLO - Difficult Indie Platformer;Action, Indie;0 - 20,000;10;0;10;0;0;0
711560;Stone Flower;Action, Adventure, Casual, Free to Play, Indie, RPG, Simulation, Strategy;50,000 - 100,000;34;35;-1;4;5;0
711570;Epic Battle Simulator 2;Action, Adventure, Indie;0 - 20,000;29;14;15;0;0;0
711600;Dragon Orb;Action, Adventure, Casual, Indie, Strategy, Early Access;0 - 20,000;0;0;0;0;0;0
711660;CHUCHEL;Indie, Early Access;100,000 - 200,000;2314;509;1805;223;257;13
711690;Cognizer;Free to Play, Indie, Strategy;0 - 20,000;46;4;42;0;0;0
711690;Cognizer;Adventure, Indie, RPG;0 - 20,000;46;4;42;0;0;0
711700;Derpy Fight;Action, Adventure, Casual, Indie;0 - 20,000;8;1;7;0;0;0
711710;RedEyes 赤瞳之勋;Casual, Indie, Simulation, Strategy;0 - 20,000;35;17;18;0;0;0
711720;Fade Away;Adventure, Indie, RPG, Simulation;0 - 20,000;7;1;6;0;0;0
711750;Monster Energy Supercross - The Official Videogame;Adventure, Indie;50,000 - 100,000;665;146;519;1196;1742;20
711770;Hotel Dracula;Casual;0 - 20,000;34;26;8;0;0;1
711810;Never Split the Party;Adventure, Casual, Indie;500,000 - 1,000,000;3189;973;2216;78;31;26
711820;Plumb;Action, Indie, Early Access;0 - 20,000;2;0;2;0;0;0
711870;Degauss;Adventure, Indie;0 - 20,000;0;0;0;0;0;0
711890;Dark Parables: Goldilocks and the Fallen Star Collector's Edition;Casual, Indie, Simulation;0 - 20,000;14;0;14;0;0;0
711920;Detective Case and Clown Bot in: The Express Killer;Indie;0 - 20,000;26;3;23;0;0;0
711930;Square Head Zombies - FPS Game;Action, Indie, Racing, Early Access;0 - 20,000;32;62;-30;0;0;0
711970;GALACTIC FIELD：Strategy Edition BATE2017 银河领域：策略版 BATE 2017;Action, Adventure, Indie, RPG;0 - 20,000;8;3;5;0;0;0
711980;Starship EVO;Action, Adventure, Strategy;20,000 - 50,000;704;123;581;0;0;9
711990;Elise the Devil;Action, Adventure, Indie, Early Access;200,000 - 500,000;2085;158;1927;1011;226;2
712000;Elder Chaos;Action, Adventure, Casual, Indie, Racing;20,000 - 50,000;37;42;-5;0;0;0
712010;Chevo Lurker: Exodus;Action, Adventure, Indie, Simulation, Early Access;0 - 20,000;71;21;50;0;0;0
712050;Otaku's Fantasy;Action, Indie;200,000 - 500,000;2674;349;2325;145;125;2
712060;M.I.A. - Overture;Adventure, Casual, Indie;0 - 20,000;35;4;31;0;0;0
712070;Lantern of Worlds;Action, Casual, Indie;0 - 20,000;8;5;3;1;1;0
712080;7 Bones and 7 Stones - The Ritual;Casual, Indie, Simulation;20,000 - 50,000;34;30;4;0;0;1
712090;Don't Feed;Action, Adventure, Indie;0 - 20,000;40;15;25;0;0;0
712090;Don't Feed;Casual;0 - 20,000;40;15;25;0;0;0
712100;A Total War Saga: THRONES OF BRITANNIA;Indie;500,000 - 1,000,000;8661;3870;4791;2165;1155;488
712150;TankVR;Adventure, Indie, RPG;0 - 20,000;20;16;4;0;0;0
712180;Mugsters;Action, Casual, Free to Play, Indie;20,000 - 50,000;62;25;37;143;143;1
712190;Genesis Alpha One Deluxe Edition;Action, Adventure, Indie;100,000 - 200,000;1406;660;746;196;285;36
712230;WARZONE;Action, Casual, Indie, Racing, Sports, Early Access;0 - 20,000;3;1;2;0;0;0
712240;Sneaky Bears;Action, Indie;0 - 20,000;20;3;17;0;0;0
712260;Feast Your Eyes;Action;0 - 20,000;19;3;16;0;0;0
712380;Temple Escape;Violent, Gore, Action, Adventure, Indie, Early Access;50,000 - 100,000;48;12;36;1;1;0
712390;Team Four Star RPG;Casual, Indie;20,000 - 50,000;67;14;53;9;9;0
712410;Cirque du Soleil;Action, Adventure, Indie, RPG;;;;0;;;
712410;Cirque du Soleil;Action, Adventure, Casual, Indie;;;;0;;;
712430;Vibrant;Action, Casual, Indie, Simulation;0 - 20,000;10;1;9;0;0;0
712530;Chamber of Darkness;Action, Indie;20,000 - 50,000;31;30;1;0;0;0
712610;Onironauta;Adventure, Indie, RPG;0 - 20,000;14;0;14;0;0;0
712620;Shattered;Casual, RPG, Simulation, Strategy;0 - 20,000;3;0;3;0;0;0
712650;Azure Sky Project;Indie;0 - 20,000;17;6;11;165;165;0
712660;YBit;Indie, Simulation, Strategy;0 - 20,000;9;3;6;0;0;0
712700;Black Friday: The Game;Action, Casual, Indie;0 - 20,000;7;1;6;0;0;0
712730;SIMULACRA;Action, Casual, Indie;200,000 - 500,000;3263;318;2945;503;505;17
712760;Duped;Free to Play, Indie, Massively Multiplayer, RPG, Strategy;0 - 20,000;5;0;5;0;0;0
712770;Just A Dream;Adventure, Casual, Indie;20,000 - 50,000;54;13;41;0;0;0
712790;Crimson Memories;Casual, Indie;20,000 - 50,000;51;21;30;0;0;0
712810;Fallen Times;Adventure, Casual, Indie, Simulation, Strategy;20,000 - 50,000;63;44;19;0;0;0
712810;Fallen Times;Action, Casual, Indie, Simulation, Strategy;20,000 - 50,000;63;44;19;0;0;0
712840;King Exit;Casual, Indie;200,000 - 500,000;6341;309;6032;279;153;13
712870;Vectorium;Action, Indie, Sports;0 - 20,000;58;16;42;83;83;0
712880;Chess Arena-象棋竞技场;Action, Simulation, Sports;0 - 20,000;9;5;4;0;0;0
712890;Harmonium;Casual, Indie;0 - 20,000;5;1;4;0;0;0
712970;Clad in Iron: Philippines 1898;Casual, Indie, Strategy;0 - 20,000;25;3;22;0;0;0
712980;Rainyday;Action, Casual, Free to Play, Indie;0 - 20,000;17;8;9;0;0;0
713010;WARIUM;Action, Adventure, Casual;0 - 20,000;17;5;12;0;0;0
713030;Mini Hockey Champ!;Action, Adventure, Indie, RPG, Simulation;0 - 20,000;22;5;17;0;0;0
713050;Vampires!;Strategy;50,000 - 100,000;138;30;108;0;0;0
713060;The Beanstalk;Action, Adventure, Indie, RPG;0 - 20,000;11;5;6;0;0;0
713070;Pray for Death;Indie, Simulation, Strategy;0 - 20,000;2;1;1;0;0;0
713080;President Evil;Casual, Indie;0 - 20,000;5;17;-12;0;0;0
713090;Zombie Bloxx;Indie, RPG, Simulation;0 - 20,000;13;0;13;0;0;0
713100;"""StockUp""";Casual, Indie;0 - 20,000;10;23;-13;0;0;0
713160;After Death;Simulation, Strategy;0 - 20,000;98;6;92;0;0;0
713170;unBorn;Violent, Gore, Action, Indie;0 - 20,000;20;10;10;0;0;0
713180;Eredia: The Diary of Heroes;Violent, Action, Casual, Indie;0 - 20,000;40;7;33;0;0;0
713220;Mass O' Kyzt;Adventure, Indie, Racing;0 - 20,000;16;3;13;0;0;0
713230;VR Drivers;Action, Free to Play, Massively Multiplayer, Strategy;0 - 20,000;2;10;-8;0;0;0
713260;Beyond the Sunset 斜阳下的彼岸;Free to Play, Massively Multiplayer, Early Access;0 - 20,000;151;8;143;0;0;0
713310;Gambol;RPG;0 - 20,000;16;1;15;0;0;0
713320;Google Spotlight Stories: Sonaria;Casual, Indie, Strategy;0 - 20,000;31;8;23;4;4;0
713340;Space Ship Commander;Strategy;0 - 20,000;1;0;1;0;0;0
713380;Mr. Barrel;Action, Indie;0 - 20,000;17;16;1;0;0;0
713390;No God For Us;Casual, Indie;0 - 20,000;0;1;-1;0;0;0
713420;Crisis on the Planet of the Apes;Casual, Free to Play, RPG;0 - 20,000;26;13;13;0;0;0
713430;Secrets of Magic 2: Witches and Wizards;Action, Indie;0 - 20,000;16;2;14;0;0;1
713440;CYCOM: Cybernet Combat;Indie;0 - 20,000;12;3;9;0;0;0
713450;Dungeon Rustlers;Action, Adventure, Indie, Strategy;0 - 20,000;11;1;10;0;0;0
713460;Train Frontier Classic;Action, Simulation, Strategy;0 - 20,000;159;25;134;0;0;4
713500;Moto VR;Action;0 - 20,000;7;8;-1;0;0;0
713530;ARMORED KITTEN;Action, Adventure, Casual, Indie, Simulation;20,000 - 50,000;276;60;216;345;345;0
713540;Neptunian Donut;Casual, Indie;0 - 20,000;106;17;89;112;112;0
713540;Neptunian Donut;Casual, Indie;0 - 20,000;106;17;89;112;112;0
713550;Hikaru's Cube;Action, Adventure, Indie;0 - 20,000;1;0;1;0;0;0
713570;Go Kart Survival;Indie;0 - 20,000;16;18;-2;0;0;0
713570;Go Kart Survival;Casual, Indie;0 - 20,000;16;18;-2;0;0;0
713590;Hidden Object - Food;Casual;0 - 20,000;1;11;-10;0;0;0
713600;Airstrike One;Action, Indie;0 - 20,000;22;27;-5;1;1;0
713610;Qbike: Crypto Motorcycles;Action, Indie, Massively Multiplayer, Strategy, Early Access;0 - 20,000;6;8;-2;0;0;0
713650;Sevgilim Olur musun ?;Adventure, Indie;50,000 - 100,000;533;238;295;10;15;1
713680;Ablepsia;Action;20,000 - 50,000;96;80;16;366;366;0
713740;Train Your Minibot;Action;0 - 20,000;11;0;11;0;0;0
713760;Turf Wars;Casual, Indie, Sports;0 - 20,000;1;2;-1;0;0;0
713800;Infinite Gateway;Utilities, Early Access;0 - 20,000;16;9;7;3;3;0
713830;Pivot Puzzles;Action, Casual, Indie;20,000 - 50,000;1;0;1;0;0;0
713840;Goblin Storm;Action, Adventure;0 - 20,000;5;4;1;0;0;0
713860;My Name is Addiction;Action, Adventure, RPG;0 - 20,000;52;23;29;0;0;0
713930;The Perplexing Orb;Simulation, Strategy;0 - 20,000;2;1;1;0;0;0
713980;Mark After Dark;Adventure, Simulation, Strategy;0 - 20,000;5;0;5;0;0;0
714010;Aim Lab;Action, Adventure, Indie;2,000,000 - 5,000,000;79151;4784;74367;412;54;5275
714020;Idle Adventure;Action;100,000 - 200,000;277;146;131;17;17;6
714030;StudyX - Save Game Codes & Study Any Subject;Action, Casual, Indie, Simulation, Sports;0 - 20,000;6;0;6;0;0;0
714050;Undead;Adventure, Indie, RPG;0 - 20,000;17;18;-1;0;0;0
714060;Alien Mayhem;Action, Casual, Indie, Simulation, Strategy;0 - 20,000;4;0;4;0;0;0
714080;BLACK CLOVER: QUARTET KNIGHTS;Nudity, Adventure, Indie, Early Access;20,000 - 50,000;586;176;410;0;0;3
714100;Live2D VR Girls;Sports;50,000 - 100,000;135;12;123;24;25;0
714120;Little Misfortune;Casual, Indie;200,000 - 500,000;6407;665;5742;159;191;126
714130;WhiTaers;Action, Adventure, Casual, Indie, Simulation, Strategy, Early Access;0 - 20,000;16;7;9;0;0;0
714150;Bombastic Cars;Casual, Simulation;0 - 20,000;9;17;-8;0;0;0
714240;SWARMRIDER OMEGA;Casual;50,000 - 100,000;72;18;54;0;0;0
714250;Eternity: The Last Unicorn;Free to Play, Massively Multiplayer, Strategy;50,000 - 100,000;68;119;-51;132;132;2
714270;imos LOFT;Adventure, Casual, Indie, RPG;0 - 20,000;7;6;1;0;0;0
714280;Time Up;Action, Casual, Free to Play;0 - 20,000;85;3;82;0;0;0
714290;Endless Treasure Hunt;Casual, Free to Play;0 - 20,000;6;2;4;0;0;0
714300;Dead By Murder;Action, Indie, Racing;0 - 20,000;26;22;4;0;0;0
714360;A Shawn Story;Indie;0 - 20,000;11;25;-14;1;1;0
714370;LEFT ALIVE;Action, Indie;20,000 - 50,000;206;530;-324;56;56;0
714510;Chaos Souls;Adventure, Indie, Racing, Simulation, Early Access;0 - 20,000;12;12;0;0;0;0
714520;A Spooky Teaparty;Action, Casual, Indie;0 - 20,000;1;0;1;0;0;0
714530;GRIM - Mystery of Wasules;Adventure, Indie, Massively Multiplayer, Simulation, Early Access;0 - 20,000;1;3;-2;0;0;0
714570;Hidden Object - Tools;Utilities;0 - 20,000;3;2;1;0;0;0
714580;Google Spotlight Stories: Son of Jaguar;Indie, Massively Multiplayer, Simulation, Sports, Early Access;20,000 - 50,000;80;16;64;9;9;0
714590;BACK OF SPACE;Indie, Strategy;0 - 20,000;61;1;60;0;0;0
714610;Google Spotlight Stories: Rain or Shine;Action, Adventure, Indie;20,000 - 50,000;52;6;46;5;5;0
714620;Snakeez;Adventure, Indie;20,000 - 50,000;28;14;14;3;3;0
714640;Abstractanoid;Casual, Indie, Simulation, Strategy;0 - 20,000;30;18;12;0;0;0
714730;Luvocious;Indie, Simulation, Strategy;0 - 20,000;22;14;8;0;0;0
714780;Google Spotlight Stories: Special Delivery;Nudity, Action, Casual, Indie;0 - 20,000;37;5;32;0;0;0
714800;Maitetsu;Adventure, Indie, RPG;20,000 - 50,000;319;18;301;0;0;2
714820;Creature Romances: For the Ladies;Sexual Content, Nudity, Adventure, Indie, Simulation, Strategy;0 - 20,000;27;5;22;0;0;0
714840;Mecho Tales;Sexual Content, Nudity, Violent, Indie, Simulation, Strategy;0 - 20,000;4;2;2;0;0;0
714880;大乱斗 Chaos Battle;Indie, Simulation, Strategy;0 - 20,000;3;2;1;0;0;0
714910;n-body VR;Adventure, Casual, Indie;0 - 20,000;1;0;1;0;0;0
714970;Metonymy;Adventure, Casual, Indie;20,000 - 50,000;30;27;3;0;0;0
714980;Meanwhile: An Interactive Comic Book;Adventure, Free to Play, Indie;20,000 - 50,000;8;3;5;0;0;0
715010;Diamo XL;Action;20,000 - 50,000;440;30;410;177;236;1
715020;Elden: Path of the Forgotten;Action, Adventure, Casual, Indie, RPG, Strategy;0 - 20,000;30;30;0;0;0;0
715050;The Islander;Utilities, Early Access;100,000 - 200,000;281;115;166;118;118;0
715060;Lost in the Forest;Adventure, Casual, Indie, Simulation;20,000 - 50,000;21;44;-23;0;0;0
715090;Rescue Team 4;Action, Casual, Indie, Racing;0 - 20,000;28;4;24;0;0;1
715100;Endless Wave;Action, Simulation, Early Access;0 - 20,000;4;0;4;0;0;0
715210;The Pillage;Casual;1,000,000 - 2,000,000;48;7;41;166;72;0
715220;Ironsight;Indie;500,000 - 1,000,000;4313;1177;3136;85;81;0
715240;Claws & Feathers 3;Adventure, Indie;0 - 20,000;8;0;8;0;0;1
715270;Fire and Fury: English Civil War;Casual;0 - 20,000;13;3;10;0;0;0
715280;Ancient Battle: Hannibal;Adventure, Indie;0 - 20,000;8;4;4;0;0;0
715290;SEGFAULT;Casual, Indie, Strategy;0 - 20,000;20;14;6;21;21;1
715310;Urban Rivals;Action, Indie, Early Access;100,000 - 200,000;313;179;134;138;263;0
715320;Legend of Egypt - Pharaohs Garden;Adventure, Indie;0 - 20,000;1;0;1;0;0;2
715350;DeadlandVR : Action Shooter FPS;Casual, Indie;0 - 20,000;2;2;0;0;0;0
715370;Fidget Spinner Editor;RPG;0 - 20,000;83;10;73;15;15;1
715380;Those Who Remain;Action, Adventure, Casual, Free to Play, Massively Multiplayer, RPG;50,000 - 100,000;391;178;213;0;0;1
715400;Frozen Flame;Action, Casual, Indie;200,000 - 500,000;1573;655;918;313;378;149
715410;Signs Of Darkness;Video Production;0 - 20,000;12;43;-31;0;0;0
715430;Going Astray;Indie, Simulation;0 - 20,000;6;0;6;0;0;0
715440;Choice of the Cat;Adventure, Indie, RPG;0 - 20,000;18;2;16;0;0;0
715460;Disparity;Adventure, Indie;0 - 20,000;27;4;23;0;0;0
715470;Rocks and Rockets;Casual, Indie, Strategy;0 - 20,000;33;14;19;1;1;0
715490;Above: The Fallen;Indie;0 - 20,000;13;13;0;0;0;0
715510;Run Zeus Run;Action, Casual, Sports;20,000 - 50,000;1118;140;978;24;24;2
715520;Wall Street Junior;Casual, Indie;0 - 20,000;25;32;-7;0;0;0
715560;Eastshade;Casual, Indie;100,000 - 200,000;4049;471;3578;489;691;23
715580;Hoshizora no Memoria -Wish upon a Shooting Star-;Sexual Content, Nudity, Violent, Gore, Action, Adventure, Indie, RPG, Early Access;20,000 - 50,000;198;6;192;0;0;2
715650;The Endless Journey;Casual, Indie;0 - 20,000;202;37;165;188;188;0
715660;Follower:Sacrifice;Indie, Simulation, Sports;0 - 20,000;28;9;19;0;0;0
715670;DashPanel;Violent, Action;100,000 - 200,000;334;76;258;1970;2586;129
715690;Putrefaction 2: Rumble in the hometown;Action, Adventure, Casual, Indie, RPG, Early Access;0 - 20,000;77;26;51;0;0;0
715760;DOJAGI: The Korean Pottery;Action, Adventure, Casual, Indie, Racing, Simulation, Sports, Strategy;0 - 20,000;14;6;8;0;0;0
715800;Check Your 6!;Adventure, Casual, Indie, Simulation;0 - 20,000;15;13;2;0;0;0
715810;Project Amalthea: Battlegrounds;Adventure, Indie, RPG;100,000 - 200,000;42;24;18;0;0;0
715840;PooSky;Action;20,000 - 50,000;58;34;24;0;0;0
715980;Eared Hero;Casual, Indie;0 - 20,000;42;103;-61;1;1;0
715990;Maybot Run;Action;0 - 20,000;12;1;11;0;0;0
716000;Space Dragon;Violent, Gore, Indie, Sports;0 - 20,000;8;2;6;0;0;0
716010;Inline;Indie;0 - 20,000;56;2;54;0;0;0
716030;Oppaidius Summer Trouble!;Casual, Indie;0 - 20,000;0;0;0;0;0;0
716040;Hide and go boom;Action, Indie;0 - 20,000;27;8;19;0;0;0
716050;Strike Team Hydra;Action, Casual, Indie, Racing;0 - 20,000;27;13;14;0;0;0
716060;Purgatory Ashes | 炼狱灰烬;Indie, Strategy;0 - 20,000;0;0;0;0;0;0
716070;Mindsight;Action;0 - 20,000;51;6;45;0;0;0
716090;Cottage Garden;Action, Casual, Indie;0 - 20,000;14;7;7;0;0;0
716100;Bohnanza The Duel;Action, Adventure, Indie, Simulation, Early Access;0 - 20,000;11;7;4;0;0;0
716130;Rotatorix;Simulation;0 - 20,000;0;0;0;0;0;0
716140;PALEO museum VR;Adventure, Casual, Indie, Strategy;0 - 20,000;2;1;1;0;0;0
716150;Nakawak: Expanded Color Edition;Action, Adventure, Casual, Indie;0 - 20,000;21;5;16;0;0;1
716190;Animalia - The Quiz Game;Violent, Action, Adventure;0 - 20,000;11;3;8;0;0;0
716220;Strata Spaces VR;Action, Casual, Indie;0 - 20,000;0;1;-1;0;0;0
716230;Galactic Lords;Casual, Indie;20,000 - 50,000;27;25;2;1;1;0
716240;Pathstow Mystery VR;Action, Adventure, Casual, Indie, Early Access;0 - 20,000;4;3;1;0;0;0
716250;Eight Dragons;Casual, Indie, Simulation;0 - 20,000;22;3;19;0;0;0
716260;Guns'n'Stories: Preface VR;Action, Adventure, Indie, Strategy;100,000 - 200,000;233;45;188;17;21;3
716310;Crazy Toad;Action, Adventure, Indie, RPG, Simulation;0 - 20,000;0;3;-3;0;0;0
716330;VOID;Action, Casual, Indie, Sports;0 - 20,000;27;7;20;0;0;0
716340;Blackberry Honey;Casual, Indie;0 - 20,000;460;14;446;109;109;1
716360;SweeperVR;Adventure, Indie, RPG;0 - 20,000;7;1;6;0;0;0
716370;Flippt;Casual, Simulation, Early Access;0 - 20,000;5;1;4;0;0;0
716380;The Chemist;Violent, Action, Casual;0 - 20,000;55;46;9;0;0;1
716400;Battle of Red Cliffs VR;Action, Adventure, Casual, Indie, RPG;0 - 20,000;39;8;31;0;0;0
716480;Halloween Knight;Adventure, Casual;0 - 20,000;0;1;-1;0;0;0
716490;EXAPUNKS;Adventure, Indie, RPG;100,000 - 200,000;1412;77;1335;494;704;19
716500;Eliza;Action, Indie, Early Access;50,000 - 100,000;1281;121;1160;289;303;2
716560;Trancelation;Indie, Simulation, Strategy, Early Access;0 - 20,000;22;2;20;0;0;0
716600;Premier Buggy Racing Tour;Indie, Simulation, Strategy, Early Access;0 - 20,000;10;30;-20;1;1;0
716610;Battle for the Galaxy;Casual, Indie;50,000 - 100,000;128;141;-13;0;0;0
716630;Battlevoid: Sector Siege;Adventure, Indie, RPG, Strategy, Early Access;50,000 - 100,000;90;74;16;0;0;2
716640;Sigma Theory: Global Cold War;Violent, Gore;50,000 - 100,000;955;289;666;270;318;1
716650;Yorkshire Gubbins;Adventure, Casual;0 - 20,000;152;4;148;0;0;0
716680;Nirvana Pilot Yume;Casual, Indie;50,000 - 100,000;96;26;70;0;0;0
716710;東方憑依華　～ Antinomy of Common Flowers.;Adventure, Indie;100,000 - 200,000;1657;170;1487;372;523;5
716750;Nemesis Realms;Casual, Indie;0 - 20,000;13;8;5;0;0;0
716760;Dream Alone;Casual;0 - 20,000;32;20;12;0;0;0
716770;Exorder;Indie, Strategy, Early Access;0 - 20,000;47;16;31;113;113;0
716850;Jewel of WonderLand;Action, Adventure, Casual, Indie, RPG;0 - 20,000;1;2;-1;0;0;0
716870;Gravity Ball;Action, Adventure, Indie, Massively Multiplayer, Simulation;0 - 20,000;15;12;3;0;0;0
716900;El Ministerio del Tiempo VR: Salva el tiempo;Casual, Indie, RPG, Strategy;50,000 - 100,000;7;5;2;0;0;0
716920;The Ultimate Trivia Challenge;Action, Adventure, Indie, RPG, Simulation, Early Access;0 - 20,000;4;2;2;0;0;0
716940;Grape Jelly;Action, Casual, Indie;0 - 20,000;30;16;14;0;0;0
716950;Dino Scourge;Action, Adventure, Indie, RPG;0 - 20,000;15;6;9;0;0;0
717000;SKIMMERZ;RPG;0 - 20,000;2;0;2;0;0;0
717020;Drosoph Hotel;Indie, Racing, Simulation;0 - 20,000;12;2;10;0;0;0
717040;The Flight Of Dowran;Action, Indie;0 - 20,000;2;6;-4;0;0;0
717050;Thirdmage;Adventure, Casual, Indie;20,000 - 50,000;19;12;7;0;0;0
717060;Konrad the Rocket;Violent, Action, Adventure, Casual, Simulation, Strategy;0 - 20,000;5;0;5;0;0;0
717070;R-COIL;Casual, Strategy;0 - 20,000;32;12;20;0;0;0
717090;Game-Ready Assets;Adventure, Casual, Indie;0 - 20,000;9;5;4;3;3;0
717110;Claire de Lune;Utilities;0 - 20,000;26;16;10;0;0;1
717120;A Collection of Bad Moments;Action, Indie;0 - 20,000;15;10;5;0;0;1
717170;Mulletman and the Molemen;Simulation;0 - 20,000;2;0;2;0;0;0
717190;Super Dungeon Master Ace RPG;Adventure, Indie, RPG, Early Access;50,000 - 100,000;37;13;24;0;0;0
717200;KEEPER- the hunter of insects;Violent, Gore, Action;0 - 20,000;3;0;3;0;0;0
717240;Divide & Conquer;Action, Adventure;0 - 20,000;1;1;0;0;0;0
717280;Critters - Cute Cubs in a Cruel World;Action, Adventure, Free to Play, RPG, Simulation, Early Access;0 - 20,000;1;0;1;0;0;0
717300;Arena;Casual, Indie, Simulation;0 - 20,000;23;14;9;0;0;0
717310;Aggelos;Action, Adventure, Indie;20,000 - 50,000;304;78;226;21;21;2
717320;Tales of Inca - Lost Land;Action, Adventure, Simulation;0 - 20,000;0;1;-1;0;0;0
717330;Halloween Pumpkin Story;Gore, Action, Adventure, Indie;0 - 20,000;13;6;7;0;0;0
717380;Yerah;Casual, Indie;0 - 20,000;0;1;-1;0;0;0
717400;Power of The Void;Casual, Free to Play, Indie, Sports;0 - 20,000;4;1;3;0;0;0
717440;Hiro's Harvest Season;Adventure, Indie;0 - 20,000;0;0;0;0;0;0
717540;De Mambo;Action, Adventure, Free to Play;0 - 20,000;9;0;9;0;0;0
717560;Lucifer Within Us;Action, Adventure, Free to Play, Indie, Simulation, Strategy;50,000 - 100,000;311;81;230;0;0;3
717610;A Case of Distrust;Action, Adventure, Early Access;50,000 - 100,000;402;83;319;81;125;0
717640;Reigns: Her Majesty;Casual, Indie;100,000 - 200,000;913;162;751;143;177;4
717670;The Occupant;Action, Adventure, Indie;0 - 20,000;2;3;-1;0;0;0
717680;Tubular Rift;Action, Adventure, Indie;0 - 20,000;3;1;2;0;0;0
717710;Bloom: Labyrinth;Casual, Indie, Simulation;0 - 20,000;1;4;-3;0;0;0
717720;Cyberia 2: Resurrection;Adventure, Casual;200,000 - 500,000;9;1;8;0;0;0
717760;Catch the Thief, If you can!;Adventure, Casual;0 - 20,000;13;6;7;0;0;0
717760;Catch the Thief, If you can!;Adventure, Casual;0 - 20,000;13;6;7;0;0;0
717780;Trap Labs;Indie;0 - 20,000;31;2;29;0;0;0
717790;Hold Your Own;Indie;20,000 - 50,000;365;173;192;224;442;7
717800;三国宏图(Great Cause Of The Three Kingdoms);Utilities, Early Access;0 - 20,000;19;15;4;0;0;0
717820;Boom Island;RPG;20,000 - 50,000;17;13;4;0;0;0
717830;Waiting for the Loop;Indie, Simulation, Strategy, Early Access;0 - 20,000;13;1;12;0;0;0
717840;Viral;Indie, Strategy;0 - 20,000;7;3;4;0;0;0
717910;Bubble Rush;Action, Casual, Indie;0 - 20,000;0;2;-2;0;0;0
717940;WIL;Action, Casual, Indie;0 - 20,000;2;1;1;0;0;0
717950;Rainbow Snake;Casual, Indie, Simulation, Early Access;50,000 - 100,000;131;46;85;0;0;0
717960;SoTo;Casual, Free to Play, Indie;0 - 20,000;7;5;2;0;0;0
717980;伏雨录：少年篇;Simulation;0 - 20,000;73;8;65;0;0;0
717990;Bloodworks;Action, Casual, Free to Play, Indie, Simulation, Strategy;20,000 - 50,000;76;35;41;1;1;0
718010;Robbie Swifthand and the Orb of Mysteries;Action, Indie, Early Access;0 - 20,000;72;5;67;0;0;0
718020;GRAL;Simulation;0 - 20,000;11;2;9;0;0;0
718030;Kyklos Code;Casual, Indie, Strategy;20,000 - 50,000;17;0;17;0;0;0
718040;Super Arcade Boy in Defender of Planet Earth;Action, Casual, Indie;0 - 20,000;2;0;2;0;0;0
718070;AgeOfDarkness;Action, Indie;0 - 20,000;2;5;-3;0;0;0
718080;Artifact Quest 2 - Match 3 Puzzle;Violent, Gore, Action, Indie, Simulation;0 - 20,000;32;7;25;0;0;3
718120;Jack B. Nimble;Education, Utilities;0 - 20,000;20;1;19;0;0;0
718140;Domino Dungeon;Indie, Strategy;0 - 20,000;7;5;2;0;0;0
718180;Super Dungeon Boy;Sports;20,000 - 50,000;170;40;130;8;8;0
718200;Forever Home;Action, Adventure, Indie;0 - 20,000;153;13;140;0;0;3
718210;Depopulation;Indie, Simulation, Strategy;0 - 20,000;12;7;5;2;2;0
718220;NeoBoom2;RPG;0 - 20,000;28;32;-4;70;70;0
718240;Solar Collector;Casual, Indie, Simulation, Strategy;0 - 20,000;3;3;0;0;0;0
718250;Nova Flow;Action, Indie;0 - 20,000;30;1;29;0;0;1
718270;ZombieThon;Adventure, Indie, Simulation;0 - 20,000;14;24;-10;0;0;0
718310;Diaspora : Mass Exodus;Casual, Indie, Simulation;50,000 - 100,000;123;59;64;0;0;0
718320;FoxyLand;Action, Indie;20,000 - 50,000;106;53;53;0;0;0
718330;Cubic;Casual, Indie, Strategy;20,000 - 50,000;260;50;210;4;7;0
718350;Loot Collection: Mahjong;Adventure, Indie;20,000 - 50,000;3;3;0;0;0;0
718370;LSD;Action, Indie;20,000 - 50,000;142;127;15;0;0;0
718380;Holopoint: Chronicle;Action, Free to Play, Indie;0 - 20,000;11;16;-5;0;0;0
718410;AWS Argentina Wingshooting Simulator;Action, Adventure, Indie;0 - 20,000;9;0;9;0;0;0
718470;Rockland VR;Casual;0 - 20,000;1;0;1;0;0;0
718490;LOGistICAL: Japan;Action, Casual, Indie;0 - 20,000;4;1;3;0;0;0
718500;Derpy Dinos;Adventure, Casual, Indie, Simulation;20,000 - 50,000;50;15;35;0;0;0
718530;The Survival Test VR: Defend To Death;Violent, Action, Indie, Early Access;0 - 20,000;6;1;5;0;0;0
718540;Exorcism: Case Zero;RPG;0 - 20,000;12;12;0;0;0;0
718560;Scythe: Digital Edition;Action, Indie;200,000 - 500,000;2796;311;2485;154;163;159
718590;Dark Devotion;Indie;50,000 - 100,000;1570;483;1087;303;303;8
718650;Driftland: The Magic Revival;Indie, RPG;100,000 - 200,000;1210;423;787;204;231;35
718660;Magic matchstick;Casual, Indie;0 - 20,000;22;15;7;0;0;0
718670;Cultist Simulator;Action, Casual, Indie;500,000 - 1,000,000;7316;1973;5343;797;356;160
718680;Left&Right;Indie, Simulation;0 - 20,000;12;1;11;0;0;0
718710;Command: Shifting Sands;Adventure, Indie;0 - 20,000;7;0;7;0;0;0
718720;DEATHPIT 3000;Casual, Indie;20,000 - 50,000;27;7;20;0;0;0
718730;One Strike;Action, Adventure, Indie, Simulation;0 - 20,000;62;2;60;0;0;0
718730;One Strike;Casual, Indie, Simulation, Sports;0 - 20,000;62;2;60;0;0;0
718740;Chop Chop Princess!;Casual, Free to Play, Indie, Strategy;0 - 20,000;2;1;1;0;0;0
718750;Epic Battles of History;Violent, Casual, Indie, Strategy;0 - 20,000;6;5;1;0;0;0
718790;Warmonger;Action, Indie;50,000 - 100,000;169;125;44;53;66;0
718810;Teleporter;Action, Casual;0 - 20,000;8;4;4;0;0;0
718830;Unrested Development;Adventure, Indie, RPG;0 - 20,000;6;3;3;0;0;0
718840;DiamondFalls;Action, Adventure, Casual, Indie, RPG, Early Access;0 - 20,000;1;2;-1;0;0;0
718850;Age of Wonders: Planetfall;Action, Indie, Early Access;200,000 - 500,000;4563;1117;3446;1291;419;531
718910;Vitamin Girl / ビタミンガール;Action, Adventure, Indie;0 - 20,000;10;7;3;0;0;0
718920;Dead Noir the Heart;Adventure, Indie;0 - 20,000;3;6;-3;0;0;0
718940;Prey with Gun 带枪的猎物;Casual, Free to Play, Indie, Simulation;50,000 - 100,000;166;23;143;0;0;0
718960;The Flesh God;Strategy;0 - 20,000;12;2;10;0;0;0
718970;Gone Astray;Action, Indie, Early Access;0 - 20,000;9;5;4;0;0;0
718980;Grey Zone;Audio Production, Education, Utilities, Video Production;0 - 20,000;7;1;6;0;0;0
718990;Drone Infiltrator;Action, Early Access;0 - 20,000;0;2;-2;0;0;0
719040;Wasteland 3;Indie;200,000 - 500,000;14213;2696;11517;1388;1031;822
719070;BlowOut;Action, Indie;0 - 20,000;6;2;4;5;5;0
719080;Fart Simulator 2018;Casual, Indie;0 - 20,000;93;8;85;0;0;0
719100;Space Way;Adventure, Indie;0 - 20,000;18;13;5;0;0;0
719110;Imperil;Action, Adventure, Indie, Massively Multiplayer, Simulation;0 - 20,000;14;1;13;0;0;0
719120;O'Fox Life;Casual, Indie;20,000 - 50,000;39;89;-50;223;223;0
719130;OVO Smash!;Simulation;0 - 20,000;8;1;7;0;0;0
719140;Entanglement;Gore, Action;0 - 20,000;34;1;33;0;0;0
719180;Revulsion;Casual, Indie, Simulation, Sports, Early Access;0 - 20,000;58;16;42;0;0;0
719200;The Wall;Action, Adventure, Indie, RPG, Sports;20,000 - 50,000;259;92;167;0;0;3
719210;Supposedly Wonderful Future;Adventure, Free to Play;0 - 20,000;13;1;12;0;0;0
719220;Romans From Mars;Action, Indie, Simulation, Strategy, Early Access;0 - 20,000;2;0;2;0;0;0
719240;Romans From Mars 360;Action, Indie;0 - 20,000;1;0;1;0;0;0
719250;Cove Point Fun Center VR;Casual, Indie, Simulation, Strategy;0 - 20,000;10;6;4;0;0;0
719270;Drop;Casual, Indie;0 - 20,000;7;0;7;0;0;0
719290;Prophecy I - The Viking Child;Action, Adventure, Simulation;0 - 20,000;9;13;-4;0;0;0
719300;Daemonsgate;Adventure, Casual, Indie, Simulation;200,000 - 500,000;3;10;-7;0;0;0
719310;King's Table - The Legend of Ragnarok;Adventure, Casual, Indie, RPG;200,000 - 500,000;4;7;-3;0;0;0
719320;The Humans Collection;Indie;0 - 20,000;5;6;-1;0;0;0
719350;Orbits;Action, Casual, Indie;0 - 20,000;1;0;1;0;0;0
719370;ELE BLAZE;Adventure, Casual, Indie;0 - 20,000;1;1;0;0;0;0
719410;Magical Squash;Adventure, Indie, RPG;0 - 20,000;72;8;64;0;0;0
719430;Taima Miko Yuugi;Action, Adventure, Indie, Early Access;20,000 - 50,000;597;55;542;127;153;3
719470;Demon And Fairy;Action, Indie;0 - 20,000;8;9;-1;0;0;0
719520;Spectro;Action, Casual, Indie;0 - 20,000;53;9;44;0;0;1
719540;VR DREAM MATCH BASEBALL;Adventure, Indie;0 - 20,000;2;5;-3;0;0;0
719550;Puzzler;Action, Indie;0 - 20,000;14;4;10;0;0;0
719590;Mesozoica;Action, Adventure, Indie;20,000 - 50,000;124;438;-314;0;0;0
719600;鉄道運転士VR;Action, Adventure, Indie, Early Access;0 - 20,000;1;4;-3;0;0;0
719610;Free Bowling 3D;Animation & Modeling, Design & Illustration;20,000 - 50,000;44;45;-1;0;0;0
719630;Malkyrs;Casual, Free to Play;0 - 20,000;6;4;2;0;0;0
719640;War Planet Online: Global Conquest;Adventure, Indie;100,000 - 200,000;448;264;184;14;19;349
719660;Monster Garden;Adventure, Indie, RPG;0 - 20,000;79;2;77;0;0;0
719720;League of Pirates;Adventure, Indie;0 - 20,000;32;28;4;4;6;0
719730;Uptasia;Action, Indie;50,000 - 100,000;121;80;41;26;26;21
719740;Pi;Casual, Indie, Simulation;0 - 20,000;4;1;3;0;0;0
719750;PUSS!;Violent, Gore, Action, Adventure, Indie, RPG;50,000 - 100,000;1064;144;920;226;310;2
719800;Last Encounter;Casual, Indie, Simulation, Sports, Early Access;0 - 20,000;31;11;20;0;0;0
719830;Desert Craft;Sports;0 - 20,000;1;2;-1;0;0;0
719840;Mad Gardener: Zombie Massacre;Indie, Racing, Sports;0 - 20,000;4;0;4;0;0;0
719890;Beasts of Bermuda;Casual, Indie, Early Access;200,000 - 500,000;4566;1795;2771;5070;6034;1439
719930;Super High Ball: Pinball Platformer;Action, Casual, Simulation;50,000 - 100,000;28;1;27;0;0;0
719950;Windows Mixed Reality for SteamVR;Strategy;20,000 - 50,000;47;20;27;0;0;1
719970;Soccer Simulation;Action, Racing;0 - 20,000;2;3;-1;0;0;0
720020;Pilli Adventure;Indie;0 - 20,000;1;0;1;0;0;0
720030;Indecision.;Nudity, Adventure, Casual, Indie;0 - 20,000;474;85;389;98;194;0
720040;Valknut;Action, Indie, Early Access;0 - 20,000;5;32;-27;0;0;0
720150;Shikhondo(食魂徒) - Soul Eater;Action, Casual, Indie;20,000 - 50,000;167;33;134;0;0;1
720200;Vinewing;Adventure, Indie, Early Access;0 - 20,000;8;6;2;0;0;0
720240;Legend of Fainn Dynasty ～Battles of Beautiful Warlords～;Action, Adventure, Simulation;0 - 20,000;91;32;59;7;7;0
720250;Welcome to the Game II;Indie, Simulation, Strategy, Early Access;100,000 - 200,000;2033;327;1706;191;246;19
720280;Fox Hime;Adventure, Indie;100,000 - 200,000;3265;532;2733;139;100;2
720290;Reaching for Petals: VR Edition;Action, Adventure, Simulation, Strategy, Early Access;0 - 20,000;24;19;5;0;0;0
720310;Armed Warrior VR;Adventure, Casual, Free to Play;0 - 20,000;0;4;-4;0;0;0
720330;VRMakingSense;RPG;0 - 20,000;1;1;0;0;0;0
720350;Mundaun;Indie, RPG;20,000 - 50,000;774;40;734;1100;1174;3
720470;Caveman Alive;Action, Casual, Indie, RPG;0 - 20,000;35;62;-27;0;0;0
720480;Flappy Galaxy;Indie;0 - 20,000;10;14;-4;0;0;0
720510;Tactical AR;Education, Early Access;0 - 20,000;8;1;7;0;0;0
720560;Vigil: The Longest Night;Adventure, Indie;100,000 - 200,000;2508;348;2160;835;835;23
720600;Halloween: Jigsaw Puzzles;Indie;0 - 20,000;4;1;3;0;0;0
720620;TaleSpire;Indie, RPG, Strategy;100,000 - 200,000;3036;191;2845;220;193;230
720640;La Aventura De Axel;Action, Indie, Strategy;0 - 20,000;8;0;8;0;0;0
720660;Overloop;Adventure, Indie;0 - 20,000;88;5;83;0;0;1
720670;Cats Make You Smarter!;Casual, Indie;20,000 - 50,000;164;12;152;0;0;0
720730;Without Escape;Action, Indie;0 - 20,000;15;12;3;0;0;0
720850;Blasteron;Violent, Gore, Action, Adventure, Indie;0 - 20,000;3;1;2;0;0;0
720940;Horns of Fear;Adventure, Casual, Indie, Racing, RPG, Simulation, Strategy;20,000 - 50,000;70;5;65;0;0;0
720950;EGE DistantPlanet NonXXX;Action, Adventure, Indie, Simulation;0 - 20,000;2;0;2;0;0;0
721030;La Tale - Evolved;Casual, Indie, Strategy;100,000 - 200,000;257;191;66;73;73;15
721080;Bounce Ball;Adventure, Casual, RPG;0 - 20,000;2;3;-1;0;0;0
721090;SKYBOX VR Video Player;Action, Free to Play, Indie;50,000 - 100,000;442;139;303;163;231;17
721300;American Angst (Steam Deluxe Edition);Indie, RPG;0 - 20,000;3;1;2;0;0;0
721350;Where Are My Friends?;Action, Free to Play, Indie;0 - 20,000;25;4;21;0;0;0
721380;LOGistICAL: USA - New York;Action, Indie;0 - 20,000;9;0;9;0;0;1
721390;Pipe Push Paradise;Violent, Gore, Action, Indie, Early Access;0 - 20,000;143;5;138;0;0;3
721400;Hot Runback - VR Runner;Adventure, Casual, Indie;0 - 20,000;6;1;5;0;0;0
721420;FIGHTING BOX;Action, Casual, Indie, Simulation;0 - 20,000;7;8;-1;0;0;0
721430;My Coloring Book: Animals;Action, Casual, Indie;20,000 - 50,000;62;15;47;36;36;0
721460;Xeno Time Inception;Action, Adventure;0 - 20,000;0;0;0;0;0;0
721470;Snake Treasure Chest;Indie, RPG, Strategy, Early Access;20,000 - 50,000;3;1;2;0;0;0
721480;VR Hockey League;Casual, Indie;0 - 20,000;5;1;4;0;0;0
721510;Renters Revenge;Action, Indie;0 - 20,000;19;5;14;0;0;0
721540;Cursed Isles;Action, Adventure, Indie, RPG;0 - 20,000;1;1;0;0;0;0
721670;Frontiers.io;Adventure, Indie;20,000 - 50,000;3;2;1;0;0;0
721700;Holomento;Action, Adventure, Casual, Indie;0 - 20,000;96;32;64;0;0;2
721740;Sea Of Fatness: Save Humanity Together;Adventure, Indie;;;;0;;;
721760;Highlands, Deep Waters;Action, Adventure, Casual, Indie;0 - 20,000;24;5;19;0;0;0
721850;Wanna Run Again - Sprite Girl;Indie, Simulation, Strategy, Early Access;0 - 20,000;17;17;0;0;0;0
721890;ZhanDou (VR and Non-VR);Sexual Content, Casual, Indie;0 - 20,000;17;11;6;0;0;0
721890;ZhanDou (VR and Non-VR);Indie, Simulation;0 - 20,000;17;11;6;0;0;0
721940;Daily Run;Gore, Adventure, Indie;20,000 - 50,000;87;76;11;0;0;0
721950;Last Toon Standing;Adventure, Indie;0 - 20,000;13;10;3;0;0;0
721960;Deathmatch Soccer;Adventure, Indie;0 - 20,000;12;3;9;0;0;0
721990;Dead Spawn;Adventure, Indie, Strategy;0 - 20,000;0;2;-2;0;0;0
722010;B A S E M E N T;Action;0 - 20,000;2;5;-3;0;0;0
722040;Cargo Breach;Action;0 - 20,000;22;6;16;0;0;0
722050;Dean Daimon;RPG;0 - 20,000;12;12;0;0;0;0
722060;Dominions 5 - Warriors of the Faith;Casual, Indie;200,000 - 500,000;1811;109;1702;11190;12787;235
722070;Hyperide VR;Action, Indie, Early Access;0 - 20,000;3;3;0;0;0;0
722080;Blue Snake Adventures;Casual, Indie, Massively Multiplayer, Strategy;0 - 20,000;8;6;2;0;0;0
722180;SURV1V3;Adventure, Simulation, Strategy;100,000 - 200,000;1341;292;1049;187;236;15
722190;EEP 14;Adventure, Simulation;0 - 20,000;12;11;1;0;0;0
722210;Smart Cube;Action, Indie;0 - 20,000;26;15;11;0;0;0
722230;L.A. Noire: The VR Case Files;Adventure, Indie;50,000 - 100,000;482;388;94;54;62;2
722250;Feeding The Monster;Action, Adventure, Indie, RPG, Strategy, Early Access;50,000 - 100,000;63;29;34;0;0;0
722290;HikeJam;Adventure, Indie, Simulation;0 - 20,000;7;7;0;0;0;0
722330;The Painter's Playground;Action, Adventure, Indie, Early Access;0 - 20,000;61;2;59;0;0;0
722340;Captain vs Sky Pirates;Casual, Free to Play, Indie, Early Access;50,000 - 100,000;1;3;-2;0;0;0
722350;Light of Mine;Indie, Racing;0 - 20,000;12;2;10;0;0;0
722370;Funball Games VR;Action, Adventure, Indie, RPG;0 - 20,000;7;0;7;0;0;0
722380;Blindsight;Action, Adventure, RPG;0 - 20,000;0;0;0;0;0;0
722400;Record Store Nightmare;Adventure, Indie;0 - 20,000;1;1;0;0;0;0
722410;Fallen Kingdom;Casual, Indie;0 - 20,000;1;2;-1;0;0;0
722540;Banana Town;Action, Indie, Early Access;0 - 20,000;20;14;6;0;0;0
722560;RAD;Action, Indie, Early Access;50,000 - 100,000;633;209;424;83;117;7
722570;NaziShoot;Casual, Racing;0 - 20,000;10;33;-23;0;0;0
722580;Dreadnought Sol;Action, Casual, Indie, Early Access;0 - 20,000;2;0;2;0;0;0
722590;Audio Factory;Adventure, Casual, Indie;0 - 20,000;50;12;38;0;0;0
722590;Audio Factory;Action, Adventure, Indie;0 - 20,000;50;12;38;0;0;0
722600;The Last Monster Master;Casual, Indie;0 - 20,000;5;2;3;0;0;0
722620;Fatal Velocity: Physics Combat;Action, Indie;0 - 20,000;37;10;27;0;0;0
722660;Startup Freak;Casual, Free to Play, Indie, Simulation, Strategy;0 - 20,000;36;16;20;0;0;0
722670;Chinese Chess/ Elephant Game: 象棋/ 中国象棋/ 中國象棋;Violent, Action, Adventure, Indie;50,000 - 100,000;166;49;117;142;130;1
722680;BLOK DROP NEO;Adventure, Casual, Indie;20,000 - 50,000;45;18;27;0;0;0
722730;Cogmind;Action, Casual, Indie;50,000 - 100,000;1293;53;1240;1030;1030;9
722760;Captain Firebeard and the Bay of Crows;Education, Utilities;0 - 20,000;21;11;10;0;0;0
722760;Captain Firebeard and the Bay of Crows;Sexual Content, Nudity, Violent, Gore, Action, Casual;0 - 20,000;21;11;10;0;0;0
722810;Casual Spider Solitaire;Casual, Indie, Racing;0 - 20,000;9;6;3;0;0;0
722870;The Mind of Marlo;Action, Adventure, Indie, Early Access;0 - 20,000;183;14;169;0;0;0
722890;Last Berserker : Endless War;Action, RPG;0 - 20,000;38;5;33;0;0;0
722910;LightTrack;Casual, Indie, Simulation, Sports, Early Access;20,000 - 50,000;9;1;8;0;0;0
722920;Hex Empire 3;Action, Adventure, Indie;20,000 - 50,000;68;19;49;0;0;5
722960;CASE 2: Animatronics Survival;Violent, Action, Adventure, Indie;100,000 - 200,000;1866;390;1476;226;313;4
722990;Dungeons of Hell;Casual, Indie;0 - 20,000;30;3;27;0;0;0
722990;Dungeons of Hell;Action, Casual, Indie, Simulation;0 - 20,000;30;3;27;0;0;0
723020;3571 The Game;Action, Casual, Indie;0 - 20,000;2;5;-3;0;0;0
723050;Neon Rage;Action, Indie;0 - 20,000;1;0;1;0;0;0
723070;Scrolls of the Lord;Action, Adventure, Indie;0 - 20,000;14;5;9;0;0;0
723090;Meltys Quest;Simulation, Strategy;20,000 - 50,000;446;10;436;107;107;26
723100;Orbital Racer;Casual, Indie;0 - 20,000;32;36;-4;120;120;0
723110;Scrap Galaxy;Violent, Gore, Indie;0 - 20,000;12;4;8;0;0;0
723180;The Rift;Indie, Simulation, Sports, Strategy;0 - 20,000;1;1;0;0;0;0
723190;Sniper Hunter Adventure 3D;Sexual Content, Indie;0 - 20,000;9;9;0;0;0;0
723210;Mind Sweeper VR;Sexual Content, Nudity, Casual, Indie;20,000 - 50,000;0;1;-1;0;0;0
723270;Rumu;Casual, Indie;20,000 - 50,000;456;44;412;91;91;1
723280;VR360Viewer;Adventure, Indie;0 - 20,000;2;2;0;0;0;1
723350;Hell Shooter;Action, Indie, Early Access;0 - 20,000;81;18;63;0;0;0
723360;KEKW;Action, Adventure, Casual, Indie;0 - 20,000;0;0;0;0;0;0
723370;FARIA: Spiritbird;Strategy;0 - 20,000;0;1;-1;0;0;0
723380;Wraith;Simulation;0 - 20,000;7;3;4;0;0;0
723390;Hunt Down The Freeman;Action, Casual, Indie;100,000 - 200,000;1443;1610;-167;99;124;9
723400;Ballrun 3D Marble Maze Speedrun;Casual, Free to Play, Indie, Simulation, Sports;0 - 20,000;1;0;1;0;0;0
723420;创世-修真录;Action, Casual, Indie;20,000 - 50,000;32;10;22;0;0;0
723450;Dragon Hunt;Casual, Indie, Sports, Strategy;0 - 20,000;53;32;21;0;0;0
723510;The Cave VR;Action, Indie;0 - 20,000;3;4;-1;0;0;0
723540;魔光;Action, Adventure, Casual, Indie, RPG, Simulation, Strategy;;;;0;;;
723600;Star Swapper;Action, Adventure, Indie, Strategy;0 - 20,000;7;0;7;0;0;0
723610;Dream Golf VR;Casual;100,000 - 200,000;97;29;68;20;30;0
723720;La Maledizione dell'Uccello Serpente;Adventure, Casual;20,000 - 50,000;3;0;3;0;0;0
723760;Steamburg;Adventure, Indie;20,000 - 50,000;20;22;-2;0;0;0
723780;Modern Combat Versus;Adventure, Casual;1,000,000 - 2,000,000;4451;2371;2080;272;53;44
723790;The Pirate: Plague of the Dead;Adventure, Casual;100,000 - 200,000;408;123;285;46;69;5
723810;Don't Bleed;Adventure, Casual;0 - 20,000;10;12;-2;0;0;0
723820;BANANO BROS.;Adventure, Casual;0 - 20,000;23;2;21;0;0;0
723830;Cyborg Invasion Shooter;Adventure, Casual;0 - 20,000;23;21;2;0;0;0
723880;New World: The Tupis;Action, Indie;0 - 20,000;11;4;7;0;0;0
723890;Don't Make Love;Casual, Indie;20,000 - 50,000;350;65;285;4;8;1
723910;Dark Canvas: Blood and Stone Collector's Edition;Action, Casual, Indie, Sports;0 - 20,000;1;0;1;0;0;1
723930;Dark Romance: Vampire in Love Collector's Edition;Casual, Indie;0 - 20,000;23;3;20;0;0;1
723940;Hidden Expedition: The Fountain of Youth Collector's Edition;Casual;0 - 20,000;4;0;4;0;0;0
723950;Haunted Manor: Queen of Death Collector's Edition;Adventure, Casual, RPG, Simulation;0 - 20,000;2;0;2;0;0;0
723960;Twilight Phenomena: Strange Menagerie Collector's Edition;Casual, Free to Play;0 - 20,000;1;0;1;0;0;1
724010;House of Velez part 1;Casual, Indie, Simulation, Strategy;0 - 20,000;44;6;38;19;19;0
724030;Buffy Stole Your Sandwich;Action, Casual;0 - 20,000;2;1;1;0;0;0
724070;Keyboard Engine;Action, Adventure, Casual, Simulation;0 - 20,000;27;9;18;0;0;0
724080;The Ino Chronicles: Ascension;Action, Casual, Simulation, Strategy;0 - 20,000;8;5;3;0;0;0
724090;Restaurant Manager;Action, Adventure, Indie;0 - 20,000;7;13;-6;0;0;0
724110;PlayUSA;Action, Indie, Early Access;0 - 20,000;14;26;-12;0;0;0
724120;Rise:30 Minutes to Extinction;Casual, Indie, Simulation;0 - 20,000;8;2;6;0;0;0
724130;Radar Warfare;Adventure, Casual, Indie;20,000 - 50,000;10;5;5;0;0;0
724170;Solar Lander;Action, Casual, Indie;0 - 20,000;3;0;3;0;0;0
724180;Morgan lives in a Rocket House in VR;Action;20,000 - 50,000;41;2;39;0;0;0
724250;Princess Maker 5;Education;50,000 - 100,000;297;156;141;544;544;12
724260;Princess Maker Go!Go! Princess;Indie, Simulation, Strategy;0 - 20,000;75;44;31;0;0;1
724260;Princess Maker Go!Go! Princess;Action, Indie, Strategy, Early Access;0 - 20,000;75;44;31;0;0;1
724300;Roof Rage;Action, Adventure, Casual, Indie, RPG, Simulation, Strategy;20,000 - 50,000;530;63;467;29;31;3
724310;Kawanakajima no Kassen;Animation & Modeling, Early Access;0 - 20,000;4;2;2;0;0;0
724330;Age of Grit;Action, Racing;0 - 20,000;44;14;30;0;0;0
724340;Scavenger;Action, Adventure, Casual, Indie;0 - 20,000;5;1;4;0;0;0
724350;King of the Couch: Zoovival;Casual, Indie;0 - 20,000;211;53;158;27;31;0
724370;夕生 Halflight;Casual, Indie;0 - 20,000;86;45;41;0;0;0
724390;Rigid Force Alpha;Indie;0 - 20,000;87;22;65;0;0;2
724430;Knights Hunt;Action, Adventure, Casual, Indie, RPG, Strategy;0 - 20,000;40;61;-21;19;32;0
724450;Call of Nightmare;Action, Casual, Indie;0 - 20,000;1;7;-6;0;0;0
724460;Palm Reading Premium;Action, Indie, Racing, Early Access;0 - 20,000;2;2;0;0;0;0
724470;Lazy Galaxy;Adventure;0 - 20,000;134;32;102;12;12;1
724480;World Circuit Boxing;Adventure;0 - 20,000;1;3;-2;0;0;0
724490;Protocol;Action, Casual, Simulation;20,000 - 50,000;195;75;120;461;461;2
724510;The Quiet Sleep;Action, Casual, Simulation;0 - 20,000;18;10;8;0;0;0
724520;Magilore;Violent, Gore, Adventure, Casual, RPG;0 - 20,000;4;4;0;0;0;0
724580;Domino;Action, Indie;0 - 20,000;7;13;-6;0;0;0
724590;Sharecare YOU VR;Casual, Indie, Strategy;0 - 20,000;31;5;26;0;0;1
724600;Another Rocket Game;Action, Casual, Simulation, Sports;0 - 20,000;6;0;6;0;0;0
724630;ArchaeologyX;Action, Casual, Free to Play, Indie;0 - 20,000;7;10;-3;0;0;0
724640;AuroraBound Deluxe;Violent, Action, Indie;0 - 20,000;21;1;20;0;0;0
724680;Cosmo's Quickstop;Action;0 - 20,000;65;1;64;0;0;0
724690;RAILED;Adventure, Casual, Indie;0 - 20,000;24;6;18;0;0;0
724710;Super Knockoff! VS;Action, Casual, Indie;0 - 20,000;12;8;4;0;0;0
724740;Lines X;Action, Casual, Indie;50,000 - 100,000;655;143;512;101;106;1
724750;Robot's Mystery;Casual, Indie, Strategy;0 - 20,000;1;0;1;0;0;0
724760;Duralumin Wind;Adventure, Casual, Indie, Simulation;0 - 20,000;7;1;6;0;0;0
724870;Glorious Noon;Action;20,000 - 50,000;28;6;22;35;35;0
724900;Hallowed Encounter;Violent, Gore, Action, Adventure, Indie, RPG;0 - 20,000;4;2;2;0;0;0
724900;Hallowed Encounter;Violent, Gore, Action, Adventure, Indie, RPG;0 - 20,000;4;2;2;0;0;0
724910;Icarus Six Sixty Six;Action, Adventure, Casual, Indie, Strategy;0 - 20,000;16;2;14;0;0;0
724920;Starcats;;0 - 20,000;2;1;1;0;0;0
724940;Beach Cry of VR;Violent, Gore, Action, Indie;0 - 20,000;7;5;2;0;0;0
724950;Hope is in 23;Action, Indie;0 - 20,000;1;0;1;0;0;0
724970;神舞幻想 Faith of Danschant;Casual, Indie, Early Access;500,000 - 1,000,000;2761;1799;962;309;168;36
724980;Winter Warland;Adventure, Indie, RPG;0 - 20,000;26;7;19;0;0;0
724980;Winter Warland;Action, Adventure, Strategy;0 - 20,000;26;7;19;0;0;0
725020;SoM Soul Of Mask;Action, Adventure, Racing, Early Access;0 - 20,000;8;2;6;0;0;0
725040;Ebony Spire: Heresy;Action, Adventure, Indie, Simulation;0 - 20,000;33;14;19;0;0;0
725050;Thug Life;Adventure;0 - 20,000;1;0;1;0;0;0
725080;Fearful Symmetry & The Cursed Prince;Adventure, Free to Play, Indie;0 - 20,000;41;6;35;0;0;0
725100;Pongarena;Casual, Simulation;20,000 - 50,000;245;56;189;0;0;0
725110;Wizards Tourney;Action, Indie;0 - 20,000;26;6;20;0;0;0
725120;ADIOS Amigos: Galactic Explorers;Casual, Indie;0 - 20,000;85;7;78;0;0;10
725140;Nogard;Action, Indie, RPG;0 - 20,000;2;0;2;0;0;0
725170;Home Run Solitaire;Casual;0 - 20,000;17;3;14;0;0;1
725270;Necrobarista;Indie, Simulation, Strategy;20,000 - 50,000;980;186;794;231;279;2
725280;Psi Project;Casual, Simulation;20,000 - 50,000;58;83;-25;0;0;0
725320;Dance Studio VR;Casual, Indie;0 - 20,000;0;1;-1;0;0;0
725330;Zelle;Casual, Indie, Simulation, Strategy;0 - 20,000;308;18;290;0;0;0
725340;Lines X Free;Casual, Indie, Strategy;100,000 - 200,000;1371;110;1261;87;23;6
725370;Doctor Who Infinity;Indie, Simulation, Strategy;0 - 20,000;36;26;10;0;0;0
725380;Maddening Euphoria;Action, Adventure, Indie, Simulation, Early Access;0 - 20,000;7;0;7;0;0;0
725400;Forest Escape;Action, Adventure, RPG;20,000 - 50,000;23;32;-9;0;0;0
725410;Gaia's Melody: Echoed Melodies;Adventure, Casual, Indie, Strategy;0 - 20,000;42;2;40;0;0;0
725430;Gates of Avalon;Adventure, Indie;0 - 20,000;2;0;2;0;0;0
725480;Slap City;Indie, Massively Multiplayer;100,000 - 200,000;2647;146;2501;2581;2476;10
725510;Merper VR;Action, Adventure, Indie;20,000 - 50,000;33;4;29;0;0;0
725540;Morps;Action, Adventure, Indie;20,000 - 50,000;3;0;3;0;0;0
725550;VS Round 1;Casual, Indie, Simulation, Strategy, Early Access;0 - 20,000;6;1;5;0;0;0
725610;foreverloops LONGPLAY;Indie, RPG, Simulation, Early Access;0 - 20,000;24;7;17;0;0;0
725620;Battlegrounds2D.IO;Action, Indie, RPG;0 - 20,000;5;2;3;0;0;0
725640;DUEL;Action, Adventure, Free to Play, Indie;0 - 20,000;20;4;16;0;0;0
725660;Thundering Skies;Action, Adventure, Casual, Indie, RPG;20,000 - 50,000;16;4;12;0;0;0
725680;Golf 2D;Casual, Strategy;20,000 - 50,000;36;39;-3;0;0;0
725780;Play With Me: Escape Room;Action, Adventure, Indie, Early Access;20,000 - 50,000;232;122;110;205;205;10
725850;Kana Quest;Action, Casual, Indie, Racing, Sports;0 - 20,000;21;1;20;0;0;0
725870;Age of seas;Action, Strategy;0 - 20,000;0;0;0;0;0;0
725890;Assembly League;Casual, Simulation, Early Access;0 - 20,000;0;1;-1;0;0;0
725910;Collide;Gore, Action, Indie, Strategy;0 - 20,000;4;0;4;0;0;0
725920;If Only...;Casual, Indie;0 - 20,000;7;1;6;0;0;0
725950;Zombie Nightmare;Action, Casual, Indie;0 - 20,000;2;2;0;0;0;0
725960;Ballistic Mini Golf;Casual, Indie;0 - 20,000;46;39;7;0;0;1
725970;COMBAT INSTINCT;Action, Adventure, Free to Play, Indie, Simulation;0 - 20,000;13;4;9;0;0;0
725980;Path Out;Action, Indie;0 - 20,000;157;12;145;0;0;0
725980;Path Out;Action, Adventure, Casual, Indie, Simulation;0 - 20,000;157;12;145;0;0;0
726000;No King No Kingdom;Casual, Indie, Racing;0 - 20,000;99;18;81;0;0;2
726000;No King No Kingdom;Action, Adventure, Indie, RPG;0 - 20,000;99;18;81;0;0;2
726020;Mission Ammunition;Adventure, Indie;20,000 - 50,000;69;20;49;65;65;0
726030;MinSweeper;Action, Casual, Indie;0 - 20,000;3;4;-1;0;0;0
726060;CAR THIEF SIMULATOR 2017;Action, Casual, Indie, Simulation;0 - 20,000;1;11;-10;0;0;0
726070;Hidden Object - Sweet Home;Free to Play, Indie, Simulation;20,000 - 50,000;35;92;-57;1;1;0
726110;Overcrowd: A Commute 'Em Up;Violent, Action, Indie, Early Access;100,000 - 200,000;1225;249;976;275;180;19
726120;Beyond the Wall;Casual, Indie, Strategy;20,000 - 50,000;39;15;24;0;0;0
726160;The Under;Casual, Indie;0 - 20,000;16;10;6;0;0;0
726200;Hostil;Action, Casual, Indie;0 - 20,000;196;34;162;0;0;0
726230;The Superlatives: Aetherfall;Casual, Indie, Strategy;0 - 20,000;22;2;20;0;0;1
726250;Unknightly;Nudity, Casual, Indie;0 - 20,000;158;54;104;0;0;0
726260;Bit Bullet;Casual, Indie, Strategy;0 - 20,000;20;2;18;0;0;0
726300;Ionball 3;Action, Casual, Indie;0 - 20,000;6;0;6;0;0;0
726320;Girl Blonde;Action, Adventure, Indie;20,000 - 50,000;69;24;45;0;0;0
726330;Ocean's Crabellum;Action;0 - 20,000;3;0;3;0;0;0
726340;Alchemist's Castle;Action, Casual, Indie;0 - 20,000;54;10;44;3;3;0
726360;BOOBS SAGA: Prepare To Hentai Edition;Adventure, Indie;20,000 - 50,000;367;103;264;122;119;11
726380;Space2D;Adventure;0 - 20,000;14;4;10;0;0;0
726390;Scream Collector;Adventure, Indie;50,000 - 100,000;583;85;498;1;1;15
726430;Creeping Terror;Indie, Strategy, Early Access;0 - 20,000;22;15;7;0;0;0
726450;Hero's Descent;Indie, RPG, Strategy, Early Access;0 - 20,000;2;0;2;0;0;0
726460;Choice of Broadsides;Adventure, Free to Play, Indie, RPG, Strategy;0 - 20,000;7;4;3;0;0;0
726490;Projection: First Light;Casual, Indie, Strategy;0 - 20,000;20;3;17;0;0;0
726500;The Adventures of Sam Carlisle: The Hunt for the Lost Treasure;Casual, Indie, Strategy;0 - 20,000;2;0;2;0;0;0
726510;Heads Run;Casual, Indie, Strategy;0 - 20,000;28;4;24;0;0;0
726520;The Merchant Memoirs;Casual, Indie, Strategy;0 - 20,000;9;4;5;0;0;0
726570;Heavy Destinies;Casual, Indie, Strategy;0 - 20,000;8;10;-2;0;0;0
726580;Game Machines: Arcade Casino;Strategy, Early Access;20,000 - 50,000;16;18;-2;0;0;0
726590;NBA 2K Playgrounds 2;Adventure, Indie, RPG;20,000 - 50,000;1457;356;1101;499;615;17
726600;Drift Zone;Adventure, Indie, RPG;0 - 20,000;22;24;-2;0;0;0
726610;Podium Bash;Action, Adventure, Casual, Indie, RPG;0 - 20,000;1;2;-1;4;4;0
726620;Kitty Rescue;Violent, Action, Indie;0 - 20,000;25;9;16;0;0;0
726710;RAZED;Adventure, Indie;0 - 20,000;27;11;16;0;0;0
726720;Marble Run;Indie, Early Access;0 - 20,000;39;18;21;0;0;0
726720;Marble Run;Nudity, Simulation;0 - 20,000;39;18;21;0;0;0
726760;Boy Next Door;Action, Indie;0 - 20,000;49;34;15;0;0;0
726800;The Rare Nine;Action, Racing;0 - 20,000;41;40;1;0;0;0
726810;Void Cube Runner;Action, Racing;0 - 20,000;6;8;-2;0;0;0
726820;Inner Mazes - Souls Guides;Adventure, RPG, Simulation;0 - 20,000;2;2;0;3;3;0
726830;Vacation Simulator;Strategy;200,000 - 500,000;761;73;688;358;422;20
726840;City Game Studio: a tycoon about game dev;Casual, Indie;100,000 - 200,000;864;106;758;1767;1771;18
726870;Anchorhead;Casual, Simulation;0 - 20,000;35;4;31;6458;11352;1
726880;Posable Heroes;Casual, Indie;0 - 20,000;18;1;17;0;0;0
726910;Star Wars: Droid Repair Bay;Action, Casual, Indie, Early Access;100,000 - 200,000;386;50;336;15;17;2
726950;Dark Rose Valkyrie;Adventure, Casual, Indie;0 - 20,000;65;85;-20;0;0;1
726990;Succubus Rem;Adventure, Indie;50,000 - 100,000;847;96;751;191;312;1
727010;Wrath of Thor;Casual, Indie, Simulation;0 - 20,000;0;2;-2;0;0;0
727020;Arcade Moonlander;Adventure, Indie;20,000 - 50,000;923;73;850;2;4;3
727030;Museu do Círio de Nazaré em Realidade Virtual;Casual;0 - 20,000;6;0;6;0;0;0
727040;Alucinod;Adventure;0 - 20,000;29;5;24;0;0;0
727060;The Mystery Room;Adventure, Indie;0 - 20,000;10;5;5;0;0;0
727070;Hex;Free to Play, Indie, Massively Multiplayer, RPG, Simulation, Strategy, Early Access;0 - 20,000;31;5;26;0;0;0
727090;Village of Adventurers 2;Simulation, Early Access;20,000 - 50,000;155;56;99;69;119;0
727100;Orch Star;Action, Indie, Racing, Simulation, Early Access;0 - 20,000;26;6;20;0;0;0
727130;Between the Stars;Adventure, Casual, Indie;50,000 - 100,000;1395;428;967;347;597;7
727140;Love all you have left;Adventure, Casual, Indie, RPG;0 - 20,000;4;0;4;0;0;0
727150;One Watcher;Indie, Strategy;0 - 20,000;7;0;7;0;0;0
727170;Old School FOTD;Adventure, Casual, Indie, Strategy;0 - 20,000;25;48;-23;0;0;0
727180;大逃亡专家 Escape Expert;RPG, Strategy;0 - 20,000;44;21;23;0;0;0
727190;BLIK;Casual, Indie;0 - 20,000;16;8;8;24;24;0
727200;Santa's Workshop;Action, Free to Play, Massively Multiplayer, Racing;0 - 20,000;14;4;10;0;0;0
727220;Nightingale Downs;Casual, Indie, Simulation;0 - 20,000;13;9;4;0;0;0
727280;Scrap;Action, Adventure, Free to Play, Indie, Massively Multiplayer;50,000 - 100,000;30;32;-2;4;4;0
727290;Boot Hill Bounties;Violent, Gore, Action, Adventure, Casual, Indie, Massively Multiplayer, RPG, Strategy, Early Access;0 - 20,000;23;1;22;0;0;1
727310;Major League Gladiators;Action, Adventure, Indie, Early Access;100,000 - 200,000;24;5;19;0;0;0
727320;Operation Desert Road;Strategy;0 - 20,000;15;12;3;0;0;0
727320;Operation Desert Road;Casual, Free to Play, Simulation;0 - 20,000;15;12;3;0;0;0
727330;Last Salvo;Action, Adventure, Casual, Indie;0 - 20,000;1;1;0;0;0;0
727340;Stitched HD;Casual, Strategy;0 - 20,000;75;18;57;0;0;1
727420;Taco Tom 2;Adventure, Simulation, Early Access;0 - 20,000;15;1;14;0;0;0
727430;Starcaster;Adventure, Casual, Indie;0 - 20,000;4;2;2;0;0;0
727450;Beats Of Fury;Adventure, Casual, Free to Play, Indie;0 - 20,000;44;5;39;0;0;0
727460;Magic Tower;Action, Adventure, Casual, Indie;0 - 20,000;30;11;19;0;0;0
727480;Reach Me;Casual, Indie, Simulation, Strategy, Early Access;0 - 20,000;47;10;37;0;0;0
727490;Hell Space;RPG;0 - 20,000;1;2;-1;0;0;0
727510;Void Memory;Adventure, Casual, Indie;20,000 - 50,000;127;62;65;0;0;0
727530;Expelled;Action, Adventure, Indie, Early Access;20,000 - 50,000;49;32;17;0;0;0
727540;ReX;Action, Adventure, Indie, RPG;0 - 20,000;82;12;70;0;0;0
727550;Illville: Return instructions. Act 1;Indie, Simulation, Strategy;20,000 - 50,000;19;12;7;0;0;0
727570;After the Collapse;Casual, Indie;0 - 20,000;123;34;89;0;0;5
727610;Hot Pool;Simulation, Strategy;0 - 20,000;7;19;-12;0;0;0
727640;ШП - ShP;Casual;0 - 20,000;139;48;91;7;13;0
727720;Found Horror Game 11.exe;Adventure, Casual, Simulation;0 - 20,000;42;17;25;0;0;0
727720;Found Horror Game 11.exe;Utilities;0 - 20,000;42;17;25;0;0;0
727730;Shiver;Indie;20,000 - 50,000;285;33;252;34;34;0
727730;Shiver;Casual, Indie;20,000 - 50,000;285;33;252;34;34;0
727740;Raging Fists: Retribution;Casual, Free to Play, Early Access;0 - 20,000;2;0;2;0;0;0
727790;DEAD TARGET VR: Zombie Intensified;Animation & Modeling;0 - 20,000;8;2;6;0;0;0
727800;Voxel Tank VR;Action, Adventure, Indie;0 - 20,000;9;9;0;0;0;0
727830;Reformers;Action, Casual, Strategy;0 - 20,000;32;0;32;0;0;0
727840;Eggcellent VR;Casual, Indie, Strategy;0 - 20,000;0;1;-1;0;0;0
727850;ELDERBORN;Indie;50,000 - 100,000;1804;277;1527;164;246;7
727860;Space Quiz;Action, Sports, Strategy;0 - 20,000;2;1;1;0;0;0
727900;Maze of Gaea（Real Maze VR Simulation）;Action, Casual, Free to Play, Indie;0 - 20,000;3;1;2;0;0;0
727910;Titanic: The Experience;Adventure, Casual;0 - 20,000;158;118;40;1528;1528;1
727930;Robo Revenge Squad;Sexual Content, Nudity, Adventure, Indie;0 - 20,000;101;27;74;366;366;0
727970;Cosmic Trail;Action, Indie, Early Access;0 - 20,000;4;1;3;0;0;0
728020;Lost Home;Indie, Strategy;0 - 20,000;4;0;4;0;0;0
728050;❂ Heroes of Hexaluga ❂;Action, Massively Multiplayer, Racing;20,000 - 50,000;8;16;-8;0;0;0
728070;Shark Week: Operation Apex;Violent, Gore, Action, Indie;0 - 20,000;22;8;14;0;0;0
728090;CIBOS;Free to Play, Indie, Racing, Simulation;0 - 20,000;7;0;7;0;0;0
728110;Board Games VR;Action, Casual, Indie;0 - 20,000;8;2;6;1;1;0
728150;Virtual Race Car Engineer 2018;Casual, Free to Play, Indie, Simulation;0 - 20,000;6;9;-3;0;0;0
728220;Deadeye Dungeon;Casual, Indie;0 - 20,000;3;1;2;0;0;0
728240;Adventure Time: Pirates of the Enchiridion;Adventure, Indie;0 - 20,000;499;64;435;47;47;1
728420;Rogue Quest: The Vault of the Lost Tyrant;Adventure, Indie;0 - 20,000;35;10;25;0;0;0
728440;Next;Casual, Indie, RPG, Simulation;0 - 20,000;209;32;177;0;0;0
728530;SD GUNDAM G GENERATION CROSS RAYS;Action, Adventure, Indie;500,000 - 1,000,000;5858;965;4893;4864;6123;424
728540;Islands of Nyne: Battle Royale;Action, Indie, Massively Multiplayer, Simulation, Strategy;500,000 - 1,000,000;3471;3373;98;219;151;2
728610;Willowisp VR;Action, Adventure, Casual, Indie, Simulation;0 - 20,000;2;0;2;0;0;0
728620;RibbonChase;Action, Adventure, Indie, Early Access;0 - 20,000;1;0;1;0;0;0
728630;Cardboard Wars;Violent, Action, Indie;0 - 20,000;16;13;3;0;0;0
728670;Maze Up!;Indie;0 - 20,000;4;1;3;0;0;0
728710;Trooper 1;Animation & Modeling, Audio Production, Design & Illustration, Utilities, Video Production;0 - 20,000;1;0;1;0;0;0
728720;Roojack;Indie, Sports;0 - 20,000;1;0;1;0;0;0
728730;Holyday City: Reloaded;Casual, Indie;200,000 - 500,000;1213;272;941;4056;281;68
728740;Sniper Elite V2 Remastered;Casual, Indie, Simulation;200,000 - 500,000;1627;565;1062;142;152;45
728830;San Matias -- Mafia City;Indie;0 - 20,000;23;6;17;24;24;0
728870;Viaerium;Indie, RPG, Early Access;0 - 20,000;109;22;87;0;0;0
728880;Overcooked! 2;Action, Adventure, Indie;2,000,000 - 5,000,000;42277;4440;37837;572;287;4254
728920;Tarot Readings Premium;Indie, RPG, Strategy, Early Access;0 - 20,000;12;4;8;0;0;0
728950;Barrels Up;Adventure, Indie, Simulation, Strategy;0 - 20,000;12;5;7;0;0;0
728990;Pixel Car;Action, Casual, Indie, Simulation;20,000 - 50,000;39;39;0;0;0;0
729000;Wytchwood;Adventure, Casual, Indie;200,000 - 500,000;1767;105;1662;33;33;34
729030;サバイバルメソッド Survival Method;Action, Casual, Strategy;0 - 20,000;42;84;-42;0;0;0
729040;Borderlands Game of the Year Enhanced;Indie, RPG;1,000,000 - 2,000,000;14757;2365;12392;799;351;801
729050;Big Bang Billiards;Action, Early Access;0 - 20,000;2;1;1;0;0;0
729060;Silent Descent;Gore, Adventure;20,000 - 50,000;89;36;53;0;0;0
729090;Tropical Escape;Casual, Indie;0 - 20,000;8;21;-13;0;0;0
729130;Sound Soarer;Strategy;0 - 20,000;1;1;0;0;0;0
729180;Turtle: Voidrunner;Adventure, Casual, Indie;0 - 20,000;10;2;8;0;0;0
729190;KRAKEN;Casual, Simulation;0 - 20,000;13;6;7;0;0;0
729220;Save me Mr Tako: Tasukete Tako-San;Adventure, Casual, Indie;0 - 20,000;15;11;4;0;0;0
729270;ALVAROK;Casual, Indie, Simulation, Sports, Early Access;20,000 - 50,000;1;1;0;0;0;0
729290;Hidden Cubes;;0 - 20,000;0;0;0;0;0;0
729300;Cleansuit;Violent, Gore, Simulation, Early Access;0 - 20,000;42;0;42;0;0;0
729310;Draft Day Sports: College Basketball 2017;Action;0 - 20,000;6;6;0;0;0;0
729320;The Succubi Trap;Action, Indie;0 - 20,000;4;2;2;0;0;0
729330;The Girl on the Train;Action, Casual, Indie;0 - 20,000;46;57;-11;0;0;0
729340;AMON;Action, Indie, Massively Multiplayer, Early Access;0 - 20,000;0;1;-1;0;0;0
729370;-KLAUS-;Action, Indie;0 - 20,000;89;11;78;0;0;0
729370;-KLAUS-;Adventure, Free to Play, RPG;0 - 20,000;89;11;78;0;0;0
729390;Debris Infinity;Action, Adventure, Indie;0 - 20,000;15;0;15;0;0;0
729460;Distant Space 2;Adventure, Indie;0 - 20,000;107;28;79;1;1;0
729470;Stratego Multiplayer;Indie, Simulation, Strategy;0 - 20,000;12;11;1;0;0;0
729530;Legends of Talia: Arcadia;Racing;0 - 20,000;158;51;107;0;0;0
729570;222 Hearts;Action, Indie, Early Access;0 - 20,000;47;10;37;0;0;0
729580;Malzbie's Pinball Collection;Action, Adventure, Indie;100,000 - 200,000;114;31;83;0;0;1
729640;BOMBFEST;Action, Indie;0 - 20,000;27;0;27;0;0;0
729650;More Than Just Chess;Adventure, Casual, Indie, Simulation;0 - 20,000;1;1;0;0;0;0
729660;Blackout Z: Slaughterhouse Edition;Violent, Action;100,000 - 200,000;1389;258;1131;4;5;0
729720;Zomborg;Racing, Simulation, Sports;20,000 - 50,000;92;55;37;0;0;0
729740;JigsawMania;Casual, Indie;0 - 20,000;5;9;-4;16;16;0
729780;Timeless: The Lost Castle;Education;0 - 20,000;3;0;3;0;0;0
729820;Wheelbarrow Warrior;Casual;0 - 20,000;11;0;11;0;0;0
729820;Wheelbarrow Warrior;Simulation;0 - 20,000;11;0;11;0;0;0
729910;Sable Maze: Norwich Caves Collector's Edition;Action, Indie;0 - 20,000;0;1;-1;0;0;0
729920;Dark Dimensions: City of Ash Collector's Edition;RPG, Simulation;0 - 20,000;2;0;2;0;0;0
729930;Tales of Terror: House on the Hill Collector's Edition;Action, Casual, Indie;0 - 20,000;2;2;0;0;0;0
729940;Azada : In Libro Collector's Edition;Casual, Indie, Massively Multiplayer;0 - 20,000;6;0;6;0;0;0
729950;Witch Hunters: Full Moon Ceremony Collector's Edition;Adventure, Indie;0 - 20,000;3;0;3;0;0;0
729960;Ominous Objects: Phantom Reflection Collector's Edition;RPG;0 - 20,000;2;0;2;0;0;0
729970;Dogma;Action, Casual, Indie;0 - 20,000;5;0;5;0;0;0
729980;Happy Neighbors;Indie;0 - 20,000;15;0;15;0;0;0
729990;HEXOPODS;Free to Play, Indie, Simulation;0 - 20,000;9;6;3;0;0;0
730010;Ninja in Training;Sexual Content, Nudity, Violent, Gore, Adventure, Indie, RPG;0 - 20,000;0;1;-1;0;0;0
730030;Ultimate Spinner Simulator - Unstress Yourself;Education;0 - 20,000;24;7;17;0;0;0
730090;Travel VR;Action, Indie;20,000 - 50,000;15;24;-9;1;1;0
730120;Micro Miners;Action, Indie, Sports;0 - 20,000;10;6;4;0;0;0
730170;Rocketboarder;Action, Adventure, Indie;0 - 20,000;1;1;0;0;0;0
730180;Bits n Bullets;Casual, Indie, Simulation;0 - 20,000;10;8;2;0;0;0
730190;Sick Coaster;Animation & Modeling, Design & Illustration, Education, Early Access;0 - 20,000;2;2;0;0;0;0
730220;Trivia Vault: Video Game Trivia Deluxe;Casual, Simulation, Early Access;0 - 20,000;42;41;1;9;18;0
730240;Chicken with Chainguns;Adventure, Casual, Indie, Simulation;0 - 20,000;1;3;-2;0;0;0
730270;JunkerBot;RPG, Strategy;0 - 20,000;17;1;16;0;0;0
730280;Protect your planet;Violent, Action, Adventure, Indie, RPG, Early Access;0 - 20,000;16;19;-3;0;0;0
730290;Eat All The Things;Action, Adventure, Indie;0 - 20,000;16;6;10;0;0;0
730300;Super Star Panda;Adventure, Indie;0 - 20,000;17;3;14;0;0;0
730300;Super Star Panda;Action, Adventure, Free to Play, Indie, Early Access;0 - 20,000;17;3;14;0;0;0
730310;DYNASTY WARRIORS 9;Adventure, Early Access;1,000,000 - 2,000,000;3205;6157;-2952;835;126;123
730360;Sharecare VR 2017;Action;20,000 - 50,000;56;2;54;4;4;0
730390;Raji: An Ancient Epic;RPG;50,000 - 100,000;1550;292;1258;125;194;7
730410;Music Band Manager;Sports;0 - 20,000;190;161;29;0;0;1
730420;Combine War Toys;Adventure, Indie;0 - 20,000;2;0;2;0;0;0
730430;This Is the President;Strategy;0 - 20,000;164;62;102;1609;1609;12
730450;AXYOS: Battlecards;Strategy;20,000 - 50,000;24;6;18;0;0;0
730460;Peter World;Action, Adventure, Indie, Simulation;0 - 20,000;1;1;0;0;0;0
730550;Kanova;Indie, Simulation, Strategy, Early Access;20,000 - 50,000;46;15;31;13;13;0
730580;MegaRace 1;Casual, Indie;0 - 20,000;17;8;9;1;1;0
730620;Hammer 2;Indie;0 - 20,000;267;38;229;0;0;1
730670;EXIT 3 - Painter;Adventure, Indie, RPG, Early Access;0 - 20,000;2;0;2;0;0;0
730690;EXIT 4 - Portal;Indie;0 - 20,000;5;0;5;0;0;0
730700;The Word Is Not The Thing;Action, Adventure, Casual, Indie;0 - 20,000;4;0;4;0;0;0
730710;Space Viking Raiders;Adventure, Indie, Simulation;0 - 20,000;12;8;4;0;0;0
730760;Go! Go! Radio : 8-Bit Edition;Design & Illustration, Utilities, Early Access;0 - 20,000;5;10;-5;0;0;0
730780;Kentucky Dash;Adventure, Free to Play, RPG, Strategy;0 - 20,000;1;0;1;0;0;0
730820;The Curse of Monkey Island;Casual, Indie;100,000 - 200,000;2029;53;1976;190;246;60
730830;Escape from Monkey Island;Action, Adventure;20,000 - 50,000;285;210;75;8;15;9
730840;Burger Shop;Adventure, Casual, Indie;0 - 20,000;168;2;166;9;11;9
730860;Amoeba Battle: Microscopic RTS Action;Nudity, Violent, Gore, Action, Adventure;20,000 - 50,000;36;4;32;0;0;0
730890;Salvation in Corruption;Adventure, Casual, Indie;0 - 20,000;1;0;1;0;0;0
730920;Super Skelemania;Action, Adventure, Casual, Indie, Racing, Simulation;0 - 20,000;77;6;71;0;0;0
731120;Three Kingdoms VR - Jade Knight (光之三國VR - 青龍騎);Action, Adventure, Indie;0 - 20,000;1;2;-1;0;0;0
731180;Coffee Run;Indie, Strategy;20,000 - 50,000;85;26;59;3;3;0
731190;Loud or Quiet;Action, Adventure, Indie, RPG;0 - 20,000;2;4;-2;0;0;0
731230;Snake: Road to apple;Action, Indie, Early Access;0 - 20,000;54;41;13;366;402;0
731230;Snake: Road to apple;Adventure, Casual, Strategy;0 - 20,000;54;41;13;366;402;0
731250;ExoTanks;Casual, Indie;0 - 20,000;125;55;70;0;0;1
731300;Solos;Adventure, Casual, Indie;20,000 - 50,000;8;0;8;0;0;0
731310;Undercrewed;Action, Adventure, Indie;20,000 - 50,000;23;8;15;0;0;0
731320;Speebot;Casual, Indie;20,000 - 50,000;18;3;15;0;0;0
731410;Merv Reborn;Adventure, Indie, RPG;0 - 20,000;1;1;0;0;0;0
731420;Roguebreaker;Adventure, Casual, Indie, Simulation;0 - 20,000;30;6;24;0;0;0
731430;influence;Action, Free to Play, Indie;0 - 20,000;2;3;-1;0;0;0
731450;DROP VR - AUDIO VISUALIZER;Action;0 - 20,000;1;3;-2;0;0;0
731490;Crash Bandicoot N. Sane Trilogy;Casual, Indie;1,000,000 - 2,000,000;13279;1022;12257;882;290;390
731500;Cave Brawlers;Casual, Indie, Strategy;0 - 20,000;4;10;-6;0;0;0
731510;The Scrungeon Depths;Action, Indie;0 - 20,000;10;1;9;0;0;0
731520;Tooki;Adventure, Indie;0 - 20,000;7;0;7;0;0;0
731560;Boinks;Casual, Indie, Simulation;0 - 20,000;42;2;40;0;0;0
731590;Midnight Ultra;Action;50,000 - 100,000;55;30;25;0;0;0
731600;Heckpoint;Action, Adventure, Indie, RPG, Strategy, Early Access;0 - 20,000;15;1;14;10;10;0
731620;Hide Or Die;Violent, Gore, Action, Adventure, RPG, Simulation;50,000 - 100,000;877;668;209;202;301;0
731650;Summer Islands;Action, Adventure, Indie, RPG, Early Access;0 - 20,000;57;17;40;0;0;2
731670;ERMO;Action, Adventure, Casual, Indie, RPG;0 - 20,000;3;0;3;0;0;0
731680;遇见猎人;Action, Indie;0 - 20,000;2;2;0;0;0;0
731690;Jingo;Casual, Indie, Strategy;0 - 20,000;1;1;0;0;0;0
731700;Wild Downtown;RPG;0 - 20,000;4;10;-6;0;0;0
731720;DOOMED;Action, Casual, Indie;0 - 20,000;78;58;20;0;0;1
731760;Crawl Space: The Mansion;Indie, Strategy;0 - 20,000;2;7;-5;0;0;0
731770;Flightless Classic;Action, Casual, Indie;50,000 - 100,000;329;32;297;38;38;0
731790;Fly Destroyer;Free to Play, Simulation;20,000 - 50,000;9;12;-3;1;1;0
731820;Final Storm;Sexual Content, Casual, Indie;0 - 20,000;6;1;5;0;0;0
731860;Galactic Pocket Billiards;Adventure, Casual, Indie;0 - 20,000;1;1;0;0;0;0
731880;Remaya Idle;Violent, Gore, Action, Adventure, Indie, RPG;20,000 - 50,000;53;30;23;0;0;0
731890;Horror Hunt;Adventure, Casual, Indie;0 - 20,000;15;11;4;0;0;0
731910;JumpSky;Action, Adventure;0 - 20,000;59;53;6;0;0;0
731920;Government Simulator;Adventure, Casual, Indie;20,000 - 50,000;80;93;-13;0;0;2
731930;Talk to Aya;Action, Casual, Indie, Strategy, Early Access;20,000 - 50,000;9;3;6;0;0;0
731940;Bars and Balance;Adventure, Casual;0 - 20,000;65;10;55;0;0;0
731950;The Homestead;Adventure, Indie, Strategy;0 - 20,000;21;7;14;0;0;0
732010;BrainyJoy;Indie, Simulation;0 - 20,000;9;1;8;1;1;0
732030;Pimiko Plus;Indie;0 - 20,000;13;1;12;0;0;0
732040;Corridor 15 Firts;Adventure;0 - 20,000;5;3;2;0;0;0
732050;Voxel Tycoon;Action, Adventure, Casual, Indie;20,000 - 50,000;1171;208;963;865;865;68
732060;The Monk and the Warrior. The Heart of the King.;Casual, Indie, Simulation;0 - 20,000;18;32;-14;11;11;0
732070;Lost in the tomb;Action, Indie, Simulation, Sports;20,000 - 50,000;29;19;10;0;0;0
732090;Dragon Perception;Casual, Strategy;0 - 20,000;15;36;-21;0;0;0
732230;LuxVR;Free to Play, Indie, Animation & Modeling, Design & Illustration, Education, Software Training, Utilities, Web Publishing, Early Access;0 - 20,000;24;3;21;0;0;8
732240;SpaceBourne;Adventure, Casual, Indie;20,000 - 50,000;515;145;370;164;164;23
732290;Schatte ～The Witch and the Fake Shadow～ / 魔女と偽りの影;Action, Casual, Indie;0 - 20,000;17;6;11;0;0;1
732360;Mercury Blue: Mini Episode;Indie, Early Access;50,000 - 100,000;92;15;77;0;0;0
732370;Juicy Realm;Casual, Indie, Early Access;500,000 - 1,000,000;2975;407;2568;226;340;34
732390;Grandpa and the Zombies;Indie;0 - 20,000;3;0;3;0;0;0
732400;PlataGO! Super Platform Game Maker;Action, Adventure, Casual, Indie, Simulation;0 - 20,000;85;24;61;0;0;0
732430;Superflight;Sexual Content, Violent, Gore, Action, Adventure, Casual, Indie, RPG, Strategy;500,000 - 1,000,000;9919;368;9551;286;42;27
732470;Battleship Lonewolf;Violent, Action, Casual;0 - 20,000;16;10;6;0;0;0
732480;Jam Session VR;Adventure, Indie;0 - 20,000;5;4;1;0;0;0
732670;Dyana Moto;Indie;0 - 20,000;7;16;-9;0;0;0
732680;Gems;Action, Adventure, Free to Play, Indie;0 - 20,000;0;2;-2;0;0;0
732690;FIVE NIGHTS AT FREDDY'S: HELP WANTED;Action, Adventure;500,000 - 1,000,000;8969;308;8661;413;274;67
732730;War Trigger 2;Adventure, Casual;200,000 - 500,000;491;403;88;65;74;4
732770;Knight Terrors;RPG, Strategy;0 - 20,000;27;1;26;0;0;0
732800;Turtle Quest;Action, Adventure, Indie, RPG, Strategy;0 - 20,000;8;2;6;0;0;0
732810;Slipstream;Casual, Indie;100,000 - 200,000;1197;188;1009;36;52;2
732820;Green Blood;Sexual Content, Nudity, Violent, Adventure, Casual, Indie, Simulation;0 - 20,000;1;0;1;0;0;0
732840;Nullysun;Indie;0 - 20,000;18;17;1;0;0;0
732850;Sector Assault;Indie, Simulation, Strategy;0 - 20,000;1;0;1;0;0;0
732900;Cow Catcher;Action, Casual;0 - 20,000;0;0;0;0;0;0
732930;Wunderling DX;Casual, Indie, Simulation, Strategy;0 - 20,000;113;7;106;0;0;1
732950;Pairs;Casual, Indie;0 - 20,000;27;7;20;0;0;0
732980;Keyscaper;Action, Casual, Indie;0 - 20,000;4;0;4;0;0;0
733020;Zen Blocks - Relaxing Puzzle Board Game;Action, Casual, Indie;0 - 20,000;9;4;5;0;0;0
733020;Zen Blocks - Relaxing Puzzle Board Game;Adventure, Casual, Indie, Simulation, Sports, Strategy;0 - 20,000;9;4;5;0;0;0
733030;Famousity Card Game;Action, Casual, Indie, Simulation, Early Access;0 - 20,000;6;2;4;0;0;0
733040;Cube Defender 2000;Adventure, Casual, Indie;0 - 20,000;0;3;-3;0;0;0
733050;Lines Infinite;Casual, Indie;20,000 - 50,000;421;40;381;44;61;2
733060;The 37th Week;Nudity, Design & Illustration;0 - 20,000;1;5;-4;0;0;0
733070;Sudoku Universe / 数独宇宙;Adventure, Casual, Indie;100,000 - 200,000;2103;92;2011;102;91;62
733090;Mustache Politics Shooter;Casual, Indie, Simulation, Strategy;0 - 20,000;49;19;30;0;0;1
733110;8-Bit Adventures 2;Action, Free to Play, Indie, Early Access;0 - 20,000;72;4;68;0;0;18
733180;Destroy Space Aliens;Action;0 - 20,000;11;5;6;0;0;0
733210;Neversong;Casual, Strategy;20,000 - 50,000;701;101;600;0;0;1
733230;Cyber Arena;Action, Strategy;0 - 20,000;0;4;-4;0;0;0
733250;Mover;Action, Simulation;0 - 20,000;43;15;28;0;0;0
733300;My Big Sister;Adventure, Casual, Indie;20,000 - 50,000;472;35;437;0;0;1
733340;Hakuoki: Edo Blossoms;Casual, Simulation;0 - 20,000;699;28;671;23;23;18
733420;Fragments;Action, Indie, Simulation;20,000 - 50,000;4;1;3;0;0;0
733430;The Escape;Action, Indie;0 - 20,000;11;10;1;0;0;0
733460;First Feudal;Adventure, Indie;20,000 - 50,000;359;113;246;666;828;1
733480;Flora;Casual, Indie;50,000 - 100,000;147;54;93;8;16;0
733500;LOGistICAL: Russia;Free to Play, Indie, Strategy;0 - 20,000;10;0;10;0;0;0
733510;LOGistICAL: USA - Wisconsin;Violent, Gore, Action, Indie;0 - 20,000;9;0;9;0;0;1
733520;LOGistICAL: Switzerland;Adventure, Casual, Indie;0 - 20,000;10;1;9;0;0;0
733530;LOGistICAL: South Africa;Strategy;0 - 20,000;6;0;6;0;0;1
733540;LOGistICAL: Brazil;Action, Indie, Simulation, Strategy;0 - 20,000;11;1;10;0;0;0
733550;Clash of Magic VR;Action, Indie;0 - 20,000;1;5;-4;0;0;0
733570;Loot Run;Action, Adventure, Indie, RPG;0 - 20,000;6;4;2;0;0;0
733610;Tales of Winds: Tomb of the Sol Empire;Action;0 - 20,000;130;27;103;0;0;0
733670;Award. Room of fear;Indie, RPG;0 - 20,000;6;8;-2;0;0;0
733690;The Hospital: Allison's Diary;Action, Casual, Indie, Simulation, Sports;0 - 20,000;9;10;-1;0;0;0
733710;YOUFIGHT;Action, Casual, Indie, Strategy;0 - 20,000;3;2;1;0;0;0
733740;Sakura Cupid;Casual, Indie, Simulation;0 - 20,000;242;25;217;149;160;1
733750;Steel Eagle;RPG;0 - 20,000;1;0;1;0;0;0
733760;MegaRace 2;Adventure, Indie, RPG;0 - 20,000;18;2;16;0;0;0
733770;MegaRace 3;Nudity, Free to Play, Indie, Simulation;0 - 20,000;9;18;-9;0;0;0
733790;Not Tonight;Adventure, Indie, Simulation;100,000 - 200,000;1629;302;1327;333;358;15
733800;Frosty Nights;Indie, RPG, Simulation;20,000 - 50,000;158;44;114;0;0;1
733810;Clutter VI: Leigh's Story;Adventure, Indie;0 - 20,000;4;0;4;0;0;1
733820;Highrisers;Action;20,000 - 50,000;46;69;-23;0;0;0
733840;Anime Bubble Pop;Adventure, Casual, Indie, Strategy;0 - 20,000;9;5;4;0;0;0
733870;King of the Eggs;Action, RPG;0 - 20,000;13;5;8;0;0;0
733910;Entropic Shop VR;Adventure, Indie;0 - 20,000;4;2;2;0;0;0
733990;I Can't Believe It's Not Gambling;Action, Adventure, Casual, Indie, Racing, Simulation, Strategy, Early Access;50,000 - 100,000;1391;115;1276;129;200;4
734020;Legendary DXP;Adventure;20,000 - 50,000;48;40;8;514;514;2
734080;Qajary Cat;Adventure, Casual, Indie;0 - 20,000;4;8;-4;0;0;0
734090;Moon Bus;Casual, Free to Play, Indie, Strategy;0 - 20,000;2;0;2;0;0;0
734290;World Warfare;Indie, RPG, Strategy;50,000 - 100,000;105;64;41;23;26;0
734330;Ultimate Coaster X;Casual, Indie;50,000 - 100,000;158;21;137;0;0;0
734350;Rocket Armor;Action, Casual, Free to Play;0 - 20,000;3;1;2;0;0;0
734380;Sacrament;Indie, Strategy;0 - 20,000;11;20;-9;0;0;0
734440;Black Moon 黑月;Action, Adventure, Indie;0 - 20,000;59;8;51;0;0;0
734450;Grimante;Free to Play, Strategy;0 - 20,000;10;1;9;0;0;0
734490;Minimancer;Indie, RPG, Simulation;0 - 20,000;6;1;5;0;0;0
734510;Worshippers;Adventure, Simulation, Utilities;20,000 - 50,000;76;21;55;0;0;0
734540;The Sapper;Casual, Indie, Sports;20,000 - 50,000;16;20;-4;0;0;0
734550;Wheel Riders Online OBT;Adventure, Free to Play, Massively Multiplayer;50,000 - 100,000;68;189;-121;128;128;0
734570;Bitcoin Tycoon - Mining Simulation Game;Action, Indie;0 - 20,000;55;38;17;0;0;0
734580;BattleRush;Action, Adventure, Casual, Indie, Simulation;500,000 - 1,000,000;1973;897;1076;132;28;7
734590;Civil Warfare: Another Bullet In The War;Casual, Indie, Simulation, Early Access;20,000 - 50,000;45;82;-37;0;0;0
734700;The Lost Gardens;Action, Casual, Free to Play, Indie;0 - 20,000;25;6;19;0;0;0
734700;The Lost Gardens;Casual, Simulation, Sports, Strategy;0 - 20,000;25;6;19;0;0;0
734730;Ancient Frontier: Steel Shadows;Action, Indie;0 - 20,000;28;10;18;0;0;0
734750;PickCrafter;Action, Casual;500,000 - 1,000,000;4852;747;4105;671;197;192
734820;Protect Me;Action;20,000 - 50,000;23;10;13;0;0;0
734840;Neon Defense 1 : Pink Power;Indie;0 - 20,000;10;2;8;0;0;0
734870;Houston, We Have Spinach!;Sports;0 - 20,000;2;1;1;0;0;0
734890;The Francy Droo & Friends Collection;Adventure, Casual, Indie;0 - 20,000;4;0;4;0;0;0
734900;Chemically Bonded;Adventure, Casual, Indie;0 - 20,000;56;5;51;0;0;0
734910;Eternal Hour: Golden Hour;Action, Adventure, Indie;100,000 - 200,000;741;83;658;3;3;0
734920;MEANDERS;Indie, Simulation;20,000 - 50,000;378;27;351;172;172;0
734980;Prosperity;Action, Casual, RPG, Simulation;0 - 20,000;74;16;58;0;0;0
735010;Fantasy of Eden;Casual, Indie;0 - 20,000;6;1;5;0;0;0
735030;Oneirogen;Action, Adventure, Indie;0 - 20,000;5;1;4;0;0;0
735060;The Forbidden Arts;Action, Adventure, Casual, Indie, Simulation, Strategy;0 - 20,000;30;7;23;0;0;0
735110;Defenders of Tetsoidea;Action, Indie;0 - 20,000;2;3;-1;0;0;0
735260;meleng;Adventure, Casual;0 - 20,000;20;7;13;0;0;0
735260;meleng;Action, Indie, Racing, Sports;0 - 20,000;20;7;13;0;0;0
735280;EMERGENCY 20;Action, Indie, Massively Multiplayer, RPG;50,000 - 100,000;1171;243;928;1900;2442;196
735290;Genesis Noir;Action;100,000 - 200,000;1039;261;778;162;263;6
735320;TimeTravelers;Action;0 - 20,000;5;1;4;0;0;0
735350;Bottle: Pilgrim Redux;Action, Adventure, Casual, Indie;0 - 20,000;156;46;110;185;185;0
735360;Driver Booster 5 for Steam;Adventure, Indie;100,000 - 200,000;745;182;563;305;490;8
735410;Task is to Survive;Action, Indie;20,000 - 50,000;27;24;3;0;0;0
735450;Ninja Way;Action, Indie;50,000 - 100,000;90;42;48;0;0;0
735460;Highway Madness;Indie, Racing, Early Access;20,000 - 50,000;29;11;18;1;1;0
735470;vBuilder;Action;0 - 20,000;10;4;6;1;1;0
735490;烛梦灯  The Dreams of Candlelight;Action;0 - 20,000;11;4;7;0;0;0
735500;Creepy Road;Action, Indie;20,000 - 50,000;95;41;54;0;0;0
735520;Time Killers: CatchOut;Adventure, Indie;0 - 20,000;6;3;3;0;0;0
735530;Time Killers: Spot Race;Action, Adventure, Casual, Racing, RPG, Simulation, Sports, Strategy;0 - 20,000;13;5;8;0;0;0
735540;NO ONE;Action, Adventure, Indie;0 - 20,000;0;1;-1;0;0;0
735550;Crazy Soccer: Football Stars;Casual, Indie, Simulation, Early Access;0 - 20,000;19;6;13;0;0;0
735570;Project Rhombus;Action, Adventure, Indie, RPG, Early Access;100,000 - 200,000;1276;103;1173;90;72;0
735580;11-11 Memories Retold;Adventure, Indie;100,000 - 200,000;1339;218;1121;233;302;15
735600;BANZAI ROYALE;Adventure, Free to Play, Indie;0 - 20,000;71;8;63;0;0;0
735650;One More Night: BiO Clinic;Adventure, Casual, Indie;0 - 20,000;4;0;4;0;0;0
735660;Steamcraft;Sexual Content, Nudity, Action, Casual, Indie;0 - 20,000;117;52;65;0;0;0
735700;How To Meat People;Action, Adventure, Indie;0 - 20,000;5;1;4;0;0;0
735810;Cyber Surf;Action, Simulation, Strategy;0 - 20,000;10;5;5;1;1;0
735850;Trailer Park Boys: Greasy Money;Action, Adventure, RPG, Sports, Early Access;200,000 - 500,000;993;235;758;666;390;234
736050;Kink;Sexual Content, Nudity, Action, Casual, Indie, Simulation;0 - 20,000;1;0;1;0;0;0
736110;Deep Sorrow;Action, Indie;0 - 20,000;38;30;8;0;0;0
736110;Deep Sorrow;Animation & Modeling, Design & Illustration;0 - 20,000;38;30;8;0;0;0
736180;EX0: Dark Moon;Casual, Indie;0 - 20,000;3;0;3;0;0;0
736190;Chinese Parents;Action, Indie, Simulation, Strategy, Early Access;1,000,000 - 2,000,000;20819;1837;18982;926;565;241
736200;Nana in the Dark;Casual, Indie, RPG;0 - 20,000;31;11;20;0;0;0
736220;Post Scriptum;Adventure, Casual, Simulation, Strategy;1,000,000 - 2,000,000;14790;4623;10167;1258;588;385
736230;Salt Thrust;Adventure, Casual, Free to Play;0 - 20,000;1;0;1;0;0;0
736240;The Revolt: Awakening;Action, Indie, Simulation, Early Access;0 - 20,000;19;0;19;0;0;0
736250;Amberskull;Sexual Content, Nudity, Gore, Action, Adventure, Casual, Indie, RPG, Simulation;0 - 20,000;61;7;54;0;0;0
736260;Baba Is You;Action, Adventure, Indie, RPG, Simulation, Early Access;500,000 - 1,000,000;16813;324;16489;1001;407;194
736280;VJmachine;Adventure, Indie, Strategy, Early Access;0 - 20,000;10;9;1;0;0;0
736340;VR Mini Bowling;Violent, Gore, Action, Indie, Massively Multiplayer, Early Access;0 - 20,000;20;5;15;0;0;0
736390;Unforgiving Happiness;Casual, Free to Play, Indie;0 - 20,000;9;1;8;0;0;0
736420;Yag;Casual, Free to Play, Indie;0 - 20,000;33;2;31;0;0;1
736430;Clicker bAdventure;Strategy;0 - 20,000;24;61;-37;0;0;0
736470;The Godbeast;Casual, RPG, Simulation, Strategy;0 - 20,000;17;4;13;0;0;0
736480;Glory & Honor;Action, Free to Play, Indie, Massively Multiplayer, RPG, Early Access;0 - 20,000;1;1;0;0;0;0
736570;The Crooked Man;Adventure, Indie;20,000 - 50,000;650;53;597;174;181;3
736590;Operation: Harsh Doorstop;Indie;200,000 - 500,000;964;505;459;66;78;1244
736610;WAR Pig - Big Bang;Action, Adventure, Indie, RPG, Strategy, Early Access;0 - 20,000;0;1;-1;0;0;0
736710;Yōdanji;Casual, Indie;0 - 20,000;27;6;21;0;0;0
736720;BAAM SQUAD;Adventure, Indie;0 - 20,000;76;12;64;0;0;0
736810;The Raven Remastered;Action, Indie, RPG;20,000 - 50,000;226;50;176;102;102;2
736820;Knights of Honor II: Sovereign;Casual, Indie, Simulation;50,000 - 100,000;1935;569;1366;1363;2572;461
736840;aMAZE Double;Action;0 - 20,000;110;38;72;0;0;0
736850;We. The Revolution;Action, Adventure, Casual, Indie, Racing, Sports, Strategy;200,000 - 500,000;1350;368;982;1822;1920;9
736860;Hidden Objects - Around the World in 80 days;Action, Adventure, Casual, Indie;0 - 20,000;119;52;67;0;0;1
736920;Here & Elsewhere;Indie;0 - 20,000;9;2;7;0;0;0
736930;Delicious - Moms vs Dads;Indie, RPG;0 - 20,000;49;23;26;0;0;4
737050;Open Sorcery: Sea++;Adventure, Casual, Indie;0 - 20,000;39;3;36;2128;2128;0
737070;OlympicVR;Action, Adventure, Indie;0 - 20,000;1;3;-2;0;0;0
737230;Rising Storm 2: Vietnam CTB Beta;Adventure, Indie;0 - 20,000;0;0;0;14;14;2
737260;Coaster of Carnage VR;Casual, Indie;0 - 20,000;8;16;-8;5;5;0
737280;Moose Invasion;Action, Adventure, Casual, Indie, Strategy;0 - 20,000;11;3;8;0;0;0
737330;Pixelord;Casual, Indie, Strategy;0 - 20,000;16;11;5;0;0;0
737380;Cutthroat;Action, Casual, Indie;0 - 20,000;3;0;3;0;0;0
737390;Batch 17;Adventure, Casual, Indie;0 - 20,000;3;6;-3;0;0;0
737470;MC Lars 2: Brotherhood;Action, Indie;0 - 20,000;2;0;2;0;0;0
737490;Journey to Luonto;Indie, Simulation, Sports, Strategy;0 - 20,000;17;6;11;26;26;0
737500;Chio Hero;Action, Casual, Indie;0 - 20,000;35;10;25;0;0;0
737500;Chio Hero;Action, Free to Play, Indie;0 - 20,000;35;10;25;0;0;0
737510;Dead Forest;Casual, Simulation;0 - 20,000;6;28;-22;0;0;0
737520;Flynn: Son of Crimson;Casual, Indie, Strategy;0 - 20,000;285;52;233;123;123;2
737530;I'm Lost;Action, Indie;0 - 20,000;19;42;-23;0;0;0
737600;40 Days [四十天];Casual, Indie;0 - 20,000;6;5;1;0;0;0
737640;Pipes Racer;Action, Indie, Early Access;0 - 20,000;0;0;0;0;0;0
737660;The Deepest House;Action, Casual, Indie;0 - 20,000;2;0;2;0;0;0
737670;Lost King's Lullaby;Action, RPG, Strategy;0 - 20,000;6;2;4;0;0;0
737690;Bernackels' Shoggoth;Adventure, Casual, Free to Play, Indie;0 - 20,000;16;8;8;5;5;0
737710;Melody of Iris-虹色旋律-(Full Color ver.);Action, Indie;0 - 20,000;103;9;94;0;0;0
737730;TrES-2b;Action, Adventure, Massively Multiplayer, RPG, Strategy, Early Access;0 - 20,000;5;1;4;0;0;0
737800;F1 2018;RPG;500,000 - 1,000,000;10995;1401;9594;4031;570;217
737810;Fluffy Friends 2;Adventure, Casual, Indie, RPG;0 - 20,000;23;22;1;0;0;0
737820;High Mountain Roller Coaster VR;Adventure, Indie;0 - 20,000;4;11;-7;28;28;0
737830;Christmas Puzzle;Casual, Indie;0 - 20,000;17;0;17;0;0;0
737840;GyroCube VR;Adventure, RPG;0 - 20,000;4;2;2;0;0;0
737870;Conduct DELUXE!;Action, Indie;0 - 20,000;136;23;113;0;0;9
737880;RIFF VR;Action, Adventure, Casual, Indie;0 - 20,000;21;11;10;0;0;0
737890;Catastronauts;Action, Massively Multiplayer, Strategy;20,000 - 50,000;133;57;76;17;17;4
737930;Online Circle Pong;Action, Adventure, Indie, RPG, Early Access;0 - 20,000;9;4;5;0;0;0
737980;The Grimsworth Reports: Woodfall;Adventure, Indie, Simulation;0 - 20,000;2;0;2;0;0;0
738000;Achievement Lurker: Respectable Accomplishment;Action, Indie, Early Access;0 - 20,000;82;23;59;0;0;0
738020;ELMIA;Adventure, Casual, Simulation;0 - 20,000;68;24;44;433;433;0
738030;Monjarmageddon;Simulation, Strategy, Early Access;0 - 20,000;6;1;5;0;0;0
738060;Freddy Fazbear's Pizzeria Simulator;Action, Indie;1,000,000 - 2,000,000;21217;1361;19856;137;71;206
738080;Creatio Ex Nihilo: Aition;Action, Casual, Free to Play, Indie, Early Access;50,000 - 100,000;4;11;-7;0;0;0
738100;Becoming Homeless: A Human Experience;Adventure, Indie, RPG;0 - 20,000;19;17;2;0;0;0
738130;Get Dis Money;Action, Casual, Indie, RPG, Simulation;0 - 20,000;1;0;1;0;0;0
738190;Morth;Adventure, Casual, Indie, Massively Multiplayer, RPG, Strategy, Early Access;100,000 - 200,000;3;1;2;0;0;0
738210;Galactic Orbital Death Sport;Action, Adventure, Casual, Indie;0 - 20,000;6;0;6;0;0;0
738260;Survivor of Eschewal;Adventure, Indie, RPG, Strategy;0 - 20,000;1;5;-4;0;0;0
738270;Ciel Fledge: A Daughter Raising Simulator;Action, Casual;0 - 20,000;75;24;51;0;0;3
738290;SpaceCoaster VR;Adventure, Indie;0 - 20,000;2;1;1;0;0;0
738310;The VU;Action, Indie, Simulation;0 - 20,000;10;1;9;0;0;0
738350;Dream Pets VR;Violent, Gore, Action, Free to Play, Indie;0 - 20,000;5;22;-17;0;0;0
738440;MazeQuest 2;Action, Adventure, Casual, Indie;0 - 20,000;7;2;5;0;0;0
738450;Knights of the Drowned Table;Action, Sports;0 - 20,000;4;8;-4;0;0;0
738470;God Of Thunder;Action, Casual, Indie;0 - 20,000;74;3;71;0;0;0
738480;Find Pixel;Casual;0 - 20,000;4;0;4;0;0;0
738500;The Parallax Effect;Audio Production, Software Training, Utilities, Video Production, Web Publishing;100,000 - 200,000;113;128;-15;22;33;0
738510;メモリーズオフ-Innocent Fille-;Casual, Indie, Simulation;0 - 20,000;833;84;749;0;0;13
738520;Breathedge;Casual, Indie, Strategy;200,000 - 500,000;10760;2051;8709;632;421;76
738530;New Gundam Breaker;Adventure, Indie;;;;0;;;
738540;Tales of Vesperia: Definitive Edition;Indie, Simulation, Strategy;200,000 - 500,000;2982;626;2356;1176;712;292
738550;Spike Volleyball;Animation & Modeling, Design & Illustration;0 - 20,000;184;165;19;129;129;1
738550;Spike Volleyball;Adventure, Casual, Indie, Simulation;0 - 20,000;184;165;19;129;129;1
738560;Fariwalk: The Prelude;Action, Adventure, Casual, Indie, Racing, Simulation, Sports, Early Access;0 - 20,000;24;5;19;0;0;0
738580;Wars and Battles: Normandy;Casual, Indie, Strategy;0 - 20,000;9;1;8;0;0;0
738590;Wars and Battles: October War;Indie, Simulation, Early Access;0 - 20,000;10;2;8;0;0;0
738600;Odyssey: The Deep Space Expedition;Indie;0 - 20,000;13;10;3;0;0;0
738610;Train Station Simulator;Casual, Simulation;20,000 - 50,000;148;106;42;365;365;0
738620;The Reaction;Action, Adventure, Casual, Indie;0 - 20,000;4;0;4;0;0;0
738650;Seers Isle;Adventure, Indie;0 - 20,000;145;9;136;0;0;0
738700;Secret of the Rendrasha Blade CH1&2;Indie;0 - 20,000;6;0;6;0;0;0
738720;Bug Attack!;Action, Indie, Early Access;0 - 20,000;8;1;7;0;0;0
738730;Family Jewels;Casual, Indie, Strategy;0 - 20,000;4;1;3;0;0;0
738760;the Line;Action, Adventure, Casual, Indie;0 - 20,000;24;14;10;0;0;0
738830;Atlas Tile Editor (ATE);Adventure, Casual;0 - 20,000;2;0;2;0;0;0
738840;わがままアリスと百日戦争 -Brutal Alice and the Hundred Day's War-;Action, Adventure, Indie;50,000 - 100,000;128;18;110;1;1;1
738860;Jetstream;Action, Adventure, Indie, RPG;0 - 20,000;38;4;34;0;0;2
738880;Pain of War;Casual, Indie, Simulation;20,000 - 50,000;45;34;11;0;0;0
738900;Winter's Symphonies;Action, Adventure, Indie;0 - 20,000;2;0;2;0;0;0
738920;Sexy Serial Killer;Casual, Free to Play, Indie, Simulation, Strategy;0 - 20,000;127;91;36;4;8;0
739000;Grobda Remix;Casual, Free to Play, Indie;50,000 - 100,000;565;192;373;139;185;0
739010;The Blue Box;Indie, Massively Multiplayer, RPG;0 - 20,000;21;7;14;0;0;0
739010;The Blue Box;Indie, Racing, Sports;0 - 20,000;21;7;14;0;0;0
739030;The Fog;Indie, Early Access;0 - 20,000;4;8;-4;0;0;0
739050;Deck Casters;Adventure, Casual, Indie;0 - 20,000;105;11;94;0;0;0
739080;9 Monkeys of Shaolin;Indie, RPG;100,000 - 200,000;573;86;487;74;90;3
739100;Blink: Rogues;Action, Adventure, Casual, Indie, Simulation, Early Access;0 - 20,000;25;4;21;0;0;0
739130;The Executioner;Action, Casual, Indie;20,000 - 50,000;245;112;133;340;340;0
739170;Parker & Lane: Twisted Minds;Indie;0 - 20,000;29;8;21;0;0;0
739180;AchBall;Indie;20,000 - 50,000;32;2;30;0;0;0
739190;AntVentor;Adventure, Indie, RPG;50,000 - 100,000;311;64;247;1;1;3
739210;My Coloring Book: Transport;Adventure, Indie, RPG, Early Access;0 - 20,000;49;4;45;0;0;0
739240;The Ghosts of Hackney Mills;Free to Play, Massively Multiplayer, RPG, Strategy, Early Access;50,000 - 100,000;13;8;5;0;0;0
739260;Golden Hornet;Simulation, Strategy;20,000 - 50,000;155;11;144;18;36;0
739270;Cradle of Links;Racing, Simulation, Sports;0 - 20,000;2;1;1;0;0;0
739290;Dark Old Sun;Action, Indie, Simulation;0 - 20,000;27;0;27;0;0;0
739360;Poly Island;Action, Indie;0 - 20,000;29;14;15;0;0;0
739410;Zorbit's Orbits;Indie, Simulation, Strategy;0 - 20,000;17;11;6;1;1;0
739540;Break the Game;Indie, RPG;100,000 - 200,000;456;147;309;182;233;0
739630;Phasmophobia;Action, Adventure, Indie, RPG, Early Access;10,000,000 - 20,000,000;513219;17066;496153;1574;832;15454
739650;Drake Hollow;Nudity, Violent, Gore, Action, Adventure, Indie;100,000 - 200,000;1157;320;837;338;326;8
739660;Battle Trendaria;Action, Adventure, Indie;0 - 20,000;1;0;1;0;0;0
739690;Now Man Flies;Adventure, Indie;0 - 20,000;46;18;28;0;0;0
739690;Now Man Flies;Action, Indie;0 - 20,000;46;18;28;0;0;0
739710;Monsterplants vs Bowling - Arcade Edition;Action, Casual, Indie;0 - 20,000;2;0;2;0;0;0
739720;Penkura;Action, Indie, Racing, Sports;0 - 20,000;51;5;46;0;0;0
739730;Awe of Despair;Violent, Action, Free to Play, Massively Multiplayer;0 - 20,000;5;4;1;0;0;0
739780;LVL99: AxeRage;Action, Indie;0 - 20,000;4;2;2;0;0;0
739780;LVL99: AxeRage;Action, Adventure, Casual, Indie;0 - 20,000;4;2;2;0;0;0
739800;Verzaken! VR Adventure;Action, Adventure, Indie;0 - 20,000;7;6;1;0;0;0
739810;Odd Island;Action, Adventure, Indie, Early Access;20,000 - 50,000;37;9;28;0;0;0
739820;Wraithmind;Action, Indie, Simulation;0 - 20,000;2;1;1;0;0;0
739850;Goblins Keep Coming - Tower Defense;Action, Adventure, Indie, Strategy, Early Access;0 - 20,000;24;7;17;0;0;0
739850;Goblins Keep Coming - Tower Defense;Action, Adventure, Indie, Early Access;0 - 20,000;24;7;17;0;0;0
739880;アルカナリッター;Action, Free to Play, Indie;0 - 20,000;8;2;6;0;0;0
739890;Dogstar;Casual, Sports;0 - 20,000;7;6;1;0;0;0
739940;Guide The Ball;Casual, Indie, Simulation, Strategy;0 - 20,000;7;3;4;2;2;0
739950;Fruit Attacks VR;Action, Indie;0 - 20,000;12;0;12;0;0;0
739960;Kokoda VR;Adventure, Casual, Indie, RPG, Simulation, Early Access;20,000 - 50,000;37;6;31;1;1;0
739980;Let`s not stay friends;Indie, Simulation;20,000 - 50,000;222;54;168;214;214;0
739990;Lucky Panda;Free to Play, Massively Multiplayer;0 - 20,000;47;59;-12;0;0;0
739990;Lucky Panda;Action, Indie;0 - 20,000;47;59;-12;0;0;0
740000;绝境幸存者 Escape Zombie Land;Free to Play, Massively Multiplayer, RPG;0 - 20,000;25;3;22;0;0;0
740040;Play With Gilbert - Remake;Indie;0 - 20,000;111;12;99;0;0;1
740060;Virality;Adventure, Casual, Indie;0 - 20,000;0;3;-3;0;0;0
740070;Dead Link: Pages Torn;Casual, Indie;0 - 20,000;11;6;5;0;0;0
740080;Deadly Days;Action, Strategy;100,000 - 200,000;996;145;851;128;148;63
740130;Tales of Arise;Violent, Indie, Early Access;2,000,000 - 5,000,000;25416;2872;22544;1838;1547;990
740150;Burn, Clown, Burn!;Casual;0 - 20,000;6;7;-1;0;0;0
740170;Unexpected End;Action, Adventure, Indie, Early Access;0 - 20,000;3;1;2;0;0;0
740200;The Mercury Man;Adventure, Casual, Indie, RPG, Simulation;100,000 - 200,000;483;97;386;11;11;0
740220;PeoplePackages;Adventure, Casual, Simulation;0 - 20,000;3;2;1;0;0;0
740230;Just Ski+;Action, Adventure, Casual;0 - 20,000;139;20;119;57;64;1
740240;Snake Eyes Dungeon;Indie, Simulation;0 - 20,000;37;33;4;0;0;1
740250;Neos VR;Action, Adventure, Indie, Early Access;200,000 - 500,000;1441;285;1156;772;1472;222
740260;Crimson Imprint plus -Nonexistent Christmas-;Action;50,000 - 100,000;1849;124;1725;129;126;1
740270;MusicWave;Action, Massively Multiplayer, Simulation, Early Access;0 - 20,000;41;22;19;0;0;0
740280;Preventive Strike;Action, Free to Play, Simulation, Sports;0 - 20,000;16;12;4;0;0;0
740290;Irony Of Nightmare;Action, Indie, Sports;20,000 - 50,000;544;63;481;0;0;2
740300;Hide N Seek VR;Indie, Racing, Simulation;0 - 20,000;3;1;2;0;0;0
740320;Djilyaro;Adventure;20,000 - 50,000;7;8;-1;0;0;0
740330;Rain of Arrows;RPG;0 - 20,000;3;0;3;0;0;0
740340;NeuroMatrix;Action, Casual, Indie;0 - 20,000;7;4;3;0;0;0
740350;Stay Woke Etheral Edition;Casual, Indie, Simulation;0 - 20,000;3;1;2;0;0;0
740390;Terrorist Elimination;Adventure, Casual;0 - 20,000;4;16;-12;0;0;0
740400;Elevator... to the Moon!;Action, Indie, Early Access;0 - 20,000;23;4;19;0;0;0
740410;Puzzle Chambers;Adventure, Casual, Simulation;0 - 20,000;75;15;60;0;0;0
740450;Alien Planet;Action, Indie;0 - 20,000;2;0;2;0;0;0
740470;Echoed World;Action, Simulation;100,000 - 200,000;425;139;286;10;13;0
740500;Eseapner;Adventure, Casual, Indie, Simulation, Sports;0 - 20,000;3;2;1;0;0;0
740520;Mystery Tales: The Twilight World Collector's Edition;Adventure, Casual, Indie, Simulation, Sports;0 - 20,000;5;1;4;0;0;0
740550;Record of Agarest War Mariage;Action, Adventure, Indie, RPG, Strategy;0 - 20,000;88;49;39;289;289;0
740560;star of lemutia;Adventure, Casual, Indie, Simulation;20,000 - 50,000;0;1;-1;0;0;0
740570;illie;Racing;0 - 20,000;100;19;81;1;1;0
740600;Gachimuchi;Action, Adventure, Early Access;0 - 20,000;76;50;26;22;22;0
740720;Masked and Mysterious;Action, Casual, Indie, Simulation, Sports;0 - 20,000;2;4;-2;0;0;0
740730;Station Commander;Free to Play, Indie;0 - 20,000;1;2;-1;0;0;0
740780;OnsenVR;Adventure, Indie, RPG;0 - 20,000;18;8;10;3;3;0
740790;Goldmine;Adventure, Casual, Indie;20,000 - 50,000;108;268;-160;0;0;2
740810;Pleasure Puzzle:Workshop 趣拼拼：拼图工坊;Action, Indie, Strategy;0 - 20,000;178;19;159;0;0;2
740950;OverKill;Casual, Free to Play, Strategy, Early Access;0 - 20,000;7;1;6;0;0;0
740990;Wurst Defender Coop Edition;Casual;20,000 - 50,000;3;0;3;0;0;0
741010;BALL GAME;Casual, Indie;0 - 20,000;2;0;2;0;0;0
741080;Pterodalien;Action, Indie;0 - 20,000;0;1;-1;0;0;0
741100;Save the Halloween;Casual, Indie, Simulation;0 - 20,000;12;33;-21;0;0;0
741110;Blackshift;Casual, Indie;0 - 20,000;20;1;19;0;0;0
741120;Solar System;Action, Adventure, Casual, Indie, Simulation;20,000 - 50,000;19;30;-11;0;0;0
741140;Baldr Sky;Adventure, Casual;20,000 - 50,000;998;40;958;1396;1396;13
741150;ArtPose Pro;Action, Casual, Indie, RPG;0 - 20,000;186;45;141;6554;6554;27
741250;The Sand Man;Action, Adventure;0 - 20,000;183;10;173;72;72;3
741260;Mobile Empire;Action, Casual, Indie;200,000 - 500,000;806;659;147;199;199;4
741320;The Song of Terminus  終焉的迴響:護界者之歌;Adventure, RPG;20,000 - 50,000;36;32;4;0;0;0
741320;The Song of Terminus  終焉的迴響:護界者之歌;Action, Adventure, Indie;20,000 - 50,000;36;32;4;0;0;0
741360;VR Hybrid War 2117 - VR 混合战争 2117;Indie, Simulation;0 - 20,000;4;1;3;0;0;0
741390;最強の囲碁 ～名人への道～ / Igo Meijin;Action, Indie, Early Access;0 - 20,000;3;1;2;0;0;0
741400;Wands;Action, Casual, Indie;0 - 20,000;41;33;8;13;17;0
741450;Immortal Heroes;Adventure, Indie;20,000 - 50,000;33;71;-38;0;0;0
741490;Atlantis VR;Casual, Indie, Simulation, Strategy;0 - 20,000;21;34;-13;0;0;0
741500;John, The Zombie;;0 - 20,000;131;91;40;51;51;0
741510;The Hong Kong Massacre;Casual, Indie;50,000 - 100,000;640;188;452;34;34;4
741520;Professor Lupo and his Horrible Pets;Casual, Indie;0 - 20,000;44;1;43;0;0;0
741590;Hex Commander: Fantasy Heroes;Violent, Gore, Action;50,000 - 100,000;196;61;135;0;0;4
741620;Seal Guardian;Violent, Gore, Action, Indie;0 - 20,000;1;1;0;0;0;0
741650;Holy Towers;Action, Indie;0 - 20,000;3;5;-2;0;0;0
741670;Easy Red;Violent, Gore, Action, Adventure, Casual, Indie;50,000 - 100,000;771;184;587;41;42;0
741770;Santa's vacation;Action, Casual, Indie;0 - 20,000;12;4;8;0;0;0
741820;Prey: Typhon Hunter;Adventure;20,000 - 50,000;229;489;-260;59;22;1
741930;Hydroactive;Action, Adventure, Casual, Indie, Simulation, Early Access;0 - 20,000;3;8;-5;1;1;0
741990;Wild Animal Sports Day;Casual, Indie, Racing;0 - 20,000;256;24;232;17;17;0
742010;Lab 03 Yrinth;Action, Indie;0 - 20,000;7;16;-9;0;0;0
742030;MahJong;Casual, Indie;0 - 20,000;12;5;7;0;0;0
742120;DRAGON QUEST XI: Echoes of an Elusive Age - Digital Edition of Light;Adventure, Casual, Indie;200,000 - 500,000;7456;1223;6233;2013;1977;65
742150;Heart of the House;Casual, Indie, Strategy;0 - 20,000;54;3;51;0;0;0
742170;Dr. Frank's Build a Boyfriend;Action, Adventure, Indie;20,000 - 50,000;227;31;196;0;0;1
742220;Escape Camp Waddalooh;Action, Casual, Indie;0 - 20,000;3;0;3;0;0;0
742230;A Day For A Kitten;Action, Adventure, Casual, Indie;0 - 20,000;25;11;14;0;0;0
742250;OPUS: Rocket of Whispers;Casual, Indie, Simulation, Strategy;100,000 - 200,000;1148;96;1052;105;105;4
742300;Mega Man 11;Action, Indie, Early Access;200,000 - 500,000;3319;321;2998;247;295;12
742340;Super BoxMan Ultra;Action, Indie, Massively Multiplayer;0 - 20,000;15;5;10;0;0;0
742360;全民王者;Action;0 - 20,000;6;4;2;0;0;0
742380;Spreadstorm;Action, Indie, Simulation;0 - 20,000;20;1;19;0;0;0
742460;Marble Skies;Action, Indie;20,000 - 50,000;245;41;204;28;28;0
742470;Chronicles of cyberpunk;Adventure, Casual, Indie;0 - 20,000;26;4;22;0;0;0
742480;The Big Journey;Indie, RPG, Strategy;20,000 - 50,000;268;39;229;0;0;0
742490;Nonogram - The Greatest Painter;Action, Indie, Sports;20,000 - 50,000;235;28;207;0;0;7
742500;Nonogram - Master's Legacy;Casual, Indie, Strategy;50,000 - 100,000;283;53;230;157;305;16
742510;Psikodelya;Action, Casual, Indie;0 - 20,000;21;5;16;0;0;0
742520;Astrologaster;Adventure, Casual, Indie;20,000 - 50,000;363;17;346;380;380;1
742530;Roguemance;Indie;0 - 20,000;34;12;22;88;88;0
742540;Keep Rollin!;Action, Adventure, Indie, RPG;50,000 - 100,000;27;10;17;0;0;0
742630;Wonky Ship;Simulation, Strategy, Early Access;0 - 20,000;27;22;5;0;0;0
742700;Empire Deluxe Combined Edition;Adventure, Indie;0 - 20,000;107;12;95;0;0;41
742900;Sleeping Dawn;Action, Casual, Indie;0 - 20,000;48;24;24;0;0;0
742900;Sleeping Dawn;Violent, Gore, Action;0 - 20,000;48;24;24;0;0;0
742990;Sanguo: War Under Heaven;Adventure, RPG;0 - 20,000;7;5;2;0;0;0
743000;Progeny VR;Casual, Indie, Simulation;0 - 20,000;9;2;7;0;0;0
743030;HELI;Indie, Simulation;0 - 20,000;6;9;-3;0;0;0
743070;Paddle Master VR;Indie, Simulation;0 - 20,000;2;1;1;0;0;0
743090;Defiance 2050;Action, Adventure;200,000 - 500,000;1110;1185;-75;230;61;0
743100;dsync;Indie, Simulation, Early Access;0 - 20,000;3;1;2;0;0;0
743110;Shit Storm;Action, Adventure, Indie;0 - 20,000;34;4;30;0;0;0
743130;MewnBase;Action, Indie;50,000 - 100,000;1025;56;969;1383;1383;5
743190;Zap Zap Zombie Cats;Action, Indie, Early Access;20,000 - 50,000;37;24;13;0;0;0
743230;Baseball Mogul 2018;Action, Indie, Simulation;0 - 20,000;10;2;8;0;0;0
743330;Super Hyperactive Ninja;Action, Casual, Indie, Sports;0 - 20,000;11;3;8;0;0;0
743340;Tanks Meet Zombies;Adventure, Free to Play;0 - 20,000;4;1;3;0;0;0
743350;Slay.one;Adventure, Free to Play;0 - 20,000;77;57;20;3;4;1
743360;Haste Heist;Action, Indie, Early Access;0 - 20,000;3;1;2;0;0;0
743370;Soccer Manager 2018;Indie, Strategy;100,000 - 200,000;296;137;159;268;135;7
743380;Split - manipulate time, make clones and solve cyber puzzles from the future!;Action, Indie, Strategy;20,000 - 50,000;28;8;20;1;1;0
743390;DISTRAINT 2;Action, Adventure, Indie;100,000 - 200,000;3138;130;3008;289;429;4
743420;Temple of Spikes;Action, Indie, Massively Multiplayer, Simulation, Early Access;0 - 20,000;3;0;3;0;0;0
743450;Monster Prom;Action, Indie;500,000 - 1,000,000;11243;785;10458;334;263;249
743460;VR火灾逃生应急演练(VR fire emergency simulation system);Casual, Indie;0 - 20,000;0;0;0;0;0;0
743480;HexaMon;Casual, Strategy;0 - 20,000;4;1;3;0;0;0
743550;COSMONAUT;Action;0 - 20,000;20;3;17;0;0;0
743580;CARRUMBLE;Indie, RPG;50,000 - 100,000;85;60;25;0;0;0
743640;Achievement Clicker;Action, Casual, Indie;100,000 - 200,000;1975;433;1542;20;26;4
743660;Boot Hill Blaster;Adventure, Indie, RPG, Strategy;20,000 - 50,000;11;1;10;0;0;0
743830;SuperTrucks Offroad Racing;Casual;0 - 20,000;36;17;19;0;0;0
743850;Polyroll;Action, Indie;0 - 20,000;67;4;63;0;0;1
743860;Wild West Online;Action, Indie, RPG, Early Access;20,000 - 50,000;272;668;-396;527;527;0
743890;Mega Man X Legacy Collection;Video Production;200,000 - 500,000;2172;666;1506;934;1274;67
743900;Mega Man X Legacy Collection 2;Casual, Indie;100,000 - 200,000;1108;325;783;700;1148;40
743920;Choo-Choo! The Train Rides!;Casual, Indie, Racing, Sports;0 - 20,000;4;0;4;0;0;0
743940;Stand by you;Adventure, Casual;0 - 20,000;13;0;13;0;0;0
743960;Super Powered Battle Friends;Action, Adventure;0 - 20,000;16;9;7;0;0;0
743990;Private Detective Punch Drunk;Casual, Indie;0 - 20,000;1;1;0;0;0;0
744010;Mount Hill;Action, Adventure, Indie;0 - 20,000;6;9;-3;3;3;0
744040;Street Heat;Sexual Content, Nudity, Action, Casual, Indie, Simulation;0 - 20,000;27;13;14;0;0;0
744050;Space Invaders Extreme;Action, Adventure, Casual, Indie;0 - 20,000;175;15;160;0;0;0
744060;Groove Coaster;Casual, Indie;100,000 - 200,000;1014;443;571;894;1532;3
744070;Kunoichi Rush;Casual, Indie, Simulation;0 - 20,000;0;1;-1;0;0;0
744170;Starfighter Neon;Education, Software Training;20,000 - 50,000;3;0;3;0;0;0
744190;Rusty Lake Paradise;Education, Software Training;200,000 - 500,000;3508;189;3319;241;236;61
744220;AI Dummy;Indie, Strategy;0 - 20,000;24;38;-14;0;0;0
744240;FISK;Indie;0 - 20,000;9;0;9;0;0;0
744260;Legend of Homebody;Action, Indie;50,000 - 100,000;336;73;263;0;0;3
744270;Rise of Ages;Action, Early Access;20,000 - 50,000;90;98;-8;0;0;1
744280;AF-ZERO;Action, Adventure, Indie;0 - 20,000;0;2;-2;0;0;0
744390;Yago, the Coquerrestrial;Action, Adventure, Indie;0 - 20,000;1;4;-3;0;0;0
744400;TRATEL64;Indie;0 - 20,000;99;33;66;0;0;0
744420;Adventures Of Pipi;Adventure, Indie;0 - 20,000;170;58;112;0;0;0
744430;Deep GachiGASM;Casual;0 - 20,000;97;31;66;2;2;1
744450;Water Density;Action, Casual, Indie;0 - 20,000;0;1;-1;0;0;0
744460;BE THE HERO;Action;0 - 20,000;9;8;1;0;0;0
744520;NEKO-NIN exHeart +PLUS Nachi;Action, Casual, Free to Play, Indie;20,000 - 50,000;237;15;222;31;31;1
744550;Tactical Operations;Violent, Action;0 - 20,000;8;11;-3;1;1;0
744570;Substance Painter 2018;Action, Casual;0 - 20,000;174;30;144;0;0;7
744590;Starship Clicker;Casual, Indie;0 - 20,000;13;9;4;0;0;0
744600;Balloonatics;Sexual Content, Nudity, Adventure;0 - 20,000;20;1;19;0;0;0
744610;TAD: That Alien Dude;Casual, Indie;100,000 - 200,000;1;4;-3;0;0;0
744630;Mystery Stone from Heaven;Action, Casual;0 - 20,000;2;1;1;0;0;0
744650;Order Of The Gatekeepers;Strategy;0 - 20,000;37;2;35;0;0;0
744660;Dream Channel;Action, Casual, Indie;0 - 20,000;7;3;4;0;0;0
744670;WORLDS AT WAR (Monitors & VR);Action, Casual, Indie;0 - 20,000;103;58;45;0;0;0
744710;Kungfu Beggar;Adventure, Indie, RPG;0 - 20,000;17;25;-8;0;0;0
744720;The Silence Outside;Action, RPG;0 - 20,000;1;5;-4;0;0;0
744750;Devil and the Fairy;Action, Adventure, Free to Play, Indie, RPG;0 - 20,000;27;11;16;0;0;0
744760;Epic Royal;Action, Adventure, Indie;0 - 20,000;4;6;-2;0;0;0
744800;Banyu Lintar Angin - Little Storm -;Action, Indie, Simulation;20,000 - 50,000;679;25;654;1;1;0
744810;A Raven Monologue;Adventure, Casual, Indie;100,000 - 200,000;2248;127;2121;10;14;1
744880;Monkeys Ahoy;Action, Casual, Racing;20,000 - 50,000;2;2;0;0;0;0
744890;TEEN DATE SIMULATOR;Action, Adventure, Casual, Indie;0 - 20,000;0;1;-1;0;0;0
744900;Dead Frontier 2;Indie, Simulation, Sports;2,000,000 - 5,000,000;15316;6140;9176;240;33;1513
744940;Blue Whale;Action, Adventure, Indie, Simulation;0 - 20,000;26;22;4;0;0;0
744940;Blue Whale;Action, Adventure, Indie, Simulation;0 - 20,000;26;22;4;0;0;0
744980;Super Club Soccer;Action, Simulation;20,000 - 50,000;69;29;40;0;0;2
745000;Card Crawl;Action, Indie, Strategy;20,000 - 50,000;125;41;84;0;0;2
745030;Squarism;Action, Casual, Indie, Strategy;0 - 20,000;57;5;52;0;0;0
745060;Hunter of Antiques;Action, Casual, Indie;0 - 20,000;5;7;-2;0;0;0
745090;ROMBIE;Violent, Gore, Action, Adventure, Indie;0 - 20,000;25;5;20;0;0;0
745120;Pinball;Violent, Gore, Indie, Early Access;0 - 20,000;4;4;0;0;0;0
745130;Rage Room;Casual, Simulation;0 - 20,000;14;13;1;0;0;0
745180;Bike of the Wild;Action, Casual, Indie;0 - 20,000;10;14;-4;0;0;0
745250;YAPP: Yet Another Puzzle Platformer;Adventure, Indie;50,000 - 100,000;44;4;40;0;0;1
745280;まぜっこタワー;Adventure, Casual, RPG, Simulation;0 - 20,000;0;2;-2;0;0;0
745340;Super Meat Shooter;Casual;20,000 - 50,000;32;56;-24;2;2;0
745370;Purple Heart;Casual, Simulation;20,000 - 50,000;59;59;0;0;0;0
745380;Znkl - 177;Adventure, Indie, RPG;0 - 20,000;42;33;9;0;0;0
745380;Znkl - 177;Action, Indie, RPG;0 - 20,000;42;33;9;0;0;0
745400;Kebab it Up!;Action, Casual, Indie, Simulation, Sports;0 - 20,000;30;5;25;0;0;0
745420;Tronix Defender;Action, Indie, Racing;0 - 20,000;3;2;1;0;0;0
745430;Neon Aileron;Action, Casual, Indie;0 - 20,000;14;0;14;0;0;0
745450;The Finnish Virtual Art Gallery;Adventure, Indie;0 - 20,000;4;0;4;0;0;0
745500;Pixel Space Battles;Action, Adventure, Casual, Indie;20,000 - 50,000;24;45;-21;0;0;0
745510;Fidget Spinner In Space;Action, Casual, Indie, Racing, Sports;0 - 20,000;68;22;46;0;0;0
745520;RoboVDino;Action, Indie;0 - 20,000;6;1;5;0;0;0
745530;Draft Day Sports: Pro Basketball 2018;Adventure, Indie, RPG, Strategy;0 - 20,000;8;8;0;0;0;0
745550;The Valley In My Mind;Adventure, Casual;0 - 20,000;4;3;1;0;0;0
745560;Overclocked;Adventure, Casual, Indie;50,000 - 100,000;295;23;272;0;0;0
745620;Soul Survival VR;Action, Casual, Simulation, Sports, Strategy;0 - 20,000;1;3;-2;0;0;0
745630;The redemption of pancakes;Action;0 - 20,000;2;1;1;0;0;0
745650;Cross Pixels;Action, Casual, Indie;0 - 20,000;9;3;6;0;0;0
745660;Sockman;Action, Casual, Indie, Racing;0 - 20,000;28;0;28;0;0;0
745670;3D Tower;Violent, Action, Indie;20,000 - 50,000;37;97;-60;16;16;0
745680;Lovehammer 400 000: The Buttlerian Crusade;Adventure, Casual;0 - 20,000;2;2;0;0;0;0
745710;SMACKHEAD;Adventure, Casual;0 - 20,000;32;54;-22;0;0;0
745720;Crazy Appliances 疯狂电器;Action, Casual, Indie;0 - 20,000;15;0;15;0;0;0
745730;Sunshine Manor;Indie, Simulation;0 - 20,000;36;3;33;0;0;0
745740;Reflex;Violent, Gore, Action, Indie;100,000 - 200,000;610;106;504;125;121;5
745750;Viking Village;Adventure, Indie, RPG;20,000 - 50,000;2;2;0;0;0;0
745760;Perceptions of the Dead;Adventure, Indie, RPG;50,000 - 100,000;293;25;268;5;5;1
745790;Chambara;Adventure, Indie, RPG;0 - 20,000;22;2;20;0;0;0
745810;SAS;Adventure, Indie, RPG;20,000 - 50,000;91;35;56;0;0;0
745820;贤者挽歌之马略卡协奏曲;Casual, Indie;0 - 20,000;6;0;6;0;0;0
745830;Dragon Sinker;Action, Casual, Indie, Early Access;0 - 20,000;30;11;19;0;0;0
745840;Cut 2017;Casual, Free to Play, Early Access;0 - 20,000;17;2;15;0;0;0
745850;KARAKARA2;Free to Play;20,000 - 50,000;567;34;533;148;165;2
745870;Prehistorik;Action, Indie;0 - 20,000;20;3;17;0;0;0
745880;Touhou Tenkuushou ~ Hidden Star in Four Seasons.;Casual, Strategy;100,000 - 200,000;4392;64;4328;829;829;4
745890;This Is Not A Jumping Game;Action, Adventure, Indie, Strategy;0 - 20,000;117;5;112;0;0;0
745900;Tank of War-VR;Violent, Gore, Action, Adventure, Casual, Indie;0 - 20,000;6;5;1;0;0;0
745920;Temtem;Casual, Indie;500,000 - 1,000,000;30667;5608;25059;3187;1327;613
745930;Ancient Treasure 法爾斯編年史：上古秘寶;Adventure, Indie;0 - 20,000;14;8;6;0;0;0
745940;Quanect;Adventure, Indie, RPG, Strategy;0 - 20,000;41;14;27;0;0;0
745950;Apparition;Casual, Indie, Simulation;0 - 20,000;66;15;51;2;2;0
745960;A Sky Full of Stars 仰望夜空的星辰;Sexual Content, Nudity, Casual, Indie, RPG;20,000 - 50,000;709;27;682;0;0;7
745970;Terminal Conflict;Action;0 - 20,000;44;19;25;209;209;0
746000;Haxor;Action;0 - 20,000;15;6;9;0;0;0
746010;Rig or Skill: PC Brawl;Action, Indie;0 - 20,000;15;10;5;0;0;0
746020;Pit of Evil;Adventure;0 - 20,000;5;8;-3;0;0;0
746030;Wreckin' Ball Adventure;Action, Indie, RPG, Early Access;0 - 20,000;11;2;9;0;0;0
746040;INMATE: Survival;Casual, Indie, Strategy;0 - 20,000;42;22;20;0;0;0
746110;Technosphere - Collector's Edition;Action, Adventure;0 - 20,000;11;3;8;0;0;0
746140;The Walking Zombie: Dead City;Violent, Gore, Action, Casual, Free to Play, Indie, Strategy, Early Access;20,000 - 50,000;310;95;215;17;22;1
746220;Monarch of Greed - Act 1;Casual, Simulation;0 - 20,000;17;0;17;0;0;0
746240;Flip the Table;Action, Adventure;0 - 20,000;6;5;1;0;0;0
746260;Square Massacre;Action, Adventure, Casual, Indie;0 - 20,000;1;0;1;0;0;0
746270;Tale of Alamar;Indie, Simulation;20,000 - 50,000;3;0;3;0;0;0
746280;Alpha Locus VR;Action, Indie, Simulation;0 - 20,000;26;4;22;0;0;0
746300;Rasty Pelican;Violent, Action, Indie, Simulation;0 - 20,000;1;3;-2;0;0;0
746340;HeadSquare - Multiplayer VR Ball Game;Adventure, Indie;0 - 20,000;1;1;0;0;0;0
746350;Air Combat Arena;Indie, Simulation, Strategy;20,000 - 50,000;31;28;3;0;0;0
746360;Orblitz;Action, Adventure, Indie, RPG;0 - 20,000;8;2;6;1;1;0
746390;PlayClaw :: Overlays, Game Recording & Streaming;Adventure, Indie, RPG;0 - 20,000;64;31;33;0;0;3
746400;Speed Dating for Ghosts;Violent, Gore, Action, Adventure, Indie, Simulation;0 - 20,000;388;17;371;208;208;20
746410;Stop Santa - Tower Defense;Action, Indie;0 - 20,000;33;13;20;0;0;0
746420;Broken Minds;Education, Utilities;0 - 20,000;17;2;15;0;0;0
746430;Slumlord Simulator;Casual, Indie, Simulation, Early Access;0 - 20,000;5;6;-1;0;0;0
746470;Substance Designer 2018;Adventure, Casual, Indie, Simulation;0 - 20,000;37;4;33;0;0;1
746500;Totally Realistic Sledding VR;Action, Casual, Indie, Strategy;0 - 20,000;8;2;6;0;0;0
746510;Duck Season PC;Casual, Indie, Strategy;50,000 - 100,000;698;59;639;105;202;5
746540;Space Panic Defense;Casual, Indie;0 - 20,000;12;11;1;0;0;0
746560;Gadgeteer;Casual, Indie, Simulation;0 - 20,000;109;3;106;17;17;0
746570;Box Looter 2018;Action, Adventure, Casual, Free to Play, Indie, RPG;0 - 20,000;21;9;12;0;0;0
746580;HARDCORE MECHA;Action, Indie, Strategy;200,000 - 500,000;2020;412;1608;341;341;6
746620;Bakery;Action, Casual, Indie;0 - 20,000;93;21;72;0;0;1
746660;Throw Anything;RPG;0 - 20,000;24;4;20;0;0;0
746680;Bounce Rescue!;Action, Indie;0 - 20,000;6;4;2;0;0;0
746710;Cypher;Casual, Indie;20,000 - 50,000;569;50;519;23;29;4
746750;The Unholy Society;Indie, RPG;0 - 20,000;18;8;10;0;0;0
746750;The Unholy Society;Action, Free to Play, Massively Multiplayer, RPG, Strategy;0 - 20,000;18;8;10;0;0;0
746760;Outside;Violent, Action, Indie, Early Access;0 - 20,000;12;29;-17;0;0;0
746770;Bunny Mania 2;Adventure, Casual, Indie, Simulation;0 - 20,000;6;1;5;0;0;0
746840;Chronicles of Magic: Divided Kingdoms;Casual, Simulation;20,000 - 50,000;153;29;124;198;198;0
746850;Cloudpunk;Adventure, Indie;500,000 - 1,000,000;10558;1329;9229;292;115;29
746880;Spoxel;Casual, Indie;0 - 20,000;17;10;7;0;0;0
746890;Skript;Action, Casual, Indie;0 - 20,000;10;2;8;0;0;0
746900;A song in the void;Casual, Indie;0 - 20,000;11;2;9;0;0;0
746910;Chicken Farm 2K17;Simulation;50,000 - 100,000;232;68;164;36;36;5
746920;Rapid Tap;Action, Casual, Indie;20,000 - 50,000;353;28;325;3;3;0
746930;OrbusVR: Reborn;Action, Adventure, Indie;20,000 - 50,000;924;273;651;203;203;2
746990;Prelude: Psychological Horror Game;Sexual Content, Violent, Gore, Simulation;0 - 20,000;6;12;-6;0;0;0
747050;Portal Journey: Portarius;Free to Play;0 - 20,000;21;5;16;0;0;0
747090;Deep Space: Unknown Universe;Casual, Indie;0 - 20,000;4;2;2;0;0;0
747110;Kamboja;Free to Play, Simulation;0 - 20,000;4;1;3;0;0;0
747120;Keyboard Warrior;Casual;0 - 20,000;1;1;0;0;0;0
747160;BAPTISM;Casual, Simulation;0 - 20,000;15;1;14;0;0;0
747190;Achievement Lurker: Dad Jokes;Action, Adventure, Indie, Early Access;0 - 20,000;101;26;75;0;0;0
747200;Keplerth;Casual, Indie;100,000 - 200,000;3069;504;2565;903;1022;73
747210;Voyage Senki VR 海洋传说 VR;Action, Casual, Free to Play, Massively Multiplayer, Strategy, Early Access;20,000 - 50,000;19;22;-3;0;0;0
747240;XL1-ClippingPoint;Adventure, Indie;0 - 20,000;56;29;27;5;5;0
747260;KungFu Town VR;Indie, Simulation, Strategy;0 - 20,000;9;16;-7;0;0;0
747280;Asteroid Girl;Free to Play, Indie, RPG, Strategy;0 - 20,000;0;1;-1;0;0;0
747310;Hyper Knights: Battles;Casual, Indie, Strategy;20,000 - 50,000;47;32;15;0;0;0
747320;Bravium;Indie, Racing;0 - 20,000;52;20;32;0;0;0
747320;Bravium;Action, Casual, Indie;0 - 20,000;52;20;32;0;0;0
747330;The adventure of Kroos;Casual, Indie;0 - 20,000;14;9;5;0;0;0
747340;Unforgiving - A Northern Hymn;Utilities, Video Production;50,000 - 100,000;1095;215;880;87;103;0
747350;Hellblade: Senua's Sacrifice VR Edition;Animation & Modeling, Utilities;50,000 - 100,000;1098;160;938;39;44;5
747360;Gray Dawn;Action, Adventure, Indie, Early Access;50,000 - 100,000;619;123;496;503;722;0
747470;Doughlings: Arcade;Indie;0 - 20,000;78;4;74;0;0;1
747540;AcChen - Tile matching the Arcade way;Action, Adventure, Indie, RPG, Early Access;20,000 - 50,000;6;2;4;0;0;1
747590;Drive//Shaft;Action, Adventure, Indie, RPG, Early Access;20,000 - 50,000;47;24;23;0;0;0
747610;ZULA LatinoAmerica;Action, Adventure, Indie;500,000 - 1,000,000;3932;1719;2213;1212;203;597
747620;Joggernauts;Action, Casual, Indie;20,000 - 50,000;89;13;76;0;0;1
747640;Harambe Kong;Action, Adventure;0 - 20,000;11;1;10;0;0;0
747650;The Padre;Action, Casual, Indie, Sports, Strategy;0 - 20,000;40;8;32;98;98;0
747660;Five Nights at Freddy's: Security Breach;Casual, Indie, Early Access;500,000 - 1,000,000;37581;6812;30769;587;544;409
747690;Sinister Halloween;Utilities, Video Production, Web Publishing, Early Access;0 - 20,000;100;16;84;2;2;0
747700;Space Shaft;Action, Adventure, Indie, Sports;0 - 20,000;7;11;-4;0;0;0
747730;Operation Red Dragon;Action, Adventure, Indie, RPG;0 - 20,000;4;1;3;0;0;0
747750;D.F.R.: The Light;Action, Adventure, Casual, Indie;0 - 20,000;3;0;3;0;0;0
747770;Super Shoot Owl;Action, Indie;20,000 - 50,000;25;19;6;1;1;1
747790;Olson's Boxing Challenge;Casual, Indie;0 - 20,000;8;3;5;0;0;0
747810;Flow Handcrafted;Action, Indie;0 - 20,000;4;0;4;0;0;0
747810;Flow Handcrafted;Action;0 - 20,000;4;0;4;0;0;0
747820;Terra Tanks: Defenders of the Earth;Action, Indie, Strategy;0 - 20,000;1;0;1;0;0;0
747850;Warm Village 暖暖村物语;Adventure, Casual, Strategy;20,000 - 50,000;267;134;133;637;637;1
747910;Disassembly 3D;Early Access;0 - 20,000;223;53;170;1368;1368;3
747920;Hero Plus;Action, Free to Play, Massively Multiplayer, Early Access;50,000 - 100,000;117;91;26;0;0;35
747930;Battle Ion;Free to Play, Massively Multiplayer, Strategy;0 - 20,000;2;3;-1;0;0;0
747970;Scions of Fate;Action, Casual, Indie;20,000 - 50,000;86;50;36;0;0;47
747980;Puzzle Blocks;Action, Casual, Indie, Simulation;0 - 20,000;2;0;2;0;0;0
747990;Project Cabin;Sports;0 - 20,000;15;8;7;0;0;0
748010;Space Rocks;Casual, Indie;0 - 20,000;4;0;4;0;0;0
748040;State of War : Warmonger / 蓝色警戒 (Classic 2000);Action, Indie, Early Access;20,000 - 50,000;409;51;358;62;97;44
748050;Initiation;Casual;0 - 20,000;5;6;-1;0;0;0
748060;SchoolJump;Action, Casual, Indie, Massively Multiplayer, Sports, Strategy;0 - 20,000;6;7;-1;0;0;0
748110;Kitten Madness;Action, Casual, Indie;0 - 20,000;6;2;4;0;0;0
748130;Sugy the Christmas elf;Adventure;0 - 20,000;8;3;5;0;0;0
748150;The Love Boat;Nudity, Violent, Gore, Action, Adventure, Indie, RPG, Simulation, Strategy, Early Access;0 - 20,000;26;6;20;0;0;0
748270;VR Roller Coaster - Cave Depths;Adventure;0 - 20,000;13;3;10;7;7;0
748300;Treasure Hunter Simulator;Casual, Indie, Simulation;100,000 - 200,000;754;531;223;221;100;8
748310;Trio Adventures;Casual, Indie;0 - 20,000;16;1;15;0;0;0
748330;Super Mega Space Blaster Special Turbo;Action, Indie;0 - 20,000;15;1;14;0;0;0
748360;MY HERO ONE'S JUSTICE;Adventure, Casual, Indie;100,000 - 200,000;1525;491;1034;404;577;7
748370;STAND OUT : VR Battle Royale;Adventure, Indie;50,000 - 100,000;1016;374;642;853;1424;2
748420;Beat the Blitz;Indie;0 - 20,000;26;3;23;1;1;0
748420;Beat the Blitz;Casual, Indie, Strategy;0 - 20,000;26;3;23;1;1;0
748430;Cube Color;Casual, Indie, Strategy;0 - 20,000;26;23;3;0;0;0
748430;Cube Color;Action, Adventure, Early Access;0 - 20,000;26;23;3;0;0;0
748460;RealFlight 8;Adventure, Indie;0 - 20,000;61;14;47;0;0;3
748480;Wild Romance: Mofu Mofu Edition;Action, Strategy;20,000 - 50,000;145;37;108;160;164;1
748490;The Legend of Heroes: Trails of Cold Steel II;Violent, Action, Indie;50,000 - 100,000;2227;139;2088;3817;4980;84
748520;Tevris;Violent, Gore, Indie, Massively Multiplayer, Early Access;0 - 20,000;0;6;-6;0;0;0
748540;Solitaire;Action, Adventure, Indie;0 - 20,000;14;9;5;0;0;0
748580;Bridge to Another World: The Others Collector's Edition;Action, Adventure, Indie;0 - 20,000;3;0;3;0;0;1
748600;Meme Dragons;Action, Adventure, Casual, Indie;0 - 20,000;14;4;10;0;0;0
748610;Airport Madness 3D: Volume 2;Action, Adventure, Casual, Indie, RPG;20,000 - 50,000;135;29;106;0;0;4
748650;Carnage in Space: Ignition;Adventure, Casual;0 - 20,000;7;5;2;0;0;0
748660;Tom's Mansion;Sexual Content, Adventure;0 - 20,000;12;4;8;0;0;0
748670;Skydiving Simulator VR;Action, Adventure, Casual, Indie, Strategy;0 - 20,000;0;6;-6;0;0;0
748720;ATV Simulator VR;RPG;0 - 20,000;2;1;1;0;0;0
748730;Seek Not a Lighthouse;Action, Casual, Indie, Early Access;0 - 20,000;7;3;4;0;0;0
748780;Cardinal Conclave;Action, Indie;0 - 20,000;1;0;1;0;0;0
748800;Savage Offroad;Action;0 - 20,000;15;9;6;0;0;0
748820;Monstrous;Action, Casual, Racing, Sports;0 - 20,000;2;5;-3;0;0;0
748830;Yanone: Letter Splatter;Action, Racing, Early Access;0 - 20,000;5;0;5;0;0;0
748880;External Visions;Violent, Action, Indie;0 - 20,000;36;11;25;0;0;0
748890;Choice of Rebels: Uprising;Casual, Indie, Strategy;0 - 20,000;110;11;99;0;0;1
748910;SpacePig;Strategy;0 - 20,000;1;1;0;0;0;0
748930;Brink of Extinction;Action, Adventure, Indie;0 - 20,000;8;5;3;0;0;0
748940;Rise of Legions;Gore, Action, Adventure, Indie;200,000 - 500,000;1351;285;1066;0;0;0
748970;Zen Chess: Mate in One;Adventure, Casual, Indie;0 - 20,000;252;41;211;0;0;1
748970;Zen Chess: Mate in One;Adventure, Casual, Indie, RPG, Strategy;0 - 20,000;252;41;211;0;0;1
748980;Tico;Action, Adventure, Casual, Indie, Strategy;0 - 20,000;6;0;6;0;0;1
748990;The Z Axis: Continuum;Adventure, Casual;0 - 20,000;2;0;2;0;0;0
749000;Final Cut: Homage Collector's Edition;Indie, Sports;0 - 20,000;1;1;0;0;0;0
749010;Yatzy;Action, Indie, Simulation, Early Access;0 - 20,000;18;10;8;0;0;2
749040;Battle Runner;Adventure, Indie, RPG;0 - 20,000;12;13;-1;0;0;0
749050;The 111th Soul;Action, Casual, Indie, Sports;0 - 20,000;118;52;66;0;0;0
749080;Mystery Case Files: The Revenant's Hunt Collector's Edition;Action, Free to Play, Massively Multiplayer, Simulation, Sports;0 - 20,000;8;5;3;0;0;0
749110;Bold Blade;Casual, Simulation, Early Access;0 - 20,000;7;6;1;0;0;0
749130;SK8;Adventure, Casual, Indie;0 - 20,000;6;12;-6;0;0;0
749140;Prehistorik 2;Adventure, Casual, Indie, RPG;0 - 20,000;40;6;34;0;0;1
749150;Thrushbriar Hall;Action, Casual, Indie;0 - 20,000;0;1;-1;0;0;0
749180;Bridge Trek;Simulation, Strategy;0 - 20,000;18;5;13;0;0;0
749200;Offensive Dimensions;Simulation, Strategy;0 - 20,000;7;0;7;0;0;0
749250;7th Sector;Casual, Strategy;100,000 - 200,000;444;145;299;127;127;0
749270;Magic Siege - Defender;Action, Free to Play, Indie, Early Access;0 - 20,000;50;41;9;0;0;1
749290;VEHICLES FURY;Casual, Indie;0 - 20,000;1;5;-4;0;0;0
749320;Alma;Adventure, Indie;0 - 20,000;4;0;4;0;0;0
749340;Chocolate makes you happy;Casual, Indie;0 - 20,000;118;38;80;42;42;0
749370;The Perfect Sniper;Casual, Indie;0 - 20,000;13;13;0;0;0;0
749410;Season's Beatings;Action, Casual, Free to Play, Indie, Massively Multiplayer, Simulation;0 - 20,000;51;6;45;0;0;0
749430;Stacker;Action, Early Access;20,000 - 50,000;1;0;1;0;0;0
749470;TAOTH - The Adventures of the Herkulez;Action, Adventure, Indie, Early Access;0 - 20,000;2;0;2;0;0;0
749480;Station 228;Indie, Simulation, Strategy;0 - 20,000;11;27;-16;0;0;0
749520;Sakura no Mori † Dreamers;Adventure, Indie, RPG;0 - 20,000;745;66;679;422;841;3
749540;Wild Wolf;Adventure, Indie;0 - 20,000;72;69;3;0;0;0
749560;Cycle 28;Casual, Free to Play, Indie;20,000 - 50,000;42;8;34;0;0;0
749580;All That Remains;Action, Adventure, Indie, RPG, Early Access;0 - 20,000;14;20;-6;0;0;0
749650;Barrimean Jungle;Simulation;0 - 20,000;0;2;-2;0;0;0
749670;Spinning Around;Violent, Action, Indie, Simulation;0 - 20,000;41;5;36;0;0;0
749700;Karate Krab;Indie, Simulation, Early Access;0 - 20,000;10;0;10;0;0;0
749710;Imperi;Action, Adventure, RPG;0 - 20,000;5;4;1;0;0;0
749730;While you are Downloading;Action, Adventure, Indie, RPG, Early Access;0 - 20,000;20;3;17;0;0;0
749780;DEAD DOZEN;Action;20,000 - 50,000;238;348;-110;280;280;0
749800;PixelJunk Monsters 2;Indie;20,000 - 50,000;148;76;72;0;0;1
749820;Villages;Action, Casual, Indie;0 - 20,000;0;0;0;0;0;0
749830;Moon Bullet;Adventure, Casual, Indie;0 - 20,000;15;9;6;0;0;0
749840;The Boogie Man;Action, Adventure, Indie, RPG, Strategy;0 - 20,000;145;29;116;0;0;1
749840;The Boogie Man;Action, Indie, Early Access;0 - 20,000;145;29;116;0;0;1
749850;DragonFangZ - The Rose & Dungeon of Time;Free to Play, Massively Multiplayer;0 - 20,000;117;39;78;35;35;0
749860;Super Sportmatchen;Casual, Indie;0 - 20,000;39;15;24;11;11;0
749870;MyTD 我的塔防;Action, Adventure, Casual, Indie;0 - 20,000;32;20;12;183;183;1
749880;Just Jump;Adventure, Casual;20,000 - 50,000;65;19;46;0;0;1
749890;The Hanged Man;Action;0 - 20,000;114;15;99;0;0;0
749900;Feed the Animals;Action, Adventure, Indie;0 - 20,000;9;2;7;0;0;0
749920;Eternal Dread;Indie, Simulation;0 - 20,000;37;12;25;0;0;0
749960;Townsmen VR;Action, Indie;0 - 20,000;306;71;235;478;922;5
749980;Illusion: A Tale of the Mind;Action, Indie, RPG, Early Access;0 - 20,000;22;7;15;0;0;0
750010;Combat Tested;Adventure;0 - 20,000;62;30;32;0;0;1
750020;Moving Day;Indie, Simulation, Strategy;0 - 20,000;6;4;2;0;0;0
750050;Diesel Brothers: Truck Building Simulator;Action, Casual, Indie, Racing, Simulation, Sports;50,000 - 100,000;790;458;332;404;664;8
750070;Motorbike Garage Mechanic Simulator;Action, Indie;0 - 20,000;20;34;-14;0;0;0
750080;Dead Climb;Action, Indie, Early Access;0 - 20,000;5;4;1;0;0;0
750130;The Sinking City;Action, Adventure, Indie;100,000 - 200,000;1480;571;909;614;1081;45
750170;Diesel Railcar Simulator;Adventure, Casual, Indie, RPG, Simulation, Strategy;0 - 20,000;259;16;243;180;180;1
750200;AWAY: The Survival Series;Adventure, Simulation, Early Access;0 - 20,000;122;100;22;26;26;1
750210;Last Anime boy: Saving loli;Action, Adventure, Indie, RPG;0 - 20,000;105;47;58;0;0;1
750240;Ascending Madness;Indie, Strategy, Early Access;0 - 20,000;5;0;5;0;0;0
750270;Hover X Souls: Git Gud Edition;Violent, Gore, Action, Indie, Early Access;0 - 20,000;1;3;-2;0;0;0
750290;Slice of Sea;Sexual Content, Nudity, RPG;0 - 20,000;362;22;340;0;0;1
750330;Air Hockey;Action, Adventure, RPG;0 - 20,000;41;13;28;11;11;0
750350;Google Spotlight Stories: Piggy;Indie, Strategy;0 - 20,000;35;4;31;3;3;0
750360;Google Spotlight Stories: On Ice;Action, Adventure, Casual, Indie, Simulation;0 - 20,000;38;3;35;0;0;0
750400;Two Inns at Miller's Hollow;Sports;20,000 - 50,000;1;1;0;0;0;0
750420;Super Dashmatch;Action, Adventure, Casual, Indie;0 - 20,000;4;1;3;0;0;0
750440;Skylight;Adventure, Casual, Indie, Simulation;0 - 20,000;13;6;7;0;0;0
750440;Skylight;Casual;0 - 20,000;13;6;7;0;0;0
750450;Gunlock;Adventure, Casual, Free to Play, Indie, Strategy;0 - 20,000;40;1;39;0;0;0
750460;WRONGED;Violent, Gore, Action, Indie, Early Access;0 - 20,000;25;7;18;0;0;0
750470;War Brokers;Adventure, Casual, Indie;0 - 20,000;330;33;297;2;2;19
750500;Socketeer;Adventure, Casual;0 - 20,000;19;8;11;0;0;0
750610;Garenburg Woods;Adventure, Casual;0 - 20,000;2;0;2;0;0;0
750620;Naughty Elves;Adventure, Casual;0 - 20,000;5;2;3;0;0;0
750660;Knockout Checkers Chamber;Adventure, Casual;0 - 20,000;48;7;41;0;0;0
750670;SUSHIDO VS ZOMBIES;Adventure, Casual;0 - 20,000;1;0;1;0;0;0
750710;CRONEWORLD RPG ADVENTURE - 1;Adventure, Casual;0 - 20,000;1;1;0;0;0;0
750740;Slice the Ice;Adventure, Casual;0 - 20,000;1;3;-2;0;0;0
750770;Labyronia Elements;Violent, Action, Indie, Early Access;0 - 20,000;16;6;10;0;0;1
750780;Christmas Puzzle 2;Gore, Action, Indie, Strategy;0 - 20,000;14;1;13;0;0;0
750790;Hollow Throne;Action, Adventure, Casual;0 - 20,000;6;3;3;1;1;0
750800;Egress;Casual, Indie;0 - 20,000;99;61;38;0;0;0
750820;You are a torpedo AI;Indie, RPG, Simulation, Early Access;0 - 20,000;1;0;1;0;0;0
750840;MAGIX Video Pro X9 Steam Edition;Indie, Massively Multiplayer, Strategy;0 - 20,000;5;3;2;0;0;0
750850;The Dream Collector;Casual, Indie;0 - 20,000;57;8;49;0;0;0
750870;JumpBall 2;Action, Strategy;0 - 20,000;4;7;-3;0;0;0
750900;Fight desserts;Casual, Free to Play, Indie, Massively Multiplayer, Simulation;0 - 20,000;5;17;-12;0;0;0
750920;Shadow of the Tomb Raider: Definitive Edition;Action, Indie, Simulation, Strategy, Early Access;1,000,000 - 2,000,000;54253;10377;43876;1258;915;742
750960;Yissa Deep Realms;Casual, Indie;0 - 20,000;70;6;64;0;0;0
751060;Ice Age Scrat's Nutty Adventure;Action, Adventure, Indie;0 - 20,000;90;32;58;0;0;1
751100;Nonograms Prophecy;Action, Casual, Indie, Early Access;0 - 20,000;0;0;0;0;0;0
751110;OVERVIEW (A Walk Through The Universe);Action, Early Access;50,000 - 100,000;79;28;51;60;60;0
751160;Hazard Perception Test UK 2017/18 Bundle - Driving Test Success;Action, Indie;0 - 20,000;0;3;-3;0;0;0
751170;Driving Theory Test UK 2017/18 - Driving Test Success;Gore, Adventure, Indie;0 - 20,000;4;1;3;0;0;0
751200;Puzzle Tactics;Adventure, Casual, Indie, RPG;50,000 - 100,000;23;6;17;0;0;0
751220;ETHEREAL;Action, Adventure, Indie;0 - 20,000;118;11;107;0;0;0
751230;Hyper Slasher;Action, Adventure, Casual, Indie, Early Access;0 - 20,000;0;0;0;0;0;0
751240;Fractured Lands;Adventure, Indie, RPG, Strategy;0 - 20,000;225;199;26;0;0;0
751250;Big Tower Tiny Square;Sexual Content, Nudity, Action, Casual, Indie;0 - 20,000;97;10;87;188;217;0
751260;Astrohazard Solutions Ltd.;Casual, Indie;0 - 20,000;15;0;15;0;0;0
751270;BioEntity;Action, Adventure, Casual, Racing, RPG, Early Access;0 - 20,000;1;0;1;0;0;0
751280;Snail Trek - Chapter 1: Intershellar;Action, Indie, Early Access;20,000 - 50,000;128;8;120;22;22;0
751300;Alice Mystery Garden;Violent, Gore, Adventure, Indie, Simulation;0 - 20,000;193;10;183;2;2;0
751300;Alice Mystery Garden;Action, Adventure, Indie;0 - 20,000;193;10;183;2;2;0
751320;Echo;Casual;0 - 20,000;14;12;2;0;0;0
751330;Battery Jam;Racing, Simulation, Sports;0 - 20,000;23;6;17;0;0;0
751340;ASSAULT GUNNERS HD EDITION;Casual, Indie, Simulation;0 - 20,000;79;28;51;174;174;1
751350;Deadly Contact;Free to Play, Indie, Simulation, Strategy;20,000 - 50,000;24;9;15;1;1;0
751380;Sacred Four;Action, Indie;0 - 20,000;11;3;8;0;0;0
751400;The Turdler;Action;0 - 20,000;3;1;2;0;0;0
751430;Puzzle of Santa Girl VR;Action, Casual, Indie, RPG, Sports;0 - 20,000;2;4;-2;0;0;0
751440;VR Kanojo / VRカノジョ;Violent, Gore, Action, Adventure, Indie, Strategy;100,000 - 200,000;1381;440;941;172;189;11
751450;Nanairo Reincarnation;Action, Casual, Indie, Simulation, Strategy, Early Access;0 - 20,000;140;6;134;0;0;2
751470;Deadstep;Indie;20,000 - 50,000;29;11;18;0;0;1
751480;Vector Velocity;Action, Early Access;0 - 20,000;11;9;2;0;0;0
751490;WaveCrash!!;Adventure, Free to Play, Indie, RPG;0 - 20,000;14;0;14;0;0;0
751500;TINY METAL;Action, Adventure, Casual, Simulation, Sports, Strategy, Early Access;0 - 20,000;184;77;107;0;0;0
751530;Dog Fight Super Ultra Deluxe;Action, Adventure, Casual, Indie, Early Access;0 - 20,000;2;1;1;0;0;0
751540;Duel Jousting;Action, Casual, Indie, Simulation;0 - 20,000;2;3;-1;0;0;0
751550;The Same Crime;Indie, RPG, Strategy;20,000 - 50,000;7;4;3;0;0;0
751590;Dinosaurs A Prehistoric Adventure;Action, Indie, Early Access;20,000 - 50,000;91;112;-21;4;4;0
751630;After the Fall;RPG, Strategy;50,000 - 100,000;1634;487;1147;277;181;104
751640;Dead Dungeon;Adventure, Indie, RPG;0 - 20,000;224;18;206;0;0;0
751670;Cloud Chasers - Journey of Hope;Casual, Early Access;0 - 20,000;10;1;9;0;0;0
751680;C64 & AMIGA Classix Remakes Sixpack 2;RPG;0 - 20,000;5;2;3;0;0;0
751690;The Mammoth: A Cave Painting;Action, Adventure, Indie, RPG;20,000 - 50,000;770;71;699;7;7;0
751730;Tennis Arcade VR;Action, Casual, Indie, RPG;0 - 20,000;22;8;14;0;0;0
751740;Roller Coaster Egypt VR;Casual, Indie;0 - 20,000;0;3;-3;0;0;1
751780;Forager;Casual, Indie, Simulation;500,000 - 1,000,000;30441;3135;27306;1464;1011;483
751820;Black Future '88;Casual, Indie;50,000 - 100,000;458;159;299;52;87;3
751870;Chopper Battle New Horizon;Indie, Racing, Early Access;0 - 20,000;0;3;-3;0;0;0
751920;Sealer Assist;Action, Adventure, Casual, Indie;0 - 20,000;1;0;1;0;0;0
751950;TACTICAL;Adventure, Casual, Indie;0 - 20,000;10;2;8;0;0;0
751970;Plox Neon;Casual, Indie;0 - 20,000;16;2;14;0;0;0
751980;Box Cats Puzzle;Adventure, Free to Play, Indie, RPG;0 - 20,000;77;3;74;0;0;3
752000;Bug Battle;Adventure, Casual, Indie;0 - 20,000;2;2;0;0;0;0
752020;The Apartment;Animation & Modeling;0 - 20,000;16;15;1;0;0;0
752030;Paradise Lost: FPS Cosmic Horror Game;Casual, Indie, Early Access;0 - 20,000;5;3;2;0;0;0
752050;Virtual Reality Girls;Adventure, Indie, RPG;0 - 20,000;17;14;3;0;0;0
752060;Subwar 2050;Indie, Simulation;200,000 - 500,000;2;0;2;0;0;0
752080;Intergalactic traveler: The Omega Sector;Action, Adventure, Indie;0 - 20,000;3;0;3;0;0;0
752170;Save Your Nuts;Adventure, Casual, Indie, RPG, Simulation;0 - 20,000;57;16;41;0;0;0
752180;One Night;Action, Adventure, Casual, Indie;0 - 20,000;20;4;16;0;0;1
752200;VR Dunhuang;Action, Indie, Racing, Simulation, Sports;0 - 20,000;9;3;6;0;0;0
752300;Forestation;Action, Indie;0 - 20,000;37;26;11;0;0;0
752310;Flying Salvager;Education, Utilities;0 - 20,000;8;13;-5;0;0;0
752330;Shape of America: Episode One;Casual;0 - 20,000;41;7;34;0;0;0
752380;TERRORHYTHM (TRRT) - Rhythm driven action beat 'em up!;Casual, Indie, Simulation;20,000 - 50,000;60;25;35;0;0;0
752430;Arcade Love / ゲーセンラブ。;Adventure, Indie;0 - 20,000;6;1;5;0;0;0
752470;CINERIS SOMNIA;Action, Adventure, Casual, Indie, RPG, Early Access;0 - 20,000;129;36;93;0;0;0
752480;Sniper Elite VR;Casual, Indie, Simulation;20,000 - 50,000;360;286;74;0;0;2
752500;Ghoulboy - Dark Sword of Goblin;Action, Adventure, Casual, Indie, Simulation;0 - 20,000;162;65;97;6;6;1
752520;Football Nation VR Tournament 2018;Indie, RPG;0 - 20,000;16;13;3;0;0;0
752530;Close Call Extreme;Action, Adventure, Indie, Early Access;0 - 20,000;0;0;0;0;0;0
752550;Ripped Pants at Work;Simulation;0 - 20,000;25;4;21;0;0;0
752560;Noahmund;Casual, Indie, Simulation;0 - 20,000;17;6;11;0;0;0
752570;Song of Memories (Complete Scenario);Action;0 - 20,000;67;46;21;0;0;0
752580;"Imperivm RTC - HD Edition ""Great Battles of Rome""";Utilities;50,000 - 100,000;499;241;258;2824;2824;84
752590;A Plague Tale: Innocence;Action, Adventure, Indie;1,000,000 - 2,000,000;47417;3221;44196;827;583;317
752600;Dual Snake;Action, Adventure, Indie, RPG;0 - 20,000;51;4;47;0;0;0
752640;National Rugby Manager;Adventure, Indie, RPG, Strategy;0 - 20,000;30;15;15;0;0;1
752690;The Resistance;Indie, RPG, Strategy, Early Access;0 - 20,000;8;5;3;0;0;0
752700;Abscond;Casual, Free to Play, Indie;20,000 - 50,000;35;20;15;0;0;0
752710;Infinity Trip;Action, Casual, Indie;0 - 20,000;10;10;0;0;0;0
752720;The Culling 2;Action, Casual, Indie;20,000 - 50,000;27;133;-106;0;0;0
752730;Fantastic Beasts and Where to Find Them VR Experience;Action, Casual, Indie;0 - 20,000;8;21;-13;0;0;0
752750;Justice League VR: The Complete Experience;Casual, Indie;0 - 20,000;8;17;-9;0;0;0
752770;GyroShooter;Casual, Indie, RPG, Strategy;0 - 20,000;2;0;2;0;0;0
752780;W4RR-i/o-RS;Indie, Simulation, Strategy;0 - 20,000;13;21;-8;1;1;0
752790;Danger Close!;Indie;0 - 20,000;3;2;1;0;0;0
752800;Mysterious Realms RPG;Action, Adventure, Free to Play, Indie, RPG;0 - 20,000;45;2;43;0;0;0
752810;NOLA is Burning;Adventure, Casual, Indie;0 - 20,000;2;6;-4;0;0;0
752830;Choice of the Rock Star;Action, Indie, Early Access;0 - 20,000;3;2;1;0;0;0
752850;Choice of the Ninja;Adventure, Casual, Indie;0 - 20,000;8;5;3;0;0;0
752880;Sounds of Music;Action, Adventure, Casual, Indie;20,000 - 50,000;3;0;3;0;0;0
752900;Prehistoric Hunt;Action, Adventure, Indie, Simulation, Strategy;0 - 20,000;96;25;71;472;472;13
752910;Cookies vs. Claus;Violent, Gore, Action, Indie;0 - 20,000;208;38;170;91;91;1
753060;Lucky Night VR;Violent, Action, Indie;20,000 - 50,000;18;11;7;0;0;0
753090;Marius;Action, Indie;20,000 - 50,000;15;11;4;0;0;0
753100;Orbitality;Adventure, Casual, Indie;0 - 20,000;10;3;7;0;0;0
753110;Chronicles of Vinland;Adventure, Indie;0 - 20,000;59;85;-26;0;0;0
753170;Blood Harvest 2;Adventure, Indie;0 - 20,000;12;16;-4;0;0;0
753200;Sharecare YOU;Action, Adventure, Indie;0 - 20,000;67;14;53;0;0;1
753210;DIY Simulator;Action;0 - 20,000;13;14;-1;0;0;0
753220;Mhakna Gramura and Fairy Bell;Adventure, Indie, Simulation, Strategy;0 - 20,000;566;8;558;0;0;0
753230;STAY;Casual, Indie;0 - 20,000;344;147;197;0;0;0
753240;CG the Seven Virus Knights;Action, Adventure, Casual, Indie;0 - 20,000;5;3;2;0;0;0
753270;Henri's Secret - Visual novel;Action, Casual, Indie, Simulation;0 - 20,000;24;13;11;0;0;0
753360;VoiceActress;Adventure, Casual;0 - 20,000;190;32;158;3;3;0
753370;Regenesis Arcade;Adventure, Indie;0 - 20,000;16;6;10;0;0;0
753380;Metal Soldiers 2;Casual;0 - 20,000;14;11;3;0;0;0
753390;The Eerie Adventures Of Kally;Casual, Indie, Simulation;0 - 20,000;4;2;2;0;0;0
753400;Harem Girl: Evie;Violent, Adventure, Casual, Simulation;0 - 20,000;22;4;18;0;0;0
753420;Dungreed;Action, Indie, Early Access;500,000 - 1,000,000;7290;581;6709;1313;918;249
753440;A Small Robot Story;Free to Play, Massively Multiplayer, RPG;0 - 20,000;29;4;25;0;0;0
753490;Lamplight Station;Action, Indie, Strategy;0 - 20,000;4;4;0;0;0;0
753560;Twinstack;Action, Adventure, Indie;0 - 20,000;6;1;5;0;0;0
753570;Rogue Buddies - Aztek Gold;Action, Casual, Indie, Sports;0 - 20,000;2;1;1;0;0;0
753590;Hellbound;Action, Casual, Indie, Early Access;20,000 - 50,000;723;404;319;94;107;4
753610;J.A.W.S;Action, Indie;100,000 - 200,000;73;74;-1;7;7;0
753630;Refinish Network - Paintboss VR;Casual, Indie, Strategy;0 - 20,000;0;1;-1;0;0;0
753640;Outer Wilds;Action, Adventure, Casual, Indie, Simulation, Strategy;1,000,000 - 2,000,000;43585;2094;41491;683;314;664
753650;Due Process;Casual, Early Access;200,000 - 500,000;4772;1083;3689;450;382;6
753660;AtmaSphere;Action;0 - 20,000;145;32;113;0;0;0
753670;Restaurant Tycoon;Indie;0 - 20,000;4;13;-9;0;0;0
753900;End Space;Indie, RPG, Early Access;0 - 20,000;62;28;34;0;0;0
753920;Battle for the last chicken;Action, Casual, Indie, Simulation, Sports, Strategy, Early Access;0 - 20,000;6;8;-2;0;0;0
753930;God's Basement;Action, Indie;20,000 - 50,000;832;286;546;0;0;1
753950;WWII英雄列伝 最強の虎　クルト・クニスペル;Casual, Indie;0 - 20,000;1;0;1;0;0;0
753960;Jida Chronicle Chaos frontier VR;Action, Adventure, Indie, RPG, Early Access;0 - 20,000;7;5;2;0;0;0
753980;ARK -the lost fairytale-;Casual, Simulation;100,000 - 200,000;7;0;7;0;0;0
753990;Psi Project: Legacy;Action, Indie;0 - 20,000;37;54;-17;2;2;0
754000;Re-bot VR;Action, Casual, Indie;0 - 20,000;1;0;1;0;0;0
754010;MEDICALHOLODECK. The medical DICOM Viewer and Human Anatomy Lab in Virtual Reality.;Adventure, Casual;20,000 - 50,000;30;10;20;1;1;0
754020;Galactic Harvester;Free to Play, Indie, Massively Multiplayer, Strategy, Early Access;0 - 20,000;16;12;4;0;0;0
754040;Piggy Poggy Pog;Action, Indie, Racing;20,000 - 50,000;470;111;359;1;2;1
754050;Bomb Bots Arena;Action, Indie;100,000 - 200,000;518;92;426;0;0;3
754110;Escort Commander;Adventure, Indie, RPG;0 - 20,000;11;4;7;0;0;0
754120;Ninja Stealth 3;Indie, Simulation, Strategy, Early Access;50,000 - 100,000;270;66;204;241;272;4
754150;Rolling Line;Action;100,000 - 200,000;1512;70;1442;179;244;70
754160;Defenders of Tetsoidea Academy;Action, Indie, Early Access;0 - 20,000;39;16;23;1;1;0
754230;Defense Warfare;Casual;0 - 20,000;6;1;5;0;0;0
754270;Hexvade;Action, Indie;0 - 20,000;6;0;6;0;0;0
754300;Metal Quest;Action, Indie, Racing, Early Access;0 - 20,000;6;0;6;0;0;0
754310;Deadly Cryptids;Adventure;0 - 20,000;7;3;4;0;0;0
754320;Pixel Noir;Indie, Simulation, Sports, Strategy, Early Access;20,000 - 50,000;19;2;17;0;0;1
754330;Nogibator: Way Of Legs;Violent, Gore, Action, Adventure, Indie, Early Access;0 - 20,000;29;22;7;0;0;0
754340;Paper Dungeons Crawler;Adventure, Indie, RPG;0 - 20,000;30;11;19;0;0;0
754350;忍者村大战2;Adventure, Indie;100,000 - 200,000;142;149;-7;280;554;6
754380;War on Drugs VR;Adventure, Casual, Indie;0 - 20,000;0;2;-2;0;0;0
754400;Amazeing Lemons;Violent, Gore, Action, Adventure, Indie;0 - 20,000;18;28;-10;0;0;0
754410;鉄道運転士 Railroad operator;Action, Casual, Indie, Strategy;0 - 20,000;0;0;0;0;0;0
754460;Jisei;Adventure, Indie, RPG;20,000 - 50,000;18;2;16;0;0;0
754460;Jisei;Adventure, Casual, Indie, RPG;20,000 - 50,000;18;2;16;0;0;0
754480;Dummy!;Casual, Free to Play, Indie;0 - 20,000;6;3;3;0;0;0
754500;Plutocracy;Adventure, Indie, Strategy;20,000 - 50,000;709;201;508;60;60;26
754510;3D Hardcore Cube 2;Strategy;0 - 20,000;35;23;12;0;0;0
754520;Animals Memory;Adventure, Indie;0 - 20,000;49;8;41;0;0;0
754530;IL-2 Sturmovik: Cliffs of Dover Blitz Edition;Action, Adventure, Casual, Indie, Racing, Simulation, Sports, Strategy;200,000 - 500,000;961;403;558;620;1198;28
754540;Gauntlet of IRE;Action, Indie, RPG, Simulation, Early Access;0 - 20,000;130;44;86;0;0;1
754610;>Mars Taken;Casual, Indie, Strategy;0 - 20,000;3;17;-14;52;52;0
754620;High School Simulator;Action, Casual, Indie, Sports;20,000 - 50,000;174;66;108;11;11;4
754640;Rockfest;Casual, Indie;0 - 20,000;12;19;-7;0;0;0
754800;Yashik;RPG;20,000 - 50,000;38;32;6;0;0;0
754810;Six Days of Snow;Casual, Indie;20,000 - 50,000;255;70;185;54;107;1
754810;Six Days of Snow;Action, Free to Play, Indie;20,000 - 50,000;255;70;185;54;107;1
754830;Travel Mosaics 6: Christmas Around the World;Action, Early Access;0 - 20,000;14;0;14;0;0;0
754840;My Life as a Maiden;Action, Simulation, Sports;0 - 20,000;75;11;64;0;0;1
754850;The Spy Who Shrunk Me;Action, Adventure, Casual, Indie;20,000 - 50,000;77;21;56;47;47;0
754930;Zero Days VR;Casual, Indie;0 - 20,000;15;2;13;0;0;0
755040;抓雞遊戲 Catch Chicken Games;Adventure, Casual, Free to Play, Indie, Strategy, Early Access;0 - 20,000;1;0;1;0;0;0
755080;Genesis - 创世争霸;Violent, Action, Adventure;100,000 - 200,000;77;67;10;0;0;0
755130;Snowglobe;Action, Adventure, Free to Play, Indie, Early Access;0 - 20,000;6;1;5;0;0;0
755140;Air Dash;Action, Casual, Indie, Simulation, Sports, Early Access;0 - 20,000;1;5;-4;0;0;0
755140;Air Dash;Adventure, Casual, Indie, Simulation;0 - 20,000;1;5;-4;0;0;0
755150;Aurora Trail;Utilities;50,000 - 100,000;83;15;68;2;2;0
755220;Frutakia 2;Action, Indie;0 - 20,000;6;3;3;0;0;0
755230;Target speed;Casual, Indie;0 - 20,000;10;14;-4;2;3;0
755240;Raining Coins;Action, Adventure, Indie, RPG, Strategy;0 - 20,000;6;2;4;0;0;0
755250;Impale;Casual, Indie;0 - 20,000;23;3;20;0;0;0
755290;CyberLink PowerDVD 17 Standard;Casual, Indie;0 - 20,000;0;2;-2;0;0;0
755320;CyberLink PowerDVD 18 Ultra - Media player, video player, 4k media player, 360 video;Casual, Indie, Simulation;0 - 20,000;2;0;2;0;0;0
755340;Shawy Adventures;Action, Indie, Simulation;0 - 20,000;4;0;4;0;0;0
755350;Truth: Disorder;Education;0 - 20,000;24;33;-9;0;0;0
755370;Smart Junior Academy - Summer;Adventure, RPG;0 - 20,000;1;0;1;0;0;0
755370;Smart Junior Academy - Summer;Adventure, Indie, Simulation;0 - 20,000;1;0;1;0;0;0
755410;Vengeful Rites;Adventure, Indie, RPG;0 - 20,000;234;16;218;0;0;1
755450;Stage 3: Azaria;Adventure, Indie, RPG;0 - 20,000;0;7;-7;0;0;0
755470;The World Next Door;Adventure;0 - 20,000;223;46;177;0;0;0
755500;ONE PIECE World Seeker;Casual, Indie;100,000 - 200,000;2761;811;1950;394;536;206
755520;Battle Shapes;Free to Play;0 - 20,000;16;1;15;0;0;0
755530;Factorybelts 2;Action, Indie, Massively Multiplayer, Simulation, Strategy, Early Access;0 - 20,000;1;0;1;0;0;0
755540;LIV;Action, Casual, Indie;200,000 - 500,000;664;83;581;266;310;72
755550;True Mining Simulator;Indie, Early Access;0 - 20,000;46;21;25;0;0;1
755560;Arrowpoint;Casual, Simulation;0 - 20,000;18;3;15;0;0;0
755570;Chinbu's Adventure;Indie, RPG;20,000 - 50,000;30;29;1;0;0;0
755580;Daddy's gone a-hunting;Simulation, Early Access;0 - 20,000;5;10;-5;0;0;0
755590;Battle High 2 A+;Adventure, Casual, Massively Multiplayer, Simulation;0 - 20,000;29;3;26;0;0;0
755600;Christmas Race;Action, Adventure, Casual;20,000 - 50,000;39;30;9;0;0;0
755610;Defend Your Buttress;Action, Adventure, Indie;0 - 20,000;4;0;4;0;0;0
755630;Drake of the 99 Dragons;Indie, RPG, Strategy;20,000 - 50,000;53;37;16;0;0;0
755640;Predator VR;Casual, Indie, Strategy;0 - 20,000;1;0;1;0;0;0
755760;Power Supplied;Indie;0 - 20,000;1;0;1;0;0;0
755790;Ring of Elysium;Adventure, Casual, Indie, RPG;10,000,000 - 20,000,000;74590;25859;48731;1426;96;367
755800;Hades' Star;Action, Adventure, Indie;200,000 - 500,000;1612;399;1213;0;0;334
755820;One Against The Galaxy;Action, Casual, Indie, Simulation;0 - 20,000;1;0;1;0;0;0
755830;Lonely Astronaut;Action, Adventure, Indie;0 - 20,000;18;2;16;0;0;0
755850;VR Ping Pong Paradise;Casual, Simulation, Strategy;0 - 20,000;6;6;0;0;0;0
755890;Pipes!;Casual, Strategy;50,000 - 100,000;123;35;88;0;0;0
755920;CHOP;Casual, Indie;0 - 20,000;17;2;15;0;0;0
755950;Fantasy Quest Solitaire;Casual, Indie, Simulation, Early Access;0 - 20,000;78;14;64;0;0;2
755980;DEPLOYMENT;Adventure, Simulation, Strategy;50,000 - 100,000;573;120;453;48;48;1
756020;Puppet Kings;Action, Adventure, Indie;0 - 20,000;19;7;12;0;0;0
756040;RollerCoaster Legends;Action, Casual, Indie;0 - 20,000;21;8;13;0;0;0
756090;Good Morning;Action, RPG;0 - 20,000;7;17;-10;0;0;0
756100;Curse of the Old Gods;Casual, Indie;0 - 20,000;16;6;10;0;0;1
756150;Born Tubi Wild;Casual, Indie;0 - 20,000;9;0;9;0;0;0
756170;Helix Brawl;Action, Indie;0 - 20,000;5;1;4;0;0;0
756200;Impossibox;Casual, Indie;0 - 20,000;3;0;3;0;0;0
756210;Talsaluq: Tower of Infinity;Action, Casual, Indie;0 - 20,000;4;0;4;0;0;0
756220;Whirlpool;Adventure, Casual, Indie;0 - 20,000;5;5;0;0;0;0
756230;KARTOFELKA;Action, Indie, Sports;0 - 20,000;31;26;5;270;270;0
756240;Asylamba: Influence;Action, Adventure, Massively Multiplayer, RPG, Simulation, Early Access;0 - 20,000;42;10;32;0;0;0
756260;Kingdom Defense;Action, Indie, Strategy;0 - 20,000;43;57;-14;1;1;0
756290;In League;Violent, Gore, Action;0 - 20,000;3;5;-2;0;0;0
756320;Snail Trek - Chapter 2: A Snail Of Two Worlds;Action, Free to Play, Indie;0 - 20,000;32;0;32;0;0;0
756340;Traffic Cop;Action, Adventure;0 - 20,000;1;3;-2;0;0;0
756350;OutBreak: The Escape;Action, Adventure, Casual, Indie, RPG, Early Access;0 - 20,000;1;5;-4;0;0;0
756360;LINCH;Indie, Strategy, Early Access;20,000 - 50,000;102;66;36;67;68;0
756380;Super Bugman Extreme Ultra;Action, Indie;0 - 20,000;2;0;2;0;0;0
756410;Nova 1492;Casual, Indie;0 - 20,000;33;20;13;0;0;0
756420;Dark Maze;Action, Adventure, Casual, Indie;0 - 20,000;17;30;-13;4;4;0
756440;Your Bunny Wrote;Action, Casual, Indie;50,000 - 100,000;152;20;132;0;0;0
756490;Next Hero;Action, Indie, Early Access;0 - 20,000;29;19;10;0;0;0
756500;Noir Chronicles: City of Crime;Action, Adventure, Indie, Early Access;0 - 20,000;110;76;34;0;0;0
756520;Sensual VR;Action, Adventure, Casual, Indie;0 - 20,000;0;9;-9;0;0;0
756530;TOKYO GHOUL:re [CALL to EXIST];Adventure, Indie, Simulation;20,000 - 50,000;939;430;509;0;0;11
756560;Robot Warriors;Casual, Indie;0 - 20,000;34;40;-6;1;1;0
756600;Trianga's Project: Battle Splash 2.0;Action, Casual, Indie, Strategy;0 - 20,000;69;8;61;0;0;0
756630;Solar Wind;Simulation, Early Access;0 - 20,000;6;0;6;0;0;0
756650;THE BOX VR;Adventure, Indie;0 - 20,000;5;3;2;0;0;0
756680;Angelo Skate Away;Action, Indie;0 - 20,000;11;2;9;0;0;0
756700;Neon Seoul: Outrun;Action, Adventure, Casual, Indie, RPG, Simulation;0 - 20,000;30;6;24;0;0;0
756740;Man of Honor;Casual, Indie, Simulation;20,000 - 50,000;6;0;6;0;0;0
756790;cityglitch;Action, Indie;0 - 20,000;14;0;14;0;0;0
756810;M.A.X. 2: Mechanized Assault & Exploration;Casual, Indie, RPG;0 - 20,000;7;12;-5;0;0;0
756840;摩尼遊戯TOKOYO;Indie, Strategy;0 - 20,000;8;1;7;0;0;0
756860;Archers;Action, Adventure, Indie;0 - 20,000;3;3;0;0;0;0
756880;NVL;Violent, Action, Adventure, Indie;50,000 - 100,000;256;118;138;234;234;2
756880;NVL;Adventure, Casual;50,000 - 100,000;256;118;138;234;234;2
756890;Alive Hunter;Violent, Gore, Action, Indie;0 - 20,000;3;1;2;0;0;0
756980;Raymond's Obstacle Course;Violent, Action, Adventure, Casual, Indie, Racing, RPG, Simulation, Strategy;0 - 20,000;2;0;2;0;0;0
757030;Christmas Stories: A Christmas Carol Collector's Edition;Indie, Strategy;20,000 - 50,000;41;3;38;0;0;13
757040;Desert Golfing;Adventure, Indie;0 - 20,000;74;1;73;0;0;1
757050;Pure Metal: Feature 1;Casual, Indie;0 - 20,000;1;0;1;0;0;0
757060;DoubleTap;Indie, Simulation, Sports, Strategy;0 - 20,000;9;6;3;0;0;0
757080;Broadway: 1849;Action, Simulation, Early Access;0 - 20,000;13;2;11;0;0;0
757100;VR RHYTHM ACTION SEIYA;Action, Casual, Indie;0 - 20,000;25;6;19;0;0;0
757130;Paintball War;Casual, Indie;200,000 - 500,000;501;661;-160;15;15;0
757160;ULTIMATE ARENA: SHOWDOWN;Casual, Indie;0 - 20,000;7;11;-4;0;0;0
757170;KOLOBOK;Gore, Adventure, Indie, Racing;0 - 20,000;44;54;-10;0;0;0
757180;Wolf & Rabbit;Casual, Indie;0 - 20,000;245;24;221;203;203;0
757200;EMERGENCY 3;Casual, Free to Play;0 - 20,000;103;27;76;285;285;2
757210;EMERGENCY 4 Deluxe;Adventure, Casual, Indie;100,000 - 200,000;1201;86;1115;2635;3954;127
757230;Donjon Defense;Action, Casual, Free to Play, Indie;0 - 20,000;1;2;-1;0;0;0
757240;Aimtastic;Action, Adventure, Indie, RPG;200,000 - 500,000;2415;155;2260;116;18;12
757290;On Board;Adventure, Casual, Indie;0 - 20,000;7;18;-11;0;0;0
757300;Truberbrook / Trüberbrook;Casual, Indie;100,000 - 200,000;1169;460;709;237;273;6
757310;Sable;Adventure, Massively Multiplayer, Strategy, Early Access;200,000 - 500,000;2865;449;2416;609;637;39
757320;Atomicrops;Adventure;200,000 - 500,000;974;81;893;516;570;112
757330;qop 2;Adventure;50,000 - 100,000;382;19;363;118;127;1
757350;SAWKOBAN;Adventure;50,000 - 100,000;57;32;25;0;0;1
757380;Ship Ahoy Open BETA;Adventure;20,000 - 50,000;38;6;32;0;0;0
757400;CITY BALLS VR;Adventure, Indie;0 - 20,000;1;0;1;0;0;0
757420;Zombie Crisis: Last One Standing;Adventure;0 - 20,000;5;8;-3;0;0;0
757430;Schwerpunkt;Adventure;0 - 20,000;7;4;3;0;0;0
757440;Crafting Tycoon;Adventure;0 - 20,000;0;10;-10;0;0;0
757450;Samurai of Hyuga Book 3;Casual;0 - 20,000;23;6;17;0;0;0
757480;Broken Reality;Adventure, Indie, Simulation;50,000 - 100,000;1286;82;1204;0;0;2
757490;Mapas do Horizonte - Um jogo para conhecer BH;Casual, Indie;0 - 20,000;10;1;9;1;1;0
757500;Fadeholm;Action, Adventure, Indie;0 - 20,000;0;5;-5;0;0;0
757540;Oedipus Dating Sim;Casual, Indie, Strategy;0 - 20,000;7;3;4;0;0;0
757580;Endless Inside;Violent, Gore, Adventure, Indie, Strategy;0 - 20,000;16;7;9;128;128;0
757590;Life Game;Adventure, Casual, Free to Play, Indie;0 - 20,000;10;12;-2;0;0;0
757630;Big Day;Video Production;20,000 - 50,000;83;61;22;0;0;0
757670;Blitz Freak;Casual, Indie;0 - 20,000;1;1;0;0;0;0
757690;Limit of defense;Animation & Modeling, Audio Production, Design & Illustration;0 - 20,000;1;2;-1;0;0;0
757700;Dungeon's Barrage;Action, RPG;0 - 20,000;18;0;18;0;0;0
757730;Shadowcrawl: The Dark Pilgrimage;Action, Casual, Indie, Simulation, Early Access;0 - 20,000;19;3;16;0;0;0
757780;Sector 452;Action, RPG, Early Access;0 - 20,000;1;0;1;0;0;0
757820;Flowing Lights;Action, Casual, Indie;0 - 20,000;19;2;17;0;0;0
757850;The Grim Ending;Action, Adventure, Indie, RPG, Early Access;0 - 20,000;19;0;19;0;0;0
757860;Elbub;Simulation;0 - 20,000;23;12;11;0;0;0
757870;Australian trip;Gore, Action, Adventure, Indie, Early Access;20,000 - 50,000;27;11;16;0;0;0
757910;Away;Adventure, Casual, Indie, Simulation;0 - 20,000;155;82;73;0;0;0
757990;Disassembly Line;Indie, RPG;0 - 20,000;1;2;-1;0;0;0
758010;Big NEON Tower VS Tiny Square;Adventure, Casual, Free to Play, Massively Multiplayer, RPG, Simulation, Sports, Early Access;50,000 - 100,000;24;1;23;0;0;1
758020;DMD Mars Mission;Action, Simulation, Early Access;0 - 20,000;6;5;1;0;0;0
758050;Internet Simulator;Adventure, Indie, RPG, Simulation, Strategy, Early Access;0 - 20,000;26;32;-6;0;0;0
758080;BloodLust 2: Nemesis;Adventure, Casual, Indie, RPG;0 - 20,000;88;24;64;0;0;3
758090;Monobeno;Action, Free to Play, Sports, Early Access;0 - 20,000;587;26;561;630;1015;2
758100;E-Startup;Action, Adventure, Casual, Indie, RPG;0 - 20,000;80;74;6;0;0;0
758120;RC Fun City;Action, Adventure, Indie;0 - 20,000;18;13;5;0;0;0
758140;The Plague;Adventure, Casual, Indie, Early Access;0 - 20,000;0;1;-1;0;0;0
758150;McRogue;Action, Casual, Indie;0 - 20,000;8;6;2;0;0;0
758170;Krampus Quest;Casual, Indie, Simulation;0 - 20,000;6;3;3;0;0;0
758190;Dragon Cliff;Sexual Content, Violent, Adventure, Casual, Indie, RPG, Simulation;500,000 - 1,000,000;5921;673;5248;3160;1030;4072
758210;Escape Room;Indie, RPG;0 - 20,000;8;23;-15;3;3;0
758220;Osmorrow;Simulation, Sports;0 - 20,000;3;1;2;0;0;0
758250;Taste of Power;Casual, Indie, Simulation, Strategy;0 - 20,000;44;20;24;0;0;0
758280;Drunkenpants;Indie;0 - 20,000;15;0;15;0;0;0
758320;Cursed Lands;Action, Adventure, Indie;0 - 20,000;75;22;53;0;0;4
758330;Shenmue I & II;Casual, Indie, Simulation;100,000 - 200,000;2160;284;1876;592;424;13
758370;Through the Ages;Casual, Indie, Simulation;100,000 - 200,000;1652;171;1481;100;140;138
758400;The Ultimate Heist;Casual, Indie;0 - 20,000;7;9;-2;0;0;0
758410;AO International Tennis;Casual, Indie;0 - 20,000;257;101;156;0;0;1
758440;Last Rose;Animation & Modeling, Design & Illustration, Education, Software Training, Utilities, Game Development;0 - 20,000;13;2;11;0;0;0
758480;Ukrainian ball in search of gas;Free to Play, Indie, Massively Multiplayer, Strategy, Early Access;20,000 - 50,000;680;44;636;23;23;5
758500;Loot Box Quest;Violent, Gore, Action, Adventure, Indie, Strategy, Early Access;0 - 20,000;380;26;354;0;0;0
758530;Sprout;Casual, Indie, Simulation, Sports;100,000 - 200,000;1393;57;1336;12;13;1
758560;Versus World;Adventure, Casual;0 - 20,000;78;10;68;0;0;0
758570;TOMORROW DON'T COME - Puzzling Depression;Casual, Indie, Racing, Sports, Early Access;;;;0;;;
758580;Grim Tales: The Wishes Collector's Edition;Adventure, Racing, Simulation, Sports;0 - 20,000;14;4;10;0;0;0
758590;League of Light: Silent Mountain Collector's Edition;Action, Adventure, Casual;0 - 20,000;6;0;6;0;0;0
758600;Christmas Stories: Hans Christian Andersen's Tin Soldier Collector's Edition;Casual, Free to Play, Simulation;0 - 20,000;13;6;7;0;0;1
758610;Botanica: Earthbound Collector's Edition;Indie, Strategy;0 - 20,000;1;1;0;0;0;0
758620;Shadow Wolf Mysteries: Bane of the Family Collector's Edition;Adventure, Indie, Simulation, Early Access;0 - 20,000;3;0;3;0;0;1
758630;Cadenza: The Kiss of Death Collector's Edition;Adventure, Indie;0 - 20,000;8;0;8;0;0;0
758640;Nevertales: Legends Collector's Edition;Action, Indie;0 - 20,000;4;1;3;0;0;0
758650;Haunted Train: Frozen in Time Collector's Edition;Action, Free to Play;0 - 20,000;1;0;1;0;0;0
758660;NeverBound;Casual, Indie;0 - 20,000;36;4;32;0;0;0
758730;Paw Patrol: On A Roll!;Adventure, Indie;0 - 20,000;279;49;230;342;342;14
758790;Musical Reflex;Indie, RPG, Simulation, Strategy;0 - 20,000;2;3;-1;0;0;0
758870;Kynseed;Action, Adventure, Indie;50,000 - 100,000;1832;424;1408;441;700;209
758880;RedSun RTS;Adventure, Free to Play, Indie;0 - 20,000;12;15;-3;0;0;0
758920;Action Rush;Utilities, Video Production;0 - 20,000;22;27;-5;6718;6718;0
758930;Captain Forever Trilogy;Casual, Indie;20,000 - 50,000;128;15;113;0;0;2
758980;Poker Legends: Texas Hold'em Poker Tournaments;Action, Casual, Indie;50,000 - 100,000;454;137;317;87;106;37
758990;Ancient Warfare 3;Indie;200,000 - 500,000;1882;103;1779;439;439;95
759000;.projekt;Action, Indie;0 - 20,000;123;12;111;0;0;0
759010;Escape;Indie, Strategy;0 - 20,000;7;23;-16;3;6;0
759030;WaywaY;Action, Adventure;0 - 20,000;4;1;3;0;0;0
759040;Planet Guardian VR;Adventure, Indie, RPG, Strategy;0 - 20,000;2;0;2;0;0;0
759060;Ground Runner: Trials;Gore, Adventure, Casual, Indie, Simulation;0 - 20,000;23;10;13;0;0;0
759080;City Eye;Action, Adventure, Indie;0 - 20,000;26;41;-15;0;0;1
759160;Dungeons & Vampires;Utilities;0 - 20,000;22;24;-2;0;0;0
759220;Hinedere Beat;Action, Adventure, Simulation;0 - 20,000;31;1;30;0;0;0
759260;Go All Out;Action, Adventure, Indie, RPG;0 - 20,000;23;8;15;0;0;2
759440;Learn Japanese To Survive! Kanji Combat;Casual, Simulation;20,000 - 50,000;244;40;204;0;0;5
759530;Struckd - 3D Game Creator;Adventure, Simulation;100,000 - 200,000;204;184;20;67;102;0
759540;Wanted Killer VR;Adventure;0 - 20,000;105;21;84;0;0;0
759570;Decay of Logos;Adventure, Casual, Indie;0 - 20,000;111;90;21;20;20;2
759610;House of Evil;Casual, Indie, Simulation;0 - 20,000;36;63;-27;94;94;0
759640;Plug Me;Action, Indie;0 - 20,000;37;4;33;0;0;0
759650;Christmas Puzzle 3;Adventure, Indie, Massively Multiplayer, RPG, Simulation, Strategy, Early Access;0 - 20,000;13;1;12;0;0;0
759740;RIDE 3;Action, Adventure, Indie, RPG, Early Access;200,000 - 500,000;3875;814;3061;3002;5091;43
759750;Doodle God: Alchemy Jam;Action, Adventure, Strategy;0 - 20,000;23;52;-29;0;0;0
759800;Everyday Lite;Action, Racing;0 - 20,000;20;10;10;8;8;0
759830;Gamma Blast;Action, Adventure, Indie, RPG, Simulation, Early Access;0 - 20,000;7;3;4;0;0;0
759840;Battle for Mountain Throne;Violent, Gore, Action, Indie, Simulation, Sports, Early Access;0 - 20,000;1;3;-2;0;0;0
759850;DEBUFF;Action, Indie, Simulation, Early Access;0 - 20,000;4;2;2;0;0;0
759870;HJ: Sacrifice;Action, Indie, Racing, Sports;0 - 20,000;8;32;-24;0;0;0
759920;Souland;Casual, Indie;0 - 20,000;6;0;6;0;0;0
759940;前程似锦 Excellent Expectations;Action, Indie;20,000 - 50,000;782;110;672;244;262;2
759950;Uizuno Blade VR;Strategy;0 - 20,000;4;6;-2;0;0;0
759970;HIBIKAKEYIRONOKISEKI / 裂色的奇迹 / ひびかけ色のキセキ;Adventure, Casual, Indie, Massively Multiplayer, Simulation;50,000 - 100,000;301;32;269;10;10;0
759980;MIMIC;Indie, Simulation;0 - 20,000;3;0;3;0;0;0
760000;AWAKEN：Gunpowder Adventurer Day.Dream;Casual, Indie, Racing, Simulation;0 - 20,000;13;2;11;0;0;0
760010;Flying Turkey;Casual, Indie;0 - 20,000;4;2;2;0;0;0
760030;Dizzy Dungeon;Action, Casual, Free to Play, Indie, Racing;0 - 20,000;16;2;14;0;0;0
760030;Dizzy Dungeon;Casual, Indie;0 - 20,000;16;2;14;0;0;0
760050;Nightwolf: Survive the Megadome;Utilities;0 - 20,000;51;13;38;0;0;0
760060;Mutant Year Zero: Road to Eden;Violent, Action, Indie, Early Access;500,000 - 1,000,000;16615;1707;14908;413;337;51
760120;Your Toy;Action, Adventure, Casual, Indie, Strategy;0 - 20,000;5;11;-6;0;0;0
760220;Chineze;Casual;0 - 20,000;0;2;-2;0;0;0
760300;Ender Story: Chapter 1;Indie, Simulation;0 - 20,000;7;1;6;0;0;0
760320;Gunman Tales;Action;50,000 - 100,000;53;20;33;0;0;0
760330;BYTEPATH;Action, Adventure, Casual, Indie, Strategy, Early Access;50,000 - 100,000;263;18;245;370;370;1
760350;Star Sweet;Adventure, Casual, Indie, Simulation, Sports;20,000 - 50,000;54;34;20;5;5;0
760360;Android John 2.1;Action, Casual, Indie, Simulation, Early Access;0 - 20,000;3;4;-1;0;0;0
760390;Tile Typer;Action, Casual, Indie;0 - 20,000;1;0;1;0;0;0
760400;Audio Drive;Violent, Gore, Action, Indie;0 - 20,000;119;63;56;0;0;1
760410;Don't Be Afraid;Action, Casual, Indie;20,000 - 50,000;372;59;313;536;536;0
760460;WEED;Casual, Indie;20,000 - 50,000;120;96;24;2;2;2
760490;Frontier Runner;Action, Indie;0 - 20,000;21;17;4;1;1;0
760490;Frontier Runner;Violent, Gore, Adventure, Indie;0 - 20,000;21;17;4;1;1;0
760510;Cat Burglar: A Tail of Purrsuit;Adventure, Casual, Indie;500,000 - 1,000,000;316;25;291;187;159;0
760520;Dough;Nudity, Violent, Gore, Action, Adventure, Indie;0 - 20,000;3;1;2;0;0;0
760530;Futurejam;Indie, Strategy;0 - 20,000;6;2;4;0;0;0
760560;Happy New Year Clicker;Casual, Indie, Early Access;0 - 20,000;42;50;-8;0;0;0
760580;INSPACE 2980;Casual, Indie, Simulation;0 - 20,000;4;3;1;0;0;0
760630;Tennis Elbow Manager 2;Action, Casual;0 - 20,000;167;19;148;0;0;13
760640;Tennis Elbow 4;Adventure, Casual, Indie;0 - 20,000;251;20;231;0;0;69
760650;Hammerting;Action, Casual;200,000 - 500,000;1359;837;522;733;551;50
760660;Retro Miami;Nudity, Casual, Indie, Strategy;20,000 - 50,000;17;41;-24;0;0;0
760680;Galaxy Race;Adventure;0 - 20,000;6;11;-5;0;0;0
760710;Astrology and Horoscope Premium;Action, Strategy;0 - 20,000;6;6;0;0;0;0
760800;Cube Life: Island Survival;Audio Production, Software Training, Utilities, Video Production;20,000 - 50,000;112;48;64;6;6;1
760810;Retimed;RPG, Simulation;0 - 20,000;260;50;210;214;238;4
760810;Retimed;Indie, Simulation;0 - 20,000;260;50;210;214;238;4
760860;TRANSCEND;Casual, Indie, Strategy;0 - 20,000;14;14;0;0;0;0
760890;Hello Charlotte EP3: Childhood's End;Casual, Indie, Racing;50,000 - 100,000;1330;19;1311;374;374;13
760900;In the thrall of darkness: The gift of dreams;Casual, Indie, Simulation;0 - 20,000;1;3;-2;0;0;0
760920;ElectricVLab;Indie;0 - 20,000;43;7;36;0;0;1
760960;RocketGirl;Action, Strategy, Early Access;0 - 20,000;6;1;5;0;0;0
760970;Renegade Tabletop Tools System;Indie, Strategy;0 - 20,000;2;0;2;0;0;0
760990;WeakWood Throne;Indie, Strategy;0 - 20,000;44;28;16;0;0;0
761010;Wave Break;Adventure, Indie;0 - 20,000;72;9;63;38;38;0
761030;EARTHLOCK;Action, Indie;50,000 - 100,000;373;133;240;339;415;1
761040;Wolf Gang;Action, Casual, Indie, Simulation, Strategy;0 - 20,000;6;0;6;0;0;0
761100;Jump! Jump! Jump!;Action, Indie;0 - 20,000;7;11;-4;0;0;0
761110;Infinity Escape;Adventure, RPG;0 - 20,000;12;12;0;0;0;0
761130;Stellar Warrior;Action, Adventure, Casual, Free to Play, Indie;0 - 20,000;1;9;-8;10;10;0
761130;Stellar Warrior;Adventure, Indie, RPG, Strategy;0 - 20,000;1;9;-8;10;10;0
761150;Brick Breaker Bunch;Adventure, Casual, Indie;0 - 20,000;2;0;2;0;0;0
761190;1010;Adventure, Indie, RPG, Early Access;0 - 20,000;10;3;7;0;0;0
761220;Live the Guitar;Indie;0 - 20,000;6;3;3;0;0;0
761280;White Pearl;Action, Adventure, RPG, Strategy, Early Access;20,000 - 50,000;52;18;34;1;1;0
761290;Sink or Skim;Sports;0 - 20,000;6;1;5;0;0;0
761300;Horde Of Plenty;Action, Early Access;0 - 20,000;9;1;8;0;0;0
761320;Black Jewel;Action, Adventure, Casual, Indie;0 - 20,000;83;16;67;32;32;0
761350;Booth: A Dystopian Adventure;Casual, Indie, Racing;0 - 20,000;281;26;255;0;0;0
761440;Santa Run;Action, Adventure, Casual, Indie, RPG;0 - 20,000;11;27;-16;9;9;0
761460;Lamplight City;Adventure, Indie, RPG;50,000 - 100,000;538;60;478;656;656;4
761480;Snail Trek - Chapter 3: Lettuce Be;Action, Adventure, Indie, RPG;0 - 20,000;29;0;29;0;0;0
761570;Beard & Axe;Casual, Indie;0 - 20,000;2;1;1;0;0;0
761600;Onimusha: Warlords;Adventure, Indie;100,000 - 200,000;1715;119;1596;157;281;9
761620;Beholder 2;Adventure, Casual, Indie;200,000 - 500,000;4871;657;4214;413;280;44
761640;Home Darkness - Escape?;Adventure, Free to Play, Indie;20,000 - 50,000;12;31;-19;0;0;0
761660;Stickman Destruction 2;Casual, Free to Play, Indie, Simulation;0 - 20,000;14;20;-6;0;0;0
761660;Stickman Destruction 2;Action, Adventure;0 - 20,000;14;20;-6;0;0;0
761670;Grisaia Phantom Trigger Vol.4;Action, Casual, Indie;0 - 20,000;106;2;104;0;0;0
761670;Grisaia Phantom Trigger Vol.4;Action, Casual, Indie;0 - 20,000;106;2;104;0;0;0
761700;Your Diary +;Casual, Indie;0 - 20,000;139;18;121;0;0;0
761720;Can you eat by yourself;Photo Editing;0 - 20,000;0;0;0;0;0;0
761730;non - The First Warp;Web Publishing;0 - 20,000;4;1;3;0;0;0
761760;Till the dawn, waiting;Action, Indie;0 - 20,000;22;8;14;0;0;0
761770;Fire Flight;Action, Indie, Simulation, Sports;0 - 20,000;2;1;1;0;0;0
761790;Parker & Lane: Criminal Justice;Action, Casual, Indie;0 - 20,000;35;25;10;0;0;1
761830;Mr. Prepper;Casual, Indie, Strategy;200,000 - 500,000;3010;588;2422;481;568;65
761880;The Day They Landed;Action, Casual, Indie;0 - 20,000;1;3;-2;0;0;0
761890;Albion Online;Casual, Indie, Simulation, Early Access;2,000,000 - 5,000,000;44645;11213;33432;4031;133;7673
761910;Worbital;Action, Indie, Simulation;0 - 20,000;346;34;312;450;506;3
761920;Zenodeath;Action, Adventure, Indie;0 - 20,000;9;1;8;0;0;0
761930;Code Name: Origin;Indie;0 - 20,000;0;2;-2;0;0;0
761990;Rockochet;Indie, Strategy;0 - 20,000;3;0;3;0;0;0
762030;Mowin' & Throwin';Adventure, Casual;0 - 20,000;21;2;19;0;0;0
762080;Galactic Force;Adventure, Casual;50,000 - 100,000;64;24;40;0;0;0
762100;The Most Challenging Game;Adventure, Casual;0 - 20,000;1;0;1;0;0;0
762110;Meow Wars: Card Battle;Adventure, Casual;0 - 20,000;10;5;5;0;0;0
762120;Nuke Babysitter Simulator | Kim Edition;Casual, Indie, Simulation, Strategy;0 - 20,000;0;3;-3;0;0;0
762130;Namaste Virtual Yoga Retreat;Action, Free to Play, Indie, Strategy, Early Access;0 - 20,000;2;1;1;0;0;0
762150;Rise of the Gunters;Action, Indie;0 - 20,000;0;0;0;0;0;0
762180;Treachery in Beatdown City;Casual, Simulation;20,000 - 50,000;42;12;30;0;0;0
762190;Epic Loon;Casual, Indie, Strategy;0 - 20,000;32;3;29;0;0;0
762220;Afterparty;Action, Adventure, Casual, Indie, RPG;50,000 - 100,000;426;166;260;209;209;6
762240;Fantasy Realm: A Land Torn Asunder;Casual, Indie, Strategy;0 - 20,000;6;0;6;0;0;0
762250;Fire In The Hole;Action;0 - 20,000;0;0;0;0;0;0
762270;Thunder Chase;Casual, Free to Play, Indie, Early Access;0 - 20,000;18;0;18;0;0;0
762360;Hexed;Casual, Free to Play;0 - 20,000;1;0;1;0;0;0
762380;World Apart;Casual;0 - 20,000;7;8;-1;0;0;0
762480;Chinese inn;Adventure, Indie;0 - 20,000;56;22;34;0;0;1
762500;Rhythm Girl;Casual, Indie, Simulation, Strategy;0 - 20,000;22;4;18;0;0;0
762560;ManaRocks;Action, Indie, RPG;50,000 - 100,000;279;79;200;0;0;0
762590;Zombie Derby 2;Adventure, Indie;0 - 20,000;87;19;68;0;0;0
762610;Russian Subway Dogs;Action, Indie, Simulation, Strategy;0 - 20,000;218;4;214;0;0;0
762630;Dark Wish;Casual, Indie;50,000 - 100,000;4;2;2;0;0;0
762650;Depraved;Action, Adventure, Strategy;100,000 - 200,000;687;412;275;476;577;5
762670;Astro Joust;Action, Casual, Indie, Racing, Simulation;0 - 20,000;3;3;0;0;0;0
762680;Double Turn;Adventure, Casual, Free to Play, Indie;0 - 20,000;9;9;0;0;0;0
762830;Telling Lies;Action, Adventure, Racing;50,000 - 100,000;660;346;314;416;514;7
762840;Maquette;Action, Indie;20,000 - 50,000;347;152;195;258;258;1
762850;Cubit;Action, Adventure, Casual, Indie, RPG, Simulation, Early Access;0 - 20,000;4;4;0;0;0;0
762850;Cubit;Action, Adventure, Casual, Indie, Early Access;0 - 20,000;4;4;0;0;0;0
762860;ANti: Virus Destroyer;Action, Indie, Early Access;0 - 20,000;2;0;2;0;0;0
762900;Cars with Guns: It's About Time;Violent, Gore, Action, Indie, RPG, Simulation, Strategy;0 - 20,000;7;5;2;0;0;0
762930;Supipara - Chapter 2 Spring Has Come!;Indie;0 - 20,000;90;0;90;0;0;0
762950;Chess Cubed;Action, Casual, Simulation, Sports;0 - 20,000;7;3;4;0;0;0
762980;Chaotic Void;Action, Indie;0 - 20,000;5;0;5;0;0;0
763000;Super Army of Tentacles 3: The Search for Army of Tentacles 2: Black GOAT of the Woods Edition;Action, Adventure, Indie;0 - 20,000;0;0;0;0;0;0
763010;Lost In Maze;Action, Adventure, Indie, Simulation;0 - 20,000;7;1;6;0;0;0
763030;Nelly Cootalot: Spoonbeaks Ahoy! HD;Action, Adventure, Indie;20,000 - 50,000;135;16;119;0;0;0
763050;Happiness Drops!;Adventure, Casual, RPG, Strategy;0 - 20,000;19;6;13;0;0;0
763070;Overcoming Pain;Casual, Indie;0 - 20,000;18;11;7;0;0;0
763090;Aqua Fish;Action, Casual, Indie, Racing;20,000 - 50,000;30;35;-5;0;0;0
763100;Lumberjack Simulator;Adventure, Casual, Indie, Simulation;0 - 20,000;125;63;62;17;17;1
763200;Volkstein;Casual, Indie;0 - 20,000;7;10;-3;0;0;0
763210;Amelon;Simulation;0 - 20,000;28;9;19;0;0;0
763230;Fruity Smoothie;Adventure, Indie;20,000 - 50,000;183;24;159;22;22;1
763250;The Spectrum Retreat;Casual, Free to Play, Indie, Simulation, Strategy;20,000 - 50,000;175;60;115;164;164;1
763270;Fritz Chess 16 Steam Edition;Adventure, Casual, Indie;0 - 20,000;31;12;19;0;0;6
763290;Riddlord: The Consequence;Indie, RPG;0 - 20,000;40;29;11;0;0;0
763300;GAME TUBE ♛;Action, Indie, Simulation;50,000 - 100,000;10;20;-10;0;0;0
763320;Advanced Mechanized Spacecraft;Action, Free to Play, Indie;0 - 20,000;7;1;6;0;0;0
763340;Brave Hand;Casual, Indie, Simulation, Sports, Early Access;0 - 20,000;24;8;16;0;0;0
763350;Slime Sports;Action, Adventure, Indie;0 - 20,000;8;1;7;0;0;0
763360;Nice Way;Adventure, Casual;20,000 - 50,000;81;27;54;0;0;0
763380;Koikoi;Action, Indie, Early Access;0 - 20,000;5;1;4;0;0;0
763400;Cave Runner;Action, Adventure, Indie, Racing, Early Access;0 - 20,000;22;26;-4;0;0;0
763410;Long Live Santa!;Adventure, Indie, RPG;200,000 - 500,000;2630;364;2266;43;22;2
763430;Front Defense: Heroes;Action, Adventure, Indie, Massively Multiplayer, RPG;0 - 20,000;86;40;46;16;22;0
763490;Precision Archery: Competitive;Adventure, Indie;0 - 20,000;11;28;-17;8;8;0
763520;Hard Place;Adventure, Indie, RPG;0 - 20,000;26;22;4;0;0;0
763550;A Journey Through Valhalla;Adventure, Indie, RPG;0 - 20,000;3;3;0;0;0;0
763610;Freakshow:Anniversary;Adventure, Indie, RPG;0 - 20,000;21;15;6;0;0;0
763630;The Door of Ice 冰封之门;Adventure, Indie, RPG;0 - 20,000;5;8;-3;0;0;0
763650;Comets Wake;Casual, Indie, Simulation, Strategy;0 - 20,000;22;7;15;4;4;0
763680;Miney Company: A Data Racket;Adventure, Casual, Indie, RPG;0 - 20,000;5;1;4;0;0;0
763710;River City Melee Mach!!;Casual, Indie, Strategy;20,000 - 50,000;83;26;57;3;3;2
763720;KeysIn1;Action, Indie;0 - 20,000;5;3;2;0;0;0
763730;Ragtag Adventurers;Adventure, Casual, Free to Play, Indie, RPG;0 - 20,000;8;5;3;0;0;0
763740;NARK THE DRAGON;Indie;20,000 - 50,000;27;36;-9;0;0;0
763750;Minaurs;Casual, Indie, Sports;0 - 20,000;17;6;11;0;0;0
763760;My Coloring Book: Food and Beverage;Action, Adventure, Indie, RPG;20,000 - 50,000;86;19;67;28;28;0
763770;Space Stories: Darth Star;Action, Casual, Racing, Simulation, Sports;50,000 - 100,000;45;17;28;0;0;0
763790;TrainerVR;Action, Adventure, Simulation;0 - 20,000;55;4;51;3;3;0
763810;Jingle;Action;0 - 20,000;6;3;3;0;0;0
763870;Xploquest;Action, Adventure, Indie;0 - 20,000;23;4;19;0;0;0
763890;Wildermyth;Action, Adventure, Indie;200,000 - 500,000;13757;717;13040;1156;703;511
763910;Time Tenshi Paradox: Episode 1;Adventure, Casual, Indie;0 - 20,000;21;6;15;0;0;0
763930;Tally Ho;Adventure, Casual, Free to Play, Indie;0 - 20,000;81;4;77;0;0;1
763950;T-Rex Time Machine;Casual, Indie, Simulation;0 - 20,000;2;4;-2;0;0;0
763970;Leisure Suit Larry 1 - In the Land of the Lounge Lizards;Action, Adventure, Indie, RPG, Early Access;50,000 - 100,000;147;48;99;176;176;19
764010;Insane Cold: Back to the Ice Age;Casual, Indie, Racing;0 - 20,000;53;48;5;0;0;0
764030;Realm Revolutions;Action, Adventure, RPG, Early Access;500,000 - 1,000,000;250;80;170;3064;4723;44
764050;Maelstrom;Indie;200,000 - 500,000;2016;415;1601;217;62;5
764080;GloGo;Adventure, Indie;0 - 20,000;0;0;0;0;0;0
764090;STAR SHREDDERS;Adventure, Indie;0 - 20,000;3;1;2;0;0;0
764110;Flappy Arms;Action, Adventure, Casual, Indie, Sports;0 - 20,000;21;4;17;0;0;0
764180;Cross of Auria;Action, Casual, Indie;0 - 20,000;13;3;10;0;0;0
764230;Shoujo City;Action, Casual, Indie;0 - 20,000;199;25;174;0;0;4
764240;Horse Paradise - My Dream Ranch;Casual;0 - 20,000;28;10;18;0;0;0
764280;Atomic Adam: Episode 1;Utilities;0 - 20,000;15;2;13;0;0;0
764300;Shantae: Half-Genie Hero Ultimate Edition;Action, Adventure, Indie;20,000 - 50,000;649;75;574;685;685;8
764370;Realm of the Ghost King;Casual, Indie, Racing;0 - 20,000;11;0;11;0;0;0
764390;Synced Warriors;Video Production;20,000 - 50,000;1;0;1;0;0;0
764410;Trials of the Gauntlet;Action, Adventure, Casual, Indie;0 - 20,000;31;25;6;0;0;0
764430;The Legend of Bean;Action, Adventure, Casual, Indie, Simulation;100,000 - 200,000;68;21;47;0;0;0
764470;Gear Path;Action, Adventure, Casual, Indie;0 - 20,000;13;4;9;0;0;0
764490;Stickman Jetpack;Action, Indie, Simulation, Sports;20,000 - 50,000;34;18;16;0;0;0
764500;Deep Dark Fight;Nudity, Violent, Indie;0 - 20,000;112;44;68;0;0;0
764510;Phantom Signal — Sci-Fi Strategy Game;Casual, Indie, Racing;50,000 - 100,000;123;19;104;0;0;1
764540;Tall Order;Casual, Indie, Racing;0 - 20,000;1;2;-1;0;0;0
764550;City Builder;Casual, Indie, Strategy;0 - 20,000;2;1;1;0;0;0
764560;Chocolate makes you happy 2;Adventure, Casual, Indie, Strategy;0 - 20,000;83;29;54;28;28;0
764570;Beavers Be Dammed;Free to Play, Massively Multiplayer, Strategy, Early Access;50,000 - 100,000;364;49;315;14;19;34
764580;RealmCraft;Casual, Free to Play, Indie, Strategy;0 - 20,000;34;9;25;0;0;0
764590;Shadow of Loot Box;Action, Indie, Early Access;0 - 20,000;60;13;47;0;0;0
764630;Alien Invaders from the Planet Plorth;Action, Casual, Indie, Sports;0 - 20,000;0;0;0;0;0;0
764670;Sea Dogs;Casual, Indie, Simulation, Strategy;50,000 - 100,000;87;32;55;0;0;5
764720;Oh No! Ninjas!;Indie, Massively Multiplayer, RPG, Strategy;0 - 20,000;2;0;2;0;0;0
764780;Edepth Angel: Pinocchio's Murder;Action, Adventure, Indie;0 - 20,000;3;3;0;0;0;0
764790;The Messenger;Adventure, Indie, RPG;200,000 - 500,000;7746;473;7273;502;523;58
764830;Snowmania;Casual, Indie, Simulation, Strategy;0 - 20,000;6;2;4;0;0;0
764870;Bubblien Pop;Adventure, Casual, Indie, Simulation, Strategy;0 - 20,000;1;0;1;0;0;0
764880;Brazilian Adventure;Action, Casual, Indie, Strategy;0 - 20,000;3;0;3;0;0;0
764890;Match Point;Casual, Indie;0 - 20,000;15;6;9;0;0;0
764920;Fear the Night - 恐惧之夜;Action, Indie;20,000 - 50,000;490;384;106;0;0;5
764990;Whack the Serial Killer 20 Ways plus Neighbour, Burglars...;Adventure;0 - 20,000;44;7;37;88;88;0
765010;Strid;Action, Adventure, Indie, Early Access;0 - 20,000;9;15;-6;0;0;0
765020;Greedy Dungeons;Action, Adventure, Indie, RPG, Strategy;0 - 20,000;0;0;0;0;0;0
765030;樱雪集～Yuyuko's Butterfly Dream;Action, Adventure, Casual, Free to Play, Indie, Massively Multiplayer, RPG, Simulation, Sports, Strategy;0 - 20,000;98;11;87;0;0;0
765040;Defense of the Fantasy Robots;Action, Casual, Simulation;0 - 20,000;1;0;1;0;0;0
765060;pixelBOT EXTREME!;Action, Indie, RPG, Strategy, Early Access;0 - 20,000;26;2;24;0;0;0
765090;Kojou;Action, Adventure, Casual, Indie, Sports, Early Access;0 - 20,000;1;0;1;0;0;0
765100;Labirinto;Indie, Simulation, Strategy;0 - 20,000;94;29;65;0;0;0
765140;S.U.B.;Action, Adventure, Casual, Indie, Massively Multiplayer;0 - 20,000;2;2;0;0;0;0
765160;Weable 2;Adventure;20,000 - 50,000;44;20;24;3;3;0
765170;CRAZY BIGHEADS;Adventure;0 - 20,000;3;0;3;0;0;0
765180;SCP-087: Recovered document;Adventure;0 - 20,000;40;52;-12;0;0;0
765210;Your Royal Gayness;Indie;0 - 20,000;86;26;60;0;0;0
765230;Unrect;Casual, Indie;0 - 20,000;19;5;14;0;0;0
765240;Daydream;Adventure, Indie;0 - 20,000;0;1;-1;0;0;0
765250;Mind the Vikings;Indie;0 - 20,000;37;43;-6;0;0;0
765260;Overhead;Simulation, Education;0 - 20,000;16;11;5;0;0;0
765290;Alien Food Frenzy;Action, Adventure, RPG;0 - 20,000;1;5;-4;0;0;0
765320;Planetarium 2 - Zen Odyssey;Casual, Indie, Simulation;0 - 20,000;7;4;3;0;0;0
765350;Quirky Crook;Adventure, Indie, RPG;0 - 20,000;3;0;3;0;0;0
765360;Clumsy Knight Vs. Skeleton Remastered;Action, Adventure, Indie;0 - 20,000;17;9;8;0;0;0
765380;Internal Light VR;Adventure, Indie;0 - 20,000;26;5;21;0;0;0
765390;The Darkness;Casual, Indie, Simulation, Strategy;0 - 20,000;6;27;-21;0;0;0
765400;Christmas Tale - Visual Novel;Action, Casual, Indie;0 - 20,000;4;11;-7;0;0;0
765410;Bean Battles;Casual, Indie, Early Access;100,000 - 200,000;8072;450;7622;218;222;49
765450;Tank Brawl 2: Armor Fury;Casual, Free to Play, Indie, Simulation;20,000 - 50,000;19;10;9;0;0;0
765460;Atoms;Casual, Indie, Simulation;0 - 20,000;8;4;4;0;0;0
765470;The Great Fantasy Struggle;Adventure, Casual;0 - 20,000;4;2;2;0;0;0
765490;Spectrum Break;Casual;0 - 20,000;19;1;18;0;0;0
765520;Billy;Sports;0 - 20,000;2;0;2;0;0;0
765530;Fall Down;Action, RPG;0 - 20,000;7;10;-3;0;0;0
765530;Fall Down;Adventure, Indie;0 - 20,000;7;10;-3;0;0;0
765560;Pro Strategy Football 2018;Simulation, Early Access;0 - 20,000;4;2;2;0;0;0
765570;Orcz Evolve VR;Action, RPG, Sports, Early Access;0 - 20,000;2;3;-1;0;0;0
765590;Co-op SNEK Online;Action, Adventure, Indie;0 - 20,000;28;5;23;0;0;0
765610;Hex-Up;Adventure, Indie;0 - 20,000;38;5;33;0;0;0
765620;Last Hope;Utilities;0 - 20,000;2;7;-5;1;1;0
765630;The Dead Cloud Forest;Utilities;0 - 20,000;3;3;0;0;0;0
765640;Change;Casual, Indie;50,000 - 100,000;351;27;324;102;102;0
765650;TSUKUMOHIME;Action, Adventure, Indie;20,000 - 50,000;98;37;61;0;0;0
765690;Dark Strokes: The Legend of the Snow Kingdom Collector’s Edition;Casual, Indie, Simulation;0 - 20,000;101;5;96;0;0;2
765710;Light Bearers;Action, Adventure, Casual, Indie, Strategy, Early Access;200,000 - 500,000;1014;116;898;184;148;7
765730;Wand Wars VR;Action, Indie;0 - 20,000;2;4;-2;0;0;0
765770;Forest Legends: The Call of Love Collector's Edition;Simulation, Sports, Early Access;0 - 20,000;60;14;46;0;0;0
765780;Little Smart Planet;Adventure, Casual, Indie, Simulation;0 - 20,000;1;0;1;0;0;0
765790;Legend of Long Night;Casual, Indie, Simulation;0 - 20,000;3;3;0;0;0;0
765800;Agents: Biohunters;Violent, Gore, Action, Indie;20,000 - 50,000;103;178;-75;0;0;0
765810;Mars Horizon;Adventure, Free to Play, Massively Multiplayer, RPG, Strategy;200,000 - 500,000;2059;386;1673;413;596;42
765840;Leisure Suit Larry 2 - Looking For Love (In Several Wrong Places);Violent, Gore, Action, Casual, Indie;20,000 - 50,000;47;21;26;0;0;0
765860;Leisure Suit Larry 5 - Passionate Patti Does a Little Undercover Work;Action, Casual, Indie;20,000 - 50,000;26;13;13;0;0;0
765870;Leisure Suit Larry - Wet Dreams Don't Dry;Action, Adventure, Indie;50,000 - 100,000;1166;192;974;601;725;49
765880;The Occupation;Action, Adventure, RPG;20,000 - 50,000;196;116;80;74;74;0
765880;The Occupation;Adventure, Indie, RPG;20,000 - 50,000;196;116;80;74;74;0
765890;Leisure Suit Larry 7 - Love for Sail;Action, Casual;20,000 - 50,000;146;25;121;19;19;7
765900;Leisure Suit Larry - Magna Cum Laude Uncut and Uncensored;Casual, Indie;50,000 - 100,000;362;114;248;38;73;37
765910;Leisure Suit Larry 6 - Shape Up Or Slip Out;Casual, Indie, Simulation;20,000 - 50,000;49;13;36;0;0;0
765940;SOK;Action, Indie;0 - 20,000;101;12;89;0;0;0
765950;Project Glitch;Action, Casual, Indie, Sports;0 - 20,000;4;4;0;0;0;0
766000;Kenshō;Casual, Indie;0 - 20,000;47;7;40;0;0;0
766010;Slime-san: Sheeple’s Sequel;Casual, Indie;0 - 20,000;1;0;1;0;0;0
766040;Gloom: Digital Edition;Casual, Indie, RPG, Simulation;100,000 - 200,000;59;105;-46;48;75;0
766070;Apperception;Action, Casual, Indie;0 - 20,000;0;1;-1;0;0;0
766090;We Walked In Darkness;Violent, Gore, Action, Adventure, Indie;20,000 - 50,000;20;19;1;20;20;0
766110;Félix VR;Casual, Indie;0 - 20,000;11;6;5;0;0;0
766150;The Tension;Indie;0 - 20,000;3;0;3;0;0;0
766210;Wargs;Casual, Free to Play, Indie, Simulation;0 - 20,000;2;3;-1;0;0;0
766250;Kaz Ball;Sexual Content, Violent, Action, Indie, Early Access;0 - 20,000;21;3;18;0;0;0
766250;Kaz Ball;Racing, Simulation, Sports;0 - 20,000;21;3;18;0;0;0
766280;A Light in the Dark;Casual, Indie;50,000 - 100,000;1500;104;1396;187;187;2
766300;Mazetools Soniface Lab;Indie, RPG, Strategy, Early Access;0 - 20,000;5;0;5;0;0;0
766320;The Mage's Tale;Indie, Strategy, Early Access;0 - 20,000;113;38;75;202;352;0
766320;The Mage's Tale;Adventure, Indie;0 - 20,000;113;38;75;202;352;0
766360;Conference in VR;Adventure, Indie, RPG;0 - 20,000;0;0;0;0;0;0
766370;Dying Light: Bad Blood;Adventure, Indie, RPG;100,000 - 200,000;2528;1092;1436;305;250;7
766420;Neckbeards: Silly Squadron;Action, Adventure, Indie;0 - 20,000;1;1;0;0;0;0
766430;Dolla World;Casual, Indie;0 - 20,000;5;2;3;0;0;0
766460;Trireme Commander;Adventure;0 - 20,000;0;2;-2;0;0;0
766500;The Hordes of the Dead;Violent, Gore, Action, Adventure, Indie;0 - 20,000;5;4;1;0;0;0
766560;The Fruitless Flower 雾雨中的徒花;Indie;0 - 20,000;90;6;84;0;0;0
766570;Russian Fishing 4;Action, Adventure, Indie;2,000,000 - 5,000,000;22275;6532;15743;3490;46;7715
766600;Amazing Human Simulator;Action, Racing, Simulation;0 - 20,000;22;14;8;0;0;0
766620;Gambit Heart;Action, Casual, Indie;0 - 20,000;0;1;-1;0;0;0
766630;Dust and Salt;Sexual Content, Nudity, Casual, Indie, Simulation;0 - 20,000;57;10;47;0;0;0
766650;D.R.I.L.L.;Action, Indie;0 - 20,000;12;2;10;0;0;0
766680;Punch Line;Casual, Indie;0 - 20,000;42;18;24;0;0;0
766700;PearsAndGrayWitch;Action, Casual, Indie, Sports;0 - 20,000;7;10;-3;0;0;0
766700;PearsAndGrayWitch;Action, Adventure;0 - 20,000;7;10;-3;0;0;0
766740;Maze Of Adventures;Action, Early Access;0 - 20,000;20;1;19;0;0;0
766740;Maze Of Adventures;Action, Indie;0 - 20,000;20;1;19;0;0;0
766780;STAX;Action, Casual, Indie, Racing, Early Access;0 - 20,000;7;1;6;0;0;0
766850;Vaporwave Simulator;Action, Adventure, Indie, RPG;0 - 20,000;54;29;25;0;0;0
766910;E-Ball;Casual, Massively Multiplayer, Simulation, Strategy;0 - 20,000;1;0;1;0;0;0
766940;Snares of Ruin;Casual, Indie;0 - 20,000;41;4;37;122;122;0
767010;Agent X: Equation Rider;Adventure, Casual, Indie, Sports;0 - 20,000;1;0;1;0;0;0
767020;Shooting Sports Gun Club;Action, Adventure;0 - 20,000;3;1;2;0;0;1
767030;Trivia Vault: Technology Trivia Deluxe;Action, Adventure, Indie, RPG;0 - 20,000;37;31;6;3;5;0
767030;Trivia Vault: Technology Trivia Deluxe;Nudity, Adventure, Casual, Indie, RPG, Early Access;0 - 20,000;37;31;6;3;5;0
767050;Last Day of FEAR;Casual, Indie, Simulation;0 - 20,000;77;25;52;0;0;0
767100;Super Poop;Action, Adventure, Casual, Indie;0 - 20,000;22;16;6;0;0;0
767110;Anime Girls VR;Adventure, Casual, Indie;0 - 20,000;8;13;-5;0;0;0
767130;Virtual Reality Girls 2;RPG, Strategy;0 - 20,000;2;7;-5;0;0;0
767170;Dolphins-cyborgs and open space;Action, Indie;0 - 20,000;26;33;-7;0;0;0
767200;Chinese Ink Painting Puzzle & Creator / 國畫拼圖創作家;Indie, Simulation;20,000 - 50,000;17;1;16;0;0;1
767240;BASIC8;Adventure, Casual, Indie, Simulation;0 - 20,000;27;7;20;0;0;0
767300;War of Conquest;Casual, Indie, Simulation;0 - 20,000;14;13;1;0;0;0
767300;War of Conquest;Animation & Modeling, Design & Illustration;0 - 20,000;14;13;1;0;0;0
767310;Brutal Inventions;Action, Adventure, Casual, Indie;0 - 20,000;9;12;-3;0;0;0
767330;Indoor Rock Climbing VR;Violent, Gore, Action, Adventure, Casual;0 - 20,000;2;4;-2;0;0;0
767340;Minion Forest;Casual, Indie, Simulation, Early Access;0 - 20,000;12;9;3;0;0;0
767360;Monster League;Casual, Indie;0 - 20,000;53;9;44;0;0;0
767390;Dakar 18;Violent, Action, Indie;50,000 - 100,000;683;318;365;105;150;5
767400;弹炸人2222;Adventure, Casual, Indie;0 - 20,000;11;3;8;0;0;0
767410;MightyIronBall;Indie, Simulation, Strategy;0 - 20,000;3;0;3;0;0;0
767420;Wauies - The Pet Shop Game;Action, Adventure, Casual, Indie, Simulation;100,000 - 200,000;196;102;94;9;9;5
767460;Technotron Defense;Casual, Free to Play, Indie, Simulation, Early Access;0 - 20,000;25;5;20;0;0;0
767490;Last Wood;Free to Play, Indie;20,000 - 50,000;375;166;209;178;268;4
767500;Once in Yaissor 2;Indie, Massively Multiplayer, RPG, Simulation, Early Access;0 - 20,000;36;19;17;18;18;0
767550;TopShot: Darkness;Adventure, Casual, Indie;0 - 20,000;0;0;0;0;0;0
767560;War Robots;Utilities, Early Access;1,000,000 - 2,000,000;10135;6051;4084;1643;55;1823
767590;Raining blocks;Adventure, Indie, RPG;0 - 20,000;20;4;16;0;0;0
767660;Orphan Age;Indie, RPG, Strategy;0 - 20,000;0;0;0;0;0;0
767680;Domino Effect;Adventure, Casual, Indie, RPG;0 - 20,000;3;0;3;0;0;0
767690;Heart of the Emberstone: Coliseum;Action, Adventure, Indie, Massively Multiplayer, RPG, Early Access;20,000 - 50,000;60;7;53;0;0;0
767800;Struggle For Talyria;Adventure, Casual, Indie;0 - 20,000;5;1;4;0;0;0
767810;Amaze: Interactive VR Movies;Action, Adventure, Indie;50,000 - 100,000;61;23;38;6;6;0
767840;Meteorite Defense Command;Casual, Indie;0 - 20,000;3;2;1;0;0;0
767870;Dark Noid;Adventure, Casual, Indie, Strategy;0 - 20,000;9;1;8;0;0;0
767930;Assault Spy;Action, Casual, Indie, Early Access;0 - 20,000;633;52;581;272;272;1
767960;Math RTS;Indie, Strategy;0 - 20,000;1;3;-2;0;0;0
767970;Inhumanus;Action, Casual, Indie;0 - 20,000;20;8;12;0;0;0
767980;Multi-Quest;Indie;0 - 20,000;4;2;2;0;0;0
768020;The mysterious ship（诡船谜案）;Adventure, Casual, Indie, RPG, Simulation, Early Access;0 - 20,000;6;2;4;0;0;0
768060;The Warrior Of Treasures;Simulation, Sports, Early Access;0 - 20,000;31;13;18;0;0;0
768090;Amatarasu Riddle Star;Casual, Indie, Simulation, Sports, Early Access;0 - 20,000;36;2;34;0;0;0
768100;GizmoVR Video Player;Action;100,000 - 200,000;251;124;127;31;41;12
768110;Dawn City;Action, Massively Multiplayer, RPG;0 - 20,000;1;2;-1;0;0;0
768130;Aiso;Action, Indie;0 - 20,000;3;7;-4;0;0;0
768170;"""Medieval Real Estate""";Indie;0 - 20,000;3;26;-23;0;0;0
768180;Truck Driver;Casual, Indie, RPG, Simulation, Strategy, Early Access;0 - 20,000;67;35;32;0;0;2
768270;Lisssn;Indie, Simulation, Early Access;0 - 20,000;14;3;11;0;0;0
768290;Snow White Solitaire. Charmed Kingdom;Strategy;0 - 20,000;45;6;39;0;0;2
768300;Zhulik.exe;Adventure, Indie;20,000 - 50,000;59;20;39;0;0;1
768310;Er-Spectro;Casual, RPG, Simulation, Strategy;0 - 20,000;11;12;-1;0;0;0
768370;New Dawn;Action;0 - 20,000;86;75;11;0;0;0
768450;NUTS;Action, Indie;100,000 - 200,000;467;64;403;166;215;5
768460;Areia: Pathway to Dawn;Action, Adventure, Casual, Indie;0 - 20,000;53;10;43;0;0;0
768470;Battlemage;Strategy;0 - 20,000;9;3;6;0;0;0
768480;Chamber of the Sci-Mutant Priestess;Action, Adventure, Indie, Strategy;0 - 20,000;15;10;5;0;0;0
768520;Red Solstice 2: Survivors;Action, Adventure, Casual, Indie;200,000 - 500,000;2019;813;1206;2873;2944;80
768540;Dinosaurs Prehistoric Survivors;Casual, Indie, Strategy, Early Access;0 - 20,000;44;28;16;0;0;0
768550;Zanshin;Casual, Indie;0 - 20,000;9;7;2;0;0;0
768570;Uncanny Islands;Adventure, Indie;0 - 20,000;0;4;-4;0;0;0
768580;Witchball;Action, Indie, Strategy;0 - 20,000;8;1;7;0;0;0
768590;BOX align;Software Training, Early Access;0 - 20,000;26;1;25;0;0;0
768630;Zyxia: Neon Termination;Indie, Simulation, Strategy;0 - 20,000;0;1;-1;0;0;0
768640;Red Hot Ricochet;Adventure, Casual, Indie, Strategy;0 - 20,000;4;0;4;0;0;0
768740;QuartoⒸ;Action;20,000 - 50,000;2;0;2;0;0;0
768750;MonteCrypto: The Bitcoin Enigma;Action, Adventure, Casual, Indie;100,000 - 200,000;128;145;-17;0;0;0
768770;IndustrialVR - Hoover Dam;Animation & Modeling, Design & Illustration, Education, Utilities, Early Access;0 - 20,000;3;1;2;0;0;0
768800;Race;Action, Adventure;20,000 - 50,000;105;50;55;9;13;0
768820;Free Yourself - A Gravity Puzzle Game Starring YOU!;Action, Indie;0 - 20,000;3;2;1;0;0;0
768880;Beach Rules;Action, Indie, Simulation;0 - 20,000;20;1;19;0;0;0
768970;ModLab;Casual;0 - 20,000;41;4;37;0;0;1
768990;X-Fire VR;Adventure, Casual, Indie;0 - 20,000;6;7;-1;0;0;0
769020;Ye Fenny - Revenge of the Evil Good Shepherd;Casual, Indie, Simulation, Strategy;0 - 20,000;12;1;11;0;0;0
769030;Twine3D;Action, Adventure, Indie;0 - 20,000;12;12;0;0;0;0
769030;Twine3D;Indie, Simulation, Strategy, Early Access;0 - 20,000;12;12;0;0;0;0
769060;Dab on 'em Haterz;Adventure, Free to Play;0 - 20,000;10;9;1;0;0;0
769080;The Little War;Action, Adventure;0 - 20,000;19;9;10;0;0;0
769110;Barbarian Souls;Adventure, Indie;0 - 20,000;33;61;-28;18;18;0
769150;Casino Slot Machines;Casual, Indie;0 - 20,000;6;10;-4;0;0;0
769160;Sol Galaxy Defender;Violent, Action, Adventure, Casual, Indie, RPG, Strategy;0 - 20,000;5;0;5;0;0;0
769170;Flinch;Adventure;0 - 20,000;1;1;0;0;0;0
769200;Click&Fight;Adventure;20,000 - 50,000;15;28;-13;0;0;0
769220;TRAFICO;Action, Indie, RPG, Strategy;0 - 20,000;10;9;1;8;8;0
769320;Invasher;Adventure, Casual, Indie, Simulation;0 - 20,000;29;0;29;0;0;0
769340;Zomby Soldier;Audio Production, Utilities;0 - 20,000;16;21;-5;4;4;0
769360;Harts;Adventure, Casual, Indie, Simulation;0 - 20,000;42;36;6;36;36;0
769360;Harts;Action, Indie;0 - 20,000;42;36;6;36;36;0
769370;Dragon Boar and Lady Rabbit;Adventure, Casual, Indie, Strategy;0 - 20,000;30;14;16;0;0;0
769390;Xmas Zombie Rampage 2;Action, Adventure, Indie;0 - 20,000;1;6;-5;0;0;0
769410;Electromaze Tower Defense;Violent, Action, Casual;0 - 20,000;28;9;19;0;0;0
769420;JuVentures;Adventure, Casual, Indie, Simulation;0 - 20,000;29;2;27;0;0;0
769440;Beach Restaurant;Action, Adventure, Indie;0 - 20,000;38;45;-7;0;0;0
769520;Abyss Crew;Adventure, Casual, Indie, Simulation;0 - 20,000;7;0;7;0;0;0
769540;Beat Miner;Sexual Content, Nudity, Adventure, Indie;0 - 20,000;4;5;-1;0;0;0
769550;East 73: Magenta Fairytale;Action, Adventure, Indie;0 - 20,000;113;10;103;0;0;1
769560;月圆之夜 (Night of Full Moon);Action, Casual, Indie;500,000 - 1,000,000;6761;918;5843;1554;526;475
769580;Kingdom of Blades;Sexual Content, Free to Play, Indie, Simulation;0 - 20,000;5;1;4;0;0;0
769590;Play Cube with Uncle Billy;Casual, Indie, Early Access;0 - 20,000;11;5;6;0;0;0
769630;紅蜘蛛外伝：暗戦;Adventure, Casual, Simulation;100,000 - 200,000;4;2;2;0;0;0
769640;Lordian: Karma;Casual, Indie;0 - 20,000;2;2;0;0;0;0
769670;Gecata by Movavi 5 - Game Recording Software;RPG;0 - 20,000;332;143;189;0;0;24
769680;愛神餐館2;Adventure, Indie, RPG;0 - 20,000;51;0;51;0;0;0
769690;Reading Simulator;Adventure, Indie;0 - 20,000;55;41;14;0;0;0
769720;Island of Deception;Action, Casual, Indie, RPG;0 - 20,000;100;62;38;82;82;0
769730;Awkward;Indie;0 - 20,000;56;18;38;378;378;5
769840;Muddledash;Casual, Indie;0 - 20,000;47;8;39;2;2;0
769910;Flipped On;Action, Indie, Racing;0 - 20,000;12;2;10;0;0;0
769910;Flipped On;Action, Adventure, Casual, Indie;0 - 20,000;12;2;10;0;0;0
769920;Odysseus Kosmos and his Robot Quest: Episode 1;Action, Adventure, Indie;20,000 - 50,000;306;87;219;82;27;0
769930;DwarVRs;Violent, Action, Indie;0 - 20,000;1;1;0;0;0;0
769940;Fantasy Defense;Casual, Indie, Massively Multiplayer, Strategy, Early Access;0 - 20,000;13;15;-2;0;0;0
769950;Panzer Strategy;Action, Indie;20,000 - 50,000;305;160;145;0;0;3
769970;Bad Dream: Fever;Action, Adventure, Indie;50,000 - 100,000;686;165;521;195;201;0
769980;Lock Her Up: The Trump Supremacy;Adventure, Indie;0 - 20,000;16;7;9;0;0;0
770010;Bacon Roll;Action, Indie, Early Access;0 - 20,000;1;0;1;0;0;0
770020;Royal Tumble;RPG, Early Access;0 - 20,000;8;5;3;0;0;0
770050;Castle Clamber;Education;0 - 20,000;5;2;3;0;0;0
770070;Swords and Sandals 5 Redux: Maximus Edition;;20,000 - 50,000;101;48;53;0;0;5
770090;La Camila: A VR Story;Action, Indie, RPG;20,000 - 50,000;42;10;32;0;0;0
770100;One Deck Dungeon;Violent, Action, Simulation;100,000 - 200,000;531;138;393;385;385;6
770110;Twilight Path;Action, Early Access;0 - 20,000;119;23;96;0;0;0
770120;Yoltrund;Action, Casual, Indie, Strategy;0 - 20,000;3;0;3;0;0;0
770160;Seishin - Virtual Rhythm;Casual, Indie, RPG;0 - 20,000;4;3;1;0;0;0
770200;Squally;Action, Adventure, Indie;0 - 20,000;64;21;43;0;0;0
770240;PRO EVOLUTION SOCCER 2019;Action, Indie;200,000 - 500,000;3194;2720;474;7636;8249;114
770270;Warbot;Utilities;0 - 20,000;4;5;-1;0;0;0
770320;Zazmo Arcade Pack;Indie, Simulation, Strategy, Early Access;0 - 20,000;3;5;-2;0;0;0
770350;PIXEL DRIFT;Casual, Indie;20,000 - 50,000;35;44;-9;0;0;0
770360;Lowpoly Hero;Adventure, Indie, RPG, Strategy;0 - 20,000;1;0;1;0;0;0
770370;Adventures of Dragon;Indie, Simulation, Strategy;0 - 20,000;10;7;3;0;0;0
770380;Army of Tentacles: (Not) A Cthulhu Dating Sim: Black GOAT of the Woods Edition;Action, Strategy;0 - 20,000;1;0;1;0;0;0
770390;Draugen;Action, Casual, Indie;50,000 - 100,000;1293;428;865;4274;4274;2
770400;Fairy of the treasures;Casual, Indie;0 - 20,000;52;80;-28;0;0;0
770440;Hangover;Action, Indie, Early Access;100,000 - 200,000;71;69;2;1;1;0
770460;The Dummy Experiment;Adventure, Indie;20,000 - 50,000;159;87;72;9;12;0
770490;Death in the Water;Simulation, Sports;0 - 20,000;87;36;51;0;0;5
770490;Death in the Water;Adventure, Casual, RPG;0 - 20,000;87;36;51;0;0;5
770500;Goblin Gearshop;Action, Adventure, Casual, Indie, RPG;50,000 - 100,000;151;51;100;15;19;2
770520;Boomer Rampage;Casual, Indie, Simulation, Strategy;0 - 20,000;3;0;3;0;0;0
770560;Overlook: Local multiplayer game - up to 16 players;Action, Casual, Indie, Early Access;0 - 20,000;0;3;-3;0;0;0
770600;Memento of Spring;Action, Adventure, Indie, Simulation;0 - 20,000;34;2;32;0;0;0
770610;Photo & Graphic Designer 15 Steam Edition;Action, Adventure, Massively Multiplayer, Early Access;0 - 20,000;3;2;1;0;0;1
770620;Web Designer 15 Premium Steam Edition;Violent, Gore, Action, Adventure;0 - 20,000;19;17;2;0;0;0
770630;Boo! Greedy Kid;Adventure, Indie, Simulation;0 - 20,000;38;2;36;0;0;0
770660;Thetaball;Action, Adventure, Free to Play;0 - 20,000;4;0;4;0;0;0
770790;FormFish;Action, Adventure, Casual, Indie;0 - 20,000;0;1;-1;0;0;0
770790;FormFish;Indie, Simulation, Sports;0 - 20,000;0;1;-1;0;0;0
770810;Good Pizza, Great Pizza - Cooking Simulator Game;Casual, Indie, Strategy;20,000 - 50,000;1341;132;1209;2340;2340;79
770810;Good Pizza, Great Pizza - Cooking Simulator Game;Adventure, Casual, Indie;20,000 - 50,000;1341;132;1209;2340;2340;79
770820;Factory Hiro;Action, Casual, Indie;0 - 20,000;8;0;8;0;0;0
770830;Alien Revival - Episode 1 - Duty Calls;Adventure, Indie;0 - 20,000;0;2;-2;0;0;0
770850;DUNKYPUNG;Video Production;0 - 20,000;8;1;7;0;0;0
770860;Annwn: the Otherworld;Adventure;0 - 20,000;12;2;10;0;0;0
770870;Queen's Tales: Sins of the Past Collector's Edition;Adventure, Indie;0 - 20,000;3;0;3;0;0;0
770880;Love Story: The Beach Cottage;Action, Indie, Simulation;0 - 20,000;1;0;1;0;0;0
770900;Off The Record: Liberty Stone Collector's Edition;Indie, Simulation, Audio Production, Early Access;0 - 20,000;3;0;3;0;0;0
770920;Haunted Legends: The Undertaker Collector's Edition;Casual, Free to Play, Indie;0 - 20,000;2;2;0;0;0;1
771010;Containment;Action, Indie, Simulation;0 - 20,000;42;7;35;0;0;0
771060;Iron League;Action, Casual, Indie, Racing, Simulation, Sports, Strategy;200,000 - 500,000;581;228;353;92;125;0
771070;Infinos Gaiden;Utilities;0 - 20,000;65;1;64;0;0;0
771100;Talk to Saki;Casual, Free to Play, Indie, Racing, Sports;0 - 20,000;4;2;2;0;0;0
771120;Rotator;Adventure, Indie;0 - 20,000;1;1;0;0;0;0
771130;Sad City 42;Casual, Racing, Early Access;0 - 20,000;13;26;-13;0;0;0
771240;YumeCore;Indie, Simulation;0 - 20,000;160;9;151;0;0;0
771250;Doodle God: Mighty Trio;Indie;20,000 - 50,000;87;44;43;300;300;0
771310;Welcome to Light Fields;Casual;20,000 - 50,000;253;11;242;24;44;0
771320;Amazing Trivia;Action, Casual, Indie, Strategy;0 - 20,000;11;7;4;0;0;0
771340;Kansei;Casual, Indie, Simulation, Sports;0 - 20,000;10;0;10;0;0;0
771350;Achievement Clicker 2018;Adventure, Casual, Indie;20,000 - 50,000;479;141;338;45;49;1
771370;Confederate Express;Casual, Indie, Strategy;0 - 20,000;7;38;-31;0;0;0
771370;Confederate Express;Action, Adventure;0 - 20,000;7;38;-31;0;0;0
771380;Yousei;Casual, Indie;0 - 20,000;8;0;8;0;0;0
771400;ESCAPE FROM VOYNA:  Tactical FPS survival;Casual, Indie, Strategy;0 - 20,000;0;9;-9;0;0;0
771400;ESCAPE FROM VOYNA:  Tactical FPS survival;Action, Adventure, Casual, Indie, RPG;0 - 20,000;0;9;-9;0;0;0
771410;You Will Never Get This Achievement;Casual, Indie, Strategy;20,000 - 50,000;93;27;66;0;0;0
771420;Primal Light;Casual, Indie;0 - 20,000;288;53;235;4;4;1
771430;Evolva;Casual, Indie, Strategy;200,000 - 500,000;28;3;25;0;0;0
771450;ERROR: Human Not Found;Adventure, Indie;0 - 20,000;44;6;38;0;0;0
771470;Stage Fright;Action, Adventure, Casual, Indie, Strategy;0 - 20,000;6;10;-4;0;0;0
771500;The Intern;Action, Adventure, Casual;0 - 20,000;13;12;1;0;0;0
771530;Take That;Adventure, Casual, Indie, RPG, Strategy;0 - 20,000;69;21;48;0;0;0
771540;Banshee Force;Action, Casual, Indie;0 - 20,000;1;0;1;0;0;0
771570;Zombie City;Action, Adventure, Casual, Indie, RPG, Strategy, Early Access;0 - 20,000;19;7;12;0;0;0
771610;NeoBalls;Casual, Indie, Simulation, Strategy, Early Access;20,000 - 50,000;48;41;7;101;101;0
771670;VR_PlayRoom;Action, Indie, Strategy, Early Access;0 - 20,000;4;3;1;0;0;0
771680;Shield Impact;Adventure;0 - 20,000;58;14;44;0;0;0
771690;Fimbul;Casual, Indie;0 - 20,000;21;12;9;0;0;0
771710;.T.E.S.T: Expected Behaviour — Sci-Fi 3D Puzzle Quest;Action, Indie;20,000 - 50,000;62;21;41;16;16;0
771770;Isles of Etherion;Indie;0 - 20,000;32;18;14;0;0;0
771810;The spy who shot me;Adventure, Indie;0 - 20,000;219;46;173;82;147;1
771820;Rookie Math Pro;Casual, Indie;0 - 20,000;1;2;-1;0;0;0
771840;Royal Casino: Video Poker;Casual, Indie, Simulation, Strategy, Early Access;50,000 - 100,000;81;23;58;0;0;1
771860;Jelly Escape;Action, Adventure, Casual, Indie, Simulation;0 - 20,000;4;0;4;0;0;0
771920;TOGETHER VR;Action, Free to Play, Massively Multiplayer, RPG;20,000 - 50,000;204;110;94;35;35;2
771950;SUMETRICK;Simulation;50,000 - 100,000;317;77;240;0;0;3
771960;Lily 白き百合の乙女たち Lisblanc;Adventure, Casual, Indie;0 - 20,000;0;0;0;0;0;0
772060;Harvester of Dreams : Episode 1;Casual, Indie;0 - 20,000;18;4;14;0;0;0
772070;Harvest Seasons;Violent, Gore, Adventure, Indie;100,000 - 200,000;220;138;82;15;18;0
772080;Mind Portal;Casual, Indie, Simulation, Strategy, Early Access;0 - 20,000;17;14;3;0;0;0
772090;Once upon a Dungeon;Action, Adventure, Indie;0 - 20,000;35;4;31;0;0;1
772100;Dexterity;Adventure, RPG;0 - 20,000;0;5;-5;0;0;0
772110;Asteroidiga;Action, Indie;0 - 20,000;0;3;-3;0;0;0
772160;4 for the Money Demo;Action;20,000 - 50,000;57;5;52;0;0;0
772180;Cricket Club;Action, Adventure;0 - 20,000;104;9;95;0;0;0
772200;Mortal Manor;Action, Adventure, Simulation, Strategy;0 - 20,000;14;4;10;0;0;0
772210;Committed: Mystery at Shady Pines - Premium Edition;Action, Adventure;0 - 20,000;2;0;2;0;0;0
772220;Arbiter;Action, Adventure, RPG;0 - 20,000;3;2;1;0;0;0
772230;跳跃2/LeapII;Action, Strategy;0 - 20,000;14;0;14;0;0;0
772240;The Treasure Seekers of Lady Luck;RPG;0 - 20,000;4;1;3;0;0;0
772270;Blocked and Loaded;Action, Casual, Indie;0 - 20,000;93;8;85;0;0;0
772290;Rainswept;Action, Indie, Early Access;0 - 20,000;204;25;179;0;0;1
772300;To the City of the Clouds;Action, Adventure, Free to Play, Indie;0 - 20,000;0;3;-3;0;0;0
772320;Yeti's Parole Officer;Adventure, Casual, Indie, Simulation;0 - 20,000;4;2;2;0;0;0
772340;Showdown at Willow Creek;Casual, Indie;0 - 20,000;5;0;5;0;0;0
772360;For Rent: Haunted House;Action, Casual, Indie;0 - 20,000;4;2;2;0;0;0
772420;COMPLEX a VR Puzzle Game;Action, Adventure, Casual, Indie, Simulation, Strategy;0 - 20,000;13;5;8;0;0;0
772430;Hero of the Kingdom III;Action, Adventure, Indie;100,000 - 200,000;986;252;734;0;0;10
772440;Sky Ball;Adventure, RPG, Strategy;0 - 20,000;5;5;0;0;0;0
772450;Prison Bomber;Adventure, Indie;0 - 20,000;0;0;0;0;0;0
772460;YangBo Adventure;Action, Casual, Indie, Strategy;0 - 20,000;14;4;10;1;1;0
772470;8-in-1 IQ Scale Bundle;Action, Casual, Indie;0 - 20,000;63;14;49;32;32;0
772480;Super Inefficient Golf;Indie, Racing, Simulation;20,000 - 50,000;163;43;120;24;24;0
772500;Distortions;Casual, Indie;20,000 - 50,000;108;66;42;0;0;0
772530;Crayola Scoot;Casual, Free to Play, Indie;0 - 20,000;44;12;32;0;0;3
772540;Battle Royale Trainer;Indie;200,000 - 500,000;959;701;258;673;513;4
772570;Crew 167: The Grand Block Odyssey;Adventure, Casual, Indie, Simulation;0 - 20,000;28;2;26;0;0;1
772600;Fisherones;Casual, Indie, Simulation, Strategy;0 - 20,000;9;4;5;0;0;0
772610;Q-YO Blaster;Adventure, Indie, Simulation;20,000 - 50,000;156;12;144;0;0;0
772650;R.A.F.A.;Action, Indie;0 - 20,000;4;2;2;0;0;0
772670;Beyond the Invisible: Darkness Came;Casual, Indie;20,000 - 50,000;22;14;8;0;0;0
772680;a Museum of Dubious Splendors;Casual, Indie;20,000 - 50,000;114;41;73;0;0;0
772700;MatchyGotchy;Action, Adventure, Casual, Indie;20,000 - 50,000;114;40;74;0;0;1
772730;Angel Light The Elven Truce;Action, Adventure, Indie, Strategy;0 - 20,000;18;4;14;0;0;0
772750;Wizards: Wand of Epicosity;Action, Casual, Indie, Simulation, Strategy;0 - 20,000;11;1;10;0;0;0
772990;Bird Watcher;Casual, Indie;0 - 20,000;44;17;27;0;0;0
773010;Hunahpu Quest. Mechanoid;Casual, Indie;0 - 20,000;25;10;15;0;0;0
773090;Lucid Dream Adventure;Free to Play, Indie, Strategy;20,000 - 50,000;167;35;132;0;0;0
773120;Christmas Santa Troubles;Action, Adventure, Indie, RPG, Early Access;0 - 20,000;9;18;-9;0;0;0
773130;NYAN DESTROYER;Adventure, Indie, Strategy;0 - 20,000;30;3;27;39;39;0
773150;Subscribe & Punch!;Action, Adventure, Casual, Indie;0 - 20,000;21;4;17;0;0;0
773150;Subscribe & Punch!;Casual, Indie, Simulation;0 - 20,000;21;4;17;0;0;0
773170;Close the Window!;Action, Indie;20,000 - 50,000;32;39;-7;0;0;0
773210;ControlMyJoystick;Casual, Indie;0 - 20,000;12;4;8;0;0;0
773230;The Evil Party;Indie, Strategy;0 - 20,000;21;20;1;0;0;0
773240;Raceland;Violent, Gore, Casual, Indie, RPG, Simulation, Early Access;20,000 - 50,000;68;147;-79;4;6;0
773320;TcNo TimeKeeper;Adventure, Casual, Indie, RPG;0 - 20,000;2;1;1;0;0;0
773330;Action Alien: Survival;Casual, Simulation;0 - 20,000;15;17;-2;0;0;0
773340;WingMen;Action, Indie, Racing, Sports, Early Access;0 - 20,000;0;6;-6;0;0;0
773360;Stinky Snake;Casual, Indie;0 - 20,000;5;0;5;0;0;0
773370;Exo One;Adventure, Casual, Indie, Simulation;100,000 - 200,000;3124;316;2808;85;98;9
773390;Aim Trainer Pro;Indie;20,000 - 50,000;77;52;25;27;27;0
773420;Panacea: Last Will;Casual, Free to Play, Indie;0 - 20,000;14;7;7;0;0;0
773430;Meow Motors;Action, Adventure, Indie;0 - 20,000;190;23;167;35;35;1
773440;Primal Pursuit;Simulation, Strategy;0 - 20,000;59;19;40;0;0;0
773460;瞳：祈愿 VR / Pupil: Wandering VR;Action, Adventure, Casual, Indie;0 - 20,000;86;40;46;0;0;0
773490;谜桥 / RiddleBridge;Action, Casual, Indie;0 - 20,000;10;1;9;0;0;0
773510;The Hardest Thing;Indie, Simulation, Sports;0 - 20,000;11;4;7;0;0;0
773520;Refight:Burning Engine;Adventure, Indie, RPG, Strategy;50,000 - 100,000;277;130;147;0;0;0
773530;Magic Nations - Card Game;Action, Adventure, Casual, Indie;0 - 20,000;86;35;51;0;0;1
773540;Boss Crushers;Action, Casual, Free to Play, Indie;0 - 20,000;44;25;19;0;0;0
773570;Log Challenge;Action, Adventure, Indie;0 - 20,000;1;1;0;0;0;0
773580;Game Dev Studio;Action, Free to Play, Massively Multiplayer, Simulation;50,000 - 100,000;503;81;422;16;16;6
773590;Azusa RP Online;Action, Casual, Free to Play, Massively Multiplayer, Simulation, Strategy;0 - 20,000;79;53;26;0;0;3
773610;Hill Quest;Adventure, Indie, RPG;0 - 20,000;3;0;3;0;0;0
773620;Redemption: Tyranny of Daetorem;Adventure, Casual, Indie;20,000 - 50,000;5;0;5;0;0;0
773630;Quanero 2 - System Release;Adventure, Indie;0 - 20,000;29;3;26;0;0;0
773650;The first thrust of God;Adventure, Casual, Indie;0 - 20,000;5;32;-27;0;0;0
773660;Cannon Fire;Indie, Simulation, Strategy, Early Access;0 - 20,000;1;0;1;0;0;0
773660;Cannon Fire;Action, Casual, Indie;0 - 20,000;1;0;1;0;0;0
773670;Delete;Adventure;50,000 - 100,000;1251;50;1201;107;107;2
773740;Overpass;Indie, Simulation;0 - 20,000;101;8;93;0;0;0
773750;Danger Forever;Action, RPG;0 - 20,000;3;1;2;0;0;0
773790;Ostriv;Adventure, RPG;100,000 - 200,000;3150;223;2927;703;725;110
773810;NOSTOI;Adventure, Casual, Indie, RPG, Strategy;0 - 20,000;8;4;4;0;0;0
773830;Dr. Trolley's Problem;Strategy;0 - 20,000;18;17;1;0;0;0
773840;DRAG Outer Zones;Casual, Indie;0 - 20,000;158;60;98;0;0;0
773850;WT2;Action, Adventure, Indie, RPG, Early Access;0 - 20,000;2;0;2;0;0;0
773910;The Short Story of a Drifting Labyrinth;Action, Adventure, Casual, Free to Play, Indie, Massively Multiplayer, Early Access;0 - 20,000;0;1;-1;0;0;0
773930;Coaster;Casual, Indie;0 - 20,000;15;3;12;0;0;0
773951;Freeman: Guerrilla Warfare;Early Access;500,000 - 1,000,000;8317;2885;5432;1316;976;51
774051;Dream On The Moon;Action, Indie;0 - 20,000;3;1;2;0;0;0
774091;Ostalgie: The Berlin Wall;Action, Adventure, Indie, Simulation;100,000 - 200,000;547;43;504;497;559;8
774121;Super Jet Juck;Adventure, Indie;0 - 20,000;13;4;9;0;0;0
774131;Nostradamus - The Four Horsemen of the Apocalypse;Action, Adventure, Casual, Indie, Simulation;0 - 20,000;12;19;-7;0;0;3
774131;Nostradamus - The Four Horsemen of the Apocalypse;Gore, Adventure, Indie, RPG;0 - 20,000;12;19;-7;0;0;3
774141;MIAZMA or the Devil's Stone;Action, Indie;0 - 20,000;20;7;13;0;0;0
774151;YOOMURJAK'S RING;Casual, Indie, Simulation;0 - 20,000;35;6;29;10078;10078;0
774151;YOOMURJAK'S RING;Indie, RPG, Sports, Strategy;0 - 20,000;35;6;29;10078;10078;0
774161;Steampunker;Action, Casual;0 - 20,000;19;18;1;0;0;0
774171;Muse Dash;Indie;2,000,000 - 5,000,000;78157;4628;73529;728;201;1819
774181;Rhythm Doctor;Utilities;200,000 - 500,000;16644;262;16382;450;249;99
774191;Car Puzzler;Action, Casual, Indie;0 - 20,000;21;5;16;0;0;0
774201;Heaven's Vault;Action, Adventure, RPG;100,000 - 200,000;1510;194;1316;1358;1358;14
774211;Drive Buy;Action, Adventure, Indie, RPG;0 - 20,000;18;2;16;0;0;0
774221;Nekomew's Potty Trouble;Action, Adventure, Casual, Indie, Racing, RPG, Simulation, Sports;0 - 20,000;65;4;61;0;0;1
774231;The Kremer Collection VR Museum;Adventure, Casual, Indie;0 - 20,000;10;2;8;0;0;0
774241;Warhammer: Chaosbane;Casual, Indie, Strategy;500,000 - 1,000,000;2873;2286;587;734;629;46
774261;My Little Bomb;Action, Adventure, Casual, Indie, Racing, Simulation;0 - 20,000;68;28;40;0;0;0
774261;My Little Bomb;Violent, Gore, Adventure, Indie;0 - 20,000;68;28;40;0;0;0
774281;Achievement Lurker: We Give Up!;Adventure;0 - 20,000;66;19;47;0;0;0
774321;STARBO - The Story of Leo Cornell;Casual, Indie;20,000 - 50,000;64;40;24;0;0;0
774331;ASH OF WAR;Casual, Indie;0 - 20,000;37;25;12;0;0;0
774351;Citystate;Casual, Indie, Strategy;200,000 - 500,000;572;185;387;849;1665;5
774361;Blasphemous;Action, Adventure, RPG;500,000 - 1,000,000;25994;2809;23185;542;309;614
774401;Scrap Attack VR;Violent, Action, Casual, Indie, Early Access;0 - 20,000;17;10;7;0;0;0
774411;Temple of Xiala;Adventure, Casual, Indie;0 - 20,000;35;35;0;6;6;0
774421;Shinrin-yoku: Forest Meditation and Relaxation;Indie, Simulation;20,000 - 50,000;14;9;5;17;17;0
774441;Island Time VR;Action, Indie;0 - 20,000;49;23;26;147;147;2
774451;Among the Dead;Indie, Simulation, Strategy, Early Access;0 - 20,000;8;13;-5;0;0;0
774461;The Jackbox Party Pack 5;Casual;200,000 - 500,000;2133;152;1981;615;268;123
774501;VR Soccer '96;Adventure, Indie;50,000 - 100,000;2;0;2;0;0;0
774511;Megadimension Neptunia VIIR;Free to Play, Indie, Massively Multiplayer, Strategy;50,000 - 100,000;640;220;420;3272;3761;12
774531;Snail Trek - Chapter 4: The Final Fondue;Casual, Indie;0 - 20,000;31;0;31;0;0;0
774541;Species: Artificial Life, Real Evolution;Action, Adventure, Indie;100,000 - 200,000;647;204;443;161;161;12
774551;Football Heroes Turbo;Adventure, Indie;0 - 20,000;14;5;9;0;0;0
774561;Rym 9000;Casual, Indie;20,000 - 50,000;79;20;59;0;0;0
774651;MIGHTY GUNVOLT BURST;Violent, Gore, Action, Free to Play, Indie;0 - 20,000;133;22;111;120;120;2
774661;Filthy Frank Kart;Casual, Indie, Simulation;0 - 20,000;7;4;3;0;0;0
774711;The Best Of MagiCats;Audio Production, Video Production;0 - 20,000;68;22;46;6;6;0
774721;EF EVE - Volumetric Video Platform (VR & Desktop);Video Production;20,000 - 50,000;16;3;13;0;0;0
774731;Juventus VR;Racing;0 - 20,000;7;0;7;0;0;0
774781;My Coloring Book: Professions;Violent, Adventure, Casual, Simulation;0 - 20,000;29;8;21;0;0;0
774791;Surgeon Simulator 2;Action, Casual, Indie, Early Access;20,000 - 50,000;702;302;400;127;135;8
774811;YUMENIKKI -DREAM DIARY-;Action, Indie;100,000 - 200,000;824;345;479;233;233;3
774861;Project Winter;Casual, Indie, Simulation;1,000,000 - 2,000,000;15019;3038;11981;727;278;135
774891;Fenix Box;Casual;0 - 20,000;5;1;4;0;0;0
774901;Pure Football 2018;Indie, Simulation, Early Access;0 - 20,000;10;7;3;0;0;0
774911;The Master;Indie, Simulation;0 - 20,000;51;26;25;0;0;0
775200;Powerless;Indie, Simulation;0 - 20,000;3;0;3;0;0;0
775220;Crusaders of Light;Action, Indie;100,000 - 200,000;351;235;116;939;1043;0
775270;They have HORNS;Adventure, Indie, Strategy;0 - 20,000;13;1;12;0;0;0
775310;Blood of Patriots;Simulation;0 - 20,000;22;1;21;0;0;0
775430;Discovery Tour by Assassin’s Creed: Ancient Egypt;Simulation, Strategy;0 - 20,000;115;20;95;0;0;0
775430;Discovery Tour by Assassin’s Creed: Ancient Egypt;Action, Adventure, Casual, Indie, Simulation;0 - 20,000;115;20;95;0;0;0
775460;The Cryptkeepers of Hallowford;Casual, Indie;0 - 20,000;9;2;7;0;0;0
775490;Super Steampunk Pinball 2D;Action, Adventure, Indie, RPG, Simulation, Strategy;0 - 20,000;46;25;21;0;0;0
775500;SCARLET NEXUS;Indie;500,000 - 1,000,000;10965;2163;8802;854;837;325
775520;Animals Memory: Dinosaurs;Action, Indie;0 - 20,000;30;3;27;0;0;0
775570;Deadly Blue;Casual, Indie, Strategy;0 - 20,000;1;1;0;0;0;0
775580;ITTA;Adventure, Indie, Strategy;50,000 - 100,000;227;24;203;40;40;1
775590;Spork: The Manic Utensil Storm;Simulation, Strategy;0 - 20,000;3;1;2;0;0;0
775620;Fight or Flight;Strategy;0 - 20,000;68;32;36;0;0;0
775690;Platform Golf;Action, Adventure;0 - 20,000;9;1;8;0;0;0
775720;Lozenge;Gore, Action, Indie;0 - 20,000;22;7;15;0;0;0
775730;Dialing;Utilities;0 - 20,000;24;3;21;0;0;0
775760;蜜汁女孩 Juice Girl;Adventure, Casual;0 - 20,000;87;27;60;0;0;0
775790;Rampage Ragdoll;Adventure, Casual;0 - 20,000;4;12;-8;1;1;0
775800;Ling;Adventure, Casual;0 - 20,000;69;27;42;3;3;0
775820;Controllers Battery Indicator;Action, Indie, Early Access;0 - 20,000;50;26;24;0;0;0
775850;Piwall;Casual, Indie, Simulation, Strategy;0 - 20,000;19;13;6;1;1;0
775860;Midnightland;Action, Casual, Free to Play, Indie;0 - 20,000;9;9;0;0;0;0
775900;MotoGP18;Violent, Action, Casual, Indie, Early Access;20,000 - 50,000;476;171;305;1770;3191;3
775910;Animals Memory: Birds;Action, Indie, Simulation;0 - 20,000;29;4;25;0;0;0
775920;Soul Reaper: Unreap Commander;Action, Indie, Massively Multiplayer;0 - 20,000;6;2;4;0;0;0
775940;Rise of Liberty;Adventure, Indie, RPG;100,000 - 200,000;1490;247;1243;54;54;3
775960;The Tower of Beatrice;Casual, Indie, RPG;0 - 20,000;68;9;59;0;0;0
776000;Choice of the Vampire;Adventure, Casual, Indie, Simulation;0 - 20,000;20;15;5;0;0;0
776020;Choice of the Vampire: The Fall of Memphis;Action, Indie;0 - 20,000;4;2;2;0;0;0
776040;John Lazarus - Episode 1: Dead Man's Origin;Action, Free to Play, Indie;0 - 20,000;11;2;9;0;0;0
776080;Dodge;Gore, Adventure;0 - 20,000;28;12;16;0;0;0
776100;One Night On The Road;Indie, Simulation, Early Access;0 - 20,000;2;5;-3;0;0;0
776140;Idol Quest VR;Adventure, Casual, Free to Play, Indie, Simulation;0 - 20,000;13;10;3;3;3;0
776150;M1 Tank Platoon;Casual, Indie, Simulation, Strategy;0 - 20,000;4;1;3;0;0;0
776160;Up and Down;Action, Adventure, Indie, RPG, Simulation, Strategy;0 - 20,000;19;3;16;0;0;0
776180;CryPixels;Action, Indie, RPG, Early Access;0 - 20,000;18;3;15;0;0;2
776190;Galactic Battles;Action, Casual, Free to Play, Indie, Simulation;20,000 - 50,000;40;67;-27;2;2;0
776270;Earl's Minecart Adventures;RPG;0 - 20,000;1;0;1;0;0;0
776280;Lux Ex - Legacy;Utilities, Early Access;0 - 20,000;17;0;17;0;0;1
776290;Kamikazo VR;Casual, Indie;0 - 20,000;3;8;-5;0;0;0
776320;Armada Skies;Indie;0 - 20,000;13;11;2;0;0;0
776340;Gay World;Action, Adventure, Casual, Indie, Simulation;20,000 - 50,000;600;124;476;100;101;0
776360;A Walk Along the Wall;Action, Adventure, Casual, Indie, RPG, Simulation;0 - 20,000;6;0;6;0;0;0
776370;Next 2;Indie;0 - 20,000;95;18;77;15;15;0
776390;Outbreak in Space VR - Free;Action, Indie, Early Access;0 - 20,000;4;4;0;0;0;0
776410;Sorcerer's Path;Casual, Indie, Racing, Simulation, Sports;0 - 20,000;1;0;1;0;0;0
776430;STAR SAGA ONE - RISE OF THE DOMINATORS;Casual, Indie;0 - 20,000;1;1;0;0;0;0
776440;PROJECT VELOCITY;Casual, Indie, Simulation;0 - 20,000;3;3;0;0;0;0
776450;hOSHIs Elektronauts;Action, Free to Play, Indie;0 - 20,000;2;0;2;0;0;0
776490;永远消失的幻想乡 ～ The Disappearing of Gensokyo;Action, Adventure, Casual, Indie;200,000 - 500,000;2906;518;2388;137;114;5
776510;RICHCODE富豪密码;Action, Indie, Strategy;0 - 20,000;18;15;3;0;0;0
776540;aMAZE Untouchable;Action, Adventure, Casual, Indie;0 - 20,000;51;45;6;0;0;0
776550;Yuzi Lims: anime runner;Gore, Action, Early Access;20,000 - 50,000;27;57;-30;0;0;0
776580;Abasralsa;Casual, Indie;20,000 - 50,000;317;130;187;36;71;0
776600;Witch Sword;Action, Adventure, Casual, Indie;0 - 20,000;25;12;13;0;0;0
776610;My Beastly Lovers;Casual, Indie;0 - 20,000;1;5;-4;0;0;0
776660;Smooth Operators 2;Casual;0 - 20,000;16;5;11;0;0;7
776670;Flying Bacon:Ukrainian Air Force;Indie, Racing, Early Access;20,000 - 50,000;30;20;10;0;0;0
776670;Flying Bacon:Ukrainian Air Force;Free to Play, Indie, RPG;20,000 - 50,000;30;20;10;0;0;0
776720;Dungeon Gambit Boy;Adventure, Indie;0 - 20,000;26;6;20;0;0;0
776740;Unveloped;Casual, Indie, Strategy;0 - 20,000;2;12;-10;0;0;0
776780;Copierre;Nudity, Violent, Gore, Casual, Indie;20,000 - 50,000;10;0;10;0;0;0
776790;Squirrel Sphere;Action, Indie;0 - 20,000;19;4;15;0;0;0
776820;Sit on bottle;Casual, Indie, Strategy;0 - 20,000;42;16;26;20;20;0
776830;Tears - 9, 10;Action, Indie, Strategy;0 - 20,000;17;4;13;0;0;0
776880;ExtremeRetroArena;Action, Adventure, Casual, Indie, Early Access;0 - 20,000;1;0;1;0;0;0
776890;Clicker: Mining Simulator;Action, Adventure, Indie;0 - 20,000;62;102;-40;0;0;1
776920;3DCoat Modding Tool;Action, Adventure, Indie, Strategy;0 - 20,000;39;10;29;0;0;0
776930;Omnibion War;Violent, Gore, Adventure, RPG;0 - 20,000;7;15;-8;0;0;0
776960;Mouse (Sneaking);RPG;200,000 - 500,000;832;201;631;130;107;1
776970;Scary new year;Adventure, Indie;0 - 20,000;0;4;-4;0;0;0
777000;FreeFlight;Casual, RPG, Early Access;0 - 20,000;1;3;-2;0;0;0
777020;Mumps;Adventure, Indie;20,000 - 50,000;80;37;43;17;17;0
777040;Criminal Bundle;Action, Casual, Indie;0 - 20,000;32;18;14;0;0;0
777050;TOXIC PLUMBING;Casual, Free to Play, Indie;0 - 20,000;69;54;15;53;53;0
777090;Assembly Required;Casual, Indie;0 - 20,000;7;3;4;0;0;0
777130;Blush Blush;Action, Casual, Indie, Strategy, Early Access;200,000 - 500,000;5028;687;4341;3567;6312;635
777150;Adventure Land - The Code MMORPG;Casual, Indie;0 - 20,000;105;17;88;0;0;22
777160;Forgotten Places: Regained Castle;Violent, Action, Adventure, Indie, RPG;20,000 - 50,000;104;32;72;0;0;1
777180;Game Server Toolbox;Adventure, Indie, RPG;0 - 20,000;7;8;-1;0;0;0
777200;KOEWOTAYORINI SP / 声之寄托SP;Action, Casual, Indie;0 - 20,000;209;12;197;95;151;0
777220;审判者 The Inquisitor;Action, Adventure, Casual, Indie, RPG;0 - 20,000;45;3;42;0;0;0
777240;Tren0;Action, Indie;50,000 - 100,000;210;65;145;0;0;1
777250;The Tavern of Magic;Action, Indie, Simulation;0 - 20,000;3;6;-3;0;0;0
777270;Thirsty Bubble;Casual, Indie, Strategy;0 - 20,000;16;14;2;0;0;0
777300;The Placebos;Adventure, Free to Play, Indie, RPG;0 - 20,000;1;0;1;0;0;0
777310;Battle Of Keys;Action, Casual, Indie, Simulation, Sports, Early Access;0 - 20,000;8;11;-3;0;0;0
777340;Animals Memory: Underwater Kingdom;Adventure;0 - 20,000;20;3;17;0;0;0
777350;Maze Walker;Action, Casual, Indie, Early Access;20,000 - 50,000;6;4;2;0;0;0
777360;HorD: High or Die;Violent, Action, Early Access;0 - 20,000;1;0;1;0;0;0
777380;Fleets of Ascendancy;Casual, Indie;0 - 20,000;2;1;1;0;0;0
777400;Ultimate Spider Hero;Casual, Indie;20,000 - 50,000;59;32;27;0;0;1
777410;EarthNight;Simulation;0 - 20,000;70;21;49;0;0;0
777420;Quests Unlimited;Action, Indie, Strategy;0 - 20,000;6;5;1;0;0;0
777430;Virtual Boxing League;Casual, Indie;0 - 20,000;24;15;9;0;0;0
777460;Motor Strike: Racing Rampage;Casual, Indie, Strategy;0 - 20,000;20;1;19;0;0;0
777470;The Infinite Black 2;Indie, Simulation, Strategy;20,000 - 50,000;120;10;110;0;0;25
777530;Salsa-Virtual;Adventure;0 - 20,000;1;4;-3;0;0;0
777540;Entertainment Hero;Simulation;0 - 20,000;2;0;2;0;0;0
777550;King Battle;Action, Massively Multiplayer;0 - 20,000;2;3;-1;0;0;0
777560;INVISIBLE;Action, Adventure, Casual, Indie, RPG, Strategy, Early Access;0 - 20,000;10;11;-1;0;0;0
777560;INVISIBLE;Casual, Free to Play, Indie, Racing, Simulation;0 - 20,000;10;11;-1;0;0;0
777580;Champ Against Chumps Upgrade Edition;Action, Adventure, Casual, Indie, Strategy;0 - 20,000;2;0;2;0;0;0
777590;众生;Casual, Indie, RPG, Simulation;0 - 20,000;295;165;130;261;261;1
777610;DrummingVR;Simulation;0 - 20,000;3;0;3;0;0;0
777620;Little fight;Simulation;0 - 20,000;0;2;-2;0;0;0
777640;Lightform;Casual, Indie;0 - 20,000;7;20;-13;9;9;0
777650;Yet Another Research Dog;Casual, Indie;20,000 - 50,000;291;51;240;27;27;0
777660;Spacepowers;Casual, Indie, Simulation;0 - 20,000;10;7;3;0;0;0
777670;Okinawa Rush;Casual, Indie;0 - 20,000;101;14;87;0;0;0
777730;Entropy 2120;Action, Casual, Free to Play, Indie, Racing;0 - 20,000;2;1;1;0;0;0
777760;Charlie II;Casual, Indie, Simulation;0 - 20,000;14;5;9;0;0;0
777770;WAR PARTY;Action, Casual, Indie, Racing, Simulation, Sports, Strategy, Early Access;50,000 - 100,000;302;132;170;273;273;1
777790;Final Directive;;0 - 20,000;74;13;61;0;0;0
777820;The Quest for the BIG KEY;Indie;0 - 20,000;18;4;14;0;0;0
777850;Cannon Crew;Adventure, Indie, RPG;0 - 20,000;4;2;2;0;0;0
777860;Jambo;Action, Casual, Indie;20,000 - 50,000;0;2;-2;0;0;0
777880;Fluffy Horde;Adventure, Casual, Indie;50,000 - 100,000;224;143;81;34;34;0
777890;Primitive;Action, Casual, Indie;0 - 20,000;10;0;10;0;0;0
777900;The Departure;Action, Indie;0 - 20,000;3;5;-2;0;0;0
778000;The SOL Device;Indie, RPG, Simulation, Strategy;0 - 20,000;3;1;2;0;0;0
778010;Filmmaker Tycoon;Action, Adventure, Casual, Indie;0 - 20,000;25;55;-30;0;0;0
778030;Block Heads: Instakill;Action, Adventure, Indie, RPG;0 - 20,000;20;6;14;0;0;0
778050;Revenge of the Headless;Casual, Indie;0 - 20,000;42;11;31;0;0;0
778060;Specter;Casual, Indie;0 - 20,000;17;0;17;0;0;0
778080;40 Winks;Action, Casual, Indie;0 - 20,000;23;10;13;0;0;1
778110;Bladeline VR;Action, Adventure, Casual;0 - 20,000;10;8;2;0;0;0
778120;Hyperbolic Ignition;Casual, Indie;0 - 20,000;4;3;1;0;0;0
778140;BRIKS 2;Casual, Indie, Simulation;0 - 20,000;2;0;2;0;0;0
778150;Crossroad;Adventure, Indie;0 - 20,000;103;26;77;256;256;0
778230;Mighty Gemstones;Casual, Strategy;20,000 - 50,000;26;26;0;17;17;1
778240;STAR SOD;Casual, Free to Play, Simulation;0 - 20,000;1;1;0;0;0;0
778250;Battle of Kings VR;Action, Adventure, Indie;0 - 20,000;30;11;19;0;0;0
778260;The Scent of Summer;Simulation, Strategy, Early Access;0 - 20,000;32;6;26;1;1;0
778270;Tombo Breaker VR;Action, Casual, Indie, Sports;0 - 20,000;1;8;-7;0;0;0
778330;Squirm;Action, Indie;0 - 20,000;173;7;166;0;0;0
778340;Animals Memory: Dogs;Adventure, Casual, Indie, RPG;0 - 20,000;25;5;20;0;0;0
778360;Love or Loved - A Bullet For My Valentine;Simulation;0 - 20,000;4;6;-2;0;0;0
778390;Corpse Party: Book of Shadows;Action, Adventure, Indie;20,000 - 50,000;318;37;281;0;0;2
778400;Corpse Party: Sweet Sachiko's Hysteric Birthday Bash;Action, Indie, RPG, Early Access;0 - 20,000;132;13;119;0;0;1
778410;Dead Ground;;0 - 20,000;64;42;22;0;0;0
778430;OSCKit;Adventure;0 - 20,000;0;1;-1;0;0;0
778460;The Communist Dogifesto;Casual, Indie, RPG, Simulation, Strategy;0 - 20,000;8;2;6;0;0;0
778470;Crystals and Curses;Action, Adventure, Casual, Free to Play, Indie, Racing, RPG, Simulation, Sports;0 - 20,000;4;0;4;0;0;0
778540;Big Blue - Memory;Casual;0 - 20,000;1;2;-1;0;0;0
778550;Nazi Elimination;Adventure, Indie, Simulation;0 - 20,000;4;14;-10;0;0;0
778570;Bustories;Action, Indie;0 - 20,000;30;16;14;0;0;0
778580;Trinity;Action, Casual, Free to Play, Indie, Simulation;0 - 20,000;5;2;3;0;0;1
778590;Mountain Troll;Adventure, Casual, Indie, RPG, Strategy;0 - 20,000;54;69;-15;0;0;0
778600;Zero Gravity Pool;Violent, Action, Adventure, Indie;0 - 20,000;0;1;-1;0;0;0
778610;Foto Flash;Action, Adventure, Indie;20,000 - 50,000;253;22;231;0;0;0
778640;Super Bit Adventure: Paragons of Life;Action, Adventure, Indie, Simulation, Strategy, Early Access;0 - 20,000;20;2;18;0;0;0
778650;Volcano Tower;Free to Play;0 - 20,000;7;0;7;0;0;0
778700;Amorous;Action, Adventure, Casual, Indie;200,000 - 500,000;5608;1265;4343;214;149;63
778710;Tunescape;Action, Adventure, Indie;0 - 20,000;0;1;-1;0;0;0
778760;The Agency: Chapter 2;Adventure, Indie, RPG;0 - 20,000;9;6;3;0;0;0
778770;Ladybird Reflect;Action, Casual, Indie;0 - 20,000;2;4;-2;0;0;0
778780;Desktop Agents - Cov1d-999;Design & Illustration, Photo Editing, Web Publishing;0 - 20,000;47;2;45;0;0;0
778800;HYBRIS - Pulse of Ruin;Action, Adventure, Casual, Indie, RPG, Simulation, Strategy;0 - 20,000;32;2;30;0;0;0
778810;Soul for two;Adventure, Casual, Indie;20,000 - 50,000;7;2;5;0;0;0
778830;Knights of Hearts;Casual, Indie, RPG;0 - 20,000;8;28;-20;21;21;0
778840;Armored Evolution;Casual, Indie, Early Access;0 - 20,000;52;13;39;6;9;0
778850;Please close the doors;Casual, Free to Play, Simulation;50,000 - 100,000;51;43;8;10;19;0
778860;Animals Memory: Insect;Action, Adventure, Casual, Indie;0 - 20,000;25;5;20;0;0;0
778870;KOMMERSANT;Action, Adventure, Casual, Indie, Simulation;0 - 20,000;9;1;8;0;0;0
778900;Magical Star Pillars;Indie, Massively Multiplayer;0 - 20,000;1;0;1;0;0;0
778930;Property;Indie;0 - 20,000;66;18;48;0;0;0
779050;A tractor;Action, Adventure, Indie, RPG, Strategy, Early Access;20,000 - 50,000;98;36;62;0;0;0
779060;Cyborg Invasion Shooter 2: Battle Of Earth;Action, Adventure, Casual, Indie;0 - 20,000;16;20;-4;0;0;0
779070;Steel Knight 1513;Nudity, Casual, Indie;0 - 20,000;1;1;0;0;0;0
779090;Umfend;Action, Adventure, Casual, Indie;0 - 20,000;100;11;89;0;0;0
779100;Daemonical;Action, Indie;20,000 - 50,000;145;74;71;1;1;0
779110;Harsh;Simulation;0 - 20,000;4;5;-1;0;0;0
779120;Satori Sounds VR;Casual, Indie;0 - 20,000;5;1;4;0;0;0
779130;Virtual Fighting Championship (VFC);Casual, Indie;;;;0;;;
779140;Outrealm;Indie;0 - 20,000;6;1;5;0;0;0
779150;Shadow of Something;Action, Indie;0 - 20,000;1;5;-4;0;0;0
779160;Realshot;Adventure, Casual, Free to Play, Indie;0 - 20,000;1;1;0;0;0;0
779220;LOA : Me And Angel;Casual, Indie;0 - 20,000;4;1;3;0;0;0
779240;Conquer;Action, Adventure, Indie, RPG;0 - 20,000;13;11;2;0;0;0
779250;Paradox Wrench;Action, Indie;0 - 20,000;32;6;26;8;8;0
779260;Kode Studio;Action, Casual, Indie;0 - 20,000;28;7;21;4;4;0
779290;Stygian: Reign of the Old Ones;Action, Adventure, Casual, Indie, Racing;100,000 - 200,000;1452;716;736;514;721;9
779300;Battle of Kings;Action, Adventure, Casual, Free to Play, Indie, RPG;0 - 20,000;19;10;9;0;0;0
779320;Asura Valley;Action, Indie, Strategy;0 - 20,000;12;3;9;0;0;0
779330;Ninja Tycoon;Action, Adventure, Casual, Indie, Strategy;20,000 - 50,000;287;110;177;155;155;0
779340;Total War: THREE KINGDOMS;Casual, Indie, Simulation, Early Access;2,000,000 - 5,000,000;66911;27238;39673;4739;1697;6680
779360;Instant Death;Indie;0 - 20,000;53;13;40;4;4;0
779380;Atmocity;Action, Adventure, Casual, Indie, RPG;0 - 20,000;12;7;5;0;0;0
779390;Run Dorothy Run;Casual, Indie;0 - 20,000;2;1;1;0;0;0
779410;Outworld Battlegrounds;Sexual Content, Action, Casual, Indie;0 - 20,000;52;9;43;0;0;0
779430;Full Ace Tennis Simulator;Casual, Indie;0 - 20,000;299;33;266;0;0;23
779450;Overlanders;Action, Indie, RPG, Early Access;0 - 20,000;19;11;8;0;0;0
779550;The Rising of the Rose Ocelot;Violent, Gore, Action;0 - 20,000;2;1;1;0;0;0
779570;Roulette Simulator;Action, Racing;0 - 20,000;17;21;-4;0;0;0
779580;Fat Foods;Adventure, Casual;0 - 20,000;7;0;7;0;0;0
779590;Scavenger SV-4;Adventure, Indie;20,000 - 50,000;355;38;317;0;0;1
779610;DEATH FIELD: The Battle Royale of Disaster;Indie;0 - 20,000;60;121;-61;0;0;0
779620;Empty Town;Adventure, Indie;0 - 20,000;11;4;7;0;0;0
779640;妄想症：Deliver Me;Action, Adventure, Indie, Early Access;100,000 - 200,000;1776;239;1537;191;225;9
779650;Ready Player One: OASIS beta;Violent, Gore, Action;200,000 - 500,000;292;197;95;80;149;0
779700;In Between Games;Adventure, Casual, Indie, RPG;0 - 20,000;15;7;8;0;0;0
779730;Foosball VR;Indie, Racing;0 - 20,000;13;0;13;0;0;0
779760;Burak Bahar's Unseen Anchor;Action, Casual, Indie, Simulation;0 - 20,000;12;1;11;0;0;0
779780;R Academy;Action, Indie, Early Access;0 - 20,000;3;0;3;0;0;0
779790;cell;Indie, Racing, Early Access;0 - 20,000;6;10;-4;0;0;0
779800;Dangerous Level;Action, Indie;0 - 20,000;22;12;10;0;0;0
779810;VR Austria;Action, Adventure, Indie;0 - 20,000;3;3;0;0;0;0
779840;Forgotten Sound 1: Revelation;Casual, Indie;0 - 20,000;0;3;-3;0;0;0
779870;Flatwaters: The Curse of Echita;Adventure;0 - 20,000;5;0;5;0;0;0
779920;Hexxon;Action, Adventure, Indie;0 - 20,000;2;0;2;0;0;0
779950;Spirit Roots;Action, Casual, Indie;0 - 20,000;13;8;5;0;0;0
779960;BM Studio;Sexual Content, Nudity, Action, Adventure, RPG;0 - 20,000;74;20;54;0;0;0
779990;Space Between Worlds;Action, Adventure, Casual, Indie, RPG;50,000 - 100,000;433;22;411;0;0;0
779990;Space Between Worlds;Adventure, Casual, Indie, Simulation, Strategy;50,000 - 100,000;433;22;411;0;0;0
780000;Critical Mess;Adventure, Casual, Indie;0 - 20,000;4;2;2;0;0;0
780080;Bikour!;Adventure, Indie;0 - 20,000;10;6;4;0;0;0
780100;ClearMem :: Free Up Your RAM;Action, Casual, Free to Play, Indie;20,000 - 50,000;151;52;99;486;486;21
780150;The Studio;Action;0 - 20,000;0;0;0;0;0;0
780160;All Stars Racing Cup;Adventure, Casual, Indie;0 - 20,000;3;8;-5;0;0;0
780210;Freeways;Action, Adventure, Indie;50,000 - 100,000;1042;182;860;596;484;27
780220;Gump;Free to Play, Strategy;0 - 20,000;2;3;-1;0;0;0
780230;Missing Road;Action, Adventure, Casual, Indie;0 - 20,000;5;2;3;0;0;0
780230;Missing Road;Action, Free to Play, Strategy;0 - 20,000;5;2;3;0;0;0
780260;Stranded Alone;Adventure, Casual, Indie, Simulation;0 - 20,000;4;3;1;0;0;0
780270;Brimstone Brawlers - Early Access;Action, Adventure, Indie, RPG, Simulation, Early Access;0 - 20,000;142;17;125;0;0;0
780280;Summer Funland;Action, Free to Play, Massively Multiplayer, Simulation, Early Access;20,000 - 50,000;261;42;219;15;15;1
780290;Gloomhaven;Utilities;200,000 - 500,000;10419;1598;8821;1227;607;1637
780310;The Riftbreaker;Adventure, Casual, Indie;1,000,000 - 2,000,000;11963;1077;10886;1551;989;514
780320;Snow White Solitaire. Legacy of Dwarves;Action, Indie;0 - 20,000;13;9;4;0;0;0
780350;Unruly Heroes;Casual, Indie;50,000 - 100,000;641;199;442;5;5;1
780390;Space Bob vs. The Replicons;Action, Indie;20,000 - 50,000;85;10;75;0;0;1
780430;Hiro's Forest Rumble;Casual, Free to Play, Indie;0 - 20,000;0;0;0;0;0;0
780500;Suzy Cube;Action, Adventure, Simulation;20,000 - 50,000;251;41;210;0;0;4
780520;Technolites: Episode 1;Action, Casual, Indie;0 - 20,000;3;0;3;0;0;0
780570;AI Anomaly;Action, RPG, Strategy;0 - 20,000;4;0;4;0;0;0
780630;The Painter's Apprentice;Casual, Indie;0 - 20,000;5;1;4;0;0;0
780670;Fantasy of Expedition;Action, Adventure, Indie, RPG, Early Access;50,000 - 100,000;538;120;418;2623;2623;3
780690;University Tycoon: 2019;Casual, Indie;0 - 20,000;0;14;-14;0;0;0
780710;TURRET SYNDROME VR;Design & Illustration;0 - 20,000;8;2;6;0;0;0
780740;Silent Footsteps;Action, Indie, Strategy;20,000 - 50,000;8;0;8;0;0;0
780750;Snake Classic;Violent, Action, Adventure, Indie, Simulation, Strategy, Early Access;20,000 - 50,000;167;59;108;0;0;0
780760;Lots of Balls;Action, Adventure, Indie;0 - 20,000;25;6;19;0;0;0
780800;Ball laB;Action, Indie, RPG;0 - 20,000;526;284;242;495;39;0
780820;XOXO Blood Droplets;Sexual Content, Nudity, Violent, Gore, RPG;20,000 - 50,000;207;19;188;0;0;1
780840;Kuchisake Onna - 口裂け女;Education, Utilities;0 - 20,000;39;14;25;0;0;0
780850;Recreational Dreaming;Indie;0 - 20,000;7;0;7;0;0;0
780930;Cute War：Zero 萌系战争：零;Action, Indie, Early Access;0 - 20,000;0;1;-1;0;0;0
780970;Food Dream Factory 梦想的美食世界：研发美食开心制作糖果模拟经营养成;Free to Play, Indie, Racing, Simulation;0 - 20,000;2;4;-2;0;0;0
781000;Mystic Space;Action, Casual, Indie, Simulation, Strategy;0 - 20,000;7;7;0;0;0;0
781030;DK Online;Action, Adventure, Indie;100,000 - 200,000;234;328;-94;0;0;13
781040;Vinhomes Metropolis VR Interior;Casual, Indie, Early Access;0 - 20,000;5;4;1;0;0;0
781050;Evie;Action, Adventure, Casual, Free to Play, Indie;0 - 20,000;56;65;-9;52;52;0
781100;Winner Winner Chicken Dinner!;Adventure, Indie;0 - 20,000;17;26;-9;0;0;1
781110;Later On;Adventure, Indie, RPG;0 - 20,000;25;0;25;0;0;0
781130;Creatura;Adventure, Casual, Indie, Simulation;0 - 20,000;95;36;59;0;0;2
781150;GR_D;Adventure, Casual, Indie, Simulation;0 - 20,000;4;9;-5;0;0;0
781180;Technicity;Adventure, RPG;20,000 - 50,000;104;21;83;188;188;4
781220;Drakkhen;Action, Casual, Free to Play, Indie, Racing, Simulation, Strategy;0 - 20,000;21;13;8;0;0;0
781230;Bubble Ghost;Casual, Indie, RPG, Simulation, Strategy;0 - 20,000;21;11;10;0;0;0
781240;Mystical;Indie, Strategy, Early Access;0 - 20,000;5;13;-8;0;0;0
781250;Eternam;Action, Adventure, Casual, Indie, RPG, Simulation, Strategy;0 - 20,000;8;6;2;0;0;0
781260;Marco Polo;Indie;0 - 20,000;11;8;3;0;0;0
781270;Chaos Control;Action, Indie, Strategy;0 - 20,000;17;13;4;0;0;0
781280;Time Gate: Knight's Chase;Casual, Strategy;0 - 20,000;7;2;5;0;0;0
781290;Hostage: Rescue Mission;Casual, Indie, Simulation;0 - 20,000;5;14;-9;0;0;0
781310;Alpha/Omega: The Christian RPG;Racing, Simulation, Strategy, Early Access;0 - 20,000;3;2;1;0;0;0
781320;Guns & Notes;Indie, Simulation;0 - 20,000;11;4;7;0;0;0
781380;SOS Atlas;Action, Adventure, Casual, Indie, RPG, Strategy;0 - 20,000;6;0;6;0;0;0
781440;OH MY GOD, LOOK AT THIS KNIGHT;Action, Adventure, Indie;100,000 - 200,000;1714;71;1643;20;24;0
781480;Tech Support: Error Unknown;Nudity, Violent, Gore, Action, Indie, Simulation;20,000 - 50,000;385;128;257;173;162;4
781490;Lonely Trip;Adventure, Casual, Indie;0 - 20,000;12;0;12;0;0;0
781500;Candy Snake Master;Action, Adventure, Indie, Strategy;0 - 20,000;6;0;6;0;0;0
781520;Ayahuasca: Polyventure;Action, Adventure, Indie, Simulation, Early Access;0 - 20,000;16;24;-8;330;339;0
781590;三国游侠志;Action, Adventure, Indie;0 - 20,000;63;15;48;0;0;0
781590;三国游侠志;Strategy;0 - 20,000;63;15;48;0;0;0
781610;Night Fly;Casual, Free to Play, Indie;0 - 20,000;18;34;-16;0;0;0
781630;Iffy Institute;Adventure, Casual, Indie, Simulation;0 - 20,000;2;2;0;0;0;0
781640;Run Jump Fail;Action, Casual, Indie;0 - 20,000;42;7;35;216;216;0
781650;Endlessness;Action, Casual, Indie, Strategy;0 - 20,000;6;4;2;0;0;0
781660;Space Rocket;Indie, Simulation, Sports, Strategy;0 - 20,000;36;27;9;0;0;0
781670;The Directed;Casual, Indie, Strategy;0 - 20,000;20;3;17;1;1;0
781680;In Darkness;Casual, Indie;0 - 20,000;4;2;2;0;0;0
781760;Trivia Vault: Health Trivia Deluxe;Sports;0 - 20,000;43;31;12;2;3;0
781780;Behind Walls;Action;0 - 20,000;1;1;0;0;0;0
781800;Walhall;Casual, Indie, RPG;20,000 - 50,000;22;19;3;0;0;0
781810;Oik 4;Indie;20,000 - 50,000;208;39;169;0;0;0
781820;Oik Memory 2;Indie, Simulation;0 - 20,000;147;15;132;1;1;0
781830;Survival Space: Unlimited Shooting;Adventure, Casual, Strategy;0 - 20,000;1;0;1;0;0;0
781840;Sub Terra Draconis;Action, Indie;0 - 20,000;1;0;1;0;0;0
781860;Stick Adventures: Wizard Madness: Chapter 1;Action, Casual, Indie;0 - 20,000;4;0;4;0;0;0
781880;"Object ""Cleaning""";Action, Casual, Indie, Early Access;0 - 20,000;18;39;-21;0;0;0
781890;Darkness Restricted;Casual, Indie;0 - 20,000;9;0;9;0;0;0
781920;The Haunted House of Doom;Action, Indie;0 - 20,000;13;2;11;0;0;0
781930;Count Dookie Fart;Adventure;0 - 20,000;16;4;12;0;0;0
781950;Galactic Delivery;Strategy, Early Access;0 - 20,000;9;2;7;0;0;0
781990;Wequer;Casual, Indie;0 - 20,000;58;4;54;0;0;0
782020;Endless Crusade;Action, Casual, Free to Play, Indie, Early Access;0 - 20,000;3;7;-4;0;0;0
782050;Frio3 - Parting and Meeting;Action, Adventure, Indie, Early Access;0 - 20,000;17;5;12;0;0;0
782050;Frio3 - Parting and Meeting;Video Production;0 - 20,000;17;5;12;0;0;0
782070;Late Night 1320;Action, Adventure, Indie;0 - 20,000;23;26;-3;0;0;0
782100;#CuteSnake;Free to Play, Indie, Strategy, Early Access;0 - 20,000;41;35;6;271;271;0
782120;Super Gravity Ball;Casual, Indie;0 - 20,000;21;0;21;0;0;0
782120;Super Gravity Ball;Casual, Indie, Simulation, Strategy;0 - 20,000;21;0;21;0;0;0
782130;Wer weiß denn sowas? - Das Spiel;Simulation, Strategy;0 - 20,000;44;17;27;46;46;0
782140;Re-Legion;Action, Casual, Simulation, Strategy, Early Access;50,000 - 100,000;170;112;58;444;515;1
782160;Raptainment;Violent, Gore, Action, Indie;0 - 20,000;2;3;-1;0;0;0
782180;The way to defeat the Archfiend / 打倒魔王的方法;Action, Early Access;0 - 20,000;66;7;59;0;0;0
782190;The Seven Districts of Sin: The Tail Makes the Fox - Episode 1;Action, Casual, Indie, Sports;;;;0;;;
782210;Arc Surfer;Violent, Gore, Indie;0 - 20,000;6;0;6;0;0;0
782280;Beer!;Action, Adventure, Casual, Indie;0 - 20,000;21;5;16;0;0;1
782300;Unstoppable Hamster;Adventure, Casual, Indie, Simulation;20,000 - 50,000;95;45;50;2;2;0
782330;DOOM Eternal;Adventure;2,000,000 - 5,000,000;152195;15505;136690;1312;723;1768
782340;Lake of Voices;Indie;50,000 - 100,000;458;25;433;0;0;0
782380;Mirage of Dragon;Action, Casual, Indie;0 - 20,000;24;8;16;0;0;0
782410;Metropolis;Action, Adventure, Casual, Indie;0 - 20,000;1;7;-6;0;0;0
782420;RHCs StretchingVr;Action, Indie;0 - 20,000;0;1;-1;0;0;0
782450;Fleazer;Action;0 - 20,000;3;3;0;0;0;0
782460;Tank Slam;Action, Adventure, Free to Play, RPG, Strategy;0 - 20,000;10;9;1;0;0;0
782510;Draft Day Sports: Pro Football 2018;Indie, Simulation, Strategy;0 - 20,000;7;7;0;0;0;0
782570;Endless Road: Reborn;Action, Adventure, Indie, RPG, Simulation, Early Access;20,000 - 50,000;388;126;262;1649;1649;9
782610;Tank 51;Indie, Racing, Early Access;0 - 20,000;6;0;6;0;0;0
782630;Twisted Sails;Adventure, Massively Multiplayer, RPG, Simulation, Early Access;20,000 - 50,000;12;4;8;0;0;0
782650;DRONES AND RUINS;Action, Casual, Indie;0 - 20,000;2;0;2;0;0;0
782660;Armada: Modern Tanks;Violent, Action, Casual, Indie;20,000 - 50,000;140;135;5;16;16;25
782670;Battle Tanks: Legends of World War II;Action, Indie, Early Access;100,000 - 200,000;646;344;302;36;52;95
782690;Gazing from beyond;Free to Play, Strategy;20,000 - 50,000;309;161;148;268;268;1
782700;Jerry and the mystery loot box;Free to Play, Simulation;20,000 - 50,000;3;7;-4;0;0;0
783050;Bear With Me - Collector's Edition;Adventure, Free to Play, Indie;20,000 - 50,000;286;49;237;100;159;0
783060;AIDEN;Adventure, Casual, Indie, RPG, Simulation, Strategy;0 - 20,000;18;25;-7;0;0;0
783070;Robotics in VR;Utilities;50,000 - 100,000;20;4;16;0;0;0
783090;Neon;Adventure, Casual, Indie;0 - 20,000;1;0;1;0;0;0
783120;HELLO LADY!;Adventure, Indie, Simulation;20,000 - 50,000;759;35;724;1;1;1
783140;Removed;Adventure, Indie;200,000 - 500,000;25;16;9;60;40;0
783170;INSOMNIA: The Ark;Action, Casual, Indie;100,000 - 200,000;703;458;245;565;565;3
783180;Fairune Collection;Casual, Indie, Strategy;20,000 - 50,000;62;9;53;0;0;0
783180;Fairune Collection;Indie, Strategy;20,000 - 50,000;62;9;53;0;0;0
783200;Forbidden Clicker Party;Action, Indie, Early Access;0 - 20,000;96;30;66;0;0;1
783210;Aggressors: Ancient Rome;Action, Casual, Indie;0 - 20,000;199;42;157;78;78;2
783220;Block Shock;Action, Casual;20,000 - 50,000;2;15;-13;0;0;0
783220;Block Shock;Violent, Action, Adventure, Indie;20,000 - 50,000;2;15;-13;0;0;0
783230;Way of the Orb;Indie, RPG;0 - 20,000;1;0;1;0;0;0
783240;Die pig die;Adventure, Indie, RPG;100,000 - 200,000;104;215;-111;3;3;0
783250;CONTAINMENT;Casual, Indie;0 - 20,000;1;0;1;0;0;0
783260;CRUSH;Action, Casual, Free to Play, Indie, Massively Multiplayer, RPG, Simulation, Strategy;;;;0;;;
783270;Seek & Destroy - Steampunk Arcade;Adventure, Indie;0 - 20,000;2;0;2;0;0;0
783310;Burden;Action, Indie, Early Access;0 - 20,000;21;22;-1;0;0;0
783330;Super Robolom;Action, Indie;0 - 20,000;37;31;6;4;4;0
783340;FRACTER;Action, Indie;0 - 20,000;26;4;22;0;0;0
783400;Lexie The Takeover;Action, Indie;0 - 20,000;2;0;2;0;0;0
783420;Elementium;Action, Casual, Indie;0 - 20,000;8;9;-1;0;0;0
783430;Gatlin';Action, Indie;0 - 20,000;9;1;8;0;0;0
783440;Seven Mysteries: The Last Page;Action, Indie, RPG;0 - 20,000;39;12;27;0;0;0
783450;HYPERGUN;Strategy, Early Access;0 - 20,000;42;28;14;0;0;0
783590;Age of Gladiators II: Rome;Casual, Indie, Simulation;50,000 - 100,000;154;72;82;0;0;0
783650;Keys;Casual, Indie;0 - 20,000;2;0;2;0;0;0
783710;Virtual Desktop Dashboard;Action, Adventure, Indie;0 - 20,000;19;25;-6;0;0;14
783720;Ninja Striker!;Sexual Content, Action, Casual, Indie, Simulation, Strategy, Early Access;0 - 20,000;6;1;5;0;0;0
783770;Ironsight;Action, Adventure, Indie, RPG;2,000,000 - 5,000,000;14147;5318;8829;159;75;520
783790;Survivors of Borridor;Casual, Indie, Simulation;0 - 20,000;7;0;7;0;0;0
783810;牧剑：化神书(Tale Of Swords: Mystery Scroll);Casual, Simulation;50,000 - 100,000;265;60;205;0;0;0
783840;Lakeview Valley;Adventure, Racing, Sports;50,000 - 100,000;512;95;417;127;127;4
783850;Derpy pirates!;Casual, Indie;0 - 20,000;4;8;-4;0;0;0
783890;BRIGHTEST;Violent, Gore, Adventure, Casual, Indie, RPG;0 - 20,000;7;11;-4;0;0;0
783940;Forgotten Hill Mementoes;Massively Multiplayer, Racing, Simulation, Sports;20,000 - 50,000;158;16;142;0;0;1
783960;Forgotten Sound 2: Destiny;Casual, Simulation, Sports;0 - 20,000;0;3;-3;0;0;0
784010;Dragonview;Indie, Simulation, Sports;0 - 20,000;24;1;23;0;0;0
784040;Food Monster and Animals Memory Match;Adventure, Indie, Early Access;0 - 20,000;1;0;1;0;0;0
784050;Filthy Hands;Action, Indie;0 - 20,000;49;25;24;0;0;0
784080;MechWarrior 5: Mercenaries;RPG;200,000 - 500,000;6403;1299;5104;1360;1224;3281
784100;Gone Fireflies;Action, Adventure, Indie, RPG, Early Access;0 - 20,000;39;8;31;0;0;0
784110;bLogic Blox;Sexual Content, Action, Adventure, Indie, RPG;0 - 20,000;3;1;2;0;0;0
784130;Treasure Stack;Adventure, Casual, Indie, Simulation;0 - 20,000;13;0;13;0;0;0
784940;Countryballs: Over The World;Action, Indie, RPG;20,000 - 50,000;130;123;7;0;0;0
784950;CONFLICT OF NATIONS: WORLD WAR 3;Action, Adventure, Casual, Indie, RPG;200,000 - 500,000;2421;731;1690;3670;4638;1051
785030;Little Adventurer III;Action, Adventure, Indie;0 - 20,000;11;44;-33;0;0;0
785070;Dig and Shoot;Action, Adventure, Casual, Indie, RPG, Simulation, Early Access;0 - 20,000;6;2;4;0;0;0
785100;Cosmic Top Secret;Action, Indie, RPG;0 - 20,000;23;2;21;0;0;0
785110;Anime girl Or Bottle?;Action, Indie;0 - 20,000;108;22;86;0;0;0
785130;Clawface;Sports;20,000 - 50,000;128;16;112;1;1;1
785150;VIRUS RUSH;Action;0 - 20,000;4;0;4;0;0;0
785160;VEGAS Movie Studio 15 Steam Edition;Action, Free to Play;0 - 20,000;73;77;-4;0;0;3
785170;VEGAS Movie Studio 15 Platinum Steam Edition;Casual, Indie, Strategy;0 - 20,000;97;69;28;1650;1650;8
785260;Team Sonic Racing;Indie, Early Access;200,000 - 500,000;2058;781;1277;597;999;36
785430;Space Farm;Action, Adventure, Casual, Indie, RPG, Simulation, Strategy;0 - 20,000;1;4;-3;0;0;0
785480;Titanic: Adventure Out Of Time;Simulation, Strategy;0 - 20,000;235;35;200;394;394;6
785560;Scutter;Simulation, Strategy;0 - 20,000;7;0;7;0;0;0
785590;The Real Laser Ball;Adventure;0 - 20,000;8;2;6;0;0;0
785640;Luminescence;Action, Indie;0 - 20,000;28;17;11;0;0;0
785660;Subway Simulator;Action, Indie, Simulation, Early Access;0 - 20,000;118;105;13;76;76;0
785670;Great Hunt: North America;Casual, Strategy;0 - 20,000;14;28;-14;0;0;0
785680;Space Launch Engineer;Adventure, Casual, Indie, Racing;20,000 - 50,000;1;25;-24;0;0;0
785690;desTRUCKtors: Warfare Showdown;Indie, RPG, Simulation;0 - 20,000;8;7;1;0;0;0
785740;This Is the Police 2;Adventure, Indie;500,000 - 1,000,000;3927;1296;2631;942;930;62
785750;[東方二次] Senran Meisuishu Tactics / 戦乱命萃酒タクティクス;Racing, Simulation, Sports;0 - 20,000;21;4;17;0;0;0
785760;Crumple Zone;Action, Casual, Indie, Strategy;0 - 20,000;49;4;45;0;0;0
785770;Emergency Call 112 – The Fire Fighting Simulation 2;Casual, Indie, Simulation;100,000 - 200,000;1849;1453;396;101;101;145
785780;OF MICE AND SAND -REVISED-;Utilities, Video Production;100,000 - 200,000;201;59;142;123;123;4
785790;WHAT THE GOLF?;Casual, Indie, Strategy;200,000 - 500,000;2573;172;2401;262;335;30
785830;ADONIS;Indie, RPG;0 - 20,000;23;1;22;0;0;0
785840;Moe Jigsaw;Adventure, Casual, Indie, Massively Multiplayer;20,000 - 50,000;286;55;231;59;59;3
785850;Valthirian Arc: Hero School Story;Action, Adventure, Indie;20,000 - 50,000;179;117;62;0;0;3
785860;Zombie Watch;Indie;0 - 20,000;33;44;-11;0;0;0
785870;Admine;Action, Adventure, Indie;0 - 20,000;3;0;3;0;0;0
785880;OVERWHELM;Casual, Indie, Sports, Strategy;20,000 - 50,000;166;29;137;38;38;1
785890;Hexologic;Violent, Gore, Casual, Free to Play, Indie, Strategy;50,000 - 100,000;837;35;802;206;261;4
785920;Madness of the Architect;Casual, Indie;0 - 20,000;8;13;-5;0;0;0
785930;Command: The Silent Service;Adventure, Indie, RPG;0 - 20,000;10;8;2;0;0;0
785940;Strategic Command Classic: Global Conflict;Indie, Simulation, Strategy;0 - 20,000;9;2;7;0;0;0
785950;Sacrifice Dungeon;Adventure;0 - 20,000;4;34;-30;1;1;0
785990;Hub Culture VR;Casual, Indie, Simulation, Strategy;0 - 20,000;7;0;7;0;0;0
786020;Warhead;Casual, Indie, Simulation, Strategy;0 - 20,000;3;3;0;0;0;0
786040;Haunted Hotel: Lonely Dream;Action, Adventure, Indie, Simulation;0 - 20,000;7;1;6;0;0;1
786060;Sea of Lies: Burning Coast Collector's Edition;Casual;0 - 20,000;1;0;1;0;0;0
786070;Myths of the World: Spirit Wolf Collector's Edition;Action, Adventure, Indie, Racing;0 - 20,000;1;0;1;0;0;1
786080;Grim Facade: A Wealth of Betrayal Collector's Edition;Action, Indie, Early Access;0 - 20,000;1;1;0;0;0;0
786090;Rite of Passage: Hide and Seek Collector's Edition;Adventure, Casual, Indie, Simulation;0 - 20,000;7;0;7;0;0;0
786100;Maestro: Notes of Life Collector's Edition;Action;0 - 20,000;5;0;5;0;0;0
786120;Galaxy Wide Domination;Action, Adventure, Indie, Early Access;0 - 20,000;2;0;2;0;0;0
786130;Teeny Heist;Action, Casual, Indie;0 - 20,000;1;6;-5;0;0;0
786140;Plat4mer;Action, Indie;0 - 20,000;23;5;18;0;0;0
786170;Bomb Bay;Action, Free to Play, Early Access;0 - 20,000;2;1;1;0;0;0
786180;ReHack;Action, Adventure, Indie;0 - 20,000;41;9;32;0;0;0
786180;ReHack;Audio Production, Utilities, Video Production;0 - 20,000;41;9;32;0;0;0
786280;Armored Squad;Casual, Indie;0 - 20,000;12;2;10;0;0;0
786290;Undercover Agent;Adventure, Indie, RPG;0 - 20,000;6;4;2;0;0;0
786330;Internal Storm;Action, Casual, Indie;20,000 - 50,000;1;0;1;0;0;0
786340;Ativeil;Casual, Indie, Strategy;0 - 20,000;6;3;3;0;0;0
786350;Shinobi Bad Buddies;Action, Adventure, Indie;0 - 20,000;19;2;17;0;0;0
786370;Alien Crusader;Action, Adventure, Indie;20,000 - 50,000;49;30;19;110;111;0
786390;Purgatory Fell;Action, Adventure, Indie, Strategy;0 - 20,000;11;3;8;0;0;0
786400;Element Industry;Adventure, Casual;0 - 20,000;7;2;5;0;0;0
786410;An Aspie Life;Adventure, Casual;20,000 - 50,000;84;39;45;31;31;0
786420;Fantastic Sea;Adventure, Casual;0 - 20,000;11;4;7;0;0;0
786450;Don't Bite Me Bro! +;Adventure, Casual;100,000 - 200,000;213;58;155;130;130;4
786470;Border closure 边境封闭;Adventure, Casual;0 - 20,000;9;0;9;0;0;0
786490;Brew-Ha;Action, Casual, Indie;0 - 20,000;12;4;8;0;0;0
786510;Oracle of Forgotten Testament;Adventure, Indie, Simulation;0 - 20,000;26;6;20;0;0;0
786510;Oracle of Forgotten Testament;Adventure, Indie, RPG, Simulation;0 - 20,000;26;6;20;0;0;0
786520;SAO Utils: Beta;Action, Indie, Racing, Simulation, Sports;200,000 - 500,000;2435;346;2089;25605;685;2999
786540;Brick vs. Paddle;Action, Free to Play, Simulation, Sports, Early Access;0 - 20,000;1;0;1;0;0;0
786560;NeoBalls2;Casual, Indie;0 - 20,000;31;30;1;37;73;0
786570;The Alpha Device;Action, Adventure, Early Access;20,000 - 50,000;55;31;24;0;0;0
786580;Gleaner Heights;Adventure, Simulation;20,000 - 50,000;250;91;159;500;500;3
786590;Karloman and His Iced Muffins;Casual, Indie;0 - 20,000;3;0;3;0;0;0
786590;Karloman and His Iced Muffins;Adventure, Indie;0 - 20,000;3;0;3;0;0;0
786620;Dash Blitz;Action, Indie;0 - 20,000;4;0;4;0;0;0
786630;MY 1980's DASHBOARD;Adventure, Indie;0 - 20,000;52;12;40;0;0;0
786630;MY 1980's DASHBOARD;Action, Casual, Indie, Early Access;0 - 20,000;52;12;40;0;0;0
786650;Running King;Action, Indie;0 - 20,000;18;3;15;0;0;0
786670;Loot Box Simulator 20!8;Action, Indie, Simulation, Sports;0 - 20,000;28;55;-27;0;0;0
786680;Dungeons Forever;Casual, Indie, Simulation;20,000 - 50,000;97;20;77;10;14;0
786710;ECHOES OF WAR: The Last Heartbeat;Adventure, Indie;0 - 20,000;14;2;12;0;0;0
786720;Eternal Man: Forest;Casual, Indie, Strategy;0 - 20,000;19;10;9;0;0;0
786740;Proletarian Budget Survival;Action, Casual, Indie, Early Access;0 - 20,000;2;8;-6;0;0;0
786750;Squares;Adventure, Casual, Indie, RPG;20,000 - 50,000;35;29;6;0;0;0
786770;Z: The End;Casual, Indie;20,000 - 50,000;5;1;4;0;0;0
786800;Puzzles By Axis;Casual;0 - 20,000;2;0;2;0;0;0
786820;SOK MAX;Action;20,000 - 50,000;51;5;46;0;0;1
786840;OutOfColors;Action, Adventure, Indie, RPG;0 - 20,000;1;1;0;0;0;0
786850;Roun;Adventure, Casual, Indie;0 - 20,000;26;17;9;0;0;0
786910;Deluded Mind;Adventure, Simulation;0 - 20,000;61;34;27;22;22;0
786940;Afternoon empire;Action, Indie;0 - 20,000;0;7;-7;0;0;0
786950;Baptize Billy;Adventure, Indie, Strategy;0 - 20,000;4;1;3;0;0;0
786950;Baptize Billy;Casual, Indie, Simulation;0 - 20,000;4;1;3;0;0;0
786980;Behind The Beyond;Action, Indie, Racing, Simulation, Sports;0 - 20,000;5;13;-8;0;0;0
786990;SpellKeeper;Casual, Indie, Simulation;0 - 20,000;40;4;36;0;0;0
787040;Perfect Heist;Action, Adventure, Indie, Early Access;20,000 - 50,000;310;112;198;143;143;4
787050;Impossible Jumpy Quest;Adventure, Casual, Indie, Simulation;0 - 20,000;2;1;1;0;0;0
787070;Super Ledgehop: Double Laser;Adventure, Casual, Simulation;20,000 - 50,000;589;15;574;0;0;1
787100;Homeworld Defense;Indie;0 - 20,000;7;7;0;0;0;0
787110;Usotsuki Game / 谎言游戏;Violent, Action, Adventure, Casual, Indie, RPG, Simulation, Early Access;0 - 20,000;198;68;130;0;0;0
787120;There Is No Tomorrow: Revived Edition;Adventure, Casual, Indie, Simulation;20,000 - 50,000;16;10;6;0;0;1
787140;The Adventures of Kusoge;Action, Casual, Indie, Simulation;0 - 20,000;1;2;-1;0;0;0
787150;Necro Wars;Sexual Content, Violent, Adventure, Free to Play, Indie;0 - 20,000;6;0;6;0;0;0
787160;Frol Blok;Action, Simulation;0 - 20,000;0;0;0;0;0;0
787170;Choices: The Game;Action, Adventure, Indie, Racing, RPG, Sports;20,000 - 50,000;7;2;5;0;0;0
787200;Nova Wing;Casual;20,000 - 50,000;7;1;6;43;43;0
787220;Annotation of Love;Indie;20,000 - 50,000;74;27;47;1;1;0
787250;Clash of Castle;Simulation, Sports;20,000 - 50,000;26;25;1;0;0;0
787260;Universe Balancing Bureau;Action, Adventure, Casual, Indie;0 - 20,000;22;2;20;0;0;0
787300;Shadow: Treachery cannot be tolerated;Casual, Free to Play, Indie, RPG;0 - 20,000;4;9;-5;0;0;0
787370;Fable of the Sword;Indie, Simulation, Strategy;0 - 20,000;92;56;36;0;0;0
787400;Fantasy Versus;Action, Adventure, RPG, Early Access;50,000 - 100,000;394;118;276;56;75;1
787410;BoomTris;Casual, Indie, Simulation;0 - 20,000;0;1;-1;0;0;0
787420;Robot Fighting;Adventure, Casual;0 - 20,000;6;18;-12;0;0;0
787430;Steel Arena: Robot War;Casual, Indie, Simulation, Strategy;0 - 20,000;2;9;-7;0;0;0
787440;Sea Battle: Through the Ages;Action, Adventure, Indie, RPG, Strategy;0 - 20,000;14;9;5;52;52;0
787450;KOEWOTAYORINI / 声之寄托;Casual, Indie;100,000 - 200,000;770;127;643;62;66;1
787460;Squash Kings VR;Casual, Indie, Strategy;0 - 20,000;3;4;-1;0;0;0
787480;Phoenix Wright: Ace Attorney Trilogy;Casual, Indie, Strategy;500,000 - 1,000,000;17667;433;17234;1430;1050;615
787510;Muv-Luv Alternative Total Eclipse Remastered;Casual, Indie, Strategy;0 - 20,000;125;5;120;0;0;11
787530;Pale Lands VR;Casual, Indie, Strategy;0 - 20,000;3;2;1;0;0;0
787550;FARHOME;Casual, Indie, Strategy;0 - 20,000;16;11;5;0;0;0
787550;FARHOME;Adventure, Free to Play, Indie;0 - 20,000;16;11;5;0;0;0
787580;10 Pin Bowling (VR Support);Action, Casual, Indie, Sports, Early Access;20,000 - 50,000;0;1;-1;0;0;0
787620;Dinoku;Casual, Indie, Racing;0 - 20,000;6;0;6;0;0;0
787640;Shoppe Keep 2 Character Creator Preview;Casual, Free to Play, Massively Multiplayer, Simulation, Sports, Strategy;0 - 20,000;9;3;6;0;0;0
787650;Neonwall;Casual, Indie, Strategy;0 - 20,000;10;2;8;0;0;0
787690;Math Hero;Casual, Indie, Strategy;0 - 20,000;11;3;8;0;0;0
787710;Comrades and Barons: Solitaire of Bloody 1919;Action, Casual;0 - 20,000;38;4;34;0;0;0
787720;Block'hood VR;Indie, Sports;0 - 20,000;3;8;-5;0;0;0
787730;Adventure Game;Action, Casual, Indie;0 - 20,000;1;1;0;0;0;0
787740;Construction Simulator 2 US - Pocket Edition;Casual, Indie;100,000 - 200,000;406;142;264;1009;1015;9
787750;Blazing Core (beta);Indie, RPG;20,000 - 50,000;30;20;10;0;0;0
787780;In memory of TITAN;Action, Massively Multiplayer, RPG, Strategy;0 - 20,000;12;24;-12;0;0;0
787790;Epic Roller Coasters;Action, Casual, Indie, RPG, Sports;200,000 - 500,000;333;208;125;28;17;14
787810;Rogue Heroes: Ruins of Tasos;Action, Casual, Indie, Racing, Early Access;200,000 - 500,000;1725;431;1294;742;863;121
787820;Ricko's Island;Adventure;0 - 20,000;2;1;1;0;0;0
787840;Blacksmith;Action, Indie, Early Access;0 - 20,000;64;27;37;0;0;0
787850;Heroine Anthem Zero 2 : Scalescars Oath;Action, Casual, Indie;20,000 - 50,000;499;93;406;0;0;9
787860;Farming Simulator 19;Action, Adventure, Indie, RPG;2,000,000 - 5,000,000;62730;3891;58839;9487;3001;6088
787920;Running Fable;Action, Adventure, Indie, Massively Multiplayer;0 - 20,000;23;1;22;0;0;1
787930;American Railroads - Summit River & Pine Valley;Action, Adventure, Indie, RPG, Simulation;0 - 20,000;100;67;33;0;0;3
787940;Glista;Action, Adventure, Casual, Indie, Strategy;20,000 - 50,000;5;0;5;0;0;0
787960;Prism;Action, Adventure, Free to Play, Indie, Simulation, Strategy;0 - 20,000;2;2;0;0;0;0
787970;miraclr - Divine Dating Sim;Racing, Simulation, Sports;0 - 20,000;35;6;29;0;0;0
787990;Resume: The Video Game;Action, Adventure, Indie, RPG, Simulation;20,000 - 50,000;25;10;15;3;3;0
788000;RogueVerse;Action, Indie;0 - 20,000;5;0;5;0;0;0
788010;Carried Away: Winter Sports;Casual, Indie;0 - 20,000;22;5;17;0;0;0
788020;Critical Gravity;Adventure, Indie;0 - 20,000;6;2;4;0;0;0
788040;Edvog Explorer Game;Action, Adventure, Indie;0 - 20,000;1;0;1;0;0;0
788050;Re;Action, Casual, Free to Play, Massively Multiplayer, Simulation, Sports;;;;0;;;
788100;Neon Abyss;Adventure, Indie;1,000,000 - 2,000,000;17688;2352;15336;1258;669;554
788120;Disjoint;Strategy;0 - 20,000;3;1;2;0;0;0
788130;Otaku's Fantasy 2;Adventure, Indie, Simulation;50,000 - 100,000;468;213;255;180;212;1
788150;Go Away My Fat;Adventure, Casual, Indie, Simulation;0 - 20,000;35;5;30;0;0;0
788180;City of sky;Casual, Indie;0 - 20,000;7;2;5;0;0;0
788190;SUPER ASTEROIDS;Action, Adventure, Indie;0 - 20,000;14;6;8;0;0;0
788190;SUPER ASTEROIDS;Action, Adventure, RPG, Strategy, Early Access;0 - 20,000;14;6;8;0;0;0
788200;The Little Slime;Action, Adventure, Casual, Indie, Early Access;0 - 20,000;3;2;1;0;0;0
788210;The Bonfire: Forsaken Lands;Action, Adventure, Indie, Early Access;0 - 20,000;135;43;92;57;57;1
788250;Soul Grabber;Action, Adventure, Indie, Strategy;0 - 20,000;5;4;1;0;0;0
788260;Rules Of Survival;Casual, Indie;200,000 - 500,000;3152;2005;1147;886;709;2
788270;Exiled Kingdoms;Casual, Indie, Strategy;50,000 - 100,000;682;87;595;3139;3139;15
788310;Shallow Swing;Simulation, Utilities;0 - 20,000;4;0;4;0;0;0
788320;Balls and Magnets;Casual, Indie, RPG, Simulation, Strategy;0 - 20,000;21;7;14;0;0;0
788330;Varion;Simulation;0 - 20,000;20;0;20;0;0;0
788350;Funny Wings VR;Adventure, Indie, RPG;0 - 20,000;3;2;1;0;0;0
788380;Viki Spotter: The Farm;Casual, Indie, Early Access;0 - 20,000;88;14;74;0;0;0
788390;Uagi-Saba;Action, Adventure, Free to Play, Indie;0 - 20,000;18;2;16;0;0;0
788410;Tales of Nebezem: Elemental Link;Indie, Simulation;0 - 20,000;35;5;30;0;0;1
788420;Potion Explosion;Action, Indie, Simulation, Strategy;20,000 - 50,000;176;27;149;349;349;12
788470;Stonies;Casual, Indie;50,000 - 100,000;197;178;19;190;279;33
788480;Changeover: Decisions;Casual;0 - 20,000;37;12;25;0;0;0
788490;StackFortress;Casual, Indie;0 - 20,000;7;9;-2;0;0;0
788500;7 Soccer: a sci-fi soccer tale;Action, Casual, Simulation;0 - 20,000;1;3;-2;0;0;0
788510;Aeve:Zero Gravity;Casual, Indie, Strategy;0 - 20,000;31;87;-56;3;3;0
788520;Bleeding Knife;Casual, Free to Play, Simulation;0 - 20,000;15;2;13;0;0;0
788540;Vivez Versailles;Action, Casual, Indie, Simulation;0 - 20,000;26;13;13;0;0;0
788610;The Piano;Indie, Racing, Sports;0 - 20,000;17;15;2;0;0;0
788630;Gaia Beyond;Adventure, Casual, Free to Play, Simulation;100,000 - 200,000;163;51;112;0;0;0
788640;Dungeon Stars;Action, Adventure, Indie, RPG;;;;0;;;
788670;Waxworks: Curse of the Ancestors;Indie, Strategy, Early Access;20,000 - 50,000;26;23;3;0;0;0
788690;Psychonauts in the Rhombus of Ruin;Action, Adventure, Casual, Indie, Early Access;50,000 - 100,000;424;60;364;92;92;0
788700;ValeGuard;Action, Adventure, Indie;20,000 - 50,000;114;48;66;129;129;1
788720;Naturallandscape - GuilinLandscape (自然景观系列-桂林山水);Violent, Action, Adventure;0 - 20,000;4;5;-1;0;0;0
788730;Mortar and Pestle;Action, Adventure, Casual, Indie, Early Access;0 - 20,000;1;0;1;0;0;0
788740;A Salem Witch Trial - Murder Mystery;Adventure, Casual, Indie, RPG, Early Access;0 - 20,000;41;22;19;0;0;0
788760;Cubiques;Action, Indie;0 - 20,000;26;3;23;0;0;0
788760;Cubiques;Action, Indie;0 - 20,000;26;3;23;0;0;0
788770;Meteor 60 Seconds!;Indie, RPG, Strategy;200,000 - 500,000;3997;151;3846;35;23;6
788800;Magic Tower 3D;Indie, Strategy;0 - 20,000;4;13;-9;0;0;0
788810;Exposure;Adventure, Indie;0 - 20,000;14;14;0;0;0;0
788820;Lightning War;Casual, Indie;0 - 20,000;11;8;3;0;0;0
788870;In The Long Run The Game;Casual, Indie;0 - 20,000;6;13;-7;0;0;0
788890;Tomato Jones - Episode 3;Adventure, Indie;0 - 20,000;8;4;4;0;0;0
788900;VR_PlayRoom : Episode Beginning (Escape Room - Horror);Casual, Simulation, Strategy;0 - 20,000;4;1;3;0;0;0
788910;Apartment of Love;Adventure, Free to Play, Simulation;20,000 - 50,000;152;94;58;24;24;1
788930;Razerwire:Nanowars;Adventure, Indie, RPG, Strategy;;;;0;;;
788940;Xara Designer Pro X 15 Steam Edition;Action, Adventure, Casual, Indie, RPG, Simulation, Strategy;0 - 20,000;11;7;4;0;0;0
788960;MAR WAR: The Evil Awakens;Action, Indie, Early Access;0 - 20,000;1;7;-6;0;0;0
788970;Hidden Object Adventure: Captain Nemo. Objets Cachés;Free to Play, Massively Multiplayer, RPG;0 - 20,000;82;28;54;0;0;1
789010;Wanderfog;Adventure, Indie, RPG;0 - 20,000;13;5;8;0;0;0
789050;Paradise;Adventure, Indie, RPG;0 - 20,000;34;4;30;0;0;0
789090;Rainbow Reactor;Action, Casual;0 - 20,000;90;8;82;0;0;0
789100;My Little Farmies;Casual, Indie;100,000 - 200,000;209;184;25;5;5;127
789160;Plastic Rebellion;Casual, Indie, RPG, Strategy;0 - 20,000;10;4;6;0;0;0
789200;S.P.I.K.E: ARENA;Casual;0 - 20,000;20;10;10;0;0;0
789210;NCradle: An 80s Synth Adventure;Adventure, Casual;0 - 20,000;1;0;1;0;0;0
789220;★ Fallalypse ★ Death or Cress ♝;Adventure, Indie;0 - 20,000;8;19;-11;0;0;0
789240;The Day I Died;Action, Adventure, Indie;0 - 20,000;10;2;8;0;0;0
789260;Unmoor;Casual, Indie;0 - 20,000;78;23;55;0;0;0
789280;Rysen;Action, Adventure, Indie;0 - 20,000;7;0;7;0;0;0
789290;RPG Merchant;Strategy;0 - 20,000;13;6;7;0;0;0
789380;Sometimes to Deal with the Difficulty of Being Alive, I Need to Believe There Is a Possibility That Life Is Not Real.;Action, Adventure, Casual, Indie;0 - 20,000;63;13;50;0;0;0
789480;AstroBlast VR;Action, Casual, Indie, Strategy;0 - 20,000;13;0;13;0;0;0
789490;Boom! Maze;Action, Adventure, Casual, Indie, Strategy, Early Access;0 - 20,000;1;1;0;0;0;0
789510;Super Goribei;Action, Casual, Indie;0 - 20,000;2;5;-3;0;0;0
789520;Warz: Horde;Action, Casual, Indie;0 - 20,000;2;9;-7;0;0;0
789540;The Adventures of Nick & Willikins;Casual, Indie, Strategy;20,000 - 50,000;108;11;97;0;0;0
789550;Bright Bob;Indie;0 - 20,000;20;11;9;0;0;0
789550;Bright Bob;Casual, Early Access;0 - 20,000;20;11;9;0;0;0
789570;Nepenthe;Adventure, Indie, Simulation;0 - 20,000;75;5;70;0;0;0
789580;I・S・U ~Fighting Musical Chair~;Action, Casual, Indie;0 - 20,000;0;0;0;0;0;0
789600;Mortal box;Action, Adventure, Indie;0 - 20,000;2;0;2;0;0;0
789610;Splash Adventure: The Maze of Morla;Casual, Indie;0 - 20,000;1;0;1;0;0;0
789620;Crypt- The Black Tower;Indie, RPG;20,000 - 50,000;105;34;71;7;7;0
789660;Buggos;Adventure, Indie, RPG;0 - 20,000;393;62;331;707;707;8
789660;Buggos;Adventure, Indie, RPG;0 - 20,000;393;62;331;707;707;8
789670;UNHALLOWED: THE CABIN;Adventure, Indie, RPG;0 - 20,000;11;7;4;0;0;0
789680;Mech Troid;Adventure, Indie, RPG;0 - 20,000;2;3;-1;0;0;0
789700;Wendy’s Mart 3D;Action, Indie, Early Access;0 - 20,000;1;1;0;0;0;0
789710;BoyAndLabyrinth;Action;0 - 20,000;0;0;0;0;0;0
789720;Aurora;Indie, Early Access;0 - 20,000;3;0;3;0;0;0
789730;Not Without My Poop;Sports;20,000 - 50,000;149;36;113;11;11;0
789740;Maidens of a Hollow Dream;Indie, Strategy;0 - 20,000;51;15;36;0;0;0
789750;Idle Earth;Indie, Strategy, Early Access;0 - 20,000;16;7;9;0;0;0
789760;DEAD OR SCHOOL;Action, Indie, RPG, Simulation;50,000 - 100,000;2223;381;1842;185;167;7
789770;Starena;Action, Indie;0 - 20,000;57;11;46;0;0;0
789830;[TDA03] Muv-Luv Unlimited: THE DAY AFTER - Episode 03 REMASTERED;Sexual Content, Nudity, Casual, Indie;0 - 20,000;53;3;50;0;0;0
789840;A Dream of Burning Sand;Adventure, Casual;0 - 20,000;1;1;0;0;0;0
789880;Ghost Platoon;Indie;0 - 20,000;8;15;-7;0;0;0
789890;City Patrol: Police;Action, Adventure, Indie;0 - 20,000;14;22;-8;0;0;0
789900;My Little Riding Champion;Adventure, Casual, Indie, Simulation;0 - 20,000;28;30;-2;0;0;0
789910;Planet of the Apes: Last Frontier;Action;0 - 20,000;116;50;66;0;0;0
789930;Blind Boris;Action, Adventure, Indie, RPG, Simulation, Early Access;0 - 20,000;11;12;-1;0;0;0
789950;INFERNIUM;Action, Casual, Indie;20,000 - 50,000;116;57;59;74;74;0
789960;DARCO - Reign of Elements;Indie, Simulation, Strategy, Early Access;0 - 20,000;35;22;13;0;0;0
789970;Let's Kill Zombies VR;Casual, Indie, Simulation;0 - 20,000;1;1;0;0;0;0
789980;Twilight on Yulestead;Gore, Action, Adventure, Indie, RPG, Strategy, Early Access;0 - 20,000;0;2;-2;0;0;0
790020;Lightfield HYPER Edition;Casual, Free to Play, Indie, Simulation, Strategy, Early Access;0 - 20,000;48;12;36;0;0;0
790030;Hexer;Action, Casual, Indie, Strategy;0 - 20,000;1;0;1;0;0;0
790050;Porcelain Panic;Action, Adventure, Casual, Indie;0 - 20,000;3;0;3;0;0;0
790060;The Void Rains Upon Her Heart;Action, Casual, Indie, Sports, Strategy;0 - 20,000;539;0;539;0;0;4
790080;ZEROCAR: Future Motorsport;Casual, Strategy;0 - 20,000;23;10;13;0;0;0
790120;Run and Jump;Indie, RPG, Strategy;0 - 20,000;42;3;39;0;0;0
790130;ORE;Indie;0 - 20,000;13;10;3;0;0;0
790160;Five Keys to Exit;Adventure, Indie;0 - 20,000;8;27;-19;0;0;0
790170;Fairly Certain Doom;Adventure, Casual, Indie;0 - 20,000;4;0;4;0;0;0
790210;Neon Knight: Vengeance From The Grave;Action, Adventure, Indie;0 - 20,000;3;4;-1;0;0;0
790230;Zombie Clicker Defense;Indie, Simulation, Sports, Strategy;20,000 - 50,000;21;25;-4;0;0;0
790250;Bloodgeon;Action, Adventure, Indie;0 - 20,000;5;2;3;0;0;0
790260;Kate's Test;Adventure, Indie, RPG;0 - 20,000;14;3;11;0;0;0
790290;Lonely in the Winter;Casual, RPG, Simulation;20,000 - 50,000;49;3;46;0;0;0
790300;Puzzle for Kids;Action, Adventure, Casual, Indie;0 - 20,000;5;5;0;0;0;0
790350;The Inner Friend;Indie;0 - 20,000;48;7;41;0;0;0
790360;WarriOrb;Action, Indie, Early Access;0 - 20,000;124;28;96;0;0;1
790390;The Revenge of Johnny Bonasera: Episode 2;Indie, RPG;0 - 20,000;20;1;19;0;0;0
790450;ANYKEY;Indie, Simulation;20,000 - 50,000;58;13;45;3;3;0
790540;THE QUIET MAN;Violent, Action, Indie;20,000 - 50,000;198;369;-171;0;0;0
790550;Monktastic;Casual, Indie, Simulation;0 - 20,000;3;0;3;0;0;0
790570;Innocent VR;Adventure, Casual, Indie;0 - 20,000;6;5;1;0;0;0
790600;Stormbound;Nudity, Violent, Gore, Action, Adventure, Indie, RPG;100,000 - 200,000;726;303;423;144;214;34
790610;5Rings;Casual, Free to Play, Simulation;0 - 20,000;1;8;-7;0;0;0
790630;BoxCat;Action;0 - 20,000;13;1;12;0;0;0
790650;MARVEL END TIME ARENA;Indie, Strategy, Early Access;100,000 - 200,000;368;160;208;210;210;0
790700;BugOut;Action, Adventure, Casual, Indie, Racing, Simulation, Sports;0 - 20,000;17;17;0;0;0;0
790710;World of Warplanes;Casual, Indie, Early Access;500,000 - 1,000,000;2658;896;1762;35680;87;216
790730;Nero Burning ROM - All-in-One Disc Burn Solution;Action, Adventure, Casual, Indie;0 - 20,000;11;6;5;0;0;0
790740;Tick Tock: A Tale for Two;Action, Casual, Indie, Simulation;500,000 - 1,000,000;7673;1063;6610;206;152;24
790740;Tick Tock: A Tale for Two;Casual, Indie, Strategy;500,000 - 1,000,000;7673;1063;6610;206;152;24
790750;oVRshot;Casual, Simulation;0 - 20,000;51;9;42;225;225;0
790750;oVRshot;Action, Massively Multiplayer, Racing, Simulation;0 - 20,000;51;9;42;225;225;0
790760;Space Chip;Casual, Indie, Racing;0 - 20,000;2;3;-1;0;0;0
790780;Yozakura Wizard VR;Casual, Indie, Simulation;0 - 20,000;4;0;4;0;0;0
790790;Impossible Runner;Action, Casual, Free to Play, Indie, Early Access;50,000 - 100,000;148;84;64;5;6;0
790800;Ascent Spirit;Action, Adventure, Indie;0 - 20,000;0;10;-10;0;0;0
790810;Voxel Baller;Casual, Free to Play;0 - 20,000;4;15;-11;0;0;0
790820;Valkyria Chronicles 4 Complete Edition;Indie, RPG;200,000 - 500,000;4871;692;4179;718;649;110
790850;Undead Horde;Action, Casual, Indie;200,000 - 500,000;1055;150;905;240;259;8
790860;Chocolate makes you happy 3;Action, Casual, Indie;0 - 20,000;90;30;60;1;1;0
790860;Chocolate makes you happy 3;Nudity, Violent, Gore, Action, Indie, Simulation;0 - 20,000;90;30;60;1;1;0
790900;Home Architect - Design your floor plans in 3D - Ultimate Edition;Adventure, Casual, Indie;0 - 20,000;0;7;-7;0;0;1
790930;Primitive Shooter;Action, Indie, Strategy;20,000 - 50,000;65;20;45;0;0;0
790950;Feed Eve;Action, Casual;0 - 20,000;4;7;-3;0;0;0
790960;Beer Ranger;Action, Indie, RPG;0 - 20,000;5;1;4;0;0;0
791000;Atomic Heist;Action, Free to Play, Indie, Early Access;0 - 20,000;9;0;9;0;0;0
791020;Drumpf: Rise Up, Libertonia!;Action, Casual, Racing, Simulation, Sports;0 - 20,000;31;7;24;0;0;0
791040;Virtual Reality Neuron Tracer;Casual, Indie, Simulation, Sports, Early Access;0 - 20,000;4;1;3;0;0;0
791050;I Hate Heroes: Rocket Man;Casual, Indie, Simulation, Sports, Early Access;0 - 20,000;3;4;-1;0;0;0
791140;Shatter EVERYTHING (VR);Casual, Indie, Simulation, Sports, Early Access;0 - 20,000;10;1;9;0;0;0
791150;EV3 - Drag Racing;Casual, Indie, Simulation, Sports, Early Access;50,000 - 100,000;104;105;-1;58;108;2
791160;Icky;Casual, Indie, Simulation, Sports, Early Access;0 - 20,000;12;5;7;0;0;0
791180;1 Screen Platformer;Adventure, Casual, RPG;0 - 20,000;350;51;299;0;0;1
791240;Lumote: The Mastermote Chronicles;Action, Adventure, Casual, Free to Play, Indie, Massively Multiplayer, RPG, Strategy, Early Access;0 - 20,000;71;1;70;0;0;1
791260;Pandora: Chains of Chaos;Adventure, Casual, Indie;0 - 20,000;11;4;7;0;0;0
791290;Space Ball;Adventure, Indie;0 - 20,000;4;1;3;0;0;0
791300;Canek: Quest for Corn [Demo];Indie, Early Access;0 - 20,000;23;5;18;0;0;0
791320;Zahalia;Adventure, Casual, Strategy;20,000 - 50,000;7;4;3;0;0;0
791330;Fallen ~Makina and the City of Ruins~;Adventure, Indie, RPG, Strategy;200,000 - 500,000;1390;230;1160;132;132;27
791370;Xploquest 2;Action, Casual, Indie, Strategy;0 - 20,000;11;1;10;0;0;0
791380;Way Out;Casual, Indie, Racing;50,000 - 100,000;3;5;-2;206;237;0
791390;Mr Dirt Poor 吃土计划;Casual, Indie;0 - 20,000;5;12;-7;0;0;0
791400;From Village to Empire;Casual, Indie, Simulation;0 - 20,000;19;9;10;0;0;0
791430;THE ARCHER: Dead Hunt;Action, Adventure, Indie, Early Access;0 - 20,000;9;16;-7;0;0;0
791470;DYO;Casual, Indie, Simulation;50,000 - 100,000;854;27;827;73;106;11
791490;Rainbow Cult;Action, Indie;0 - 20,000;1;0;1;0;0;0
791570;Redline Ultimate Racing;Adventure, Casual, Indie;0 - 20,000;7;16;-9;0;0;0
791590;Psychiatrist Simulator;Action, Adventure, Casual, Indie, Simulation;0 - 20,000;35;52;-17;3;3;0
791600;Aplestia;Violent, Action, Casual;0 - 20,000;5;1;4;0;0;0
791700;Bird Game;Adventure;20,000 - 50,000;52;16;36;0;0;0
791740;Gladiators Of The Arena;Sexual Content, Nudity, Adventure, Casual;0 - 20,000;2;1;1;0;0;0
791750;President Trump The Way In Uganda;Sexual Content, Nudity, Violent, Gore, Adventure, Casual;0 - 20,000;115;21;94;0;0;0
791760;A Story of Distress;Adventure, Indie;0 - 20,000;9;10;-1;0;0;0
791770;Try To Fall Asleep;Indie;0 - 20,000;141;11;130;0;0;0
791790;No safety;Adventure, Indie, RPG;0 - 20,000;0;11;-11;0;0;0
791800;Mind Over Mushroom;Free to Play, RPG, Strategy;0 - 20,000;9;1;8;0;0;0
791880;Essence of Illumination: The Beginning;Action, Casual;0 - 20,000;4;3;1;0;0;0
791880;Essence of Illumination: The Beginning;Casual, Free to Play, Indie, Accounting, Animation & Modeling, Audio Production, Design & Illustration, Education, Photo Editing, Software Training, Utilities, Video Production, Web Publishing;0 - 20,000;4;3;1;0;0;0
791930;BombTag;Casual, Free to Play, Indie;200,000 - 500,000;1227;232;995;57;34;8
791950;Hiking Simulator 2018;Adventure;200,000 - 500,000;8;21;-13;0;0;0
791960;Cactus Jumper;Action, Casual;0 - 20,000;25;3;22;3;3;0
791990;MOBA GM;Action, Indie;0 - 20,000;17;14;3;0;0;2
792000;Pit Blocks 3D;Adventure, Indie;0 - 20,000;3;4;-1;0;0;0
792030;Just, Bearly;Free to Play, Early Access;20,000 - 50,000;454;30;424;7;7;0
792040;Detective Di: The Silk Rose Murders;Adventure, Casual;100,000 - 200,000;911;101;810;456;552;1
792050;Beneath The Surface;Action, Free to Play, Strategy;20,000 - 50,000;351;22;329;0;0;0
792060;Stickman Fighting;Adventure, Casual, Indie, RPG;0 - 20,000;5;8;-3;0;0;0
792070;Asteion Nights;Action, Casual, Indie, Sports;0 - 20,000;2;2;0;0;0;0
792080;glutton man;Indie, Simulation;20,000 - 50,000;2;0;2;0;0;0
792100;7 Billion Humans;Action, Adventure, Indie;200,000 - 500,000;1394;100;1294;916;1036;11
792120;FIGHT KNIGHT;Casual, Indie, Simulation, Strategy;50,000 - 100,000;796;46;750;663;663;3
792160;Heroes Of Hellas 4: Birth Of Legend;Adventure, Indie, RPG, Early Access;0 - 20,000;36;2;34;0;0;4
792190;Iridescence;Violent, Action, Adventure, Indie, Strategy;0 - 20,000;1;0;1;0;0;0
792220;Paunch;Action, Casual, Indie;500,000 - 1,000,000;9225;1058;8167;0;0;8
792230;Zombie Serial Killer Incident;Casual, Indie;0 - 20,000;2;0;2;0;0;0
792300;The Beast Inside;Sexual Content, Nudity, Violent, Gore, Action, Adventure, Indie, Early Access;200,000 - 500,000;6355;1285;5070;233;230;103
792320;Sunburnt;Casual, Indie, Strategy;0 - 20,000;7;3;4;0;0;0
792340;ESPER;RPG, Strategy;0 - 20,000;9;2;7;0;0;0
792350;Joy Climb;Casual, Indie;0 - 20,000;33;4;29;0;0;0
792370;A Rite from the Stars;RPG, Strategy;0 - 20,000;22;4;18;0;0;1
792400;Battleship Lonewolf 2;Adventure;0 - 20,000;3;3;0;0;0;0
792410;Viki Spotter: Undersea;Adventure, Casual, Indie, Early Access;20,000 - 50,000;58;7;51;0;0;0
792470;WWⅡ英雄列伝 泥の中の虎　オットー・カリウス;Action, Adventure, Indie;0 - 20,000;0;1;-1;0;0;0
792480;Name The Song Quiz;Action, Casual, Free to Play, Massively Multiplayer, Strategy, Early Access;0 - 20,000;20;23;-3;0;0;0
792500;Streets Ablaze;Action, Adventure, Casual, Indie, RPG;0 - 20,000;15;7;8;0;0;0
792550;Welcome to Wacken;Action, Indie, Racing, Sports;0 - 20,000;1;6;-5;0;0;0
792560;Ukhar;Action, Indie;0 - 20,000;26;2;24;0;0;0
792570;BattleCON: Online;Action, Adventure, Indie;50,000 - 100,000;202;74;128;0;0;0
792640;Inca Blocks;Simulation;20,000 - 50,000;15;15;0;0;0;0
792650;Super Jigsaw Puzzle;Adventure, Casual, Indie;0 - 20,000;89;11;78;209;209;6
792660;The Operational Art of War IV;Action, Casual, Indie;0 - 20,000;209;46;163;109;109;36
792670;The Woods;Adventure, Indie, Simulation, Early Access;0 - 20,000;1;7;-6;0;0;0
792680;Containment Initiative: PC Standalone;Action, Adventure;0 - 20,000;4;4;0;0;0;0
792710;Levelhead: Platformer Maker;Action, Indie;50,000 - 100,000;819;50;769;354;562;10
792720;Boxing Apocalypse;Casual, Indie;0 - 20,000;9;2;7;0;0;0
792760;The Necklace of Blood;Action, Adventure, Casual, Indie;0 - 20,000;3;3;0;0;0;0
792800;Adventures of Hendri;Action, Adventure, Indie;0 - 20,000;7;13;-6;0;0;0
792800;Adventures of Hendri;Casual, Indie, Simulation;0 - 20,000;7;13;-6;0;0;0
792810;Balloon;Adventure, Casual, Indie;20,000 - 50,000;9;18;-9;0;0;0
792820;Lost In 80s II;Action, Early Access;0 - 20,000;1;0;1;0;0;0
792820;Lost In 80s II;Indie, Simulation, Strategy;0 - 20,000;1;0;1;0;0;0
792850;Robo Puzzle Smash;Action, Casual, Indie, Simulation;0 - 20,000;13;2;11;0;0;0
792860;Road Doom;Action, Strategy, Early Access;0 - 20,000;40;7;33;0;0;0
792870;Super Nosebleed Land;Action, Indie, Simulation, Sports;0 - 20,000;1;1;0;0;0;0
792880;Never Stop Sneakin';Action, Casual, Indie, Massively Multiplayer;0 - 20,000;17;11;6;0;0;0
792900;OutBreak Zombie;Action, Casual;0 - 20,000;2;6;-4;0;0;0
792920;BRIG 12;Casual;0 - 20,000;0;0;0;0;0;0
792930;Age of Viking Conquest;Action, Casual, Indie;0 - 20,000;24;15;9;0;0;1
792940;Sail and Sacrifice;Action, Casual, Indie, Sports;0 - 20,000;5;17;-12;0;0;0
792970;Wheelz2;Action, Adventure, Indie;0 - 20,000;21;9;12;0;0;0
792990;Identity;Adventure;20,000 - 50,000;373;1680;-1307;0;0;0
793000;Star-Pit Starship;Indie, Strategy;20,000 - 50,000;2;0;2;0;0;0
793010;Super Pillow Fight;Sexual Content, Nudity, Action, Adventure, Indie, RPG;0 - 20,000;13;3;10;0;0;0
793030;Asteroid Defender!;Action, Indie, Strategy, Early Access;0 - 20,000;3;0;3;0;0;0
793050;UNDEAD FACTORY:Zombie Pandemic;Casual, Indie, Strategy;20,000 - 50,000;47;39;8;1;1;1
793060;Starship;Casual, Indie;20,000 - 50,000;2;0;2;0;0;0
793080;ばるばろっさ! ～すすめ? 赤軍少女旅団～(全年齢版);Action, Adventure, Indie;0 - 20,000;2;0;2;0;0;0
793150;Moe! Ninja Girls;Adventure, Casual;20,000 - 50,000;213;74;139;0;0;4
793170;Seeking Dawn: Free to Play Edition;Adventure, Casual;0 - 20,000;16;15;1;0;0;0
793180;魔王村长和杂货店-Hero Village Simulator;Adventure, Casual;0 - 20,000;3;12;-9;0;0;0
793190;Daily OVR;Adventure, Casual;0 - 20,000;45;17;28;0;0;2
793200;Escape the Darkness;Action, Indie;0 - 20,000;36;9;27;0;0;0
793200;Escape the Darkness;Casual, Indie, Simulation, Strategy;0 - 20,000;36;9;27;0;0;0
793210;The Cathedral: Allison's Diary;Action, Free to Play, Indie, Massively Multiplayer;0 - 20,000;8;3;5;0;0;0
793220;A Fine Mess;Adventure, Indie, RPG;0 - 20,000;18;6;12;0;0;0
793240;Merlin vs Zombies;Indie, Simulation;20,000 - 50,000;40;15;25;52;52;1
793250;Casino Poker;Indie;50,000 - 100,000;0;2;-2;0;0;0
793260;Army of Squirrels;Action, Indie;0 - 20,000;11;5;6;0;0;0
793280;Neon Valley: Revenge;Casual, Indie;0 - 20,000;4;1;3;0;0;0
793350;Swarmlake;Violent, RPG, Strategy;200,000 - 500,000;1541;67;1474;100;106;3
793360;Big Crown: Showdown;Action, Indie;0 - 20,000;16;13;3;0;0;0
793370;KIDS;Action, Indie;50,000 - 100,000;1356;265;1091;26;31;0
793400;Fist of Brave;Action, Casual;0 - 20,000;0;0;0;0;0;0
793410;橙天の銀翼　～スカイランドの魔女と巫女～;Indie, Simulation;0 - 20,000;3;0;3;0;0;0
793450;Desecration of Wings;Casual, Indie;0 - 20,000;56;3;53;0;0;1
793460;112 Operator;Casual, Indie;200,000 - 500,000;3876;496;3380;575;343;87
793480;Trick Shot;Action, Casual, Indie;0 - 20,000;2;0;2;0;0;0
793490;Exocraft;Action, Adventure, Casual, Indie;100,000 - 200,000;171;144;27;0;0;1
793510;Dusk Of Confinement;Casual, Indie;0 - 20,000;5;14;-9;0;0;0
793560;Warfare 1944;Action, Indie, Strategy;0 - 20,000;70;53;17;0;0;0
793570;Trenchfoot;Adventure, Casual, Indie;0 - 20,000;0;1;-1;0;0;0
793600;Bully Beatdown;Racing, Simulation, Sports, Early Access;0 - 20,000;53;11;42;0;0;0
793620;Hellbreaker;Action, Adventure, Casual, Indie;0 - 20,000;16;6;10;0;0;0
793630;GROOD;Action;0 - 20,000;25;3;22;0;0;0
793640;D.C. S#*!storm;Action, Adventure, Casual, Indie;;;;0;;;
793670;The Wastes;Action, Adventure, Indie;0 - 20,000;21;4;17;0;0;0
793690;Final Assault;Action, Casual, Indie, Simulation;50,000 - 100,000;415;28;387;0;0;2
793760;My Sweet Waifu;Casual, Indie;0 - 20,000;18;15;3;0;0;0
793820;Coffee Crawl;Indie, Strategy;0 - 20,000;9;4;5;31;31;0
793830;Kharon's Crypt - Even Death May Die;Strategy;0 - 20,000;91;0;91;0;0;0
793880;MIRAGE;Adventure, Indie;0 - 20,000;92;19;73;0;0;0
793940;MOAI 5: New Generation Collector’s Edition;Adventure, Casual, Indie, RPG, Strategy, Early Access;0 - 20,000;19;9;10;0;0;5
793970;Super Kids Racing;Adventure, Casual, Indie;0 - 20,000;7;16;-9;0;0;0
793990;Dupio;Casual;0 - 20,000;23;18;5;0;0;0
794030;Pegasus-5: Gone Astray;Casual, Indie;0 - 20,000;31;1;30;0;0;0
794040;The Broken Seal: Arena;Action, Casual, Indie;0 - 20,000;5;2;3;0;0;0
794180;PRO FISHING SIMULATOR;Indie;0 - 20,000;22;21;1;458;458;1
794190;Football Russian 20!8;Action, Free to Play, Massively Multiplayer, Racing, Sports, Strategy;0 - 20,000;59;12;47;0;0;0
794230;Golden8bits;Adventure, Indie;0 - 20,000;3;3;0;0;0;0
794260;Outward Definitive Edition;Action, Casual;500,000 - 1,000,000;16317;5847;10470;1353;482;567
794270;Landinar: Into the Void;Action, Casual, Indie, Simulation, Strategy;20,000 - 50,000;131;89;42;213;213;1
794300;Simple Man;Casual, Indie, RPG;0 - 20,000;9;13;-4;0;0;0
794350;No Captain Allowed!;Action, Adventure, Indie, Massively Multiplayer, RPG;0 - 20,000;14;10;4;0;0;0
794390;Zed Survival;Action, Indie;0 - 20,000;51;2;49;0;0;0
794480;Ottoman Empire: Spectacular Millennium;Action, Indie;0 - 20,000;26;5;21;0;0;0
794490;Journey Of Life;Action, Adventure, Free to Play, Indie, Simulation;50,000 - 100,000;431;299;132;0;0;2
794530;Zombie Lane Survival;Casual, Indie, Strategy;0 - 20,000;2;9;-7;0;0;0
794540;Neo Cab;Casual, Indie, RPG, Simulation, Strategy;200,000 - 500,000;1612;315;1297;317;317;8
794550;Grapple Force Rena;Action, Casual, Indie, Sports;;;;0;;;
794570;XBall Champion;Action, Casual, Indie;0 - 20,000;13;7;6;0;0;0
794580;SNK HEROINES Tag Team Frenzy;Action, Adventure, Casual, Indie;0 - 20,000;452;175;277;82;140;5
794600;LET IT DIE;Action, Indie;1,000,000 - 2,000,000;3736;1317;2419;1699;255;107
794630;Puzzle 3D;Action, Indie;20,000 - 50,000;1;1;0;0;0;0
794640;Tommyknockers;Action, Casual, Indie, RPG, Early Access;0 - 20,000;2;1;1;0;0;0
794650;I saw IT;Indie;0 - 20,000;16;28;-12;0;0;0
794710;挙式VR 鴻上大和 編 Wedding VR : Yamato;Casual, Indie;0 - 20,000;2;1;1;0;0;0
794730;挙式VR 伊達政宗 編 Wedding VR : Masamune;Action, Indie;0 - 20,000;1;1;0;0;0;0
794740;Patent9 - Goddess of Trust;Simulation;0 - 20,000;46;15;31;0;0;0
794760;ABYSS CRAWLERS plus　迷宮クロウラ＋;Casual, Indie, Sports;0 - 20,000;67;6;61;0;0;0
794780;Pathogen-病原体;Action, Indie;0 - 20,000;17;5;12;0;0;0
794800;Clue/Cluedo: The Classic Mystery Game;Sexual Content, Violent, Casual, Free to Play, Indie;200,000 - 500,000;2144;294;1850;407;581;78
794820;Knights of Pen and Paper 2: Free Edition;Action, Indie, RPG;50,000 - 100,000;150;73;77;20;36;0
794830;"Abha ""Light on the Path""";Action, Adventure, Casual, Indie, Racing, Sports, Strategy;0 - 20,000;11;1;10;0;0;0
794850;Landflix Odyssey;RPG;0 - 20,000;11;2;9;0;0;0
794860;eSail Sailing Simulator;Adventure, Casual, Indie;0 - 20,000;476;30;446;44;44;13
794940;Hexa Turn;Action, Casual;0 - 20,000;90;9;81;52;52;0
794950;The Frosty Leaves 寒叶下的薄冰;Simulation, Strategy;0 - 20,000;51;11;40;0;0;0
794960;The Sojourn;Indie, Early Access;0 - 20,000;119;39;80;0;0;4
794990;Geometry Runner Online;Action, Adventure, Indie;0 - 20,000;5;6;-1;0;0;0
795040;E.Z;Indie, Strategy;0 - 20,000;202;18;184;0;0;0
795050;Techno Boy;Indie;0 - 20,000;14;0;14;0;0;0
795100;Friday the 13th: Killer Puzzle;Action, Casual, Indie;500,000 - 1,000,000;5226;340;4886;137;66;31
795110;IIN;Casual;0 - 20,000;22;5;17;0;0;0
795120;To The Capital 2;Casual, Simulation, Sports;20,000 - 50,000;5;1;4;0;0;0
795140;Roanoke;Action, Adventure, Indie, Strategy, Early Access;0 - 20,000;1;6;-5;0;0;0
795160;Tsundere Idol;Casual, Indie;20,000 - 50,000;51;24;27;1;1;0
795220;Wildlife Tycoon: Venture Africa;Action, Indie, Early Access;0 - 20,000;22;2;20;0;0;0
795230;Venture Arctic;Action, Casual, Indie, Strategy;0 - 20,000;2;3;-1;0;0;0
795320;Dissimilation;Indie, RPG, Early Access;0 - 20,000;1;1;0;0;0;0
795420;The Darkside Detective: A Fumble in the Dark;Adventure, Casual, Indie, RPG;20,000 - 50,000;1082;30;1052;626;626;11
795430;Puzzle Lab;Casual, Indie;0 - 20,000;3;1;2;0;0;0
795440;Why War?;Action, Indie, Simulation, Strategy;0 - 20,000;2;0;2;0;0;0
795480;Unknown Pain: Hardcore;Adventure, Casual, Simulation;0 - 20,000;1;5;-4;0;0;0
795490;FukTopia;Indie, Simulation, Strategy;0 - 20,000;6;9;-3;0;0;0
795510;Koihime Enbu RyoRaiRai 恋姫†演武 ～遼来来～;Action, Indie;0 - 20,000;124;10;114;61;61;0
795530;Viral Cry;Adventure, Casual, Indie, RPG, Simulation, Strategy;0 - 20,000;9;10;-1;0;0;0
795550;Warawara Invaders;Action, Free to Play, Indie, Early Access;0 - 20,000;3;1;2;0;0;0
795570;Odium to the Core;Adventure, Indie, RPG, Strategy;20,000 - 50,000;41;11;30;0;0;0
795580;THE DAY Online;Action, Adventure, Casual, Indie;200,000 - 500,000;341;246;95;46;26;0
795610;Gift of Parthax;Indie, RPG, Strategy;20,000 - 50,000;34;45;-11;0;0;0
795610;Gift of Parthax;Indie, Simulation;20,000 - 50,000;34;45;-11;0;0;0
795630;Movavi Video Suite 17 - Video Making Software - Video Editor, Video Converter, Screen Capture, and more;Violent, Gore, Action, Adventure, Casual, Indie;50,000 - 100,000;2438;613;1825;339;418;162
795680;Border of her Heart;Indie;20,000 - 50,000;48;19;29;0;0;0
795760;UPPERS;Casual, Indie;0 - 20,000;101;18;83;0;0;1
795910;Montero;Action, Casual, Indie;0 - 20,000;10;4;6;0;0;0
795920;SALVATOR;Indie, Early Access;0 - 20,000;13;4;9;0;0;0
795940;Fantasy Mosaics 19: Edge of the World;Indie, Simulation, Sports, Strategy;0 - 20,000;4;0;4;0;0;1
795950;Deathly Storm: The Edge of Life;Sexual Content, Nudity, Casual;0 - 20,000;21;4;17;0;0;0
795960;Murder Diaries: Ankara;Casual;0 - 20,000;22;3;19;0;0;0
795990;Rise: The Vieneo Province;Adventure, Simulation, Sports;0 - 20,000;16;8;8;0;0;1
796030;Hard Helmets;Action, Indie;0 - 20,000;5;9;-4;0;0;0
796050;The Agency of Anomalies: Mind Invasion Collector's Edition;Casual;0 - 20,000;6;3;3;0;0;0
796060;Riddles of Fate: Memento Mori Collector's Edition;Casual, Indie;0 - 20,000;3;0;3;0;0;0
796070;PuppetShow: Return to Joyville Collector's Edition;Casual;0 - 20,000;5;0;5;0;0;1
796080;Amaranthine Voyage: The Shadow of Torment Collector's Edition;Casual, Simulation;0 - 20,000;2;1;1;0;0;1
796090;Danse Macabre: Deadly Deception Collector's Edition;Violent, Adventure, Indie, Early Access;0 - 20,000;1;0;1;0;0;0
796100;Haunted Halls: Fears from Childhood Collector's Edition;Casual;0 - 20,000;6;1;5;0;0;0
796110;Arkasha;Casual, Indie;0 - 20,000;11;12;-1;0;0;0
796130;Virus Petya;Casual, Racing;0 - 20,000;16;10;6;0;0;0
796260;Radiant Melodia;Casual, Indie, Simulation;0 - 20,000;1;0;1;0;0;0
796290;World of Tennis: Roaring ’20s;Action, Adventure;50,000 - 100,000;181;64;117;0;0;0
796320;Potatoe;Action, Adventure;0 - 20,000;15;24;-9;0;0;0
796330;Widower's Sky;Adventure, Indie;0 - 20,000;2;16;-14;0;0;0
796340;Lifeblood;Casual, Indie;0 - 20,000;25;17;8;0;0;0
796350;NatureFly;Indie, Early Access;0 - 20,000;5;5;0;0;0;0
796360;JQ: countries;Indie, Racing, Simulation, Sports;0 - 20,000;67;44;23;0;0;0
796360;JQ: countries;Adventure, Indie, Simulation;0 - 20,000;67;44;23;0;0;0
796370;Desert of Vice;Simulation;0 - 20,000;13;3;10;0;0;0
796380;Terra Feminarum;Action, Indie;0 - 20,000;47;7;40;0;0;0
796430;SHiRO 011;Action, Adventure, Casual, Indie;0 - 20,000;62;15;47;0;0;0
796440;Spaceguy;Indie, Simulation, Early Access;20,000 - 50,000;52;53;-1;0;0;0
796460;Individual Investor Tycoon;Racing;0 - 20,000;18;21;-3;0;0;0
796480;Bit-Boom;Adventure, Indie, Simulation;0 - 20,000;41;29;12;0;0;0
796490;Fantasy Mosaics 20: Castle of Puzzles;Action, Adventure, Indie, Simulation, Early Access;0 - 20,000;5;0;5;0;0;2
796500;SpellShokked!;Action, Casual, Indie;0 - 20,000;2;0;2;0;0;0
796510;Monkey Slap;Action, Adventure, Free to Play, Massively Multiplayer, RPG;0 - 20,000;90;30;60;1;1;0
796510;Monkey Slap;Adventure, Indie;0 - 20,000;90;30;60;1;1;0
796520;Ice Cream Factory;Casual, Indie, Simulation, Sports, Strategy;0 - 20,000;12;15;-3;0;0;0
796580;100 Seconds;Violent, Gore, Action, Casual, Indie;20,000 - 50,000;0;1;-1;0;0;0
796590;The Arab Republic of Taghia;Action, Adventure, Casual, Indie, Simulation, Sports, Early Access;0 - 20,000;15;12;3;0;0;0
796600;DON'T touch the walls;Action;0 - 20,000;21;6;15;0;0;0
796620;X Mushrooms;Free to Play, Indie;20,000 - 50,000;140;66;74;32;32;0
796640;Mr.Jezko;Adventure, Indie;0 - 20,000;76;44;32;1;1;0
796650;Frio2 - Memory of my sister;Action, Adventure, Indie, RPG, Early Access;0 - 20,000;36;6;30;0;0;0
796710;web spice;Indie;0 - 20,000;8;6;2;0;0;0
796760;varBlocks;Casual, Indie, RPG, Simulation;0 - 20,000;4;0;4;0;0;0
796770;Toddler Simulator;Action, Racing;0 - 20,000;19;10;9;0;0;0
796780;Star Drift;Casual;0 - 20,000;25;2;23;0;0;0
796790;GLAD VALAKAS SIMULATOR;Action, Indie, Simulation, Strategy;0 - 20,000;422;26;396;0;0;0
796800;Lair of the Titans;Adventure;0 - 20,000;0;1;-1;0;0;0
796840;Molecule - a chemical challenge;Action, Indie;0 - 20,000;17;6;11;0;0;0
796860;Police Enforcement VR : 1-King-27;Action, Casual, Indie;100,000 - 200,000;87;188;-101;0;0;0
796900;Trivia Vault: Mixed Trivia 2;Adventure, Casual, Indie;0 - 20,000;36;31;5;1;1;0
796910;Please Love My Computer Game;Violent, Action, Adventure, Casual, Indie, RPG;20,000 - 50,000;115;39;76;1;1;0
796930;Neon Spaceboard;Indie, Simulation, Strategy, Early Access;0 - 20,000;1;0;1;0;0;0
796950;The Haunting of Billy;Casual, Free to Play, Strategy;0 - 20,000;20;23;-3;0;0;0
796970;VR Soccer Training;Action, Adventure, Indie, Simulation, Early Access;0 - 20,000;5;3;2;0;0;0
796980;Kai Yuen's Overlapped Universe;Violent, Gore, Action, Indie, Early Access;0 - 20,000;1;2;-1;0;0;0
797010;Mavi's Journey;Action, Indie, RPG, Simulation, Early Access;20,000 - 50,000;37;6;31;0;0;0
797020;TinyWar high-speed;Violent, Action, Casual, Indie, Simulation;0 - 20,000;11;1;10;0;0;0
797040;Reboant - Endless Dawn;Adventure, Casual, Indie, Strategy;0 - 20,000;16;18;-2;0;0;0
797060;Qubika;Adventure, Free to Play, Indie;0 - 20,000;23;13;10;1;1;0
797070;Bunny adventure;Utilities;0 - 20,000;22;14;8;0;0;0
797090;Neon Sun;Simulation, Strategy;0 - 20,000;22;26;-4;0;0;0
797190;Survive: The king killer;Action, Indie, Strategy, Early Access;0 - 20,000;5;13;-8;0;0;0
797200;International Space Station Tour VR;Casual, Indie;20,000 - 50,000;60;11;49;36;36;0
797300;Fantasy Mosaics 21: On the Movie Set;Adventure, Indie, RPG;0 - 20,000;4;1;3;0;0;1
797310;Fantasy Mosaics 22: Summer Vacation;Casual, Indie, Racing, Simulation, Sports;0 - 20,000;4;0;4;0;0;0
797330;Fantasy Mosaics 23: Magic Forest;Action, Casual, Indie;0 - 20,000;4;0;4;0;0;0
797340;Fantasy Mosaics 24: Deserted Island;Casual, Indie, RPG;0 - 20,000;5;0;5;0;0;1
797350;Fantasy Mosaics 25: Wedding Ceremony;Casual, Indie, Strategy;0 - 20,000;3;0;3;0;0;1
797390;How To Cope With Boredom and Loneliness;Action, Simulation, Strategy;50,000 - 100,000;459;44;415;9;16;0
797400;Railroad Corporation;Indie, Strategy;100,000 - 200,000;833;293;540;828;1014;76
797410;Headsnatchers;Action, Adventure, Indie, RPG, Strategy, Early Access;200,000 - 500,000;799;743;56;236;77;4
797420;Night Drive VR;Indie, Strategy;0 - 20,000;2;4;-2;0;0;0
797430;HD Poker: Texas Hold'em;Indie, Simulation, Early Access;200,000 - 500,000;3019;640;2379;960;307;238
797440;Fantasy Mosaics 26: Fairytale Garden;Violent, Gore, Action, Adventure, Indie;0 - 20,000;4;0;4;0;0;1
797450;Fantasy Mosaics 27: Secret Colors;Action, Indie;0 - 20,000;6;0;6;0;0;2
797550;Ultimate Panic Flight;Action, Casual, Indie;0 - 20,000;2;1;1;0;0;0
797570;Go Morse Go! Arcade Edition;Action, Casual, Indie, Strategy, Early Access;0 - 20,000;53;0;53;0;0;0
797610;Subsideria;Adventure, Casual;0 - 20,000;17;1;16;0;0;0
797620;Dissembler;Action, Indie, Massively Multiplayer, Early Access;0 - 20,000;65;5;60;0;0;0
797640;Monster RPG 3;Adventure, Casual, Indie, Simulation, Sports;0 - 20,000;3;1;2;0;0;0
797660;God Test;Indie, Simulation;0 - 20,000;7;8;-1;4;4;0
797710;RPGolf;Adventure, Casual, Indie;0 - 20,000;25;13;12;60;60;0
798140;Blood Drift;Casual, Indie, Racing;0 - 20,000;13;5;8;0;0;0
798170;Dive;Action, Casual, Indie;0 - 20,000;11;0;11;0;0;0
798180;Space Turret Gunner 宇宙大炮手;Casual, Indie, Simulation;0 - 20,000;2;2;0;0;0;0
798190;Star Clash;Casual, Indie, Simulation;0 - 20,000;2;0;2;0;0;0
798200;Tomb Exploration VR;Sexual Content, Violent, Gore, Indie;0 - 20,000;4;4;0;0;0;0
798230;Aima Wars: Steampunk & Orcs;Adventure, Casual, Indie;0 - 20,000;19;13;6;0;0;0
798240;CRYEP;Casual, Indie, Strategy;0 - 20,000;23;5;18;0;0;0
798280;CrocoMars;Sexual Content, Nudity, Adventure, Casual, Indie, Simulation;20,000 - 50,000;153;30;123;6;6;0
798290;MXGP PRO;Casual, Indie, Strategy;50,000 - 100,000;832;154;678;870;1348;14
798330;Bacterium / 生命之旅;Action, Adventure, Indie, RPG;0 - 20,000;41;8;33;0;0;0
798350;Capsule Jump;Adventure, Casual, Indie;0 - 20,000;2;1;1;0;0;0
798380;Debtor;Adventure, RPG;50,000 - 100,000;79;28;51;2;2;0
798420;Professional Fishing;Casual, Indie, Racing;200,000 - 500,000;2324;726;1598;230;40;60
798460;Ni no Kuni Wrath of the White Witch Remastered;Adventure, Indie;100,000 - 200,000;2765;452;2313;623;817;155
798480;LONELINESS AFTER: Chapter 1;Action, Adventure, Free to Play, Indie, Massively Multiplayer, Early Access;0 - 20,000;11;2;9;0;0;0
798490;Othercide;Action, Adventure, Indie;100,000 - 200,000;3015;620;2395;891;1299;67
798510;SUPER DRAGON BALL HEROES WORLD MISSION;Education;100,000 - 200,000;1218;220;998;19;19;26
798560;Inaccessible world;Action, Casual, Indie, Early Access;0 - 20,000;23;40;-17;0;0;0
798590;Elven Love;Animation & Modeling, Education, Utilities, Early Access;20,000 - 50,000;70;66;4;39;77;0
798610;Mermaid Adventures: The Frozen Time;Action, Casual, Indie, Massively Multiplayer;20,000 - 50,000;29;13;16;0;0;1
798650;Squeakers;Casual, Free to Play, Indie;20,000 - 50,000;53;1;52;0;0;0
798670;Tactical Chronicle;Casual, Indie;0 - 20,000;6;1;5;0;0;0
798680;Animosity;Adventure, Free to Play, Indie;0 - 20,000;7;1;6;0;0;0
798710;Voltage;Indie;0 - 20,000;5;8;-3;0;0;0
798720;SUPER ROBO MOUSE;Action, Adventure, Casual, Indie, RPG, Strategy, Early Access;0 - 20,000;4;5;-1;0;0;0
798730;rOt;Casual, Indie, Simulation, Early Access;0 - 20,000;37;20;17;0;0;0
798790;PolyCube;Casual;0 - 20,000;37;4;33;0;0;0
798810;Natural Locomotion;Adventure, Indie;100,000 - 200,000;448;79;369;1668;1675;7
798830;The Commission: Organized Crime Grand Strategy;Action, Adventure, Indie;0 - 20,000;20;26;-6;0;0;0
798840;Panzer War : Definitive Edition (Cry of War);Adventure, Indie;20,000 - 50,000;591;63;528;223;223;32
798850;Achievement Lurker: Easiest Cosmetic Numbers;Action, Indie, Sports, Early Access;0 - 20,000;62;13;49;0;0;1
798850;Achievement Lurker: Easiest Cosmetic Numbers;Action, Adventure, Casual, Indie, Simulation, Strategy;0 - 20,000;62;13;49;0;0;1
798930;Swing Dunk (Beta);Action;50,000 - 100,000;51;14;37;0;0;0
798940;勇士冲冲冲-Classic Rodeo play;Casual, Indie, Strategy;0 - 20,000;21;11;10;0;0;0
798940;勇士冲冲冲-Classic Rodeo play;Adventure, Indie;0 - 20,000;21;11;10;0;0;0
798950;Logout;RPG, Early Access;20,000 - 50,000;26;17;9;0;0;0
798960;Putin takes taxes;Violent, Action, Casual, Indie;0 - 20,000;28;18;10;0;0;0
799060;Biotix: Phage Genesis;Action, Casual, Indie;0 - 20,000;14;10;4;0;0;0
799070;Zup! 8;Indie, Strategy;100,000 - 200,000;3605;138;3467;172;175;0
799080;5 Star Hawaii Resort - Your Resort;Nudity, Casual, Indie, Sports;0 - 20,000;7;7;0;0;0;0
799110;Picrastination;Adventure, Indie;0 - 20,000;35;3;32;0;0;1
799120;ZombieHunt;Adventure, Casual, Indie, RPG, Strategy;0 - 20,000;2;23;-21;0;0;0
799180;Unfinished Battle;Gore, Action, Casual, Indie;0 - 20,000;11;9;2;0;0;0
799210;Legions At War;Indie;0 - 20,000;1;1;0;0;0;1
799240;My Free Farm 2;Sexual Content, Violent, Casual, Indie;100,000 - 200,000;334;240;94;48;79;110
799260;Godly Corp;Gore, Action, Casual, Indie;0 - 20,000;38;13;25;0;0;0
799270;Looney Rally;Casual, Indie, Simulation, Strategy;0 - 20,000;3;6;-3;0;0;0
799310;Dhalang MG;Action, Adventure, Casual, Indie;0 - 20,000;4;1;3;0;0;0
799340;Battle for Gaming;Free to Play, Indie, Simulation;20,000 - 50,000;0;1;-1;0;0;0
799420;Shadow of the Black Dragon;Action, Adventure, Casual, Indie;0 - 20,000;11;5;6;0;0;0
799460;Broken Metal;Action, Adventure, Indie, RPG;0 - 20,000;10;1;9;0;0;0
799500;SurvivalZ;Action, Adventure, Casual, Indie;0 - 20,000;179;118;61;0;0;0
799510;Squidlit;Adventure, Indie;50,000 - 100,000;381;34;347;0;0;1
799530;Psychopathics;Simulation, Sports, Strategy;0 - 20,000;17;9;8;6;6;0
799560;Blackbeard's Cove;Violent, Adventure, Casual, Indie, RPG, Simulation;0 - 20,000;4;4;0;0;0;0
799570;Angles;Adventure, Indie;0 - 20,000;2;0;2;0;0;0
799590;Life Lessons;Casual;0 - 20,000;5;0;5;0;0;0
799600;Cosmoteer: Starship Architect & Commander;Casual;200,000 - 500,000;5815;246;5569;809;693;972
799610;Drill Arena;Action, Adventure, Casual, Indie;0 - 20,000;4;18;-14;0;0;0
799620;Grim Wanderings;Action, Indie, Massively Multiplayer, Early Access;0 - 20,000;18;7;11;0;0;0
799640;Dungeon Munchies;Casual, Simulation;100,000 - 200,000;5581;155;5426;248;322;35
799670;Volantia;Action, Indie;0 - 20,000;12;6;6;0;0;0
799730;Guard of Wonderland VR;Violent, Adventure, Casual, Indie;0 - 20,000;11;6;5;0;0;0
799770;Alea;Violent, Gore, Action, Adventure;0 - 20,000;3;0;3;0;0;0
799800;Animals Memory: Cats;Adventure, Casual, Indie;0 - 20,000;56;6;50;0;0;0
799810;Returner 77;Adventure, Indie, Strategy;20,000 - 50,000;39;15;24;0;0;0
799840;Life and Debt: A Real Life Simulator;Adventure, Casual, Indie;0 - 20,000;15;14;1;0;0;1
799860;BREATHE;Casual;100,000 - 200,000;173;186;-13;78;153;0
799870;Neko Dungeon | 喵酱迷城 | 喵醬迷城 | ねこダンジョン;Casual, Indie, Strategy;20,000 - 50,000;28;21;7;0;0;0
799890;REVENGER: Age of Morons;Casual, Indie;0 - 20,000;6;15;-9;0;0;0
799910;Cheitha;Adventure, Casual, Indie, Simulation;0 - 20,000;16;4;12;0;0;0
799960;Wizard101;Violent, Gore, Adventure, Indie, Strategy, Early Access;500,000 - 1,000,000;4428;1036;3392;175;74;745
800030;Magikiras;Indie;0 - 20,000;5;6;-1;0;0;0
800050;The Great Tournament;Violent, Indie;0 - 20,000;25;2;23;0;0;1
800120;Lonely Yuri;Action, Casual, Indie;0 - 20,000;122;9;113;0;0;1
800130;SmartBoy;Action, Casual, Indie, Racing, Simulation, Sports, Strategy;0 - 20,000;3;6;-3;0;0;0
800160;斗地主VR;Action, Adventure, Indie, RPG, Strategy;20,000 - 50,000;1;3;-2;0;0;0
800170;隐-Stealth;Action, Free to Play, Indie;0 - 20,000;4;1;3;0;0;0
800180;Momoiro Closet;Utilities;0 - 20,000;51;4;47;0;0;0
800190;The Adventures of Elena Temple: Definitive Edition;Action, Indie;0 - 20,000;47;2;45;0;0;0
800200;Witching Tower VR;Action, Adventure, Racing;0 - 20,000;90;25;65;0;0;0
800230;Viki Spotter: Megapolis;Action, Indie;0 - 20,000;49;4;45;0;0;0
800240;Ghostly Matter;Action, Casual, Indie;0 - 20,000;28;14;14;0;0;0
800270;Terraforming Mars;Action, Casual, Indie;200,000 - 500,000;3705;1369;2336;5849;2290;694
800280;FLYVALNY 20!8;Action, Indie;20,000 - 50,000;47;11;36;0;0;0
800290;ViSP - Virtual Space Port;Adventure, Indie;0 - 20,000;26;3;23;0;0;0
800310;Paladin Duty - Knights and Blades;Action, Adventure, Indie, Simulation, Strategy, Early Access;0 - 20,000;26;46;-20;5;5;0
800320;Cubic Color;Action, Adventure, Indie, Early Access;0 - 20,000;8;13;-5;0;0;0
800330;Color Circle;Adventure, Indie;0 - 20,000;18;4;14;0;0;0
800350;Casino Blackjack;Adventure, Casual;50,000 - 100,000;7;1;6;1;1;0
800380;Escape Room VR: Stories;Adventure, Casual;0 - 20,000;14;16;-2;0;0;0
800390;Puppet Fever;Action, Adventure, RPG;0 - 20,000;29;2;27;0;0;0
800490;ALASKA;Adventure, Indie;0 - 20,000;22;6;16;0;0;0
800510;RoboHeist VR;Action, Adventure, Casual, Indie, Strategy;0 - 20,000;4;3;1;0;0;0
800520;Just a Jumping Square;Casual, Indie, Early Access;0 - 20,000;4;2;2;0;0;0
800530;Ninja jump;Action, Adventure, Indie, Early Access;0 - 20,000;12;22;-10;0;0;0
800530;Ninja jump;Action, Adventure, Indie, Early Access;0 - 20,000;12;22;-10;0;0;0
800550;DarkDIRE: The Advanced Set;Casual, Indie, Simulation;0 - 20,000;12;3;9;0;0;0
800560;The Great Tournament 2;Simulation;0 - 20,000;11;6;5;0;0;0
800580;Highway Wars;Casual, Indie;0 - 20,000;11;5;6;0;0;0
800600;Wayhaven Chronicles: Book One;Casual, Indie, Simulation;0 - 20,000;278;15;263;0;0;7
800620;Fallen Hero: Rebirth;Action, Indie;0 - 20,000;307;8;299;0;0;18
800640;Xtreme Paddleball;Adventure, Casual, Simulation;0 - 20,000;8;1;7;0;0;0
800650;The Last Operator;Casual, Indie;0 - 20,000;14;7;7;0;0;0
800660;Star Plantation;Casual, Indie;0 - 20,000;3;3;0;0;0;0
800670;NetStars - VR Goalie Trainer;Casual;0 - 20,000;15;5;10;0;0;0
800680;RTAG rise;Casual, Indie;0 - 20,000;1;0;1;0;0;0
800690;The Unlikely Legend of Rusty Pup;Action, Casual, Indie;0 - 20,000;20;1;19;0;0;0
800700;Project Hastur;Action, Casual, Indie;0 - 20,000;11;1;10;0;0;0
800710;Mad Zombie;Casual, Indie;0 - 20,000;0;1;-1;0;0;0
800720;Space Fighters;Strategy;0 - 20,000;1;0;1;0;0;0
800820;2236 A.D.;Action, Indie;0 - 20,000;53;4;49;0;0;0
800830;Floogen;Indie, RPG, Strategy, Early Access;0 - 20,000;5;1;4;0;0;0
800840;Jesters Poker;Gore, Action, Indie, RPG;0 - 20,000;0;2;-2;0;0;0
800860;Omnicube;Adventure, RPG;0 - 20,000;8;0;8;0;0;0
800910;FriendZoned Archer;RPG;0 - 20,000;5;1;4;0;0;0
800930;Twin Blue Moons;Adventure, Indie, RPG, Simulation, Strategy;0 - 20,000;17;2;15;0;0;0
800980;One Man Army VR;Action, Adventure, Indie, RPG;0 - 20,000;1;2;-1;0;0;0
801010;Unsolved Stories;Adventure, Casual, Indie, Strategy, Early Access;0 - 20,000;14;11;3;0;0;0
801020;Golden Dungeons;Racing, Sports;50,000 - 100,000;49;55;-6;1;1;0
801040;Poly Universe;Action, Casual;0 - 20,000;104;15;89;0;0;1
801060;ArcBall;Adventure, Indie;0 - 20,000;14;43;-29;250;250;0
801080;Hunting on Myths;Action, Indie;0 - 20,000;0;0;0;0;0;0
801120;Kirchhoff's Revenge;Action;20,000 - 50,000;89;24;65;35;35;0
801150;IMM Defense;Adventure, Indie;0 - 20,000;1;1;0;0;0;0
801180;Beer Pong VR;Adventure, Casual, Indie, RPG, Simulation;0 - 20,000;1;4;-3;0;0;0
801210;Spellsword Cards: Demontide;Sexual Content, Gore, RPG, Simulation, Strategy;0 - 20,000;48;25;23;0;0;0
801220;Magnificent 5;;100,000 - 200,000;50;77;-27;0;0;0
801250;GOHOROBO;Adventure, RPG;0 - 20,000;1;0;1;0;0;0
801260;NOSTALGIC TRAIN;Adventure;20,000 - 50,000;136;38;98;7;7;0
801280;Cowboy Escape;Adventure, Indie, RPG;0 - 20,000;24;37;-13;0;0;0
801280;Cowboy Escape;Action, Free to Play, Indie, Simulation, Sports;0 - 20,000;24;37;-13;0;0;0
801290;Diabolic;Action, Indie;20,000 - 50,000;295;48;247;1;1;1
801300;Digital Diamond Baseball V7;Simulation;0 - 20,000;8;0;8;0;0;0
801320;The Last Hope: Atomic Bomb - Crypto War;Adventure;0 - 20,000;51;42;9;8;8;0
801330;Monkey Rush;Action, Casual, Indie, Simulation;0 - 20,000;2;1;1;0;0;0
801340;Healer Simulator;Adventure, Indie;20,000 - 50,000;1;9;-8;0;0;0
801380;MOVIT;Action, Adventure, Indie;0 - 20,000;2;1;1;0;0;0
801390;Onslaught VR;Casual, Indie;0 - 20,000;0;0;0;0;0;0
801400;Hoser Hockey;Simulation;0 - 20,000;27;9;18;0;0;1
801410;Hidden Life;Action, Adventure, Indie, Strategy;0 - 20,000;1;0;1;0;0;0
801450;Microtransaction Simulator Game of the Decade: Deluxe Edition;Action, Free to Play, Early Access;0 - 20,000;0;0;0;0;0;0
801480;Agent A: A puzzle in disguise;Action, Indie;;;;0;;;
801490;HellCrunch;Action, Adventure, Indie, Early Access;0 - 20,000;6;5;1;0;0;0
801500;WannaMine;Action, Adventure, Casual, Indie, RPG;0 - 20,000;24;23;1;0;0;0
801550;VAIL VR;Action, Casual, Indie, Racing, Sports;100,000 - 200,000;784;160;624;91;91;58
801600;夜雪冰娇;Action, Casual, Indie, Sports;0 - 20,000;16;8;8;0;0;0
801610;Amigo Fishing;Adventure, Casual;20,000 - 50,000;15;21;-6;0;0;0
801610;Amigo Fishing;Action, Adventure, Indie, Early Access;20,000 - 50,000;15;21;-6;0;0;0
801630;UNDER NIGHT IN-BIRTH Exe:Late[cl-r];Casual, Indie;100,000 - 200,000;3042;190;2852;2101;2291;39
801660;Swapper Tiles;Adventure;0 - 20,000;2;0;2;0;0;0
801700;AlpenCROSS;Adventure, Casual, Indie, Simulation;0 - 20,000;5;3;2;0;0;0
801750;Hot Shot Burn;Action, Casual, Indie, Sports;20,000 - 50,000;167;16;151;16;16;0
801760;City Monsters;Action, Casual, Indie;0 - 20,000;32;12;20;0;0;0
801760;City Monsters;Action, Adventure, Indie, Massively Multiplayer, Simulation, Early Access;0 - 20,000;32;12;20;0;0;0
801770;Brutalism;Adventure, Casual, Indie;0 - 20,000;2;3;-1;0;0;0
801780;Haters, kill them all!;Action, Adventure;0 - 20,000;11;26;-15;0;0;0
801840;Psychoballs;Casual, Indie, Strategy, Early Access;0 - 20,000;5;5;0;0;0;0
801870;Ramen;Adventure, Casual, Massively Multiplayer, Simulation;0 - 20,000;30;11;19;388;388;0
801890;Christmas Race 2;Casual, Indie;0 - 20,000;16;10;6;0;0;0
801900;The last Baron's stunt (Anime);Adventure, Indie, RPG;0 - 20,000;12;10;2;0;0;0
801910;Orbos;Action, Adventure, Simulation, Strategy;50,000 - 100,000;36;21;15;1;2;0
801940;Star Boy;Action, Adventure, Simulation, Strategy;0 - 20,000;1;4;-3;0;0;0
801950;CryptoRIG;Action, Adventure, Casual, Indie, Strategy;0 - 20,000;4;1;3;0;0;0
802020;Acute Art;Action, Racing, Simulation;20,000 - 50,000;16;7;9;0;0;0
802040;Captive;Violent, Gore, Action;0 - 20,000;94;9;85;0;0;0
802050;Rag Doll Joe;Action, Simulation, Strategy;0 - 20,000;140;26;114;0;0;1
802060;Spencer;Action, Adventure;0 - 20,000;3;0;3;0;0;0
802070;Cluster Dust;Adventure, Strategy;0 - 20,000;13;5;8;0;0;0
802080;Pillage;Adventure, Strategy;0 - 20,000;11;5;6;0;0;0
802090;Dungeon Puzzle VR - Solve it or die;Action, Adventure, Casual, RPG;0 - 20,000;2;2;0;0;0;0
802120;Cellyon: Boss Confrontation;Casual, Free to Play, Simulation;20,000 - 50,000;46;7;39;0;0;0
802130;Break The Targets;Action, Adventure, Casual, Indie;0 - 20,000;42;1;41;0;0;0
802180;DesertShootout;Adventure, Indie;0 - 20,000;2;17;-15;0;0;0
802190;The Land of Glass;Indie, RPG, Strategy;0 - 20,000;11;6;5;0;0;0
802200;Hellbound: Survival Mode;Action, Casual, Indie;200,000 - 500,000;1695;244;1451;49;18;0
802210;BSL Winter Games Challenge;Action, Adventure, RPG;0 - 20,000;9;5;4;0;0;0
802260;Vandozer;Adventure, Casual, Free to Play, Indie;0 - 20,000;14;0;14;0;0;0
802300;Baseball Kings VR;Free to Play, Simulation;0 - 20,000;1;1;0;0;0;0
802310;PingPong Kings VR;Indie, Strategy;0 - 20,000;6;1;5;0;0;0
802320;Tennis Kings VR;Adventure, Indie;0 - 20,000;1;2;-1;0;0;0
802330;Badminton Kings VR;Casual, Indie;0 - 20,000;18;9;9;0;0;1
802340;Archery Kings VR;Action, Indie, Massively Multiplayer;0 - 20,000;5;4;1;0;0;0
802360;King Of Mazes;Casual, Free to Play, Strategy;0 - 20,000;6;7;-1;1;1;0
802390;Astonia Reborn;Adventure, Casual, Indie;20,000 - 50,000;94;52;42;0;0;0
802400;Fhtagn! - Tales of the Creeping Madness;Violent, Gore, Action, Adventure, Indie;0 - 20,000;47;2;45;0;0;0
802450;NAIRI: Tower of Shirin;Casual, Indie, RPG;20,000 - 50,000;384;59;325;169;169;1
802480;baby game plan 0-3;Action, Adventure, Indie, RPG;0 - 20,000;1;1;0;0;0;0
802490;Fabulous - Angela's Wedding Disaster;Adventure, Casual, Indie, RPG, Simulation, Early Access;0 - 20,000;42;7;35;0;0;1
802530;Space Raiders RPG;Simulation;0 - 20,000;14;6;8;0;0;0
802550;war1:various fighters;Action, Indie;0 - 20,000;1;0;1;0;0;0
802550;war1:various fighters;Free to Play, Indie, Massively Multiplayer, RPG, Strategy;0 - 20,000;1;0;1;0;0;0
802650;Russian AYE Race;Action, Indie, Strategy, Early Access;20,000 - 50,000;29;25;4;1;1;0
802660;Bitcoin Or Bomb?;Indie, RPG, Strategy;0 - 20,000;19;22;-3;1;1;0
802690;Crazy Machines VR;Adventure, Simulation;0 - 20,000;17;12;5;0;0;0
802720;Give Me Your Coins;Action, Indie, RPG;0 - 20,000;19;5;14;0;0;0
802730;Mother Simulator;Indie, Simulation, Early Access;20,000 - 50,000;483;96;387;0;0;2
802740;Wild Glory;Casual, Indie;0 - 20,000;42;4;38;0;0;0
802780;Ball Platformer;Action, Adventure, Casual, Indie, RPG, Sports;0 - 20,000;5;1;4;0;0;0
802810;KNACK!;Action, Adventure;0 - 20,000;38;15;23;0;0;0
802850;NaziShootout;Casual, Indie;0 - 20,000;17;19;-2;0;0;0
802870;The Ditzy Demons Are in Love With Me;Action, Casual, Indie;50,000 - 100,000;1394;45;1349;518;781;10
802870;The Ditzy Demons Are in Love With Me;Adventure, Casual;50,000 - 100,000;1394;45;1349;518;781;10
802880;Muv-Luv (マブラヴ);Adventure, Casual;50,000 - 100,000;917;45;872;379;421;43
802900;Hollow Steps;Adventure, Casual;0 - 20,000;41;21;20;0;0;0
802920;The Geology Game;Adventure, Casual;0 - 20,000;11;3;8;0;0;0
802930;The Rainsdowne Players;Adventure, Casual;0 - 20,000;12;1;11;0;0;0
802960;Oracle: Threads of Fate;Action, Indie, Racing;0 - 20,000;12;7;5;0;0;0
803010;Supermedium - Virtual Reality Browser;Indie, RPG, Strategy;50,000 - 100,000;33;14;19;36;46;0
803020;Manny Boxing VR;Violent, Indie, RPG;0 - 20,000;16;12;4;0;0;1
803040;Master of the Harem Guild;Action, Casual, Indie;0 - 20,000;0;0;0;3;3;0
803050;Per Aspera;Indie, Simulation, Sports;200,000 - 500,000;3439;1166;2273;775;847;157
803080;Bad Day;Violent, Gore, Action, Adventure, Indie, Simulation;50,000 - 100,000;118;60;58;1;1;0
803110;Dread station;Action, Casual, Indie, Simulation;0 - 20,000;9;10;-1;0;0;0
803130;Diastone: Memories;Action, Adventure, Casual, Indie;0 - 20,000;16;10;6;0;0;0
803140;Battle Carnival;Action, Indie;200,000 - 500,000;825;371;454;0;0;0
803150;Nephise: Ascension;Casual, Indie;0 - 20,000;102;20;82;105;105;0
803150;Nephise: Ascension;Casual;0 - 20,000;102;20;82;105;105;0
803220;Winions: Mana Champions;Action;50,000 - 100,000;55;53;2;0;0;0
803260;Survive in Angaria;Adventure, Indie, Strategy;0 - 20,000;32;10;22;1;1;0
803270;One Bit Arena;Casual, Indie;0 - 20,000;26;1;25;0;0;0
803280;Briquid;Adventure, Free to Play, Indie, RPG;0 - 20,000;19;0;19;0;0;0
803290;RANDOM rooms;Action, Adventure;0 - 20,000;5;2;3;0;0;0
803310;Landlord Simulator;Violent, Gore, Indie;0 - 20,000;2;16;-14;0;0;0
803320;Haldor;Action, Casual, Indie, Racing, Sports;0 - 20,000;7;27;-20;1;1;0
803320;Haldor;Casual, Indie, Sports;0 - 20,000;7;27;-20;1;1;0
803330;Destroy All Humans!;Adventure, Indie;500,000 - 1,000,000;8484;640;7844;222;133;47
803350;Fighter Royale - Last Ace Flying;Adventure, Casual, Indie;0 - 20,000;49;27;22;0;0;0
803360;Hide The Body;Casual, Indie;0 - 20,000;10;8;2;0;0;0
803520;Nothing to God;Casual, Indie;0 - 20,000;3;1;2;0;0;0
803570;SOLAR BATTALION;Action, Casual, Indie, Simulation, Strategy;0 - 20,000;1;4;-3;0;0;0
803590;Little Gold Miner;Sexual Content, Nudity, Casual;0 - 20,000;12;1;11;0;0;0
803600;Disgaea 5 Complete;Adventure, Casual, Indie;200,000 - 500,000;2632;349;2283;2262;2730;226
803680;Eat Your Words;Casual, Indie;0 - 20,000;5;5;0;0;0;0
803720;War Theatre;Action, Adventure, Casual, Indie, Racing, Simulation;0 - 20,000;10;6;4;0;0;0
803750;Moon Castle;Casual, Indie;0 - 20,000;10;6;4;0;0;0
803760;Free At Last;Casual, Indie;0 - 20,000;2;0;2;0;0;0
803780;Toon War;Action, Adventure, Indie;0 - 20,000;4;1;3;0;0;0
803800;WIDECROSS;Indie, Strategy;20,000 - 50,000;100;79;21;0;0;0
803830;The Snowboard Game;Adventure, Casual, Free to Play, Indie;0 - 20,000;253;53;200;0;0;4
803840;It Could Have Been Me;Simulation;0 - 20,000;1;1;0;0;0;0
803850;Pixelpunk XL;Action, Adventure, Indie, RPG;0 - 20,000;34;14;20;0;0;0
803870;NickProject;Action, Casual, Indie;0 - 20,000;1;0;1;0;0;0
803890;Police Helicopter Simulator;Casual, Indie;0 - 20,000;42;40;2;0;0;1
803920;Suna;Casual, Indie, Racing, Sports;0 - 20,000;20;9;11;0;0;0
803930;Galactic Bulwark Strike;Action, Adventure, Casual, Indie, Early Access;0 - 20,000;30;1;29;0;0;0
803940;Collapsion;Action, Adventure, Indie;0 - 20,000;2;0;2;0;0;0
803960;Contrasted;Sexual Content, Nudity, Casual, Indie, Simulation;0 - 20,000;1;0;1;0;0;0
803980;Plane Mechanic Simulator;Massively Multiplayer, Racing, Strategy;50,000 - 100,000;874;506;368;47;62;6
804000;Expendable;Simulation;0 - 20,000;41;8;33;0;0;1
804010;SteamWorld Quest: Hand of Gilgamech;Action;;;;0;;;
804120;Oneness;Indie, Simulation;0 - 20,000;17;1;16;0;0;0
804130;EXIST;Simulation;0 - 20,000;44;25;19;0;0;0
804210;Star Advent;Action, Indie;0 - 20,000;59;41;18;1;1;0
804270;Chex Quest HD;Adventure, Indie;200,000 - 500,000;1476;338;1138;0;0;5
804290;Training aim;Action, Adventure, Indie;0 - 20,000;32;10;22;72;72;0
804400;A Turd's Life;Action, Casual, Indie, Sports, Early Access;0 - 20,000;13;1;12;0;0;0
804430;Drink Pro Tycoon;Action, Adventure, Indie;0 - 20,000;45;40;5;106;106;0
804440;Starman in space;Action, Adventure, Indie;0 - 20,000;19;14;5;0;0;0
804460;LAST WAR 2044;Action, Casual, Indie;0 - 20,000;20;18;2;0;0;0
804490;Creed: Rise to Glory;Casual, Indie;200,000 - 500,000;1353;346;1007;211;213;11
804530;Cubism;Casual, Free to Play;0 - 20,000;41;0;41;0;0;1
804540;Greedy Developer's Cash Grab;Casual, Indie;0 - 20,000;0;0;0;0;0;0
804600;Trivia Vault Football Trivia;Casual;0 - 20,000;38;30;8;1;1;0
804610;MONMUSU * FIGHT!;Action, Indie;0 - 20,000;20;6;14;0;0;0
804620;Boxing Fighter : Super punch;Casual, Indie;0 - 20,000;2;3;-1;0;0;0
804680;Virtual Ninja VR;Action, Simulation;0 - 20,000;0;1;-1;0;0;0
804690;The Vox: Tower Defense;Action, Adventure, Indie;0 - 20,000;1;0;1;0;0;0
804700;The House in Fata Morgana: A Requiem for Innocence;Action, Adventure, Indie;0 - 20,000;715;19;696;2048;2048;4
804730;Third Front: WWII;Casual, Indie;20,000 - 50,000;224;132;92;0;0;2
804780;VRでレムと異世界生活-膝枕&添寝編;Action, Casual, Indie;0 - 20,000;7;1;6;0;0;0
804830;Shards of Eradine;Simulation, Sports;0 - 20,000;7;17;-10;0;0;0
804850;Pax Nova;Gore, Action, Casual, Indie, Strategy;20,000 - 50,000;229;154;75;20;20;1
804860;Klotzen! Panzer Battles;Action, Casual, Indie, Strategy;0 - 20,000;22;11;11;0;0;1
804870;Armed to the Gears;Casual, Indie;20,000 - 50,000;121;68;53;0;0;0
804900;Cat's Bar;Indie, RPG, Simulation;0 - 20,000;24;9;15;0;0;0
804910;Mine Seeker;Action, Adventure, Indie;0 - 20,000;0;0;0;0;0;0
804970;Shoottera;Action, Indie;0 - 20,000;24;31;-7;0;0;0
804990;Whispered Secrets: Into the Wind Collector's Edition;Action, Casual, Indie;0 - 20,000;2;0;2;0;0;0
805000;Dark Tales: Edgar Allan Poe's The Mystery of Marie Roget Collector's Edition;Action, Free to Play, Indie, Early Access;0 - 20,000;2;0;2;0;0;1
805010;Fierce Tales: Feline Sight Collector's Edition;Free to Play, Simulation, Early Access;0 - 20,000;4;1;3;0;0;0
805020;Mayan Prophecies: Blood Moon Collector's Edition;Strategy;0 - 20,000;3;0;3;0;0;0
805030;Love Chronicles: Salvation Collector's Edition;Action, Casual, Indie;0 - 20,000;3;0;3;0;0;0
805040;European Mystery: Flowers of Death Collector's Edition;Action, Indie;0 - 20,000;3;0;3;0;0;0
805070;Super Skull Smash GO! 2 Turbo;Action, RPG;0 - 20,000;5;0;5;0;0;0
805090;Blackjack In Space;Adventure, Casual, Indie, Sports, Strategy;0 - 20,000;21;15;6;0;0;0
805090;Blackjack In Space;Casual, Indie;0 - 20,000;21;15;6;0;0;0
805110;P.A.S.;Action, Indie;100,000 - 200,000;381;439;-58;0;0;0
805120;The Fielder's Choice;;0 - 20,000;6;4;2;0;0;0
805150;TSA Frisky;Indie, Racing;0 - 20,000;16;14;2;0;0;0
805260;PICNIC;Adventure, Casual, Indie;0 - 20,000;7;0;7;0;0;0
805270;Playcraft;Utilities;20,000 - 50,000;551;128;423;0;0;1
805280;Dead Rain - New Zombie Virus;Casual;0 - 20,000;31;8;23;0;0;0
805320;Conjuror's Eye;Adventure, Casual;0 - 20,000;30;2;28;0;0;0
805340;Cubiques 2;Adventure, Casual, Simulation;0 - 20,000;13;1;12;0;0;0
805350;Sphera Turris;Action, Adventure, Indie;0 - 20,000;1;1;0;0;0;0
805360;Trivia Vault Baseball Trivia;Casual, Indie, RPG, Simulation, Strategy;0 - 20,000;44;35;9;1;1;0
805370;Are You Alone?;Casual, Indie, Racing, Simulation;0 - 20,000;7;1;6;0;0;0
805400;Mahjong Solitaire;Action, Adventure, Indie;0 - 20,000;39;18;21;35;35;0
805420;Stack & Crack;Sports, Strategy;0 - 20,000;7;1;6;0;0;0
805440;Prismatix;Adventure, Casual, Simulation, Strategy;0 - 20,000;21;4;17;0;0;0
805470;CubicPanic;Casual, Indie;0 - 20,000;1;0;1;0;0;0
805480;TANK SOULS;Adventure, Indie, Early Access;0 - 20,000;0;3;-3;0;0;0
805500;Dokkaebi Hentai Adventures;Adventure, Indie;0 - 20,000;53;30;23;0;0;0
805520;The Dwarves of Glistenveld;Adventure, Indie;50,000 - 100,000;7;0;7;0;0;0
805520;The Dwarves of Glistenveld;Action, Adventure, Casual, Free to Play, Indie, Racing, RPG, Simulation, Sports;50,000 - 100,000;7;0;7;0;0;0
805550;Assetto Corsa Competizione;Adventure, Strategy;1,000,000 - 2,000,000;22528;2061;20467;2716;469;4502
805590;ARMORED HEAD;Adventure, Indie;50,000 - 100,000;827;7;820;67;67;7
805610;Gulman 5;Adventure, Casual, Indie;0 - 20,000;54;7;47;0;0;0
805660;Rad Rodgers - Radical Edition;RPG, Early Access;0 - 20,000;104;51;53;0;0;1
805690;Fear Half Factor;Action, Indie, Racing, Simulation, Sports;0 - 20,000;1;8;-7;0;0;0
805710;Alien Worms Invasion;Action, Racing;0 - 20,000;18;8;10;0;0;0
805720;Satan's Castle;Simulation;0 - 20,000;3;1;2;0;0;0
805760;Desire;Action, Indie;0 - 20,000;50;30;20;0;0;1
805770;我的赛车生涯/My Racing Career;Action, Casual, Indie;0 - 20,000;2;0;2;0;0;0
805790;Torque: Simulation Begins;Adventure, Casual, Indie, Simulation;0 - 20,000;2;0;2;0;0;0
805800;Five Seconds of Bad Music;Action, Adventure;0 - 20,000;1;0;1;0;0;0
805840;Just One Color;Action, Casual, Indie, Early Access;0 - 20,000;5;1;4;0;0;0
805850;Wrecked;Adventure, Indie, RPG;200,000 - 500,000;1773;525;1248;33;16;0
805870;Do you know de way;Action, Casual, Indie, Sports, Early Access;0 - 20,000;164;62;102;147;147;0
805880;Trivia Vault Olympics Trivia;Adventure, Indie, Simulation, Early Access;0 - 20,000;40;28;12;3;3;0
805900;Metal Division;Adventure, Indie;0 - 20,000;8;0;8;0;0;0
805920;Seek Etyliv;Adventure, Casual, Indie;0 - 20,000;43;10;33;0;0;0
805940;RUSSIA BATTLEGROUNDS;Adventure, Casual, Indie;200,000 - 500,000;2957;849;2108;71;66;81
805950;Isolated;Action, Adventure, Casual, Indie;0 - 20,000;1;0;1;0;0;0
805980;My Safe House;Casual, Indie;0 - 20,000;4;6;-2;0;0;0
806000;OrcCraft;Adventure, Indie;0 - 20,000;21;14;7;0;0;0
806020;Milky Way Map;Violent, Gore, Action, Casual, Indie;0 - 20,000;43;9;34;0;0;0
806100;PLATI NALOG: Favorite Russian Game;Action, Adventure, Casual, Indie;0 - 20,000;105;23;82;22;22;0
806140;Achievements printer;Adventure, Indie, RPG;200,000 - 500,000;831;203;628;93;105;2
806150;Bloody and cruel story of toys;Action, Indie, Early Access;0 - 20,000;4;9;-5;0;0;0
806180;Beyond The Heavens;Action, Indie;0 - 20,000;3;1;2;0;0;0
806220;;Action, Adventure, Indie;0 - 20,000;24;13;11;0;0;0
806230;Mech League Hunting;Action, Adventure, Indie;0 - 20,000;6;4;2;0;0;0
806240;RollingBall;Adventure, Casual, Indie;0 - 20,000;9;26;-17;1;1;0
806300;Quotes Quest - Match 3;Casual, Indie;0 - 20,000;0;1;-1;0;0;0
806330;Retro Rocket Robot;Action, Indie;0 - 20,000;0;1;-1;0;0;0
806350;Awkward Date Hero;Indie, Racing, Simulation, Sports;0 - 20,000;5;1;4;0;0;0
806470;Archery Blast;Adventure;0 - 20,000;28;22;6;0;0;0
806470;Archery Blast;Action, Casual, Indie;0 - 20,000;28;22;6;0;0;0
806480;Blood Moon: The Last Stand;Adventure;0 - 20,000;1;1;0;0;0;0
806490;As We Know It;Action, Adventure, Casual, Indie, Strategy;0 - 20,000;15;4;11;0;0;0
806510;Her Lie I Tried To Believe;Sexual Content, Nudity, Casual, Indie;50,000 - 100,000;784;181;603;93;185;0
806530;Unending Dusk;Casual, Indie, Strategy;0 - 20,000;46;23;23;0;0;0
806540;Crush Fly;Action, Indie;0 - 20,000;0;0;0;0;0;0
806550;Existence;Adventure, Indie;0 - 20,000;2;0;2;0;0;0
806560;VRでエミリアと異世界生活-膝枕&添寝編;RPG;0 - 20,000;2;1;1;0;0;0
806580;7th Deep;;20,000 - 50,000;23;2;21;0;0;0
806600;Escape!;Casual, Indie;0 - 20,000;1;0;1;0;0;0
806610;Trivia Vault Basketball Trivia;Simulation;0 - 20,000;37;28;9;1;1;0
806670;Lanterns;Violent, Gore, Action;0 - 20,000;4;0;4;0;0;0
806720;幻想四倍剣^2 悔悟棒の謎 / GensoYonbaiKen^2;Action, Racing;0 - 20,000;36;1;35;0;0;0
806740;Fei Duanmu VS Kobayashi 端木斐 VS 小林正雪;Action, Adventure, Indie, RPG;20,000 - 50,000;168;14;154;0;0;0
806770;NoReload Heroes;Action, Indie, Strategy;0 - 20,000;55;19;36;210;210;0
806830;Horse World;Indie, Simulation, Strategy;0 - 20,000;16;8;8;0;0;0
806840;Guiding Hand VR;Casual, Indie, Strategy;0 - 20,000;4;0;4;0;0;0
806850;aMAZE Gears;Sexual Content, Nudity, Casual, Indie;0 - 20,000;77;29;48;1;1;0
806860;They Are Hundreds;Action, Indie;0 - 20,000;102;91;11;9;9;0
806880;DJ Mole;Casual, Indie;0 - 20,000;2;2;0;0;0;0
806900;Them Bombs;Action, Adventure, Indie, RPG, Early Access;0 - 20,000;26;0;26;0;0;0
806900;Them Bombs;Action, Adventure, Casual, Indie;0 - 20,000;26;0;26;0;0;0
806910;Posthuman: Sanctuary;Action, Adventure, Casual, Indie;0 - 20,000;8;5;3;0;0;0
806930;Castle Secrets: Between Day and Night;Action, Adventure, Massively Multiplayer;0 - 20,000;0;2;-2;0;0;0
806940;So Long Grandma;Casual, Game Development;0 - 20,000;2;3;-1;0;0;0
806950;Victory At Sea Pacific;Casual, Indie;20,000 - 50,000;352;229;123;0;0;13
806960;Dr. Cares - Amy's Pet Clinic;Action, Indie, Racing;0 - 20,000;53;13;40;0;0;1
806970;Loader;Casual, Indie, Sports, Early Access;0 - 20,000;27;24;3;0;0;0
806990;EverHero - The Fantasy Shooter;Casual, RPG, Simulation;0 - 20,000;5;4;1;0;0;0
807050;Scrash;Casual, Indie, Simulation;20,000 - 50,000;20;11;9;0;0;0
807060;Void Monsters: Spring City Tales;Action, Indie;0 - 20,000;38;15;23;0;0;0
807070;Attack of the Gigant Zombie vs Unity chan;Casual, Indie;0 - 20,000;22;3;19;0;0;0
807120;Iratus: Lord of the Dead;Adventure, Massively Multiplayer, RPG;200,000 - 500,000;5648;910;4738;559;454;61
807140;Marble Run 2D;Action, Adventure, Indie;50,000 - 100,000;62;22;40;89;56;1
807230;Silenced: The House;Adventure, Casual, Indie, RPG, Simulation, Strategy;0 - 20,000;61;24;37;0;0;0
807310;Encompassed;Action, Casual, Early Access;0 - 20,000;0;0;0;0;0;0
807340;Frank the Miner;Casual, Indie, Strategy;0 - 20,000;20;40;-20;0;0;0
807430;VAD - Virtually Assured Destruction;Action, Indie, Early Access;0 - 20,000;2;2;0;0;0;0
807570;Volotic;Action, Adventure, Casual, Indie;0 - 20,000;3;1;2;0;0;0
807730;Draft Day Sports: College Basketball 2018;Indie;0 - 20,000;7;4;3;0;0;0
807770;Frequent Flyer: A Long Distance Love Story;Action, Casual, Indie;0 - 20,000;8;8;0;0;0;0
807780;Mahjong Classic;Adventure, Indie;0 - 20,000;7;18;-11;0;0;0
807790;Parkour Simulator;Casual;0 - 20,000;10;22;-12;0;0;0
807820;Mystery Village: Shards of the Past;Casual;0 - 20,000;0;5;-5;0;0;0
807830;Pottery Crafts: Hand-Made Simulator;Indie, RPG, Early Access;0 - 20,000;4;18;-14;0;0;0
807840;Fuse Balls;Casual, Free to Play;0 - 20,000;4;2;2;0;0;0
807850;Build Bridges;Action, Casual, Indie;0 - 20,000;5;11;-6;0;0;0
807860;Mafia Gambling;Free to Play, Indie, Racing;0 - 20,000;5;9;-4;0;0;0
807870;Survival Planet;Casual, Indie;0 - 20,000;2;1;1;0;0;0
807880;Mermaid Land;Action, Adventure, Indie;0 - 20,000;5;11;-6;0;0;0
807890;Geek Fighter;Adventure, Casual, Indie, Strategy;0 - 20,000;7;11;-4;25;25;0
807910;Road Legends;Adventure, Casual, Indie;0 - 20,000;2;6;-4;0;0;0
807920;Onii-Chan;Action, Adventure, Casual, Indie, RPG, Strategy;0 - 20,000;86;65;21;0;0;0
807930;War Of Spells;Casual, Indie;0 - 20,000;0;4;-4;0;0;0
807940;War of Criminals;Violent, Gore, Action, Adventure, Indie;0 - 20,000;5;9;-4;0;0;0
807950;Piano Cat;Violent, Gore, Action, Adventure, Free to Play, Indie;0 - 20,000;6;7;-1;0;0;0
807960;Poly World;Strategy;0 - 20,000;4;1;3;48;48;0
807990;DangerSpace;Action, Indie;0 - 20,000;4;1;3;0;0;0
808010;Critadel;Casual, Indie;0 - 20,000;160;29;131;0;0;1
808020;Nightmare Pop!;Adventure, Casual, Indie;0 - 20,000;0;2;-2;0;0;0
808080;Ultimate Racing 2D;Action, Adventure, Casual, Indie, Strategy;20,000 - 50,000;408;50;358;73;138;3
808080;Ultimate Racing 2D;Action, Indie;20,000 - 50,000;408;50;358;73;138;3
808090;Bury Me, My Love;Adventure, Simulation, Strategy;0 - 20,000;72;37;35;0;0;0
808100;Galimulator;Action, Casual, Indie, Strategy;50,000 - 100,000;386;41;345;26;26;5
808120;Anark.io;Action, Adventure, Casual, Indie, RPG;0 - 20,000;3;0;3;0;0;0
808130;Eternal Man: Village;Action, Indie;0 - 20,000;18;5;13;0;0;0
808160;UniverCity;Action, Adventure, Casual, Indie, Racing, Early Access;0 - 20,000;8;8;0;0;0;0
808190;Super Sonic Racer;Action, Adventure, Casual, Indie, Simulation, Sports;0 - 20,000;12;2;10;0;0;0
808210;The Villa: Allison's Diary;Action, Adventure, Indie, Racing;0 - 20,000;8;4;4;0;0;0
808220;SCP-087 VR Survivor;Action, Casual, Indie;0 - 20,000;8;5;3;0;0;0
808270;Bomb Bomb! My Friends;Casual, Indie;0 - 20,000;2;2;0;0;0;0
808290;Runes of Magic;Casual, Indie;200,000 - 500,000;751;380;371;10;13;188
808360;Graveyard Birds;Adventure, Casual, Simulation;0 - 20,000;7;1;6;0;0;0
808420;Global Soccer: A Management Game 2018;Simulation;0 - 20,000;4;7;-3;0;0;0
808450;BeeFender;RPG, Strategy;0 - 20,000;9;2;7;0;0;0
808540;GATARI: Sand on Teeth;Casual, Indie, RPG, Simulation;0 - 20,000;15;7;8;0;0;0
808550;Project Rampage VR;Adventure, Casual, Free to Play, Indie;0 - 20,000;52;20;32;0;0;0
808580;The Lone Chameleon;Action, Casual, Indie, Simulation;0 - 20,000;18;2;16;0;0;0
808770;Headspun;Action, Adventure, Indie;20,000 - 50,000;18;14;4;0;0;0
808800;Star Singularity;Casual, Indie, Simulation;0 - 20,000;43;11;32;0;0;4
808810;Robo Boop;Adventure, Casual, Indie, RPG;0 - 20,000;9;3;6;0;0;0
808870;Multiple Views Objects 多视体;Adventure, Indie;0 - 20,000;1;0;1;0;0;0
808880;MiniTracks;Casual, Indie, Strategy;0 - 20,000;23;5;18;0;0;0
808910;STAR WARS Episode I Racer;Indie;200,000 - 500,000;1439;214;1225;57;77;24
808950;Cross-Stitch Puzzle;Animation & Modeling, Software Training, Utilities, Early Access;0 - 20,000;13;3;10;0;0;0
808980;Rose Seed Replica;Action, Adventure, Indie;0 - 20,000;17;2;15;0;0;0
808990;RoboWorlD tactics;Casual, Indie, RPG, Simulation;0 - 20,000;11;1;10;0;0;0
809000;Art of Murder - FBI Confidential;Action, Adventure, Casual, Indie, Early Access;20,000 - 50,000;119;55;64;7;7;0
809020;ZeroRanger;Casual, Indie;50,000 - 100,000;1174;49;1125;276;276;3
809040;Hummingz - Retro Arcade action revised;Action, Casual, Indie;0 - 20,000;4;3;1;0;0;0
809050;Detective Holmes: Trap for the Hunter. Hidden objects. 探し物;Action, Indie;0 - 20,000;48;15;33;0;0;0
809080;Nanoui;Casual, Indie, Strategy;0 - 20,000;10;12;-2;0;0;0
809140;Cliff Empire;Action, Indie;200,000 - 500,000;3337;482;2855;246;286;34
809150;Tesseract VR;Action, Casual, Indie;20,000 - 50,000;15;10;5;0;0;0
809180;District 112 Incident: Bowling Alley;Sports;0 - 20,000;11;5;6;0;0;0
809200;TRIGGERED;Adventure, Indie, RPG;0 - 20,000;5;6;-1;0;0;0
809210;LifeZ - Survival;Casual, Indie;20,000 - 50,000;163;67;96;0;0;1
809220;AlienSurvival;Action, Casual, Indie;0 - 20,000;2;12;-10;0;0;0
809230;Unity of Command II;Strategy;20,000 - 50,000;1213;269;944;982;1886;78
809240;Vandals;Action, Adventure, Indie;20,000 - 50,000;49;9;40;0;0;0
809250;BEKKOUAME;Action, Casual, Indie, Simulation, Strategy;20,000 - 50,000;205;15;190;0;0;1
809270;GameLibBooster;Adventure, Casual, Indie;0 - 20,000;8;2;6;0;0;4
809280;Grimmwood - They Come at Night;Action, Adventure, Indie, RPG;20,000 - 50,000;133;107;26;0;0;0
809310;Sipho;Action, Casual, Indie, Sports;20,000 - 50,000;132;20;112;0;0;0
809330;Destiny of Light;Casual, Free to Play, Simulation;0 - 20,000;2;1;1;0;0;0
809340;Extreme School Driving Simulator;Action, Casual, Indie, Sports;0 - 20,000;57;23;34;0;0;0
809360;COSMIC SNAKE 8473/3671(HAMLETs);Casual, Free to Play, Simulation;0 - 20,000;12;3;9;0;0;0
809380;MagicCat;Utilities;0 - 20,000;12;1;11;0;0;0
809380;MagicCat;Adventure, Casual;0 - 20,000;12;1;11;0;0;0
809410;The Take;Action, Adventure, Casual, Indie, RPG, Strategy;0 - 20,000;14;3;11;0;0;0
809430;The Floor is Lava;Photo Editing, Video Production;0 - 20,000;0;0;0;0;0;0
809440;Protolife;Audio Production;50,000 - 100,000;358;55;303;732;855;0
809460;Earth Muncher;Action, Adventure, Indie;0 - 20,000;11;1;10;0;0;0
809470;Survivor Island;Adventure, Indie, Simulation;0 - 20,000;13;8;5;0;0;0
809470;Survivor Island;Simulation;0 - 20,000;13;8;5;0;0;0
809480;Zap, Blast, Loot;Action, Adventure, Casual;0 - 20,000;1;1;0;0;0;0
809490;Infernales: Circles of Hell;Violent, Action, Casual, Indie;0 - 20,000;8;19;-11;0;0;0
809500;Brazilian Root;Violent, Action, Casual, Indie;0 - 20,000;56;7;49;0;0;0
809530;Hypergate;Action, Adventure, Indie, RPG;0 - 20,000;40;5;35;0;0;0
809540;Mechs V Kaijus - Tower Defense;Casual, Indie, Strategy;50,000 - 100,000;361;63;298;362;362;3
809570;Ignis Avis Venatio;Sports;0 - 20,000;2;3;-1;0;0;0
809580;RAMS;Action, Adventure, Indie;0 - 20,000;48;38;10;0;0;0
809610;Yacht Simulator VR;Adventure, Free to Play, Indie, Early Access;0 - 20,000;2;3;-1;0;0;0
809640;尺子和橡皮;Adventure, Casual, Indie;0 - 20,000;0;0;0;0;0;0
809680;Panzer Hearts - War Visual Novel;Action, Casual, Indie;0 - 20,000;81;11;70;0;0;0
809680;Panzer Hearts - War Visual Novel;Action, Adventure, Indie, Simulation, Strategy;0 - 20,000;81;11;70;0;0;0
809700;CubeRun;Adventure, Indie;0 - 20,000;16;5;11;0;0;0
809720;Rescue HQ - The Tycoon;Adventure, Free to Play, Massively Multiplayer, Simulation, Early Access;20,000 - 50,000;620;146;474;295;295;9
809760;JungleShoot;Action, Indie, Strategy;0 - 20,000;2;7;-5;0;0;0
809770;DeerHunterX;Indie;0 - 20,000;9;49;-40;0;0;0
809780;TheGunRunner;Action, Indie;0 - 20,000;5;18;-13;0;0;0
809790;Nightmare Simulator;Action, Casual, Strategy;0 - 20,000;14;18;-4;0;0;0
809800;TheWraithTrails;Casual, Indie, Simulation, Strategy;0 - 20,000;2;11;-9;0;0;0
809830;China VS Roman;Action, Adventure, Massively Multiplayer, Simulation;20,000 - 50,000;3;1;2;0;0;0
809840;Anime show 动漫时装秀;Action, Adventure, Casual, Indie;0 - 20,000;13;10;3;0;0;0
809850;Sudoku Zenkai;Action;0 - 20,000;165;17;148;0;0;4
809880;Degrees of Separation;Action, Adventure, Casual, Indie;20,000 - 50,000;680;114;566;319;361;6
809890;Shining Resonance Refrain;Action, Adventure, Casual, Indie;50,000 - 100,000;809;335;474;390;418;13
809900;Calvin Tucker's Farm Animal Racing;Adventure, Indie, RPG;0 - 20,000;54;13;41;0;0;0
809950;Asemblance: Oversight;Action, Adventure, Indie, Simulation;0 - 20,000;15;4;11;0;0;0
809960;Radical Heights;Action, Adventure, Casual, Indie;1,000,000 - 2,000,000;6112;3868;2244;83;22;0
810000;Manaya;Casual, Indie, Simulation, Sports, Strategy;0 - 20,000;13;1;12;0;0;0
810000;Manaya;Action, Adventure, Indie;0 - 20,000;13;1;12;0;0;0
810020;Belle II in Virtual Reality;Casual, Indie, Simulation;0 - 20,000;6;1;5;0;0;0
810040;Swords 'n Magic and Stuff;Action, Casual, Indie;100,000 - 200,000;858;57;801;22;22;9
810050;Starbucket;Adventure, Casual, Simulation;0 - 20,000;2;2;0;0;0;0
810060;Beautiful Bricks;Action, Adventure, Indie, Early Access;0 - 20,000;22;4;18;0;0;0
810080;DMD Branefold;Action, Casual, Indie;0 - 20,000;0;1;-1;0;0;0
810190;Zombie Town : Online;Sexual Content, Nudity, Action, Adventure, Indie, RPG;0 - 20,000;1;1;0;0;0;0
810200;blue.;Violent, Gore, Action, Adventure, RPG, Simulation, Strategy, Early Access;0 - 20,000;53;43;10;3;3;0
810220;FAUCET VR;Violent, Gore, Action, Adventure, Indie, Simulation, Early Access;0 - 20,000;1;0;1;0;0;0
810230;Traum;Action, Casual, Strategy;20,000 - 50,000;312;27;285;40;49;0
810250;RACING GAME;Indie, Strategy;0 - 20,000;2;1;1;0;0;0
810330;Fast Food Rampage;Indie;0 - 20,000;13;1;12;0;0;0
810360;Masters of Puzzle;Casual, Indie;0 - 20,000;22;5;17;0;0;0
810420;Find the Gnome;Adventure, Casual, Indie;0 - 20,000;8;2;6;0;0;0
810450;The Idiot's Tale;Casual, Indie;0 - 20,000;7;0;7;0;0;0
810460;Riverhill Trials;Indie, Simulation, Strategy;0 - 20,000;33;19;14;54;54;0
810470;Black Dream Plus;Casual, Indie;0 - 20,000;60;9;51;0;0;0
810500;PowerBeatsVR - VR Fitness;Video Production;0 - 20,000;373;61;312;114;114;6
810510;Welcome Back Daddy;Action, Adventure, Indie;0 - 20,000;28;58;-30;0;0;0
810510;Welcome Back Daddy;Action, Indie;0 - 20,000;28;58;-30;0;0;0
810540;Monsters Attack;Indie;0 - 20,000;6;15;-9;0;0;0
810570;FACE;Casual, Indie;0 - 20,000;58;43;15;0;0;0
810580;Novas Las Aventurietas del Robercleiton: o Renascimento do TURBO;Adventure, Casual, Indie, Simulation, Strategy;0 - 20,000;14;1;13;0;0;0
810590;Area 86;Action, Casual, Indie, Strategy;0 - 20,000;30;7;23;0;0;0
810610;Mission Of Hero;Casual, Indie;0 - 20,000;13;20;-7;0;0;0
810630;Paint It Black;Adventure, Indie;0 - 20,000;26;7;19;0;0;0
810640;Radiis;Casual, Indie, Racing;0 - 20,000;73;7;66;0;0;3
810650;The Next Day After Friday;Casual, Indie;0 - 20,000;1;3;-2;0;0;0
810660;The Office Quest;Action, Adventure, Casual, Indie;50,000 - 100,000;624;42;582;23;23;3
810670;NALOGI;;50,000 - 100,000;1243;339;904;106;107;1
810680;Zombie Murder;Nudity, Violent, Adventure, Indie, RPG;0 - 20,000;13;13;0;0;0;0
810690;Colour Box;Casual, Free to Play, Indie, Sports;0 - 20,000;23;1;22;0;0;0
810700;The Final Days: Blood Dawn;Indie, Simulation, Sports;0 - 20,000;2;0;2;0;0;0
810720;Zombie Murder Hell Arrives;Action, Casual, Indie;0 - 20,000;10;8;2;0;0;0
810740;Turtle Lu;Casual, Free to Play, Indie, RPG, Simulation, Strategy;20,000 - 50,000;5;10;-5;0;0;0
810760;Starman's VR Experience;Adventure, Indie;0 - 20,000;22;13;9;0;0;0
810770;Frog Demon;Free to Play, Strategy;0 - 20,000;12;23;-11;0;0;0
810780;RAIN Project - a touhou fangame;Adventure, Indie, RPG, Strategy, Early Access;0 - 20,000;94;23;71;0;0;0
810800;Action Alien: Tropical;Casual, Strategy;0 - 20,000;15;11;4;0;0;0
810800;Action Alien: Tropical;Adventure, Casual, Indie;0 - 20,000;15;11;4;0;0;0
811040;Memoir;Adventure, Indie;0 - 20,000;6;0;6;0;0;0
811080;Total Esports Action Manager;Casual, Indie;0 - 20,000;6;10;-4;0;0;0
811110;BlackSimulator;Action, Racing, Simulation, Sports;0 - 20,000;16;0;16;0;0;0
811130;Forever Space;Casual, Indie;0 - 20,000;24;4;20;0;0;0
811160;Game of Stones;Action, Indie;0 - 20,000;1;0;1;0;0;0
811180;Farm Quest;Casual, Indie;0 - 20,000;5;9;-4;0;0;0
811190;ORION;Adventure, Casual, Indie;0 - 20,000;4;11;-7;0;0;0
811190;ORION;Adventure, Indie;0 - 20,000;4;11;-7;0;0;0
811240;Don't Stand Out;Adventure, Casual, Free to Play, Indie;0 - 20,000;48;30;18;0;0;0
811250;Content Creator Simulator;Adventure, Indie;0 - 20,000;10;7;3;0;0;0
811270;Impulsion;Animation & Modeling, Utilities, Early Access;20,000 - 50,000;212;28;184;107;119;0
811290;Project Pastorate;Casual, Indie;20,000 - 50,000;28;6;22;141;141;0
811320;Jupiter Hell;Action, Adventure, Indie, RPG, Simulation, Strategy;20,000 - 50,000;1320;104;1216;277;400;24
811360;Archibald;Action, Adventure, Free to Play, Indie, Early Access;0 - 20,000;44;59;-15;0;0;0
811440;Gripper's Adventure;Adventure, Casual, Indie, Simulation, Strategy;0 - 20,000;2;1;1;0;0;0
811450;Dongo Adventure;Sexual Content, Adventure, Casual, Indie;0 - 20,000;12;7;5;0;0;0
811470;Immunity;Action, Casual, Indie;0 - 20,000;1;1;0;0;0;0
811480;Geography Quiz;Casual, Indie, Simulation;0 - 20,000;8;7;1;0;0;0
811540;Amazon Rush;Action, Indie, Simulation;0 - 20,000;8;26;-18;0;0;0
811550;MythBusters: The Game - Crazy Experiments Simulator;Casual, Racing, Sports;0 - 20,000;58;68;-10;41;41;0
811550;MythBusters: The Game - Crazy Experiments Simulator;Casual, Indie, Racing, Sports;0 - 20,000;58;68;-10;41;41;0
811620;Organosphere;Free to Play, Massively Multiplayer, RPG, Strategy;0 - 20,000;43;8;35;0;0;0
811630;Don't Look Back;Action, Casual, Simulation, Strategy;0 - 20,000;3;4;-1;0;0;0
811640;Divided: Soul Theft;Action, Casual, Free to Play, Indie, Early Access;0 - 20,000;4;2;2;0;0;0
811690;It's A Racing Game;Indie, Simulation, Strategy, Early Access;0 - 20,000;0;1;-1;0;0;0
811720;Outbreak: The Nightmare Chronicles;Action, Indie, Strategy;20,000 - 50,000;61;23;38;0;0;0
811750;Breach of Contract Reloaded;Adventure, Casual;50,000 - 100,000;101;121;-20;8;12;0
811750;Breach of Contract Reloaded;Adventure, Casual, Indie, RPG;50,000 - 100,000;101;121;-20;8;12;0
811800;MINT VR;Action, Indie, Strategy;0 - 20,000;7;7;0;0;0;0
811850;Samba Shooter;Casual, Indie, Strategy;0 - 20,000;2;0;2;0;0;0
811860;Cross And Crush;Casual, Strategy;0 - 20,000;7;6;1;0;0;0
811870;Verlet Swing;Action, Casual;20,000 - 50,000;521;60;461;70;87;2
811870;Verlet Swing;Casual, Indie, Racing, Simulation, Sports, Early Access;20,000 - 50,000;521;60;461;70;87;2
811880;Close Combat: The Bloody First;Adventure, Indie, RPG;0 - 20,000;211;195;16;0;0;9
811900;Tidy Your Room Simulator;Sexual Content, Adventure, Free to Play, Indie, Simulation;0 - 20,000;8;7;1;0;0;0
811910;MRS SNAKE;Action, Adventure, Casual, Indie, Simulation;0 - 20,000;14;4;10;0;0;0
811940;Game of Drones;Casual, Indie, RPG;0 - 20,000;1;0;1;0;0;0
811950;Bloody Faerie;Action, Indie;0 - 20,000;6;10;-4;0;0;0
811970;Super Dream Dasher;Adventure, Casual, Indie;0 - 20,000;8;0;8;0;0;0
812020;Elea - Episode 1;Action, Casual, Indie;0 - 20,000;62;30;32;208;208;0
812020;Elea - Episode 1;Simulation;0 - 20,000;62;30;32;208;208;0
812040;Shortest Trip to Earth;Action, Adventure, Indie, Racing, Simulation;50,000 - 100,000;1004;295;709;543;644;11
812070;Project Nightmares Case 36: Henrietta Kedward;Casual, Indie;0 - 20,000;233;59;174;0;0;1
812090;RAW FOOTAGE;Action, Adventure, Casual, Indie, Strategy;0 - 20,000;43;26;17;0;0;0
812100;Blake and Mortimer: The Curse of the Thirty Denarii;Adventure, Casual, Indie, RPG, Simulation;0 - 20,000;16;6;10;0;0;0
812100;Blake and Mortimer: The Curse of the Thirty Denarii;Sexual Content, Nudity, Casual, Indie, RPG;0 - 20,000;16;6;10;0;0;0
812110;Alice in Wonderland - Hidden Objects;Casual;20,000 - 50,000;37;26;11;0;0;1
812140;Assassin's Creed Odyssey;Action, Adventure, Indie, RPG;2,000,000 - 5,000,000;120157;14443;105714;3696;2341;3474
812160;Etherborn;Action, Casual, Indie;20,000 - 50,000;263;101;162;154;154;1
812170;Parkland;Violent, Gore, Action, Indie;0 - 20,000;5;2;3;0;0;0
812180;Intro Maker;;0 - 20,000;4;8;-4;32;32;0
812190;Miasma Caves;Action, Casual, Free to Play, Indie;20,000 - 50,000;14;2;12;0;0;0
812360;Monsters of Kanji;Action, Adventure, Indie, Strategy;0 - 20,000;6;0;6;0;0;0
812390;Torimodosu;Adventure, Casual, Indie, Racing;0 - 20,000;0;1;-1;0;0;0
812410;Dimension of Monster Girls;Adventure, Casual, Indie;0 - 20,000;120;17;103;0;0;1
812430;Touch the devil VR(おさわり魔王VR);;0 - 20,000;1;3;-2;0;0;0
812450;The m0rg VS keys;Casual, Indie;20,000 - 50,000;31;24;7;0;0;0
812450;The m0rg VS keys;Action, Indie;20,000 - 50,000;31;24;7;0;0;0
812460;Air Raid Over Britain;Action, Indie;0 - 20,000;14;12;2;5;5;0
812470;Skyscraper Climb VR;Casual, Indie;0 - 20,000;0;1;-1;0;0;0
812550;The King's Bird;Indie;50,000 - 100,000;350;144;206;13;14;1
812560;CROSS†CHANNEL: Steam Edition;Casual, Indie, Early Access;20,000 - 50,000;228;26;202;0;0;0
812580;Chop It;Action, Indie;0 - 20,000;14;3;11;0;0;0
812590;Awakening of Celestial;Adventure, Free to Play, Indie, Simulation;0 - 20,000;5;0;5;0;0;0
812610;Escape Architect VR;Adventure, Casual, Indie, Simulation;0 - 20,000;7;0;7;0;0;0
812650;Data Defense;Casual, Indie;0 - 20,000;30;2;28;0;0;0
812740;The Plus Point;Action, Indie;0 - 20,000;7;0;7;0;0;0
812770;Lunapark VR;Action, Adventure, Indie, RPG, Early Access;20,000 - 50,000;11;9;2;0;0;0
812810;missed messages.;Action, Adventure, Casual, Indie, Simulation;200,000 - 500,000;13156;527;12629;26;27;6
812840;LuGame: Lunchtime Games Club!;Adventure, Casual;0 - 20,000;169;8;161;0;0;0
812850;Outline;Adventure, Casual;0 - 20,000;8;13;-5;0;0;0
812870;Sentinels of Freedom;Adventure, Casual;20,000 - 50,000;192;60;132;0;0;0
812890;Bifrost Project;Adventure, Casual;0 - 20,000;1;0;1;0;0;0
812900;Bump Bump Bump;Adventure, Casual;0 - 20,000;2;0;2;0;0;0
812930;Strategic Command Classic: WWII;Action, Indie, Strategy;0 - 20,000;19;3;16;0;0;5
812940;Dear Leader;Violent, Gore, Adventure, Indie;0 - 20,000;9;6;3;0;0;0
812960;Guilds Of Delenar;Free to Play;0 - 20,000;32;11;21;0;0;0
812980;POSTWORLD;Action, Adventure, Casual, Indie, Racing, Simulation, Sports;0 - 20,000;46;41;5;0;0;0
813020;Broken Ties;Adventure, Casual;0 - 20,000;6;0;6;0;0;0
813030;Reverie - A Heroes Tale;Indie, Massively Multiplayer, RPG, Strategy;0 - 20,000;16;3;13;0;0;0
813110;Paralines The Last paladin;Casual, Indie;0 - 20,000;48;40;8;0;0;0
813150;Elevator Ritual;Action;0 - 20,000;10;6;4;188;188;0
813170;Don't Pray To Satan;Action, Adventure, Indie, RPG, Early Access;0 - 20,000;9;17;-8;1;1;0
813200;DDS(D.I.Y Drone Simulator) Demo;Adventure, Casual;0 - 20,000;3;9;-6;11;11;0
813240;Grim Town: Battle Tales;Adventure, Casual;0 - 20,000;5;12;-7;0;0;0
813250;Unicorn Dungeon;Adventure, Casual;0 - 20,000;19;3;16;0;0;0
813260;Vector Born;Adventure, Casual;0 - 20,000;2;0;2;0;0;0
813280;Sky Hawk;Casual, Free to Play, Indie, Simulation;0 - 20,000;0;4;-4;0;0;0
813290;This Child Of Mine;Action, Indie;0 - 20,000;46;25;21;0;0;0
813300;CODE CRACKER 代码破译者;Action, Free to Play, Indie;0 - 20,000;134;11;123;0;0;0
813310;Outsider Strategist～異世界で軍師になる～;Action, Indie, Strategy;0 - 20,000;1;0;1;0;0;1
813350;Ben 10 VR;Education;0 - 20,000;0;0;0;0;0;0
813360;Space Duty;Adventure, Indie;0 - 20,000;1;0;1;0;0;0
813370;การิน ปริศนาคดีอาถรรพ์ the game : ตอนพิธีเปลี่ยนชีพ;Action, Indie;0 - 20,000;13;0;13;0;0;0
813400;在这个世界的尽头，你与我被遗忘的传说;Casual, Indie, Simulation, Strategy;0 - 20,000;27;12;15;0;0;0
813440;DrillsVR;Action, Indie;0 - 20,000;19;13;6;0;0;1
813450;Barbearian;Adventure, Casual, Indie;0 - 20,000;69;13;56;0;0;0
813480;General Horse and the Package of Doom;Action, Racing;0 - 20,000;41;2;39;0;0;0
813530;FPV Freerider Recharged;Casual, Indie;;;;0;;;
813540;Scheming Through The Zombie Apocalypse: The Beginning;Adventure, Casual, Indie;100,000 - 200,000;296;47;249;228;228;2
813590;Solas and the White Winter;Action, Indie, RPG, Early Access;0 - 20,000;16;8;8;0;0;0
813630;Supraland;Action, Casual, Indie;500,000 - 1,000,000;9847;470;9377;751;903;95
813650;Runefall;Sexual Content, Violent, Gore, Casual;0 - 20,000;104;10;94;0;0;4
813650;Runefall;;0 - 20,000;104;10;94;0;0;4
813700;Sakura Sadist;Violent, Gore, Adventure, Indie, Simulation, Strategy;20,000 - 50,000;337;61;276;153;153;2
813700;Sakura Sadist;Action, Adventure, Indie, RPG, Early Access;20,000 - 50,000;337;61;276;153;153;2
813730;Fleet Star V;Casual, Indie;0 - 20,000;5;0;5;0;0;0
813780;Age of Empires II: Definitive Edition;Adventure, Indie;2,000,000 - 5,000,000;111452;6173;105279;2124;614;20369
813820;Realm Royale;Action, Free to Play, Indie;5,000,000 - 10,000,000;41817;13398;28419;765;126;702
813920;oldTail;Indie, Early Access;0 - 20,000;4;1;3;0;0;0
813930;Revoke;Action, Adventure, Indie;0 - 20,000;17;7;10;0;0;1
813970;Urban - Episode 1;Action, Casual, Indie;0 - 20,000;12;1;11;0;0;0
814000;ONE PIECE ODYSSEY;Casual, Indie;50,000 - 100,000;1420;309;1111;1244;1366;309
814010;Ball Driver;Action, Adventure, Indie, RPG, Strategy, Early Access;0 - 20,000;1;2;-1;0;0;0
814020;Quickshot;Indie;0 - 20,000;2;1;1;0;0;0
814030;Queen's Quest 4: Sacred Truce;Sexual Content, Adventure, Indie, RPG;0 - 20,000;100;34;66;0;0;1
814140;Nuclear 2050;Action, Adventure, Casual, Free to Play, Indie;0 - 20,000;7;8;-1;0;0;0
814190;Digital Runner;Adventure, Indie;0 - 20,000;2;1;1;0;0;0
814200;Simple Story - Alex;Adventure, Indie, RPG;100,000 - 200,000;351;201;150;3;3;0
814210;搜索·迷城掠影/The phantom of the city;Action, Indie;0 - 20,000;10;10;0;0;0;0
814230;Slam Land;Utilities;0 - 20,000;1;0;1;0;0;0
814300;Pigeons Attack;Action, Casual, Indie;0 - 20,000;150;11;139;0;0;1
814310;D.A.T.A;Action, Indie;0 - 20,000;56;54;2;0;0;0
814310;D.A.T.A;Casual, Free to Play, Indie;0 - 20,000;56;54;2;0;0;0
814320;Arkady Survive;Adventure, Casual, Indie, RPG;0 - 20,000;7;2;5;0;0;0
814340;Ghoststory;Adventure, Indie, Early Access;0 - 20,000;6;15;-9;0;0;0
814360;Mythic Ocean;Action, Casual;0 - 20,000;85;2;83;0;0;0
814370;Monster Sanctuary;Action, Adventure, Indie;500,000 - 1,000,000;7276;609;6667;638;333;153
814380;Sekiro: Shadows Die Twice - GOTY Edition;Indie;5,000,000 - 10,000,000;209378;10448;198930;2230;1296;8611
814400;Battlewake;Violent, Action, Indie, Early Access;0 - 20,000;78;30;48;6;6;0
814420;TetraLogical;Action, Casual, Indie;0 - 20,000;19;0;19;0;0;0
814480;Mini World: Block Art;Gore, Action, Indie;1,000,000 - 2,000,000;1968;1678;290;1913;2730;216
814510;1248;Action, Indie;0 - 20,000;9;0;9;0;0;0
814530;Death Crown;Casual, Indie, Sports, Early Access;20,000 - 50,000;386;41;345;160;160;1
814540;Changed;Action;500,000 - 1,000,000;10329;1203;9126;654;577;69
814550;Cherry Island;Action, Adventure;0 - 20,000;0;1;-1;0;0;0
814560;Eat my Shuriken and Die!;Action, Casual, Indie, Simulation;0 - 20,000;1;0;1;0;0;0
814570;The Great Escape;Casual, Indie;0 - 20,000;14;12;2;0;0;0
814580;Where Time Stood Still;Action, Indie;0 - 20,000;9;9;0;0;0;0
814590;Caveman Stories;Gore, Simulation, Strategy;0 - 20,000;19;5;14;0;0;0
814600;Tunnel B1;Action, Early Access;0 - 20,000;10;10;0;0;0;0
814610;Last Rites;Action, Adventure;20,000 - 50,000;28;19;9;0;0;0
814620;Central Intelligence;Action, Casual, Indie, Early Access;0 - 20,000;6;6;0;0;0;0
814630;ELF;Action, Casual, Indie, Simulation, Sports;0 - 20,000;7;11;-4;0;0;0
814640;Sleepwalker;Design & Illustration, Photo Editing;0 - 20,000;6;7;-1;0;0;0
814650;Pushover;Indie;0 - 20,000;31;3;28;0;0;0
814660;The Unintended Consequences of Curiosity;Casual, Indie, Early Access;0 - 20,000;16;8;8;0;0;0
814680;Unbound: Worlds Apart;Adventure, Indie;20,000 - 50,000;688;114;574;141;141;4
814700;Larkin building by Frank Lloyd Wright;Casual, Indie;0 - 20,000;10;6;4;1;1;0
814710;The Rhys510 Flash Back;Adventure, Casual, Indie;0 - 20,000;3;1;2;0;0;0
814730;Rogue Frontiers;Action, Indie, Racing, Sports;0 - 20,000;10;1;9;0;0;2
814740;Armored Battle Crew [World War 1] - Tank Warfare and Crew Management Simulator;Action, Casual, Indie, Simulation, Strategy;20,000 - 50,000;235;320;-85;0;0;1
814770;Duder;Adventure, Indie;0 - 20,000;9;21;-12;0;0;0
814870;Monads;Action, Indie, Massively Multiplayer, Early Access;0 - 20,000;7;2;5;0;0;0
814870;Monads;Action, Adventure;0 - 20,000;7;2;5;0;0;0
814890;BoxEngine;Casual, Indie, Simulation;0 - 20,000;7;0;7;0;0;0
814900;三国虎将传VR-Sanguo Warriors VR;Adventure, Casual, Indie, RPG, Simulation, Strategy;0 - 20,000;53;21;32;29;29;0
814920;Sol705;Action, Indie;20,000 - 50,000;65;20;45;0;0;0
814960;Blackbox;Casual, Indie;0 - 20,000;10;1;9;0;0;0
814990;Super X Chess;Action, Adventure, Casual, Indie, Strategy;0 - 20,000;7;5;2;0;0;0
815000;Tardy;Simulation;0 - 20,000;177;14;163;0;0;0
815010;Relaxicon;Indie, Strategy;0 - 20,000;16;1;15;0;0;0
815030;SKULL FEAST;Casual, Free to Play, Indie, Simulation, Strategy;0 - 20,000;17;12;5;0;0;0
815040;Star Trek Adversaries;Action, Indie;100,000 - 200,000;171;123;48;12;12;0
815070;The Adventurous Four;Casual, Indie;0 - 20,000;16;5;11;0;0;0
815080;Hot Mars 69;Indie;20,000 - 50,000;37;46;-9;0;0;0
815110;Conc Jump;Action, Adventure, Indie, Massively Multiplayer, RPG, Simulation, Strategy, Early Access;0 - 20,000;3;0;3;0;0;0
815150;Knight Bewitched;Indie;20,000 - 50,000;122;11;111;0;0;2
815170;Zombie World;Casual;0 - 20,000;0;4;-4;0;0;0
815210;Tiny-Tasy Town;Casual, Indie, Simulation, Strategy, Early Access;0 - 20,000;115;81;34;0;0;0
815210;Tiny-Tasy Town;Adventure, Indie, RPG;0 - 20,000;115;81;34;0;0;0
815240;Forest Harvester Simulator;Action, Adventure, Casual, Indie;0 - 20,000;7;19;-12;1;1;0
815250;Magic League;Action, Casual, Indie, Sports;0 - 20,000;3;14;-11;0;0;0
815250;Magic League;Casual, Indie;0 - 20,000;3;14;-11;0;0;0
815260;Lords of Kingdoms;Adventure, Casual, Indie;200,000 - 500,000;23;40;-17;0;0;2
815280;Crooked Waters;Casual, Indie;0 - 20,000;15;3;12;0;0;0
815290;Guards of the Gate;Action, Adventure, Casual, Indie, Strategy, Early Access;0 - 20,000;28;13;15;0;0;0
815300;幻想英雄传 卡片对决;Action, Adventure, Indie;0 - 20,000;7;4;3;0;0;0
815320;Catify VR;Adventure, Indie;0 - 20,000;31;16;15;38;38;0
815360;Stick War: Castle Defence;Adventure, Indie;0 - 20,000;20;13;7;0;0;0
815370;Green Hell;Action, Casual, Indie;1,000,000 - 2,000,000;48034;7210;40824;944;664;2661
815390;Psi Cards;RPG;0 - 20,000;19;49;-30;0;0;0
815420;Bomb Hunter MT;Action, Casual, Indie;0 - 20,000;20;6;14;0;0;0
815440;Time Transit VR;Action, Casual, Indie;0 - 20,000;33;10;23;0;0;0
815450;Cardinal Cross;Action, Casual, Indie;20,000 - 50,000;167;9;158;0;0;0
815480;Ratergy;Casual, Indie, Simulation, Strategy;0 - 20,000;2;3;-1;0;0;0
815540;Awakening: The Skyward Castle Collector's Edition;Casual, Indie, Simulation, Strategy;0 - 20,000;8;1;7;0;0;1
815550;Surface: Alone in the Mist Collector's Edition;Action, Adventure, Casual, Indie, RPG;0 - 20,000;3;0;3;0;0;0
815560;Dead Reckoning: The Crescent Case Collector's Edition;Adventure, Indie;0 - 20,000;2;1;1;0;0;0
815570;Witches' Legacy: Hunter and the Hunted Collector's Edition;Indie, Simulation, Sports, Strategy;0 - 20,000;4;1;3;0;0;0
815580;Dark Parables: Return of the Salt Princess Collector's Edition;Action, Adventure, Casual;0 - 20,000;20;2;18;0;0;1
815620;Cyber Escape;Action, Indie, Early Access;0 - 20,000;0;1;-1;0;0;0
815630;Majula Frontier;Violent, Gore, Action, Adventure, Casual, Indie, Strategy;0 - 20,000;4;1;3;0;0;0
815630;Majula Frontier;Casual, Indie, Simulation;0 - 20,000;4;1;3;0;0;0
815660;Lucie;Education;0 - 20,000;77;14;63;0;0;0
815730;Swingy Sword;Adventure, Casual, Indie;0 - 20,000;4;1;3;0;0;0
815780;PIPE by BMX Streets;Adventure, Casual, Indie;200,000 - 500,000;5484;368;5116;1765;393;68
815800;Infecto;Adventure, Indie, Simulation;0 - 20,000;13;5;8;0;0;0
815830;Space Escape!;Casual, Free to Play, Indie;0 - 20,000;46;19;27;0;0;0
815840;Sword Mans;Adventure, Indie;200,000 - 500,000;2;4;-2;0;0;0
815860;Reframed;Casual, Indie, Early Access;0 - 20,000;9;8;1;0;0;0
815940;AVA: Dog Tag;Action, Indie;100,000 - 200,000;494;495;-1;0;0;0
815950;Chocolate makes you happy 4;Violent, Gore, Indie;0 - 20,000;102;37;65;1;1;0
816000;Face au train;Casual, Indie, Sports, Strategy, Early Access;0 - 20,000;2;0;2;0;0;0
816020;JUMP FORCE;Casual, Indie;1,000,000 - 2,000,000;16425;5866;10559;457;210;86
816030;Alice Must Find The Key To Escape (Hidden Objects);Adventure, Casual, Indie, Simulation, Sports;0 - 20,000;1;1;0;0;0;0
816040;Dot Debugger;Adventure, Simulation;20,000 - 50,000;8;2;6;0;0;0
816060;Kingdom Clicker;Casual, Indie;0 - 20,000;19;15;4;0;0;1
816080;Ultimate Select Hero / 究极勇者的选择传说;Action, Casual;0 - 20,000;77;13;64;0;0;0
816090;Space Hulk: Deathwing Enhanced Edition;Action, Adventure, Free to Play, Indie, Simulation;200,000 - 500,000;5736;2250;3486;256;174;72
816120;First Winter;Casual, Indie;0 - 20,000;96;4;92;0;0;0
816150;Hardway Party;Action, Indie, Simulation;0 - 20,000;6;1;5;0;0;0
816160;Score a goal 2 (Physical football);Indie, Racing, Sports, Early Access;20,000 - 50,000;64;25;39;0;0;0
816170;Spectrubes Infinity;Sexual Content, Nudity, Indie;0 - 20,000;9;2;7;0;0;0
816180;Zhmyshenko Valery Albertovich;Action;20,000 - 50,000;80;26;54;0;0;0
816190;Draw It!;Adventure, Indie;20,000 - 50,000;58;12;46;0;0;1
816200;Planet Assault;Casual, Free to Play, Simulation;0 - 20,000;0;1;-1;0;0;0
816210;The Balcony;Adventure, Casual, Indie, RPG;0 - 20,000;28;10;18;0;0;0
816220;Analistica Academy;Adventure;0 - 20,000;3;4;-1;0;0;0
816240;Build Wars;Action, Indie;0 - 20,000;21;20;1;8;8;0
816250;JQ: dogs & cats;Casual, Indie;0 - 20,000;77;15;62;0;0;0
816270;Sounds of Verity;Casual, Indie;20,000 - 50,000;153;36;117;193;193;0
816280;Amora;Audio Production, Utilities;0 - 20,000;12;1;11;0;0;0
816330;The Council of Hanwell;Audio Production, Utilities;0 - 20,000;48;29;19;0;0;0
816340;Kingdom Rush Origins - Tower Defense;Casual, Indie;200,000 - 500,000;4920;209;4711;867;609;183
816350;The Flood;Action, Adventure, Casual, Indie;50,000 - 100,000;956;179;777;7;11;0
816380;Crazzers;Violent, Gore, Action, Indie, Racing;0 - 20,000;10;8;2;0;0;0
816400;Questlike;Action, Casual, Indie;0 - 20,000;0;1;-1;0;0;0
816410;Go Go Poncho!;Action, Adventure, Free to Play, Indie;0 - 20,000;1;0;1;0;0;0
816430;Radical Relocation;Action, Adventure;0 - 20,000;134;44;90;0;0;0
816490;Hidden Paws;Adventure, Indie, RPG, Strategy;20,000 - 50,000;592;79;513;72;72;3
816500;Micro Pico Racers;Indie, Simulation, Sports, Strategy;0 - 20,000;26;7;19;0;0;0
816550;Gallows;Adventure, Indie;0 - 20,000;2;3;-1;0;0;0
816560;AVARIAvs;Adventure, Free to Play;0 - 20,000;46;9;37;0;0;0
816560;AVARIAvs;Action, Adventure, Indie;0 - 20,000;46;9;37;0;0;0
816570;DESOLATE: Clone Catastrophe;Adventure, Indie, Strategy;0 - 20,000;0;2;-2;0;0;0
816580;LOVE Obsession;Adventure, Indie, Simulation;0 - 20,000;3;5;-2;0;0;0
816590;FinalFire;Indie;20,000 - 50,000;74;64;10;0;0;0
816610;HandyCopter;Adventure, Casual, Indie, RPG;20,000 - 50,000;13;2;11;0;0;0
816630;Monkey King: Master of the Clouds | 中華大仙;Action, Casual, Indie, Racing;0 - 20,000;12;8;4;0;0;0
816650;Armor Contest;Adventure, Indie, Strategy, Early Access;0 - 20,000;20;5;15;0;0;0
816660;High Speed Trains;Action, Adventure, Casual, Indie, Strategy;20,000 - 50,000;13;16;-3;0;0;0
816660;High Speed Trains;Adventure;20,000 - 50,000;13;16;-3;0;0;0
816670;Slayer Of Traitors;Action, Adventure, Casual, Indie, Racing, Simulation, Sports;0 - 20,000;10;34;-24;0;0;0
816710;Gray Cat;Action, Adventure, Indie, RPG;20,000 - 50,000;104;34;70;4;4;1
816720;Bugs Must Die / 异星特勤队;Adventure, Indie, RPG, Strategy;0 - 20,000;126;9;117;0;0;0
816730;HeadON!;Casual, Indie, Simulation, Sports, Early Access;0 - 20,000;5;1;4;0;0;0
816760;Stickman: Fidget Spinner Rush;Strategy;0 - 20,000;25;3;22;0;0;0
816770;The Four Colour Theorem;RPG;0 - 20,000;13;1;12;0;0;0
816810;Unlight:SchizoChronicle;Adventure, Simulation, Early Access;20,000 - 50,000;60;28;32;0;0;0
816830;Varius;Indie, RPG, Strategy;0 - 20,000;19;2;17;0;0;0
816840;Night of the Shrub Part 1;Action, Racing, Simulation;20,000 - 50,000;0;1;-1;0;0;0
816850;Stardust Origins;Action, Indie, RPG, Simulation, Strategy;0 - 20,000;15;3;12;0;0;1
816870;Kill 'Em All;Action, Indie, Racing, Simulation, Strategy;0 - 20,000;10;4;6;0;0;0
816890;Perspecto;Violent, Adventure, Casual, Indie, RPG, Simulation;0 - 20,000;5;0;5;0;0;0
816920;Coastiality;Violent, Gore, Action, Adventure, Casual, Early Access;0 - 20,000;1;7;-6;0;0;0
816930;Production Sound / 产声;Action, Indie, Strategy;0 - 20,000;0;1;-1;0;0;0
816990;Dead Dust;Action, Casual, Indie;0 - 20,000;51;23;28;0;0;0
817110;Bitcoin VS Brain;Action, Adventure, Casual, Indie, RPG, Simulation;0 - 20,000;10;28;-18;0;0;0
817120;HAMMY;Action, Indie, Massively Multiplayer, Strategy;0 - 20,000;6;0;6;0;0;0
817130;WWE 2K19;Indie;200,000 - 500,000;2761;965;1796;1399;1109;56
817150;Factory pirates;Indie;0 - 20,000;5;5;0;0;0;0
817160;Scary defense;Action, Adventure, Casual, Indie;20,000 - 50,000;16;8;8;0;0;1
817190;Next 3;Action, Adventure, Indie, RPG, Strategy;0 - 20,000;125;11;114;0;0;0
817200;Nautical Life;Action, Indie, RPG, Early Access;0 - 20,000;27;10;17;0;0;0
817220;The Forestale;Casual, Indie, Strategy;0 - 20,000;28;1;27;0;0;0
817230;Acid Spy;Action, Indie, Massively Multiplayer, RPG, Simulation, Early Access;20,000 - 50,000;134;15;119;0;0;0
817250;Kill Him! Online Wars;Casual, Indie, Strategy;0 - 20,000;20;19;1;0;0;0
817360;The Outer Rim: Survivor;Simulation;50,000 - 100,000;49;15;34;43;43;0
817370;Marching Simulator;Action, Adventure, Indie;0 - 20,000;36;11;25;0;0;0
817370;Marching Simulator;Adventure, Casual, Indie, Sports, Strategy;0 - 20,000;36;11;25;0;0;0
817390;Age of Giants;Adventure, Indie, Strategy;0 - 20,000;3;3;0;0;0;0
817410;SushiParty;Action, Adventure, Indie;0 - 20,000;17;1;16;0;0;0
817440;AngelShooter;Casual, Indie, Simulation, Sports, Strategy;0 - 20,000;2;0;2;0;0;0
817460;Sea Dogs: Caribbean Tales;Casual, Indie, Racing, Sports;0 - 20,000;62;34;28;0;0;3
817470;ToaZZle;Action, Adventure, Indie, RPG;0 - 20,000;17;11;6;0;0;0
817490;Viki Spotter: Around The World;Adventure, Indie;0 - 20,000;63;5;58;0;0;0
817510;Golfing Over It with Alva Majo;Casual, Indie;100,000 - 200,000;1024;371;653;78;78;2
817520;烹饪吧！地狱土豆？！;Indie, Simulation;0 - 20,000;0;0;0;0;0;0
817530;Mercury Race;Early Access;0 - 20,000;14;2;12;0;0;0
817540;SpellForce 3: Soul Harvest;Action, Casual, Indie, Simulation, Sports, Early Access;100,000 - 200,000;1720;302;1418;531;672;5
817610;Hidden Space;Racing, Sports;0 - 20,000;3;2;1;0;0;1
817620;Gingerbread Story;Racing, Sports;0 - 20,000;1;6;-5;0;0;0
817620;Gingerbread Story;Adventure, Racing;0 - 20,000;1;6;-5;0;0;0
817630;Island Tribe 3;Indie;0 - 20,000;14;5;9;0;0;0
817640;Adelantado 4 Aztec Skulls;Action, Casual, Indie;0 - 20,000;7;4;3;0;0;2
817660;Soul Smith of the Kingdom;Casual, Indie, Strategy;20,000 - 50,000;90;57;33;0;0;1
817680;Real Drift;Violent, Action, Casual, Indie, Early Access;0 - 20,000;49;54;-5;262;262;0
817710;vridniX;Adventure, Casual, Indie;0 - 20,000;36;0;36;0;0;0
817720;Cricket Captain 2018;Sexual Content, Nudity, Violent, Gore, Adventure, Indie;0 - 20,000;43;28;15;0;0;9
817760;The Castle Disaster;Racing, Sports;0 - 20,000;84;29;55;1;1;0
817770;30 Seconds To Jail;Action, Casual, RPG, Sports;20,000 - 50,000;58;26;32;56;56;0
817820;"The ""Quiet, Please!"" Collection";Casual, Indie, RPG, Strategy;0 - 20,000;5;0;5;0;0;0
817840;Max Gentlemen Sexy Business!;Action, Indie, RPG;50,000 - 100,000;1310;97;1213;931;1330;60
817920;NO LOVE;Indie, RPG;100,000 - 200,000;3;1;2;0;0;0
817950;Naturallandscape - Three Gorges (自然景观系列-长江三峡);Casual, Indie;0 - 20,000;3;3;0;0;0;0
817980;Murderwave: Digital Slaughter;Indie, Simulation, Early Access;0 - 20,000;8;1;7;0;0;0
818010;IAIDO;Adventure, Indie;0 - 20,000;5;2;3;0;0;0
818030;Alicia Quatermain 3: The Mystery of the Flaming Gold;Education, Software Training, Utilities;0 - 20,000;33;8;25;0;0;0
818050;Wormster Dash;Casual, Indie, Simulation;0 - 20,000;46;1;45;0;0;0
818060;Super Saurio Fly: Jurassic Edition;Action, Casual, Indie;0 - 20,000;30;4;26;0;0;0
818070;Draoi;Casual, Simulation, Sports;0 - 20,000;0;1;-1;0;0;1
818140;Stay Safe;Action, Adventure, Casual, Indie, RPG, Simulation, Strategy;0 - 20,000;26;1;25;0;0;0
818150;Retro Hacker;Utilities, Video Production;0 - 20,000;21;3;18;0;0;0
818210;Indie Pogo;Action, Casual, Indie;0 - 20,000;290;47;243;9;9;1
818220;Fatal Stormer;Adventure, Casual;0 - 20,000;18;11;7;0;0;0
818320;LEGO The Incredibles;Education, Utilities;50,000 - 100,000;1099;128;971;1250;1235;50
818350;TENKYU;Indie;0 - 20,000;1;1;0;0;0;0
818360;Wildbus;Action, Adventure, Indie;0 - 20,000;47;7;40;0;0;0
818380;Seasonal Soccer;Action, Adventure, Casual, Indie;0 - 20,000;2;6;-4;0;0;0
818390;The Deer;Casual, Indie;0 - 20,000;36;12;24;0;0;0
818400;STARWAY VR;Action, Adventure, RPG;0 - 20,000;5;3;2;0;0;0
818410;Space Hole 2018;Casual, Indie, Strategy;0 - 20,000;38;5;33;0;0;0
818410;Space Hole 2018;Adventure;0 - 20,000;38;5;33;0;0;0
818430;BurningBridges VR;Action, Indie;0 - 20,000;1;2;-1;0;0;0
818440;Forgotten Places: Lost Circus;Simulation, Early Access;20,000 - 50,000;30;36;-6;0;0;0
818480;Eternal Man: Mountain;Action, Adventure, Massively Multiplayer, RPG, Early Access;0 - 20,000;21;13;8;0;0;1
818500;Colorzzle;Action, Adventure, Casual, Indie;0 - 20,000;112;3;109;0;0;0
818530;8 Ball;Sexual Content, Casual, Indie;0 - 20,000;80;27;53;165;165;1
818570;Zombie Desperation;Violent, Gore, Action, Indie;0 - 20,000;64;24;40;0;0;1
818570;Zombie Desperation;Casual, Indie;0 - 20,000;64;24;40;0;0;1
818590;Nano Nebula;Action, Adventure, Indie;0 - 20,000;2;3;-1;0;0;0
818610;The Great Gaias;Action, Adventure, Casual, Free to Play, Indie, Racing, RPG, Simulation, Sports;0 - 20,000;64;12;52;0;0;0
818620;Music Boy 3D;Action, Free to Play, Indie;0 - 20,000;11;3;8;0;0;0
818620;Music Boy 3D;Action, Adventure, Casual, Indie;0 - 20,000;11;3;8;0;0;0
818640;Alien Invasion 3d;Casual, Indie, Simulation;0 - 20,000;0;1;-1;0;0;0
818650;Evil Cogs;Casual, Indie;0 - 20,000;14;9;5;0;0;0
818670;Save Snegurochka!;Nudity, Casual, Indie;0 - 20,000;5;0;5;0;0;0
818720;Gummy Goo Clean Up;Action, Adventure, Casual, Indie;0 - 20,000;0;1;-1;0;0;0
818730;Tower climber;Action, Indie, Massively Multiplayer, Strategy;0 - 20,000;99;30;69;0;0;0
818760;Woodways;Casual, Simulation;20,000 - 50,000;85;2;83;0;0;0
818780;Scrunk;Adventure, Casual, Indie, RPG;0 - 20,000;12;5;7;0;0;0
818790;Stunt Hill;Action, Casual, Indie;0 - 20,000;18;39;-21;2;2;0
818800;Merrily Perilly;Casual, Indie;0 - 20,000;23;3;20;0;0;0
818830;Asteroid Deflector XL;Simulation;0 - 20,000;4;0;4;0;0;0
818860;Beyond the Sky;Adventure, Casual;0 - 20,000;21;3;18;0;0;1
818890;Box Maze Extreme;RPG, Strategy;0 - 20,000;3;3;0;0;0;0
818890;Box Maze Extreme;Violent, Gore, Action;0 - 20,000;3;3;0;0;0;0
818940;Oakwood Academy of Spells and Sorcery;Action, Casual, Indie;0 - 20,000;36;5;31;0;0;0
818950;Space Slingshot VR;Adventure, Indie;0 - 20,000;14;3;11;0;0;0
818960;TAYAL;Casual;0 - 20,000;68;6;62;0;0;0
818990;Hotel Spring;Action, Free to Play, Massively Multiplayer;0 - 20,000;2;1;1;0;0;0
819020;Zanki Zero: Last Beginning;Indie, Simulation, Strategy, Early Access;20,000 - 50,000;444;121;323;0;0;4
819030;STEINS;Action, Casual;;;;0;;;
819040;Ashi: Lake of Light;Action, Indie;0 - 20,000;40;2;38;0;0;0
819060;Red Rover;Adventure, Indie, Simulation;0 - 20,000;15;4;11;0;0;0
819070;The Unknown City (Horror Begins Now.....Episode 1);Indie;0 - 20,000;3;6;-3;0;0;0
819080;Moto Racing 3D;Violent, Gore, Action, Indie, RPG;20,000 - 50,000;1;6;-5;0;0;0
819160;Aliens Are Rude!;Action, Adventure, Casual, Indie;0 - 20,000;10;0;10;0;0;0
819210;The President;Action, Casual, Indie;0 - 20,000;4;9;-5;0;0;0
819220;Yuso;Adventure, Indie, RPG;0 - 20,000;5;1;4;0;0;0
819230;Gothicc Breaker;Action, Casual, Indie, Simulation;0 - 20,000;158;16;142;112;112;0
819280;ZAMB! Endless Extermination;Casual, Indie, Simulation;0 - 20,000;18;3;15;0;0;0
819330;Quaddro 2;Casual, Indie, Simulation;0 - 20,000;16;1;15;0;0;0
819370;Battle of cubes;Casual, Indie, Sports, Early Access;0 - 20,000;0;1;-1;0;0;0
819400;When Wardens Fall;Action, Indie;0 - 20,000;9;11;-2;0;0;0
819470;Trainpunk Run;Sexual Content, Nudity, Adventure, Free to Play, Indie, RPG;0 - 20,000;4;3;1;0;0;0
819480;Pizza Titan Ultra;Indie;20,000 - 50,000;69;9;60;0;0;0
819500;Fear The Wolves;Adventure, Indie;100,000 - 200,000;1592;1805;-213;202;224;1
819510;GLBasic SDK;Action, Indie, Strategy;0 - 20,000;18;1;17;0;0;1
819520;Star Souls;Casual, Simulation, Strategy;0 - 20,000;30;8;22;0;0;0
819550;Cheese Maze;Indie, RPG;0 - 20,000;2;0;2;0;0;0
819560;TurbOT Racing;Adventure, Casual, Indie;0 - 20,000;6;3;3;0;0;0
819630;Basketball Classics;Adventure, Casual, Indie, Strategy;0 - 20,000;136;8;128;0;0;2
819640;Crypto Quest;Adventure, Casual, Indie, Strategy;20,000 - 50,000;1;1;0;0;0;0
819640;Crypto Quest;Casual, Indie;20,000 - 50,000;1;1;0;0;0;0
819650;Bitcoin;Casual, Indie, Simulation, Education;0 - 20,000;53;89;-36;0;0;1
819660;INFINITY CHALLENGE;Casual, Simulation;0 - 20,000;0;1;-1;0;0;0
819670;Wall Walker;Adventure, RPG, Strategy;0 - 20,000;3;0;3;0;0;0
819730;Rounders (Arena);Adventure;0 - 20,000;0;1;-1;0;0;0
819740;Deadly Delivery;Casual, Indie;0 - 20,000;24;11;13;0;0;0
819780;The Singularity Wish;Action, Casual, Indie, Early Access;0 - 20,000;15;1;14;0;0;0
819790;Laplace：拉普拉斯的神子;Adventure;0 - 20,000;65;40;25;0;0;10
819800;Untouchable;Adventure;0 - 20,000;10;3;7;0;0;0
819870;7 Days in Dream 光尘;Adventure, Free to Play, Simulation;0 - 20,000;32;2;30;0;0;0
819880;SShield Reborn;Action;0 - 20,000;1;0;1;0;0;0
819940;Rum Ram;Adventure;0 - 20,000;8;0;8;0;0;0
819950;Archer's story;Adventure;50,000 - 100,000;2;2;0;0;0;0
819960;Resynth;Adventure;0 - 20,000;16;2;14;0;0;0
819980;Brief Battles;Action, Casual, Indie;0 - 20,000;16;2;14;0;0;0
819990;Peccator;Action, Adventure, Indie;0 - 20,000;8;4;4;0;0;0
820030;Picross Fairytale - nonogram: Red Riding Hood secret;Adventure, Indie, RPG;100,000 - 200,000;318;98;220;297;330;8
820040;Picross Fairytale: Legend of the Mermaid;Adventure, Casual, Indie, Simulation;20,000 - 50,000;41;25;16;96;184;1
820070;Cube Universe;Casual, Indie, Simulation;0 - 20,000;8;4;4;0;0;0
820090;Solitaire Knights;Action, Adventure, Indie, Simulation;20,000 - 50,000;35;19;16;1;1;1
820170;CRAZY MAZE;Indie;0 - 20,000;13;0;13;0;0;0
820190;FORWARD;Action, Adventure, Indie;20,000 - 50,000;26;4;22;0;0;0
820210;Ashi Wash;Casual, Indie;0 - 20,000;27;1;26;0;0;0
820240;Save One More;Action, Casual, Free to Play, Indie;20,000 - 50,000;104;60;44;0;0;0
820250;Trial of the Gods;Adventure, Indie, RPG;0 - 20,000;7;5;2;0;0;0
820300;Crypto Girl The Visual Novel;Utilities;0 - 20,000;7;23;-16;0;0;0
820310;Truth Of Falchion;Indie, Simulation;0 - 20,000;5;7;-2;0;0;0
820310;Truth Of Falchion;Indie, RPG, Simulation, Early Access;0 - 20,000;5;7;-2;0;0;0
820320;Word Typing Game;Indie;0 - 20,000;25;19;6;0;0;0
820380;Russian Prisoner VS Nazi Zombies;Action, Adventure, Racing, Simulation, Early Access;0 - 20,000;42;38;4;0;0;0
820400;Shrouded in Sanity: Freebirth;Casual, Indie, Strategy;20,000 - 50,000;137;26;111;167;167;0
820460;Hero Academy 2;Action, Indie, Early Access;0 - 20,000;81;29;52;103;103;0
820480;Warriors Of Titus;Audio Production, Design & Illustration, Education, Utilities, Web Publishing, Game Development, Early Access;0 - 20,000;14;0;14;0;0;0
820500;Tisnart Shapes;Nudity, Violent, Gore, Action, Adventure, Indie, RPG, Simulation;0 - 20,000;5;2;3;0;0;0
820510;Camp W;Action, Adventure, Casual, Indie;0 - 20,000;24;2;22;0;0;0
820530;Stardust VR;Violent, Action;0 - 20,000;3;3;0;0;0;0
820540;Bloodroots;Violent, Action;20,000 - 50,000;163;18;145;29;29;1
820580;Ashley: The Story Of Survival;Sexual Content, Adventure, RPG, Strategy;0 - 20,000;16;21;-5;0;0;0
820600;ReThink | Evolved 2;Action, Casual, Early Access;0 - 20,000;40;0;40;0;0;1
820610;Ages of Mages: The last keeper;Indie, Strategy;20,000 - 50,000;142;38;104;324;324;1
820620;Spooky Ghosts Dot Com;Casual, Indie, Simulation, Strategy;0 - 20,000;37;6;31;0;0;0
820630;Metal Wolf Chaos XD;Adventure, Casual;100,000 - 200,000;505;95;410;186;340;2
820640;Aqua Lungers;Adventure, Casual;0 - 20,000;17;1;16;0;0;0
820660;Future City Coaster;Audio Production, Utilities;0 - 20,000;0;3;-3;0;0;0
820680;HIGHER GROUND;Action, Adventure, Casual, Indie;0 - 20,000;2;1;1;0;0;0
820690;ZYTERNION;Casual, Indie, Simulation;0 - 20,000;4;1;3;0;0;0
820700;Free road;Casual, Indie;20,000 - 50,000;14;4;10;0;0;0
820700;Free road;Adventure, Indie, Simulation, Strategy;20,000 - 50,000;14;4;10;0;0;0
820710;Mogic;Action, Casual, Indie, Strategy;0 - 20,000;9;17;-8;0;0;0
820730;Adventure of a Lifetime;Indie, Strategy;0 - 20,000;717;25;692;9;9;3
820730;Adventure of a Lifetime;Action, Adventure, Indie;0 - 20,000;717;25;692;9;9;3
820750;Cryptocurrency Clicker;Adventure, Indie, RPG;20,000 - 50,000;42;61;-19;20;20;0
820760;Tactics & Strategy Master:Joan of Arc;Casual, Indie;20,000 - 50,000;30;19;11;0;0;0
820780;Dungeon Jump - 地牢跳跃;Action, Adventure, Indie, Early Access;0 - 20,000;1;0;1;0;0;0
820830;The famous diver;Casual, Indie, Early Access;0 - 20,000;12;2;10;0;0;0
820840;PRE:ONE;Adventure, Casual, Indie;0 - 20,000;20;9;11;0;0;0
820880;Helping Hand;Strategy;0 - 20,000;21;16;5;0;0;0
820900;Ceress and Orea;Action, Casual, Free to Play, Indie, Massively Multiplayer;0 - 20,000;106;12;94;0;0;0
820910;Last Resort Island;Adventure, Casual, Indie, Simulation;20,000 - 50,000;144;19;125;2868;2868;0
820950;Boltzmann Brain;Indie;0 - 20,000;23;1;22;0;0;0
821060;Desktop Mascot Engine;Action;50,000 - 100,000;113;79;34;0;0;0
821100;The Protocons;Action, Adventure, Massively Multiplayer, RPG;0 - 20,000;6;2;4;0;0;0
821120;Poopy Philosophy;Casual, Indie;0 - 20,000;36;8;28;0;0;0
821180;Reliefs The Time of the Lemures;Adventure, Casual, Indie, RPG, Strategy, Early Access;0 - 20,000;6;7;-1;0;0;0
821190;Minitime;Action, Adventure, Casual, Free to Play, Indie;0 - 20,000;5;2;3;0;0;0
821230;Drink 'Em;Action;0 - 20,000;28;9;19;0;0;0
821250;Flotsam;Adventure, Casual, Indie;100,000 - 200,000;1788;566;1222;2569;2569;60
821260;LIGHT;Racing, Simulation;0 - 20,000;5;4;1;0;0;0
821290;RUNE II: Decapitation Edition;Adventure, Racing, Simulation;100,000 - 200,000;233;195;38;1340;1340;0
821320;SPAGHET;Action, Adventure, Indie, Racing, Simulation;0 - 20,000;151;12;139;54;106;0
821330;Mob War Nazi Golds;Casual, Indie;0 - 20,000;9;8;1;0;0;0
821350;R.B.I. Baseball 20;Free to Play, Indie, Massively Multiplayer, RPG, Strategy;0 - 20,000;198;125;73;0;0;3
821360;Wallrunners;Indie;0 - 20,000;5;2;3;0;0;0
821370;MLB Home Run Derby VR;Casual, Indie, Simulation;0 - 20,000;20;7;13;0;0;1
821370;MLB Home Run Derby VR;Adventure, Casual, Indie, Strategy, Early Access;0 - 20,000;20;7;13;0;0;1
821390;Achievement Lurker: Another one bites the dust;Indie, RPG;0 - 20,000;72;19;53;0;0;2
821400;Packed Train;Adventure, Casual;0 - 20,000;11;1;10;0;0;0
821410;Yafti;Adventure, Casual;20,000 - 50,000;29;17;12;0;0;0
821440;GunnRunner;Adventure, Casual;0 - 20,000;6;0;6;0;0;0
821480;Space Flowers;Adventure, Casual;0 - 20,000;1;2;-1;0;0;0
821490;BattleCourt;Action, Adventure, Indie, Early Access;0 - 20,000;6;0;6;0;0;0
821500;Ria's Hook;Action, Early Access;50,000 - 100,000;359;95;264;0;0;0
821520;Trivia Vault: Boxing Trivia;Action, Indie;0 - 20,000;39;33;6;1;1;0
821550;The Dreamlands: Aisling's Quest;Adventure, Free to Play, Massively Multiplayer, RPG, Simulation, Early Access;0 - 20,000;11;11;0;0;0;0
821560;螢幕判官 Behind the Screen;Adventure, Indie;0 - 20,000;205;34;171;0;0;1
821570;Lethal Lawns: Competitive Mowing Bloodsport;Adventure, Indie;0 - 20,000;14;0;14;0;0;0
821610;My Sunny Resort;Indie, Strategy;50,000 - 100,000;107;99;8;37;73;3
821640;Floor Kids;Indie;0 - 20,000;144;21;123;161;161;0
821670;Horse Farm;Adventure, Indie;50,000 - 100,000;131;98;33;19;19;10
821680;Military Operations: Benchmark;Adventure, Indie;50,000 - 100,000;29;29;0;0;0;0
821720;20.000 Leagues Under The Sea - Captain Nemo;Adventure, Indie, Massively Multiplayer, RPG, Early Access;20,000 - 50,000;24;14;10;0;0;0
821760;MAGIX Photostory Premium VR Steam Edition;Action, Sports;0 - 20,000;1;0;1;0;0;0
821770;SOUND FORGE Pro 12 Steam Edition;Action, Casual, Indie;0 - 20,000;1;0;1;0;0;0
821780;Last Anime Boy 2: Hentai Zombie Hell;Adventure, Casual, Indie, Simulation;0 - 20,000;37;22;15;0;0;0
821790;Who Am I: The Tale of Dorothy;Simulation;0 - 20,000;349;28;321;0;0;0
821800;ADR-Labelling Game;Adventure, Indie;0 - 20,000;11;4;7;0;0;0
821820;Farmer's Fairy Tale;Indie;0 - 20,000;18;14;4;0;0;1
821850;Old Factory;Free to Play, Indie;0 - 20,000;4;21;-17;0;0;0
821850;Old Factory;Adventure, RPG, Strategy;0 - 20,000;4;21;-17;0;0;0
821860;Secret Laboratory;Adventure, Indie, Simulation;0 - 20,000;4;11;-7;0;0;0
821880;Idol Manager;Adventure, Indie, Simulation;100,000 - 200,000;2782;358;2424;1456;1229;71
821890;Steven Universe: Save the Light;Indie, Sports;20,000 - 50,000;982;89;893;0;0;20
821910;Tower Defense Sudden Attack;Indie, Simulation;0 - 20,000;2;21;-19;0;0;0
821920;OAOA - Off And On Again;Casual;0 - 20,000;11;0;11;0;0;0
822040;Super Volley Blast;Indie, Early Access;0 - 20,000;86;7;79;0;0;2
822070;SAS VS Zombies;Indie, RPG, Strategy;0 - 20,000;9;15;-6;0;0;0
822110;Magika Land of Fantasy;Action, Adventure, Indie;20,000 - 50,000;85;18;67;0;0;0
822140;Glaive: Brick Breaker;Action, Adventure, Indie;0 - 20,000;18;5;13;0;0;0
822150;WAY HOME;Adventure;0 - 20,000;20;9;11;0;0;0
822190;Little Bug;Casual, Indie, Strategy;0 - 20,000;48;1;47;0;0;0
822190;Little Bug;Violent, Gore, Action, Indie, RPG, Strategy, Early Access;0 - 20,000;48;1;47;0;0;0
822240;Animal Jam;Action, Adventure, Indie, RPG, Strategy;200,000 - 500,000;1915;1313;602;0;0;138
822250;GL1TCH;Action, Casual;0 - 20,000;0;1;-1;0;0;0
822440;You Are The Apple Of My Eye 研磨时光;Casual, Indie;0 - 20,000;24;11;13;0;0;0
822450;EXE: Mainframe;Sexual Content, Free to Play, Indie;0 - 20,000;6;0;6;0;0;0
822460;Trivia Vault: Auto Racing Trivia;Casual, Indie;0 - 20,000;37;32;5;1;1;0
822470;属性与生活;Audio Production, Utilities;0 - 20,000;21;14;7;0;0;0
822510;Struggle For Survival VR : Battle Royale;Casual, Indie;0 - 20,000;12;9;3;0;0;0
822530;Pukan Bye Bye;Casual, Indie;20,000 - 50,000;105;37;68;2;2;1
822540;Escape From Tethys;Adventure, Casual, Indie, Simulation, Early Access;20,000 - 50,000;284;119;165;0;0;1
822550;2DGameManias Taken;Adventure, Casual, Indie;20,000 - 50,000;6;22;-16;0;0;0
822610;Patternis;Action;0 - 20,000;2;1;1;0;0;0
822640;Squids Odyssey;Casual, Indie;0 - 20,000;26;3;23;0;0;0
822650;Typical Nightmare;Action, Casual, Free to Play, Indie;20,000 - 50,000;39;67;-28;0;0;0
822660;Abacus;Action, Adventure, Casual, Indie, Sports, Strategy;0 - 20,000;10;0;10;0;0;0
822680;Eternal Man: Jump;Action, Adventure, Indie, RPG, Simulation, Sports;0 - 20,000;16;9;7;0;0;0
822680;Eternal Man: Jump;Casual, Indie, Simulation, Sports;0 - 20,000;16;9;7;0;0;0
822700;Beer and Skittls VR;Casual, Indie, Racing, Simulation;0 - 20,000;20;4;16;0;0;0
822710;Clash: Mutants Vs Pirates;Adventure, Indie, RPG;100,000 - 200,000;68;35;33;0;0;0
822720;The Amazing Bernard;Action, Indie, Early Access;0 - 20,000;8;4;4;0;0;0
822740;FlappyU VR;Adventure, Indie, RPG, Simulation;0 - 20,000;1;0;1;0;0;0
822750;Try to seize me;Action, Indie;0 - 20,000;4;1;3;0;0;0
822760;Fureraba ~Friend to Lover~;Action, Casual, Simulation;20,000 - 50,000;289;6;283;1598;1598;1
822770;The Secrets of The Forest;Violent, Action, Indie, Simulation;0 - 20,000;12;16;-4;0;0;0
822800;Soulfire;Indie, RPG, Strategy;20,000 - 50,000;613;235;378;46;22;0
822810;Velvet Guard;Casual, Indie;0 - 20,000;10;1;9;0;0;0
822840;METAL;Action, Adventure, Free to Play, Indie, Massively Multiplayer, Strategy, Early Access;0 - 20,000;0;1;-1;0;0;0
822870;Diary of Defender;Action, Adventure, Massively Multiplayer, RPG, Early Access;0 - 20,000;7;9;-2;0;0;0
822900;Trivia Vault: Golf Trivia;Utilities, Video Production, Early Access;0 - 20,000;36;29;7;1;1;0
822910;Mortal Squad: Portal to Hell;Adventure, Casual, Indie, RPG, Simulation, Strategy;20,000 - 50,000;3;1;2;0;0;0
822920;Ellen;Adventure, Casual, Indie;0 - 20,000;20;4;16;0;0;0
822930;Wolf Tails;Action;20,000 - 50,000;803;35;768;151;151;1
822940;Tori;Casual;0 - 20,000;28;1;27;0;0;0
822940;Tori;Casual;0 - 20,000;28;1;27;0;0;0
822970;BLOCK CAT SPACE GOLF;Action, Simulation;0 - 20,000;1;0;1;0;0;0
822990;Spinnortality | cyberpunk management sim;Adventure, Casual, Indie, RPG;50,000 - 100,000;218;56;162;0;0;2
823080;liquivid Easy Cinemagraph;Action, Indie, Racing, Sports;0 - 20,000;1;1;0;0;0;0
823100;Peace Duke;Action, Indie;0 - 20,000;51;47;4;4;4;0
823130;Totally Accurate Battlegrounds;Casual, Indie, Racing;1,000,000 - 2,000,000;67701;9141;58560;254;67;711
823160;Knife Hit Dash;Action, Adventure, Casual, Free to Play, Indie;0 - 20,000;30;46;-16;9;9;0
823180;Bubble Strike;Action, Indie, Early Access;20,000 - 50,000;31;29;2;0;0;0
823230;Demolition Pro Online;Sexual Content, Action, Adventure, Indie, Racing, Simulation, Sports;0 - 20,000;27;14;13;0;0;6
823280;STE : Save The Earth;Casual, Indie;0 - 20,000;11;15;-4;0;0;0
823290;Pokka Man;Action, Casual, Indie, Simulation, Sports, Early Access;0 - 20,000;5;3;2;0;0;0
823310;Alchemy Classic;Action, Indie;0 - 20,000;11;7;4;0;0;0
823330;Marginal act;Indie, RPG, Strategy;20,000 - 50,000;4;5;-1;0;0;0
823340;Round Mars;Action, Casual, Free to Play, Indie;0 - 20,000;13;4;9;0;0;0
823360;Sloppy Goat;Indie, Racing;20,000 - 50,000;71;24;47;3;3;0
823370;Lucky VS Aliens;Casual, Indie;0 - 20,000;12;6;6;0;0;0
823420;Erinye Demo;Action, Casual, Simulation;0 - 20,000;75;9;66;0;0;0
823470;Glitchball;RPG;0 - 20,000;18;11;7;1;1;0
823470;Glitchball;Casual, Indie, Simulation, Strategy;0 - 20,000;18;11;7;1;1;0
823500;BONEWORKS;Action, Adventure, Early Access;1,000,000 - 2,000,000;30338;2610;27728;527;292;154
823510;Precision Sniping: Competitive;Action, Adventure, Casual, Indie, Massively Multiplayer, RPG, Strategy, Early Access;0 - 20,000;3;4;-1;0;0;0
823550;Booty Calls;Casual, Indie, Racing, Strategy, Early Access;100,000 - 200,000;255;294;-39;128;185;123
823580;Isoland 2 - Ashes of Time;;0 - 20,000;252;9;243;0;0;2
823600;Battle Brawlers;Action, Adventure, Indie;50,000 - 100,000;112;82;30;0;0;5
823610;Dungeon Of Dragon Knight;Action, Adventure, Indie, RPG, Early Access;50,000 - 100,000;232;63;169;0;0;0
823640;Gnomes Garden Lost King;Action, Casual, Indie;0 - 20,000;42;35;7;0;0;2
823650;Zombow;Action, Indie;0 - 20,000;15;39;-24;0;0;0
823670;HYKEE - Episode 1: Underwater;Adventure, Casual;0 - 20,000;0;2;-2;0;0;0
823690;VR TOON Help Me (살려주세요);Casual, Indie;0 - 20,000;7;0;7;0;0;0
823700;AUTOCROSS MADNESS;Action, Casual, Indie, Racing;20,000 - 50,000;36;33;3;0;0;0
823710;Who's in the Box?;Adventure, Indie, Simulation;0 - 20,000;23;30;-7;0;0;0
823730;Oscillatron: Alien Frequency;Action, Adventure, Casual, Indie, Early Access;0 - 20,000;7;7;0;0;0;0
823730;Oscillatron: Alien Frequency;Casual, Indie;0 - 20,000;7;7;0;0;0;0
823740;Freedom March: Rebel Leader;Action, Adventure, Casual, Indie, RPG, Simulation;0 - 20,000;3;8;-5;0;0;0
823770;Labyrinths of Atlantis;Casual, Strategy, Early Access;0 - 20,000;10;45;-35;0;0;0
823800;Kitty Play;Adventure, Indie;0 - 20,000;25;8;17;0;0;0
823830;Frightened Beetles;Sexual Content, Free to Play, Indie, Simulation;20,000 - 50,000;357;36;321;9;9;0
823840;Macrotis: A Mother's Journey;Action, Indie, Strategy;20,000 - 50,000;165;12;153;218;218;0
823900;Float;Indie;0 - 20,000;9;0;9;0;0;0
823920;Kawaii Rainbow Portal;Adventure, Casual, Indie, RPG, Strategy;20,000 - 50,000;29;14;15;0;0;0
823950;Re:Legend;Simulation, Sports;50,000 - 100,000;1093;750;343;1542;1839;22
824000;Hokko Life;Action, Indie;100,000 - 200,000;1262;505;757;172;303;76
824170;Relic Raiders;Action, Adventure, Indie;20,000 - 50,000;58;28;30;0;0;1
824190;Achievement Clicker 2019;Indie, Strategy;20,000 - 50,000;505;129;376;26;38;0
824200;The Bell Chimes for Gold;Adventure, Casual;0 - 20,000;9;2;7;0;0;0
824220;Reflecting Reflections;Casual, Free to Play, Indie, Sports, Early Access;0 - 20,000;0;2;-2;0;0;0
824250;BitBreaker;Casual, Indie, Strategy;0 - 20,000;4;1;3;0;0;0
824260;Show Me What You Got;Indie;0 - 20,000;0;0;0;0;0;0
824270;KovaaK's;Action, Adventure, Indie, Early Access;500,000 - 1,000,000;25473;2055;23418;2112;400;2152
824280;Monster Jam Steel Titans;Action, Adventure, Indie, RPG, Strategy;20,000 - 50,000;220;106;114;5;5;3
824300;Dragon Awaken;Adventure, Indie;20,000 - 50,000;24;28;-4;0;0;0
824400;Havoc in heaven;RPG;0 - 20,000;1;2;-1;0;0;0
824420;Ouch！War！/ 破音乱斗;Adventure, Casual, Indie;20,000 - 50,000;24;9;15;0;0;0
824440;雪色废都 Abandoned Snowy Castle;Violent, Action, Indie, Simulation;0 - 20,000;3;1;2;0;0;0
824450;Blockchain Tycoon;Adventure, Casual, Indie;0 - 20,000;24;26;-2;0;0;0
824460;HELLFRONT: HONEYMOON;Casual, Indie;0 - 20,000;63;9;54;0;0;0
824470;My Maid Girlfriend;Casual, Strategy;0 - 20,000;27;5;22;0;0;0
824470;My Maid Girlfriend;Violent, Action, Indie;0 - 20,000;27;5;22;0;0;0
824520;Nobody Knows;Action, Indie;20,000 - 50,000;3;2;1;0;0;0
824550;SD GUNDAM BATTLE ALLIANCE;Action, Simulation, Early Access;200,000 - 500,000;3183;1860;1323;2888;3903;96
824570;Kine;Casual, Indie;0 - 20,000;82;6;76;0;0;0
824580;The Last Tower;Simulation;0 - 20,000;25;33;-8;0;0;0
824600;HROT;Casual, Indie;100,000 - 200,000;2597;66;2531;126;145;8
824620;Jolly Battle;Adventure, Casual, RPG;20,000 - 50,000;83;13;70;0;0;0
824640;The Witch's Apprentice: A Magical Mishap;Action, Adventure, Indie;0 - 20,000;2;0;2;0;0;1
824720;Pure Rock Crawling;Adventure, Casual;50,000 - 100,000;813;147;666;45;51;5
824760;Deathtrap Dungeon Trilogy;Adventure, Indie, Simulation;0 - 20,000;59;40;19;840;840;2
824770;Labirinto 2;Casual, Simulation, Early Access;0 - 20,000;21;11;10;0;0;0
824830;Corpse Party: Blood Drive;Casual, Free to Play, Indie, Simulation;0 - 20,000;215;41;174;153;153;0
824850;Some Distant Memory;Action, Indie;0 - 20,000;212;12;200;162;162;0
824900;Fallen Empires;Indie, RPG, Strategy;0 - 20,000;4;0;4;0;0;0
825000;Temptation;Action, Adventure, Casual, Indie, RPG, Simulation, Strategy;0 - 20,000;30;25;5;0;0;0
825060;Watch Over Christmas;Indie, Racing;0 - 20,000;39;1;38;0;0;0
825080;Dragonward;Casual, Indie, Simulation;0 - 20,000;4;1;3;0;0;0
825110;Space Drift Squad;Action, Adventure, Casual, Indie, Racing, Simulation, Sports;0 - 20,000;6;4;2;0;0;0
825170;Porcuball;Adventure, Free to Play, Indie;0 - 20,000;13;5;8;4;4;0
825170;Porcuball;Casual, Indie, Simulation;0 - 20,000;13;5;8;4;4;0
825190;MisBits;Gore, Action, Indie;20,000 - 50,000;414;80;334;94;176;0
825240;Elude;Adventure, Indie, RPG, Early Access;20,000 - 50,000;9;2;7;0;0;0
825300;To Trust an Incubus;Action, Adventure, Casual, Indie;0 - 20,000;43;5;38;0;0;1
825310;Dude Simulator 2;Action, Casual, Indie, Racing;200,000 - 500,000;1075;871;204;170;198;21
825320;CyberRebeat -The Fifth Domain of Warfare-;Violent, Action, Casual, Indie;0 - 20,000;15;2;13;0;0;0
825350;Downhill Deceits;Action, Adventure, Casual, Indie;0 - 20,000;3;1;2;0;0;0
825370;A Bloody Party;Action, Adventure, Casual, Indie;0 - 20,000;16;5;11;0;0;0
825380;强军;Gore, Action, Indie;200,000 - 500,000;88;412;-324;58;58;0
825450;Type;Action, Indie;20,000 - 50,000;1;3;-2;0;0;0
825480;ELDR  LEGACY;Casual, Indie;0 - 20,000;4;1;3;0;0;0
825490;Crazy Science: Long Run;Action, Indie;0 - 20,000;4;4;0;0;0;0
825500;Dead Ground:Arena;Indie, Simulation;0 - 20,000;16;6;10;0;0;0
825550;BlueberryNOVA;Adventure, Indie, RPG;0 - 20,000;72;34;38;0;0;0
825580;Grotoro;Action, Adventure, Casual, Indie, Early Access;0 - 20,000;18;7;11;0;0;0
825580;Grotoro;Indie;0 - 20,000;18;7;11;0;0;0
825610;Viking's drakkars;Action, Adventure, Indie;20,000 - 50,000;37;64;-27;0;0;0
825620;M.I.N.D.;Action, Casual, Indie;0 - 20,000;4;5;-1;0;0;0
825630;STEINS;Action, Adventure, Indie;;;;0;;;
825730;Tzar: The Burden of the Crown;Casual, Indie, Simulation, Strategy;50,000 - 100,000;340;32;308;67;67;9
825930;Royal Battleships;Free to Play;20,000 - 50,000;45;12;33;0;0;0
825970;The Mystery of Devils House;Action, Adventure, RPG, Strategy;0 - 20,000;9;10;-1;0;0;0
826000;Masked Forces 3;Casual, Indie, Simulation;0 - 20,000;26;19;7;0;0;0
826010;JQ: chemistry;Indie;0 - 20,000;91;29;62;16;16;0
826020;Zombie Teacher;Action, Adventure;0 - 20,000;1;0;1;0;0;0
826030;BrainPower;Adventure, Indie;0 - 20,000;5;14;-9;0;0;0
826040;Sacred Stones;Action, Casual, Indie;0 - 20,000;43;9;34;0;0;0
826050;Chime Sharp Game Composer Edition;Adventure, Indie, Simulation;0 - 20,000;2;1;1;0;0;0
826100;Find someone else;Action, Indie;0 - 20,000;107;10;97;0;0;0
826160;ButcherBoy;RPG;20,000 - 50,000;62;41;21;1;1;0
826170;Laser Ball;Adventure, Indie, Massively Multiplayer;0 - 20,000;10;3;7;0;0;0
826180;EONIA;Action, Indie, RPG;0 - 20,000;30;8;22;0;0;0
826230;CONCLUSE;Action, Indie;100,000 - 200,000;315;105;210;0;0;0
826370;Spirits of Mystery: The Silver Arrow Collector's Edition;Action, Adventure, Casual, Indie, Massively Multiplayer, Early Access;0 - 20,000;3;0;3;0;0;0
826380;Dark Canvas: A Murder Exposed Collector's Edition;Action, Adventure, Casual, Indie, RPG;0 - 20,000;1;0;1;0;0;0
826390;Haunted Manor: Painted Beauties Collector's Edition;Simulation;0 - 20,000;1;0;1;0;0;0
826420;Dark Romance: Heart of the Beast Collector's Edition;Action, Casual, Indie;0 - 20,000;15;2;13;0;0;0
826430;Twilight Phenomena: The Incredible Show Collector's Edition;Action, Casual, Indie;0 - 20,000;1;2;-1;0;0;0
826440;Sable Maze: Forbidden Garden Collector's Edition;Action, Indie, Simulation, Strategy, Early Access;0 - 20,000;1;0;1;0;0;0
826450;Paws 'n Claws VR;Indie, Simulation, Strategy;0 - 20,000;5;2;3;0;0;0
826460;The Road to Hades;Action, Casual, Indie, Massively Multiplayer, Strategy, Early Access;0 - 20,000;26;25;1;11;11;0
826470;Nummels;Adventure, Indie;0 - 20,000;14;0;14;0;0;3
826480;VR Benchmark Kanojo;Action, Indie, Strategy;100,000 - 200,000;192;59;133;9;13;2
826540;Audio Trip;Action, Casual, Indie;0 - 20,000;235;26;209;0;0;2
826550;Golf Cart Drive;Casual;0 - 20,000;2;0;2;0;0;0
826580;Mervin and the Wicked Station;Adventure, Casual, Indie, Early Access;20,000 - 50,000;0;1;-1;0;0;0
826600;I am not a Monster: First Contact;Action, Adventure, Indie, Early Access;100,000 - 200,000;917;247;670;4030;25;3
826630;Iron Harvest;Casual, Free to Play, Indie, RPG;500,000 - 1,000,000;8646;3335;5311;852;609;202
826660;Rosette and Words;Action, Indie;0 - 20,000;15;3;12;0;0;1
826740;Rise of the Slime;Action, Adventure, RPG, Early Access;0 - 20,000;71;33;38;0;0;0
826810;Floor By Floor;Action, Indie, Early Access;0 - 20,000;6;1;5;0;0;0
826930;The Capture Worlds;Action, Indie;0 - 20,000;9;1;8;0;0;0
826940;Maid of Sker;Violent, Gore, Adventure;50,000 - 100,000;1141;287;854;303;298;16
827000;Celtic Kings: Rage of War;Casual, Indie, Simulation;20,000 - 50,000;107;12;95;6;6;10
827050;Rising Kingdoms;Casual, Indie, Simulation, Strategy, Early Access;50,000 - 100,000;152;15;137;0;0;5
827100;Aladin & the Enchanted Lamp;Violent, Action, Casual;20,000 - 50,000;24;14;10;0;0;0
827120;Les Misérables: Cosette's Fate;Casual, Indie, Early Access;0 - 20,000;20;12;8;0;0;0
827130;Les Misérables: Jean Valjean;Action, Adventure, Indie, Simulation;0 - 20,000;16;6;10;0;0;0
827170;FlickSync - Mad Hatter VR;Casual;0 - 20,000;6;9;-3;1;1;0
827210;Death Carnival;Action, Casual, Indie;0 - 20,000;0;0;0;0;0;0
827220;Overclocked: The Aclockalypse;Violent, Gore, Action, Indie, RPG, Strategy;0 - 20,000;36;15;21;0;0;0
827270;Bounty Hunter: Space Detective;Casual, Indie, Strategy;0 - 20,000;8;9;-1;0;0;0
827280;School Fab Lab VR;Indie;0 - 20,000;2;1;1;0;0;0
827290;Secret Little Haven;Action, Indie;0 - 20,000;289;6;283;0;0;0
827330;Skydrift Infinity;Action, Indie, Early Access;0 - 20,000;64;14;50;0;0;0
827410;Luminous Combat;Violent, Action, Indie, RPG, Strategy;0 - 20,000;3;2;1;0;0;0
827420;Coin Pusher;Action, Racing, Simulation, Sports;20,000 - 50,000;43;30;13;0;0;0
827450;InkSplosion;Action, Indie, Racing, RPG, Simulation;0 - 20,000;11;7;4;0;0;0
827460;TETRA's Escape;Video Production, Early Access;0 - 20,000;25;2;23;0;0;0
827520;Risky Wings;Casual, Indie, Simulation;0 - 20,000;8;2;6;0;0;0
827520;Risky Wings;Simulation, Early Access;0 - 20,000;8;2;6;0;0;0
827530;Current;Adventure, Indie;0 - 20,000;3;3;0;0;0;0
827540;A Penny For Some Motivation;Action, Casual, Simulation;0 - 20,000;1;2;-1;0;0;0
827560;Arena of the Gods;Casual, Indie;0 - 20,000;5;4;1;0;0;0
827590;Nova Wing II;Action, Casual, Indie;20,000 - 50,000;5;1;4;0;0;0
827610;Dead End Job;Casual, Early Access;0 - 20,000;64;18;46;0;0;0
827610;Dead End Job;Indie, RPG, Simulation, Strategy, Early Access;0 - 20,000;64;18;46;0;0;0
827640;Trash Story;Action;20,000 - 50,000;268;101;167;9;9;0
827660;Feminist Cyborg Vs Last guy(gay);Action, Indie;0 - 20,000;0;0;0;0;0;0
827770;Pathosis;Indie, Simulation, Sports;0 - 20,000;1;1;0;0;0;0
827780;Margot's Word Brain;Action, Adventure, Simulation, Strategy;20,000 - 50,000;1;4;-3;0;0;0
827780;Margot's Word Brain;Casual, Indie, Strategy;20,000 - 50,000;1;4;-3;0;0;0
827830;Castle Agony;Action, Casual, Free to Play, Indie;0 - 20,000;13;3;10;0;0;0
827860;Destined;Violent, Gore, Action, Indie, RPG, Strategy;50,000 - 100,000;227;122;105;2;2;2
827880;The Endless Mission;Action, Indie, Early Access;0 - 20,000;11;5;6;0;0;0
827900;Bounty Hunter: Stampede;Free to Play, Indie, Strategy;0 - 20,000;10;8;2;0;0;0
827920;Bounce;Action, Indie, Strategy;20,000 - 50,000;52;33;19;20;20;0
827930;Strive;Simulation;0 - 20,000;3;3;0;0;0;0
827940;Marvellous Inc.;Sexual Content, Nudity, Casual, Indie;0 - 20,000;19;5;14;0;0;0
827950;Inzo;Violent, Indie, Early Access;0 - 20,000;4;0;4;0;0;0
828030;One Ping Only;Casual, Indie;20,000 - 50,000;214;20;194;0;0;0
828050;The Mirror Lied;Indie, Racing, Simulation, Sports;20,000 - 50,000;609;73;536;0;0;0
828070;Treasure Hunter Claire;Adventure, Casual, Indie;200,000 - 500,000;1802;203;1599;294;297;65
828080;Pong like;Action, Casual, Indie;0 - 20,000;0;7;-7;0;0;0
828090;TCPingInfoView;Adventure, Casual, Simulation;0 - 20,000;2;7;-5;0;0;0
828150;WIN THE GAME!;Action, Adventure, Casual, Indie, RPG, Early Access;0 - 20,000;191;84;107;32;58;1
828160;X-Town 3D game;Action, Free to Play, Early Access;0 - 20,000;5;17;-12;0;0;0
828170;Pivross;Utilities;20,000 - 50,000;52;29;23;1;1;0
828240;HOST;Simulation, Sports;0 - 20,000;23;2;21;0;0;0
828250;Stargazer program;Adventure, Casual, Indie;0 - 20,000;1;0;1;0;0;0
828250;Stargazer program;Adventure, Indie, RPG;0 - 20,000;1;0;1;0;0;0
828270;Jelly Bomber;Adventure, Indie, RPG;0 - 20,000;6;1;5;0;0;0
828320;Grid Clash VR;Action, Casual, Indie;0 - 20,000;14;4;10;0;0;0
828350;Tomb Towers;Action, Adventure;0 - 20,000;18;4;14;0;0;0
828380;Death Mark Vol.1 - 死印之迷雾;Action, Indie, Strategy, Early Access;0 - 20,000;34;10;24;0;0;0
828410;OniBushi VR;Casual, Indie, Simulation;0 - 20,000;2;10;-8;0;0;0
828420;Six Second Slam;Adventure, Free to Play;0 - 20,000;2;0;2;0;0;0
828480;MinigolfPark VR;Action, Casual, Indie;0 - 20,000;2;4;-2;0;0;0
828520;Metis One;Adventure, Indie, RPG, Strategy, Early Access;0 - 20,000;3;0;3;0;0;0
828540;Игра забытых Богов. Проснись / Game of the forgotten Gods. Wake up;Casual, Indie;0 - 20,000;4;5;-1;0;0;0
828580;NEKO-NIN exHeart 2;Casual;20,000 - 50,000;259;13;246;332;369;0
828590;Super Weekend Mode;Action, Adventure, Indie;0 - 20,000;17;2;15;0;0;0
828600;Mama Farm;Utilities, Early Access;0 - 20,000;4;0;4;0;0;0
828640;The Stranger VR;Simulation;20,000 - 50,000;48;17;31;0;0;0
828660;War Of The Zombie;Indie;0 - 20,000;46;17;29;0;0;1
828680;Berserker's Descent;Action, Adventure, Casual, Indie;0 - 20,000;39;0;39;0;0;0
828710;Laws of Machine;Casual, Indie, Simulation;0 - 20,000;3;0;3;0;0;0
828730;Dumb As Wizards;Casual, Indie;0 - 20,000;3;3;0;0;0;0
828740;Tales of the Neon Sea;Sexual Content, Nudity, Violent, Action, Casual, Indie;500,000 - 1,000,000;2435;371;2064;163;196;7
828770;Turbo Soccer VR;Action, Indie;0 - 20,000;3;2;1;0;0;0
828800;Artipic;Casual, Early Access;0 - 20,000;15;10;5;0;0;0
828860;The Stroke of Midnight;Audio Production, Utilities;0 - 20,000;3;0;3;0;0;0
828890;My Golf;Audio Production, Utilities;0 - 20,000;23;25;-2;0;0;0
828900;The Stillness of the Wind;Action, Indie, Early Access;50,000 - 100,000;845;299;546;42;70;1
828910;aMAZE Frozen;Casual, Indie, Strategy;0 - 20,000;62;43;19;0;0;0
828950;Howlville: The Dark Past;Adventure, Casual, Indie;0 - 20,000;43;15;28;294;294;0
828960;Blonde Driver;Action, Adventure, Indie, RPG, Early Access;20,000 - 50,000;136;105;31;25;45;0
828970;Hit The Hive;Casual, Indie;0 - 20,000;3;5;-2;0;0;0
829040;Light Borrower;Adventure, Indie, Simulation, Strategy;0 - 20,000;8;2;6;0;0;0
829080;Burst Into;Indie, Simulation, Strategy;0 - 20,000;30;25;5;0;0;0
829110;LEGO DC Super-Villains;Indie, Strategy, Early Access;200,000 - 500,000;4255;442;3813;2046;2045;353
829210;AIdol;Action, Adventure, Casual, Indie;0 - 20,000;35;14;21;0;0;1
829250;Craft and Dungeon;Indie, Simulation, Early Access;0 - 20,000;15;25;-10;89;177;0
829260;Morning Never Comes;Action, Adventure, Indie;0 - 20,000;29;4;25;0;0;0
829280;Kaze and the Wild Masks;Action, Adventure, Indie, Massively Multiplayer, Simulation, Early Access;0 - 20,000;837;31;806;498;498;39
829300;bomber-un;Action, Adventure, Indie, Racing, Strategy;0 - 20,000;14;6;8;0;0;0
829370;Nicky - The Home Alone Golf Ball;Indie, Strategy, Early Access;0 - 20,000;29;5;24;0;0;0
829390;Kitten Life Simulator;Action, Casual, Indie;0 - 20,000;18;15;3;0;0;0
829410;Project Myriad;Casual, Indie, Sports;0 - 20,000;6;3;3;0;0;0
829420;Fun Hospital;Action, Adventure, Indie;100,000 - 200,000;293;180;113;0;0;110
829490;Firebird - Steam version;Indie, Racing, Simulation, Sports;0 - 20,000;7;1;6;0;0;0
829540;Viki Spotter: Shopping;Indie, Simulation;0 - 20,000;52;4;48;0;0;0
829560;Katie;Indie;0 - 20,000;25;5;20;0;0;0
829590;CryoFall;Casual, Indie, Strategy;200,000 - 500,000;4202;1044;3158;589;691;125
829610;Alice In VR;Gore, Indie, Early Access;0 - 20,000;3;2;1;0;0;0
829630;Skat Stammtisch;Action, RPG;0 - 20,000;8;12;-4;0;0;0
829660;No Time to Relax;Casual, Indie;100,000 - 200,000;1147;88;1059;331;425;39
829720;The Nature;Action, Casual, Indie;0 - 20,000;9;4;5;0;0;0
829750;Robots Attack On Vapeland;Adventure, Indie;0 - 20,000;5;16;-11;0;0;0
829760;Synthrally;Action, Casual, Simulation, Strategy;0 - 20,000;3;1;2;0;0;0
829780;Baby's on fire: 99 virgins;Adventure, Indie;20,000 - 50,000;22;13;9;0;0;0
829940;Russian World;Violent, Gore, Action, Adventure, Casual, Indie;20,000 - 50,000;57;5;52;0;0;0
830360;Platform Challenge;Adventure, Free to Play, Indie, RPG, Strategy;0 - 20,000;11;2;9;0;0;0
830360;Platform Challenge;Indie, Simulation, Strategy;0 - 20,000;11;2;9;0;0;0
830370;Monster Crown;Casual, Indie;20,000 - 50,000;446;125;321;0;0;7
830390;Vadine: Bite-Man;Action, Adventure, Indie, RPG;0 - 20,000;5;1;4;0;0;0
830410;Nogalious;Action, Indie, Simulation;0 - 20,000;8;6;2;0;0;0
830430;Drowning;Action, Indie, Strategy;0 - 20,000;11;11;0;0;0;0
830470;MazeBot;Action, Indie, Simulation;0 - 20,000;24;4;20;0;0;0
830500;The Blobs Fight;Adventure, Indie, RPG, Strategy;0 - 20,000;3;0;3;0;0;0
830510;Bounty Hunter: Ocean Diver;Adventure, Indie, RPG;20,000 - 50,000;5;17;-12;0;0;0
830520;Finger Jets;Adventure, Casual, Indie;0 - 20,000;5;0;5;0;0;0
830540;Motocross: Chasing the Dream;Action, Indie, Simulation;0 - 20,000;81;5;76;0;0;2
830580;BattleBeasts;Sexual Content, Nudity, Action, Indie, RPG;50,000 - 100,000;10;43;-33;0;0;0
830590;Holy Potatoes! A Spy Story?!;;0 - 20,000;93;46;47;0;0;1
830620;Storm of Jigsaw Puzzles  拼图风暴;Adventure, Early Access;0 - 20,000;15;3;12;0;0;0
830630;Existential Kitty Cat RPG;Casual, Free to Play, Indie, Strategy;0 - 20,000;17;11;6;0;0;0
830710;The Eerie Inn;Action, Casual, Indie, Strategy;0 - 20,000;28;8;20;0;0;0
830750;Poker Simulator;Action, Casual, Indie;0 - 20,000;12;5;7;0;0;0
830810;Death Game;Action, Adventure, Casual, Indie;0 - 20,000;7;8;-1;0;0;0
830810;Death Game;Action, Adventure, Casual;0 - 20,000;7;8;-1;0;0;0
830820;Jets'n'Guns 2;Strategy;50,000 - 100,000;1018;90;928;796;796;4
830850;Dragon's Eye;Casual, Indie, Simulation, Strategy;0 - 20,000;9;4;5;0;0;0
830890;Infinite Vector;Adventure, Casual, Indie, RPG;0 - 20,000;3;3;0;0;0;0
830980;Doodle Date;Adventure, Casual;0 - 20,000;198;85;113;8;8;0
831040;London Museum Of Water & Steam;Adventure, Casual;0 - 20,000;10;2;8;0;0;0
831050;Dolmen;Adventure, Indie, RPG;0 - 20,000;155;103;52;0;0;2
831060;Black Jack Story;Action, Free to Play, Indie;0 - 20,000;47;18;29;0;0;0
831070;The Cabinets of Doctor Arcana;Casual, Indie, Simulation;0 - 20,000;40;5;35;0;0;0
831090;OS:Path;Action, Casual, Indie;0 - 20,000;34;2;32;0;0;0
831100;Brother Perro;Adventure, Indie, RPG;0 - 20,000;29;12;17;0;0;0
831110;Unconventional Warfare;Adventure, Indie, RPG;0 - 20,000;43;5;38;0;0;4
831120;Space Pilgrim Academy: Year 2;Adventure, Indie, RPG;20,000 - 50,000;40;2;38;0;0;0
831150;Conveyor VR;Indie, RPG;0 - 20,000;5;0;5;0;0;0
831180;Pixel Beef Battle;Strategy;0 - 20,000;6;0;6;0;0;0
831230;Doors Quest Demo;Adventure, Casual, Indie;0 - 20,000;83;13;70;3;3;0
831250;Maxi Pool Masters VR;Adventure, Indie, RPG;0 - 20,000;9;6;3;0;0;0
831260;KeyBoard Guitar Master;Adventure, Indie, RPG;0 - 20,000;15;2;13;0;0;0
831350;Hovercraft Drive;Adventure, Indie, RPG;0 - 20,000;0;1;-1;0;0;0
831450;Kolb Antarctica Experience;Action, Adventure;0 - 20,000;6;5;1;11;11;0
831460;VOICEACTRESSⅡ;Action, Adventure;0 - 20,000;3;5;-2;0;0;0
831470;One Dollar Simulator;Action, Casual, Indie;0 - 20,000;39;7;32;0;0;0
831470;One Dollar Simulator;Indie, RPG;0 - 20,000;39;7;32;0;0;0
831490;Draw Near;Action, Adventure, Indie, RPG, Early Access;0 - 20,000;15;8;7;0;0;0
831510;Another Brick in Space;Action, Casual, Indie;0 - 20,000;7;5;2;0;0;0
831520;Jurassic City Walk;Casual;0 - 20,000;4;20;-16;0;0;0
831530;SRC: Sprint Robot Championship;Action, Casual, Indie, Sports;0 - 20,000;36;5;31;0;0;0
831540;Norilsk;Action, Adventure, Indie;0 - 20,000;4;8;-4;0;0;0
831560;WARRIORS OROCHI 4;Indie;100,000 - 200,000;4174;646;3528;2676;2567;100
831590;VRQ Test;Action, Indie;0 - 20,000;10;3;7;2;2;0
831650;Chronus Arc;Casual, Indie, Simulation, Strategy;0 - 20,000;2;2;0;0;0;0
831660;Monobeno-HAPPY END- Deluxe;Free to Play, Simulation;0 - 20,000;354;25;329;112;112;11
831660;Monobeno-HAPPY END- Deluxe;Adventure;0 - 20,000;354;25;329;112;112;11
831670;SPACE HUNT;Indie, Simulation;0 - 20,000;9;8;1;0;0;0
831680;Hero Go;Action, Indie;0 - 20,000;13;1;12;0;0;0
831690;Piano Play 3D;Adventure, Indie, Simulation;0 - 20,000;1;7;-6;0;0;0
831700;Circuit Loops;Action, Adventure, Casual, Indie, Racing, Simulation, Sports;0 - 20,000;3;15;-12;0;0;0
831710;Electronic Piano;Free to Play, Indie;0 - 20,000;15;24;-9;0;0;0
831720;EMMA The Story;Casual, Indie;0 - 20,000;89;7;82;0;0;0
831740;Circles of hell;Action, Casual, Indie;0 - 20,000;7;7;0;2;2;0
831770;Zombie Derby;RPG;0 - 20,000;85;15;70;0;0;0
831790;Geeste;Indie, Early Access;0 - 20,000;6;6;0;0;0;0
831810;Bane of Asphodel;Action, Adventure, Indie;20,000 - 50,000;58;30;28;6;10;0
831910;Croc's World Construction Kit;Action, Indie;0 - 20,000;2;0;2;0;0;0
831950;Infinite Survival;Action, Strategy;0 - 20,000;5;6;-1;0;0;0
831980;Out of the Park Baseball 20;Action, Adventure, Indie, Early Access;50,000 - 100,000;1003;83;920;0;0;40
832020;Questery;Audio Production, Utilities, Video Production;0 - 20,000;6;2;4;0;0;0
832080;Google Spotlight Stories: Back to the Moon;Action, Indie, RPG;0 - 20,000;43;1;42;0;0;0
832130;Negative World;Action, Casual, Indie;0 - 20,000;8;3;5;0;0;0
832140;Infernal Radiation;Casual, Indie, Racing, Simulation, Sports;0 - 20,000;43;6;37;0;0;0
832320;Mighty Switch Force! Collection;Action, Adventure, Casual, Indie;0 - 20,000;65;5;60;76;76;0
832360;Hotel Magnate;Casual, Indie;0 - 20,000;233;125;108;226;226;9
832380;Reignman（掌控者）;Casual, Indie;0 - 20,000;22;7;15;0;0;0
832420;ICED VR;Casual, Indie, Simulation, Strategy, Early Access;0 - 20,000;7;4;3;0;0;0
832470;Season Up;Software Training, Utilities;0 - 20,000;20;11;9;0;0;0
832470;Season Up;Action, Casual;0 - 20,000;20;11;9;0;0;0
832510;AeroChopper;Action, Adventure, Indie, Simulation, Strategy, Early Access;0 - 20,000;8;3;5;0;0;0
832520;灵文西游;Indie, Simulation;0 - 20,000;17;6;11;0;0;0
832530;VR GAME-Brick of War 魔块战争;Action, Indie;0 - 20,000;2;0;2;0;0;0
832540;Art of Murder - Hunt for the Puppeteer;Adventure, Indie, Early Access;20,000 - 50,000;87;32;55;0;0;1
832550;Tetripank;Action, Casual, Indie;0 - 20,000;4;19;-15;0;0;0
832610;Corrupted;Casual, Indie, Sports, Strategy;20,000 - 50,000;18;23;-5;0;0;0
832650;Royal Adventure;Action;0 - 20,000;19;10;9;0;0;1
832680;Darts and Friends;Action, Indie;0 - 20,000;17;27;-10;0;0;0
832690;Stonetowers;Action, Adventure, Casual, Indie;0 - 20,000;5;1;4;0;0;0
832710;The 7th Circle - Endless Nightmare;Adventure, Casual, Indie;0 - 20,000;40;12;28;0;0;0
832720;Dungeon Brewmaster;Casual, Indie, Simulation, Early Access;0 - 20,000;59;32;27;0;0;2
832770;Age of Fear: The Undead King GOLD;Action;0 - 20,000;76;3;73;0;0;2
832990;Apocalypse Rider;Action, Adventure, Indie;0 - 20,000;2;7;-5;0;0;0
833010;Zombie Forest 2;Casual, Indie;0 - 20,000;22;4;18;0;0;0
833030;Hypertrain;Indie;0 - 20,000;30;10;20;0;0;0
833040;Hiveswap Friendsim;Action, Adventure, Indie;50,000 - 100,000;1135;89;1046;589;589;16
833070;Arrowborn;Action, Adventure, Indie;0 - 20,000;13;5;8;0;0;0
833090;Swords of Gurrah;Free to Play;50,000 - 100,000;634;182;452;26;34;0
833110;The Steadfast VR Challenge;Casual, Indie, Strategy, Early Access;0 - 20,000;8;3;5;0;0;0
833140;Supaplex;Action, Indie;20,000 - 50,000;188;9;179;264;264;2
833150;Hungry Fish Evolution;Adventure, Indie;0 - 20,000;12;19;-7;0;0;0
833170;Burned Land;Action, Indie;0 - 20,000;47;33;14;0;0;1
833180;Spaceship Commander;Casual;0 - 20,000;9;8;1;0;0;0
833260;catAnod;Violent, Action, Indie;0 - 20,000;28;10;18;0;0;0
833270;Citrouille: Sweet Witches;Action, Adventure, Indie;0 - 20,000;57;11;46;248;248;2
833300;Fantasyland;Action, Casual, Indie, Strategy;0 - 20,000;5;37;-32;3;4;0
833360;Star Valor;Casual, Indie;50,000 - 100,000;1767;197;1570;123;197;182
833370;HexLab;Action, Adventure, Casual, Indie, RPG;0 - 20,000;13;6;7;0;0;0
833380;Downtown;Indie;0 - 20,000;3;10;-7;0;0;0
833390;En Tactico;Casual, Racing;0 - 20,000;13;13;0;0;0;0
833390;En Tactico;Casual, Indie, Simulation;0 - 20,000;13;13;0;0;0;0
833400;Corral;Adventure, Casual, Indie, RPG, Strategy;0 - 20,000;15;8;7;0;0;0
833400;Corral;Action, Casual, Indie, Early Access;0 - 20,000;15;8;7;0;0;0
833440;Vera Swings;Casual, Indie;0 - 20,000;10;4;6;0;0;0
833470;Rabbit: Jigsaw Puzzles;Adventure, Casual, Indie;0 - 20,000;21;2;19;0;0;0
833500;Thunder Rally;Action, Casual;0 - 20,000;27;0;27;0;0;0
833510;Time-Skip;Indie;0 - 20,000;1;1;0;0;0;0
833540;The Platformer Gun;Casual, Indie;0 - 20,000;5;1;4;0;0;0
833640;Sci-fi Chess;Adventure, Casual, Indie;0 - 20,000;4;15;-11;0;0;0
833650;Dust n Wheels;Action, Adventure, Indie;0 - 20,000;0;5;-5;0;0;0
833660;Grave Prosperity - part 1;Action, Casual;0 - 20,000;23;9;14;55;55;0
833670;Naughty study for exams with a ghost;Adventure, Indie, RPG;0 - 20,000;6;2;4;0;0;0
833690;Cubesc;Violent, Action, Casual, Indie, Early Access;0 - 20,000;7;0;7;0;0;0
833700;City Bus Simulator 2018;Action, Casual, Simulation, Strategy;0 - 20,000;5;39;-34;0;0;0
833740;Aximion;Action, Indie, Sports;0 - 20,000;2;1;1;0;0;0
833750;Syko Swinger;Action, Indie, Early Access;0 - 20,000;11;1;10;0;0;0
833770;Couch Party Game Night;Action, Indie;0 - 20,000;6;2;4;0;0;0
833800;Speed Car Fighter;Adventure, Casual, Indie, Simulation, Accounting;0 - 20,000;4;3;1;0;0;0
833810;Extreme Formula Championship;Indie, Strategy;0 - 20,000;11;11;0;0;0;0
833820;Mountain Racing;Adventure, Indie;0 - 20,000;2;10;-8;0;0;0
833820;Mountain Racing;Casual, Indie, Simulation, Strategy;0 - 20,000;2;10;-8;0;0;0
833890;NeoSticks;Action, Massively Multiplayer, Early Access;0 - 20,000;54;41;13;136;146;0
833910;Overchunked;Action, Adventure, Indie;0 - 20,000;69;15;54;0;0;0
833920;Meme Machine;Action, Adventure, Indie;0 - 20,000;5;12;-7;0;0;0
833940;Vertigo FPS;Action, Adventure, Indie;0 - 20,000;4;2;2;0;0;0
833950;Risk System;RPG;0 - 20,000;33;2;31;0;0;0
833980;Dave;Action;0 - 20,000;28;1;27;0;0;0
833990;Stonewall Penitentiary;Adventure, Indie, RPG;0 - 20,000;41;2;39;0;0;0
834000;Cross Country Skiing VR;Casual, Indie;0 - 20,000;13;5;8;0;0;0
834030;Slamdunk VR;Adventure, Indie, RPG;0 - 20,000;0;1;-1;0;0;0
834050;SixGenerals | 六小将传说;Indie;0 - 20,000;7;4;3;0;0;0
834060;Goblin Walker;Casual;100,000 - 200,000;388;255;133;295;295;0
834070;AI Escort;Action, Adventure, RPG;0 - 20,000;86;46;40;0;0;0
834100;Dungeon Adventure;Casual, Indie, Strategy;0 - 20,000;0;1;-1;0;0;0
834140;Blacksmith: Dark Times;Free to Play, Sports, Strategy;0 - 20,000;14;11;3;0;0;0
834150;Glare1more;Action, Indie;100,000 - 200,000;205;35;170;0;0;2
834170;Chameleon Video Player;Casual, Indie, Racing, Sports;0 - 20,000;13;12;1;0;0;0
834180;#CuteSnake 2;Simulation, Strategy;0 - 20,000;49;15;34;257;257;0
834210;Clicker Planet;RPG;20,000 - 50,000;0;5;-5;0;0;0
834280;Fishing Sim World: Pro Tour;Casual;50,000 - 100,000;716;206;510;195;215;27
834340;The Hardest Dungeon;Casual;0 - 20,000;16;4;12;0;0;0
834350;liquivid Video Stabilization;Adventure, Casual, Indie;0 - 20,000;1;0;1;0;0;0
834380;Cube Zone;Casual, Indie, Simulation, Sports;0 - 20,000;27;3;24;150;150;1
834390;King's Heir: Rise to the Throne;Violent, Gore, Action, Adventure, Casual, Sports;20,000 - 50,000;123;38;85;0;0;2
834410;Hacker News Reader;Casual, Indie, Simulation;0 - 20,000;15;2;13;0;0;0
834420;RollingBall: Unlimited World;Action, Adventure, Indie;0 - 20,000;11;37;-26;7;7;0
834440;NAMELESS;Action, Casual, Indie, RPG, Simulation, Sports, Strategy;0 - 20,000;9;0;9;0;0;0
834450;Roarr! The Adventures of Rampage Rex;Adventure, Casual, Indie;20,000 - 50,000;59;101;-42;0;0;1
834470;Zima uhodi!;Action, Casual, Simulation, Early Access;0 - 20,000;15;37;-22;0;0;0
834470;Zima uhodi!;Casual, Indie;0 - 20,000;15;37;-22;0;0;0
834530;Yakuza Kiwami;Adventure, Indie;500,000 - 1,000,000;14219;1019;13200;1684;1630;413
834580;東方逆妙乱 ~ Ephemeral Unnatural Balance;Indie, RPG;0 - 20,000;70;4;66;0;0;1
834740;Circle Empires;Adventure, Casual, Indie, RPG;100,000 - 200,000;2932;341;2591;409;480;22
834750;Crucible Falls: Together Forever;Action, Casual, Indie, Sports;0 - 20,000;20;20;0;0;0;0
834760;Robot Wants It All;Casual, Simulation;0 - 20,000;105;12;93;877;877;5
834800;SolSeraph;Action;0 - 20,000;52;42;10;0;0;0
834880;Acro FS;Adventure, Casual, Indie, RPG;50,000 - 100,000;92;78;14;47;70;0
834910;ATLAS;Simulation;1,000,000 - 2,000,000;19631;21660;-2029;11383;643;1286
834920;Operation Osama Bin Laden;Indie, Simulation;20,000 - 50,000;25;2;23;0;0;0
834930;Bishi and the Alien Slime Invasion!;Action, Simulation;0 - 20,000;4;0;4;0;0;0
835040;美少女夏日欢乐!;Casual, Indie;0 - 20,000;38;9;29;0;0;0
835130;Last Stanza;Indie, Simulation;0 - 20,000;8;2;6;0;0;0
835430;La-Mulana 2;Indie, Strategy;100,000 - 200,000;686;122;564;171;171;17
835440;Naturallandscape - Grand Canyon (自然景观系列-美国大峡谷);Action, Adventure, Indie;0 - 20,000;0;4;-4;0;0;0
835450;Neon Force Pushers;Action, Adventure, Indie, RPG;20,000 - 50,000;14;7;7;16;16;0
835490;Deadly Stigma;Action, Adventure, Indie;0 - 20,000;18;2;16;0;0;0
835510;Horror Fish Simulator;Casual, Racing, Simulation, Early Access;0 - 20,000;38;30;8;0;0;0
835520;Dodge Show;Action, Adventure, Indie;50,000 - 100,000;285;60;225;91;113;17
835530;魔物娘物语;Casual, Indie;0 - 20,000;27;18;9;0;0;0
835560;Ancient Rush 2;Action, Indie, Simulation;0 - 20,000;8;9;-1;0;0;0
835600;Techwars Deathmatch;Action, Adventure, Casual, Indie;0 - 20,000;12;7;5;0;0;0
835600;Techwars Deathmatch;Casual, Indie;0 - 20,000;12;7;5;0;0;0
835630;All You Can Feed: Sushi Bar;Adventure, Casual, Indie;0 - 20,000;10;3;7;0;0;0
835640;Dust and Salt: The Battle for Murk;Simulation;0 - 20,000;12;0;12;0;0;0
835650;Rising Lords;Action, Adventure, Indie;20,000 - 50,000;436;154;282;0;0;3
835660;Circle UP;Action, Adventure, Casual, Indie;0 - 20,000;7;21;-14;0;0;0
835680;Intelligence: Dinosaurs;Action, Casual, Simulation, Strategy;0 - 20,000;5;0;5;0;0;0
835690;City Sweeper - Clean it Fast!;Action, Free to Play, Indie;0 - 20,000;4;0;4;0;0;0
835700;Alice - Behind the Mirror;Violent, Action, Casual, Indie, Early Access;20,000 - 50,000;111;20;91;78;78;0
835710;Tactics Maiden Remastered;Casual, Indie;0 - 20,000;16;0;16;0;0;0
835720;2260 VR;Indie, Racing, Early Access;0 - 20,000;3;0;3;0;0;0
835740;HyperFighter Boost Mode ON;Casual, Free to Play, Indie, Strategy;0 - 20,000;3;2;1;0;0;0
835770;Tony Slopes;Casual, Indie;0 - 20,000;4;1;3;0;0;1
835790;Datascape;Action, Casual, Simulation, Strategy;0 - 20,000;0;0;0;0;0;0
835800;Flailure;Casual, Indie;0 - 20,000;4;0;4;0;0;0
835860;Dreadnought;Action, Indie;1,000,000 - 2,000,000;4051;2019;2032;2690;292;34
835910;Above the Fold;Indie, Simulation, Strategy;0 - 20,000;13;12;1;0;0;0
835910;Above the Fold;Action, Adventure, Indie, RPG, Early Access;0 - 20,000;13;12;1;0;0;0
835950;Transpose;Casual, Free to Play, Indie;20,000 - 50,000;214;22;192;2;2;1
836080;BARRAGE / 铁幕;RPG, Simulation, Strategy;20,000 - 50,000;46;8;38;0;0;0
836110;Time Tenshi Paradox: Episode 2;Casual, Indie, RPG;0 - 20,000;12;10;2;0;0;0
836120;Hard Way To Heaven;Adventure, Indie;0 - 20,000;2;0;2;0;0;0
836230;Heavy Blade;Action, Adventure;0 - 20,000;1;2;-1;0;0;0
836260;Call of Bitcoin;Action, Casual, Indie;20,000 - 50,000;44;26;18;0;0;0
836260;Call of Bitcoin;Indie, Simulation, Strategy, Early Access;20,000 - 50,000;44;26;18;0;0;0
836280;Dynamite Bunny: Catch The Carrot;Indie, Racing, Sports;0 - 20,000;4;1;3;0;0;0
836290;Achievement Lurker: Ballad of the Shimapan Warrior - King of Panties;Action, Casual, Indie, Sports;0 - 20,000;19;6;13;0;0;0
836300;Humble Pie;Casual, Indie;0 - 20,000;5;1;4;0;0;0
836330;The God;Action, Casual, Indie;0 - 20,000;38;15;23;0;0;0
836350;Heartbreak High: A Break-Up Simulator;Action, Casual, Indie;0 - 20,000;18;2;16;0;0;0
836400;Basketball Hero VR;Action, Casual, Indie;0 - 20,000;1;0;1;0;0;0
836420;Beginner'sGame;Casual, Indie;0 - 20,000;0;1;-1;0;0;0
836440;MonsterxMan: Inheritence To Lust;Adventure, Casual, Indie, RPG;20,000 - 50,000;61;16;45;0;0;0
836450;Heaven Will Be Mine;Action, Adventure, Indie, Simulation, Strategy;20,000 - 50,000;368;26;342;339;339;1
836460;Etherian;Action, Casual, Indie;0 - 20,000;8;2;6;0;0;0
836470;Mage Fort;Action, Casual, Free to Play, Indie;0 - 20,000;5;3;2;0;0;0
836480;恋爱模拟器 Love Simulation;Action, Indie;200,000 - 500,000;579;463;116;160;294;0
836490;月夜下的紅茶杯 ~ Blacktea With Moon;Casual, Indie;20,000 - 50,000;496;33;463;0;0;1
836490;月夜下的紅茶杯 ~ Blacktea With Moon;Action, Adventure, Casual, Free to Play, Indie, Early Access;20,000 - 50,000;496;33;463;0;0;1
836540;Viking Brothers 2;Action, Indie;0 - 20,000;29;4;25;0;0;1
836550;Viking Brothers 3;Action, Casual, Indie, Massively Multiplayer, Early Access;0 - 20,000;22;2;20;0;0;1
836560;Viking Brothers 4;Action, Casual, Free to Play, Indie, Simulation, Sports;0 - 20,000;23;2;21;0;0;1
836580;Dead GroundZ;Action, Free to Play, Indie, RPG, Strategy;0 - 20,000;20;15;5;0;0;0
836590;STAY COOL, KOBAYASHI-SAN!: A RIVER CITY RANSOM STORY;Action, Indie, Sports;0 - 20,000;17;26;-9;0;0;0
836600;Alternate Jake Hunter: DAEDALUS The Awakening of Golden Jazz;Action, Indie;20,000 - 50,000;15;33;-18;0;0;0
836610;Jigsaw 360;Action, Indie;0 - 20,000;21;1;20;0;0;0
836640;寄居隅怪奇事件簿 Hermitage Strange Case Files;Casual, Indie;100,000 - 200,000;1468;305;1163;1815;3324;3
836690;HomestarVR;Casual, Indie, Strategy;0 - 20,000;5;4;1;0;0;0
836700;Doctor Flow;Action, Casual, Indie;0 - 20,000;7;3;4;0;0;0
836700;Doctor Flow;Adventure, Indie, Simulation;0 - 20,000;7;3;4;0;0;0
836760;Sorcery Saga: Curse of the Great Curry God;Adventure, Casual, Indie;0 - 20,000;80;27;53;0;0;0
836770;Art of Murder - Cards of Destiny;Action, Adventure, Indie;20,000 - 50,000;81;41;40;0;0;1
836790;Dr. Pills;Adventure, Casual, Indie, RPG;50,000 - 100,000;20;21;-1;0;0;0
836850;Tiny Tanks;Action, Indie;20,000 - 50,000;85;39;46;0;0;0
836850;Tiny Tanks;Action, Adventure, Indie;20,000 - 50,000;85;39;46;0;0;0
836860;Art of Murder - The Secret Files;Adventure, Indie, Early Access;0 - 20,000;10;72;-62;0;0;0
836940;【SCP】器関ノ彷徨 -The will of a single Tale-【DEMOver.】;Action, Adventure, Indie;50,000 - 100,000;302;35;267;2;2;0
837040;Redneck Kentucky and the Next Generation Chickens;Adventure;0 - 20,000;75;3;72;0;0;0
837090;Chronicles of Mystery - The Tree of Life;Action, Adventure, Indie, Early Access;0 - 20,000;32;20;12;0;0;0
837100;Chronicles of Mystery - The Legend of the Sacred Treasure;Indie;0 - 20,000;11;27;-16;0;0;1
837110;Chronicles of Mystery - Secret of the Lost Kingdom;Violent, Gore, Action, Adventure, Indie;0 - 20,000;7;31;-24;0;0;2
837180;Slamoids!;Action, Adventure, Indie;20,000 - 50,000;4;0;4;0;0;0
837190;Tanglewood;Casual, Indie;0 - 20,000;77;3;74;0;0;0
837200;NetHack: Legacy;Action, Massively Multiplayer, Simulation;0 - 20,000;34;12;22;0;0;1
837210;Doodle God: Genesis Secrets;Strategy, Early Access;0 - 20,000;5;11;-6;0;0;0
837220;Doodle Tanks;Action, Indie, Racing, Sports;0 - 20,000;9;8;1;0;0;0
837240;Shopkeeper Simulator VR;Casual, Indie, Simulation;0 - 20,000;14;11;3;0;0;0
837260;Roller Coaster Apocalypse VR;Adventure, Indie, Strategy;0 - 20,000;3;1;2;0;0;0
837270;Tharn;Free to Play;0 - 20,000;4;2;2;0;0;0
837280;Lost Borderline;Action, Indie, Early Access;20,000 - 50,000;15;0;15;0;0;0
837290;Blind Mind;Adventure, Casual, Free to Play, Indie, RPG;20,000 - 50,000;2;6;-4;0;0;0
837310;Telophase;Casual, Indie, Strategy;20,000 - 50,000;47;11;36;0;0;0
837330;Crimson Shift;Action, Indie;0 - 20,000;17;3;14;0;0;0
837330;Crimson Shift;Adventure, Casual, Indie;0 - 20,000;17;3;14;0;0;0
837350;King of the Hat;Adventure, Indie;0 - 20,000;130;1;129;0;0;0
837380;DeoVR Video Player;Action, Casual, Indie;200,000 - 500,000;427;194;233;146;72;74
837390;My zero trip;Indie;0 - 20,000;14;35;-21;45;45;0
837400;Fated Kingdom;Indie, Simulation;0 - 20,000;234;71;163;20;21;0
837430;Flying Aces - Navy Pilot Simulator;Adventure, Casual, Indie;0 - 20,000;19;24;-5;0;0;0
837440;MineSweep;Adventure, Casual, Indie;20,000 - 50,000;44;24;20;0;0;0
837460;Batbarian: Testament of the Primordials;Casual, Indie, Simulation;0 - 20,000;179;29;150;0;0;1
837470;Untitled Goose Game;Action, Adventure, Casual, Indie;500,000 - 1,000,000;12995;583;12412;188;147;537
837500;Leder Panzer;Casual, Indie;0 - 20,000;3;0;3;0;0;0
837510;Pixel Game Maker MV;Action, Indie;50,000 - 100,000;347;140;207;144;148;51
837530;Dark Ghost RPG;Casual, Indie;0 - 20,000;16;26;-10;0;0;0
837550;Bouncy Butter Ball;Adventure, Indie, RPG;0 - 20,000;3;1;2;0;0;0
837590;Operation Thunderstorm;Action, Indie, Early Access;20,000 - 50,000;182;64;118;122;122;2
837600;The Royal Marines Commando;Action, Indie;0 - 20,000;109;51;58;80;110;0
837610;Mary Skelter: Nightmares;Casual, Simulation;20,000 - 50,000;429;60;369;727;727;1
837720;Tactical Mind;Casual, Indie, Strategy;20,000 - 50,000;4;0;4;0;0;0
837780;Coin-Op Kingdom;Casual, Indie;0 - 20,000;7;6;1;0;0;0
837790;Around the World in 80 Days;Indie;20,000 - 50,000;37;13;24;153;153;1
837800;Red Riding Hood - Star Crossed Lovers;Action, Adventure, Indie, RPG;0 - 20,000;49;29;20;35;35;0
837810;Spectrum Analyzer;Action, Casual, Indie;0 - 20,000;0;4;-4;0;0;0
837850;Photonic Distress;Adventure, Casual, Indie;0 - 20,000;49;3;46;0;0;0
837880;You Suck at Parking;Action, Adventure, Indie;20,000 - 50,000;153;25;128;225;263;9
837900;Bitcoin Trader;Adventure, Indie, Strategy;0 - 20,000;37;45;-8;0;0;0
837900;Bitcoin Trader;Casual, Indie, Racing, Sports;0 - 20,000;37;45;-8;0;0;0
837920;Abnormal world: season one;Adventure, Indie;0 - 20,000;3;12;-9;0;0;0
837930;Alone;Violent, Gore, Action, Adventure, Indie;0 - 20,000;18;6;12;2;2;0
837940;Mobile Forces;Simulation;20,000 - 50,000;64;3;61;0;0;0
837950;Mad Carnage;Action, Indie, Early Access;0 - 20,000;6;1;5;0;0;0
838010;Double Cross;Casual;0 - 20,000;91;21;70;0;0;0
838050;The Hero Project: Open Season;Casual;0 - 20,000;7;14;-7;0;0;0
838100;Point;Action, Casual, Indie, Massively Multiplayer, Early Access;0 - 20,000;26;0;26;0;0;0
838110;HyperParasite;Action, Adventure;20,000 - 50,000;123;20;103;0;0;0
838150;Falling Slime;Violent, Action, Adventure, Indie, Strategy;0 - 20,000;1;1;0;0;0;0
838160;Trail Breaking;Strategy;0 - 20,000;5;4;1;0;0;0
838180;MechCorp;Adventure, Indie;0 - 20,000;53;13;40;983;983;1
838190;Hidden Protector : ROADTRIP;Action;0 - 20,000;21;2;19;0;0;0
838270;Grandpa;Casual, Strategy;20,000 - 50,000;80;102;-22;0;0;0
838310;Bloodstained: Curse of the Moon;Adventure, Indie;200,000 - 500,000;3520;202;3318;571;835;10
838330;Warlords Awakening;Action, Indie;20,000 - 50,000;390;157;233;201;201;0
838340;May;Action, Adventure, RPG;0 - 20,000;23;5;18;0;0;0
838350;太吾绘卷 The Scroll Of Taiwu;Adventure, Indie, Early Access;2,000,000 - 5,000,000;38878;17144;21734;3317;1327;1279
838360;Life Goals;Adventure, Casual, Indie;0 - 20,000;0;0;0;0;0;0
838380;DEAD OR ALIVE 6;Utilities;500,000 - 1,000,000;5768;2046;3722;368;81;113
838390;Merry Glade;Sexual Content, Nudity, Violent, Casual, Indie, RPG;20,000 - 50,000;206;11;195;0;0;0
838410;Tabletop Playground;Violent, Gore, Action, Indie, Early Access;0 - 20,000;117;57;60;132;132;4
838420;Longboard Stunts and Tricks;Indie, Simulation, Sports;0 - 20,000;6;16;-10;0;0;0
838430;Galaxy Ball;Casual, Indie;0 - 20,000;4;4;0;0;0;0
838440;The Great Race;Adventure, Casual, Indie, Strategy, Early Access;0 - 20,000;8;0;8;0;0;0
838490;Theorem;Violent, Adventure, Indie;0 - 20,000;26;1;25;0;0;0
838510;Find & Destroy: Tank Strategy;Indie, Sports, Strategy, Early Access;20,000 - 50,000;72;47;25;0;0;2
838530;Ball Escape;Casual, Indie;50,000 - 100,000;3;1;2;0;0;0
838540;City Escaper;Strategy;0 - 20,000;14;23;-9;1;1;1
838620;Slappy Ass;Adventure, Casual, Indie;0 - 20,000;0;0;0;0;0;0
838630;Deadliest Catch: The Game;Casual;50,000 - 100,000;639;566;73;165;167;7
838690;Unleashed;Action, Indie, Simulation;0 - 20,000;2;1;1;0;0;0
838700;Azada: Ancient Magic;Casual, Simulation, Sports;0 - 20,000;10;0;10;0;0;0
838710;Dark Dimensions: Somber Song Collector's Edition;Indie;0 - 20,000;2;0;2;0;0;0
838720;Mystery Tales: Alaskan Wild Collector's Edition;Adventure, Casual, Indie;0 - 20,000;5;0;5;0;0;0
838730;Grim Tales: The Stone Queen Collector's Edition;Action, Indie, Strategy;0 - 20,000;9;2;7;0;0;0
838740;Final Cut: The True Escapade Collector's Edition;Action, Racing;0 - 20,000;2;2;0;0;0;1
838750;Shadow Wolf Mysteries: Cursed Wedding Collector's Edition;Indie;0 - 20,000;4;0;4;0;0;0
838760;Haunted Legends: The Stone Guest Collector's Edition;Nudity, Violent, Adventure, Indie, RPG;0 - 20,000;1;1;0;0;0;0
838790;The Devil's Garden;Action, Adventure, Casual, Free to Play, Indie, Racing, RPG, Simulation, Sports;0 - 20,000;2;6;-4;0;0;0
838820;Warzone VR;Action, Casual, Indie;0 - 20,000;16;20;-4;0;0;0
838840;Secret of Harrow Manor;Adventure, Indie;0 - 20,000;5;10;-5;0;0;0
838900;Cereal Soup;Adventure, Casual, Indie;100,000 - 200,000;319;400;-81;27;27;1
838940;Little Marisa's Disaster Journey;Action, Racing;0 - 20,000;19;10;9;0;0;0
838980;Eon Fleet;Adventure, Casual, Indie, Strategy;0 - 20,000;20;15;5;0;0;0
838990;Endhall;Casual, Indie, Racing;50,000 - 100,000;104;17;87;0;0;0
839010;Real Winners: Victoryball;Casual, Indie;0 - 20,000;2;0;2;0;0;0
839020;The Rig: A Starmap to Murder;Adventure, Casual;0 - 20,000;39;11;28;0;0;0
839030;Mad Frost;Adventure, Casual, Indie, Simulation;0 - 20,000;9;5;4;0;0;0
839040;Fasaria World: Ancients of Moons + Server;Action, Casual, Indie;0 - 20,000;3;4;-1;0;0;0
839090;Galaxy Ball Defender;Action, Indie;0 - 20,000;6;1;5;0;0;0
839130;Snowball Saves Summer;Action, Indie, Early Access;0 - 20,000;1;0;1;0;0;0
839170;Paradox of the Cryptomancers;Casual, Indie;0 - 20,000;7;3;4;0;0;0
839180;Nine-Slicer;Indie, Simulation, Strategy, Early Access;0 - 20,000;1;0;1;0;0;0
839200;SpedV;Indie;500,000 - 1,000,000;539;148;391;0;0;113
839210;The Land of the Seazogs;Casual;0 - 20,000;11;2;9;0;0;0
839240;Penny Black;Animation & Modeling, Design & Illustration, Video Production;0 - 20,000;82;5;77;0;0;0
839250;三国英雄列传 (Legendary Heros in the Three Kingdoms);Adventure;0 - 20,000;46;16;30;0;0;0
839250;三国英雄列传 (Legendary Heros in the Three Kingdoms);Casual, Indie, Sports;0 - 20,000;46;16;30;0;0;0
839260;Russian AYE Horror;Action, Indie, Early Access;0 - 20,000;81;55;26;0;0;0
839280;Cartonfall;Casual, Indie;0 - 20,000;103;9;94;0;0;0
839300;Legendary Eleven: Epic Football;Action, Adventure, Indie, RPG, Simulation, Sports, Strategy;0 - 20,000;77;26;51;497;497;0
839310;Signal Simulator;Violent, Action, Early Access;50,000 - 100,000;715;134;581;74;112;4
839330;Catch Me If You Can;Action, Casual, Indie, Simulation, Strategy, Early Access;20,000 - 50,000;60;1;59;0;0;3
839340;SOK MIN;Action, Indie, Strategy;20,000 - 50,000;63;6;57;0;0;0
839350;Melordandek;Action, Adventure, Casual, Indie, Strategy, Early Access;0 - 20,000;13;0;13;0;0;0
839370;The story of Gods 七神物语;Indie;0 - 20,000;7;5;2;0;0;0
839410;Undead & Beyond;Adventure, Casual;0 - 20,000;25;3;22;0;0;0
839420;Krampus is Home;Adventure, Indie, Early Access;20,000 - 50,000;142;34;108;0;0;2
839430;Flurius;Casual, Free to Play, Indie, Simulation, Sports, Early Access;0 - 20,000;4;10;-6;58;58;0
839450;7'scarlet;Adventure, Indie, RPG;20,000 - 50,000;470;138;332;0;0;6
839500;血战夹皮沟;Violent, Gore, Action, Adventure, Casual, Indie, Racing;0 - 20,000;78;52;26;0;0;0
839500;血战夹皮沟;Action, Indie;0 - 20,000;78;52;26;0;0;0
839520;The Legend of Evil;Casual, Indie, RPG;0 - 20,000;13;5;8;0;0;0
839530;Bomight;Indie, Racing;0 - 20,000;3;1;2;0;0;0
839540;Electroquest: Resistance is Futile;Action, Indie, Early Access;20,000 - 50,000;4;20;-16;0;0;0
839560;Shrinking Pains;Adventure, Indie;20,000 - 50,000;163;28;135;15;15;0
839570;What Are You Stupid;Casual, Indie;0 - 20,000;19;3;16;0;0;0
839580;Volume Maximizer;Casual, Indie;0 - 20,000;2;6;-4;0;0;0
839590;Hamster Daily;Casual, Indie;0 - 20,000;8;12;-4;0;0;0
839620;Bomb Labyrinth;Adventure, Casual, Indie;0 - 20,000;2;5;-3;0;0;0
839630;Survisland / 实境求生;Indie, Simulation, Strategy;20,000 - 50,000;839;457;382;179;340;4
839670;Alice's Adventures - Hidden Object. Wimmelbild;Indie, Simulation;0 - 20,000;43;6;37;0;0;1
839680;The Front of Greed;Action, Casual, Indie;50,000 - 100,000;11;16;-5;0;0;0
839730;Planum;Action, Casual, Indie;20,000 - 50,000;11;26;-15;0;0;0
839740;戾谈;Action, Adventure, Indie;100,000 - 200,000;75;25;50;0;0;0
839770;Phoenix Point;Action, Indie, Strategy;200,000 - 500,000;3550;1342;2208;3431;5085;431
839810;Drift 4000;Action, Adventure, Casual, Indie, RPG;20,000 - 50,000;14;9;5;93;93;0
839820;Match Connect Challenge;Action, Indie;0 - 20,000;4;1;3;0;0;1
839850;Lenin - The Lion;Adventure, Casual, Indie;0 - 20,000;93;4;89;0;0;1
839890;Kama Bullet Heritage 2;Action, Indie, Early Access;0 - 20,000;20;57;-37;0;0;0
839910;Mythgard;Free to Play, Early Access;100,000 - 200,000;1114;169;945;0;0;17
839920;9 Balls;Education, Software Training, Early Access;0 - 20,000;12;42;-30;0;0;0
839930;My Car;Indie, Racing, Simulation, Early Access;50,000 - 100,000;277;135;142;25;25;0
839940;Silverworld;Casual, Indie;0 - 20,000;23;1;22;0;0;1
839960;The Technician;Action, Casual, Indie;0 - 20,000;20;2;18;0;0;0
839970;Mr Rabbit's Memory Game;Action, Adventure, Casual, Indie, Early Access;0 - 20,000;1;3;-2;0;0;0
840010;Garden Paws;Nudity, Adventure, Casual, Indie;50,000 - 100,000;2026;187;1839;5452;5459;162
840020;Gun Rage;Action, Indie;0 - 20,000;6;3;3;0;0;0
840050;ad movere;Indie, Simulation, Strategy;0 - 20,000;5;2;3;0;0;0
840060;Good Doggo;Free to Play, Indie, RPG;0 - 20,000;90;21;69;0;0;0
840090;Battleground Shooting Training 吃鸡枪法训练器;Indie;0 - 20,000;4;9;-5;0;0;0
840110;The Beat: A Glam Noir Game;Adventure, Indie, RPG, Strategy;0 - 20,000;3;2;1;0;0;0
840120;Pi is Everything;Action, Adventure, Casual, Indie;0 - 20,000;2;2;0;0;0;0
840130;Battle Royale: Survivors 究极求生:大逃杀;Action, Adventure, Casual, Indie;50,000 - 100,000;257;320;-63;0;0;0
840140;武侠乂 The Swordsmen X;Casual, Simulation, Sports;50,000 - 100,000;1673;1844;-171;2286;763;1
840160;Tokavuh Stream Control;Adventure, Casual, Indie;0 - 20,000;13;0;13;0;0;0
840170;Delivery man simulator;Action, Casual, Indie;0 - 20,000;5;20;-15;0;0;0
840180;On Board 4 PC;Casual;0 - 20,000;12;18;-6;0;0;0
840210;Arkham Horror: Mother's Embrace;Action, Casual, Indie;50,000 - 100,000;363;217;146;0;0;1
840230;Chicken ~Boiled Egg~;Action, Adventure, Casual, Indie;0 - 20,000;10;1;9;0;0;0
840240;Mosaic: Game of Gods II;Casual, Indie, Simulation, Early Access;0 - 20,000;21;5;16;0;0;0
840260;Endless World Idle RPG;Action, Casual, Indie;200,000 - 500,000;3232;868;2364;1037;761;103
840290;Pendula Swing Episode 1 - Tired and Retired;Action, Indie, Massively Multiplayer, RPG, Strategy, Early Access;0 - 20,000;47;22;25;0;0;0
840300;Supralympic Runners;Adventure, Indie, RPG;0 - 20,000;8;0;8;0;0;0
840310;SLICE;Design & Illustration, Utilities, Game Development;20,000 - 50,000;51;2;49;0;0;0
840380;Quible Sphere;Action, Indie, Strategy;0 - 20,000;10;0;10;0;0;0
840390;Spacebase Startopia;Action, Casual, Indie;50,000 - 100,000;318;230;88;30;30;4
840410;Mushroom Heroes;Animation & Modeling, Design & Illustration;50,000 - 100,000;127;23;104;22;22;0
840430;Planetary Dustoff;Action, Casual, Indie, Strategy;0 - 20,000;38;5;33;0;0;0
840440;Good Boy!;Adventure;0 - 20,000;14;10;4;0;0;0
840500;Dictator's dreams;Action, Indie;20,000 - 50,000;15;11;4;0;0;0
840510;Furious Drivers;Adventure, Casual;0 - 20,000;0;1;-1;0;0;0
840580;Virtual Foosball;Action, Indie;0 - 20,000;23;6;17;0;0;0
840590;Hypnotic Experience - ANOIX;Adventure, Casual, Indie, Simulation;0 - 20,000;41;19;22;0;0;1
840590;Hypnotic Experience - ANOIX;Indie, Simulation;0 - 20,000;41;19;22;0;0;1
840610;Fortune-499;Action, Indie;0 - 20,000;123;15;108;363;363;0
840620;Geometry Boxer;Casual, Indie;20,000 - 50,000;43;21;22;9;9;0
840690;Setup Developer Tool 2018;Racing;0 - 20,000;24;12;12;0;0;0
840700;Qvabllock;Indie, RPG, Simulation, Strategy;0 - 20,000;82;18;64;1;1;0
840710;Trivia Vault: Tennis Trivia;Action, Indie;0 - 20,000;26;17;9;0;0;3
840720;Sword Art Online: Lost Song;Simulation, Strategy;50,000 - 100,000;1391;337;1054;541;756;21
840730;The Sandbox of God: Remastered Edition;Sexual Content, Nudity, Adventure, Casual, Indie, Simulation;0 - 20,000;7;2;5;0;0;0
840790;The Firlyn Stones *No More Updates*;Violent, Action, Casual, Indie, Simulation;0 - 20,000;4;2;2;0;0;0
840800;Outlaws of the Old West;Action, Indie;200,000 - 500,000;3652;2272;1380;690;420;38
840810;Data Ball;Action, Indie, Racing, Early Access;0 - 20,000;3;0;3;0;0;0
840830;Noonie;Action, Indie;0 - 20,000;1;0;1;0;0;0
840860;I Pay No Rent;Adventure, Casual, Indie, Racing;;;;0;;;
840880;Camped Out!;Adventure, Casual, Indie;0 - 20,000;2;1;1;0;0;0
840910;Save her, from dreams;Adventure, Casual, Indie, Racing;0 - 20,000;16;2;14;0;0;0
840910;Save her, from dreams;Adventure, Casual, Indie, Racing;0 - 20,000;16;2;14;0;0;0
840920;Asimov Laws;Action, Adventure, Casual, Indie, Early Access;0 - 20,000;4;1;3;0;0;0
840930;Bing Bong XL;Action, Adventure, Indie, Strategy, Early Access;0 - 20,000;190;15;175;0;0;1
840940;Spirits of Metropolis: Legacy Edition;Adventure, Indie, Early Access;20,000 - 50,000;1;2;-1;0;0;0
840980;Exoder;Action, Adventure, Indie, RPG, Strategy, Early Access;0 - 20,000;9;2;7;0;0;0
841010;Jack and Sara: Educational game;Action, Indie;0 - 20,000;12;1;11;1;1;0
841020;Knockdown the Ball;Action, Casual, Indie;0 - 20,000;10;7;3;0;0;0
841030;Fairy Escape;Adventure, Indie;0 - 20,000;30;25;5;0;0;0
841110;HOLY COW! Milking Simulator;Action, Strategy;0 - 20,000;4;0;4;0;0;0
841110;HOLY COW! Milking Simulator;Adventure, Casual, RPG, Simulation;0 - 20,000;4;0;4;0;0;0
841120;Wheelchair Simulator VR;Casual, Indie, Strategy;0 - 20,000;14;5;9;0;0;0
841140;Square Head Zombies 2 - FPS Game;Indie, Simulation;0 - 20,000;17;31;-14;29;29;0
841190;Honey, I Joined a Cult;Action, Adventure, Casual, Free to Play, Indie, RPG, Strategy;50,000 - 100,000;930;223;707;296;309;33
841200;Intelligence;Action, Adventure, Casual, Indie;0 - 20,000;10;5;5;0;0;0
841210;WW Fantasy;Indie, RPG;0 - 20,000;47;11;36;0;0;0
841260;Final Match;Adventure, Indie, RPG, Simulation, Strategy;0 - 20,000;8;8;0;0;0;0
841270;Trap welcome to Breil;Casual, Indie;0 - 20,000;180;29;151;18;18;0
841300;Together;Action, Indie, Early Access;20,000 - 50,000;156;56;100;4;4;0
841320;Whitevale Defender;Action, Adventure, Indie, Early Access;0 - 20,000;10;4;6;0;0;0
841340;Fightttris VR;Action, Indie;0 - 20,000;10;4;6;0;0;0
841350;NALOGI 2;Action, Adventure, Indie;20,000 - 50,000;217;77;140;247;247;2
841370;NBA 2K19;Action, Adventure, Casual, Indie;2,000,000 - 5,000,000;8949;13951;-5002;11924;6301;390
841440;ShellBlast: Legacy Edition;Adventure, Casual, Free to Play;0 - 20,000;6;0;6;0;0;0
841460;The Great C;Adventure, Casual, Indie;20,000 - 50,000;200;26;174;0;0;0
841470;greenTech+ Legacy Edition;Action, Casual, Simulation;20,000 - 50,000;3;0;3;0;0;0
841500;Sheep Game;Adventure, Indie;20,000 - 50,000;36;7;29;1;1;0
841570;BlindMaze;Indie, RPG;0 - 20,000;7;3;4;0;0;0
841580;Realmstone;Action, Casual, Indie, Strategy;0 - 20,000;1;0;1;0;0;0
841600;Aura of Worlds;Action, Indie, Early Access;0 - 20,000;78;4;74;0;0;0
841660;The Treehouse Man;Action, Indie, Early Access;20,000 - 50,000;106;17;89;0;0;1
841680;Hazmat Hijinks: Total Meltdown;Action, Casual, Indie;0 - 20,000;7;1;6;0;0;0
841770;Siralim 3;Casual, Indie;100,000 - 200,000;902;51;851;0;0;3
841790;Adventures in the Light & Dark;Adventure, Indie, RPG;20,000 - 50,000;3;1;2;0;0;0
841800;Super Heroes: Men in VR beta;Indie, Simulation, Strategy;0 - 20,000;1;2;-1;0;0;0
841830;Semi-Sweet Tofu;Adventure;0 - 20,000;5;0;5;0;0;0
841840;Escape From Cozy Island;Casual, Indie;0 - 20,000;10;15;-5;0;0;0
841870;Guardian of Immortal Mountain(仙山守卫者);Action, Indie, Strategy, Early Access;0 - 20,000;7;1;6;0;0;0
841950;Echoes III;Adventure, Indie;0 - 20,000;14;5;9;0;0;0
841970;Play Top Frag;Action, Adventure, Indie;0 - 20,000;1;0;1;0;0;0
841980;Avalon Legends Solitaire 3;Utilities, Early Access;0 - 20,000;14;4;10;0;0;0
841990;Der Milchbauer;English, Simplified Chinese;0 - 20,000;4;7;-3;0;0;0
842070;FantasyDynasty: Le château DERETIC;Casual, Indie;0 - 20,000;2;2;0;0;0;0
842100;Daymare: 1998;Action, Casual, Indie, Early Access;100,000 - 200,000;1901;755;1146;349;473;31
842120;Arca's Path VR;Action, Casual, Indie;0 - 20,000;13;2;11;0;0;0
842130;Sunny Smiles;Free to Play, Indie, Racing;0 - 20,000;12;13;-1;0;0;0
842130;Sunny Smiles;Action, Indie;0 - 20,000;12;13;-1;0;0;0
842140;Kitten'd;Adventure, RPG;0 - 20,000;67;10;57;0;0;0
842150;Wild West Saga: Idle Tycoon Clicker;Action, Massively Multiplayer;100,000 - 200,000;488;232;256;374;542;46
842170;Hyperspace Dogfights;Casual, Free to Play, Simulation, Strategy;50,000 - 100,000;91;8;83;0;0;4
842180;Prison Simulator;Action, Indie, RPG;100,000 - 200,000;1421;201;1220;287;374;27
842190;江湖侠客行;Violent, Gore, Action, Adventure, Free to Play;0 - 20,000;7;18;-11;0;0;0
842250;GM Forge - Virtual Tabletop;Adventure, Indie, RPG;0 - 20,000;31;51;-20;5;5;0
842270;Formula X;Adventure, Indie;0 - 20,000;1;13;-12;1;1;0
842290;ArcBall 2;Action, Indie;0 - 20,000;4;31;-27;0;0;0
842350;Escape Code - Coding Adventure;Action, Casual, Indie;0 - 20,000;0;1;-1;0;0;0
842420;A Walk in the Woods;Casual;50,000 - 100,000;215;309;-94;13;19;0
842430;Star Girls;Action, Adventure, Indie, Early Access;0 - 20,000;15;1;14;0;0;0
842470;Cranes;Action, Indie, Strategy;0 - 20,000;7;0;7;0;0;0
842490;BOXiGON!;Adventure, Indie;0 - 20,000;0;1;-1;0;0;0
842500;Kickshot;Adventure, Casual, Indie, Simulation;0 - 20,000;46;15;31;0;0;0
842510;Survival Maze;Adventure, Casual, Indie;0 - 20,000;2;4;-2;0;0;0
842520;Neon Void Runner;Casual, Simulation, Early Access;0 - 20,000;6;10;-4;0;0;0
842530;Police Patrol;Action, Indie;20,000 - 50,000;11;37;-26;0;0;0
842560;War Hunter;Adventure, Indie;0 - 20,000;6;36;-30;0;0;0
842590;Knight Fighter;Action, Indie, Racing, Sports;20,000 - 50,000;6;16;-10;0;0;0
842620;Funny Yo;Action, Casual, Indie, RPG;0 - 20,000;1;9;-8;0;0;0
842640;Deadly Tropics;Violent, Gore, Action, Simulation, Sports;0 - 20,000;10;16;-6;0;0;0
842660;MiniState;Casual, Strategy, Early Access;20,000 - 50,000;50;33;17;0;0;0
842750;Galaxy Champions TV;Adventure, Casual, Indie, Simulation;0 - 20,000;93;7;86;0;0;0
842760;Highscore Processing Unit;Action, Indie;0 - 20,000;4;0;4;0;0;0
842770;Deadfall Tropics;Action, Adventure, Indie, Simulation, Strategy;0 - 20,000;12;0;12;0;0;0
842780;NavalArt;Casual, Indie, Racing;50,000 - 100,000;1027;93;934;625;640;106
842810;Märchen Forest: Mylne and the Forest Gift [Legacy ver.];Action, Adventure, Casual, Indie;50,000 - 100,000;330;65;265;55;55;20
842850;Newt One;Casual, Massively Multiplayer, Simulation;0 - 20,000;42;24;18;0;0;0
842870;Lords of Strife;Adventure, Casual, Indie;0 - 20,000;9;3;6;0;0;0
842910;The MISSING: J.J. Macfield and the Island of Memories;Casual, Indie, Strategy;50,000 - 100,000;1016;113;903;404;404;2
842990;Taco Gun;Casual, Indie;0 - 20,000;8;0;8;0;0;0
843010;Orb Labs, Inc.;Action, Casual, Indie, Strategy, Early Access;0 - 20,000;25;7;18;0;0;0
843020;Hipster Cafe;Casual, Indie, Simulation;0 - 20,000;23;3;20;0;0;6
843040;RECOG The First Wave;Violent, Gore, Action, Casual, Indie;0 - 20,000;6;8;-2;0;0;0
843050;North Stars;Action, Indie;20,000 - 50,000;59;13;46;0;0;0
843080;VR Hero Sentry;Sexual Content, Nudity, Casual, Indie, Simulation;0 - 20,000;11;3;8;0;0;0
843120;Joyo Kanji Quiz;Action, Casual, Indie;0 - 20,000;11;1;10;0;0;0
843130;Squirgle;Action, Early Access;0 - 20,000;0;0;0;0;0;0
843160;The Lift;Action, Casual, Indie;0 - 20,000;7;7;0;0;0;0
843170;ILLUSION;Adventure, Casual, Indie, Sports;0 - 20,000;58;2;56;0;0;0
843180;Clan O'Conall and the Crown of the Stag;Action, Adventure, Casual, Indie;20,000 - 50,000;106;6;100;0;0;0
843190;Z: Escape;Action, Indie;0 - 20,000;10;12;-2;0;0;0
843230;Album Corvus;Action, Massively Multiplayer, RPG, Early Access;0 - 20,000;5;1;4;0;0;0
843250;The Last DeadEnd;Adventure, Indie, Strategy;0 - 20,000;74;23;51;0;0;0
843250;The Last DeadEnd;Strategy;0 - 20,000;74;23;51;0;0;0
843260;The Bard's Tale Trilogy;Action, Casual, Free to Play, Indie;50,000 - 100,000;1127;53;1074;83;70;42
843270;Flapping Over It;Action, Casual, Simulation;0 - 20,000;8;11;-3;0;0;0
843360;Rift Keeper;Action, Casual, Simulation;0 - 20,000;61;23;38;0;0;0
843370;Gravity Well;Action, Indie;0 - 20,000;12;0;12;0;0;0
843380;Super Animal Royale;Casual, Simulation, Strategy;1,000,000 - 2,000,000;32720;2083;30637;740;105;912
843400;Distant castle;Casual, Simulation, Strategy;0 - 20,000;0;4;-4;0;0;0
843420;Supermarket VR and mini-games;Adventure, Casual, Indie, RPG;0 - 20,000;2;12;-10;0;0;0
843430;Righty Tighty XL;Violent, Indie;0 - 20,000;118;6;112;0;0;0
843440;Pivot XL;Adventure, Casual, Indie, Simulation;0 - 20,000;134;7;127;4;4;0
843500;God Vs Zombies;Indie, Strategy;0 - 20,000;19;46;-27;0;0;0
843510;Colony Prospector;Adventure, Casual, Indie, RPG;0 - 20,000;18;4;14;0;0;0
843520;The Last Front;Adventure, Casual, Indie, RPG;0 - 20,000;40;28;12;0;0;0
843560;IronCommando/钢铁突击队;Action, Adventure, Indie, Early Access;0 - 20,000;10;0;10;0;0;0
843580;DotLine;Adventure, Casual, Indie;0 - 20,000;2;2;0;0;0;0
843590;GhostGame;Casual, Indie, Racing;0 - 20,000;29;0;29;0;0;0
843620;Forest Below;Casual, Simulation;0 - 20,000;11;1;10;0;0;0
843630;Project R.A.T.;Indie;0 - 20,000;15;5;10;0;0;0
843640;WEscape;Sports;0 - 20,000;26;7;19;0;0;0
843650;Sophont;Action, Indie;0 - 20,000;2;1;1;0;0;0
843660;Rogue Agent;Indie;0 - 20,000;226;43;183;11154;11154;13
843700;El Taco Diablo;Action, Adventure, Indie, Simulation;0 - 20,000;9;2;7;0;0;0
843710;Déjà Vu;Adventure;0 - 20,000;9;0;9;0;0;0
843720;Dissimilated Land;Adventure, Casual, Indie;20,000 - 50,000;111;64;47;0;0;0
843730;Infected Battlegrounds;Violent, Gore, Action, Indie, Early Access;0 - 20,000;29;17;12;0;0;0
843740;HellStar Squadron;Action, Adventure, Indie, RPG, Strategy, Early Access;0 - 20,000;20;4;16;0;0;0
843760;Kemonomichi-White Moment-;Action, Indie;0 - 20,000;1;1;0;0;0;0
843780;City Builder;Free to Play, Indie;0 - 20,000;33;15;18;1;1;1
843790;HUMAN LIVE-HOW LONG CAN HUMAN BEINGS EXIST?人类能生存多久？挑战各种灾难，地球世界末日，冒险策略模拟经营游戏;Casual, Indie;0 - 20,000;11;11;0;0;0;0
843810;A Perfect Day;Action, Adventure, Casual, Indie;100,000 - 200,000;1230;212;1018;313;313;1
843820;TheShooterGame;Casual;0 - 20,000;5;9;-4;0;0;0
843840;Space Orb;Action, Adventure, Indie;0 - 20,000;12;1;11;0;0;0
843860;When They Arrived;Casual, Simulation;20,000 - 50,000;49;84;-35;0;0;0
843870;Card Games Mega Collection;Adventure, Casual, Indie, Simulation, Sports, Strategy;0 - 20,000;16;13;3;0;0;0
843890;WIN THE GAME: DO IT!;Simulation, Strategy, Early Access;50,000 - 100,000;204;122;82;65;72;0
843920;Hungry Piggy vs Chicken;Action, Casual, Indie;0 - 20,000;3;0;3;0;0;0
843930;Cyadonia;Adventure, Indie;0 - 20,000;9;1;8;0;0;0
843980;Vortex Rush;Adventure, Casual, Indie, Strategy;0 - 20,000;2;0;2;0;0;0
843990;Bullet Hell ADVANCED;Action, Indie;0 - 20,000;7;3;4;0;0;0
844020;G.A.M.E.S;Adventure, Casual, Indie;0 - 20,000;1;0;1;0;0;0
844030;Codename Ghost Hunt;Casual, Indie;0 - 20,000;1;4;-3;0;0;0
844040;RUSH;Indie;50,000 - 100,000;168;34;134;36;56;8
844050;Desert Child;Action, Adventure, Casual, Free to Play, Indie, RPG, Strategy, Early Access;0 - 20,000;159;123;36;209;415;1
844060;Reality Blender;Action, Adventure, Indie, RPG, Early Access;0 - 20,000;8;6;2;0;0;0
844090;Piano Simulator;Adventure, Indie;0 - 20,000;2;14;-12;0;0;0
844130;Future Proof;Action, Indie;0 - 20,000;62;8;54;0;0;0
844140;Trivia Vault: Soccer Trivia;Action, Indie;0 - 20,000;29;26;3;0;0;0
844160;Chocolate makes you happy 5;Casual, Indie;0 - 20,000;64;21;43;0;0;0
844160;Chocolate makes you happy 5;Indie;0 - 20,000;64;21;43;0;0;0
844180;Slab;Adventure, Casual, Indie;0 - 20,000;62;15;47;0;0;0
844180;Slab;Casual, Indie, Strategy;0 - 20,000;62;15;47;0;0;0
844210;Titty Crush;Action, Indie;0 - 20,000;50;31;19;4;4;1
844210;Titty Crush;Indie;0 - 20,000;50;31;19;4;4;1
844250;GameMaster: MAGUS;Adventure, Indie;0 - 20,000;2;6;-4;0;0;0
844260;Rustler (Grand Theft Horse);Casual, Indie, Sports, Strategy, Early Access;50,000 - 100,000;943;304;639;163;202;8
844290;Sniper Squad Mission;Action, Casual, Indie;0 - 20,000;6;19;-13;0;0;0
844300;Demolition Engineer;Action, Indie, RPG, Simulation, Sports, Early Access;0 - 20,000;10;18;-8;0;0;0
844310;Curling World Cup;Simulation;0 - 20,000;8;22;-14;0;0;0
844330;The Goatman;Indie;100,000 - 200,000;291;138;153;0;0;3
844350;Obscurity;Indie, Strategy;20,000 - 50,000;2;8;-6;0;0;0
844380;Cave Digger VR;Action, Indie, Racing;50,000 - 100,000;265;81;184;38;64;1
844390;Deadly Flare;Action, Casual, Indie;0 - 20,000;87;35;52;272;272;0
844420;Demon's Rise - Lords of Chaos;Adventure, Indie, RPG;20,000 - 50,000;125;25;100;0;0;3
844440;The Indie Game Legend 3D;Strategy;0 - 20,000;13;1;12;0;0;0
844490;Rhombus Legends;Casual, Indie;0 - 20,000;26;19;7;0;0;0
844500;Draw a Stickman: EPIC 3;Action, Casual, Simulation, Strategy;0 - 20,000;91;52;39;0;0;2
844520;RECOIL;Action, Casual, Simulation, Strategy;0 - 20,000;2;1;1;0;0;0
844580;Jungle Juggle;Adventure, Indie;0 - 20,000;0;1;-1;0;0;0
844590;Hypnospace Outlaw;Indie, Strategy;200,000 - 500,000;2997;74;2923;439;357;36
844610;Hentai PuZZles;Action, Casual, Indie;0 - 20,000;4;7;-3;0;0;0
844620;Odyssee;Action, Casual, Simulation;0 - 20,000;1;1;0;0;0;0
844660;Heart of the Woods;Casual, Indie, Strategy;20,000 - 50,000;678;25;653;576;576;4
844670;Please Be Happy;Action, Adventure, Casual, Indie;0 - 20,000;144;2;142;696;696;5
844750;Go-Kart Racing;Casual, Indie, Strategy;0 - 20,000;75;57;18;7;7;0
844760;The Armclaw Experiment;Casual, Free to Play, Indie, Strategy;0 - 20,000;4;4;0;0;0;0
844820;Ocean Wonder VR;Casual, Free to Play, Indie;0 - 20,000;2;1;1;0;0;0
844850;Tower Hunter: Erza's Trial;Action, Casual, Indie;50,000 - 100,000;1194;377;817;198;249;7
844860;Tank Operations: European Campaign;Action, Casual, Indie, Sports;0 - 20,000;70;9;61;0;0;1
844870;KurtzPel;Action, Casual, Indie;5,000,000 - 10,000,000;21518;13236;8282;4300;107;126
844880;VR-X Player Steam Edition;Action, Casual, Indie;0 - 20,000;11;7;4;0;0;0
844900;Director of Football;Action, Casual, Indie;0 - 20,000;7;4;3;0;0;0
844920;Fortissimo FA;Casual, Indie, Simulation, Strategy;20,000 - 50,000;261;52;209;72;72;2
844930;Fox Hime Zero;Casual, Indie;100,000 - 200,000;4367;107;4260;232;287;5
844940;Have a N.I.C.E day!;Racing;0 - 20,000;3;1;2;0;0;0
844950;Eternal Fantasy;Casual, Indie, Simulation;0 - 20,000;38;12;26;0;0;0
844960;Pro 11 - Football Manager Game;Action, Free to Play, Indie;50,000 - 100,000;161;58;103;0;0;21
844970;Cowboy : Attack of Wild Animal;Action, Casual, Indie;0 - 20,000;9;0;9;0;0;0
844990;Drone Striker;Action, Indie, Simulation, Sports, Strategy;0 - 20,000;1;1;0;0;0;0
845030;Evergate;Action, Adventure, Indie;0 - 20,000;118;4;114;11;11;0
845040;AegisM;Casual, Indie;0 - 20,000;39;3;36;0;0;0
845050;Last Regiment;Action, Indie;0 - 20,000;69;4;65;0;0;1
845070;The Awesome Adventures of Captain Spirit;Casual, Indie;2,000,000 - 5,000,000;11840;930;10910;182;58;28
845110;Snakelike;Action, Indie, Racing, Early Access;0 - 20,000;1;0;1;0;0;0
845150;Vietnam War PuZZles;Adventure, Casual, Indie;20,000 - 50,000;38;18;20;0;0;0
845170;Block Smashers VR;Casual, Indie;0 - 20,000;0;1;-1;0;0;0
845200;❂ Hexaluga ❂ Weapon and Shield ☯;Action, Casual, Indie;0 - 20,000;11;20;-9;0;0;0
845210;Sim Racing Telemetry;Indie, Simulation, Early Access;0 - 20,000;51;16;35;1;1;8
845250;Fish Tycoon 2: Virtual Aquarium;Indie, RPG;50,000 - 100,000;114;87;27;13;13;15
845270;Mirror Drop;Adventure, Indie;0 - 20,000;59;4;55;0;0;0
845270;Mirror Drop;Adventure, Casual, Indie, RPG, Early Access;0 - 20,000;59;4;55;0;0;0
845290;Destructions;Action, Adventure, Casual, Simulation;0 - 20,000;23;5;18;0;0;0
845330;Sign Here: _________;Casual;0 - 20,000;7;12;-5;0;0;0
845350;Color Path;Action, Casual, Indie;0 - 20,000;9;3;6;0;0;0
845400;Club Dance Party VR;Violent, Gore, Adventure, Indie;0 - 20,000;7;15;-8;0;0;0
845410;Party Mixer 3D;Action, Indie, Early Access;0 - 20,000;1;5;-4;0;0;0
845420;DJ Mix Pads;Action;0 - 20,000;24;11;13;0;0;0
845440;World Of Walking Cities;Indie, Strategy;0 - 20,000;3;16;-13;0;0;0
845460;Make Route;Casual, Indie;0 - 20,000;5;3;2;0;0;0
845480;Kinaman vs Gray Elephant;Adventure, Casual, Free to Play, Indie;0 - 20,000;13;24;-11;0;0;0
845490;RESEQUENCED;Action, RPG, Early Access;0 - 20,000;60;31;29;0;0;0
845510;DiyMachinery （自定义机械）;Action, Adventure, Casual, Indie;0 - 20,000;1;0;1;0;0;0
845520;Hard Work;Action, Indie;0 - 20,000;3;9;-6;0;0;0
845530;Imperialism: The Dark Continent;Indie;20,000 - 50,000;9;33;-24;0;0;0
845570;Super Punchman;Action, Indie, RPG;20,000 - 50,000;2;11;-9;0;0;0
845590;God is a Cube: Programming Robot Cubes;Casual, Indie;0 - 20,000;14;6;8;0;0;0
845600;Waking Violet;Casual, Indie;0 - 20,000;8;0;8;0;0;0
845630;Disdoored;Action, Adventure;0 - 20,000;19;14;5;0;0;0
845650;Meteor Shower;Gore, Action, Adventure, Indie, RPG, Simulation, Early Access;0 - 20,000;15;2;13;0;0;0
845690;Rats, Bats, and Bones;Indie;0 - 20,000;64;7;57;0;0;0
845700;Mushroom: The Ruckus;Action, Adventure, Indie, RPG, Early Access;0 - 20,000;6;1;5;0;0;0
845730;Russian Prison Sport: OCHKO;Action, Early Access;0 - 20,000;23;13;10;0;0;0
845750;Don't Play With Dolls;Action, Early Access;0 - 20,000;24;3;21;0;0;0
845820;Lighter Than AR;Action, Indie, Strategy, Early Access;0 - 20,000;5;4;1;0;0;0
845840;Laser Maze;Adventure, Casual, Free to Play, Indie;0 - 20,000;16;1;15;0;0;0
845860;Gem Rush;Action, Adventure;0 - 20,000;14;1;13;0;0;0
845870;BlackFaith;Indie, Strategy;20,000 - 50,000;143;269;-126;0;0;0
845880;Touhou: Scarlet Curiosity;Action, Casual, Indie, Simulation, Sports;20,000 - 50,000;950;72;878;395;767;3
845890;Moonbreaker;Action, Adventure;20,000 - 50,000;477;112;365;0;0;14
845900;Awake: Episode One;Adventure, Casual, Indie, Simulation;0 - 20,000;34;10;24;0;0;0
845940;Brickfest;Adventure, Indie, Massively Multiplayer, RPG, Strategy;0 - 20,000;9;1;8;0;0;0
845960;Furries & Scalies & Bears OH MY!;Action, Casual, Indie;0 - 20,000;8;8;0;0;0;0
845970;Trivia Vault: Movie Trivia;Adventure, Casual, Indie, Animation & Modeling, Education, Video Production;0 - 20,000;34;23;11;0;0;0
846000;Vinnie's Diary;Adventure, Casual, Indie;0 - 20,000;0;0;0;0;0;0
846010;Visceral Cubes;Action;0 - 20,000;21;12;9;6;6;0
846020;YOMOTSU;Free to Play;0 - 20,000;5;2;3;0;0;0
846030;ΔV: Rings of Saturn;Adventure, Casual, RPG, Simulation, Strategy;100,000 - 200,000;1319;80;1239;138;209;63
846050;Silent Depth 3D Submarine Simulation;Action, Casual;0 - 20,000;30;25;5;0;0;1
846080;Where Thoughts Go;Action, Adventure, Indie, RPG, Early Access;0 - 20,000;27;2;25;0;0;0
846110;The friends of Ringo Ishikawa;Casual, Indie, Strategy;50,000 - 100,000;1515;193;1322;131;242;28
846120;Hello Pollution!;Adventure, Casual, Indie, Simulation;0 - 20,000;17;53;-36;0;0;1
846130;Guardians Of The Past;Action, Adventure, Indie, Early Access;0 - 20,000;6;2;4;0;0;0
846200;Bastard;Indie;50,000 - 100,000;84;57;27;32;32;1
846210;Sea Explorer;Casual, Free to Play;0 - 20,000;5;1;4;0;0;0
846220;Catsapults;Casual, Indie, Simulation;0 - 20,000;3;0;3;0;0;0
846250;Devious;Action, Adventure, Indie;0 - 20,000;3;2;1;0;0;0
846260;Murderous Pursuits Beta;Action;0 - 20,000;0;0;0;0;0;0
846320;AI Vendetta;Casual, Indie, Strategy;0 - 20,000;1;0;1;0;0;0
846330;Forests of Augusta;Casual, Indie, RPG;0 - 20,000;9;1;8;0;0;0
846340;Obliteracy;Adventure, Casual, Indie, RPG, Simulation;0 - 20,000;21;6;15;0;0;0
846370;OboStar;Action, Casual, Indie;0 - 20,000;3;7;-4;0;0;0
846470;Moss;Adventure, Casual, Indie;200,000 - 500,000;2648;135;2513;191;219;8
846490;Dragon Defense;Casual, Indie, Racing;0 - 20,000;4;0;4;0;0;0
846530;LifeGameSimulator;Sexual Content, Action, Adventure, Casual, Indie, RPG, Early Access;20,000 - 50,000;0;1;-1;0;0;0
846660;Cicadas - The IQA Edition;Casual, Indie;0 - 20,000;8;12;-4;0;0;0
846670;Saint Slaughter X Days;Action, Casual, Indie;0 - 20,000;183;10;173;0;0;0
846690;Lost Lands: Ice Spell;Adventure, Indie;0 - 20,000;72;5;67;0;0;0
846690;Lost Lands: Ice Spell;Casual, Indie;0 - 20,000;72;5;67;0;0;0
846710;De'Vine: World of Shadows;Indie, Simulation;0 - 20,000;24;6;18;0;0;0
846730;RUGBY 20;Casual, Indie, Simulation, Early Access;0 - 20,000;131;59;72;1027;1027;6
846770;DYSMANTLE;Action;200,000 - 500,000;1642;104;1538;937;771;199
846780;JumpStream;Action, Casual, Indie;20,000 - 50,000;10;7;3;0;0;0
846800;Diner Bros;Action, Casual, Indie;50,000 - 100,000;609;73;536;666;666;17
846820;Tell Me Everything;Casual, Indie;50,000 - 100,000;32;20;12;0;0;1
846830;PartyLine VR;Gore, RPG;0 - 20,000;7;7;0;0;0;0
846850;DearCraft;Action, Casual, Indie;0 - 20,000;5;8;-3;0;0;0
846870;Yooka-Laylee and the Impossible Lair;Adventure, Indie;100,000 - 200,000;825;149;676;1626;1646;13
846880;The Chronicles of Quiver Dick;Adventure, Indie;20,000 - 50,000;177;9;168;0;0;0
847100;Тридевятые земли(Свет или тьма);Action, Adventure, Indie;0 - 20,000;4;0;4;0;0;0
847230;Turn-Based Champion;Action, Adventure, Indie;0 - 20,000;5;2;3;0;0;0
847240;Zombie Commander;Indie, RPG;;;;0;;;
847260;Deep Dark Labyrinth;Action, Indie, Simulation, Early Access;0 - 20,000;5;11;-6;0;0;0
847290;Community College Hero: Knowledge is Power;Action, Adventure, Casual, Indie, RPG;0 - 20,000;26;4;22;0;0;0
847300;Doomsday on Demand 2;Action, Indie;0 - 20,000;2;4;-2;0;0;0
847310;Doomsday on Demand;Casual, Indie, Simulation;0 - 20,000;3;4;-1;0;0;0
847360;Super Lucky's Tale;Indie;20,000 - 50,000;463;72;391;403;403;6
847370;Sunset Overdrive;Adventure, Casual, Indie, RPG;500,000 - 1,000,000;8737;943;7794;440;199;85
847390;Barrel Boot Camp;Casual, Indie;0 - 20,000;7;6;1;0;0;0
847450;Solenars Edge Heroes;Violent, Action, Casual, Indie, Simulation;0 - 20,000;20;9;11;0;0;0
847460;Trapped;Adventure, RPG;0 - 20,000;2;0;2;0;0;0
847490;Star Speeder;Action, Indie, Early Access;0 - 20,000;4;0;4;0;0;0
847510;Roller;Adventure, Indie, RPG;0 - 20,000;3;5;-2;0;0;0
847530;HyperBowl;Audio Production, Education, Software Training, Utilities, Early Access;0 - 20,000;47;4;43;0;0;0
847560;Our Hero! First;Utilities;0 - 20,000;25;0;25;0;0;0
847570;How About Spikes;Action, Adventure, Casual, Indie, Simulation;0 - 20,000;4;3;1;0;0;0
847580;Truth: Disorder II;Indie;0 - 20,000;4;17;-13;0;0;0
847590;Sword of the Black Stone;Action, Adventure, Indie;0 - 20,000;13;4;9;0;0;0
847590;Sword of the Black Stone;Action, Adventure;0 - 20,000;13;4;9;0;0;0
847600;Rapid;Casual, Free to Play, Indie, RPG, Strategy, Early Access;0 - 20,000;1;3;-2;0;0;0
847630;Commanager Tycoon;Adventure, Casual, Indie;0 - 20,000;15;10;5;0;0;0
847650;Virtual Reality Experiment Framework;Casual, Indie, Simulation;0 - 20,000;6;5;1;0;0;0
847680;Pale Cachexia;Action;0 - 20,000;32;0;32;0;0;0
847780;Castle of the Underdogs : Episode 1;Action, Casual, Indie;0 - 20,000;16;1;15;0;0;0
847790;Indentured Servant;Action, Indie;0 - 20,000;14;1;13;0;0;0
847800;Toybit Quest;Action, Casual, Indie;0 - 20,000;4;0;4;0;0;0
847810;Endless Horizon;Casual, Indie;0 - 20,000;1;0;1;0;0;0
847860;Die In The Dark;Action, Indie;0 - 20,000;4;5;-1;0;0;0
847870;Monster Truck Drive;Casual, Indie, Strategy, Early Access;0 - 20,000;1;1;0;0;0;0
847890;小黄条/YYNote;RPG;0 - 20,000;42;11;31;2;4;1
847900;DeathTolls Experience;Action;0 - 20,000;18;2;16;0;0;0
847940;Suki's Spooky Romance;Casual, Massively Multiplayer, Early Access;0 - 20,000;2;0;2;0;0;0
847950;Yakuza Kiss;Casual, Indie;0 - 20,000;33;8;25;0;0;0
848010;Find your way;Indie;0 - 20,000;216;109;107;0;0;0
848030;Roundguard;Casual, Indie, Simulation, Early Access;100,000 - 200,000;336;49;287;102;102;3
848050;GP Bikes;Indie;0 - 20,000;204;11;193;0;0;22
848060;Story of a Gladiator;Violent, Gore, Action, Adventure, Casual, Indie, Racing, Simulation, Sports;20,000 - 50,000;134;34;100;0;0;1
848070;UFO Simulator Control Master;Action;0 - 20,000;1;0;1;0;0;0
848080;Depths of Sanity;Action, Adventure, Indie, RPG;0 - 20,000;30;0;30;0;0;1
848090;BATTER BURST;Casual, Indie, Simulation, Early Access;0 - 20,000;1;0;1;0;0;0
848100;Maze Madness;Action, Indie;0 - 20,000;1;0;1;0;0;0
848150;Fury Fighter VR;Adventure, Indie, RPG;0 - 20,000;0;7;-7;0;0;0
848170;Movavi Video Converter Premium 18;Indie, RPG;0 - 20,000;28;5;23;0;0;0
848200;Azuran Tales: Trials;Adventure, Indie;0 - 20,000;27;10;17;0;0;0
848230;Let's Go Nuts!;Audio Production, Utilities, Video Production, Early Access;0 - 20,000;29;3;26;0;0;1
848260;Super GTR Racing;Casual, Indie;20,000 - 50,000;24;17;7;0;0;0
848270;Sky Conqueror;Action, Casual, Indie, Strategy;0 - 20,000;6;1;5;0;0;0
848280;Viki Spotter: Space Mission;Action, Adventure, Indie, RPG, Early Access;20,000 - 50,000;118;5;113;0;0;1
848300;GROW: Wild West;Adventure, Indie;0 - 20,000;22;12;10;0;0;0
848300;GROW: Wild West;Adventure, Casual, Indie, Early Access;0 - 20,000;22;12;10;0;0;0
848310;Bitcoin Trading Master: Simulator;Adventure, Free to Play, Indie, RPG;20,000 - 50,000;136;81;55;351;351;0
848330;Pride Run;Action, Casual, Indie, RPG, Simulation;0 - 20,000;27;8;19;0;0;0
848340;AGE;Action, Adventure, Casual, Indie, Early Access;0 - 20,000;14;3;11;0;0;0
848350;Katamari Damacy REROLL;Racing, Early Access;200,000 - 500,000;4109;308;3801;477;248;155
848400;Simian Rising;Action, Adventure, Casual, Indie, Simulation;0 - 20,000;0;0;0;0;0;0
848430;Freakout: Calamity TV Show;Casual, Sports;0 - 20,000;25;4;21;0;0;0
848450;Subnautica: Below Zero;Action, Indie, Racing, Simulation;2,000,000 - 5,000,000;67994;6534;61460;1709;1309;1660
848460;Aurum Kings;Indie, Strategy, Early Access;0 - 20,000;0;1;-1;0;0;0
848470;Action Card Football;Video Production;0 - 20,000;2;0;2;0;0;0
848480;Creeper World 4;Adventure, Casual, Indie;200,000 - 500,000;3139;137;3002;1141;1515;385
848500;Sniper Strike: Special Ops;Adventure, Casual, Indie;50,000 - 100,000;167;119;48;0;0;47
848520;Super Destronaut DX;Adventure, Indie;0 - 20,000;69;9;60;0;0;0
848530;Cyberemo 2007;Indie, Racing, Simulation, Sports, Early Access;0 - 20,000;82;28;54;0;0;0
848550;Welcome Back To 2007 Part II;Action, Indie;20,000 - 50,000;247;201;46;0;0;0
848610;Adult Toy Store;Adventure, Casual, Indie;0 - 20,000;2;7;-5;0;0;0
848630;Dinosaur Hunter;Casual, Indie, Strategy;0 - 20,000;6;6;0;0;0;0
848660;Cool Headed;Casual, Indie;0 - 20,000;9;0;9;0;0;0
848700;Toki Time Trial;Indie, Simulation, Strategy, Early Access;0 - 20,000;69;4;65;0;0;0
848710;Defendion;Action, Casual, Indie;0 - 20,000;4;5;-1;0;0;0
848720;Z.W!;Action, Indie, Early Access;0 - 20,000;3;1;2;0;0;0
848730;The Boy Who Typed Wolf;Adventure, Casual, Free to Play, Indie;0 - 20,000;1;4;-3;0;0;0
848740;Lazergoat: Invasion;Action, Indie, Racing, Early Access;0 - 20,000;1;1;0;0;0;0
848750;Space Drop;Action, Casual, Indie;0 - 20,000;1;0;1;0;0;0
848770;Krystal the Adventurer;Adventure, Indie;0 - 20,000;14;0;14;0;0;0
848780;Star Tower;Action, Adventure, Casual;0 - 20,000;1;0;1;0;0;0
848810;Bug Splatt;Adventure, Free to Play, Indie, RPG;0 - 20,000;1;1;0;0;0;0
848890;Afelhem;Adventure, Casual;0 - 20,000;6;4;2;0;0;0
848920;Bitsy Bits;Adventure, Casual;0 - 20,000;2;0;2;0;0;0
848930;Rising Dusk;Adventure;0 - 20,000;66;14;52;0;0;0
848960;Gotcha Racing 2nd;Casual, Indie;0 - 20,000;7;11;-4;0;0;0
849000;Open The Door;Adventure, Casual, Indie, RPG, Early Access;0 - 20,000;18;1;17;0;0;0
849070;Black Home 2;Action, Indie;0 - 20,000;2;7;-5;0;0;0
849090;Fightworld;Adventure, Casual;0 - 20,000;20;17;3;0;0;0
849140;Midnight Caravan;Action, Adventure, Casual, Indie;0 - 20,000;12;4;8;0;0;0
849210;Raccoo Venture;Casual, Simulation, Early Access;20,000 - 50,000;76;5;71;0;0;1
849270;Soccer Nations Battle;RPG;0 - 20,000;8;5;3;0;0;0
849320;Tank Rush;Sexual Content, Indie, RPG;20,000 - 50,000;10;71;-61;0;0;0
849340;zeMa;Adventure, Casual;0 - 20,000;2;0;2;0;0;0
849350;Realistic Illusion;Adventure, Casual, Indie;20,000 - 50,000;4;1;3;0;0;0
849350;Realistic Illusion;Casual;20,000 - 50,000;4;1;3;0;0;0
849360;Wrecking Towers;Simulation, Strategy;0 - 20,000;7;2;5;0;0;0
849360;Wrecking Towers;Indie;0 - 20,000;7;2;5;0;0;0
849390;Valerian Tales;Action, Casual;0 - 20,000;1;1;0;0;0;0
849410;Poop Slinger;Adventure, Casual, Indie, Massively Multiplayer, Strategy, Early Access;0 - 20,000;2;1;1;0;0;0
849520;Rheum;Action, Adventure;0 - 20,000;17;3;14;0;0;0
849560;The Road to Canterbury;Indie;0 - 20,000;11;4;7;0;0;0
849600;Sandbox Showdown;Indie, RPG;0 - 20,000;12;6;6;0;0;0
849620;Trivia Vault: Celebrity Trivia;Action, Casual, Indie;0 - 20,000;33;29;4;1;1;1
849620;Trivia Vault: Celebrity Trivia;Adventure, Indie, RPG;0 - 20,000;33;29;4;1;1;1
849630;Wolf Balls;Casual, Indie;0 - 20,000;13;0;13;0;0;0
849670;Oval;Action, Adventure, Casual, Indie, RPG, Simulation, Strategy;0 - 20,000;37;4;33;0;0;0
849680;TimeTekker;Action, Adventure, Casual, Indie, RPG;0 - 20,000;41;4;37;1;1;1
849690;Ghost Mountain Roller Coaster;Casual, Indie;0 - 20,000;4;4;0;0;0;0
849740;Love Esquire - RPG/Dating Sim/Visual Novel;Indie, Strategy, Early Access;20,000 - 50,000;897;88;809;484;484;8
849790;Firmament Wars;Indie, Strategy;0 - 20,000;38;15;23;0;0;0
849800;Mermaid Mission: Titanic;Indie, Racing;0 - 20,000;34;3;31;0;0;0
849840;Imperi II;Casual;20,000 - 50,000;2;2;0;0;0;0
849860;The Risen Dead VR;Casual, Indie, Racing;0 - 20,000;1;7;-6;0;0;0
849870;Virtual Pirate VR;Action, Simulation, Sports;0 - 20,000;0;3;-3;0;0;0
849880;Journey of the Fox;Action, Adventure, Indie;0 - 20,000;0;1;-1;0;0;0
849920;Dungeon Quest;Action, Indie, Simulation;0 - 20,000;9;1;8;0;0;1
849940;Freefall Tournament;Casual, Indie;50,000 - 100,000;68;28;40;0;0;2
849970;Forgotten Realm RPG;Indie, Simulation;0 - 20,000;4;3;1;0;0;0
849980;Color by Numbers - Dinosaurs;Action, Adventure, Casual, Indie, RPG;0 - 20,000;7;0;7;0;0;1
850000;Noel the Mortal Fate S1-7;Casual, Indie;50,000 - 100,000;1712;80;1632;37;47;32
850040;PuzzGun;Action;0 - 20,000;16;1;15;0;0;0
850050;Achievement Idler: Red;Action, Casual, Indie;0 - 20,000;206;31;175;67;133;1
850060;Anima: Gate of Memories - The Nameless Chronicles;Action, Adventure, Indie, RPG;0 - 20,000;72;19;53;0;0;1
850110;Number Guesser;Action, Adventure, Casual, Indie;20,000 - 50,000;9;5;4;0;0;0
850230;Women's Soccer/Football Manager;Casual, Indie, Sports, Early Access;20,000 - 50,000;66;31;35;0;0;2
850250;Dark Matter;Action, Free to Play, Indie, Simulation, Strategy;0 - 20,000;6;14;-8;0;0;0
850270;Kaleido Chaos;Action, Casual, Massively Multiplayer;0 - 20,000;1;5;-4;0;0;0
850290;Grimmwood Open Beta;Indie;50,000 - 100,000;188;84;104;218;218;0
850310;Deadly Station;Casual;0 - 20,000;14;17;-3;0;0;0
850310;Deadly Station;Casual, Indie;0 - 20,000;14;17;-3;0;0;0
850320;PHOGS!;Indie, Simulation;0 - 20,000;512;61;451;114;128;6
850320;PHOGS!;Violent, Action, Indie, Simulation, Early Access;0 - 20,000;512;61;451;114;128;6
850330;best game eu;Casual, Indie;20,000 - 50,000;90;22;68;0;0;0
850340;Deep Voyage;Casual, Indie, Simulation;0 - 20,000;4;0;4;0;0;0
850450;Escape First;Casual, Indie, Simulation, Strategy, Early Access;50,000 - 100,000;257;133;124;100;100;7
850500;Slum Ball VR Tournament;Sexual Content, Nudity, Violent, Gore, Free to Play, RPG;50,000 - 100,000;40;4;36;69;47;0
850550;World of Virtual Reality VR;Audio Production, Utilities;0 - 20,000;0;3;-3;0;0;0
850630;Starting The Game;Casual, Indie;20,000 - 50,000;348;64;284;1469;2925;0
850690;Crying is not Enough: Remastered;Indie, Simulation, Strategy;20,000 - 50,000;84;95;-11;0;0;0
850710;Skip's Sanity;Action, Adventure, Indie, RPG;0 - 20,000;12;2;10;0;0;0
850740;The Princess Adventure;Adventure, Indie, RPG;0 - 20,000;4;7;-3;0;0;0
850760;UnderDungeon;Audio Production;0 - 20,000;41;2;39;0;0;0
850780;Battle Royale Bootcamp;Strategy;0 - 20,000;12;8;4;0;0;0
850810;Kara's Darkness Chapter One;Indie;0 - 20,000;2;5;-3;0;0;0
850820;祛魅·教化（祛魅1）;Action, Adventure, Indie, RPG;20,000 - 50,000;61;19;42;0;0;1
850830;Adventure in Kana Village;Casual;0 - 20,000;3;6;-3;0;0;0
850840;Camp Grizzly VR;Action, Indie, RPG;0 - 20,000;3;2;1;0;0;0
850880;Vegetaball;Utilities, Early Access;0 - 20,000;7;0;7;0;0;0
850920;Hypersonic Speed Girl / 超速少女;Action, Casual, Indie, Racing;0 - 20,000;10;0;10;0;0;0
850930;MODERN ROAD-LIKE;Action, Indie;20,000 - 50,000;2;0;2;0;0;0
850940;Space Colonizers Idle Clicker;Action, Adventure;0 - 20,000;10;14;-4;0;0;0
850950;Helicopter Flight Simulator;Indie;0 - 20,000;3;11;-8;0;0;0
850960;Jurassic Safari Hunt;Action, Casual, Indie, Simulation;0 - 20,000;7;19;-12;0;0;0
850970;Plunker;Adventure, Indie;0 - 20,000;2;3;-1;0;0;0
850980;GUILTY GEAR;Adventure, Indie;20,000 - 50,000;311;50;261;0;0;1
851000;Achievement Machine;Action;50,000 - 100,000;157;41;116;105;105;0
851010;Airplane Sky Voyage;Action, Casual, Indie, Sports;0 - 20,000;7;15;-8;0;0;0
851040;Darkest Mana : Master of the Table;Adventure, Indie, Simulation, Strategy, Early Access;0 - 20,000;1;2;-1;0;0;0
851050;Paper Dolls VR;Adventure, Indie, RPG;0 - 20,000;50;37;13;0;0;1
851100;Touhou Luna Nights;Action, Casual, Indie, Early Access;500,000 - 1,000,000;11724;264;11460;433;326;28
851110;Idle Racing GO: Clicker Tycoon;Action, Adventure, Simulation;100,000 - 200,000;288;256;32;0;0;12
851150;Burning Knight;Casual, Indie;0 - 20,000;79;20;59;0;0;0
851180;Blood Harvest 3;Action, Casual, Indie;0 - 20,000;151;43;108;120;122;0
851200;Omae Wa Mou Shindeiru;Violent, Adventure;0 - 20,000;29;15;14;0;0;0
851220;Free the Animation;Action, Indie;0 - 20,000;0;1;-1;0;0;0
851240;Journey to Valhalla;Adventure, RPG;0 - 20,000;0;1;-1;0;0;0
851250;Sleeping Dawn VR;Indie;0 - 20,000;6;5;1;0;0;0
851280;MindSeize;Violent, Action, Casual, Indie, Simulation;0 - 20,000;202;61;141;0;0;0
851290;Fesnia;Casual, Indie, Simulation;0 - 20,000;7;13;-6;0;0;0
851320;SlimeGear;Action, Casual, Indie;0 - 20,000;1;0;1;0;0;0
851330;Pizza Connection 3 - Pizza Creator;Indie;0 - 20,000;44;10;34;0;0;1
851350;Let's Play with Nanai!;Action, Indie;0 - 20,000;4;7;-3;0;0;0
851370;EXAELLA OVG;Indie, Simulation, Sports, Strategy, Early Access;0 - 20,000;13;11;2;0;0;0
851490;The Amazing Adventures of Lady Fanny Featherstone;Violent, Adventure, Indie;0 - 20,000;1;0;1;0;0;0
851520;Trivia Vault: TV Trivia;Sexual Content, Adventure, Indie, Simulation;0 - 20,000;31;27;4;2;2;0
851530;Mini-Dead;Casual, Indie;50,000 - 100,000;730;46;684;32;32;1
851570;Zombie Hotel;Action, RPG;0 - 20,000;3;3;0;0;0;0
851580;Planet Unknown Runner;Action, Adventure, Indie, Massively Multiplayer, Early Access;0 - 20,000;12;9;3;0;0;0
851640;Marble Race;Casual, Indie, Simulation, Strategy;0 - 20,000;75;7;68;41;41;2
851650;LOGistICAL: ABC Islands;Casual, Indie, Simulation, Strategy;20,000 - 50,000;42;18;24;1;1;3
851670;LUMINES REMASTERED;Action, Indie, Racing;20,000 - 50,000;420;24;396;29;29;11
851710;Trivia Vault: Art Trivia;Adventure, Indie;0 - 20,000;32;31;1;1;1;0
851730;Sandmade;Action, Indie, Simulation;0 - 20,000;137;12;125;0;0;0
851770;Number Hunt;Action, Adventure, Casual, Indie, Early Access;0 - 20,000;1;2;-1;0;0;0
851790;AstronTycoon;Adventure, Indie;0 - 20,000;24;9;15;13;13;0
851800;G2 Fighter / 基因特工;Action, Casual, Indie, RPG;50,000 - 100,000;2429;521;1908;1436;1306;6
851810;Ultimate Sudoku Collection;Action, Indie;50,000 - 100,000;106;35;71;428;428;3
851820;Boxes Inc.;Action, Adventure, Indie;0 - 20,000;57;22;35;23;37;0
851850;DRAGON BALL Z: KAKAROT;Action, Adventure, Casual, Indie;1,000,000 - 2,000,000;36659;2665;33994;1672;1585;880
851880;RŌA;Adventure;0 - 20,000;10;9;1;0;0;0
851890;Gal*Gun 2;Action, Adventure, Casual, Indie, RPG;50,000 - 100,000;1280;197;1083;25;28;9
851920;Nova Wing III;Action, Early Access;20,000 - 50,000;1;4;-3;0;0;0
851930;Battle Royale Tycoon;Casual, Strategy;20,000 - 50,000;340;141;199;236;259;0
851940;Dirt Bike Insanity;Action, Adventure, Indie;0 - 20,000;3;5;-2;0;0;0
851950;Heroine of the Sniper;Adventure, Casual, Indie, Racing;20,000 - 50,000;309;16;293;27;27;1
851980;Ball Grabbers;Action, Adventure, Indie;0 - 20,000;28;11;17;0;0;0
852090;Penko Park;Casual, Strategy;0 - 20,000;122;0;122;0;0;1
852110;RetroMaze;Action, Casual, Indie;100,000 - 200,000;1064;39;1025;13;20;1
852160;Jack the Barbarian;Adventure, Casual, Indie;0 - 20,000;24;11;13;2;2;0
852180;Bunker Rush;Adventure, Indie, RPG;0 - 20,000;10;9;1;0;0;0
852190;10 seconds;Audio Production, Utilities;0 - 20,000;5;0;5;0;0;0
852220;Accident;Action, Indie, Sports, Early Access;20,000 - 50,000;929;252;677;89;129;9
852250;Danger Room VR;Adventure, Indie, RPG;20,000 - 50,000;23;9;14;0;0;0
852300;Creature in the Well;Casual, Indie, Sports;20,000 - 50,000;241;67;174;0;0;1
852310;Omega Commando;Adventure, Indie;0 - 20,000;1;0;1;0;0;0
852320;HOLONGLIDE;Casual, Indie, Simulation;0 - 20,000;10;0;10;0;0;0
852340;King Rabbit - Puzzle;Indie;20,000 - 50,000;298;28;270;0;0;2
852390;SwordBounce;Sports, Early Access;0 - 20,000;17;1;16;0;0;0
852420;Warhalla;Action, Adventure, Casual, Indie;0 - 20,000;0;0;0;0;0;0
852500;WorldQuest;Adventure, Casual, Indie, RPG, Strategy;20,000 - 50,000;58;26;32;0;0;0
852530;Atex Brawl;Indie, Strategy;0 - 20,000;7;1;6;0;0;0
852570;A Tale of Pirates: a Dummy Mutiny;Casual, Indie;0 - 20,000;2;1;1;0;0;0
852590;Alone In The Forest VR;Action, Casual, Indie;0 - 20,000;2;1;1;0;0;0
852630;Keiko Everlasting;Action, Adventure, Casual, Indie;0 - 20,000;4;2;2;0;0;0
852650;Barbarroja;Action, Casual, Indie, Simulation;0 - 20,000;0;1;-1;0;0;0
852660;Linear Chicken;Indie, Early Access;0 - 20,000;16;7;9;0;0;0
852720;Voxel Tanks;Indie;0 - 20,000;27;9;18;0;0;0
852750;Paper Shakespeare: Stick Merchant of Venice;Adventure, Casual, Indie, RPG, Simulation, Strategy;0 - 20,000;1;1;0;0;0;0
852760;D.F.R.: The Light VR;Action, Adventure, Indie;0 - 20,000;1;0;1;0;0;0
852790;The Adventure of Magical Girl;Action, Adventure, Indie;50,000 - 100,000;104;17;87;0;0;0
852860;Towards a perilous journey;Action, Indie;0 - 20,000;2;4;-2;0;0;0
852880;Ficterra;Violent, Gore, Action, Adventure, Indie, Simulation;0 - 20,000;1;0;1;0;0;0
852900;Space Captain McCallery - Episode 1: Crash Landing;Casual, Indie;20,000 - 50,000;27;5;22;0;0;0
852910;sweet pool;Casual, Indie, RPG;20,000 - 50,000;229;28;201;0;0;2
852920;Bad Bots Rise;Indie, Simulation, Early Access;0 - 20,000;1;7;-6;0;0;0
853000;Generic Jumper;Strategy;0 - 20,000;1;1;0;0;0;0
853020;Venal Soul (Chapter One);Adventure, Casual, Indie;0 - 20,000;10;11;-1;0;0;0
853040;DEEP SPACE | Space-Platformer;Animation & Modeling, Audio Production, Utilities, Video Production;0 - 20,000;10;10;0;0;0;0
853050;El Hijo - A Wild West Tale;Indie;0 - 20,000;137;31;106;0;0;1
853110;Viki Spotter: Sports;Adventure, Indie;20,000 - 50,000;61;5;56;0;0;1
853120;Iron Ground;Casual, Indie;0 - 20,000;2;6;-4;0;0;0
853140;Adeptus Titanicus: Dominus;Action, Simulation, Strategy;0 - 20,000;344;193;151;183;205;1
853200;Shred! 2 - ft Sam Pilgrim;Action, Indie, Racing;0 - 20,000;149;20;129;0;0;2
853220;Doors & Rooms;Action, Adventure, Indie, RPG, Early Access;0 - 20,000;15;3;12;0;0;0
853230;Champions of Titan;Strategy;0 - 20,000;0;0;0;140;210;1
853250;신기록 : A Compendium of Ghosts;Action, Indie;0 - 20,000;78;6;72;0;0;0
853260;Ants! Mission of the salvation;Indie, Strategy;20,000 - 50,000;11;3;8;0;0;0
853290;Claw Breaker;Action, Indie, Strategy;0 - 20,000;1;0;1;0;0;0
853300;The Pizza Delivery Boy Who Saved the World;Action, Indie, Early Access;0 - 20,000;20;1;19;0;0;0
853310;Mr. Maze;Casual, Indie;0 - 20,000;34;8;26;0;0;0
853320;KURT - DER FUSSBALLMANAGER;Casual, Indie, RPG;0 - 20,000;15;6;9;0;0;0
853330;N.I.C.E. 2;Animation & Modeling, Video Production;0 - 20,000;8;5;3;0;0;0
853380;Air Threat;Adventure, Casual, Indie, Simulation;200,000 - 500,000;143;46;97;475;542;0
853410;YAPP2: Yet Another Pushing Puzzler;Casual, Indie, Early Access;0 - 20,000;12;0;12;0;0;0
853450;Nevergrind Online;Adventure, Casual, Indie, RPG;20,000 - 50,000;464;79;385;2299;2299;20
853480;Pestis;Indie;0 - 20,000;73;21;52;0;0;0
853500;Quarantine Circular;Action, Adventure, Indie, RPG;0 - 20,000;352;47;305;0;0;0
853550;Equilinox;Action, Adventure, Indie, RPG, Early Access;100,000 - 200,000;2502;199;2303;285;374;17
853580;Lost;Animation & Modeling;20,000 - 50,000;14;22;-8;0;0;0
853590;Goroons;Indie;0 - 20,000;8;1;7;0;0;0
853610;The Outlaw, The Drunk, & The Whore;Action;0 - 20,000;10;3;7;0;0;0
853620;Stickman in the Portal;Action, Adventure;20,000 - 50,000;41;23;18;0;0;0
853700;Heart of Dixie: GOTY Hyper Combo Edition;Action;0 - 20,000;2;0;2;0;0;0
853760;Space Armor 2;Violent, Adventure, Casual;0 - 20,000;2;5;-3;0;0;0
853770;Maximum Action;Casual, Simulation;200,000 - 500,000;2878;323;2555;222;268;8
853780;BlubBlub: Quest of the Blob;Indie;0 - 20,000;24;8;16;0;0;0
853830;Great Mountain Experience;Action, Indie, Simulation;0 - 20,000;3;8;-5;0;0;0
853850;LOGistICAL: Caribbean;Adventure, Indie;0 - 20,000;5;3;2;0;0;0
853860;aMAZE Classic;Action, Adventure, Casual, Indie, RPG, Early Access;0 - 20,000;217;56;161;1;1;0
853940;Moonfall Ultimate;Action, Casual, Indie, Racing, Sports;0 - 20,000;7;12;-5;0;0;0
853980;Splash;Action, Adventure, Indie, RPG;0 - 20,000;15;1;14;0;0;0
854030;Ancient Journey VR;Action, Adventure, Indie;0 - 20,000;5;6;-1;0;0;0
854060;Bob The Cube;Action, Adventure, Indie;0 - 20,000;17;12;5;0;0;0
854110;AFTER-H;Action, Adventure, Indie;50,000 - 100,000;59;47;12;0;0;1
854120;Subterraneus;Education, Software Training;0 - 20,000;22;0;22;0;0;0
854150;Snail Racer Extreme;Casual, Simulation, Sports;20,000 - 50,000;71;39;32;0;0;0
854160;Dino Dawn;Action, Casual, Free to Play, Indie, Racing;0 - 20,000;11;33;-22;0;0;0
854190;Russian Gangsta In HELL;Adventure, Casual, Indie;0 - 20,000;24;22;2;0;0;0
854250;FPV Freerider;Casual, Indie;;;;0;;;
854250;FPV Freerider;Casual, Indie;;;;0;;;
854310;Rise of Crustaceans;Simulation;0 - 20,000;8;6;2;5823;5823;0
854330;Lost in Spice;Action, Casual, Indie;0 - 20,000;7;2;5;0;0;0
854390;Doors Push or Pull;Adventure, Indie;0 - 20,000;12;2;10;0;0;0
854400;EXCHANGE;Action, Indie, Strategy;0 - 20,000;20;7;13;0;0;0
854450;Arlo The Rabbit;Action, Free to Play, Indie;0 - 20,000;21;1;20;0;0;0
854500;Dawn of the Celestialpod;Adventure, Indie;0 - 20,000;3;1;2;0;0;0
854510;Warlock: Tower Defence;Action, Indie;50,000 - 100,000;1;2;-1;0;0;0
854530;Paper Shakespeare: Stick Julius Caesar (with a dagger);Action, Adventure, Simulation, Early Access;0 - 20,000;0;1;-1;0;0;0
854540;Paper Shakespeare: Loves Labor(s) Lost;Adventure, Casual, Indie;0 - 20,000;1;3;-2;0;0;0
854550;Scary Maze;Action, Casual, Indie;0 - 20,000;12;13;-1;0;0;0
854570;Pamali: Indonesian Folklore Horror;Indie, Simulation, Strategy, Early Access;20,000 - 50,000;486;87;399;0;0;2
854650;Indian Mutiny: Little Sepoy;Action, Adventure, Indie, Simulation;0 - 20,000;3;2;1;0;0;0
854670;HEROES TRIALS;Action, Massively Multiplayer;0 - 20,000;5;0;5;0;0;0
854680;DeepLands;Casual, Indie;0 - 20,000;4;1;3;0;0;0
854690;RollerCoaster Legends II: Thor's Hammer;Action, Indie, RPG;0 - 20,000;11;7;4;0;0;0
854710;CyberLink PowerDVD 18 Standard;Casual;0 - 20,000;1;7;-6;0;0;2
854740;President Pig;Casual, Indie;0 - 20,000;9;5;4;0;0;0
854770;WTF;Adventure, Casual, Indie;0 - 20,000;87;80;7;0;0;0
854810;Simple Sailing;Adventure, Casual, Indie;0 - 20,000;4;13;-9;0;0;0
854830;Washed Up!;Adventure, Casual, RPG;0 - 20,000;13;1;12;0;0;0
854860;Cows VS Vikings;Free to Play, Indie, RPG;20,000 - 50,000;371;57;314;0;0;2
854870;Perseverance: Part 1;Action, Casual, Indie, RPG;0 - 20,000;86;12;74;0;0;0
854940;Ikenfell;Action, Adventure, Indie;50,000 - 100,000;835;85;750;45;45;6
854950;Not Without You;Action, Casual, Indie, Simulation, Strategy, Early Access;0 - 20,000;2;0;2;0;0;0
855010;270 | Two Seventy US Election;Indie;100,000 - 200,000;579;177;402;59;74;22
855050;Thunderbolt 2;Casual, Indie, Simulation, Strategy;20,000 - 50,000;20;9;11;0;0;0
855100;Stop! Dictator Kim Jong-un;Action, Adventure, RPG, Early Access;0 - 20,000;12;4;8;0;0;0
855160;VTree Beach Volleyball;Simulation, Education, Software Training;0 - 20,000;0;3;-3;0;0;0
855190;The Subject;Action, Adventure, Indie;20,000 - 50,000;41;18;23;0;0;0
855390;Ryte - The Eye of Atlantis;Adventure;0 - 20,000;19;12;7;0;0;0
855480;Digital Dungeon;Adventure, Indie;0 - 20,000;0;12;-12;0;0;0
855490;Fury Race;Indie, Strategy;0 - 20,000;8;8;0;0;0;0
855510;VOiD;Casual;0 - 20,000;9;0;9;0;0;0
855530;New Ice York;Action, Adventure, Casual, Indie, Massively Multiplayer;20,000 - 50,000;12;3;9;0;0;0
855550;Coffee Noir - Business Detective Game;Adventure, Indie, RPG;0 - 20,000;44;12;32;0;0;0
855580;Ahlman Arcade 2018;Casual, Free to Play, Indie, Strategy;20,000 - 50,000;19;10;9;0;0;0
855620;Asteroid Deathmatch;Indie, RPG, Simulation, Strategy, Early Access;0 - 20,000;3;0;3;0;0;0
855630;Zeliria Sanctuary;Action, Adventure, Indie;50,000 - 100,000;605;81;524;0;0;1
855640;My Brother Rabbit;Action, Free to Play, Indie;100,000 - 200,000;1483;52;1431;178;178;9
855650;TRIGGER;Casual;0 - 20,000;6;2;4;0;0;0
855670;荒野寻踪;Adventure, Indie;0 - 20,000;2;5;-3;0;0;0
855700;Trippy Jump;Simulation, Sports;0 - 20,000;21;15;6;0;0;0
855730;Plants;Simulation, Sports;20,000 - 50,000;8;1;7;0;0;0
855740;Bum Simulator;Adventure, Free to Play, Indie;50,000 - 100,000;1382;232;1150;169;193;10
855760;Sweet Treats;Casual, Indie;0 - 20,000;2;0;2;0;0;0
855770;UpBoll;Violent, Action, Indie;0 - 20,000;5;0;5;0;0;0
855800;Trek: Travel Around the World;Action, RPG, Simulation, Early Access;0 - 20,000;3;3;0;0;0;0
855850;Space Elite Force;Action, Casual, Indie;0 - 20,000;138;13;125;0;0;1
855860;Superfighters Deluxe;Action, Adventure, Indie;200,000 - 500,000;2298;254;2044;4291;6366;50
855970;Vixens From Outer Space;Action, Adventure, Indie;0 - 20,000;13;8;5;0;0;0
856010;National Machine;;0 - 20,000;36;22;14;0;0;0
856040;Chameleon Man;Adventure, Casual, Indie, RPG;0 - 20,000;1;0;1;0;0;0
856060;蝶生梦影-Butterfly dream shadow;Simulation;0 - 20,000;26;1;25;0;0;1
856070;The Mill Blackbird VR Experience;Action, Adventure, Indie;0 - 20,000;7;0;7;0;0;0
856080;Mind Labyrinth VR Dreams;Action, Indie;0 - 20,000;13;4;9;0;0;0
856100;Little Comet;Action, Indie, Simulation, Strategy;0 - 20,000;2;0;2;0;0;0
856110;Antisnake;Adventure, Casual, Free to Play, RPG;0 - 20,000;18;1;17;0;0;0
856120;Next 4;Casual, Indie;0 - 20,000;110;7;103;0;0;0
856130;Dark SASI;Indie, RPG;20,000 - 50,000;204;117;87;42;60;1
856130;Dark SASI;Casual, Indie;20,000 - 50,000;204;117;87;42;60;1
856160;STAR BARON – VR BEAST COMBAT GAME;Adventure;0 - 20,000;2;0;2;0;0;0
856170;Exo TD;Adventure, Casual, Indie;0 - 20,000;7;3;4;0;0;0
856190;Metori;Casual, Indie, Simulation, Strategy;0 - 20,000;2;1;1;0;0;0
856210;bit Dungeon III;Casual, Indie;20,000 - 50,000;133;43;90;0;0;2
856220;DON'T DIE!;Action;0 - 20,000;34;6;28;0;0;0
856240;Total Singu;Action, Indie;0 - 20,000;3;2;1;0;0;0
856260;100 Chests;Sexual Content, Violent, Gore, Adventure, Indie, Simulation;0 - 20,000;5;5;0;0;0;0
856270;Draid;Adventure, Casual, Indie, Racing, Sports;0 - 20,000;4;4;0;0;0;0
856300;Rust;Casual, Indie;0 - 20,000;8;7;1;0;0;0
856310;Seul (Alone): The entrée;Adventure, Casual, Indie;0 - 20,000;2;1;1;0;0;0
856320;(Removed from steam store);Action, Casual, Indie;0 - 20,000;25;16;9;0;0;0
856350;15 seconds;Action, Casual, Indie;0 - 20,000;11;10;1;0;0;0
856370;One-Way Ticket  / 单程票;Action, Casual, Indie;20,000 - 50,000;234;149;85;0;0;1
856380;Cartoonway : Mini Cars;Adventure, Casual, Indie, Simulation, Sports, Strategy;0 - 20,000;4;3;1;0;0;0
856390;CPRC: Extant Hunters;Action, Casual, Indie, Sports;0 - 20,000;2;0;2;0;0;0
856410;Longest Monday: Unveiling;Adventure, Indie, Strategy;0 - 20,000;4;12;-8;0;0;0
856420;Glow Ball - Not A Billiard Puzzle Game;Action, Indie;0 - 20,000;3;5;-2;0;0;0
856430;Pinball 2018;Action, Free to Play, Indie, Early Access;20,000 - 50,000;27;30;-3;0;0;0
856440;Cube - The Jumper;Action, Adventure, Casual, Indie, RPG, Simulation, Strategy;20,000 - 50,000;61;116;-55;20;20;0
856450;A Story of a Band;Action, Adventure, Indie;0 - 20,000;27;2;25;0;0;0
856490;Falling words;Action, Indie, Simulation;20,000 - 50,000;71;46;25;0;0;0
856540;Super Dangerous Dungeons;RPG, Early Access;0 - 20,000;75;1;74;0;0;1
856550;Stabby Machine;Casual, Strategy;0 - 20,000;2;0;2;0;0;0
856560;Black Roses;Casual, Free to Play, Simulation, Strategy;20,000 - 50,000;1;1;0;0;0;0
856570;Lost Flame;Action, Adventure, Casual, Indie;0 - 20,000;36;0;36;0;0;0
856580;Boo Boo Bananas;Casual, Free to Play;0 - 20,000;4;0;4;0;0;0
856600;Fur the Game;Simulation;20,000 - 50,000;120;13;107;0;0;0
856610;Beacon;Casual, Indie, Strategy;50,000 - 100,000;132;16;116;0;0;0
856620;Vカツ / V-Katsu;Casual, Indie;100,000 - 200,000;472;58;414;76;95;5
856640;English Teaching Assistant VR;Casual, Strategy;0 - 20,000;7;6;1;0;0;0
856650;Pylon Racer;Action, Adventure, Free to Play, Indie;0 - 20,000;6;3;3;0;0;0
856670;Present for Manager;Indie;0 - 20,000;13;0;13;0;0;0
856670;Present for Manager;Adventure, Simulation;0 - 20,000;13;0;13;0;0;0
856730;ARENA 8;Casual, Indie, Simulation;20,000 - 50,000;1;4;-3;0;0;0
856760;Gachi Gang;Casual, Indie;0 - 20,000;14;17;-3;0;0;0
856760;Gachi Gang;Action, Adventure, RPG, Early Access;0 - 20,000;14;17;-3;0;0;0
856770;Hokan: Monster Slayer;Casual, Indie, Simulation, Strategy;0 - 20,000;0;2;-2;0;0;0
856790;Export Simulator;Action, Casual, Indie;0 - 20,000;16;28;-12;0;0;0
856850;AFL Evolution 2;Action, Adventure, Free to Play, Massively Multiplayer, RPG;0 - 20,000;131;32;99;0;0;9
856890;JUSTICE SUCKS: Tactical Vacuum Action;Adventure, Indie, RPG;0 - 20,000;117;1;116;0;0;2
856980;7-in-1 Brain Sharpness Bundle;Action, Adventure, Casual, Indie, Simulation;0 - 20,000;23;15;8;5;5;0
856990;A Long Way Down;Casual, Indie, RPG;0 - 20,000;151;66;85;0;0;0
857010;HUBE: Seeker of Achievements;Violent, Adventure, Indie;0 - 20,000;122;52;70;6;6;0
857020;Putinoids VS Navalnyats - Путиноиды Против Навальнят;Casual, Indie, Strategy;20,000 - 50,000;23;14;9;0;0;0
857050;Casual Penalty;Casual, Free to Play, Indie;0 - 20,000;57;42;15;128;128;0
857060;CCCP CALLS!;Action, Indie, RPG, Strategy;50,000 - 100,000;119;100;19;0;0;0
857080;Escape from the Princess;Action, Adventure, Indie, RPG, Early Access;0 - 20,000;173;24;149;0;0;1
857110;SPACE BLASTER 8 BIT;Adventure, Casual, Indie, Simulation;20,000 - 50,000;1;1;0;0;0;0
857130;Evolution;Sexual Content, Nudity, Casual, Free to Play, Indie;0 - 20,000;20;10;10;0;0;0
857140;Snake, snake, snake!;Action, Casual, Indie, Early Access;0 - 20,000;25;9;16;0;0;0
857180;The Cooking Game VR;Action, Indie;0 - 20,000;37;15;22;0;0;0
857200;Planet Stronghold 2;Casual, Indie, Simulation, Animation & Modeling, Design & Illustration;0 - 20,000;39;3;36;0;0;0
857210;Building Block Heroes: Rush Edition;Action, Indie;0 - 20,000;0;0;0;0;0;0
857240;The Prison Experiment: Battle Royale;Action, Casual;0 - 20,000;32;66;-34;39;40;0
857300;Korvux - Chapter 1;Action, Casual;0 - 20,000;11;3;8;0;0;0
857330;Trainiac;Action, Adventure, Indie;0 - 20,000;8;6;2;0;0;0
857350;CopperCube 6 Game Engine;Casual, Indie, Simulation;200,000 - 500,000;213;55;158;0;0;8
857370;The Entity;Utilities;0 - 20,000;15;22;-7;0;0;0
857420;Just Beat Em Up : World of Fury;Action, Casual, Free to Play, Indie, Strategy;0 - 20,000;26;7;19;0;0;0
857450;ISLAND;Casual, Indie, Simulation, Strategy;20,000 - 50,000;1226;51;1175;313;313;7
857460;∀kashicforce;Action, Indie, Simulation;0 - 20,000;29;6;23;0;0;0
857470;NEKOKORO;Casual, Indie;20,000 - 50,000;79;11;68;0;0;0
857480;Seirei;Casual, Indie;0 - 20,000;35;13;22;0;0;0
857500;BLACK BIRD;Casual, Indie, Simulation, Early Access;0 - 20,000;85;6;79;0;0;1
857510;Knife Flipping;Indie;20,000 - 50,000;12;9;3;0;0;0
857510;Knife Flipping;Indie, Simulation, Early Access;20,000 - 50,000;12;9;3;0;0;0
857520;Degrees;Action, Casual, Indie;0 - 20,000;23;28;-5;0;0;0
857520;Degrees;Free to Play, Indie, RPG;0 - 20,000;23;28;-5;0;0;0
857570;World of Feudal;Action, Casual, Indie, Racing, RPG, Simulation, Sports, Early Access;0 - 20,000;15;27;-12;0;0;0
857590;Ball Fall;Action, Indie;0 - 20,000;2;17;-15;0;0;0
857600;Fight the Horror;Simulation;0 - 20,000;30;29;1;0;0;0
857690;Lagoon Lounge : The Poisonous Fountain;Casual, Indie;0 - 20,000;482;36;446;0;0;1
857700;ZombieHunterZ;Design & Illustration, Photo Editing, Utilities;0 - 20,000;4;11;-7;0;0;0
857710;Fallen Bird;Gore, Adventure, Indie;0 - 20,000;23;4;19;0;0;0
857740;Ludicrous Speed;Free to Play, Indie, Massively Multiplayer, Early Access;0 - 20,000;26;6;20;0;0;0
857760;SAD RPG: A Social Anxiety Role Playing Game;Action, Indie, RPG;20,000 - 50,000;15;10;5;0;0;0
857770;The Risers;Action, Adventure, Indie;0 - 20,000;9;4;5;0;0;0
857850;Dwarf Defense;Adventure;0 - 20,000;21;8;13;0;0;0
857860;Planetary Settlers;Action, Indie;0 - 20,000;10;1;9;0;0;0
857890;RuneTech;Indie, Simulation, Education, Early Access;0 - 20,000;4;3;1;45;45;0
857900;Huge Enemy - Worldbreakers;Action, Adventure, Casual, Indie;0 - 20,000;18;5;13;0;0;0
857940;Nature Calls;Adventure, Casual, Indie;20,000 - 50,000;448;62;386;62;105;0
857950;Incredible Mandy;Adventure, Indie;0 - 20,000;105;11;94;0;0;0
857980;Void Bastards;Casual, Indie;200,000 - 500,000;4026;641;3385;405;346;29
858010;EnchantedGirl - 纯情房东俏房客;Action, Adventure, Casual, Indie, Simulation, Strategy;0 - 20,000;8;19;-11;0;0;0
858050;The Rose of Segunda;Casual, Indie;;;;0;;;
858050;The Rose of Segunda;Casual, Free to Play, Indie;;;;0;;;
858060;Idle Heist;Action, Indie, Early Access;50,000 - 100,000;88;235;-147;10;13;3
858070;Leviathan's Sword;Casual;0 - 20,000;3;0;3;0;0;0
858080;Spoorky;Casual;0 - 20,000;8;1;7;0;0;0
858100;Grimshade;Indie;20,000 - 50,000;102;37;65;337;337;0
858170;The Last Train - Definitive Edition;Adventure, Indie;0 - 20,000;10;10;0;0;0;0
858180;Adventures of Mike;Action, Casual, Indie, RPG;0 - 20,000;4;7;-3;0;0;0
858180;Adventures of Mike;Adventure, Casual, Indie, Simulation;0 - 20,000;4;7;-3;0;0;0
858210;Nova Drift;Action, Casual, Indie;200,000 - 500,000;9082;339;8743;378;379;218
858250;Tainted Fate;Action, Free to Play, Indie;0 - 20,000;13;11;2;0;0;0
858260;Until You Fall;Casual, Indie, Early Access;200,000 - 500,000;2750;157;2593;203;211;13
858320;Itsy Blitzy;Casual, Indie, Racing, Simulation, Sports;0 - 20,000;3;0;3;0;0;0
858360;The Initiate 2: The First Interviews;Casual, Free to Play, Indie, Massively Multiplayer, Simulation, Early Access;0 - 20,000;85;9;76;911;911;0
858380;Expedia Cenote VR;Racing, Simulation, Sports;0 - 20,000;12;6;6;0;0;0
858420;Trivia Vault: Business Trivia;Indie;0 - 20,000;41;33;8;1;1;0
858440;Ninja Midori;Adventure, Casual, Indie;0 - 20,000;10;8;2;1;1;0
858490;Sanctus Mortem;Action, Adventure, Casual, Indie;0 - 20,000;11;2;9;0;0;0
858500;Skelli Tower Defense;Action, Indie;0 - 20,000;0;0;0;0;0;0
858530;Cat Lady;Casual;0 - 20,000;31;4;27;0;0;0
858560;Tet VR;Adventure;0 - 20,000;0;1;-1;0;0;0
858590;Last Tide;Adventure, Casual, Indie, Sports;20,000 - 50,000;732;422;310;131;131;0
858600;Rule The World;Action, Adventure, Indie, Simulation, Strategy, Early Access;0 - 20,000;1;0;1;0;0;0
858630;Aquaculture Land: Fish Farming Simulation;Free to Play, Massively Multiplayer, RPG;20,000 - 50,000;130;30;100;0;0;3
858680;Black Paradox;Casual, Free to Play, Indie, Early Access;0 - 20,000;74;29;45;0;0;1
858680;Black Paradox;Adventure, Indie, RPG;0 - 20,000;74;29;45;0;0;1
858700;The Adventures of 00 Dilly;Action, Indie;0 - 20,000;1;0;1;0;0;0
858730;Yoke Light;Free to Play, Strategy;0 - 20,000;0;0;0;0;0;0
858740;Waves of Death;Action, Adventure, Casual, Indie;0 - 20,000;9;2;7;0;0;0
858760;Scalak;Action, Casual, Indie;20,000 - 50,000;803;20;783;0;0;0
858780;Rent-a-Vice;Action, Casual, Indie;0 - 20,000;14;8;6;0;0;0
858810;Dawn of Man;Adventure, Indie, RPG, Early Access;500,000 - 1,000,000;12853;1981;10872;1144;737;598
858820;Tribes of Midgard;Casual, Indie;1,000,000 - 2,000,000;12500;3916;8584;902;614;1031
858830;Echoes of the Fey: The Last Sacrament;Casual, Indie;0 - 20,000;14;0;14;0;0;0
858840;The Epic Bang Theory;Adventure, Casual, Indie, RPG, Strategy;0 - 20,000;10;11;-1;0;0;0
858860;Tabletop Gods;Indie, Simulation, Sports, Strategy;0 - 20,000;86;10;76;0;0;0
858880;Fragile Fighter;Simulation;0 - 20,000;31;2;29;0;0;0
858900;vSpatial;Casual, Indie;0 - 20,000;41;9;32;0;0;0
858940;Flowers -Le volume sur ete-;Action, Free to Play, Indie, Early Access;20,000 - 50,000;994;3;991;1003;1003;4
858950;Rabbit and the moon;Indie, Simulation;0 - 20,000;7;3;4;0;0;0
858960;Sumo;Casual, Racing, Simulation, Sports;0 - 20,000;8;1;7;0;0;0
859050;360 No Scope!;Utilities;0 - 20,000;1;0;1;0;0;0
859090;Turbo Tunnel;Casual, Indie, Strategy;0 - 20,000;134;16;118;17;17;0
859120;That Tiny Spaceship;Adventure, Casual, Indie, Strategy;0 - 20,000;0;0;0;0;0;0
859150;幻想三國誌5/Fantasia Sango 5;Action, Indie;50,000 - 100,000;170;88;82;0;0;6
859170;Survival;Action, Indie, Early Access;0 - 20,000;0;1;-1;0;0;0
859180;Monster Castle;Action, Indie;20,000 - 50,000;67;40;27;0;0;4
859200;破东荒 - Chaos Of East;Indie, Simulation, Strategy, Early Access;0 - 20,000;46;38;8;0;0;0
859220;Sweeper Zero;Action;0 - 20,000;15;5;10;0;0;0
859280;拯救大魔王重生 Falsemen: Demon Rebirth;Casual, Indie;0 - 20,000;64;28;36;0;0;0
859340;Seeking Dawn;Adventure, Casual, Indie, RPG;20,000 - 50,000;527;243;284;129;198;0
859350;Aces of the Luftwaffe - Squadron;Action, Casual, Indie, Simulation, Early Access;0 - 20,000;63;25;38;0;0;1
859370;in My MIND.;Casual, Sports;0 - 20,000;39;6;33;0;0;0
859380;What's My Gender?;Adventure, Indie;0 - 20,000;4;1;3;0;0;0
859420;Deflection Dimension;Casual, Indie;0 - 20,000;3;0;3;0;0;0
859440;Mars or Die!;Action, Adventure, Indie, RPG, Simulation, Strategy;0 - 20,000;34;36;-2;11;11;0
859460;Small person;Action, Strategy;0 - 20,000;4;4;0;0;0;0
859530;Vive le Roi 2;Casual;0 - 20,000;4;2;2;0;0;0
859560;Escape the Grid VR;Casual, Indie;0 - 20,000;4;2;2;0;0;0
859570;Secret Neighbor: Hello Neighbor Multiplayer;Indie, Simulation, Strategy;500,000 - 1,000,000;13622;1990;11632;268;213;131
859580;Imperator: Rome;Adventure, Casual, Indie, Simulation, Sports;500,000 - 1,000,000;13214;9300;3914;3287;2308;570
859610;S.T.R.E.T.C.H.;Adventure, Casual, Free to Play, Indie;0 - 20,000;11;20;-9;0;0;0
859640;Along Together;Action;0 - 20,000;43;5;38;0;0;0
859660;Discs of Steel Party;Action, Indie;0 - 20,000;3;0;3;0;0;0
859680;Deep Space Waifu: FANTASY;Casual, Indie;20,000 - 50,000;815;28;787;100;101;1
859700;USA 2020;Action, Indie;0 - 20,000;153;28;125;0;0;1
859720;Cubelz;Action, Indie, Early Access;20,000 - 50,000;1;1;0;0;0;0
859740;Don't Notice Me;Action, Adventure, Indie, Racing;0 - 20,000;29;6;23;0;0;0
859820;TripTrip;Casual, Indie, Simulation;0 - 20,000;11;1;10;0;0;0
859860;VikingJourney;Action, Adventure, Indie;0 - 20,000;0;4;-4;0;0;0
859870;Frqncy;Casual, Indie;0 - 20,000;7;2;5;0;0;0
859920;Double Head Shark Attack;Indie, Simulation;0 - 20,000;0;1;-1;0;0;0
859950;The Enthralling Realms;Casual, Indie, RPG, Simulation, Strategy;0 - 20,000;3;0;3;0;0;0
859960;Geocells Tricells;Audio Production, Education, Utilities, Early Access;0 - 20,000;8;0;8;0;0;0
859970;Math Classroom Challenge;Action, Adventure, Casual, Free to Play, Indie;0 - 20,000;1;1;0;0;0;0
859990;Eggs 1942;Action, Adventure, Indie, RPG;0 - 20,000;40;5;35;0;0;0
860000;Cosmic collapse;Action, Indie, Racing, Early Access;200,000 - 500,000;17;2;15;0;0;0
860030;Common Hanzi Quiz - Simplified Chinese;Indie;0 - 20,000;5;0;5;0;0;0
860070;BULLETLINE;Action, Indie, Simulation, Sports;0 - 20,000;12;3;9;0;0;0
860080;lilGunBois;Casual, Strategy;0 - 20,000;26;9;17;2;2;0
860090;Erotic Jigsaw Challenge Vol. 1;Violent, Gore, Action, Adventure, Indie, Simulation;0 - 20,000;21;5;16;0;0;0
860190;Vietcong;Racing, Early Access;0 - 20,000;9;33;-24;0;0;0
860260;Strike Force Remastered;Action, Adventure, Casual, Indie, Massively Multiplayer, Racing, RPG, Simulation, Sports, Strategy;0 - 20,000;2;10;-8;0;0;0
860270;Requiem;Indie, Strategy;0 - 20,000;1;1;0;0;0;0
860320;Apartment 3301;Action, Indie;0 - 20,000;2;2;0;0;0;0
860330;Mutation Mayhem;Casual, Indie, Simulation;20,000 - 50,000;16;6;10;0;0;0
860340;Trivia Vault: Toy Trivia;Action, Casual, Indie, Simulation;0 - 20,000;31;29;2;0;0;0
860350;Trivia Vault: Fashion Trivia;Action, Indie;0 - 20,000;35;33;2;0;0;0
860360;Kogent Defender;Casual, Indie, Strategy;0 - 20,000;1;1;0;0;0;0
860400;Unexpected Journey 奇幻之旅;Casual, Indie, Simulation, Strategy;20,000 - 50,000;3;5;-2;0;0;0
860430;Burgerwise the Clown;Action, Casual, Simulation;0 - 20,000;6;4;2;0;0;0
860440;Goat Life;Casual, Indie;20,000 - 50,000;94;53;41;2;2;0
860450;Module TD. Sci-Fi Tower Defense;Action;0 - 20,000;32;18;14;0;0;3
860480;Fernz Gate;Adventure, Casual, Indie;0 - 20,000;2;3;-1;0;0;0
860490;Revenant Dogma;Adventure, Indie, Simulation;0 - 20,000;5;2;3;0;0;0
860500;SpellFront;Action, Indie;0 - 20,000;28;15;13;0;0;1
860510;Little Nightmares II;Action, Adventure, Indie, RPG;500,000 - 1,000,000;24380;1348;23032;465;375;285
860530;Babycar Driver;Casual, Indie, RPG, Strategy;0 - 20,000;23;11;12;0;0;0
860550;Secrets of the Past: Dion;Action, Casual, Indie, Massively Multiplayer, Strategy, Early Access;0 - 20,000;11;1;10;0;0;0
860570;Music Producer;Simulation, Sports;0 - 20,000;0;6;-6;0;0;0
860580;Wrestlers Without Boundaries;Action;0 - 20,000;4;8;-4;0;0;0
860590;MissileDancer;Action, Indie;0 - 20,000;13;2;11;0;0;0
860600;Betweenside;Indie, Sports, Early Access;0 - 20,000;3;1;2;0;0;0
860620;KURSK;Casual, Indie, Racing;20,000 - 50,000;192;213;-21;229;251;0
860640;Lingotopia;Casual, Indie;0 - 20,000;19;25;-6;0;0;0
860660;To Hell with Hell;Casual;0 - 20,000;53;21;32;0;0;0
860670;❂ Hexaluga ❂ Dungeons and Hunting ☠;Adventure, Casual, Strategy;0 - 20,000;6;14;-8;0;0;0
860680;Smile'N'Slide;Simulation;0 - 20,000;11;5;6;0;0;0
860730;Skinscape;Casual, Indie;0 - 20,000;6;4;2;0;0;0
860770;Made to Order: The Party Game;Action, Indie;0 - 20,000;4;6;-2;0;0;0
860790;Adventures Of Pipi 2 Save Hype;Adventure, Casual, Indie, Strategy, Early Access;0 - 20,000;26;8;18;0;0;0
860790;Adventures Of Pipi 2 Save Hype;Indie;0 - 20,000;26;8;18;0;0;0
860820;Meme Supreme  ¯\_(ツ)_/¯;Action, Casual, Indie, Strategy;0 - 20,000;14;8;6;0;0;0
860870;Bully Store;Casual, Indie;0 - 20,000;4;0;4;0;0;0
860880;Castle: Jigsaw Puzzles;Casual, Indie;0 - 20,000;13;3;10;0;0;0
860880;Castle: Jigsaw Puzzles;Indie, Simulation, Sports;0 - 20,000;13;3;10;0;0;0
860890;Factory Town;Casual, Indie, RPG, Simulation;100,000 - 200,000;3459;328;3131;204;71;133
860900;Bounty Battle;Casual, Indie;0 - 20,000;15;37;-22;0;0;0
860910;Hentai 3018;Violent, Gore, Action, Adventure, Casual, Indie, Simulation;200,000 - 500,000;788;236;552;117;187;1
860930;A Quiet Mind;Adventure, Indie, Strategy;0 - 20,000;1;1;0;0;0;0
860950;Mark of the Ninja: Remastered;Education;200,000 - 500,000;4482;169;4313;382;178;29
860960;N1L (No1Lives);Casual;100,000 - 200,000;6;5;1;0;0;0
860990;Chroma Shift;Adventure, Indie;0 - 20,000;12;6;6;0;0;0
861000;Putinization;Adventure, Casual, Indie, Strategy, Early Access;0 - 20,000;10;8;2;0;0;0
861010;Minako;Action, Adventure, Indie;0 - 20,000;7;2;5;0;0;0
861030;Lovely Fox;Casual, Free to Play, Indie, Simulation, Early Access;0 - 20,000;81;26;55;0;0;0
861030;Lovely Fox;Action, Adventure, Indie, RPG;0 - 20,000;81;26;55;0;0;0
861050;DemonsAreCrazy;Action, Adventure, Indie, RPG;100,000 - 200,000;287;365;-78;0;0;7
861080;Lonia Saga 2;Action;0 - 20,000;10;4;6;0;0;0
861160;Argos - The most difficult VR game in the world;Indie, Strategy;0 - 20,000;6;6;0;0;0;0
861190;Shining Hotel: Lost in Nowhere;Action, Casual;0 - 20,000;8;17;-9;0;0;0
861210;Gaze At Maze;Action, Free to Play, Massively Multiplayer;0 - 20,000;3;8;-5;0;0;0
861230;Arevoatl Seven Coins;Casual, Indie, Simulation;0 - 20,000;18;3;15;0;0;0
861230;Arevoatl Seven Coins;Casual, Indie, Simulation;0 - 20,000;18;3;15;0;0;0
861240;Paper Valley;Casual, Free to Play, Indie;0 - 20,000;19;0;19;0;0;0
861250;Cyber Shadow;Action, Indie, RPG;200,000 - 500,000;953;184;769;301;334;12
861270;Sudoku Killer / 杀手数独;Casual, Indie;20,000 - 50,000;133;14;119;33;33;9
861280;战术狂想2(Chimera of Tactics 2);Action, Indie;0 - 20,000;6;3;3;0;0;0
861290;Shooter Game;Action, Casual, Indie, Sports, Early Access;0 - 20,000;2;5;-3;0;0;0
861330;Dungeon Deathball;Action, Casual, Indie;0 - 20,000;23;0;23;0;0;3
861400;Nefertari: Journey to Eternity;Indie;20,000 - 50,000;194;13;181;0;0;1
861410;Brave Dungeon - The Meaning of Justice -;Casual, Indie;0 - 20,000;9;9;0;0;0;0
861510;Sail Ships;Adventure, Indie;0 - 20,000;0;2;-2;0;0;0
861520;#AkiRobots;Casual, Indie, RPG, Simulation, Strategy;0 - 20,000;28;1;27;0;0;0
861520;#AkiRobots;Adventure, Indie;0 - 20,000;28;1;27;0;0;0
861540;Dicey Dungeons;Adventure, Casual, Indie;200,000 - 500,000;8151;905;7246;1028;889;137
861550;Neon Universe;Action, Adventure, Indie;0 - 20,000;12;12;0;0;0;0
861580;Delve;Action, Casual, Indie;0 - 20,000;2;0;2;0;0;0
861590;Tabletop Creator;Casual, Indie, Simulation, Strategy;0 - 20,000;23;7;16;0;0;7
861650;Session: Skate Sim;Casual, Indie, Simulation, Early Access;200,000 - 500,000;8169;1456;6713;1003;607;264
861670;Street Level: Windows Edition;Adventure, Indie, RPG, Simulation, Strategy;0 - 20,000;4;3;1;0;0;0
861710;Geometry Rush;Action, Free to Play, Indie;20,000 - 50,000;92;14;78;0;0;1
861720;Trivia Vault: Food Trivia;Design & Illustration, Education, Utilities, Early Access;0 - 20,000;41;37;4;0;0;0
861740;Trivia Vault: Literature Trivia;Action, Casual, Indie, Simulation, Strategy;0 - 20,000;28;27;1;0;0;1
861760;Foto Flash 2;Action, Indie, Sports;0 - 20,000;41;19;22;0;0;0
861770;FrogStatue;Casual, Indie;20,000 - 50,000;1;0;1;0;0;0
861770;FrogStatue;Action, Early Access;20,000 - 50,000;1;0;1;0;0;0
861790;Bomb-Bomb;Action, Adventure, Indie, RPG, Strategy, Early Access;0 - 20,000;0;1;-1;0;0;0
861860;Doctor Tsunami;Action, Adventure, Casual, Indie;0 - 20,000;4;0;4;0;0;0
861910;Catch'em;Action, Adventure, Casual, Indie, Racing, RPG, Simulation, Sports, Strategy, Early Access;0 - 20,000;3;2;1;0;0;0
861920;Rocket Valley Tycoon;Simulation;50,000 - 100,000;107;66;41;10;12;0
861930;Kidz;Audio Production, Utilities;50,000 - 100,000;233;38;195;0;0;0
861940;Crashbots;Action, Indie, Early Access;50,000 - 100,000;8;15;-7;0;0;0
861960;Master Pyrox Wizard Smackdown;Action, Indie;0 - 20,000;7;7;0;0;0;0
862110;Super Jigsaw Puzzle: Cities;Casual, Indie;0 - 20,000;62;2;60;0;0;2
862120;Deconstructor;Indie, Simulation, Sports, Strategy;20,000 - 50,000;28;35;-7;0;0;0
862130;Rainy Day Racer;Adventure, Casual, Indie;0 - 20,000;31;0;31;0;0;0
862150;Prison Test;Indie, Simulation, Sports, Strategy;0 - 20,000;23;20;3;0;0;0
862160;Comet Crasher;Indie, RPG;0 - 20,000;63;7;56;0;0;0
862190;Footy Ball Tournament 2018;Adventure, Casual, RPG, Strategy;0 - 20,000;1;3;-2;0;0;0
862200;Bot Tales: The Crashed;Casual, Indie;0 - 20,000;3;0;3;0;0;0
862210;Inca Marbles;Adventure, Indie;50,000 - 100,000;22;23;-1;726;726;0
862240;E3.14CENTER;Casual, Indie;0 - 20,000;4;1;3;0;0;0
862250;Danger!Energy;Indie;0 - 20,000;8;0;8;0;0;0
862260;Miami Cruise;Action, Indie;0 - 20,000;26;7;19;0;0;0
862280;Time Tenshi;Action, Casual, Indie;0 - 20,000;3;7;-4;0;0;0
862300;ROS;Action, Adventure, Indie, RPG;20,000 - 50,000;36;30;6;2;2;0
862370;Yahrit!;Action, Adventure, Indie;0 - 20,000;9;1;8;0;0;0
862390;FlyInside Flight Simulator;Indie, Strategy;0 - 20,000;97;45;52;0;0;0
862440;Angel Wings;Action, Adventure, Indie, RPG, Strategy, Early Access;20,000 - 50,000;543;68;475;0;0;3
862460;To Light: Ex Umbra;Casual, Indie, Simulation;0 - 20,000;14;1;13;0;0;0
862480;The Spiral Scouts;Adventure, Casual, Indie, Strategy;50,000 - 100,000;450;100;350;313;500;1
862490;Fantasy Raiders;Action, Indie;0 - 20,000;10;4;6;0;0;0
862500;Talos VR;Action, Casual, Free to Play, Massively Multiplayer;0 - 20,000;0;4;-4;0;0;0
862520;Lucky Night: Poker Games;Action, Indie;0 - 20,000;0;17;-17;0;0;0
862570;Ding Dong XL;Action, Indie;20,000 - 50,000;691;20;671;99;144;1
862580;OK/NORMAL;Action, Casual, Indie;20,000 - 50,000;441;99;342;40;40;0
862590;BlueFear;Adventure;0 - 20,000;2;7;-5;0;0;0
862640;Heroes Of The Offworld Arena;Action, Adventure, Indie;0 - 20,000;4;7;-3;0;0;0
862650;City Of Jade: Imperial Frontier;Simulation;0 - 20,000;8;20;-12;0;0;0
862690;Kid,napper: Gosh, I'm Kidnapped by a Pupil;Action, Adventure, Casual, Indie;200,000 - 500,000;3677;442;3235;22;24;2
862700;Cubers: Arena;Action, Adventure, Casual, Racing;0 - 20,000;19;3;16;0;0;0
862730;Magic Blast VR;Casual, Indie;0 - 20,000;10;4;6;0;0;0
862740;OneShift;Indie, Racing, Simulation, Early Access;0 - 20,000;45;10;35;0;0;0
862770;KO Mech;Action, Indie;0 - 20,000;43;6;37;0;0;0
862790;13 Cycles: Chaos Control;Action, Indie;0 - 20,000;4;8;-4;0;0;0
862800;Storm Chasers;Action, Indie;50,000 - 100,000;1332;226;1106;608;608;13
862850;The Great Story of a Mighty Hero - Remastered;Casual, Indie, Racing;0 - 20,000;8;6;2;0;0;0
862880;Intelligence: Anime girls;Casual, Indie, Racing, Simulation;0 - 20,000;9;7;2;0;0;0
862920;Kitsune Kitchen;Action, Casual, Indie;0 - 20,000;38;9;29;0;0;0
862990;Survive the West;Adventure, Casual, Indie, Early Access;0 - 20,000;8;9;-1;0;0;0
863120;The General Retreats;Adventure;0 - 20,000;0;1;-1;0;0;0
863150;Caverns: Lost Sky;Utilities;0 - 20,000;3;2;1;0;0;0
863170;Muerte's Arena;RPG;0 - 20,000;2;2;0;0;0;0
863190;Gamer Sensei's Range Royale;Simulation;0 - 20,000;7;1;6;0;0;0
863210;Delta Horizon;Action;0 - 20,000;12;4;8;0;0;0
863220;Anderson (Alpha);Indie, Strategy, Early Access;0 - 20,000;24;9;15;0;0;0
863230;Super Plexis;Adventure, Casual, Simulation;0 - 20,000;43;4;39;0;0;0
863270;Orc Island;Casual, Indie, Strategy;0 - 20,000;2;0;2;0;0;0
863280;Astraeus;Casual;0 - 20,000;8;1;7;27;27;0
863290;Balance of Soccer;Utilities;0 - 20,000;1;4;-3;0;0;0
863310;Vertical Fall;Action, Indie;0 - 20,000;2;2;0;0;0;0
863380;Frankenstein: Beyond the Time;Casual, Indie, Simulation;0 - 20,000;17;10;7;0;0;0
863400;Feud;Action, Adventure, Indie;50,000 - 100,000;175;19;156;0;0;0
863420;Melting World Online;Indie, Strategy, Early Access;0 - 20,000;37;37;0;0;0;0
863430;One Person Story;Action, Adventure, Indie, RPG;0 - 20,000;20;1;19;0;0;1
863460;Cyber Ops;Action, Indie, Massively Multiplayer, RPG, Early Access;20,000 - 50,000;48;52;-4;0;0;0
863470;Cairo's Tale: The Big Egg;Indie, Simulation;20,000 - 50,000;19;2;17;0;0;0
863490;Bighead Runner;Adventure, Casual, Indie, Simulation, Sports, Strategy;20,000 - 50,000;92;30;62;0;0;0
863550;HITMAN 2;Casual, Indie;5,000,000 - 10,000,000;65800;6286;59514;990;241;704
863560;Slime CCG;Casual, Indie, Simulation, Early Access;50,000 - 100,000;36;55;-19;0;0;0
863570;Super Seducer 2 - Advanced Seduction Tactics;Racing, Simulation, Sports;200,000 - 500,000;1284;261;1023;229;271;19
863580;Viking Days;Utilities;0 - 20,000;11;12;-1;0;0;0
863590;Starcom: Nexus;Violent, Gore, Adventure, Indie;50,000 - 100,000;1492;141;1351;9;9;16
863640;Quiz Time;Adventure, Casual, Indie;0 - 20,000;1;1;0;0;0;0
863660;Sea of memories;Action, Indie;0 - 20,000;5;5;0;0;0;0
863670;Science:The world is in your hands;Adventure, Free to Play;0 - 20,000;0;1;-1;0;0;0
863690;Blueprint;Simulation, Early Access;0 - 20,000;1;1;0;0;0;0
863730;Artillery Cats;Adventure, Casual, Indie;0 - 20,000;56;15;41;0;0;0
863810;SMASH BOY Ver.KZ;Casual, Strategy;0 - 20,000;19;4;15;0;0;1
863840;MinerXP;Action, Free to Play, Indie;20,000 - 50,000;3;1;2;0;0;0
863870;Brain 43℃;Casual;0 - 20,000;2;4;-2;0;0;0
863900;Villager's Biography;Adventure, Casual, Indie;0 - 20,000;72;23;49;0;0;0
863920;The Lost Sky;Casual, Free to Play, Indie, Massively Multiplayer, Racing, Sports, Early Access;0 - 20,000;4;1;3;0;0;0
863940;Treasure Adventure Game;Indie, Simulation;100,000 - 200,000;27;3;24;0;0;1
863970;Survive the Rift;Casual, Indie;0 - 20,000;7;1;6;0;0;0
863980;ORIX!;Casual, Indie;0 - 20,000;80;48;32;101;101;0
864010;Space Force;Adventure, Casual, Indie, Simulation;0 - 20,000;18;10;8;0;0;0
864020;Lost Legend;Adventure, Casual, Indie;50,000 - 100,000;4;2;2;0;0;0
864060;Marble It Up!;Action, Adventure, Indie;50,000 - 100,000;549;37;512;76;103;8
864100;Sagebrush;Adventure, Free to Play, Indie, RPG, Strategy;0 - 20,000;173;9;164;0;0;0
864110;Trap Defense;Violent, Action, Casual, Indie, Strategy, Early Access;0 - 20,000;12;1;11;0;0;0
864130;My Magical Demon Lover;Casual, Indie, Strategy;0 - 20,000;0;0;0;0;0;0
864150;Feelin;Casual, Indie;0 - 20,000;13;8;5;0;0;0
864160;BE-A Walker;Adventure, Indie, Simulation;20,000 - 50,000;292;100;192;365;365;0
864190;3, 2, 1, SURVIVE !;Indie, Strategy;0 - 20,000;3;0;3;0;0;0
864200;Demolition Ball;Action, Adventure, Casual, Indie, Early Access;0 - 20,000;2;1;1;0;0;0
864300;qop 3;Casual, Indie;20,000 - 50,000;313;20;293;20;39;1
864310;Destiny of a Wizard 2:  Beyond the Vale;Adventure, Casual, Indie;0 - 20,000;2;0;2;0;0;0
864360;SAVANNA SHOT VR;Casual, Indie, RPG, Simulation, Strategy;0 - 20,000;2;0;2;0;0;0
864370;Aztec Number;Indie;0 - 20,000;2;0;2;0;0;0
864420;Waterside Chirping 水畔空蝉;Action, Adventure, Casual, Indie;0 - 20,000;35;4;31;0;0;0
864430;SilverFrame(纯白星原);Action, Indie;0 - 20,000;58;8;50;0;0;0
864450;Combat Wings;RPG;0 - 20,000;39;11;28;0;0;0
864480;TapRPG - Homeland;Casual, Indie, Simulation;0 - 20,000;2;0;2;0;0;0
864500;Calm Cards - Klondike;Action, Adventure, Massively Multiplayer, Simulation;0 - 20,000;5;1;4;0;0;0
864510;Scud Frenzy;Adventure, RPG, Simulation;0 - 20,000;23;4;19;0;0;0
864530;Necro Immortallis;Indie, Strategy;0 - 20,000;13;4;9;0;0;0
864540;Fallback;Violent, Gore, Action, Indie;50,000 - 100,000;291;45;246;0;0;0
864540;Fallback;Action, Adventure, Simulation;50,000 - 100,000;291;45;246;0;0;0
864550;Radiant One;Casual, Indie, Strategy;0 - 20,000;167;49;118;62;62;0
864570;Chocolate makes you happy 6;Action, Indie;0 - 20,000;61;27;34;0;0;0
864590;Zombie Rampage;Action, Adventure, Indie;0 - 20,000;1;6;-5;0;0;0
864600;Jade's Dungeon Descent;Action, Indie;0 - 20,000;3;7;-4;0;0;0
864610;Magic Realm: Online;Indie, Simulation, Sports;0 - 20,000;40;9;31;0;0;0
864680;Rover Mechanic Simulator;Audio Production, Video Production;20,000 - 50,000;439;127;312;628;907;5
864700;Dinosaur Fossil Hunter;Action, Early Access;50,000 - 100,000;452;157;295;307;322;9
864730;Panther VR;Action, Adventure, Indie;0 - 20,000;65;31;34;0;0;0
864740;The World of Labyrinths: Labyronia;Casual, Indie, Simulation;0 - 20,000;16;3;13;0;0;0
864760;Limouzik;Indie, RPG, Strategy;0 - 20,000;7;7;0;0;0;0
864790;FragmentVR;Action, Indie;0 - 20,000;7;6;1;0;0;0
864810;NUMERIC;Education, Utilities, Video Production;0 - 20,000;25;9;16;0;0;0
864850;Permission VR;Casual, Indie, Simulation;0 - 20,000;2;1;1;0;0;0
864860;HellCat;Action, Adventure;20,000 - 50,000;155;25;130;0;0;0
864880;Beasts&Chests;Adventure, Early Access;0 - 20,000;8;7;1;0;0;0
864920;Tap Cats: Epic Card Battle;Adventure, Casual, Indie;20,000 - 50,000;42;17;25;0;0;0
864940;150,000 B.C.;Action, Adventure, Indie;50,000 - 100,000;119;280;-161;9;9;1
864960;Drops: Rhythm Garden;Casual, Indie;0 - 20,000;3;0;3;0;0;0
864970;NIGHTSTAR: Alliance;Adventure, Casual, Indie, RPG, Strategy;0 - 20,000;51;10;41;0;0;0
865040;Super Bit Blaster XL;Action, Adventure, Casual, Indie, Simulation;50,000 - 100,000;628;35;593;34;11;20
865060;Murasaki Tsurugi;Action;0 - 20,000;20;0;20;0;0;0
865100;李教授的知识问答;Casual, Indie, Strategy, Early Access;20,000 - 50,000;4;13;-9;0;0;0
865130;Ales Dash;Action, Adventure, Casual, Indie, RPG, Simulation;0 - 20,000;2;1;1;0;0;0
865160;Takenoko;Action, Adventure, Indie, RPG, Early Access;0 - 20,000;45;30;15;0;0;2
865170;Heavenly Duels;Casual;0 - 20,000;4;0;4;0;0;0
865180;Reformers Intl Ver(变革者国际版);Casual, Free to Play, Indie, RPG, Simulation;0 - 20,000;52;12;40;144;144;0
865190;HotFloor;Casual, Indie;0 - 20,000;26;12;14;0;0;0
865200;DiveReal (inactive, stopped);Action, Indie;0 - 20,000;9;5;4;0;0;0
865220;Puzlogic;Indie, Strategy, Early Access;0 - 20,000;36;6;30;0;0;0
865250;Phase Shift;Adventure, Indie;0 - 20,000;81;33;48;0;0;1
865270;LIBRARY;Casual, Simulation, Strategy, Early Access;0 - 20,000;130;7;123;0;0;0
865310;Dubstep Abasralsa;Adventure, Casual, Indie, RPG, Strategy;0 - 20,000;54;32;22;0;0;0
865330;Dark Days of Horror;Action, Adventure, Casual, Indie;0 - 20,000;1;4;-3;0;0;0
865360;We Were Here Together;Action, Adventure, Casual, Free to Play, Indie, RPG, Strategy;200,000 - 500,000;8938;1515;7423;378;347;134
865370;El Hincha - El Videojuego;Action, Indie;20,000 - 50,000;20;6;14;0;0;0
865390;Infinite World: Randomize everything;Action, Adventure, Casual, Indie;0 - 20,000;24;33;-9;0;0;0
865410;Cyber Puzzle HackRow;Casual, Indie;0 - 20,000;1;0;1;0;0;0
865540;PLAYNE : The Meditation Game;Adventure, Casual, Indie, RPG;20,000 - 50,000;994;44;950;70;70;10
865610;Backbone;Casual;100,000 - 200,000;1154;661;493;594;594;11
865630;One Hundred Times Me;Action, Casual, Indie;0 - 20,000;8;0;8;0;0;0
865680;The Eternal Cylinder;Adventure, Casual, Indie, Simulation, Sports, Strategy;20,000 - 50,000;264;43;221;0;0;13
865720;Torn Tales: Rebound Edition;Casual, Indie;0 - 20,000;5;7;-2;0;0;0
865750;Harmony of the bravest;Action, Free to Play, Indie, RPG, Early Access;0 - 20,000;5;0;5;0;0;0
865760;Solitude - Escape of Head;Action, Adventure, Casual, Indie, Strategy, Early Access;0 - 20,000;3;0;3;0;0;0
865770;Caffeine;Casual, Indie, Strategy;20,000 - 50,000;27;5;22;0;0;2
865770;Caffeine;Adventure, Indie, RPG;20,000 - 50,000;27;5;22;0;0;2
865800;Octo Gravity;Adventure, Indie, RPG;0 - 20,000;9;1;8;0;0;0
865810;Waifu Fight Dango Style;Adventure, Indie, RPG;0 - 20,000;0;0;0;0;0;0
865830;Psychedelica of the Ashen Hawk;Adventure, Indie, RPG;0 - 20,000;405;61;344;0;0;5
865850;Dehumanized;Casual, Indie, Strategy;20,000 - 50,000;84;40;44;0;0;0
865860;Vein Hotel;Education;0 - 20,000;7;3;4;0;0;0
865870;SpaceTone;Action, Casual, Indie;0 - 20,000;16;5;11;0;0;0
865880;天岚行 - Through the Mist and Sky;Adventure, Casual, Indie, Simulation, Strategy;20,000 - 50,000;164;7;157;12;12;2
865930;BQM - BlockQuest Maker-;Adventure, Casual, Indie, Simulation, Strategy;0 - 20,000;122;27;95;160;160;0
865940;SNK 40th ANNIVERSARY COLLECTION;Violent, Gore, Action, Free to Play, Indie, Early Access;20,000 - 50,000;155;40;115;116;143;3
865980;BOSSGARD;Adventure, Casual, Indie, Racing, Simulation, Sports;20,000 - 50,000;148;108;40;122;122;0
865990;Highway Junkie;Strategy, Early Access;0 - 20,000;5;1;4;0;0;0
866010;Beat Stickman: Infinity Clones;Action, Free to Play, Massively Multiplayer, Early Access;0 - 20,000;84;27;57;0;0;8
866080;FlyWarzz;Casual, Indie;0 - 20,000;5;0;5;0;0;0
866100;HarmonyTD;Action, Casual, Indie;0 - 20,000;6;2;4;0;0;0
866130;MAGIX Video Pro X10 Steam Edition;Simulation, Sports;0 - 20,000;4;0;4;0;0;0
866140;Arise: A Simple Story;Action, Adventure, Indie, Massively Multiplayer, Early Access;50,000 - 100,000;787;59;728;489;489;8
866150;Treasures of the Ancients: Egypt;Casual, Indie;50,000 - 100,000;55;97;-42;0;0;0
866170;Deep Space Banana;Action, Casual, Indie;0 - 20,000;6;14;-8;0;0;0
866180;Debris 2x1 Hentai;Strategy;0 - 20,000;1;5;-4;0;0;0
866190;Irony Curtain: From Matryoshka with Love;Action, Adventure, Indie, Early Access;0 - 20,000;295;40;255;31;31;2
866260;EreaDrone 2018;Action, Casual, Indie, Early Access;0 - 20,000;17;32;-15;0;0;1
866270;Lambs on the road : The beginning;Adventure, Indie;0 - 20,000;39;3;36;0;0;0
866280;Emergency Robot Simulator;Indie, Strategy, Early Access;0 - 20,000;1;15;-14;0;0;0
866310;Putin Run Away From Trump;Indie, Strategy, Early Access;0 - 20,000;45;26;19;11;11;0
866340;Colonumbers;Indie, Strategy, Early Access;20,000 - 50,000;2;4;-2;0;0;0
866350;HexTrains;Adventure, Indie, RPG;0 - 20,000;4;1;3;0;0;0
866400;On The Western Front;Adventure, Casual, Indie;0 - 20,000;47;8;39;0;0;0
866420;TANKS;Action;0 - 20,000;106;7;99;0;0;2
866430;AS+CEND;Casual, Indie;0 - 20,000;0;0;0;0;0;0
866440;What Never Was;Adventure, Indie;200,000 - 500,000;4349;220;4129;0;0;2
866450;Light Rider;Casual, Free to Play, Indie;0 - 20,000;9;2;7;0;0;0
866500;Space Toads Mayhem;Action, Adventure, Casual, Indie;0 - 20,000;5;0;5;0;0;0
866510;!AnyWay!;Casual, Indie;0 - 20,000;293;130;163;202;258;28
866520;Defense the Farm;Action, Casual, Indie, Racing;0 - 20,000;36;24;12;0;0;0
866540;VR Flush;Casual, Indie, Massively Multiplayer, Strategy;50,000 - 100,000;687;33;654;0;0;0
866700;Echoes of the Past: Wolf Healer Collector's Edition;Indie, Strategy, Early Access;0 - 20,000;4;3;1;0;0;0
866710;Shiver: The Lily's Requiem Collector's Edition;Simulation;0 - 20,000;6;2;4;0;0;1
866720;Off the Record: The Final Interview Collector's Edition;Adventure, Indie;0 - 20,000;2;1;1;0;0;0
866730;Love Story: The Way Home;Animation & Modeling, Design & Illustration, Photo Editing, Video Production, Early Access;0 - 20,000;3;0;3;0;0;1
866740;Haunted Hotel: Charles Dexter Ward Collector's Edition;Indie;0 - 20,000;13;2;11;0;0;0
866750;Redemption Cemetery: Grave Testimony Collector’s Edition;Indie, Strategy;0 - 20,000;6;0;6;0;0;0
866770;Spaceteam VR;Action, Indie, Simulation, Early Access;0 - 20,000;12;7;5;0;0;0
866780;Sea of Lies: Tide of Treachery Collector's Edition;Indie;0 - 20,000;0;1;-1;0;0;1
866790;Myths of the World: Of Fiends and Fairies Collector's Edition;Casual, Indie, Early Access;0 - 20,000;3;0;3;0;0;0
866800;The Walking Dead: The Final Season;Action, Adventure, Indie;500,000 - 1,000,000;14075;794;13281;841;720;85
866950;Deep Noise;Free to Play, Indie, Simulation;0 - 20,000;4;2;2;0;0;0
866960;Slime Kingdom;Casual;0 - 20,000;8;3;5;0;0;0
867010;Adventure Delivery Service;Adventure, Indie, Early Access;0 - 20,000;11;5;6;0;0;0
867050;Endless Fables 3: Dark Moor;Action, Free to Play, Indie, Strategy, Early Access;0 - 20,000;131;22;109;0;0;1
867080;Stones of Yalmrith;Indie, RPG;0 - 20,000;3;0;3;0;0;0
867090;つんつんVR / TSUN-TSUN VR;Action, Adventure, Indie, RPG, Strategy;0 - 20,000;24;10;14;14;14;0
867110;Dungeon Rankers;Adventure, Casual, Indie, RPG;0 - 20,000;12;1;11;0;0;0
867120;Lilipalace;Action, Adventure, Indie, RPG;0 - 20,000;77;32;45;0;0;0
867130;Alice in Wonderland - 3D Labyrinth Game;Action, Casual, Indie, Massively Multiplayer, Simulation, Early Access;0 - 20,000;7;0;7;0;0;0
867140;WIN THE GAME: WTF!;Action, Adventure, Casual, Indie;0 - 20,000;151;40;111;57;58;1
867180;Tilesweeper;Casual, Indie;20,000 - 50,000;284;48;236;360;360;20
867210;Songs of Conquest;Casual, Indie, Strategy;100,000 - 200,000;4338;565;3773;371;462;204
867250;Wars of Succession;Casual, Indie;0 - 20,000;21;4;17;3;3;4
867290;Crossroads Inn Anniversary Edition;Action, Casual, Indie, Strategy;200,000 - 500,000;2093;1614;479;2710;2710;29
867390;Chase;Action, Casual, Indie, Early Access;0 - 20,000;18;6;12;0;0;0
867400;Out of Reach: Treasure Royale;Adventure, Indie, RPG;20,000 - 50,000;278;185;93;0;0;1
867420;Andor - Wrecking Dawn;Action, Indie, Early Access;0 - 20,000;75;29;46;0;0;0
867460;PLANET RESERVE;Strategy;0 - 20,000;1;2;-1;0;0;0
867470;Albedon Wars;Casual, Free to Play, Strategy, Early Access;0 - 20,000;6;1;5;0;0;0
867480;Daddy;Adventure, Indie;0 - 20,000;68;50;18;8;8;0
867490;Remyadry;Action, Casual, Indie, Racing, Simulation;20,000 - 50,000;487;59;428;0;0;2
867490;Remyadry;Action, Indie, Early Access;20,000 - 50,000;487;59;428;0;0;2
867510;PHOTON CUBE;Action, Casual, Indie, Strategy, Early Access;0 - 20,000;11;0;11;0;0;0
867530;Party Poopers;Casual, Indie, Simulation, Strategy;0 - 20,000;2;2;0;0;0;0
867540;Honor Cry: Aftermath;Indie;0 - 20,000;5;8;-3;0;0;0
867550;Range Ball;Casual;0 - 20,000;24;9;15;0;0;0
867570;Tower Defense > Red Rose Rising;Action, Adventure, Indie, Strategy;0 - 20,000;1;3;-2;0;0;0
867590;Sakura and Crit: The Mock Game;Casual, Indie;0 - 20,000;3;1;2;0;0;0
867610;Shadow Council: The Puppeteers;Adventure, Indie;0 - 20,000;23;28;-5;0;0;0
867620;Hyper Train Corporation;Violent, Action, Casual, Indie, Simulation;0 - 20,000;2;24;-22;0;0;0
867660;NYKRA;Casual;0 - 20,000;60;41;19;9;9;0
867690;Psycho Wolf;Action, Casual, Free to Play, Indie;0 - 20,000;10;7;3;0;0;0
867700;The Wilting Amaranth;Casual, Indie;;;;0;;;
867750;Gull Kebap VR;Action, Casual, Indie;0 - 20,000;4;1;3;0;0;0
867770;The One We Found;Massively Multiplayer, Early Access;0 - 20,000;0;3;-3;0;0;0
867790;Aeroplanoui;Action, Casual, Indie, Racing, Sports;0 - 20,000;6;1;5;0;0;0
867800;Gravity Jump;Casual, Indie;0 - 20,000;23;16;7;0;0;0
867850;Turn up jeans;Action, Indie, Strategy;0 - 20,000;4;3;1;0;0;0
867920;Tales of Mahabharata;Violent, Gore, Action, Adventure, Casual, Indie;0 - 20,000;2;0;2;0;0;1
867960;Remorse: The List;Action, Adventure, Casual, Indie, Simulation;0 - 20,000;145;28;117;0;0;1
867980;Raiders Of The Lost Island;Action, Casual, Indie, Sports;0 - 20,000;46;3;43;0;0;0
868000;Dance With Memes;Adventure;0 - 20,000;3;5;-2;0;0;0
868010;Hallo Spaceboy;Action, Adventure, Casual, Indie, Simulation, Sports;0 - 20,000;7;1;6;0;0;0
868020;Aperture Hand Lab;RPG;200,000 - 500,000;1033;127;906;42;52;2
868040;Stick Spartans;Action, Adventure, Casual, Indie, Racing, Simulation, Sports;0 - 20,000;5;5;0;0;0;0
868060;Immortal Darkness: Curse of The Pale King;Simulation, Early Access;0 - 20,000;40;7;33;0;0;0
868070;Through The Tomb;Action, Adventure, Casual, Simulation;20,000 - 50,000;12;3;9;0;0;0
868080;Golf Galore;Action, Adventure, Indie, RPG;50,000 - 100,000;250;61;189;0;0;4
868090;Battle Summoners VR Basic;Gore, Action, Adventure, Indie;20,000 - 50,000;34;11;23;0;0;0
868100;小游戏世界(中国版);Action, Adventure, Casual, Indie, Simulation;20,000 - 50,000;18;27;-9;0;0;0
868130;Hex Two;Action, Adventure;0 - 20,000;13;1;12;0;0;0
868150;Takelings House Party;Adventure, Indie;20,000 - 50,000;223;70;153;49;73;0
868180;Salty Seabird Bay;Action, Indie, Early Access;0 - 20,000;4;0;4;0;0;0
868190;Sapper boom!;Design & Illustration, Photo Editing, Video Production;50,000 - 100,000;14;51;-37;0;0;0
868200;Crossing Man;Action, Casual, Indie;0 - 20,000;2;0;2;0;0;0
868210;Road Z Survival: The Last Winter;RPG;0 - 20,000;1;0;1;0;0;0
868230;Mushroom Quest;Action, Adventure, Casual, Indie;0 - 20,000;53;12;41;0;0;0
868230;Mushroom Quest;Action, Indie, RPG, Strategy;0 - 20,000;53;12;41;0;0;0
868240;FINSummerVR;Action, Adventure, Indie;0 - 20,000;3;1;2;0;0;0
868260;Zoo Constructor;Action, Adventure, Indie, Early Access;0 - 20,000;17;9;8;0;0;0
868270;The Cycle;Action;2,000,000 - 5,000,000;24079;15033;9046;609;123;2039
868320;噬元之主;Action;20,000 - 50,000;41;27;14;0;0;0
868340;Groove Studio;Adventure, Indie, RPG;0 - 20,000;31;15;16;0;0;0
868350;Ancient Warlords: Aequilibrium;Indie;0 - 20,000;0;11;-11;0;0;0
868360;Project Hospital;Action, Casual, Indie;200,000 - 500,000;5597;768;4829;1306;703;412
868370;Lost Tales - The Castle Escape;Adventure, Casual, Indie, Simulation, Sports;0 - 20,000;1;4;-3;0;0;0
868390;Survival Diary;Casual, Indie, Strategy;0 - 20,000;0;1;-1;0;0;0
868400;Samplitude Music Studio 2019 Steam Edition;Action, Adventure, Casual, Indie;0 - 20,000;13;8;5;0;0;0
868410;DAISENRYAKU PERFECT 4.0;Action, Casual, Indie, Strategy, Early Access;0 - 20,000;31;65;-34;0;0;21
868430;Brathian;Casual, Free to Play, Indie, RPG, Simulation, Strategy;0 - 20,000;3;0;3;0;0;0
868440;Apostasy;Casual, Indie;0 - 20,000;11;0;11;0;0;0
868460;Adventure of a Digger;Indie, Simulation, Sports;0 - 20,000;2;18;-16;0;0;0
868470;Heroes Arena;Action, Adventure, Indie;0 - 20,000;8;14;-6;0;0;0
868480;NextFX;Adventure, Casual, Indie;0 - 20,000;3;4;-1;0;0;0
868500;Qybe;Casual, Racing;0 - 20,000;28;2;26;0;0;0
868510;The Outsiders;Casual, Indie;0 - 20,000;6;3;3;0;0;0
868520;killer7;Casual, Indie, Strategy;50,000 - 100,000;2150;90;2060;200;378;15
868550;What do you hear?? Yanny vs Laurel;Action, Casual, Indie;0 - 20,000;49;14;35;0;0;0
868560;Fly Killer VR;Adventure, Casual;0 - 20,000;4;3;1;0;0;0
868570;Prototype Mansion - Used No Cover;Adventure, Casual;0 - 20,000;26;12;14;0;0;0
868580;Arkhangel: The House of the Seven Stars;Adventure, Casual;20,000 - 50,000;42;12;30;3947;3947;0
868600;Lands Of The Lost;Action, Casual, Indie, Early Access;0 - 20,000;1;0;1;0;0;0
868660;Soccer Battle Royale;Adventure, Indie;0 - 20,000;13;3;10;0;0;0
868710;Hope of Humanity;Casual, Simulation;0 - 20,000;8;23;-15;0;0;0
868730;Chessers;Strategy;0 - 20,000;3;0;3;0;0;0
868770;Saint Kotar: The Yellow Mask;Adventure, Free to Play, Indie, RPG;50,000 - 100,000;233;76;157;0;0;1
868780;I, Cyborg;Casual, Free to Play, Indie;0 - 20,000;23;6;17;0;0;0
868810;EggFight;Action;0 - 20,000;9;5;4;0;0;0
868810;EggFight;Casual, Indie, Simulation, Early Access;0 - 20,000;9;5;4;0;0;0
868830;Rio Rex;Violent, Simulation, Early Access;0 - 20,000;6;1;5;0;0;0
868880;Candy Raid: The Factory;Action, Adventure, Casual, Indie, RPG;0 - 20,000;11;1;10;0;0;0
868890;Horny Fighter;Adventure, Casual, Indie;50,000 - 100,000;42;31;11;0;0;0
868910;Cryptozookeeper;Audio Production, Utilities;0 - 20,000;3;1;2;0;0;0
868920;Pylow;Action, Casual, Indie, Early Access;0 - 20,000;28;28;0;0;0;0
868930;Nobunaga's Shadow;Violent, Action, Adventure, Indie, Massively Multiplayer, RPG, Simulation, Strategy;0 - 20,000;15;2;13;0;0;0
868940;The Curious Study of Dr. Blackwood:  A VR Tech Demo;Action, Casual, Indie;0 - 20,000;22;4;18;0;0;1
868950;Absolute VR Experiences;Action, Adventure, Indie;0 - 20,000;1;4;-3;0;0;0
868960;AridFortress;Indie;0 - 20,000;1;12;-11;0;0;0
868970;Cut The Ex-Girlfriends;Action, Casual, Indie, Simulation, Strategy;0 - 20,000;10;8;2;0;0;0
868980;DEEP SPACE WAIFU: NEKOMIMI;Simulation, Strategy;0 - 20,000;362;6;356;202;213;0
869010;Katto;Indie;0 - 20,000;0;0;0;0;0;0
869030;Brotherhood United;Action, Adventure, Indie;0 - 20,000;11;3;8;0;0;0
869060;Resort Boss: Golf;Violent, Gore, Action, Adventure, Casual, Indie;20,000 - 50,000;56;87;-31;141;221;0
869080;TRAGO;Action, Casual, Free to Play, Indie;0 - 20,000;13;6;7;0;0;0
869100;Universally Loved;Action, Casual, Indie;0 - 20,000;5;2;3;0;0;0
869110;Guess Da Meme;Casual, Indie, Simulation;0 - 20,000;7;3;4;0;0;0
869120;Grounds of Glory;Violent, Action, Indie, Simulation;0 - 20,000;7;1;6;0;0;0
869130;World of Zombies;Casual, Indie;0 - 20,000;12;16;-4;0;0;0
869170;Oneiros;Action, Adventure, Indie;20,000 - 50,000;183;33;150;0;0;0
869280;RapStar Tycoon;Adventure, Casual, Simulation;0 - 20,000;4;18;-14;0;0;0
869290;Don't Look Down;Free to Play;0 - 20,000;21;3;18;0;0;0
869300;The Darkest Woods;Action, Adventure, Indie, Early Access;0 - 20,000;36;6;30;0;0;0
869340;The Federal Rescue;Action, Adventure, Casual, Indie, Strategy;0 - 20,000;11;17;-6;0;0;0
869350;Because We're Here - Act I;Adventure, Indie, RPG, Strategy;20,000 - 50,000;82;4;78;0;0;0
869370;The Goracle;Action, Casual, Indie, Massively Multiplayer, Racing;20,000 - 50,000;5;0;5;0;0;0
869420;Jailbreak Lockdown;Action, Adventure, Casual, Indie;0 - 20,000;1;2;-1;0;0;0
869440;Cherry in the Sky;Casual, Indie;0 - 20,000;5;1;4;0;0;0
869470;Tiny Hands Adventure;Racing, Simulation;0 - 20,000;20;8;12;0;0;0
869500;The Book of Regrets;Casual, Indie, RPG;0 - 20,000;7;0;7;0;0;0
869540;Hero Hunters - 杀手 3D 2K19;RPG, Strategy;0 - 20,000;24;3;21;0;0;0
869550;Double Shot;Action, Indie;0 - 20,000;13;2;11;0;0;0
869560;DayD: Through time. Jurassic Rush;Casual, Indie, Early Access;0 - 20,000;6;7;-1;0;0;0
869580;Keep Running;Action, Indie;0 - 20,000;1;0;1;0;0;0
869620;Katy and Bob: Cake Café;Violent;0 - 20,000;47;8;39;0;0;0
869630;Heart'n Block;Casual, Free to Play, Indie;0 - 20,000;0;1;-1;0;0;0
869640;Angry Giant;Simulation;0 - 20,000;11;1;10;0;0;0
869650;Franky Lettuce;Indie, Early Access;0 - 20,000;7;3;4;0;0;0
869660;幻世情缘;Adventure;0 - 20,000;11;10;1;0;0;0
869680;Audio Converter;Casual, Indie, Early Access;0 - 20,000;5;10;-5;0;0;0
869690;Cat Lady - The Card Game;Action, Indie, Early Access;0 - 20,000;205;13;192;0;0;2
869750;Super Chicken Catchers;Action, Casual, Indie;0 - 20,000;19;9;10;0;0;0
869760;Stoneshard: Prologue;Action, Indie, Massively Multiplayer, RPG;200,000 - 500,000;3063;446;2617;72;43;6
869780;Super Golf 2018;Indie, Simulation;50,000 - 100,000;30;10;20;0;0;0
869840;Feather Of Praying 羽翼的祈愿;Adventure, Indie;0 - 20,000;212;10;202;7;7;3
869850;Jet Ant;Action;0 - 20,000;8;1;7;0;0;0
869870;She is Mermaid;Indie, RPG, Strategy;0 - 20,000;47;7;40;0;0;0
869880;Cyanide & Happiness - Freakpocalypse (Episode 1);Action, Indie;100,000 - 200,000;611;479;132;180;303;1
869910;Amaze Bowl;RPG;0 - 20,000;8;0;8;0;0;0
869930;Up And Up;Nudity, Indie;0 - 20,000;4;5;-1;0;0;0
870000;AmazeD 3D;Indie, Simulation, Strategy;0 - 20,000;4;8;-4;0;0;0
870000;AmazeD 3D;Casual, Free to Play, Indie, Massively Multiplayer, RPG, Strategy;0 - 20,000;4;8;-4;0;0;0
870010;Mazes and Mages;Free to Play, Indie, RPG;0 - 20,000;0;3;-3;0;0;0
870030;Polymatic;RPG;0 - 20,000;3;0;3;0;0;0
870030;Polymatic;Action, Indie;0 - 20,000;3;0;3;0;0;0
870080;Running Through Russia 2;Action, Indie;0 - 20,000;76;24;52;0;0;0
870090;Lems;Action, Casual, Indie;0 - 20,000;20;1;19;0;0;0
870100;乌鸦 - Crows;Casual, Simulation;0 - 20,000;20;33;-13;0;0;0
870110;The Monsters' History Book;Casual, Indie;0 - 20,000;85;11;74;0;0;1
870110;The Monsters' History Book;Adventure, Free to Play;0 - 20,000;85;11;74;0;0;1
870120;The Bad Gravedigger;Action, Free to Play, Indie, Early Access;0 - 20,000;17;15;2;0;0;0
870140;Treasure Hunter Man 2;Indie, Strategy, Early Access;0 - 20,000;14;1;13;0;0;0
870150;Jumponaut;Casual, Indie;0 - 20,000;1;1;0;0;0;0
870160;R.O.V.E.R.;Casual, Indie;0 - 20,000;20;17;3;0;0;0
870180;Blueprint Word;Casual, Indie, Strategy;0 - 20,000;17;8;9;0;0;0
870200;Juno: New Origins;Adventure, Indie;100,000 - 200,000;1840;204;1636;286;403;186
870260;Forward Line;Adventure, Free to Play, Indie;0 - 20,000;13;0;13;0;0;0
870290;The Miskatonic;Action, Indie, Early Access;20,000 - 50,000;283;85;198;0;0;2
870390;Moonshine Maniacs - A Wild West Saga;Adventure, Indie, Simulation;20,000 - 50,000;35;15;20;0;0;0
870420;Movavi Video Editor 14 Plus;Adventure, Free to Play, Massively Multiplayer, RPG, Strategy;0 - 20,000;363;65;298;13;13;7
870420;Movavi Video Editor 14 Plus;RPG;0 - 20,000;363;65;298;13;13;7
870430;Debit And Credit:A Walk Through Accounting Hell;Casual, Indie, Simulation;0 - 20,000;3;4;-1;0;0;0
870450;Fobia;Action, Adventure, Indie, RPG, Strategy, Early Access;0 - 20,000;14;12;2;0;0;0
870510;The Fiend's Tavern;Casual, Indie;0 - 20,000;2;0;2;0;0;0
870520;太平洋之嵐6 ～ 史上最大的激戰諾曼第攻防戰! Pacific Storm 6 - Battle for Normandy;Action, Adventure, Indie;0 - 20,000;21;11;10;0;0;0
870580;ZOOMnBOOM;Action, Casual, Indie;0 - 20,000;4;4;0;0;0;0
870590;Moonbase Down;Action, Adventure, Indie, RPG;0 - 20,000;7;0;7;0;0;0
870670;Ink Cipher;Casual, Indie;0 - 20,000;14;1;13;0;0;0
870680;Automatum;Adventure, Casual, Indie, RPG;0 - 20,000;3;2;1;0;0;0
870690;Galaxy Trucker: Extended Edition;Adventure, Simulation;20,000 - 50,000;155;12;143;0;0;8
870730;Adapt or Perish;Action, Adventure, Indie, Simulation, Strategy;0 - 20,000;38;5;33;0;0;0
870740;Bowman VS Zombies;Adventure, Simulation, Sports;0 - 20,000;7;2;5;0;0;0
870750;SMASH IT;Action, Free to Play, Massively Multiplayer, RPG;0 - 20,000;9;15;-6;0;0;0
870780;Control Ultimate Edition;Violent, Action, Adventure, Indie;1,000,000 - 2,000,000;31365;4240;27125;928;482;505
870820;Wakaru ver. beta;Action, Indie, Simulation, Sports;50,000 - 100,000;327;38;289;0;0;3
870890;Museum of Symmetry;Adventure, Indie, Simulation;0 - 20,000;61;3;58;0;0;0
870940;Brainstorm Party;Adventure, Casual, Free to Play, Indie, Strategy;0 - 20,000;0;1;-1;0;0;0
870990;!LABrpgUP!;Action, Casual, Free to Play, Indie;0 - 20,000;22;28;-6;0;0;0
871100;Animyst;RPG;50,000 - 100,000;118;29;89;0;0;0
871140;Great Old One - Arrival;Indie;0 - 20,000;7;4;3;0;0;0
871150;Noble Crusade;Action, Indie, Early Access;0 - 20,000;2;1;1;0;0;0
871170;3tene;Action, Adventure, Casual, Indie, Massively Multiplayer, Early Access;50,000 - 100,000;232;28;204;0;0;46
871190;Hatch;Indie;20,000 - 50,000;48;4;44;0;0;0
871200;FIGHTING EX LAYER;Gore, Action, Indie;20,000 - 50,000;494;99;395;172;293;4
871210;Lamp Chronicle;Casual, Indie;0 - 20,000;48;18;30;0;0;0
871230;Dungeon Rush;Action, Casual, Free to Play, Indie;0 - 20,000;11;5;6;0;0;0
871270;Wild West VR;Action, Adventure, Indie;0 - 20,000;9;10;-1;0;0;0
871280;Grisaia Phantom Trigger Vol.5;Action;0 - 20,000;108;3;105;0;0;0
871290;Shepard Fairey VR - DAMAGED;Action, Casual, Indie;0 - 20,000;4;1;3;0;0;0
871300;Curse in our heads;Action, Casual;0 - 20,000;1;7;-6;0;0;0
871310;Arc Savior;Action, Free to Play, Indie, Early Access;0 - 20,000;20;7;13;0;0;0
871320;Flaming Pixels;Indie, Simulation, Sports;0 - 20,000;0;3;-3;0;0;0
871330;Achaem;Casual, Indie, Simulation;0 - 20,000;8;1;7;0;0;0
871390;Rock n' Rush: Battle Racing;Casual;0 - 20,000;10;2;8;0;0;0
871400;Cinnamon fight;Indie, Racing;0 - 20,000;0;3;-3;0;0;0
871410;Dawngrown;Action, Casual, Indie;0 - 20,000;4;1;3;0;0;0
871420;Lovecraft's Untold Stories;Action, Adventure, Casual, Indie;50,000 - 100,000;607;184;423;379;401;2
871490;Munx VR;Action, Adventure, Casual, Indie, Simulation, Strategy;0 - 20,000;8;4;4;0;0;0
871510;Wheelchair Simulator;Animation & Modeling, Design & Illustration, Education, Utilities, Early Access;0 - 20,000;17;4;13;0;0;0
871530;Radio Commander;Action, Indie, Early Access;100,000 - 200,000;1125;382;743;318;370;6
871570;Summer Memory of Bell;Casual, Indie, Strategy;0 - 20,000;191;9;182;0;0;0
871580;SUPER BALL WRESTLE YES;Casual, Indie;0 - 20,000;5;0;5;0;0;0
871590;Nurikabe;Casual, Indie;0 - 20,000;6;3;3;0;0;0
871620;Volcano Eruption;Casual, Indie;0 - 20,000;6;8;-2;0;0;0
871640;Asteroid RKD;Casual, Indie;0 - 20,000;0;1;-1;0;0;0
871670;TrapLand;Casual, Indie;0 - 20,000;0;4;-4;0;0;0
871710;Galactic Dominion;Casual, Indie;0 - 20,000;8;7;1;0;0;0
871720;Ultimate Custom Night;Casual, Indie;2,000,000 - 5,000,000;43461;2024;41437;199;49;394
871810;Blackout;Casual, Indie;0 - 20,000;40;44;-4;0;0;0
871850;MUTATION PHASE;Casual, Indie;50,000 - 100,000;26;11;15;0;0;0
871860;Allergenium;Casual, Indie;0 - 20,000;2;1;1;0;0;0
871870;Alone;Casual;0 - 20,000;23;14;9;0;0;0
871870;Alone;Casual;0 - 20,000;23;14;9;0;0;0
871920;Mad Restaurant People;Casual;0 - 20,000;17;5;12;0;0;0
871930;GLADIABOTS - AI Combat Arena;Action;100,000 - 200,000;733;72;661;4169;4169;4
871940;BrawlQuest;Adventure, Indie, RPG, Simulation, Early Access;0 - 20,000;61;24;37;0;0;1
871950;DERE EVIL EXE;Casual, Free to Play, Indie;20,000 - 50,000;334;48;286;0;0;0
871980;Digimon Survive;Casual, Simulation;100,000 - 200,000;1972;456;1516;1874;1882;52
871990;BattleRush 2;Action, Casual, Indie, Racing, Simulation, Sports;50,000 - 100,000;416;212;204;286;286;0
872000;Beerd leaver;Casual, Indie;0 - 20,000;6;10;-4;0;0;0
872040;Hovership Havoc;Free to Play, Indie, Strategy;50,000 - 100,000;22;5;17;0;0;0
872060;Quiet as a Stone;Casual, Free to Play, Simulation;0 - 20,000;23;4;19;0;0;0
872090;Freezeer;Action, Adventure, Casual, Indie;20,000 - 50,000;123;54;69;0;0;0
872110;Burden of Proof;Audio Production, Design & Illustration, Utilities, Video Production, Web Publishing;0 - 20,000;22;2;20;0;0;0
872180;Charm Tale;Audio Production, Utilities, Video Production;0 - 20,000;10;5;5;0;0;0
872220;Delta-G;Design & Illustration, Photo Editing, Utilities;0 - 20,000;13;3;10;0;0;0
872230;Destiny of Altrais;Adventure, Casual, Indie, Massively Multiplayer, Simulation;0 - 20,000;1;0;1;0;0;0
872240;Nick Beard: The Fedora of Destiny;Free to Play, Simulation, Animation & Modeling, Design & Illustration, Game Development;20,000 - 50,000;203;36;167;0;0;0
872270;The change;Action, Casual, Indie, Simulation;0 - 20,000;3;0;3;0;0;0
872310;Grid Games: Color Coded;Action;0 - 20,000;1;0;1;0;0;0
872330;Wizard Street;Indie, Simulation, Early Access;0 - 20,000;1;6;-5;0;0;0
872340;Bunny Battle Arena;Casual, Indie, RPG, Simulation;0 - 20,000;5;2;3;0;0;0
872350;Zombie Killing Simulator;Strategy;0 - 20,000;52;30;22;0;0;1
872360;Fruit Hoop;Casual, Indie, Strategy;0 - 20,000;4;1;3;0;0;0
872380;Banzo - Marks of Slavery;Action, Casual, Indie;0 - 20,000;26;3;23;0;0;0
872400;Capsella The Lights of Lucern;Action, Adventure, Casual, Free to Play, Early Access;0 - 20,000;7;9;-2;0;0;0
872410;ROMANCE OF THE THREE KINGDOMS XIV;Adventure, Casual, Indie;200,000 - 500,000;7633;5182;2451;10405;13263;4590
872470;Necro Mutex;Adventure, Free to Play, Indie;0 - 20,000;38;7;31;0;0;2
872490;Blind Souls;Casual, Free to Play, Indie, RPG;0 - 20,000;17;13;4;0;0;0
872530;Korean Scary Folk Tales VR : The Forbidden Book;Action;0 - 20,000;5;5;0;0;0;0
872550;Urbance Clans Card Battle!;Nudity, Adventure, Casual, Indie, RPG, Simulation;0 - 20,000;4;7;-3;0;0;0
872560;Cubeology;Indie;0 - 20,000;0;0;0;0;0;0
872580;The Neon Boy;Adventure, Indie, RPG;0 - 20,000;34;4;30;0;0;0
872590;探灵警探;Indie;0 - 20,000;4;1;3;0;0;0
872600;创史者Hist Maker;Action, Casual, Indie;20,000 - 50,000;55;10;45;0;0;0
872630;Project VR Wild Hunt;Casual, Indie;0 - 20,000;7;12;-5;0;0;0
872670;SCP: 5K;Video Production;100,000 - 200,000;2753;602;2151;233;306;55
872680;Z Dawn;Action, Casual, Indie;20,000 - 50,000;167;59;108;0;0;2
872690;Funky Karts;Indie;0 - 20,000;3;2;1;0;0;0
872700;Jet-Story 2018;Free to Play, Indie, Strategy;20,000 - 50,000;31;2;29;0;0;0
872720;SuperMash;Adventure, Indie, RPG;0 - 20,000;29;13;16;0;0;0
872730;Test your knowledge: Cities;Indie, RPG;0 - 20,000;18;6;12;0;0;0
872750;Guard Duty;Action, Casual, Indie, Racing;0 - 20,000;202;22;180;0;0;1
872790;Football Manager 2019;Indie;1,000,000 - 2,000,000;10763;1662;9101;18004;8942;1649
872810;Eleven Eleven;Casual, Strategy;0 - 20,000;22;2;20;0;0;0
872820;Football Manager 2019 Touch;Adventure, Casual, Indie, Simulation, Strategy;50,000 - 100,000;323;71;252;691;843;68
872970;Azurael's Circle: Chapter 1;Action, Adventure, Indie;20,000 - 50,000;90;16;74;0;0;0
872990;Stream Games;Casual, Indie, Simulation;0 - 20,000;43;4;39;146;146;1
873000;Stuck Together;Casual, Indie;0 - 20,000;2;0;2;0;0;0
873040;Final Missions;Adventure, Casual, Indie;0 - 20,000;1;0;1;0;0;0
873070;NEO NEO;Action, Free to Play;0 - 20,000;39;2;37;0;0;0
873120;Hectic Void;Violent, Gore, Action, Adventure, Indie, Racing, RPG, Simulation, Strategy;0 - 20,000;5;3;2;0;0;0
873140;War of Gaia : Into the Fire;Adventure;0 - 20,000;0;1;-1;0;0;0
873160;SPECKLE: Chill Puzzle Game;Casual, Indie, Racing;0 - 20,000;1;3;-2;0;0;0
873190;ЕСТЬ ДВА СТУЛА;Action, Adventure, Indie;50,000 - 100,000;1337;193;1144;10;10;0
873200;Teleportals. I swear it's a nice game;Free to Play, Indie, Massively Multiplayer, RPG;20,000 - 50,000;295;12;283;0;0;0
873210;iterform;Violent, Gore, Action, Adventure, Indie, Simulation, Early Access;0 - 20,000;10;7;3;0;0;0
873220;SurvivalZ Battlegrounds;Sexual Content, Action;20,000 - 50,000;215;129;86;0;0;1
873230;The King's Request: Physiology and Anatomy Revision Game;Casual, Indie;20,000 - 50,000;151;10;141;0;0;0
873240;Hentai Memory;Action, Adventure, Casual, Indie;50,000 - 100,000;948;104;844;103;118;4
873250;Crimson Light;Casual, Indie;0 - 20,000;12;3;9;0;0;0
873250;Crimson Light;Indie, Strategy;0 - 20,000;12;3;9;0;0;0
873270;Rolled Out!;Action, Adventure, Casual, Massively Multiplayer;20,000 - 50,000;368;22;346;10;10;3
873280;Kick Them Out!!!;Indie, RPG;0 - 20,000;4;1;3;0;0;0
873320;Life's Playground;Adventure, Indie, Simulation;0 - 20,000;6;9;-3;0;0;0
873330;Color by Numbers - Flowers;Indie, Simulation, Strategy;0 - 20,000;2;0;2;0;0;0
873370;モデルDEファイト(Model DE Fight);Action, Indie, RPG;0 - 20,000;9;4;5;0;0;0
873390;Celestial Hacker Girl Jessica;Adventure, Indie;0 - 20,000;30;1;29;0;0;0
873410;The Basilisk;Casual, Free to Play, Simulation;0 - 20,000;15;5;10;0;0;0
873470;Zero Sum Future;Action, Adventure, Indie, Simulation, Strategy, Early Access;0 - 20,000;6;1;5;0;0;0
873480;Tether: ROLL, JUMP, SWING, GLIDE!;Action, Indie;0 - 20,000;0;0;0;0;0;0
873490;不落城-Unconquered Castle;Action, Indie;0 - 20,000;109;25;84;0;0;0
873500;Space Maze;Action, Indie, Early Access;0 - 20,000;17;4;13;0;0;0
873530;Trapper;Casual, Free to Play, Indie;0 - 20,000;0;1;-1;0;0;0
873560;Jack N' Jill DX;Casual, Indie;0 - 20,000;83;6;77;0;0;0
873710;Paris: Jigsaw Puzzles;Adventure, Indie, Simulation;0 - 20,000;4;2;2;0;0;0
873710;Paris: Jigsaw Puzzles;Action, Adventure, RPG, Early Access;0 - 20,000;4;2;2;0;0;0
873720;Pac Adventures 3D;Indie;0 - 20,000;4;2;2;0;0;0
873730;Under The War;Action, Casual, Indie, Simulation;0 - 20,000;4;10;-6;0;0;0
873740;Tranquility Base Mining Colony: The Moon - Explorer Version;Action, Adventure, RPG;0 - 20,000;0;2;-2;0;0;0
873790;Freebot : Battle for FreeWeb;Indie, Strategy;0 - 20,000;11;7;4;0;0;0
873810;Cars Arena;Adventure, Casual, Indie, Simulation;0 - 20,000;11;9;2;0;0;0
873820;The Brink 尘与土的边缘;Indie, Simulation;0 - 20,000;33;7;26;0;0;0
873830;Subcube;Adventure, Casual, Indie;0 - 20,000;6;0;6;0;0;0
873840;Truck and Logistics Simulator;Adventure;50,000 - 100,000;970;428;542;192;197;14
873850;PASSAGE;Action, Casual, Indie;0 - 20,000;4;5;-1;0;0;0
873860;Pop Island - Let's Code !!!;Action, Casual, Indie, Strategy;0 - 20,000;3;1;2;0;0;0
873890;Legends of Amberland: The Forgotten Crown;Casual, Indie, RPG;0 - 20,000;180;14;166;0;0;2
873900;Lost Artifacts: Golden Island;Action, Adventure, Indie, Simulation, Early Access;0 - 20,000;21;8;13;0;0;1
873910;Rail World;Indie;50,000 - 100,000;35;69;-34;1;1;0
873930;ALIENS INVADED OUR PLANET;Adventure, Casual, Free to Play, Simulation;20,000 - 50,000;47;30;17;0;0;0
873930;ALIENS INVADED OUR PLANET;Action, Adventure, Casual, Indie, Simulation, Strategy;20,000 - 50,000;47;30;17;0;0;0
873940;Crying Suns;Action, Adventure, Indie;200,000 - 500,000;3054;483;2571;478;520;25
873960;Panic Room 2: Hide and Seek;Action, Adventure, Casual, Indie, Strategy;50,000 - 100,000;32;37;-5;0;0;1
873970;Virtual Families 2: Our Dream House;Casual, Indie, Simulation;0 - 20,000;14;14;0;0;0;1
873980;Isle of Skye;Sexual Content, Nudity, Violent, Gore, Action, Adventure, Casual, Indie, RPG;20,000 - 50,000;89;43;46;190;190;3
874010;aMAZE Classic: Inverted;Action, Casual, Indie;0 - 20,000;68;18;50;0;0;0
874020;Lost Artifacts: Soulstone;Indie, Strategy;0 - 20,000;5;13;-8;0;0;0
874030;To the Core;Adventure, Casual, Indie;50,000 - 100,000;156;76;80;0;0;0
874040;Ministry of Broadcast;Action, Adventure, Casual, Indie;0 - 20,000;320;60;260;0;0;0
874040;Ministry of Broadcast;Casual, Indie;0 - 20,000;320;60;260;0;0;0
874080;Detective Failure;Action, Casual, Indie;0 - 20,000;4;0;4;0;0;0
874090;Living with Jaguars;Action, Casual, Indie, Racing;0 - 20,000;2;1;1;0;0;0
874130;HUNTER BRICK BALL;Action, Free to Play, Indie, Massively Multiplayer;0 - 20,000;33;14;19;0;0;0
874180;Vanguardian;Action, Adventure, Indie;0 - 20,000;3;0;3;0;0;0
874200;Swipe Fruit Smash;Indie;20,000 - 50,000;26;17;9;0;0;0
874230;Antirocketh;Action, Free to Play, Indie, Early Access;20,000 - 50,000;13;11;2;0;0;0
874240;MU Legend;Adventure, Casual, Indie, RPG, Strategy;500,000 - 1,000,000;1817;1872;-55;1516;76;28
874250;Hum Drum Experiences;Casual, Indie, Simulation, Early Access;0 - 20,000;1;1;0;0;0;0
874260;The Forgotten City;Action, Free to Play, Indie, Massively Multiplayer, Strategy;200,000 - 500,000;6845;243;6602;486;633;29
874270;Sphaera;Casual, Indie, Strategy;0 - 20,000;18;31;-13;0;0;0
874330;Me And Dungeons;Action, Casual, Indie, Strategy, Early Access;0 - 20,000;9;15;-6;0;0;0
874370;Repentant;Action, Casual, Free to Play, Massively Multiplayer;0 - 20,000;59;15;44;0;0;0
874380;Chess Puzzles;Action, Casual, Indie;20,000 - 50,000;9;18;-9;0;0;0
874390;The Battle of Polytopia;Action, Indie;200,000 - 500,000;2968;167;2801;564;564;155
874400;Dinosaur Hunt Puzzle;Adventure, Casual, Indie;50,000 - 100,000;242;88;154;0;0;7
874460;Achtung! Cthulhu Tactics;Adventure, Casual, Indie, RPG;0 - 20,000;143;64;79;0;0;2
874630;M.A.D. Cliff - All Quiet On The Bridge;Casual, Indie;0 - 20,000;0;1;-1;0;0;0
874640;The Life's Lane;Adventure, Indie;0 - 20,000;1;4;-3;0;0;0
874650;XXX Puzzle;Racing;50,000 - 100,000;247;147;100;0;0;0
874690;Maze And Dagger;Action, Adventure, Indie;0 - 20,000;15;7;8;0;0;0
874700;The Putinland: Divide & Conquer;Adventure, Casual;0 - 20,000;19;20;-1;0;0;0
874760;GIPHY World VR;Adventure, Casual, Indie;0 - 20,000;14;4;10;0;0;0
874770;Goinund;Indie;20,000 - 50,000;19;2;17;0;0;0
874780;Brick Breaker Premium;Casual, Indie;20,000 - 50,000;3;3;0;0;0;0
874810;Brick Breaker Premium 3;Casual, Indie;0 - 20,000;1;2;-1;0;0;0
874830;School of Horror;Indie, RPG, Simulation;50,000 - 100,000;14;50;-36;0;0;0
874840;ArcBall 3: Infinity;Casual, Indie, RPG;0 - 20,000;2;10;-8;0;0;0
874870;NextVR - Live Sports and Entertainment in Virtual Reality;Action, Casual;0 - 20,000;19;12;7;0;0;0
874880;Hat Hunters;Action, Casual, Indie;0 - 20,000;6;5;1;0;0;0
874930;What A Trash Game!;Action, Early Access;0 - 20,000;7;6;1;0;0;0
875080;Solar Explorer: New Dawn;Simulation, Strategy;0 - 20,000;10;1;9;0;0;0
875100;Tiger Tank 59 Ⅰ;Action, Adventure, Casual, Indie;0 - 20,000;1;4;-3;0;0;0
875110;InfiniPicross 2.0;Casual, Indie, Simulation;0 - 20,000;20;3;17;0;0;2
875160;Mall Town;Adventure, Casual, Indie;0 - 20,000;8;3;5;0;0;0
875210;Kingdom Heroes 8;Action, Adventure, Casual, Indie;500,000 - 1,000,000;7422;6272;1150;2971;2333;737
875230;Good Girl;Action, Casual;0 - 20,000;0;2;-2;0;0;0
875240;Tree Bonsai;Adventure, Casual, RPG;0 - 20,000;120;31;89;0;0;0
875250;Recursive Dragon;Casual;0 - 20,000;5;9;-4;0;0;0
875260;Frozen Soul;Action, Indie, Simulation, Early Access;0 - 20,000;5;43;-38;0;0;0
875270;Anceder;Indie;20,000 - 50,000;12;1;11;0;0;0
875300;De Fobos y Deimos;Action, Casual, Free to Play, Simulation;0 - 20,000;54;3;51;0;0;1
875310;LIBERATED;Action, Adventure, Indie, RPG, Early Access;200,000 - 500,000;498;145;353;0;0;1
875320;Exo Racing;Adventure, Casual, Indie, RPG;0 - 20,000;0;1;-1;0;0;0
875340;Dead Mayhem;Adventure, Indie, Simulation;0 - 20,000;7;3;4;0;0;0
875360;Last Alive;Action, Adventure, Casual, Indie, Early Access;0 - 20,000;1;13;-12;0;0;0
875400;Blackout: The Darkest Night;Action, Adventure, Indie;0 - 20,000;13;0;13;0;0;0
875430;Hentai Words;Adventure, Casual, Indie;0 - 20,000;21;22;-1;0;0;0
875460;Pixel-Me;Indie, Simulation, Strategy;0 - 20,000;17;2;15;0;0;0
875480;Somnium Space VR;Adventure, Casual;50,000 - 100,000;42;39;3;0;0;2
875500;Factory of Monsters;Violent, Action, Casual, Indie, Simulation;0 - 20,000;3;1;2;0;0;0
875510;Midnight Awake;Action, Casual, Indie;0 - 20,000;6;1;5;0;0;0
875520;Freddy's Journey;Adventure, Casual, Indie, Simulation;0 - 20,000;6;1;5;0;0;0
875530;Dead In Time;Adventure, Indie;0 - 20,000;7;3;4;0;0;0
875540;Virtual telescope;Indie, Simulation;0 - 20,000;10;6;4;0;0;0
875550;Vogue, The Explorer;Casual, Indie;0 - 20,000;7;18;-11;0;0;0
875610;Loop-Loop DX;Adventure, Indie, Simulation;0 - 20,000;400;5;395;0;0;1
875630;Call each NEW YEAR;Action, Casual, Indie, Simulation;0 - 20,000;6;8;-2;0;0;0
875660;Tales From Windy Meadow;Adventure, Casual, Indie;0 - 20,000;12;0;12;0;0;0
875670;Sophisticated Puzzle;Action, Indie, RPG;0 - 20,000;24;9;15;0;0;0
875680;Achievement Clicker: The End;Casual, Indie;0 - 20,000;0;0;0;0;0;0
875710;BRANE: Prototype;Action, Adventure, Casual, Indie, Massively Multiplayer, RPG, Simulation, Strategy, Early Access;0 - 20,000;8;4;4;0;0;0
875740;Scorch;RPG;50,000 - 100,000;252;56;196;0;0;0
875760;Furious Seas;Casual, Indie;0 - 20,000;174;60;114;51;51;5
875780;Trivia King;Action, Adventure, Free to Play, Massively Multiplayer, RPG;20,000 - 50,000;2;3;-1;0;0;0
875790;The Movie Trivia Challenge;Casual, Indie, Simulation, Strategy;20,000 - 50,000;2;0;2;0;0;0
875800;Wasteland Remastered;Action, Racing, Simulation, Sports;20,000 - 50,000;151;57;94;197;337;0
875810;Salio;Indie, Simulation, Sports;0 - 20,000;9;3;6;0;0;0
875830;Moral King;Action, Adventure, Casual, Free to Play, Indie;20,000 - 50,000;55;14;41;0;0;0
875930;Rehtona  幻境双生;Massively Multiplayer, Racing, Simulation, Sports;0 - 20,000;132;6;126;0;0;1
876100;Zodicat;Adventure, Casual, Indie, Simulation;0 - 20,000;3;0;3;0;0;0
876110;Envoy of Nezphere;Action, Adventure, Casual, Indie;20,000 - 50,000;13;16;-3;0;0;0
876130;Crazy Farm : VRGROUND;Free to Play, Indie, Simulation, Early Access;0 - 20,000;9;2;7;0;0;0
876140;Police Air Transporter;Adventure;0 - 20,000;3;10;-7;0;0;0
876160;Occupy White Walls;Adventure, Casual;50,000 - 100,000;1138;91;1047;0;0;6
876170;DDS (D.I.Y Drone Simulator);Adventure, Casual;0 - 20,000;0;3;-3;0;0;0
876180;Skyscrapers Puzzle: Airi's tale;Adventure, Casual;0 - 20,000;14;1;13;0;0;0
876190;Football Drama;Adventure, Casual;0 - 20,000;51;24;27;0;0;0
876200;Laserium;Adventure, Casual;50,000 - 100,000;82;42;40;0;0;0
876210;Zen Space Flight - VR Showcase;Adventure, Indie;0 - 20,000;2;1;1;0;0;0
876220;Moss Destruction;Action, Adventure, Casual, Indie;0 - 20,000;78;30;48;0;0;0
876260;Top Down Survivor;Adventure, Indie;0 - 20,000;9;2;7;0;0;0
876270;Homo Flimsy - The Ragdoll Goalkeeping Simulator;Casual, Simulation, Strategy;0 - 20,000;1;0;1;0;0;0
876290;Let's Split Up (A Visual Novel);Casual, RPG;0 - 20,000;4;5;-1;0;0;0
876300;ROAD HOMEWARD;Action, Free to Play, Massively Multiplayer;0 - 20,000;12;10;2;0;0;0
876310;BIG POGO MAN;Adventure, Casual, Indie, Early Access;0 - 20,000;45;13;32;0;0;0
876320;Hyperspace Delivery Service;Casual, Free to Play, Indie;0 - 20,000;37;4;33;0;0;0
876330;Revelation Online;Casual, Indie;200,000 - 500,000;365;410;-45;1952;200;7
876340;VR Slots 3D;Action;0 - 20,000;16;17;-1;0;0;0
876380;Underwater hunting;Racing, Simulation;20,000 - 50,000;40;29;11;0;0;0
876410;Greenspawn Restaurant;Action, Adventure, Casual, Indie;0 - 20,000;1;1;0;0;0;0
876460;CityBattle | Virtual Earth (EU);Adventure, Indie, RPG;20,000 - 50,000;37;15;22;8;8;1
876470;Tentlan;Action, Casual, Indie, Early Access;50,000 - 100,000;58;61;-3;0;0;10
876480;Vosaria: Lair of the Forgotten;Casual, Indie, Simulation, Strategy;0 - 20,000;4;0;4;0;0;0
876500;HyperDot;Adventure, Indie;50,000 - 100,000;29;5;24;0;0;0
876540;Adventure Hero;Action, Casual, Indie;0 - 20,000;1;1;0;0;0;0
876580;CanYouSurvive?;Action, Adventure, Casual, RPG;0 - 20,000;1;0;1;0;0;0
876650;Aground;Adventure, Indie, RPG;50,000 - 100,000;1328;75;1253;1594;1594;43
876780;Kronorite;Action, Indie, Early Access;0 - 20,000;9;1;8;0;0;0
876810;One Jump Bomb;Casual, Indie;0 - 20,000;1;1;0;0;0;0
876840;999;Adventure, Indie, RPG;0 - 20,000;7;6;1;0;0;0
876850;WhiteLily 1：丽丽公主;Casual, Indie, Simulation;50,000 - 100,000;1147;65;1082;0;0;3
876860;Magic Chess;Casual, Indie;0 - 20,000;3;11;-8;0;0;0
876870;Road Patrol Truck;Simulation, Early Access;0 - 20,000;3;13;-10;0;0;0
876880;Caretaker;Indie, Racing;0 - 20,000;11;12;-1;0;0;0
876890;Draw It! 2;Action, Adventure, Casual, Indie, Early Access;0 - 20,000;29;4;25;0;0;0
876900;Climb;Indie;100,000 - 200,000;294;94;200;0;0;0
876910;Aquarium Simulator;Casual, Indie;0 - 20,000;18;34;-16;0;0;0
876930;Fancy Skiing 2: Online;Indie;0 - 20,000;13;9;4;0;0;0
876950;PC Check & Tuning 2019 Steam Edition;Violent, Gore, Action, Adventure, Indie, Strategy;0 - 20,000;20;9;11;0;0;3
877010;Beyond Contact;Adventure, Casual, Indie;20,000 - 50,000;273;116;157;499;499;10
877040;Samurai Wish;Violent, Action, Indie;0 - 20,000;11;4;7;0;0;0
877060;MultiBall (BLADOSHARIK);Action, Indie, Racing;0 - 20,000;3;0;3;0;0;0
877070;Ticktock;Action, Casual, Indie;0 - 20,000;1;1;0;0;0;0
877080;Seeds of Resilience;Casual, Indie, RPG;20,000 - 50,000;239;102;137;264;264;3
877150;Gravity Wars;Adventure, Casual, Indie;20,000 - 50,000;144;112;32;0;0;0
877180;Candy;Casual, Indie;0 - 20,000;5;0;5;0;0;0
877190;Flamebound;Action, Adventure, Indie;0 - 20,000;29;10;19;0;0;0
877200;Zero Caliber VR;Casual, Indie, Early Access;200,000 - 500,000;3208;894;2314;319;106;52
877230;Welcome to the Pool Hall;Casual;0 - 20,000;9;4;5;0;0;0
877250;Devochka Quest;Casual, Indie;0 - 20,000;3;5;-2;0;0;0
877260;Retro Snake;Indie, Simulation, Strategy, Early Access;20,000 - 50,000;26;23;3;0;0;0
877270;The Pirates of Sector 7;Action, Indie;0 - 20,000;4;2;2;0;0;0
877300;Liquid Sunshine;Action, Indie, Early Access;50,000 - 100,000;2;1;1;0;0;0
877340;ATMOTECH EPISODE PRAELUDIUM;Casual, Indie, Strategy, Early Access;0 - 20,000;1;0;1;0;0;0
877360;18+;Video Production;20,000 - 50,000;387;196;191;0;0;1
877380;Factory Manager;Adventure, Indie, Simulation, Strategy;0 - 20,000;9;8;1;0;0;0
877440;Quench;Indie;0 - 20,000;20;1;19;0;0;0
877460;Welcome To... Chichester 0 : Preview;Indie, Simulation, Sports, Early Access;0 - 20,000;13;7;6;0;0;0
877470;Rage of the Pumpkins - Space Prostitutes Must Die! Again;Free to Play, Massively Multiplayer, RPG;0 - 20,000;4;4;0;0;0;0
877480;Ammo Pigs: Armed and Delicious;Adventure, Indie;0 - 20,000;6;1;5;0;0;0
877510;The Station VR;Casual, Indie;0 - 20,000;17;11;6;0;0;0
877550;Digital Jigsaw Puzzle;Action, Casual, Indie, Simulation;0 - 20,000;18;5;13;0;0;0
877590;Gensokyo Rolling Force / 幻想郷ローリングフォース;Action, Adventure, Indie;0 - 20,000;3;4;-1;0;0;0
877680;Hardcore Weapon Challenge - FPS Action;Indie;0 - 20,000;6;4;2;0;0;0
877710;Micromanagement;Adventure, Casual, Indie;0 - 20,000;3;0;3;0;0;0
877730;Deadly Silence;Casual, Indie;0 - 20,000;4;4;0;0;0;0
877750;Coinon;Action, Indie, RPG;0 - 20,000;3;16;-13;0;0;0
877780;Puzzles for smart: Cats;Action, Casual, Indie, Sports;0 - 20,000;14;8;6;0;0;0
877800;Swimsanity!;Casual, Indie, RPG, Simulation;0 - 20,000;17;4;13;0;0;0
877810;Anodyne 2: Return to Dust;Casual, Indie;0 - 20,000;526;34;492;207;207;3
877840;Pixel Hentai Mosaic;Free to Play, Indie;0 - 20,000;113;30;83;0;0;0
877850;TribeXR DJ School;Action, Casual, Indie, Early Access;0 - 20,000;172;15;157;0;0;3
877870;World Soccer Strikers '91;Indie;0 - 20,000;18;2;16;0;0;0
877910;Time Drifter;Action, Casual, Indie, Early Access;20,000 - 50,000;86;15;71;0;0;0
877940;Gekraxel;Adventure, Casual, Indie, Simulation, Early Access;0 - 20,000;18;1;17;0;0;0
877960;The Legend of Monster Mountain;Audio Production, Utilities;0 - 20,000;9;2;7;0;0;0
877980;Hunting fields of Jackals;Action, Indie, Strategy;0 - 20,000;10;9;1;0;0;0
878020;It's You: A Breakup Story;Adventure, Indie, Simulation;0 - 20,000;43;7;36;0;0;0
878030;Trains & Things;Adventure, Simulation;0 - 20,000;2;0;2;0;0;0
878080;Board Battlefield;Adventure, Casual, Indie, Simulation;0 - 20,000;24;35;-11;0;0;0
878090;The Dragons' Twilight II;Action, Adventure;0 - 20,000;21;1;20;0;0;1
878100;One Day for Revenge;Action, Casual, Indie;0 - 20,000;5;3;2;0;0;0
878120;UniteStar;Adventure, Free to Play, Indie;0 - 20,000;1;3;-2;0;0;0
878140;Witch of the Woods;Indie, Simulation;0 - 20,000;6;1;5;0;0;0
878150;Core Awaken ~The Yuka~;Casual, Indie, Simulation, Sports;0 - 20,000;29;3;26;0;0;0
878160;Granny's Grantastic Granventure;Action, Indie, Racing, Sports;0 - 20,000;5;13;-8;0;0;0
878170;Nazi;Action;0 - 20,000;42;10;32;0;0;0
878180;Hyper Simon X;Sexual Content, Nudity, Casual, Indie, Simulation;0 - 20,000;36;9;27;0;0;0
878240;Adva-lines;Action, Adventure, Casual, Free to Play, Indie;0 - 20,000;10;9;1;0;0;0
878250;Super Jigsaw Puzzle: Monuments;Adventure, Casual, Indie, RPG, Strategy;0 - 20,000;35;1;34;0;0;2
878270;Trivia Vault: Music Trivia;Indie, Simulation, Early Access;0 - 20,000;13;12;1;0;0;0
878280;Distorted Illusions;Action, Adventure, Indie;0 - 20,000;13;3;10;0;0;0
878290;Double Switch - 25th Anniversary Edition;Adventure, Free to Play, Indie;0 - 20,000;25;5;20;0;0;0
878290;Double Switch - 25th Anniversary Edition;Action, Adventure, Casual, Indie, Racing, Simulation;0 - 20,000;25;5;20;0;0;0
878300;RollTheEarth;Casual, Indie, Simulation;0 - 20,000;3;3;0;0;0;0
878310;Dishwasher;Action, Free to Play, Indie, Sports, Early Access;50,000 - 100,000;2;3;-1;0;0;0
878320;SIMULACRA: Pipe Dreams;Indie, RPG;50,000 - 100,000;596;124;472;0;0;1
878330;Whip! Whip!;Action, Adventure, Indie, RPG;0 - 20,000;17;3;14;0;0;0
878340;WISGR;Casual, Indie;0 - 20,000;4;0;4;0;0;0
878350;TAVERN GUARDIANS: BANQUET;Sexual Content, Nudity;0 - 20,000;53;21;32;0;0;1
878380;Touhou Big Big Battle;Casual, Indie, RPG, Simulation, Strategy, Early Access;100,000 - 200,000;3099;726;2373;133;31;17
878400;Muay Thai Fighting;Casual, Racing, Simulation;0 - 20,000;0;5;-5;0;0;0
878410;Unbroken Warrior;Casual, Simulation;0 - 20,000;1;4;-3;0;0;0
878420;Woodpunk;Casual, Indie, Simulation, Sports;20,000 - 50,000;122;47;75;0;0;0
878440;Fantasy Ball;Adventure, Indie, Early Access;0 - 20,000;9;0;9;0;0;0
878470;70 Seconds Survival;Strategy;20,000 - 50,000;10;16;-6;0;0;0
878500;Captain The Runner;Action, Adventure, Indie;0 - 20,000;4;7;-3;0;0;0
878510;Sort the Cube;Casual, Indie, Strategy;0 - 20,000;2;1;1;0;0;0
878520;Sally's Salon: Kiss & Make-Up;Casual, Indie, Strategy;0 - 20,000;69;29;40;0;0;1
878540;Coach Bus Simulator Parking;Casual, Indie;0 - 20,000;0;2;-2;0;0;0
878570;Cryptochain;Action, Indie;50,000 - 100,000;7;9;-2;0;0;0
878580;GARAGE: Bad Trip;Casual, Indie, Simulation, Strategy;50,000 - 100,000;396;204;192;187;202;1
878610;Don't Feed The Slimes!;Action, Indie, Early Access;0 - 20,000;1;0;1;0;0;0
878620;Neotrie VR Multiplayer;Adventure, Indie, RPG, Early Access;0 - 20,000;7;1;6;0;0;0
878640;LO-OP;Casual, Indie, Strategy;0 - 20,000;10;9;1;0;0;0
878660;Build buildings;Action, Casual, Indie;20,000 - 50,000;11;12;-1;0;0;0
878670;Shenmue III;Adventure, Indie;20,000 - 50,000;693;223;470;773;933;12
878710;Draft Day Sports: College Football 2018;Action, Adventure, Indie, Simulation;0 - 20,000;4;5;-1;0;0;0
878750;Hentai Girl;Action, Indie, RPG, Strategy, Early Access;200,000 - 500,000;4662;450;4212;97;32;17
878770;Spear Master;Casual, Indie, Simulation;0 - 20,000;9;1;8;0;0;0
878780;Cute Cats PuZZles;Action, Casual, Indie;20,000 - 50,000;26;10;16;0;0;0
878810;Ashes of the Ark;Action, Casual, Indie, Racing;0 - 20,000;1;7;-6;0;0;0
878820;The Castle Disaster 2;Action, Indie;0 - 20,000;10;16;-6;0;0;0
878880;AnyTime Organizer Deluxe 16;RPG, Simulation, Sports;0 - 20,000;0;2;-2;0;0;0
878890;AnyTime Organizer Standard 16;Simulation;0 - 20,000;0;1;-1;0;0;0
878910;Sarah in the Sky;Action, Simulation, Early Access;0 - 20,000;2;0;2;0;0;0
878910;Sarah in the Sky;Violent, Gore, Casual;0 - 20,000;2;0;2;0;0;0
878940;Collective: the Community Created Card Game;Action, Adventure, Indie;0 - 20,000;162;38;124;0;0;2
878970;The Block Box;Action, Indie, Massively Multiplayer, Early Access;0 - 20,000;0;0;0;0;0;0
878980;Welcome To The Dreamscape;Action, Casual, Free to Play, Indie, Racing, Sports, Early Access;0 - 20,000;9;13;-4;0;0;0
879000;Comanche;Casual, Indie, Strategy;0 - 20,000;177;105;72;0;0;3
879030;Egg Teacher VR;Adventure, Free to Play;0 - 20,000;11;4;7;0;0;0
879060;BORIS the Mutant Bear with a Gun;Action, Adventure, Indie, RPG, Early Access;0 - 20,000;35;9;26;0;0;0
879090;Meower's Quest: Jasper's Tale;Indie, Strategy, Early Access;0 - 20,000;1;1;0;0;0;0
879100;STARSHIP AVENGER Operation: Take Back Earth/スターシップアベンジャー 地球奪還大作戦;Casual, Indie, Simulation, Strategy;0 - 20,000;3;1;2;0;0;0
879110;Dragon`s Checkers;Indie, RPG;0 - 20,000;4;2;2;0;0;0
879140;Space Channel 5 VR Kinda Funky News Flash!;Casual, Indie;0 - 20,000;56;4;52;0;0;0
879140;Space Channel 5 VR Kinda Funky News Flash!;Action, Indie, Strategy;0 - 20,000;56;4;52;0;0;0
879160;Battlerite Royale;Action, Adventure, Casual, Indie;500,000 - 1,000,000;5951;2071;3880;481;142;21
879200;KIN;Design & Illustration;0 - 20,000;5;3;2;0;0;0
879250;Dot to Dot Puzzles;Action, Adventure, Indie, RPG;50,000 - 100,000;130;30;100;0;0;2
879260;WINDSHIFT;Casual, Indie, RPG;0 - 20,000;4;3;1;0;0;0
879270;'1st Core: The Zombie Killing Cyborg';Indie, Racing;0 - 20,000;11;8;3;0;0;0
879280;Supesu;Adventure, Indie, RPG;0 - 20,000;29;8;21;0;0;0
879290;MultiTaskMaster;Casual, Indie, Sports;0 - 20,000;17;0;17;0;0;0
879390;PowerUp Elevation;Casual, Indie, Strategy;0 - 20,000;0;1;-1;0;0;0
879410;Let's Go There And Wander Nowhere;Action, Free to Play, Indie;0 - 20,000;21;17;4;0;0;0
879410;Let's Go There And Wander Nowhere;Sexual Content, Nudity, Casual, Indie, Simulation, Strategy;0 - 20,000;21;17;4;0;0;0
879430;Switch - Black & White;Action, Adventure;20,000 - 50,000;38;2;36;0;0;0
879450;The Chambers;Adventure, Casual, Indie;0 - 20,000;5;2;3;0;0;0
879470;Idle Hunter;Action, Free to Play, Indie;0 - 20,000;50;32;18;0;0;1
879480;The Journey to Fairytales;Casual, Indie;0 - 20,000;2;1;1;0;0;0
879510;Lucy Got Problems;Casual, Indie, Strategy;20,000 - 50,000;683;67;616;118;159;14
879520;Ruby & Majesty: Treasure Team;Action, Indie;0 - 20,000;9;1;8;0;0;0
879530;Thunderbowl;Casual, Indie;0 - 20,000;0;0;0;0;0;0
879600;Ones and Zeroes;Casual, Indie, Strategy;0 - 20,000;6;2;4;0;0;0
879610;Girl Mod | GIRLS VR (create + pose in VR);Action, Indie;0 - 20,000;12;18;-6;0;0;0
879620;Armored Train;Free to Play, Indie, RPG;0 - 20,000;10;10;0;0;0;0
879650;Stick Arena;Action, Adventure, Indie, Early Access;0 - 20,000;71;47;24;0;0;1
879660;10k;Casual, Simulation, Sports;0 - 20,000;3;1;2;0;0;0
879670;Battle Simulator;Violent, Gore, Action, Adventure, Indie, Simulation;20,000 - 50,000;90;75;15;0;0;0
879670;Battle Simulator;Adventure, Indie, Strategy;20,000 - 50,000;90;75;15;0;0;0
879740;Epic Skater 2;Action, Adventure, Indie;0 - 20,000;18;4;14;0;0;0
879850;Box: The Game;Casual, Indie;50,000 - 100,000;111;65;46;0;0;1
879920;Trakker;Action, Adventure, Casual, Indie, Early Access;0 - 20,000;2;0;2;0;0;0
880130;Lawless Lands;Simulation, Early Access;50,000 - 100,000;81;6;75;0;0;2
880180;Long Road;Casual;0 - 20,000;10;1;9;0;0;0
880200;J15 Jet Fighter VR (歼15舰载机);Casual, Indie;0 - 20,000;21;22;-1;0;0;1
880220;~Azur Ring~virgin and slave's phylacteries;Violent, Action, Casual, Indie, Simulation;0 - 20,000;155;72;83;0;0;0
880270;GeoGebra Mixed Reality;Action, Adventure;0 - 20,000;7;2;5;0;0;0
880300;Blood will be Spilled;Action, Adventure;0 - 20,000;49;19;30;0;0;0
880310;Pro Microphone;Indie, Strategy, Early Access;0 - 20,000;6;7;-1;0;0;0
880320;魔装術師アカネ / Magic MechSuit Akane;Casual, Indie;0 - 20,000;2;1;1;0;0;0
880340;Trooper 2 - Alien Justice;Casual, Indie;0 - 20,000;3;0;3;0;0;0
880370;Jetpack Dog;Action, Adventure, Free to Play, Simulation;0 - 20,000;11;1;10;0;0;0
880380;Franchise Hockey Manager 5;Casual, Indie, Simulation;0 - 20,000;91;64;27;0;0;0
880400;Lingering Fragrance;Action, Adventure, Indie, Early Access;50,000 - 100,000;504;46;458;132;151;0
880470;Pro Basketball Manager 2019;Adventure, Casual, Free to Play, Indie, Simulation, Sports, Strategy;0 - 20,000;32;37;-5;0;0;0
880490;与雾雨魔理沙一起偷重要的东西 ~ Happy Stealing with Kirisame Marisa;Action, Adventure, Indie;20,000 - 50,000;196;19;177;0;0;0
880510;Girl and Goblin;Casual, Indie;50,000 - 100,000;947;98;849;22;31;2
880550;How to be Best Russian Game Developer;Casual, Indie, Racing;20,000 - 50,000;20;15;5;0;0;0
880550;How to be Best Russian Game Developer;Action, Indie, Racing;20,000 - 50,000;20;15;5;0;0;0
880570;Drugs to Bee;Casual, Indie;0 - 20,000;15;1;14;0;0;0
880590;Slabs;Action, Free to Play, Massively Multiplayer, RPG, Strategy;0 - 20,000;1;6;-5;0;0;0
880610;Lets Beats;Adventure, Casual, Indie, RPG, Strategy, Early Access;0 - 20,000;35;3;32;0;0;0
880620;荒漠求生;Racing;0 - 20,000;18;17;1;0;0;0
880620;荒漠求生;Simulation;0 - 20,000;18;17;1;0;0;0
880720;Entangled;Adventure, Casual, Indie;0 - 20,000;5;0;5;0;0;0
880730;Rocket Assault: Black City;Action, Casual, Indie;0 - 20,000;195;13;182;281;281;0
880750;Astra Exodus;Action, Free to Play, Massively Multiplayer, Simulation, Strategy;0 - 20,000;24;26;-2;0;0;1
880770;Cybrus;Free to Play, Strategy;0 - 20,000;3;1;2;0;0;0
880780;Vatnik Simulator - A Russian Patriot Game;Adventure, Indie, RPG, Strategy;0 - 20,000;10;13;-3;0;0;0
880800;AKAI NOROI;Adventure, Casual, Indie, RPG, Simulation;0 - 20,000;14;15;-1;0;0;0
880830;Cavesweeper;Action, Adventure, Indie, RPG, Strategy;50,000 - 100,000;13;2;11;0;0;0
880840;Sniper Fodder;Action, Adventure, Indie;0 - 20,000;11;7;4;0;0;0
880850;War Rock;Action, Casual, Indie;200,000 - 500,000;535;375;160;467;887;65
880860;Juan v Juan;Adventure, Casual, Indie, Simulation;0 - 20,000;17;5;12;0;0;0
880860;Juan v Juan;Casual, Indie, Simulation, Sports;0 - 20,000;17;5;12;0;0;0
880870;Donut Arena;Action, Adventure, Casual, Indie, RPG, Strategy;0 - 20,000;17;0;17;0;0;1
880890;Dark Visit;Action, Indie;0 - 20,000;6;9;-3;0;0;0
880940;Pummel Party;Casual, RPG, Simulation;2,000,000 - 5,000,000;37896;4651;33245;576;399;2672
880950;Maitetsu:Pure Station;Indie, Strategy, Early Access;100,000 - 200,000;3083;97;2986;403;449;18
880950;Maitetsu:Pure Station;Casual;100,000 - 200,000;3083;97;2986;403;449;18
880990;School Idol;Adventure, Casual, Indie;0 - 20,000;8;24;-16;0;0;0
881040;Bug Academy;Action, Racing, Simulation;0 - 20,000;232;9;223;357;357;1
881050;獣王/BEAST KING;Action, Indie;0 - 20,000;15;4;11;0;0;0
881050;獣王/BEAST KING;Casual, Indie;0 - 20,000;15;4;11;0;0;0
881060;Fortune and Gloria;Adventure, Casual, Indie, RPG, Strategy;0 - 20,000;4;2;2;0;0;0
881090;Super Dodgeball Beats;Action;0 - 20,000;23;1;22;0;0;0
881100;Noita;Action;1,000,000 - 2,000,000;48588;2369;46219;1863;372;1956
881110;Incel Clicker;Casual, Indie;0 - 20,000;10;1;9;0;0;0
881130;Synthwave Dream '85;Indie, RPG, Strategy;0 - 20,000;54;6;48;0;0;0
881150;Shooting over it : to be a star;Adventure, Indie;0 - 20,000;3;3;0;0;0;0
881170;Bloody Sand;Action, Free to Play, Indie;0 - 20,000;13;20;-7;0;0;0
881190;Robbotto;Action, Indie;0 - 20,000;6;3;3;0;0;0
881230;Top Down Racer;Adventure, Indie, RPG;100,000 - 200,000;17;10;7;0;0;0
881260;Vagrant Fury;Indie;0 - 20,000;5;1;4;0;0;0
881310;BearHammer;Adventure, Casual, Indie;0 - 20,000;3;4;-1;0;0;0
881320;The LEGO Movie 2 Videogame;Adventure, Casual, Indie, Massively Multiplayer, RPG, Simulation, Sports, Strategy;100,000 - 200,000;664;288;376;320;464;29
881390;WorkinVR;Action, Indie;0 - 20,000;4;3;1;0;0;0
881420;Six Ages: Ride Like the Wind;Action, Casual, Free to Play, Indie;20,000 - 50,000;305;69;236;0;0;4
881470;Combo Postage;Action, Indie;0 - 20,000;10;0;10;0;0;0
881490;Tower Keepers;Action, Adventure, Indie;20,000 - 50,000;72;61;11;0;0;8
881500;Steamulator 2019;Action, Adventure, Indie, RPG, Strategy;0 - 20,000;11;11;0;0;0;0
881510;The Official GamingTaylor Game, Great Job!;Action, Indie;50,000 - 100,000;47;66;-19;0;0;0
881520;Geometry Defense: Infinite;Action, Indie;0 - 20,000;14;5;9;0;0;0
881560;How To Date A Magical Girl!;Adventure, Indie, Strategy, Early Access;20,000 - 50,000;344;73;271;0;0;0
881610;Professor Watts Word Search: Space Voyage;Action, Adventure, Casual, Indie, RPG, Simulation, Early Access;20,000 - 50,000;8;19;-11;0;0;0
881620;Plumber: the Pipe Rush;Adventure, Casual, Indie;0 - 20,000;2;0;2;0;0;0
881670;Screensavers VR;Action, Indie, Strategy;0 - 20,000;4;2;2;0;0;0
881680;Mouse Enhancer Pro;Action;0 - 20,000;85;19;66;0;0;6
881690;The Slater;Audio Production;50,000 - 100,000;592;206;386;128;144;4
881730;Train Simulator: London Subway;Indie;0 - 20,000;11;10;1;0;0;0
881750;Furwind;Casual, Indie;0 - 20,000;28;12;16;0;0;0
881750;Furwind;English;0 - 20,000;28;12;16;0;0;0
881820;Egony;Casual;0 - 20,000;3;1;2;0;0;0
881880;Degeneration;Adventure, Casual, Free to Play, Indie;0 - 20,000;7;7;0;0;0;0
881910;The Battle Of Ages;Action, Adventure, Casual, Indie;0 - 20,000;2;1;1;0;0;0
881920;Depression The Game;Action, Early Access;0 - 20,000;182;82;100;0;0;1
881930;Business Tycoon Billionaire;Casual, Indie, Massively Multiplayer, Racing;0 - 20,000;3;9;-6;0;0;0
881970;"Voice Shooter ""Pif Paf""";Action, Free to Play, Indie, Early Access;0 - 20,000;2;1;1;0;0;0
881980;Drive Switch Evade;Adventure, Casual, Indie, RPG, Strategy;0 - 20,000;8;2;6;0;0;0
882020;Monster Energy Supercross - The Official Videogame 2;Indie, RPG;20,000 - 50,000;485;90;395;1217;1217;7
882030;Fragmania.gg (BETA);Adventure, Indie;0 - 20,000;10;3;7;0;0;0
882040;The Outpost Nine: Episode 1;Adventure, Indie, RPG;0 - 20,000;36;11;25;0;0;0
882070;PlatONIR;Action;0 - 20,000;32;24;8;0;0;0
882080;Star'Shoot;Casual, Indie, Simulation, Strategy;0 - 20,000;17;1;16;0;0;0
882100;XCOM: Chimera Squad;Indie, RPG, Strategy;500,000 - 1,000,000;14955;5694;9261;544;483;272
882110;Google Spotlight Stories: Age of Sail;Indie, RPG;50,000 - 100,000;426;7;419;9;13;0
882120;Rugon - Unfinished;Adventure, Casual, Indie;0 - 20,000;7;5;2;0;0;0
882140;Reentry - An Orbital Simulator;Adventure, Indie, RPG;50,000 - 100,000;502;21;481;73;83;17
882150;Sky Link;Casual, Indie;0 - 20,000;57;11;46;0;0;0
882200;Reveal;Casual, Indie;0 - 20,000;14;15;-1;0;0;0
882210;Duke of Defense;Casual, Indie, Simulation;20,000 - 50,000;47;4;43;0;0;0
882220;Mecha-Tokyo Rush;Adventure, Casual, Indie;0 - 20,000;65;21;44;0;0;0
882230;Dog's Quest;Action, Casual, Indie;0 - 20,000;3;3;0;0;0;0
882250;Metro Sim Hustle;Casual, Indie;0 - 20,000;224;50;174;77;77;2
882260;HellMaze;Casual, Indie, Simulation;0 - 20,000;2;1;1;0;0;0
882280;Tinkr Garage;Casual, Indie;50,000 - 100,000;17;39;-22;0;0;0
882330;Sudoku Original;Action, Adventure, Indie, Simulation;0 - 20,000;14;13;1;0;0;0
882390;EnHanced;Adventure, Indie;0 - 20,000;14;4;10;0;0;0
882410;Age of Fear: The Free World;Adventure, Casual, Indie;100,000 - 200,000;308;56;252;0;0;3
882460;The Warrior War;Casual, Indie;0 - 20,000;7;13;-6;0;0;0
882560;Door;Indie, RPG;20,000 - 50,000;87;46;41;0;0;3
882600;Chess Multiple Boards;Adventure, Indie;0 - 20,000;1;1;0;0;0;0
882620;Zeon 25;Action, Adventure, Indie;0 - 20,000;46;7;39;0;0;1
882630;Leviathan;;0 - 20,000;5;10;-5;0;0;0
882640;Ashley Clark: Secret of the Ruby;Adventure, Casual, Indie, RPG;0 - 20,000;42;9;33;0;0;0
882670;Nono's magic general shop;Action, Casual, Indie;0 - 20,000;35;22;13;0;0;2
882680;Foreskin Fury;Adventure, RPG;0 - 20,000;58;11;47;7;7;0
882700;Thievery;Action, Indie;0 - 20,000;2;0;2;0;0;0
882710;東方幕華祭 TouHou Makuka Sai ~ Fantastic Danmaku Festival;Casual, Indie, Strategy;20,000 - 50,000;1115;35;1080;8;8;7
882750;1 HIT KILL;Indie, Strategy;0 - 20,000;1;0;1;0;0;0
882760;Nom Nom Apocalypse;Action, Indie;0 - 20,000;21;11;10;0;0;0
882790;Fate Seeker;Casual, Indie;500,000 - 1,000,000;11405;1082;10323;546;221;129
882840;True North;Action, Casual, Indie, Early Access;0 - 20,000;7;1;6;0;0;0
882860;Another Reigny Day;Action, Casual, Indie, Racing, Simulation;20,000 - 50,000;1;0;1;0;0;0
882900;Lu Bu Maker;Indie;0 - 20,000;131;19;112;0;0;3
882910;BATTLE X;Casual, Indie, Racing;0 - 20,000;9;10;-1;0;0;0
882940;The Moment We Met;Casual, Indie;50,000 - 100,000;148;93;55;0;0;0
882960;Visitor 来访者;Education, Software Training, Utilities;50,000 - 100,000;591;154;437;0;0;0
882980;Night Of the Loving Dead;Action, Adventure, Casual, Indie;0 - 20,000;2;2;0;0;0;0
882990;BAD DAY;Adventure, Casual, Indie, Simulation, Strategy, Early Access;0 - 20,000;6;4;2;0;0;0
883000;Horror Rollercoaster;Sexual Content, Casual;0 - 20,000;3;3;0;0;0;0
883020;Shadowlings;Action, Adventure, Indie, RPG;0 - 20,000;73;16;57;0;0;0
883070;Viviette;Violent, Action, Adventure, Indie;0 - 20,000;328;43;285;308;308;1
883080;Ludo Online: Classic Multiplayer Dice Board Game;Action, Adventure, Massively Multiplayer, RPG, Early Access;20,000 - 50,000;257;56;201;0;0;3
883100;360 No Scope Arena;Animation & Modeling, Utilities, Video Production;20,000 - 50,000;594;71;523;53;93;0
883130;New Star Manager;Adventure, Casual, Indie, Strategy;0 - 20,000;354;50;304;0;0;7
883140;VEGAS Pro 16 Edit Steam Edition;Utilities;0 - 20,000;122;66;56;0;0;17
883170;AVATAR: Consolidate;Action, Adventure, Casual, Indie, Early Access;0 - 20,000;4;12;-8;0;0;0
883190;Jorji and Impossible Forest;Action;0 - 20,000;8;5;3;0;0;0
883220;Fugue in Void;Action, Adventure;0 - 20,000;117;60;57;0;0;0
883270;Immortals(修仙志);Action, Casual, Indie;0 - 20,000;3;1;2;0;0;0
883280;Struggle For Light;Action, Adventure, Indie, RPG;0 - 20,000;5;0;5;0;0;0
883290;MixCast;RPG;0 - 20,000;8;13;-5;0;0;0
883300;Poverty is a Choice;Casual, Indie, Massively Multiplayer, Sports, Strategy;0 - 20,000;4;3;1;0;0;0
883330;The Skeleton;Adventure, Indie, RPG, Simulation, Early Access;0 - 20,000;8;2;6;0;0;0
883360;Beyond Blue;Action, Casual, Indie;100,000 - 200,000;912;132;780;195;195;0
883370;Shimmer;Casual, Indie, RPG;0 - 20,000;4;4;0;0;0;0
883390;Beyond the Mind;Casual, Indie, Simulation;20,000 - 50,000;4;6;-2;0;0;0
883400;The treasure of the lost temple;Adventure, Casual, RPG, Strategy;0 - 20,000;1;0;1;0;0;0
883560;Wardens of the Amber Cage;Adventure, Indie;0 - 20,000;19;2;17;0;0;0
883590;Nocturne: Prelude;Action, Free to Play, Indie;100,000 - 200,000;383;12;371;0;0;0
883620;FlowDot;Action, Casual, Indie, Simulation;0 - 20,000;6;2;4;0;0;0
883630;Rocket Island;Violent, Action, Indie, RPG;0 - 20,000;5;0;5;0;0;0
883670;V.T.;Adventure, Free to Play, Indie;0 - 20,000;28;28;0;0;0;0
883680;Four Kings One War;Adventure, Indie;20,000 - 50,000;94;76;18;0;0;0
883710;Resident Evil 2;Casual, Sports;5,000,000 - 10,000,000;118982;3503;115479;1202;727;1539
883780;Wayblock;Casual;0 - 20,000;1;0;1;0;0;0
883790;Three life;Action, Adventure, Casual, Indie, Racing, Strategy;0 - 20,000;5;3;2;0;0;0
883810;Nocturne of Steel;Adventure, Indie, Simulation;0 - 20,000;5;1;4;0;0;0
883830;NSFWare;Casual;0 - 20,000;4;0;4;0;0;0
883860;Cadria Item Shop;Video Production;200,000 - 500,000;996;380;616;3594;3651;404
883870;霎时晴荫;Adventure, Casual, Indie;0 - 20,000;91;7;84;0;0;0
883880;Faraway: Puzzle Escape;Casual, Indie, Strategy;0 - 20,000;46;18;28;0;0;1
883900;ERI;Action, Indie, Strategy, Early Access;0 - 20,000;4;1;3;0;0;0
883930;Mercs;Casual, Indie, Strategy;0 - 20,000;3;1;2;0;0;0
883960;The Lost And Forgotten: Part 1;Casual, Indie, Simulation, Sports, Strategy;0 - 20,000;2;2;0;0;0;0
883970;Little Imps: A Dungeon Builder;Action, Adventure, RPG, Simulation, Strategy;0 - 20,000;20;32;-12;0;0;0
884080;Munchies;Adventure, Casual, Indie, Strategy;0 - 20,000;4;0;4;0;0;0
884090;Idle Dungeons;Adventure, Casual, Indie, Simulation, Strategy;50,000 - 100,000;68;154;-86;0;0;0
884160;HyperZen Training;Education;0 - 20,000;8;2;6;0;0;0
884200;PUGNite;Adventure;0 - 20,000;78;60;18;0;0;0
884260;Akane;Casual;100,000 - 200,000;2148;90;2058;296;364;16
884270;Cabins: Jigsaw Puzzles;Free to Play, Indie, Simulation;0 - 20,000;8;1;7;0;0;0
884290;Cat's Yarn;Casual;0 - 20,000;2;2;0;0;0;0
884340;Hold Out;Action, RPG, Strategy;0 - 20,000;25;17;8;0;0;0
884350;The Unfolding Engine: Paint a Game;Casual;0 - 20,000;19;4;15;0;0;2
884370;Hotel Transylvania Popstic;Simulation;0 - 20,000;12;1;11;0;0;0
884390;Professor Watts Word Search: Pirates Life;Action, Adventure, Casual, Indie;20,000 - 50,000;10;12;-2;0;0;0
884400;The Harbinger's Head;Casual, Free to Play, RPG, Simulation, Strategy;0 - 20,000;15;1;14;0;0;0
884410;Unnatural;Utilities;0 - 20,000;13;7;6;0;0;0
884420;The Last Wizard;Action, Adventure, Casual, Indie, RPG;0 - 20,000;16;4;12;0;0;0
884430;The Magician's Burden;Casual, Indie, Simulation;0 - 20,000;5;7;-2;0;0;0
884440;Professor Watts Word Search: Yummy Foods;Action, Casual, Indie;0 - 20,000;12;15;-3;0;0;0
884460;Beyond Tokyo;;0 - 20,000;2;2;0;0;0;0
884470;Sunken;Adventure, Strategy;0 - 20,000;5;0;5;0;0;0
884500;Bitcoin Mining Tycoon;Adventure, Indie;0 - 20,000;0;4;-4;0;0;0
884530;Pro Gamer Tycoon;Action, Indie, Simulation, Sports;0 - 20,000;2;11;-9;0;0;0
884550;Mist of the Dark;Adventure, Indie, RPG;100,000 - 200,000;62;67;-5;0;0;0
884590;Garage Master 2018;Adventure, Casual, Indie;0 - 20,000;1;5;-4;0;0;0
884610;Road Rage Royale;Action, Casual, Indie;0 - 20,000;1;0;1;0;0;0
884630;Golden Fall;Indie;0 - 20,000;3;0;3;0;0;0
884640;Mines and Magic;Indie;0 - 20,000;47;14;33;0;0;1
884660;CRSED: F.O.A.D.;Action, Indie;2,000,000 - 5,000,000;29879;7688;22191;191;44;279
884770;Astro Bouncer;Casual, RPG, Early Access;50,000 - 100,000;6;4;2;0;0;0
884830;Football Manager 2019: The Hashtag United Challenge;Simulation;20,000 - 50,000;52;7;45;25;25;0
884880;Super Seeker;Indie, Simulation, Strategy, Early Access;0 - 20,000;7;4;3;0;0;0
884900;Slider;Action, Adventure, Casual, Indie;20,000 - 50,000;5;5;0;0;0;0
884910;The Grid;Action, Adventure, Indie, RPG, Early Access;0 - 20,000;1;0;1;0;0;0
884960;Rolling in the Reef;Indie;0 - 20,000;27;2;25;0;0;0
884980;Code Romantic;Action, Casual, Free to Play;0 - 20,000;34;1;33;0;0;0
884990;Absinth;Casual, Indie, Strategy;0 - 20,000;68;24;44;0;0;0
885000;Synth Riders;Casual, Indie, Strategy;50,000 - 100,000;1186;88;1098;83;115;24
885030;Platform Builder;Adventure, Casual, Indie, RPG;20,000 - 50,000;56;10;46;0;0;1
885080;My Town: Dessert Slice;Action, Indie;0 - 20,000;1;0;1;0;0;0
885090;Digital Siege;Casual, Indie, Strategy;0 - 20,000;3;30;-27;0;0;0
885100;Intelligence Trader;Adventure, Casual, Indie;0 - 20,000;19;39;-20;0;0;0
885110;Imperialism: Fate of India;Action, Adventure, Indie;0 - 20,000;9;15;-6;0;0;0
885120;Werewolves: Haven Rising;Action, Adventure, RPG, Early Access;0 - 20,000;73;8;65;0;0;2
885140;七人杀阵 - Seven Sacrifices;Adventure, Indie, Simulation;20,000 - 50,000;751;165;586;38;47;1
885150;Capcom Beat 'Em Up Bundle;Action, Indie, Simulation, Sports;100,000 - 200,000;860;127;733;637;637;7
885190;Mahjong Pretty Manga Girls;Animation & Modeling;0 - 20,000;20;20;0;0;0;0
885220;Neon Cat Tickler;Action, Adventure, Free to Play, RPG;0 - 20,000;6;1;5;0;0;0
885240;Tower Stacker;Indie;50,000 - 100,000;5;4;1;0;0;0
885250;Mind Map VR / マインドマップVR;Action, Adventure, Indie;0 - 20,000;4;4;0;0;0;0
885290;AceSpeeder3;Casual, Indie, Simulation;0 - 20,000;8;2;6;0;0;0
885320;Cro Magnon;Utilities;0 - 20,000;5;7;-2;0;0;0
885380;Need a packet?;Action, Adventure, Indie, RPG, Early Access;0 - 20,000;26;16;10;0;0;0
885380;Need a packet?;Action, Adventure;0 - 20,000;26;16;10;0;0;0
885440;Easy Audio Visualization;Indie;20,000 - 50,000;64;15;49;0;0;0
885440;Easy Audio Visualization;Adventure, Casual;20,000 - 50,000;64;15;49;0;0;0
885470;Wired;Casual, Indie, Racing, Early Access;0 - 20,000;79;7;72;0;0;1
885480;Maze Crusher;Action, Indie, RPG, Early Access;0 - 20,000;1;0;1;0;0;0
885570;Nova-Life: Amboise;Action, Casual, Indie;50,000 - 100,000;442;130;312;0;0;141
885590;Time;Casual, Indie, Strategy;0 - 20,000;12;7;5;0;0;0
885630;Floor Massacre;Adventure, Casual, Indie;0 - 20,000;23;16;7;0;0;0
885640;Lynne;Adventure, Casual, Indie, Strategy;50,000 - 100,000;685;182;503;50;50;0
885650;The Waters Above: Prelude;Audio Production, Utilities;20,000 - 50,000;106;8;98;0;0;0
885730;Aerial Guardian;Adventure, Casual, Indie;20,000 - 50,000;20;60;-40;0;0;0
885780;Legion's Crawl;Action, Indie;0 - 20,000;32;9;23;0;0;1
885790;Ayni Fairyland;Action, Adventure, Indie;0 - 20,000;18;2;16;0;0;0
885810;The Witch's House MV;Action, Indie, RPG, Early Access;50,000 - 100,000;2294;73;2221;154;165;17
885890;Immortal Quest;Adventure, Casual, Indie;0 - 20,000;0;0;0;0;0;0
885910;Ginga Force;Adventure, Indie;0 - 20,000;68;5;63;0;0;0
885950;Airranger;Casual, Indie;0 - 20,000;119;6;113;0;0;0
885970;Total War: ROME REMASTERED;Adventure, Casual, Indie;500,000 - 1,000,000;6426;2324;4102;614;434;1055
886010;Smash Halloween Pumpkins: The Challenge;Action, Adventure;20,000 - 50,000;9;10;-1;0;0;0
886020;Jumper Magic;Action, Adventure, Casual, Free to Play, Indie;0 - 20,000;4;5;-1;0;0;0
886040;Hentai Temple;Action, Casual, Indie;20,000 - 50,000;381;154;227;26;27;0
886060;Redout: Space Assault;Action, Indie;0 - 20,000;39;46;-7;0;0;0
886070;Jewel Match Solitaire;Casual, Indie, Sports;0 - 20,000;103;9;94;0;0;4
886110;RKN Block Me: Telegram;Action, Indie;0 - 20,000;0;0;0;0;0;0
886120;UpBreakers;Action, Adventure, Casual, Indie, Simulation, Strategy;0 - 20,000;17;9;8;0;0;0
886160;Respublica;Adventure, Indie;50,000 - 100,000;134;85;49;0;0;0
886180;Blood Money;Action, Indie;0 - 20,000;18;3;15;0;0;0
886200;EndCycle VS;Action, Adventure, Free to Play, Indie;0 - 20,000;74;2;72;0;0;0
886210;The Disgusting Slaughterman;Action, Indie;0 - 20,000;1;0;1;0;0;0
886220;Thunderballs VR;Adventure, Indie, RPG;20,000 - 50,000;8;2;6;0;0;0
886230;Noble Armada: Lost Worlds;Racing;0 - 20,000;1;3;-2;0;0;0
886250;PokerStars VR;Adventure, Indie, Simulation, Strategy;200,000 - 500,000;2358;420;1938;191;207;39
886270;Yeli Orog;Action, Indie;0 - 20,000;26;25;1;0;0;0
886290;Starfield Wars - 沙罗曼蛇 3D;Adventure, Indie, Racing, Early Access;0 - 20,000;2;5;-3;0;0;0
886300;Store Crasher;Action, Adventure, Indie;0 - 20,000;4;2;2;0;0;0
886310;The Island Combat;Action, Adventure, Indie;0 - 20,000;5;11;-6;0;0;0
886330;DomiCard;Casual, Indie;0 - 20,000;9;2;7;0;0;0
886350;Clouded;Action, Adventure, Racing, RPG;0 - 20,000;6;1;5;0;0;0
886360;Casino Mega Collection;Action, Adventure, Free to Play, Indie;0 - 20,000;18;12;6;0;0;4
886370;Multicellular;Adventure, Casual, Indie, RPG;0 - 20,000;35;19;16;0;0;0
886380;Ruya;Audio Production, Video Production;0 - 20,000;19;0;19;0;0;0
886390;A Roll-Back Story;Casual, Free to Play;0 - 20,000;10;7;3;0;0;0
886420;UnBorn;Adventure, Indie, RPG;0 - 20,000;2;9;-7;0;0;0
886450;Night of the Shrub Part 2;Action, Casual, Indie;20,000 - 50,000;0;1;-1;0;0;0
886460;Outside the Lines;Casual, Free to Play, Indie;;;;0;;;
886470;Another Otter;Action, Indie;50,000 - 100,000;84;40;44;0;0;0
886480;Audiate;Action, Adventure, Indie, RPG, Strategy;0 - 20,000;1;0;1;0;0;0
886480;Audiate;Indie;0 - 20,000;1;0;1;0;0;0
886490;SPEED BOX;Casual, Indie, Simulation;0 - 20,000;22;4;18;0;0;0
886520;HopeLine;Adventure, Casual, Indie, RPG;0 - 20,000;81;100;-19;0;0;0
886530;Golem Rush;Adventure, Casual, Indie;0 - 20,000;1;0;1;0;0;0
886540;Magical girl's labyrinth;Casual, Indie, RPG;0 - 20,000;0;1;-1;0;0;0
886590;My Bingo;Action, Simulation, Strategy;20,000 - 50,000;9;7;2;0;0;0
886600;BrutalAliens;Casual, Indie;0 - 20,000;6;1;5;0;0;0
886610;The Mystery of Happyville;Action, Adventure, Casual, Indie;0 - 20,000;3;3;0;0;0;0
886630;GlitchPets;Indie;0 - 20,000;47;4;43;0;0;1
886630;GlitchPets;Casual, Indie;0 - 20,000;47;4;43;0;0;1
886670;Proficient Paddles;Free to Play;0 - 20,000;7;3;4;0;0;0
886710;Lavender;Adventure, Casual, Indie, Racing, Simulation, Sports, Strategy;0 - 20,000;33;36;-3;0;0;0
886730;EPHEMERAL -FANTASY ON DARK-;Action, Adventure, Casual, Indie;0 - 20,000;61;9;52;0;0;1
886780;Jelly Wrestle;Action, Adventure, Casual, Indie;0 - 20,000;2;0;2;0;0;0
886820;Nelke & the Legendary Alchemists ~Ateliers of the New World~;Indie, Simulation, Sports, Strategy;0 - 20,000;169;51;118;0;0;3
886830;ParkourMan;Casual, Indie;0 - 20,000;4;1;3;0;0;0
886900;Chef: A Restaurant Tycoon Game;Adventure;20,000 - 50,000;900;305;595;1057;1792;22
886950;Roman The Worm;Indie, Simulation;0 - 20,000;28;6;22;0;0;0
886960;Dragon Spear;Action, Adventure, Indie;50,000 - 100,000;545;326;219;259;259;4
886970;Tomato Way 2;Action, Casual, Indie, Early Access;0 - 20,000;71;28;43;0;0;0
887040;Paper Planets;Adventure, Indie, RPG;0 - 20,000;0;0;0;0;0;0
887060;Asterix & Obelix XXL 2;Action, Indie, Early Access;20,000 - 50,000;554;144;410;359;397;7
887090;Blocks!: Richard III;Casual;0 - 20,000;60;17;43;0;0;1
887160;The Sunny Day 晴天;Action, Adventure, Indie;0 - 20,000;63;3;60;0;0;0
887170;Vortex Of Pain;Action, Casual, Indie;0 - 20,000;3;2;1;0;0;0
887240;MAGIX Photostory 2019 Deluxe Steam Edition;Action, Casual, Indie;0 - 20,000;2;2;0;0;0;0
887260;Moondust: Knuckles Tech Demos;Action, Casual, Indie;20,000 - 50,000;52;2;50;0;0;0
887280;Epic Helicopter;Design & Illustration, Photo Editing;0 - 20,000;1;0;1;0;0;0
887300;Bleeding Sun;Adventure, Indie, RPG;0 - 20,000;9;2;7;0;0;0
887340;Owl Watch;Action, Adventure, Indie, RPG, Early Access;0 - 20,000;98;25;73;0;0;0
887370;Element Space;Action, Adventure, Casual, Indie, Simulation, Sports;20,000 - 50,000;155;114;41;0;0;0
887400;THE GREAT GEOMETRIC MULTIVERSE TOUR;Indie, Simulation, Sports;50,000 - 100,000;268;77;191;0;0;0
887420;Warman;Casual, Simulation;0 - 20,000;40;4;36;0;0;0
887440;Fractal Chicken;Action, Adventure, Indie;0 - 20,000;5;1;4;0;0;0
887450;Tunche;Adventure, Casual, Indie;20,000 - 50,000;439;124;315;121;121;6
887510;Galencia;Action, Indie, Massively Multiplayer, Early Access;0 - 20,000;26;0;26;0;0;0
887520;Seat of War;Adventure, Casual, Indie, RPG, Simulation, Strategy;0 - 20,000;11;9;2;0;0;0
887530;President Yukino;Action, Adventure, Casual, Strategy;50,000 - 100,000;516;141;375;0;0;3
887550;Dimetrosaur;Adventure, Casual, Indie;20,000 - 50,000;30;3;27;0;0;0
887570;NEBULOUS: Fleet Command;Action, Adventure, Casual, Indie, Simulation, Strategy;50,000 - 100,000;1449;105;1344;79;126;111
887590;BoxRunner;Free to Play, Simulation;0 - 20,000;1;0;1;0;0;0
887630;Harpoon Cat;Action, Adventure, Casual, Indie, Simulation, Strategy;0 - 20,000;1;2;-1;0;0;1
887710;Ritter;Indie, Simulation;0 - 20,000;5;11;-6;0;0;0
887710;Ritter;Casual, Indie, RPG;0 - 20,000;5;11;-6;0;0;0
887720;Devil's Hunt;Indie, Simulation, Early Access;50,000 - 100,000;350;527;-177;219;262;1
887720;Devil's Hunt;Casual, Indie;50,000 - 100,000;350;527;-177;219;262;1
887730;Horde: Zombie Outbreak;Action, Adventure, Casual, Indie;0 - 20,000;17;4;13;0;0;0
887740;老虎游戏-tiger casino&slot game;Action, Casual, Massively Multiplayer;0 - 20,000;17;23;-6;0;0;0
887750;Opus Mortem;Adventure, Casual, Indie, RPG, Sports;0 - 20,000;6;0;6;0;0;0
887800;Snooker 19;Action, Indie, Simulation, Sports;0 - 20,000;402;157;245;0;0;58
887800;Snooker 19;Action, Adventure, Indie;0 - 20,000;402;157;245;0;0;58
887830;Pretend;Casual, Indie, Simulation, Sports;50,000 - 100,000;781;610;171;12;16;0
887830;Pretend;Casual;50,000 - 100,000;781;610;171;12;16;0
887870;Retro Racers 2;Casual, Indie;0 - 20,000;1;1;0;0;0;0
887880;O.C.D. - On Completeness & Dissonance;Casual, Indie, RPG, Simulation, Early Access;0 - 20,000;6;3;3;0;0;0
887890;Puzzles By Axis Hyper;Action, Adventure, Free to Play, Indie, Early Access;0 - 20,000;10;1;9;0;0;0
887910;Rite of Passage: The Lost Tides Collector's Edition;Action, Adventure, Massively Multiplayer, Early Access;0 - 20,000;2;1;1;0;0;0
887920;Maestro: Music from the Void Collector's Edition;Action, Adventure, Casual;0 - 20,000;4;0;4;0;0;0
887930;PuppetShow: Destiny Undone Collector's Edition;Casual, Free to Play, Indie, RPG, Simulation;0 - 20,000;6;1;5;0;0;0
887940;Amaranthine Voyage: The Obsidian Book Collector's Edition;Casual, Indie, Racing, RPG, Simulation, Sports;0 - 20,000;2;1;1;0;0;1
887950;Danse Macabre: Thin Ice Collector's Edition;Action, Casual, Indie;0 - 20,000;2;0;2;0;0;0
887960;Mystery Case Files: Rewind Collector's Edition;Action, Adventure, Casual, Indie;0 - 20,000;12;8;4;0;0;0
887970;Generation Streets;Casual, Indie, Strategy;20,000 - 50,000;140;52;88;0;0;0
887970;Generation Streets;Adventure, Indie;20,000 - 50,000;140;52;88;0;0;0
888010;Tango: The Adventure Game;Free to Play, Strategy;0 - 20,000;53;10;43;0;0;0
888010;Tango: The Adventure Game;Action, Indie;0 - 20,000;53;10;43;0;0;0
888030;Pilot Rudder VR;Action, Casual, Indie;0 - 20,000;0;3;-3;0;0;0
888040;Metal Fatigue;Free to Play, Indie;50,000 - 100,000;318;21;297;100;100;5
888070;Railroad Tracks;Casual;0 - 20,000;25;19;6;0;0;1
888070;Railroad Tracks;Action, Adventure, Indie, Simulation, Early Access;0 - 20,000;25;19;6;0;0;1
888090;TREE;Action, Adventure, Casual, Massively Multiplayer, RPG, Simulation;200,000 - 500,000;1922;113;1809;0;0;1
888130;Starport Delta;Adventure, Casual, Indie, Simulation, Strategy, Early Access;0 - 20,000;55;21;34;0;0;0
888140;Quatris;Action;0 - 20,000;4;3;1;0;0;0
888150;Space Hamster in Turmoil;Action, Casual, Free to Play, Indie, Simulation, Strategy, Early Access;0 - 20,000;1;0;1;0;0;0
888200;PSI Magic;Casual, Indie;0 - 20,000;0;1;-1;0;0;0
888220;MatchyGotchy Z;Action, Adventure, Casual, Indie;0 - 20,000;12;1;11;0;0;0
888250;Ultimate War;Action, Indie;0 - 20,000;1;1;0;0;0;0
888310;Suitchi;Indie, RPG, Simulation, Strategy;0 - 20,000;4;0;4;0;0;0
888370;Song Writer;Adventure, Casual, Free to Play, Indie, RPG, Early Access;0 - 20,000;10;4;6;0;0;0
888380;ZOLO - Zombies Only Live Once;RPG;0 - 20,000;6;1;5;0;0;0
888400;World of War : Battlegrounds;Casual, Indie;0 - 20,000;0;4;-4;0;0;0
888480;Ninja SpeedRush;Adventure;0 - 20,000;3;0;3;0;0;0
888530;Yaga;Casual, Indie;100,000 - 200,000;383;89;294;176;276;2
888540;Project 59;Indie;0 - 20,000;1;4;-3;0;0;0
888560;Forest Rabbit;Action, Casual, Indie, Simulation;0 - 20,000;2;1;1;0;0;0
888570;Zombie Head;Casual;20,000 - 50,000;4;3;1;0;0;0
888610;Oligopoly: Industrial Revolution;Casual, Indie, Strategy, Early Access;0 - 20,000;7;8;-1;0;0;0
888620;Pilgrimage;Action, Adventure, Indie;0 - 20,000;4;5;-1;0;0;0
888630;Another Sight - Definitive Edition;Action, Casual, Indie, Early Access;0 - 20,000;125;35;90;0;0;0
888640;Lovestory;Action, Casual, Indie, Early Access;0 - 20,000;4;1;3;0;0;0
888670;Notified;Action, Adventure, Casual, Indie;0 - 20,000;12;8;4;0;0;0
888690;Guess who ?;Action, Indie, Massively Multiplayer;50,000 - 100,000;57;43;14;0;0;0
888710;Pitch Perfect Ear Training;Action;0 - 20,000;3;2;1;0;0;0
888740;FortOfTheNight;Adventure, Casual, Indie;0 - 20,000;6;9;-3;0;0;0
888750;Seed of Amaranth;Action;0 - 20,000;4;1;3;0;0;0
888790;Sabbat of the Witch;Action, Free to Play, RPG;20,000 - 50,000;2033;31;2002;201;201;34
888800;S.F.77;Action, Indie, Early Access;0 - 20,000;22;12;10;0;0;0
888810;Wetwork;Adventure;0 - 20,000;5;8;-3;0;0;0
888880;Summer: Jigsaw Puzzles;Adventure, Free to Play, Indie;0 - 20,000;0;1;-1;0;0;0
888900;ZYX STORY;Action, Adventure, Casual, Indie, Simulation;0 - 20,000;11;0;11;0;0;0
888910;Tano's Fate;Action, Indie;0 - 20,000;0;0;0;0;0;0
888970;MiniCar Race - 极品飞车2019 Mini;Action, Adventure, Casual, Indie;0 - 20,000;7;9;-2;0;0;0
888990;雨上がりのハナビィ Ameagari no Hanaby;Action, Indie;0 - 20,000;64;1;63;0;0;1
889030;GKO;Action, Adventure, Indie, RPG;0 - 20,000;3;2;1;0;0;0
889040;FPV Air 2;Indie;50,000 - 100,000;183;60;123;465;465;2
889060;Open Space 2D;RPG, Simulation;0 - 20,000;0;1;-1;0;0;0
889080;Deity Empires;Casual, Indie, Strategy;20,000 - 50,000;267;33;234;14;14;18
889100;Pythagoras' Perpetual Motion Machine;Action, Adventure, Casual, Indie, RPG;0 - 20,000;7;1;6;0;0;0
889130;KnifeBoy Rebooted;Indie, RPG, Strategy;0 - 20,000;5;3;2;0;0;0
889150;IgKnight Food Fight;Adventure, Indie, RPG;0 - 20,000;5;0;5;0;0;0
889170;Battle Royale Builder;Adventure, Casual;0 - 20,000;30;12;18;0;0;0
889210;Two Wars - Part 1;Action, Strategy;0 - 20,000;4;1;3;0;0;0
889220;A Stickman Reality;Action, Adventure, Free to Play, Simulation;50,000 - 100,000;40;7;33;0;0;0
889240;Loot Box Simulator;Indie;0 - 20,000;63;19;44;0;0;0
889240;Loot Box Simulator;Adventure, Casual;0 - 20,000;63;19;44;0;0;0
889260;Bonkies;Adventure, Casual, Indie, RPG, Strategy;100,000 - 200,000;28;0;28;0;0;0
889290;Echoes World;Action, Casual;0 - 20,000;1;0;1;0;0;0
889320;The Plant;Action, Indie;0 - 20,000;32;5;27;0;0;0
889320;The Plant;Casual, Indie;0 - 20,000;32;5;27;0;0;0
889330;Nerved;Adventure, Indie, Strategy;0 - 20,000;7;11;-4;0;0;0
889400;StickyBots;Action, Free to Play, Indie;0 - 20,000;20;0;20;0;0;0
889450;Centifeed;Simulation, Strategy;0 - 20,000;6;0;6;0;0;0
889470;Another world: Truck driver;Action, Casual, Indie;0 - 20,000;2;3;-1;0;0;0
889480;Virtual Virtual Reality;Adventure, Indie, Simulation;20,000 - 50,000;535;47;488;69;69;1
889510;SENRAN KAGURA Burst Re:Newal;Action, Casual, Indie, Strategy;50,000 - 100,000;1614;116;1498;130;160;10
889520;Empire;Action, Casual, Indie;0 - 20,000;33;5;28;0;0;0
889530;Sharp;Action, Indie;50,000 - 100,000;11;6;5;0;0;0
889600;The Caligula Effect: Overdose;Adventure, Indie;20,000 - 50,000;351;122;229;1629;2647;5
889680;Her;Action, Casual, Indie;0 - 20,000;0;0;0;0;0;0
889700;Muv-Luv photonflowers*;Adventure, Indie;0 - 20,000;161;11;150;1;2;1
889710;Muv-Luv photonmelodies♮;Action, Adventure, Casual, Indie;0 - 20,000;149;23;126;0;0;6
889720;Crypto Crisis;Action, Indie;0 - 20,000;22;11;11;0;0;0
889730;Downtown Mafia: Gang Wars;Action, Adventure, Indie;50,000 - 100,000;84;39;45;0;0;7
889740;The Oni Sellsword;Casual;20,000 - 50,000;58;3;55;0;0;0
889750;BABYLON'S FALL;Casual;50,000 - 100,000;188;292;-104;0;0;4
889790;Incandescent 2;Adventure, Casual, Indie;0 - 20,000;10;7;3;0;0;0
889850;Save President From Rebels;Action, Casual, Indie;0 - 20,000;5;6;-1;0;0;0
889910;Hell Pie;Action, Indie;20,000 - 50,000;645;45;600;0;0;6
889970;My Farm;Action, Adventure, Indie, Massively Multiplayer, RPG, Early Access;0 - 20,000;5;4;1;0;0;0
889990;RGBCELLS;Adventure, Indie;20,000 - 50,000;1;3;-2;0;0;0
890110;Deicide;Action, Adventure, Indie, Early Access;0 - 20,000;23;15;8;0;0;0
890130;Pawn of the Dead;Action, Adventure, Casual, Indie, Simulation, Sports;0 - 20,000;49;3;46;0;0;1
890180;Ecchi Cards;Simulation, Early Access;0 - 20,000;39;37;2;0;0;0
890200;Destruction  Paper;Casual, Indie, Strategy;0 - 20,000;0;2;-2;0;0;0
890210;Kids Learn;Indie, Simulation, Strategy;0 - 20,000;5;4;1;0;0;0
890220;Math Fun;Casual, Indie;0 - 20,000;108;20;88;0;0;0
890280;Myha: Return to the Lost Island;Indie, Strategy;0 - 20,000;40;9;31;0;0;2
890300;Kitrinos: Inside the Cube;Action, Indie;20,000 - 50,000;34;9;25;0;0;0
890310;Shadow Brawlers;Adventure, Indie, Simulation;0 - 20,000;62;2;60;0;0;0
890340;Lovefield General: Back to Work;Action, Adventure, Casual, Indie;0 - 20,000;12;1;11;0;0;0
890400;Uncharted Waters Online;Casual, Indie, Strategy;50,000 - 100,000;237;91;146;0;0;51
890470;Slave Master: The Game;Adventure, Casual, Indie, RPG, Simulation, Early Access;0 - 20,000;1;2;-1;0;0;0
890480;Widget Satchel;Indie;0 - 20,000;10;4;6;0;0;0
890500;Love ritual;Adventure, Casual, Indie;20,000 - 50,000;66;37;29;0;0;0
890520;Rocket Science;Free to Play, Indie, Simulation;20,000 - 50,000;70;21;49;0;0;0
890550;RUMBLE;Adventure, Indie;50,000 - 100,000;1118;187;931;147;261;21
890570;Almost Alive;Indie, Simulation, Early Access;20,000 - 50,000;167;49;118;0;0;0
890590;Knight King Assassin;Adventure, Indie, Simulation;0 - 20,000;15;3;12;0;0;0
890630;Perspectrum;Adventure, Casual, Indie;0 - 20,000;5;0;5;0;0;0
890640;Rampage of the Dead;Action, Indie;0 - 20,000;9;4;5;0;0;0
890680;Mars Troopers - 生化奇兵2019;Indie, Strategy, Early Access;0 - 20,000;0;2;-2;0;0;0
890690;Forgotten World;Action, Indie;0 - 20,000;0;2;-2;0;0;0
890700;Caffeine: Victoria's Legacy;Action, Indie;0 - 20,000;27;3;24;0;0;1
890710;Ecchi Puzzle;Indie, RPG;0 - 20,000;37;20;17;0;0;0
890720;In Other Waters;Action, Adventure, Indie, RPG;100,000 - 200,000;1348;186;1162;51;71;13
890740;A Gentlemanly Adventure;Action, Adventure, Indie;0 - 20,000;4;0;4;0;0;0
890750;Lily's Night Off;Casual, Indie;0 - 20,000;92;0;92;0;0;0
890800;Country Park;Casual, Indie;0 - 20,000;25;48;-23;0;0;0
890820;Valor Time;Indie, Simulation, Strategy, Early Access;20,000 - 50,000;76;96;-20;0;0;0
890840;Ilhumia;Casual, Indie;0 - 20,000;20;11;9;0;0;0
890880;FROSTBITE: Deadly Climate;Casual, Indie;50,000 - 100,000;426;62;364;0;0;0
890900;Whacker Guy: Distance Hunter;Casual, Indie;0 - 20,000;1;0;1;0;0;0
890910;Kill The Monster;Action, Adventure, Indie;0 - 20,000;2;0;2;0;0;0
890920;Glitch;Casual, Free to Play, Indie;50,000 - 100,000;196;173;23;0;0;0
890940;Romancing Monarchy;Casual, Indie;0 - 20,000;11;4;7;0;0;0
890970;Oakwood;Casual, Indie, Simulation;20,000 - 50,000;231;42;189;0;0;1
891020;Handball 21;Action, Indie;0 - 20,000;23;44;-21;0;0;1
891020;Handball 21;Action, Adventure, Indie;0 - 20,000;23;44;-21;0;0;1
891040;Pool 2D - Poolians;Adventure, Indie, RPG;500,000 - 1,000,000;5463;785;4678;0;0;218
891050;Deplau;Strategy, Early Access;0 - 20,000;2;1;1;0;0;0
891090;JUST a Game;Casual, Indie;20,000 - 50,000;18;14;4;0;0;0
891100;Ray of Light;Indie, Strategy;0 - 20,000;25;14;11;0;0;0
891110;Hell Knights;Action, Casual, Indie, Massively Multiplayer, Simulation, Early Access;0 - 20,000;7;0;7;0;0;0
891120;Watching Delusion;Adventure, Indie, Early Access;0 - 20,000;11;3;8;0;0;0
891130;SUPER FLAIL;Indie, Simulation, Strategy;0 - 20,000;139;11;128;0;0;1
891170;The Witch & The 66 Mushrooms;Action, Adventure, Simulation;50,000 - 100,000;145;18;127;0;0;1
891180;PINPIN BALLBALL;Adventure, Indie, Early Access;0 - 20,000;14;10;4;0;0;0
891190;CROSS X CARROT;Casual, Indie, Strategy;0 - 20,000;11;12;-1;0;0;0
891200;Bike Dash Excite!;Casual, Indie;20,000 - 50,000;22;19;3;0;0;0
891220;pla_toon;Action, Adventure, Casual, Indie;100,000 - 200,000;1224;182;1042;0;0;2
891270;Draft Day Sports: Pro Golf;Action, Indie;0 - 20,000;4;8;-4;0;0;0
891290;Easy Racing;Adventure, Indie;0 - 20,000;7;5;2;0;0;0
891310;Medical verdict;Indie;0 - 20,000;28;17;11;0;0;0
891310;Medical verdict;Adventure, Indie;0 - 20,000;28;17;11;0;0;0
891320;Echoes in White;Action, Indie;0 - 20,000;6;6;0;0;0;0
891330;Fast Dust;Adventure, Casual, Indie;0 - 20,000;5;5;0;0;0;0
891340;Roidrekt;Action, Adventure, Indie, RPG, Early Access;0 - 20,000;4;0;4;0;0;0
891350;JUST DASH;Action, Casual, Indie, Simulation;0 - 20,000;19;11;8;0;0;1
891360;Hellcoming;Action, Indie;20,000 - 50,000;571;138;433;566;566;9
891370;The Last Hex;Casual, Indie;0 - 20,000;167;37;130;0;0;0
891380;Retro Snake Adventures;Indie;0 - 20,000;3;1;2;0;0;0
891420;VR Model Viewer;Adventure, Indie, Strategy;0 - 20,000;31;15;16;0;0;0
891430;Rogue Heist;Adventure, Casual, Indie;100,000 - 200,000;136;261;-125;0;0;0
891470;Falling Blocks;Casual, Indie;20,000 - 50,000;3;8;-5;0;0;0
891480;Idle Expanse;Action, Adventure, Casual, Indie, Massively Multiplayer;50,000 - 100,000;71;60;11;0;0;1
891490;Capsule;Indie, RPG, Strategy, Early Access;20,000 - 50,000;13;3;10;0;0;0
891510;Love's Sweet Garnish;Casual;20,000 - 50,000;658;39;619;305;567;6
891510;Love's Sweet Garnish;Casual, Indie, RPG, Simulation, Strategy;20,000 - 50,000;658;39;619;305;567;6
891520;Tranquil Garden;Casual, Indie;0 - 20,000;6;1;5;0;0;0
891700;Mosaics Galore. Challenging journey;Casual, Indie, RPG, Strategy, Early Access;0 - 20,000;6;9;-3;0;0;0
891710;Thanksgiving Day Mosaic;Casual, Indie, Simulation;0 - 20,000;15;1;14;0;0;0
891720;Pirate Mosaic Puzzle. Caribbean Treasures;Casual, Free to Play, Indie;0 - 20,000;21;4;17;537;537;0
891790;Devil Engine;Casual, Indie, Simulation;0 - 20,000;104;12;92;0;0;0
891850;Astrela Starlight;Action, Indie;0 - 20,000;5;0;5;0;0;0
891870;King of Phoenix;Free to Play, Indie;0 - 20,000;11;3;8;2;2;0
891950;Wagers of War;Casual, Indie, Simulation;20,000 - 50,000;34;29;5;0;0;0
891960;WebbVR: The James Webb Space Telescope Virtual Experience;Casual, Indie;20,000 - 50,000;49;5;44;0;0;0
891990;Rusty Runner;Action, Adventure, Indie;0 - 20,000;4;6;-2;0;0;0
892020;Robots 2 Unknown World;Casual, Indie, Strategy;0 - 20,000;6;7;-1;0;0;0
892030;PowerDirector 17 Ultra - edit your shooting game, RPG, car game, and all videos;Action, Adventure, Free to Play, Early Access;0 - 20,000;15;11;4;0;0;0
892040;PowerDirector 17 Ultimate - Video editing, Video editor, making videos;Utilities;0 - 20,000;13;11;2;4063;4063;3
892050;PhotoDirector 10 Ultra - Photo editor, photo editing software;Action, Adventure, Casual;0 - 20,000;7;5;2;324;324;0
892130;The Searcher Wild West Adventure;Casual;0 - 20,000;3;11;-8;0;0;0
892170;ShapeSim - Construction Set;Casual, Indie, Strategy;0 - 20,000;4;8;-4;0;0;0
892180;Powernode;Casual, Indie, Strategy;0 - 20,000;4;3;1;0;0;0
892210;GUNGRAVE VR;Action, Casual, Indie;0 - 20,000;6;5;1;0;0;0
892310;Infinity Heroes;Action, Adventure, Indie;0 - 20,000;30;8;22;0;0;1
892380;Dr Greenstuff;Action, Casual;0 - 20,000;129;17;112;1806;1806;1
892420;懒人修仙传;Casual, Indie;200,000 - 500,000;760;503;257;8783;16235;105
892440;Exodus: Proxima Centauri;Casual, Indie, Simulation;0 - 20,000;7;3;4;0;0;0
892460;TwoPlay Mahjong(双人麻将);Adventure, Indie, Strategy, Early Access;0 - 20,000;1;2;-1;0;0;1
892470;BVRGER VAN;Action, Adventure, Indie, Massively Multiplayer, RPG;0 - 20,000;13;0;13;0;0;0
892490;Fish Catcher;Casual, Indie;0 - 20,000;14;6;8;0;0;0
892510;Slay Together;Action, Adventure, Massively Multiplayer, Racing, Early Access;0 - 20,000;292;120;172;0;0;0
892550;Beauty and the Beast: Hidden Object Fairy Tale. HOG;Adventure, Casual, Indie;0 - 20,000;56;17;39;0;0;1
892560;PaulPaul - Act 1;Indie, Strategy;0 - 20,000;36;2;34;0;0;0
892630;Mojo: Hanako;Casual, Indie;50,000 - 100,000;609;152;457;0;0;0
892640;FAN'CIE VEER! (Fish Are Nasty, Cake Is Excellent Vektor Evading Emblazed Rapture);Adventure, Simulation;0 - 20,000;5;2;3;0;0;0
892650;Play With Kizami;Action, Indie, Sports;20,000 - 50,000;182;122;60;35;35;0
892690;Daemon_9;Adventure, Indie;0 - 20,000;74;11;63;0;0;0
892760;Seed of Evil;Adventure, Casual, Indie, RPG;50,000 - 100,000;336;85;251;120;145;6
892780;Sanguine Sanctum;Adventure, Indie;0 - 20,000;38;2;36;0;0;0
892830;VRITRA COMPLETE EDITION;Action, Casual, Indie;0 - 20,000;29;1;28;0;0;0
892860;Hot Brass;Action, Free to Play, Massively Multiplayer;0 - 20,000;325;68;257;13;13;2
892880;Chocolate makes you happy 7;Action, Casual, Free to Play, Indie, RPG;0 - 20,000;37;9;28;0;0;0
892900;Emoto;Adventure, Casual, Indie, RPG, Simulation;0 - 20,000;5;3;2;0;0;0
892910;Space Wars;Simulation, Strategy;0 - 20,000;5;4;1;0;0;0
892930;Sonar Beat;Casual, Indie;20,000 - 50,000;10;6;4;0;0;0
892960;Dimension Of Gameth;Casual, Indie, Strategy;20,000 - 50,000;10;5;5;0;0;0
892970;Valheim;Action, Adventure, Casual, Free to Play, Indie, Simulation, Strategy;20,000,000 - 50,000,000;372374;19739;352635;2920;1246;44801
892980;My Heart Grows Fonder;Casual, Indie, Simulation;0 - 20,000;18;2;16;0;0;1
892990;Sable's Grimoire: A Dragon's Treasure;Action, Adventure, Casual, Indie, RPG, Strategy;0 - 20,000;56;0;56;0;0;0
893010;Slave's Sword;Action, Free to Play;50,000 - 100,000;459;159;300;175;282;6
893020;Slave's Sword 2;Casual, Indie, Racing;20,000 - 50,000;237;106;131;470;470;2
893030;Music Racer;Action, Casual;100,000 - 200,000;3170;405;2765;248;225;3
893050;Hasbro's BATTLESHIP;Indie;20,000 - 50,000;322;96;226;111;153;13
893060;WAyE;Strategy, Early Access;0 - 20,000;20;22;-2;0;0;0
893070;The End: Inari's Quest;Action, Adventure, Indie;0 - 20,000;27;44;-17;0;0;0
893090;Mad Factory;Casual;0 - 20,000;7;4;3;0;0;0
893120;Synthrun;Action, Indie, Massively Multiplayer;20,000 - 50,000;1;4;-3;0;0;0
893140;Gold Digger Maze;Action, Adventure, Indie;0 - 20,000;11;13;-2;0;0;0
893150;Fury Strike;Indie;0 - 20,000;14;18;-4;0;0;0
893170;MYSTERY HOUSE : SECRET STEALTH;Casual, Indie;0 - 20,000;0;1;-1;0;0;0
893180;Catherine Classic;Indie, Simulation, Sports, Early Access;200,000 - 500,000;6908;962;5946;359;326;52
893330;Voxel Race;Action, Adventure, Indie, RPG, Early Access;0 - 20,000;44;41;3;0;0;0
893350;Malfortune;Indie;0 - 20,000;1;1;0;0;0;0
893360;The Mansion;Strategy, Early Access;0 - 20,000;9;5;4;0;0;0
893390;Meridian 59;Casual, Indie;20,000 - 50,000;204;36;168;0;0;3
893420;Harvested;Casual;0 - 20,000;18;6;12;0;0;0
893450;Life After The Living;Casual, Indie;;;;0;;;
893460;NightmareBullet;Casual, Indie;0 - 20,000;3;4;-1;0;0;0
893470;Salary Man Escape;Action, Adventure, Indie, Early Access;20,000 - 50,000;34;1;33;0;0;0
893480;For the Revenge;Indie, Early Access;0 - 20,000;3;0;3;0;0;0
893490;Team A.R.G. Anthology;Action, Adventure, Casual, Indie, Strategy;0 - 20,000;4;1;3;0;0;0
893500;Reign of the Succubus;Action, Indie;20,000 - 50,000;78;59;19;0;0;0
893520;Creative Destruction;Action, Adventure, Casual, Free to Play, Indie, RPG, Simulation, Strategy;1,000,000 - 2,000,000;14778;4118;10660;1302;215;4
893560;Spire of Sorcery – Character Generator;Casual, Indie;0 - 20,000;34;6;28;0;0;0
893570;Short Life;Adventure, Indie, RPG;20,000 - 50,000;108;47;61;0;0;3
893590;Monopolist: Technological Revolution;Adventure, Free to Play, Indie, Massively Multiplayer, RPG, Strategy;20,000 - 50,000;4;8;-4;0;0;0
893610;Skautfold: Into the Fray;Casual, Free to Play, Indie, Strategy;0 - 20,000;65;9;56;0;0;1
893620;Azurael's Circle: Chapter 2;Action, Casual, Indie;0 - 20,000;18;3;15;0;0;0
893640;Dances with Butterflies VR;Action, Adventure, Casual, Indie;0 - 20,000;16;4;12;0;0;0
893650;CSI VR: Crime Scene Investigation;Action, Adventure, Indie;0 - 20,000;2;6;-4;0;0;0
893680;Project Warlock;Strategy;100,000 - 200,000;3807;546;3261;125;94;10
893690;Rikki & Vikki;Casual, Indie;0 - 20,000;85;5;80;0;0;0
893710;Mercenary Leto;Adventure, Casual, Indie, RPG, Early Access;0 - 20,000;7;0;7;0;0;0
893720;One Hand Clapping;Action, Simulation;20,000 - 50,000;438;70;368;89;89;2
893730;Viki Spotter: Camping;Action, Free to Play, Early Access;20,000 - 50,000;204;8;196;0;0;0
893740;Memory Trainer;Video Production;20,000 - 50,000;20;0;20;0;0;0
893790;Newfound Courage;Video Production;0 - 20,000;283;15;268;0;0;0
893810;Chrono Project;Adventure, Casual, Indie;0 - 20,000;4;0;4;0;0;0
893840;Roll for the Galaxy;Action, Adventure, Indie;0 - 20,000;102;6;96;0;0;4
893850;THE LONGING;Strategy;200,000 - 500,000;4509;379;4130;1764;2350;55
893870;Trials of Ascension: Exile;Indie, RPG, Strategy;0 - 20,000;29;28;1;0;0;0
893900;Astral Gunners;Action;0 - 20,000;30;0;30;0;0;0
893910;Science Simulator;Indie;0 - 20,000;3;0;3;0;0;0
893940;Super GMA;Indie;0 - 20,000;1;1;0;0;0;0
893950;RUSSI.A SIMULATOR;Adventure, Casual, Indie, RPG;20,000 - 50,000;253;93;160;0;0;0
893960;Running Naked Simulator 2019;Action, Adventure, Indie;0 - 20,000;8;4;4;0;0;0
894000;Night of the Blood Moon;Adventure, Casual;0 - 20,000;57;6;51;0;0;0
894010;Battle Of Worldviews;Action, Adventure, Casual, Indie;0 - 20,000;10;15;-5;0;0;0
894020;Death's Door;Casual, Indie, Sports;200,000 - 500,000;12060;783;11277;445;533;101
894070;Unmanned helicopter;Education;0 - 20,000;12;6;6;0;0;0
894090;Maze Gold Run;Casual;0 - 20,000;3;0;3;0;0;0
894110;PIDO1;Action, Strategy, Early Access;20,000 - 50,000;57;26;31;0;0;0
894120;Ghostman: The Council Calamity;Adventure, Indie, RPG;20,000 - 50,000;4;1;3;0;0;0
894160;Oh Boy Cheese;Action, Adventure, Casual, Indie, RPG, Strategy;0 - 20,000;12;0;12;0;0;0
894270;Beware of Trains;Free to Play;0 - 20,000;52;14;38;0;0;1
894310;Finding Light;Action, Adventure, Indie;0 - 20,000;17;1;16;0;0;0
894310;Finding Light;Adventure, Casual, Indie, Strategy, Early Access;0 - 20,000;17;1;16;0;0;0
894330;One Hunt;Indie;0 - 20,000;13;5;8;0;0;0
894340;Beat the Song;Casual, Indie;20,000 - 50,000;91;10;81;0;0;0
894360;ActionpaintVR;Indie, Simulation, Strategy;0 - 20,000;1;0;1;0;0;0
894380;Exoplanet;Adventure, Indie, Early Access;0 - 20,000;20;5;15;0;0;0
894390;Bernie’s Nightmare;Action, Casual, Indie;0 - 20,000;34;26;8;0;0;0
894420;Duke Dashington Remastered;Action, Adventure, Casual, Indie, Simulation, Strategy;20,000 - 50,000;33;2;31;0;0;0
894430;Push Blox 2;Simulation, Strategy, Early Access;0 - 20,000;15;0;15;0;0;0
894460;Crimson Gray: Dusk and Dawn;Adventure, Casual, Indie;0 - 20,000;92;7;85;79;79;0
894540;ShyChess;Action, Adventure, Early Access;0 - 20,000;33;8;25;0;0;0
894570;Supaplex HARD;Adventure, Casual, Simulation;0 - 20,000;11;1;10;0;0;0
894610;Hungry Kitty Donuts Mania;Action, Casual, Indie, RPG;0 - 20,000;3;1;2;0;0;0
894620;ATONE: Heart of the Elder Tree;Adventure, Indie;0 - 20,000;35;2;33;0;0;3
894630;Final Theory;Adventure, Indie, Simulation;50,000 - 100,000;274;62;212;0;0;5
894730;The Chronicles of Noah's Ark;Casual, Indie, Simulation, Strategy;0 - 20,000;7;3;4;0;0;0
894730;The Chronicles of Noah's Ark;Casual, Indie, Simulation;0 - 20,000;7;3;4;0;0;0
894740;Cosmic Ray;Indie, RPG, Strategy, Early Access;0 - 20,000;5;2;3;0;0;0
894750;L-Way;Casual, Indie, Strategy;0 - 20,000;8;3;5;0;0;0
894790;Invaders! From Outer Space;Action, Adventure, Indie, Massively Multiplayer;0 - 20,000;2;0;2;0;0;0
894820;Trumpy Wall;Action, Adventure, Indie;0 - 20,000;1;1;0;0;0;0
894830;Hanz Puppetguns;Casual, Indie;20,000 - 50,000;62;40;22;0;0;0
894890;Stalked at Night;Action, Indie, Sports;0 - 20,000;1;0;1;0;0;0
894920;ZKILLER;Action, Free to Play, Indie;0 - 20,000;19;14;5;0;0;0
894930;The Cage;Action, Adventure, Indie;0 - 20,000;21;11;10;0;0;0
894940;Littlewood;Adventure, Casual, Indie, Simulation, Early Access;200,000 - 500,000;5553;353;5200;890;713;82
894960;Evil Reap;Action, Casual, Indie;0 - 20,000;9;0;9;0;0;0
895000;Convergence Compulsion;Adventure, Casual, RPG, Simulation;0 - 20,000;5;0;5;0;0;0
895040;CSC | Space MMO;Action, Indie;20,000 - 50,000;297;184;113;9;11;3
895060;My House;Action, Indie;0 - 20,000;89;61;28;0;0;0
895080;Warrecs;Adventure, Casual, Indie, Racing, Simulation, Sports;0 - 20,000;14;19;-5;0;0;0
895080;Warrecs;Adventure, Indie, Strategy, Early Access;0 - 20,000;14;19;-5;0;0;0
895120;Dog Jam;Adventure, Casual, Indie;0 - 20,000;19;3;16;0;0;0
895140;JJBoom;Casual, Indie;0 - 20,000;178;16;162;0;0;0
895150;Endless Battle;Simulation;100,000 - 200,000;155;200;-45;0;0;0
895170;Drop Up;Casual, Free to Play, Simulation;0 - 20,000;10;1;9;0;0;0
895180;Majin Woman;Action, Adventure, Indie;0 - 20,000;3;2;1;0;0;0
895200;SWORDS of GARGANTUA;Action;20,000 - 50,000;189;131;58;0;0;1
895200;SWORDS of GARGANTUA;Adventure, Casual, Indie;20,000 - 50,000;189;131;58;0;0;1
895210;On Board Remastered;Action;20,000 - 50,000;1;3;-2;0;0;0
895220;Leaflet Love Story;Adventure, Casual, Indie;20,000 - 50,000;658;62;596;57;57;1
895330;Unblock: The Parking;Casual, Indie;100,000 - 200,000;11;7;4;0;0;0
895370;DollKart;Adventure, Casual, Indie;20,000 - 50,000;7;2;5;0;0;0
895400;Deadside;Action, Simulation;1,000,000 - 2,000,000;22637;6309;16328;1328;454;858
895430;From The Sky: New Horizon;Utilities;0 - 20,000;8;38;-30;0;0;0
895450;UglyDolls: An Imperfect Adventure;Action, Adventure;0 - 20,000;5;2;3;0;0;0
895470;EW/WE;Action, Casual, Indie;0 - 20,000;45;8;37;0;0;0
895480;Fates of Ort;Indie, Simulation;0 - 20,000;107;12;95;0;0;0
895480;Fates of Ort;Casual, Indie, Simulation;0 - 20,000;107;12;95;0;0;0
895510;Blow Up Pieces: Unleashed;Action, Indie, Early Access;0 - 20,000;2;0;2;0;0;0
895550;Total 15;Indie, RPG;0 - 20,000;3;11;-8;0;0;0
895570;Fairy Rescue;Adventure, Indie, RPG;100,000 - 200,000;4;3;1;0;0;0
895580;Yoga Lesson VR;Casual, Indie;20,000 - 50,000;3;6;-3;0;0;0
895600;Mojo;Adventure, Casual, Indie;0 - 20,000;82;13;69;0;0;0
895610;Where's Baby;Action, Indie;0 - 20,000;5;0;5;0;0;0
895620;Spellcaster University;Racing, Simulation, Sports;100,000 - 200,000;2646;540;2106;347;364;105
895650;Save The Cookie;Adventure, Casual, Indie;0 - 20,000;7;1;6;0;0;0
895670;Armajet;Adventure, Casual, Indie;100,000 - 200,000;554;90;464;0;0;12
895710;ELECTRONIC STOCK TRADING SYSTEM;Adventure, Casual, Indie, Early Access;0 - 20,000;2;2;0;0;0;0
895740;GunFu Heroes;Action, Adventure, Casual, Indie, RPG;0 - 20,000;2;1;1;0;0;0
895750;The Adventures of Mr. Fluffykins;Action, Adventure, Indie;0 - 20,000;9;8;1;0;0;0
895760;Ollie-Oop;Action, Adventure, Casual, Indie;0 - 20,000;9;0;9;0;0;0
895820;Kokorogawari;Education;0 - 20,000;9;3;6;0;0;0
895850;URO;Casual, Indie, Strategy;0 - 20,000;19;10;9;0;0;0
895860;WitchAction;Action, Adventure, Casual;0 - 20,000;15;3;12;0;0;1
895870;Project Wingman;Adventure, Casual;500,000 - 1,000,000;12009;717;11292;786;461;165
895890;GrabBag;Adventure, Casual;0 - 20,000;5;2;3;0;0;0
895900;The Chaotic Workshop;Action, Indie, Early Access;0 - 20,000;1;0;1;0;0;0
895930;Maze Quest 1: The Forest;Adventure, Casual;20,000 - 50,000;4;0;4;0;0;0
895940;Atlantic Edge;Adventure, Casual;0 - 20,000;1;2;-1;0;0;0
895960;Save Them;Indie, RPG, Simulation, Early Access;0 - 20,000;0;1;-1;0;0;0
895970;BlackShot: Revolution;Indie;0 - 20,000;0;0;0;0;0;27
895980;《古斯塔奥：帝國重生》Gustavo Kingdom Rebirth;Action, Adventure;0 - 20,000;13;7;6;0;0;0
895990;水时钟-Water_Clock;Action, Indie;0 - 20,000;81;22;59;0;0;0
896030;Fortissimo FA INTL Ver;Action, Indie;20,000 - 50,000;93;36;57;0;0;0
896040;The Impure;Adventure, Casual, Indie;0 - 20,000;54;6;48;0;0;0
896070;Second Hazardous Course;Action, Indie;0 - 20,000;15;2;13;0;0;0
896110;Crime Stories : Days of Vengeance;Indie;0 - 20,000;4;0;4;0;0;0
896160;Evil Bank Manager;Action, Adventure, Indie;50,000 - 100,000;1264;382;882;755;833;9
896170;My Fox Sister|我的妖狐妹妹;Casual, Indie;0 - 20,000;27;16;11;0;0;0
896180;Nazi 2;Adventure, Indie;0 - 20,000;28;14;14;0;0;0
896220;Dangerous Skies 80's edition;Adventure, Casual, Indie, Simulation, Early Access;0 - 20,000;2;5;-3;0;0;0
896240;The Grand Museum VR;Action, Adventure, Casual;0 - 20,000;1;2;-1;0;0;0
896340;To Leave;Strategy;0 - 20,000;43;10;33;0;0;1
896350;Symphonics: Make Music in VR;Action, Adventure, Casual, Indie, Early Access;0 - 20,000;1;0;1;0;0;0
896370;Navigator;Adventure;0 - 20,000;5;1;4;0;0;0
896380;Before Nightfall;Action, Adventure, Indie, Simulation;0 - 20,000;52;34;18;0;0;0
896400;Alien Attack: Pocket Edition;Action, Indie, Simulation;0 - 20,000;17;1;16;0;0;0
896420;Starless Night;Action, Indie, Racing, Simulation, Sports;0 - 20,000;1;1;0;0;0;0
896440;Eternal Edge +;Adventure, Indie;0 - 20,000;312;109;203;0;0;3
896460;Lucah: Born of a Dream;Adventure, Indie, RPG;20,000 - 50,000;370;18;352;136;136;0
896510;Norpon;Action, Adventure, Casual, Indie, RPG, Simulation;0 - 20,000;18;12;6;0;0;0
896520;Stay Out of the House;Action, Adventure, Casual, Indie, RPG;0 - 20,000;606;31;575;0;0;3
896550;The Sea Between;Action, Adventure, Casual, Indie, Simulation;0 - 20,000;15;1;14;0;0;0
896550;The Sea Between;RPG, Strategy;0 - 20,000;15;1;14;0;0;0
896570;PUZZLE: CATS & DOGS;Casual, Indie, Racing, Simulation, Sports, Early Access;0 - 20,000;24;5;19;0;0;0
896590;MilMo;Casual, Indie;200,000 - 500,000;452;117;335;0;0;8
896650;End War RTS;Design & Illustration, Utilities;0 - 20,000;7;5;2;0;0;0
896670;Ritual on the Eve 前夜祭;Casual, Indie, Strategy;20,000 - 50,000;54;9;45;0;0;0
896700;Extreme Drifters;Action, Adventure, Indie;0 - 20,000;14;15;-1;0;0;0
896730;Dare Course;Indie, RPG, Simulation;0 - 20,000;14;5;9;0;0;0
896750;Koral;Action, Adventure, Casual, Free to Play, Indie, Early Access;0 - 20,000;269;46;223;336;336;0
896850;Car Crash Online;Casual, Indie, RPG, Simulation;0 - 20,000;10;12;-2;0;0;0
896860;Trekking and Camping Sketch Edition;Action, Adventure, Casual, Indie;0 - 20,000;10;10;0;0;0;0
896880;Bouncing Over It with friends;Action, Casual, Free to Play, Indie;0 - 20,000;33;9;24;0;0;0
896890;VR Paradise - Steam Edition;Free to Play, Indie;20,000 - 50,000;138;50;88;49;31;6
896940;Switcher;Casual, Indie;0 - 20,000;1;1;0;0;0;0
896950;JUMANJI: The Video Game;Action, Adventure, Indie;20,000 - 50,000;32;34;-2;0;0;0
896960;DreamWorks Dragons: Dawn of New Riders;Adventure, Casual, Indie, RPG;20,000 - 50,000;106;20;86;0;0;2
896970;Haunted Halls: Revenge of Doctor Blackmore Collector's Edition;Casual, Indie;0 - 20,000;5;3;2;0;0;0
896980;Whispered Secrets: Golden Silence Collector's Edition;Indie, Strategy;0 - 20,000;3;1;2;0;0;0
896990;Dark Tales: Edgar Allan Poe's The Tell-Tale Heart Collector's Edition;Action, Massively Multiplayer, Early Access;0 - 20,000;4;5;-1;0;0;0
897000;Love Chronicles: A Winter's Spell Collector's Edition;Casual, Indie, Simulation, Strategy;0 - 20,000;3;0;3;0;0;0
897010;Surface: Return to Another World Collector's Edition;Action, Casual, Indie, Strategy;0 - 20,000;2;0;2;0;0;1
897020;Awakening: Moonfell Wood;Simulation;0 - 20,000;13;3;10;0;0;0
897030;Paratopic;Action, Adventure, Indie;50,000 - 100,000;1225;425;800;52;85;1
897040;Nazi Bunker;Action, Casual, Sports;0 - 20,000;134;46;88;0;0;0
897040;Nazi Bunker;Action;0 - 20,000;134;46;88;0;0;0
897100;Escape Black Orion VR;Casual;0 - 20,000;5;4;1;0;0;0
897120;Moko's Advice;Indie, RPG, Strategy;0 - 20,000;128;6;122;0;0;0
897210;Omicroid;Casual, Indie;0 - 20,000;1;0;1;0;0;0
897220;Summer Pockets;Action, Adventure, Indie;20,000 - 50,000;2087;23;2064;3441;3441;36
897270;无法传达的话语（Words cannot convey）;Action, Adventure, Indie;0 - 20,000;10;2;8;0;0;0
897300;Hacked: Hentai prison;Casual, Indie;0 - 20,000;50;29;21;0;0;0
897330;Coloring Pixels;Casual, Strategy;500,000 - 1,000,000;5591;207;5384;20058;28590;465
897360;Urban Explorer Golf;Adventure, Indie;0 - 20,000;3;0;3;0;0;0
897380;Reptiles: In Hunt;Indie, Simulation, Strategy;20,000 - 50,000;54;26;28;0;0;1
897390;Full Metal Renegade;Casual, Indie;0 - 20,000;4;10;-6;0;0;0
897400;Driftpunk Racer;Action, Casual, Indie;0 - 20,000;3;10;-7;0;0;0
897410;Esports Life Tycoon;Casual, Indie;50,000 - 100,000;310;178;132;363;529;3
897420;The Christmas Gifts;Casual, Indie;0 - 20,000;6;7;-1;0;0;0
897440;Leviathan ~A Survival RPG~;Adventure, Indie, RPG;20,000 - 50,000;155;56;99;21;21;3
897450;The Survivalists;Action, Adventure, Indie;200,000 - 500,000;4028;1255;2773;534;294;101
897530;Retroids;Simulation, Early Access;0 - 20,000;1;2;-1;0;0;0
897550;Study of Unusual: Forest of Secrets;Action, Adventure, Casual, Indie;0 - 20,000;20;16;4;0;0;0
897560;Waveform Wipeout;Indie, Strategy;0 - 20,000;2;0;2;0;0;0
897580;Avem888;Action, Adventure, Casual, Indie, Simulation, Early Access;0 - 20,000;1;0;1;0;0;0
897610;Scrapland Remastered;Adventure, Indie, RPG;0 - 20,000;59;7;52;0;0;0
897630;Death Fungeon;Adventure, Indie, RPG;0 - 20,000;85;22;63;0;0;0
897630;Death Fungeon;Action, Adventure, Indie, Simulation, Early Access;0 - 20,000;85;22;63;0;0;0
897640;Gun Crazy;Adventure, Casual, Indie, Simulation, Strategy, Early Access;0 - 20,000;71;27;44;0;0;0
897640;Gun Crazy;Casual;0 - 20,000;71;27;44;0;0;0
897690;Ding Dong VR;Action, Casual, Massively Multiplayer, Strategy, Early Access;0 - 20,000;73;5;68;0;0;0
897700;Bladequest;Adventure, Casual, Simulation;0 - 20,000;16;6;10;0;0;0
897730;Among Trees;Adventure, Casual, Simulation;50,000 - 100,000;1193;517;676;542;549;17
897740;SPAGHET 2: Al Dente Chapter;Adventure, Indie, RPG, Strategy;0 - 20,000;6;1;5;0;0;0
897760;PUT ANNA;Indie, Racing;0 - 20,000;58;7;51;0;0;0
897770;Solar Fighters;Action, Adventure, Indie;0 - 20,000;2;1;1;0;0;0
897800;Arcane Golf;Utilities;0 - 20,000;42;1;41;0;0;0
897820;Reigns: Game of Thrones;Action, Adventure, Indie, Racing, Sports;50,000 - 100,000;719;203;516;54;67;3
897830;The Queen of Blackwood High;Casual, Indie;0 - 20,000;16;6;10;0;0;0
897880;The Occluder;Casual, Indie;0 - 20,000;1;3;-2;0;0;0
897890;Blade of Arena - 劍鬥界域;Casual, Indie;0 - 20,000;8;2;6;0;0;0
897900;Typing of the Undead;Adventure;0 - 20,000;12;0;12;0;0;0
897910;Sandhill Architectures;Casual, Indie, Strategy;0 - 20,000;1;2;-1;0;0;0
897930;Demonheart: Hunters;Casual;0 - 20,000;192;36;156;0;0;1
897940;High Cats;Casual;0 - 20,000;11;5;6;0;0;0
897950;King of the Dead;Casual;0 - 20,000;1;4;-3;0;0;0
897970;Viper Attack;Casual;0 - 20,000;0;1;-1;0;0;0
898000;Uventa;Casual, Simulation;20,000 - 50,000;82;81;1;0;0;0
898010;Ratten Reich - Dance of Kings;Casual;50,000 - 100,000;31;16;15;0;0;0
898040;Whirlygig;Action, Indie, Early Access;0 - 20,000;2;1;1;0;0;0
898080;everybody's sad;Casual, Indie;0 - 20,000;110;17;93;0;0;0
898080;everybody's sad;Action, Indie;0 - 20,000;110;17;93;0;0;0
898090;立方杀阵（Cubic Kill Array）;Casual, Simulation, Early Access;0 - 20,000;18;5;13;0;0;0
898120;Temple of the Lost;Action, Adventure, Casual, Indie, RPG;0 - 20,000;2;2;0;0;0;0
898160;Hotel Remorse;Adventure, Casual, Indie;20,000 - 50,000;199;54;145;0;0;0
898160;Hotel Remorse;Action, Casual, Indie, Simulation, Strategy;20,000 - 50,000;199;54;145;0;0;0
898170;Grid Gunner;Casual, Indie, Simulation;0 - 20,000;1;1;0;0;0;0
898240;Kinkshamed;Casual, Indie, Simulation, Strategy;0 - 20,000;11;2;9;0;0;0
898250;PackageRun;Adventure, Casual, Indie, Simulation;0 - 20,000;1;1;0;0;0;0
898260;Juliantli;Casual, Indie, Simulation, Strategy;0 - 20,000;21;2;19;0;0;0
898290;V.O.I.D.;Action, Casual, Indie;0 - 20,000;5;2;3;0;0;0
898310;Happy Empire - A Bouquet for the Princess: Enhanced Edition;Free to Play, Indie, Simulation, Early Access;0 - 20,000;7;3;4;0;0;0
898320;Synth Ninja;Adventure, Indie, Strategy, Early Access;0 - 20,000;2;12;-10;0;0;0
898340;Puzzles and Board Games Mega Collection;Animation & Modeling, Utilities, Video Production;0 - 20,000;8;9;-1;0;0;0
898380;Color Party;Casual, Indie, Early Access;0 - 20,000;12;27;-15;0;0;0
898390;Megalith;Action, Adventure, Indie, Simulation;0 - 20,000;43;21;22;0;0;0
898430;Cube Creator X;Casual;0 - 20,000;5;2;3;0;0;0
898440;Turing Tumble VR;Casual, Indie;0 - 20,000;3;1;2;0;0;0
898450;UBERMOSH:SANTICIDE;Action, RPG, Strategy, Early Access;20,000 - 50,000;179;10;169;0;0;1
898460;Outback Survival;Casual, Indie;0 - 20,000;36;21;15;0;0;0
898490;Dorian Morris Adventure;Casual, Indie, Simulation, Strategy;0 - 20,000;15;7;8;0;0;0
898500;Hentai City;Action, Indie;0 - 20,000;0;0;0;0;0;0
898520;SceneThere;Action, Casual, Indie;0 - 20,000;6;3;3;0;0;0
898590;Margonem;Casual, Indie;20,000 - 50,000;132;106;26;0;0;1
898650;The Shapeshifting Detective;Indie, Simulation, Early Access;50,000 - 100,000;1046;296;750;133;156;7
898680;JUMP AND RUN - DON'T FALL;Action, Adventure, Casual, Indie, RPG;0 - 20,000;6;2;4;0;0;0
898690;Zombie;Indie, Strategy, Early Access;0 - 20,000;4;9;-5;0;0;0
898720;Kubifaktorium;Adventure, Indie;50,000 - 100,000;521;121;400;403;417;18
898750;Super Robot Wars 30;Adventure, Indie, Simulation;200,000 - 500,000;4257;538;3719;5692;6647;390
898760;Clone Adventures;Action, Casual, Indie;0 - 20,000;9;16;-7;0;0;0
898780;Escape Game;Action, RPG;0 - 20,000;118;22;96;0;0;2
898790;Locomotion;Indie;0 - 20,000;28;1;27;0;0;0
898800;Constructor Plus;Indie, RPG, Strategy, Early Access;20,000 - 50,000;302;40;262;0;0;12
898810;Merv Liberation;Casual, Indie, Strategy, Early Access;0 - 20,000;0;0;0;0;0;0
898830;In Your Realm;Adventure;0 - 20,000;6;0;6;0;0;0
898890;Endling - Extinction is Forever;Indie;20,000 - 50,000;702;25;677;20;20;11
898910;DASH: Danger Action Speed Heroes;;0 - 20,000;15;0;15;0;0;0
898920;Axis & Allies 1942 Online;Casual;100,000 - 200,000;2841;818;2023;946;1380;694
898930;Pingball Ultra;Indie;0 - 20,000;3;4;-1;0;0;0
898940;VirtuaCreature (Legacy Version);Action, Casual, Sports, Strategy;0 - 20,000;6;3;3;0;0;0
898950;ulxrd;Adventure, Casual, Indie, RPG, Strategy;0 - 20,000;0;1;-1;0;0;0
898980;The Mine;Free to Play, Indie, Massively Multiplayer, RPG, Strategy, Early Access;20,000 - 50,000;94;33;61;0;0;0
899000;Warlords.io;Casual, Indie;0 - 20,000;3;0;3;0;0;0
899020;Chiptune DJ;Casual, Indie;0 - 20,000;3;1;2;0;0;0
899090;Ricecakers;RPG;0 - 20,000;3;1;2;0;0;0
899100;SUM;Casual, Indie, Simulation, Strategy;0 - 20,000;19;5;14;0;0;0
899150;Audio Editor;Action, Adventure, Casual, Indie, Simulation;0 - 20,000;4;10;-6;0;0;0
899160;小林正雪復仇之密室重制版 Cheney Wood The Ultimate Revenge;Action, Indie, Sports;20,000 - 50,000;268;29;239;364;364;0
899180;Voronium - Locust Sols;Indie, Simulation, Sports, Early Access;0 - 20,000;41;7;34;0;0;0
899190;A Piece of Wish upon the Stars;Action, Free to Play, Early Access;0 - 20,000;158;8;150;0;0;0
899200;Windstorm: An Unexpected Arrival;Action, Casual, Indie, Massively Multiplayer, Simulation;0 - 20,000;43;24;19;0;0;0
899220;Fly of butterfly;Action, Casual, Free to Play, Indie, Strategy, Early Access;0 - 20,000;11;5;6;0;0;0
899220;Fly of butterfly;Casual;0 - 20,000;11;5;6;0;0;0
899240;Tale of Palmi;Adventure, Indie;0 - 20,000;1;2;-1;0;0;0
899270;BlamBox;Adventure, Casual, Indie, RPG;0 - 20,000;34;0;34;0;0;0
899290;The night of fire stealing/盗火之夜;Action, Adventure, Indie;20,000 - 50,000;106;9;97;0;0;2
899310;Iron Danger;Adventure, Indie, RPG;50,000 - 100,000;618;222;396;30;30;3
899340;Mendel;Action, Adventure, Indie, RPG, Simulation, Strategy;0 - 20,000;13;0;13;0;0;0
899390;Xenon Racer;Casual, Indie, Strategy, Early Access;0 - 20,000;393;202;191;181;190;3
899440;GOD EATER 3;Action, Adventure, Indie;500,000 - 1,000,000;6240;1467;4773;1268;744;112
899460;Shores Unknown;Casual, Indie;0 - 20,000;85;22;63;0;0;1
899460;Shores Unknown;Adventure, Free to Play, RPG, Strategy, Early Access;0 - 20,000;85;22;63;0;0;1
899470;Chook & Sosig: Walk the Plank;Adventure, Casual, Free to Play, Indie;0 - 20,000;84;15;69;0;0;0
899480;Girls Dance;Action, Free to Play, Indie;0 - 20,000;54;30;24;0;0;0
899530;Cosmi-Cave 64;Indie, Early Access;0 - 20,000;19;7;12;0;0;0
899540;PROTEST;Action, Indie;0 - 20,000;45;33;12;0;0;0
899570;My First Music Workshop;Casual, Indie;0 - 20,000;1;11;-10;0;0;0
899590;Heliophobia;Adventure, Casual, Indie;0 - 20,000;21;5;16;0;0;0
899760;Her 她;Adventure, Casual;0 - 20,000;67;7;60;0;0;0
899770;Last Epoch;Adventure, Indie, RPG;500,000 - 1,000,000;12336;2226;10110;3680;2554;925
899940;校园恋物语|Love in School;Adventure, Casual, Indie;0 - 20,000;46;21;25;0;0;0
899960;The Greater Good;Action, Indie;0 - 20,000;91;8;83;0;0;1
899970;NEKOPARA Extra;Adventure, Casual, Indie;200,000 - 500,000;3295;77;3218;3742;116;15
899990;LVN Fake News;Casual, Indie, Simulation;0 - 20,000;4;15;-11;0;0;0
900010;Meeple Station;Adventure, Free to Play, Indie;50,000 - 100,000;485;292;193;7;7;5
900040;ELEX II;Casual, Indie;200,000 - 500,000;3509;1136;2373;495;965;347
900050;Amber's Airline - High Hopes;Indie;0 - 20,000;100;15;85;0;0;0
900060;Free Throw;Indie;0 - 20,000;1;0;1;0;0;0
900270;Reventure;Action, Casual, Indie;200,000 - 500,000;7410;404;7006;158;158;32
900290;Veritas;Casual, Indie;20,000 - 50,000;36;12;24;0;0;0
900330;King-Dom;Indie;0 - 20,000;0;0;0;0;0;0
900340;Terror;Casual, Indie;0 - 20,000;6;8;-2;0;0;0
900370;Stockpile;Adventure, Casual, Indie, RPG, Simulation, Strategy;0 - 20,000;21;7;14;0;0;1
900370;Stockpile;RPG;0 - 20,000;21;7;14;0;0;1
900380;Indian Summer;Casual, Indie, Simulation, Audio Production;0 - 20,000;11;1;10;0;0;0
900390;Algae;Adventure, Indie, RPG;0 - 20,000;2;0;2;0;0;0
900400;Sacred Fire: A Role Playing Game;Action, Casual, Indie;50,000 - 100,000;326;15;311;0;0;2
900490;Power Gunner;Adventure, Indie, RPG;0 - 20,000;32;0;32;0;0;0
900490;Power Gunner;Casual;0 - 20,000;32;0;32;0;0;0
900790;Bunny Minesweeper;Racing;0 - 20,000;59;9;50;0;0;0
900870;Super Dig Man Deluxe;Action, Adventure, Indie;0 - 20,000;1;1;0;0;0;0
900883;The Elder Scrolls IV: Oblivion Game of the Year Edition Deluxe;Adventure, Indie;1,000,000 - 2,000,000;38018;1750;36268;0;0;0
901000;Serenade of the Sirens;Action, Adventure, Casual, Free to Play, Indie, Massively Multiplayer, Simulation, Strategy;0 - 20,000;3;1;2;0;0;0
901020;Adventure Portal;Adventure, Casual, Indie;0 - 20,000;2;0;2;0;0;0
901147;Earthworm Jim;Indie, Simulation;50,000 - 100,000;62;69;-7;0;0;0
901242;Mass Effect 2 Digital Deluxe Edition;Action, Adventure, Free to Play, Indie;1,000,000 - 2,000,000;14525;905;13620;0;0;0
901399;Sam & Max: The Devil’s Playhouse ;RPG, Simulation;200,000 - 500,000;436;47;389;0;0;0
901583;Grand Theft Auto IV: Complete Edition;Casual, Indie, Simulation;20,000,000 - 50,000,000;94891;25433;69458;0;0;0
901663;Sam & Max: Season Two;Casual;20,000 - 50,000;160;20;140;0;0;0
901735;The Stronghold Collection;Simulation, Sports;100,000 - 200,000;3540;488;3052;0;0;0
901776;Fate of the World: Tipping Point;Action, Indie;100,000 - 200,000;326;88;238;0;0;0
903150;FALL 坠落之后;Adventure, Casual, Indie;0 - 20,000;27;3;24;0;0;0
903160;Wunderwaffe;Adventure, Indie;0 - 20,000;22;18;4;0;0;0
903180;Privateers;Casual, Indie;0 - 20,000;12;1;11;0;0;0
903280;Dead Man's Fault;Action, Adventure, Casual, Indie;0 - 20,000;23;0;23;0;0;0
903310;Soter;Casual, Indie, Simulation;0 - 20,000;1;5;-4;0;0;0
903450;Turbo Cat Fight;Action, Free to Play, Indie, RPG;0 - 20,000;1;0;1;0;0;0
903560;Pixel Fishies;Indie;0 - 20,000;0;0;0;0;0;0
903570;Displacement Arcade Game Box;Action, Adventure, Indie;0 - 20,000;0;1;-1;0;0;0
903580;AstroViking;Adventure, Indie, RPG;0 - 20,000;15;1;14;0;0;0
903620;Everyday Baseball VR;Action, Adventure, Casual, Free to Play, RPG, Strategy;0 - 20,000;7;6;1;0;0;0
903630;The Last Cube;RPG;0 - 20,000;106;3;103;0;0;1
903640;Super Zombie Arcade;Adventure, Free to Play, Sports;0 - 20,000;5;1;4;0;0;0
903680;conNEcT01;Free to Play;0 - 20,000;1;1;0;0;0;0
903700;The Misadventures of Denniz & Diana;Indie;0 - 20,000;1;0;1;0;0;0
903710;Headshot VR;Casual, Free to Play, Strategy;0 - 20,000;59;24;35;0;0;0
903730;AXIOM SOCCER;Adventure, Indie, Early Access;100,000 - 200,000;261;132;129;0;0;0
903760;BinaryBotsVR;Indie, Strategy;0 - 20,000;6;4;2;0;0;0
903780;Beast Agenda 2030;Indie;0 - 20,000;14;1;13;0;0;0
903790;Card Battle Spirit Link;Indie, Strategy;0 - 20,000;3;0;3;0;0;0
903830;Cash Rush;Indie, Strategy, Early Access;0 - 20,000;26;10;16;0;0;0
903850;Fairy Knights;Indie;0 - 20,000;31;4;27;0;0;0
903880;Drying Paint Simulator VR;Adventure, Casual, Indie, Simulation;0 - 20,000;5;10;-5;0;0;0
903910;Tranzient;Indie, Racing, Simulation, Sports;0 - 20,000;15;1;14;0;0;0
903950;Last Oasis;Action, Adventure, Casual, Indie;500,000 - 1,000,000;14783;8524;6259;10051;1672;203
904050;American University Life ~Welcome Week!~;Adventure, Indie;0 - 20,000;10;4;6;0;0;0
904130;Defense: Abominations;Action, Adventure, Casual, Free to Play, Indie, Massively Multiplayer, Racing, RPG, Simulation, Sports, Strategy;0 - 20,000;37;12;25;0;0;0
904160;Ashes;Adventure, Casual, Free to Play, Indie;0 - 20,000;16;4;12;0;0;0
904300;KOPICS;Indie;0 - 20,000;20;13;7;0;0;0
904310;Initial 2 : New Stage;Casual, Indie, Simulation, Strategy;20,000 - 50,000;288;132;156;0;0;0
904320;My Holiday;Adventure, Casual, Indie;0 - 20,000;177;7;170;0;0;0
904340;Marbledrome: Crazy Stunt Balls;Adventure, Casual, Free to Play, Indie, RPG, Simulation, Strategy;0 - 20,000;2;1;1;0;0;0
904360;Family Man;Casual, Indie;50,000 - 100,000;361;141;220;93;99;3
904380;Vambrace: Cold Soul;Adventure, Casual, Indie, RPG;50,000 - 100,000;481;248;233;0;0;6
904400;Cardpocalypse;Action, Adventure, Early Access;0 - 20,000;159;19;140;0;0;1
904430;Swing the cat;Indie, Simulation, Strategy;0 - 20,000;4;0;4;0;0;0
904440;Type Defense;Casual, Indie, RPG, Strategy, Early Access;20,000 - 50,000;53;30;23;0;0;0
904500;Grompula;Action, Casual, Indie;20,000 - 50,000;27;3;24;0;0;0
904530;Erotic Jigsaw Challenge Vol 2;Action, Indie;0 - 20,000;6;0;6;0;0;0
904540;Indiana Jones and the Infernal Machine;Action, Casual, Indie;0 - 20,000;262;46;216;533;533;16
904550;Robot Chase;Indie, Strategy;0 - 20,000;14;36;-22;0;0;0
904550;Robot Chase;Adventure, Casual, Indie, Early Access;0 - 20,000;14;36;-22;0;0;0
904570;TOK;Casual, Indie;0 - 20,000;215;18;197;0;0;1
904600;Small Sister;Action, Casual, Simulation;20,000 - 50,000;40;59;-19;0;0;0
904640;Dairy Farm Simulator;Indie, Early Access;0 - 20,000;0;1;-1;0;0;0
904680;HotHead;Action, Casual, Indie;0 - 20,000;1;1;0;0;0;0
904700;Down Ward;Action, Indie;0 - 20,000;53;5;48;0;0;0
904740;东方试闻广纪 ~ Perfect Memento of Touhou Question;Casual, Free to Play, Indie, RPG, Strategy, Accounting, Animation & Modeling, Audio Production, Design & Illustration, Education, Photo Editing, Software Training, Utilities, Video Production, Web Publishing, Game Development;50,000 - 100,000;802;33;769;0;0;0
904750;Zniw Adventure;Action, Adventure, Indie;0 - 20,000;211;1;210;0;0;1
904770;Divine Miracle Defense;Action, Casual, Indie, Massively Multiplayer;20,000 - 50,000;2;0;2;0;0;0
904780;DeepWeb;Adventure, Indie, RPG;0 - 20,000;14;7;7;0;0;0
904800;Ambition;Action, Free to Play, Indie;0 - 20,000;10;15;-5;0;0;0
904810;Ectolibrium;Action, Free to Play, Indie;0 - 20,000;9;1;8;0;0;0
904820;VR Jogger;Action, Adventure, Free to Play, Indie;0 - 20,000;13;14;-1;0;0;0
904860;25 Cadre of Death;Adventure, Casual, Free to Play, Indie;20,000 - 50,000;24;33;-9;0;0;0
904890;Neverliria;Indie, RPG, Simulation, Strategy;0 - 20,000;25;10;15;0;0;0
904930;YOU - The Untold Stories;Casual, Indie, Simulation, Strategy;0 - 20,000;4;5;-1;0;0;0
904940;Les 4 Alice: Lorange Journey;Action, Adventure, Casual, Free to Play, Indie, Massively Multiplayer, Racing, RPG, Simulation, Sports, Strategy;0 - 20,000;8;0;8;0;0;0
904950;Exodus;Indie, Simulation, Strategy;0 - 20,000;1;5;-4;0;0;0
904960;Cine Tracer;Simulation;0 - 20,000;289;122;167;0;0;11
904990;21+;Action, Adventure, Indie, Simulation, Early Access;20,000 - 50,000;142;158;-16;0;0;1
905010;Draw Light;Free to Play, Indie, Early Access;0 - 20,000;2;0;2;0;0;0
905020;Fort;Casual;0 - 20,000;2;7;-5;0;0;0
905060;Turret Tech;Casual;0 - 20,000;25;13;12;0;0;1
905070;CONTINGENCY;Adventure, Free to Play, Indie, Strategy, Early Access;0 - 20,000;8;1;7;0;0;0
905090;Pineview Drive - Homeless;Adventure, Casual, Indie, RPG;20,000 - 50,000;66;33;33;0;0;0
905120;Son.Light.Sleepwalker;Casual, Indie;0 - 20,000;1;0;1;0;0;0
905130;Doggo Dig Down;Casual, Indie;0 - 20,000;10;4;6;0;0;0
905150;Trivia Quiz: All about everything!;Action, Simulation;0 - 20,000;38;18;20;0;0;0
905220;Grim Earth;Simulation, Sports;0 - 20,000;23;1;22;0;0;0
905270;Merlin Soccer;Casual, Indie;200,000 - 500,000;0;1;-1;0;0;0
905300;Daytona Racing;Indie;100,000 - 200,000;4;11;-7;0;0;0
905330;oOo: Ascension;Casual, Indie, Strategy;0 - 20,000;17;2;15;0;0;0
905340;Heave Ho;Adventure, Casual;100,000 - 200,000;1844;169;1675;248;245;51
905350;Bang Bang Fruit 3;Action, Adventure, Casual, Indie;0 - 20,000;25;6;19;0;0;0
905370;Conqueror's Blade;Casual, Indie, Racing, Simulation;2,000,000 - 5,000,000;20217;6522;13695;1560;198;2304
905380;RPG纪元;Casual, Indie;0 - 20,000;13;2;11;0;0;0
905380;RPG纪元;Casual, Indie, Simulation;0 - 20,000;13;2;11;0;0;0
905390;Drone Spektra;Action, Adventure, Indie;0 - 20,000;3;1;2;0;0;0
905450;NASCAR Heat 3;Simulation, Strategy;20,000 - 50,000;346;121;225;21;21;3
905460;Nutrients for Life;Indie, Simulation;0 - 20,000;6;1;5;0;0;0
905490;Deck Hunter;Free to Play, Indie, Simulation, Strategy;0 - 20,000;223;79;144;158;158;1
905510;Rugosi;Casual, Indie;0 - 20,000;6;3;3;0;0;0
905530;Anew: The Distant Light;Casual, Indie;0 - 20,000;9;8;1;0;0;0
905590;The Asteroid Belt's Trial;Action, Adventure, Indie, Strategy;0 - 20,000;0;1;-1;0;0;0
905630;GALAXY TOP WING;Adventure, Casual, Free to Play, Indie;0 - 20,000;0;1;-1;0;0;0
905640;Combat Arms: Reloaded;Action, Indie, Strategy;500,000 - 1,000,000;1486;1181;305;177;31;77
905650;Dominus 2;Indie, Sports;20,000 - 50,000;31;15;16;0;0;0
905660;纸境英雄 Papercraft;Adventure, Casual, Indie, Racing, Strategy;0 - 20,000;258;42;216;0;0;1
905670;巭孬嫑毖;Adventure, Simulation;0 - 20,000;12;7;5;0;0;0
905690;魔物讨伐团;Casual, Indie;20,000 - 50,000;241;136;105;0;0;0
905790;Hungry Shadows;Casual, Indie;0 - 20,000;9;18;-9;0;0;0
905800;SpaceExile;Utilities;0 - 20,000;20;4;16;0;0;0
905860;DrillMania;Strategy;0 - 20,000;1;2;-1;0;0;0
905870;Inn: the Countryside;Action, Adventure, Indie;0 - 20,000;7;2;5;0;0;0
905880;Caves of Plague;Education, Utilities;0 - 20,000;6;1;5;0;0;0
905890;MONOWARS: Red Zone;Utilities;0 - 20,000;1;0;1;0;0;0
905960;Skyland Defense;Education, Utilities;0 - 20,000;1;2;-1;0;0;0
905970;Steel Crew;RPG;0 - 20,000;340;49;291;0;0;4
906010;TAL: Arctic 2;Casual, Indie, Strategy;0 - 20,000;23;15;8;0;0;0
906020;Strike Cars;RPG;0 - 20,000;4;8;-4;0;0;0
906030;NOCE;RPG;0 - 20,000;9;4;5;0;0;0
906050;Hentai Case Opening;Indie;0 - 20,000;54;29;25;0;0;0
906100;Observation;Action, Adventure, Indie, RPG;200,000 - 500,000;3096;794;2302;327;350;9
906110;Minotaur Arcade Volume 1;Simulation, Strategy;0 - 20,000;49;0;49;0;0;1
906120;POLYBIUS;Action, Indie;0 - 20,000;200;14;186;3;3;1
906160;Repeat the image: Animals;Indie, RPG, Strategy;0 - 20,000;6;2;4;0;0;0
906170;Metal Brigade Tactics;Action, Adventure, Indie, Racing, RPG, Simulation, Early Access;50,000 - 100,000;2;1;1;0;0;0
906190;Kamikaze Cube 2;Adventure, Indie;0 - 20,000;12;32;-20;0;0;0
906190;Kamikaze Cube 2;Adventure, Indie;0 - 20,000;12;32;-20;0;0;0
906200;Tunche: Arena;Casual, Indie;50,000 - 100,000;293;42;251;36;36;0
906240;Encore Card Games Collection;Racing, Simulation, Early Access;0 - 20,000;4;6;-2;0;0;0
906250;Encore Casino Games Collection;Adventure, Indie, RPG;0 - 20,000;0;4;-4;0;0;1
906280;Combat Rush;Action, Free to Play, Indie;0 - 20,000;22;0;22;0;0;0
906300;Under One Wing;Casual, Indie, Strategy;0 - 20,000;103;7;96;0;0;0
906310;Rapid Racing;Casual;0 - 20,000;6;0;6;0;0;0
906360;LUXO Buddies;Action, Indie;50,000 - 100,000;4;2;2;0;0;0
906370;Starkid's Obstacle Course;Casual, Indie, RPG, Early Access;0 - 20,000;6;0;6;0;0;0
906390;Return.;Indie, Simulation, Strategy;50,000 - 100,000;859;88;771;0;0;0
906450;Tenacious;Action, Casual, Indie, Strategy;0 - 20,000;1;1;0;0;0;0
906470;Gravia;Adventure, Indie, RPG, Simulation, Early Access;0 - 20,000;32;3;29;0;0;1
906480;Defenders of Ekron - Definitive Edition;Action, Adventure, Casual, Indie;0 - 20,000;2;2;0;0;0;0
906510;Conception PLUS: Maidens of the Twelve Stars;Adventure, Casual, Indie, RPG;0 - 20,000;95;32;63;0;0;28
906600;Gunkid 99;Action, Adventure, Indie;0 - 20,000;58;2;56;0;0;0
906650;Gumstein: The Awakening;Action, Adventure, Indie, RPG;0 - 20,000;4;3;1;0;0;0
906660;Seacurity Breach;Action, Indie;0 - 20,000;10;4;6;0;0;0
906730;Typical;Adventure, Casual, Indie, RPG;0 - 20,000;55;10;45;0;0;0
906730;Typical;Casual, Indie;0 - 20,000;55;10;45;0;0;0
906740;Voidship: The Long Journey;Action, Casual, Free to Play, Indie, Early Access;0 - 20,000;105;32;73;0;0;1
906740;Voidship: The Long Journey;RPG;0 - 20,000;105;32;73;0;0;1
906750;Weaverse;Casual, Indie;0 - 20,000;4;3;1;0;0;0
906770;TITAN SLAYER Ⅱ;Adventure, Casual;0 - 20,000;27;11;16;0;0;0
906790;Gaia;Action, Indie, RPG, Early Access;50,000 - 100,000;55;35;20;0;0;0
906810;Music Maker Steam Edition;Action, Casual, Indie;100,000 - 200,000;317;319;-2;9;11;11
906850;Again?;Action, Indie;0 - 20,000;21;33;-12;0;0;0
906870;FurryFury: Smash & Roll;Action, Indie;50,000 - 100,000;1044;228;816;0;0;26
906880;goto;Action, Casual, Indie;0 - 20,000;11;4;7;0;0;0
906920;Political Puzzle;Action, Casual, Indie;20,000 - 50,000;35;45;-10;0;0;0
906930;LEAP;Action, Adventure, Casual, Indie;50,000 - 100,000;127;118;9;0;0;2
906950;Bomb Riders;Casual, Indie, Strategy;0 - 20,000;5;2;3;0;0;0
907000;The Navigator;Indie, Simulation, Strategy, Early Access;50,000 - 100,000;210;7;203;0;0;0
907020;Bomber 95;Adventure, Casual, Indie, RPG, Simulation, Strategy;0 - 20,000;23;12;11;0;0;0
907030;Globat Pixels;Casual, Indie;0 - 20,000;3;1;2;0;0;0
907040;Simple Racing;Action, Indie, Strategy, Early Access;0 - 20,000;7;6;1;0;0;0
907050;Deep Space Classic;Casual, Indie;50,000 - 100,000;59;39;20;0;0;0
907160;Project Skylab;Casual, Indie;20,000 - 50,000;12;37;-25;0;0;0
907180;InductVR (beta);Action, Indie;0 - 20,000;14;2;12;0;0;0
907190;GRITS Racing;Action, Adventure, Casual, Indie, Simulation, Strategy;0 - 20,000;4;0;4;0;0;0
907210;Phantom Thief Celianna;Action, RPG;20,000 - 50,000;175;96;79;35;35;1
907220;One Piu Day;Action, Adventure, Casual, Indie, Simulation;0 - 20,000;2;3;-1;0;0;0
907240;像素修真 - Pixel Xiuzhen;Action, Indie;0 - 20,000;18;9;9;0;0;0
907250;GUNGRAVE VR U.N;Casual, Free to Play, Indie;0 - 20,000;4;6;-2;0;0;0
907270;eSports Legend;Casual;200,000 - 500,000;723;431;292;1332;1867;6
907310;World of Myths;Simulation;50,000 - 100,000;251;46;205;0;0;0
907330;Amulet Zero 零物语 - Optimize;Casual, Indie, Strategy;20,000 - 50,000;43;6;37;0;0;0
907350;Welcome To... Chichester 2 - Part I : The Spy Of Chichester And The Eager Tourist Guide HD Edition;RPG;0 - 20,000;29;8;21;0;0;0
907380;The Ballad Singer;Indie;0 - 20,000;65;18;47;246;246;0
907390;Numberline 3;Casual;0 - 20,000;7;0;7;0;0;0
907390;Numberline 3;Action, Casual, Racing;0 - 20,000;7;0;7;0;0;0
907410;Hard Times;Indie, RPG;0 - 20,000;64;7;57;0;0;0
907460;Girlfriend Cards;Casual, Indie, RPG, Simulation;0 - 20,000;11;18;-7;0;0;0
907470;Iris.Fall;Adventure;50,000 - 100,000;2357;301;2056;146;173;3
907520;ABC Paint;Adventure, Casual, Simulation;0 - 20,000;0;1;-1;0;0;0
907560;Terrawurm;Action, Adventure, Casual, Indie, Racing, Simulation;0 - 20,000;6;1;5;0;0;0
907590;Data mining;Adventure, Casual, Indie;0 - 20,000;19;17;2;0;0;0
907600;Towaga: Among Shadows;Adventure, Strategy;0 - 20,000;64;6;58;0;0;1
907600;Towaga: Among Shadows;Action, Adventure, Strategy;0 - 20,000;64;6;58;0;0;1
907620;Lawnmower Game 3: Horror;Indie, RPG, Simulation, Early Access;0 - 20,000;21;19;2;0;0;0
907650;Stronghold: Warlords;Action, Casual, Indie;100,000 - 200,000;2481;1364;1117;598;892;185
907670;Super Crush KO;Casual, Simulation, Strategy;20,000 - 50,000;171;7;164;0;0;0
907680;Wwbit;Casual, Simulation;100,000 - 200,000;710;566;144;8;9;0
907710;This is the Zodiac Speaking;Adventure, Casual, Indie, Simulation, Strategy;20,000 - 50,000;36;26;10;0;0;0
907720;Do or Die;Indie, Simulation, Early Access;0 - 20,000;3;12;-9;0;0;0
907760;ARIDA: Backland's Awakening;Casual, Indie;0 - 20,000;476;66;410;0;0;9
907770;STONE;Adventure, Casual, Indie, Strategy;0 - 20,000;59;21;38;0;0;0
907780;Puzzle Noid;Indie, Racing, Simulation, Sports;0 - 20,000;1;0;1;0;0;0
907820;Aeon of Sands - The Trail;Casual, Indie;0 - 20,000;86;12;74;0;0;0
907870;Wandering Star;Adventure, Indie, RPG, Simulation;0 - 20,000;2;1;1;0;0;0
907890;The Cat and the Coup (4K Remaster);Action, Casual, Indie;0 - 20,000;19;1;18;0;0;0
907900;Mystic Ruins;Adventure, Indie;0 - 20,000;6;1;5;0;0;0
907920;建筑大冒险 Architectural Adventure;;20,000 - 50,000;1;1;0;0;0;0
907950;Falldown 79: Bottle of truth;Indie, RPG;0 - 20,000;39;28;11;0;0;0
907970;Shennong: Taste of Illusion;Casual, Indie, Strategy;0 - 20,000;21;7;14;0;0;0
908000;Stories In Stone;Casual, Indie, Strategy;0 - 20,000;5;0;5;0;0;0
908010;Farjob;Casual, Indie;0 - 20,000;8;1;7;0;0;0
908020;Tactic Code - 战术代码;Adventure, Indie;0 - 20,000;14;2;12;0;0;0
908020;Tactic Code - 战术代码;Adventure, Casual, Indie, Simulation;0 - 20,000;14;2;12;0;0;0
908030;Breen Origins;Indie;0 - 20,000;1;1;0;0;0;0
908050;Summer Catchers;Adventure, Indie, RPG;0 - 20,000;170;35;135;0;0;2
908070;Mystic Vale;Action, Casual, Indie, Early Access;0 - 20,000;299;34;265;111;111;9
908090;Skateboarding pro;Indie;0 - 20,000;1;2;-1;0;0;0
908100;九州：商旅（Nine Provinces: Caravan）;Adventure, Indie, RPG;50,000 - 100,000;942;87;855;184;184;32
908120;W. T. B.;Action, Adventure, Casual, Indie, Simulation;0 - 20,000;10;4;6;0;0;0
908150;Dunderheads;Casual;0 - 20,000;7;0;7;0;0;0
908180;Space Maze;Racing;20,000 - 50,000;15;2;13;0;0;0
908230;Basketball Hoop;Action, Indie, Simulation, Sports, Early Access;0 - 20,000;23;14;9;0;0;0
908260;Velocity G;Action, Casual, Indie, Strategy;0 - 20,000;6;6;0;0;0;0
908270;Slime Dad;Adventure, Casual, Indie, RPG, Strategy, Early Access;0 - 20,000;0;0;0;0;0;0
908290;Server Composer;Action, Casual, Indie;0 - 20,000;1;1;0;0;0;0
908310;The Call;Action, Adventure, Indie;50,000 - 100,000;5;6;-1;0;0;0
908320;Captain:Training;Action, Adventure, Indie;0 - 20,000;4;0;4;0;0;0
908350;美少女麻将接龙;Casual, Free to Play, Simulation;0 - 20,000;27;13;14;0;0;0
908390;Infinitrap : Rehamstered;Animation & Modeling, Design & Illustration, Utilities, Game Development;0 - 20,000;17;0;17;0;0;0
908400;Age Of Forays;Casual;0 - 20,000;3;1;2;0;0;0
908420;We Happy Few - Soundtrack and Digital Goods Bundle;Adventure, Indie, RPG, Simulation, Early Access;0 - 20,000;4;2;2;1;1;0
908440;All For One;Adventure, Indie;0 - 20,000;2;3;-1;0;0;0
908450;Live3D - Comic & Animation & VTuber Maker - Virtual Production;Casual, Indie, Racing, Simulation, Early Access;100,000 - 200,000;47;86;-39;0;0;0
908480;Legends of Ethernal;Action, Casual, Indie, Strategy;0 - 20,000;21;2;19;0;0;0
908500;crazy maze ~疯狂迷宫 ~ 狂った迷路 ~ Laberinto loco ~ Labyrinthe fou ~ Verrücktes Labyrinth;Action, RPG;200,000 - 500,000;14;12;2;0;0;0
908520;fpsVR;Action, Casual, Indie;200,000 - 500,000;1665;40;1625;8206;6550;288
908560;Intrepid Izzy;Casual, Indie;0 - 20,000;30;1;29;0;0;0
908590;Combiner the Card Game;Casual, Indie;0 - 20,000;1;2;-1;0;0;0
908620;Manipulate: Sacrifice;Casual, RPG;50,000 - 100,000;3;5;-2;0;0;0
908660;Circle Brawl;Adventure, Indie, Racing, RPG, Simulation, Early Access;0 - 20,000;1;0;1;0;0;0
908690;BigBoy - Visual Novel;Animation & Modeling, Design & Illustration, Utilities, Video Production;0 - 20,000;4;0;4;0;0;0
908710;NightKnight;Casual, Indie;0 - 20,000;18;4;14;0;0;0
908750;Death Race VR;Action, Adventure;0 - 20,000;6;2;4;0;0;0
908790;Subdivision Infinity DX;Indie, Simulation, Strategy;0 - 20,000;76;21;55;0;0;0
908830;Shadow Fear Path to Insanity;Casual, Indie;0 - 20,000;2;1;1;0;0;0
908840;Suprapong;Action, Adventure, Indie;0 - 20,000;7;0;7;0;0;0
908920;Nightmare Simulator;Casual, Simulation;0 - 20,000;0;3;-3;0;0;0
908940;夢物語ORIGIN;Action, Indie;0 - 20,000;4;1;3;0;0;0
908950;Glow Chess;Action, Adventure, Indie;0 - 20,000;1;13;-12;0;0;0
908960;A Second Chance;Free to Play, Indie, RPG, Strategy;0 - 20,000;1;3;-2;0;0;0
908990;Steel Vampire;Adventure, Casual, Indie;0 - 20,000;64;5;59;0;0;2
909010;LoveBug;Action;0 - 20,000;6;1;5;0;0;0
909080;Cube Escape: Paradox;Casual, Indie;500,000 - 1,000,000;7383;195;7188;223;131;88
909100;Epic Fun;Simulation;20,000 - 50,000;50;25;25;0;0;1
909110;Acid Nimbus;Action, Indie, Strategy, Early Access;20,000 - 50,000;165;12;153;0;0;0
909170;A.D.M(Angels,Demons And Men);Action, Casual, Indie;0 - 20,000;3;7;-4;0;0;0
909190;Escape Lala - Retro Point and Click Adventure;Action, Indie;20,000 - 50,000;288;6;282;0;0;0
909200;Wandering Owl;Action, Adventure, Indie, Simulation, Sports;0 - 20,000;5;0;5;0;0;0
909220;Punch Pad Workout;Casual, Strategy;0 - 20,000;15;3;12;0;0;0
909270;Flying Soul;Casual, Strategy;0 - 20,000;5;6;-1;0;0;0
909320;Ruinarch;Casual, Strategy;50,000 - 100,000;787;201;586;420;420;45
909370;RoomESC- Secret of the Hidden Room: the Collaborator;Casual, Strategy;0 - 20,000;11;0;11;0;0;0
909380;Traditional Chinese Medicine Simulator;Action, Adventure, Indie;0 - 20,000;193;5;188;0;0;16
909430;Travel Riddles: Mahjong;Action, Indie, Early Access;0 - 20,000;16;16;0;0;0;5
909460;PhotoVidShow;Action, Adventure, Indie, RPG;0 - 20,000;6;1;5;0;0;0
909480;PUZZLE: LANDSCAPES;Animation & Modeling, Design & Illustration, Utilities, Game Development;0 - 20,000;26;5;21;0;0;0
909490;Hipster Attack;Adventure, Casual;20,000 - 50,000;4;0;4;0;0;0
909500;Hurricane chase(飓风追击);Adventure, Casual;0 - 20,000;3;3;0;0;0;0
909510;MISTOVER;Adventure, Casual;100,000 - 200,000;600;563;37;1858;1858;1
909570;Spuds Unearthed;Casual, Free to Play, Indie, Simulation;0 - 20,000;32;11;21;0;0;0
909580;Cortex;Action, Casual, Indie, Early Access;0 - 20,000;17;20;-3;0;0;0
909630;Desktop Dynasties: Pro Football;Action, Casual, Indie, Simulation;0 - 20,000;9;5;4;0;0;0
909660;Vagrus - The Riven Realms;Action, Adventure, Indie;100,000 - 200,000;745;132;613;613;613;42
909670;Skybolt Zack;Indie, RPG, Strategy, Early Access;0 - 20,000;90;6;84;0;0;0
909780;Scraper: First Strike;Action, Adventure, Casual, Indie, RPG;0 - 20,000;17;9;8;0;0;0
909820;Songbird Symphony;Adventure, Indie, RPG, Strategy;20,000 - 50,000;392;40;352;3318;3318;1
909830;Color by Number - Pixel Draw;Indie, Early Access;20,000 - 50,000;13;6;7;0;0;0
909900;悪梦er-mo;Action, Indie;0 - 20,000;5;9;-4;0;0;0
909970;Tech Corp.;Action, Adventure, Strategy;0 - 20,000;84;165;-81;0;0;1
910050;Coral Compass: Fighting Climate Change in Palau;Action, Casual, Indie;0 - 20,000;10;1;9;0;0;0
910150;Roving in the Dark;Action, Adventure, Indie;0 - 20,000;6;2;4;0;0;0
910190;Hive Slayer;Utilities;20,000 - 50,000;13;1;12;0;0;0
910200;Professor Watts Memory Match: Cute Animals;Action, Adventure, Indie, RPG;0 - 20,000;11;13;-2;0;0;0
910210;Coffee Trainer VR;Action, Indie, Strategy;0 - 20,000;6;5;1;0;0;0
910220;Professor Watts Memory Match: Yummy Cupcakes;Action, Adventure, Casual, Indie, Early Access;0 - 20,000;7;13;-6;0;0;0
910230;Fortified Swiss;Action, Indie;0 - 20,000;3;0;3;0;0;0
910250;Professor Watts Memory Match: Fresh Fruit;Casual, Indie;0 - 20,000;12;11;1;0;0;0
910260;Chicken VR;Adventure, Indie;0 - 20,000;2;2;0;0;0;0
910290;CRACKPOT DESPOT: TRUMP WARFARE;Action, Indie, Strategy;0 - 20,000;1;2;-1;0;0;0
910320;Three Kingdoms 2019 阿达三国志2019 横版;Casual, Indie;50,000 - 100,000;250;76;174;0;0;8
910370;CoreOptimizer;Simulation, Early Access;0 - 20,000;26;17;9;0;0;4
910380;Red and the Deadly Sins;Casual, Indie;0 - 20,000;10;2;8;0;0;0
910390;Stay or Leave / 留离;Adventure, Casual, Indie, Simulation;0 - 20,000;26;5;21;0;0;0
910400;Mio Garden;Action, Early Access;0 - 20,000;1;1;0;0;0;0
910420;Brick Breaker with Risa;Adventure, Casual, Indie;0 - 20,000;0;0;0;0;0;0
910430;The War of the Worlds: Andromeda;Action, Adventure, Indie;0 - 20,000;5;11;-6;0;0;0
910450;Warhammer Quest 2: The End Times;Casual, Indie, Simulation, Strategy;50,000 - 100,000;165;109;56;0;0;6
910460;Rocket of Whispers: Prologue;Adventure, Indie, RPG, Simulation, Early Access;50,000 - 100,000;164;48;116;16;16;0
910470;Backworlds;Animation & Modeling, Design & Illustration, Game Development;0 - 20,000;41;1;40;0;0;0
910490;Killsquad;Casual, Indie, Strategy;200,000 - 500,000;2428;957;1471;765;1021;6
910500;Goalkeeper Legend;Action, Indie;0 - 20,000;6;1;5;0;0;0
910530;The Eerie Inn VR;Casual, Free to Play, Indie;0 - 20,000;2;2;0;0;0;0
910540;Moon River;Action, Adventure, Indie, Racing, Early Access;0 - 20,000;10;7;3;0;0;0
910590;Supaplex SQUARES;Action, Adventure, Indie, Early Access;0 - 20,000;9;2;7;0;0;0
910630;Arcade Spirits;Action, Indie;20,000 - 50,000;431;10;421;672;1195;6
910660;Shudder;Action, Casual, Free to Play;0 - 20,000;9;2;7;0;0;0
910730;Solid Aether;Action, Indie, Early Access;0 - 20,000;34;0;34;0;0;0
910770;Slay The Dragon;Action, Adventure;0 - 20,000;1;0;1;0;0;0
910830;Rebel Galaxy Outlaw;Action;50,000 - 100,000;493;272;221;0;0;13
910850;Darken VR;Action;0 - 20,000;1;2;-1;0;0;0
910880;Mad Tower Tycoon;Adventure, Free to Play;20,000 - 50,000;307;83;224;480;480;9
910990;Urban Lockdown;Action, Indie;0 - 20,000;9;1;8;0;0;0
911010;Farplane Relic;Indie;0 - 20,000;20;6;14;0;0;0
911040;Bunny - The Horror Game;Indie, Racing, Simulation, Sports;0 - 20,000;13;22;-9;6;6;0
911050;Holiday Escape;Utilities;20,000 - 50,000;24;8;16;0;0;0
911100;Memetown USA;Indie, RPG, Simulation, Strategy;0 - 20,000;13;0;13;0;0;0
911120;Yumori Forest;Action, Adventure, Casual;0 - 20,000;24;1;23;0;0;0
911130;Puzzle Monarch: Vampires;Adventure, Casual, Indie;0 - 20,000;11;18;-7;0;0;0
911170;Veccol;Indie, RPG, Simulation;0 - 20,000;1;1;0;0;0;0
911180;Lost Letters (of Seraphina);Action;0 - 20,000;2;2;0;0;0;0
911200;Petoons Party;Action, Indie, RPG;0 - 20,000;8;7;1;0;0;0
911210;King of my Castle VR;Action, Indie, RPG;0 - 20,000;2;6;-4;0;0;0
911220;Dusk Diver 酉閃町;Casual, Indie, RPG;20,000 - 50,000;584;95;489;0;0;3
911240;Super Streaker Plus;Simulation;0 - 20,000;4;0;4;0;0;0
911250;The Bond;Action, Casual, Free to Play, Indie, Simulation;20,000 - 50,000;142;8;134;0;0;0
911260;Dawn of the Breakers;Indie, Simulation;20,000 - 50,000;42;54;-12;0;0;1
911270;Intelligence: Cats;Indie, Sports;0 - 20,000;3;2;1;0;0;0
911280;Dinosaur Hunter VR;Action, Adventure, Indie, Simulation;0 - 20,000;0;2;-2;0;0;0
911290;Prehistoria;Adventure, Casual, Indie, RPG, Simulation;0 - 20,000;4;0;4;0;0;0
911310;Kz NTools : Fix Your Network;Free to Play, Indie;0 - 20,000;22;6;16;0;0;0
911320;TimeOver;Action, Casual, Indie;0 - 20,000;0;0;0;0;0;0
911400;Assassin's Creed III Remastered;Action, Free to Play, Indie;1,000,000 - 2,000,000;4292;3303;989;304;146;152
911420;Terra Incognito - Antarctica 1911;Casual, Indie, Strategy;0 - 20,000;7;2;5;0;0;0
911430;Good Company;Action, Casual, Indie, RPG, Strategy, Early Access;200,000 - 500,000;1101;374;727;574;650;86
911440;Evemnesis;;0 - 20,000;1;1;0;0;0;0
911480;GoFetch;Action, Indie;0 - 20,000;3;6;-3;0;0;0
911500;Antox vs. Free Radicals;Action, Indie, RPG, Early Access;0 - 20,000;1;0;1;0;0;0
911510;Paws and Soul;Free to Play, Massively Multiplayer, RPG, Strategy;0 - 20,000;58;54;4;0;0;0
911520;One More Roll;Free to Play, Massively Multiplayer, RPG, Strategy;0 - 20,000;26;2;24;0;0;0
911550;Din's Legacy;Audio Production, Utilities, Video Production;20,000 - 50,000;129;36;93;0;0;4
911580;Audio Infection;Casual, Indie, Simulation;0 - 20,000;7;0;7;0;0;0
911640;ChromaSquares;Action, Adventure, Indie, RPG, Early Access;0 - 20,000;1;0;1;0;0;0
911660;Ducks and Gooobers;Indie, RPG, Simulation, Strategy;0 - 20,000;1;0;1;0;0;0
911680;REZ PLZ;Action, Adventure, Indie, RPG, Simulation;0 - 20,000;32;6;26;0;0;2
911690;The Orphaned Soul;RPG;0 - 20,000;5;3;2;0;0;0
911760;Fruit Tower Defense;Adventure, Indie;0 - 20,000;19;3;16;0;0;0
911840;Zenesthetic;Casual, Indie, Sports, Early Access;0 - 20,000;6;5;1;0;0;0
911880;Caramba!;Action, Casual, Indie, Racing;20,000 - 50,000;19;61;-42;0;0;0
911950;Origami Flight;Free to Play, Indie;0 - 20,000;11;0;11;0;0;0
912020;Deadly Curse;Action, Casual, Simulation;0 - 20,000;2;3;-1;0;0;0
912070;DESERT KILL;Indie, Strategy, Early Access;0 - 20,000;16;3;13;0;0;0
912110;Ashley Clark: The Secrets of the Ancient Temple;;0 - 20,000;38;21;17;0;0;0
912110;Ashley Clark: The Secrets of the Ancient Temple;Adventure, Casual, Indie;0 - 20,000;38;21;17;0;0;0
912120;Saturnine;Casual, Free to Play, Indie, Simulation;0 - 20,000;0;3;-3;0;0;0
912170;Groupy;Action, Adventure, Free to Play, Indie, RPG, Early Access;0 - 20,000;39;7;32;1;1;0
912190;Hentai IQ Puzzle;Action, Adventure, Casual, Indie, RPG, Simulation;0 - 20,000;27;1;26;0;0;0
912210;Achievement Collector: Cat;Adventure, Casual, Indie;0 - 20,000;18;37;-19;0;0;0
912250;Simplex Mundi;Adventure, Casual, Indie, RPG;0 - 20,000;18;4;14;0;0;0
912260;Gallery One;Casual;0 - 20,000;0;1;-1;0;0;0
912360;Garrison Gauntlet;RPG;0 - 20,000;1;4;-3;0;0;0
912370;Mahjong Club;Action, Casual;20,000 - 50,000;235;94;141;289;367;2
912390;Dismantle: Construct Carnage;Adventure, Casual, Free to Play, Indie;0 - 20,000;7;1;6;0;0;0
912420;It's a Trap;Action, Indie, Early Access;0 - 20,000;7;7;0;0;0;0
912450;YU-NO: A girl who chants love at the bound of this world;Casual, Indie;0 - 20,000;167;38;129;0;0;15
912500;Poltergeist Treasure;Action, Adventure, Indie;0 - 20,000;5;2;3;0;0;0
912550;Savage Vessels;Action, Adventure, Indie;0 - 20,000;27;8;19;80;80;0
912560;PROZE: Prologue;Action;20,000 - 50,000;80;17;63;0;0;0
912570;BEAUTIFUL DESOLATION;Adventure;50,000 - 100,000;424;111;313;772;772;3
912580;RAZ;Indie, Simulation, Strategy;0 - 20,000;6;0;6;0;0;0
912590;The path to domination;Strategy, Early Access;50,000 - 100,000;18;12;6;0;0;0
912600;Speedway Challenge Career;Adventure, Indie, RPG;0 - 20,000;23;3;20;0;0;0
912630;Dystopia;Adventure, Indie, Early Access;0 - 20,000;0;1;-1;0;0;0
912650;Time Carnage;Casual, Indie;0 - 20,000;11;5;6;0;0;0
912660;Welcome Above;Action, Adventure, Indie, RPG;0 - 20,000;11;4;7;0;0;0
912760;Volcanic Blocks;Audio Production, Design & Illustration, Utilities, Video Production, Web Publishing;100,000 - 200,000;4;1;3;0;0;0
912790;Meteor;Adventure, Casual, Simulation;0 - 20,000;2;3;-1;0;0;0
912810;Sargon's Lair;Indie, Strategy;0 - 20,000;31;14;17;0;0;0
912820;Survive in Angaria 2;Free to Play, Simulation;20,000 - 50,000;10;11;-1;0;0;0
912870;V-Aria;Adventure, Indie;0 - 20,000;10;0;10;0;0;0
912900;Bunker Defense;Action, Indie;0 - 20,000;28;5;23;0;0;4
912920;SMUSH.TV - Competitive VR x PC Action;Action, Casual, Indie;0 - 20,000;26;1;25;0;0;0
912930;Insurgence - Chains of Renegade;Action, Adventure, Indie;0 - 20,000;38;2;36;0;0;0
912990;PlatBall;Indie, Simulation, Strategy, Early Access;0 - 20,000;1;0;1;0;0;0
913000;Sheepageddon;Action, Adventure, Indie;0 - 20,000;2;1;1;0;0;0
913010;Your Dry Delight;Utilities, Early Access;20,000 - 50,000;540;26;514;0;0;0
913060;Jet Lancer;Action, Adventure, Indie;20,000 - 50,000;673;34;639;320;320;1
913090;Rogue Party;Casual;0 - 20,000;48;2;46;0;0;0
913100;RED: Lucid Nightmare;Casual, Indie, Strategy;0 - 20,000;17;4;13;0;0;0
913110;Desktop Tree;Casual, Indie, Simulation;0 - 20,000;82;4;78;0;0;2
913120;Cat Inside;Action;0 - 20,000;12;0;12;0;0;0
913150;Kitten and food: adventure park;Indie, Strategy, Early Access;0 - 20,000;11;7;4;0;0;0
913160;茉莉之夏 Jasmine Summer;Indie;0 - 20,000;110;10;100;0;0;1
913180;Battle royale simulator;Action, Adventure, Casual, Free to Play, Indie, RPG, Strategy;0 - 20,000;10;15;-5;0;0;0
913210;CatCatch;Action, Indie;0 - 20,000;4;0;4;0;0;0
913250;Mimic;;0 - 20,000;1;6;-5;0;0;0
913260;Victoria;Adventure, Casual, Indie, Simulation;0 - 20,000;10;9;1;0;0;0
913270;We Are Terror: The First Days;Action, Free to Play, Indie, Early Access;0 - 20,000;13;10;3;0;0;0
913270;We Are Terror: The First Days;Action, Casual, Racing, Simulation;0 - 20,000;13;10;3;0;0;0
913280;Pranky Cat;Casual, Indie, Massively Multiplayer, Early Access;0 - 20,000;35;10;25;0;0;0
913320;The Devil's Womb;Adventure, Casual, Indie;0 - 20,000;39;2;37;0;0;0
913340;Pro Strategy Football 2019;Indie, RPG, Strategy;0 - 20,000;9;3;6;0;0;0
913370;The Colony;Casual, Indie, Early Access;0 - 20,000;5;12;-7;0;0;0
913420;The Odd Battle;Action, Adventure, Indie;0 - 20,000;2;0;2;0;0;0
913440;Mahjongg The Ultimate Collection 2;Action, Adventure, Indie, RPG, Early Access;0 - 20,000;9;1;8;0;0;0
913450;DareSora: Tears for an Unknown Sky;Indie;0 - 20,000;12;6;6;0;0;0
913500;Prank Masters ~ Otome Visual Novel;Action, Adventure, Indie;0 - 20,000;6;1;5;0;0;0
913550;I wanna be the Creator;Adventure, Indie;100,000 - 200,000;2250;82;2168;337;382;76
913570;Cave under Richmordnom;Action, Casual, Indie;0 - 20,000;2;1;1;0;0;0
913590;Dimension Drifter;Casual, Free to Play;0 - 20,000;43;11;32;0;0;0
913650;Supaplex GO!;;0 - 20,000;12;5;7;0;0;0
913650;Supaplex GO!;Casual;0 - 20,000;12;5;7;0;0;0
913660;Supaplex THINK!;Casual, Indie;0 - 20,000;6;2;4;0;0;3
913670;Supaplex WOW!;Adventure, Indie;0 - 20,000;9;1;8;0;0;0
913680;Skybox Painter 3D;Indie;0 - 20,000;1;1;0;0;0;0
913690;Me Smart Orc;Action, Adventure, Indie, Simulation, Early Access;20,000 - 50,000;9;1;8;0;0;0
913710;Dangerous Lands - Magic and RPG;Action, Indie;0 - 20,000;50;16;34;0;0;0
913720;Alchemic Cutie;Action, Adventure, Indie;0 - 20,000;24;13;11;0;0;0
913740;WORLD OF HORROR;Action, Adventure, Indie, Early Access;200,000 - 500,000;5176;286;4890;1874;419;33
913770;Toy Gun Office Simulator;Adventure, Indie, Early Access;0 - 20,000;3;2;1;0;0;0
913780;NEW LIFE;Action, Adventure, Indie;0 - 20,000;22;152;-130;0;0;0
913820;MMA Simulator;Action, Casual, Indie, RPG, Early Access;0 - 20,000;10;15;-5;0;0;0
913830;Slime Age: Parody MMORPG Clicker;Casual, Indie, Strategy;0 - 20,000;7;5;2;0;0;0
913840;Super Frog's Quest;Adventure, Casual, Indie, RPG, Simulation;0 - 20,000;5;1;4;0;0;0
913850;103;Indie, RPG;0 - 20,000;138;46;92;0;0;1
913890;Plastic soldiers;Action, Indie, RPG, Early Access;20,000 - 50,000;120;59;61;0;0;0
913910;Nightmare Of Melanie;Action, Indie;20,000 - 50,000;35;23;12;0;0;0
913970;The Legend of Protey;Strategy;20,000 - 50,000;8;1;7;0;0;0
914000;Tiny Battle Simulator;Action;0 - 20,000;37;6;31;0;0;0
914010;Train Station Renovation;Action, Indie, Strategy, Early Access;100,000 - 200,000;1941;403;1538;490;444;12
914020;Gibbous -  A Cthulhu Adventure;Action, Adventure, Indie;100,000 - 200,000;1622;186;1436;386;441;5
914030;B. Braun Aesculap Spine VR;Indie, Strategy;0 - 20,000;11;2;9;0;0;0
914050;Mummy on the run;Adventure, Casual, Indie;0 - 20,000;2;0;2;0;0;0
914070;Shoemaker;Action, Adventure, Casual, Indie;0 - 20,000;4;11;-7;0;0;0
914090;GIRAL;Casual, Indie;0 - 20,000;10;4;6;0;0;0
914110;Narcos: Rise of the Cartels;Indie, Strategy;0 - 20,000;297;293;4;419;419;4
914130;ICE AGENT;Adventure, Indie;0 - 20,000;3;10;-7;0;0;0
914140;Hentai Dojo;Education;0 - 20,000;100;46;54;0;0;0
914170;Duck Life: Battle;Casual, Simulation, Sports;0 - 20,000;194;27;167;0;0;3
914180;MMA Team Manager;Casual, Racing, Simulation;0 - 20,000;25;35;-10;0;0;1
914190;BattleBlade;Action, Casual, Indie;0 - 20,000;4;1;3;0;0;0
914200;Football Director 2019;Action, Adventure, Indie;0 - 20,000;3;9;-6;0;0;0
914220;Land of Puzzles: Castles;Indie, Strategy;0 - 20,000;11;20;-9;0;0;0
914230;Swamp Jump;Casual, Indie;50,000 - 100,000;10;15;-5;0;0;0
914240;Nuclear Rancher;Education;0 - 20,000;11;11;0;0;0;0
914250;Deadly Burrito;Adventure, Casual, Indie, Simulation;0 - 20,000;6;3;3;0;0;0
914260;HALF DEAD 2;Adventure, Casual, Indie;100,000 - 200,000;1825;324;1501;121;133;7
914290;Welcome to Princeland;Simulation, Early Access;20,000 - 50,000;283;79;204;0;0;1
914320;Swarm Simulator: Evolution;Adventure, Casual, Indie;50,000 - 100,000;363;101;262;0;0;23
914350;Wet Warfare;Casual, Indie, Strategy;0 - 20,000;1;1;0;0;0;0
914390;Dojini;Casual;0 - 20,000;7;6;1;0;0;0
914400;Key Of Impasse;Action, Casual, Free to Play, Indie, RPG;0 - 20,000;91;16;75;0;0;0
914420;Shadow Fencer Theatre;Action, Adventure, Indie;0 - 20,000;10;1;9;0;0;0
914430;Pro Office Calculator;Indie;20,000 - 50,000;193;19;174;0;0;2
914440;Dear Home;Indie;0 - 20,000;2;0;2;0;0;0
914450;Test Subject 901;Action, Indie, Early Access;50,000 - 100,000;36;10;26;0;0;0
914480;Boom Bits;Racing;0 - 20,000;1;0;1;0;0;0
914500;Boons Farm;Adventure, Casual, Simulation, Strategy;0 - 20,000;17;28;-11;0;0;0
914510;Project Reset;Adventure, Casual, Indie;0 - 20,000;15;10;5;0;0;0
914510;Project Reset;Adventure, Indie;0 - 20,000;15;10;5;0;0;0
914600;Surge;Action, Adventure, Free to Play;0 - 20,000;1;0;1;0;0;0
914620;Mist Survival;Action, Indie;200,000 - 500,000;8661;2153;6508;1279;1147;210
914630;Wolf: The Evolution Story;Adventure, Indie, RPG, Simulation;0 - 20,000;3;7;-4;0;0;0
914680;Crazy Alchemist;Casual, Indie, Simulation, Sports;0 - 20,000;21;8;13;0;0;0
914690;Hentai Shooter 3D;Design & Illustration, Early Access;50,000 - 100,000;419;123;296;277;405;1
914700;MINImax Tinyverse;Action, Indie;100,000 - 200,000;370;144;226;46;69;0
914710;Cat Quest II;Action, Adventure, Casual, Indie, Early Access;200,000 - 500,000;3671;141;3530;504;330;62
914750;Bee Simulator;Action, Indie, Simulation;50,000 - 100,000;540;222;318;89;115;7
914800;Coffee Talk;Adventure, Indie, RPG, Strategy, Early Access;200,000 - 500,000;6890;333;6557;249;248;47
914850;HENTAI PUZZLE;Indie;0 - 20,000;22;2;20;0;0;0
914890;Nine Noir Lives;Casual, Free to Play, Indie, RPG, Strategy, Early Access;0 - 20,000;51;8;43;0;0;3
914900;Super Strawberry Man;Action, Adventure;0 - 20,000;5;3;2;0;0;0
914930;Alcyon Infinity;Indie, Simulation;0 - 20,000;10;0;10;0;0;1
914950;The Ultra Code;Free to Play, Indie;0 - 20,000;12;6;6;0;0;0
915020;THE E BALL;Action, Adventure, Indie, RPG, Early Access;0 - 20,000;15;3;12;0;0;0
915060;Dream Enders RPG;Action, Casual, Free to Play, Indie, Strategy;0 - 20,000;17;3;14;0;0;0
915080;Sokoban: The RPG;Casual, Indie, RPG, Simulation, Strategy;0 - 20,000;9;3;6;0;0;0
915120;Koi Solitaire;Adventure, Casual, Indie, RPG;0 - 20,000;1;0;1;0;0;0
915130;东方龙隐談 ~ Touhou Chaos of Black Loong;Adventure, Casual, Indie, RPG;0 - 20,000;135;21;114;21;21;0
915140;Adera;Action, Casual, Indie;20,000 - 50,000;134;15;119;0;0;1
915160;Anime Girl Or Boy?;Casual, Indie;20,000 - 50,000;42;27;15;0;0;0
915190;Cartoony Cars 2;Adventure, Casual, Strategy;0 - 20,000;11;0;11;0;0;0
915200;Republique VR;Adventure, Casual, Indie, Simulation;0 - 20,000;57;21;36;0;0;1
915230;Zombie Rollerz: Pinball Heroes;Adventure, Indie, RPG, Strategy;0 - 20,000;233;26;207;0;0;3
915300;The planet's rescuer;Adventure, Casual, Indie, Simulation;0 - 20,000;5;0;5;0;0;0
915310;SNKRX;Action, Adventure, Casual, Indie;100,000 - 200,000;3727;178;3549;614;811;24
915320;Pixel Strike 3D;Action, Casual, Free to Play, Indie, Early Access;500,000 - 1,000,000;7665;2564;5101;0;0;174
915330;Hentai Block Breaker;Casual, Indie;0 - 20,000;0;0;0;0;0;0
915360;Hexahedral Pathfinder;Simulation;0 - 20,000;12;0;12;0;0;0
915380;John Black: Memories;Casual, Indie;0 - 20,000;6;1;5;0;0;0
915420;TeleBlast;Action, Casual, Indie, Simulation, Strategy, Early Access;0 - 20,000;2;0;2;0;0;0
915430;Triteckka: The pure shooter;Action, Casual, Simulation;0 - 20,000;1;1;0;0;0;0
915440;Fireflies;Action, Indie;0 - 20,000;11;9;2;0;0;0
915460;ULTIMATE HARDBASS DEFENCE;Casual, Indie, Simulation, Early Access;100,000 - 200,000;1940;166;1774;89;74;2
915490;Frontline Zed;Action, Adventure, Indie, Massively Multiplayer, RPG, Early Access;0 - 20,000;163;115;48;163;163;1
915540;Aim Master;Indie;50,000 - 100,000;31;17;14;105;105;0
915560;Koropokkur in Love ~A Little Fairy’s Tale~;Action, Casual, Free to Play, Indie;0 - 20,000;20;6;14;0;0;0
915570;Polygone;Action;0 - 20,000;5;1;4;0;0;0
915580;Dungeon Hunter Champions;Adventure, Indie;200,000 - 500,000;317;215;102;34;40;6
915670;Everreach: Project Eden;Indie, Simulation, Animation & Modeling, Video Production, Early Access;50,000 - 100,000;189;228;-39;268;268;0
915710;Little Dragons Café;Adventure, Simulation;0 - 20,000;56;43;13;0;0;0
915720;Session Seven;Action, Indie;20,000 - 50,000;171;21;150;0;0;0
915730;Catch The Kids: Priest Simulator Game;Casual, Indie;0 - 20,000;10;2;8;0;0;0
915760;Aether Drift;Casual, Indie, Simulation;0 - 20,000;3;0;3;0;0;0
915770;People Cu3ed;Indie, RPG;0 - 20,000;7;0;7;0;0;0
915810;Midnight Ghost Hunt;Indie, Simulation, Sports;200,000 - 500,000;4096;1045;3051;305;280;92
915820;Amethlion;Adventure;0 - 20,000;9;3;6;0;0;0
915850;Super Hiking League DX;Free to Play, Massively Multiplayer, RPG;0 - 20,000;32;1;31;0;0;0
915860;Zettavolt Trigger;Casual, Indie;0 - 20,000;1;0;1;0;0;0
915930;Sparticles;Indie, Strategy, Early Access;0 - 20,000;4;2;2;0;0;0
915960;Gallows Choice;Action, Indie;0 - 20,000;3;8;-5;0;0;0
916010;Beating A Dead Horse With A One-Trick Pony;Indie, Simulation;0 - 20,000;3;1;2;0;0;0
916030;A Summer with the Shiba Inu;Adventure, Casual;0 - 20,000;33;1;32;0;0;0
916040;SFD : Rogue TRPG;Action, Casual, Indie, Racing, Simulation, Strategy;0 - 20,000;83;10;73;0;0;0
916040;SFD : Rogue TRPG;Indie;0 - 20,000;83;10;73;0;0;0
916050;Clocker;Indie, Strategy;20,000 - 50,000;197;30;167;0;0;0
916060;Loca-Love My Cute Roommate;Action, Casual, Indie, Simulation, Sports;0 - 20,000;89;7;82;0;0;1
916100;Telefrag VR;Action, Casual, Indie, RPG, Strategy;0 - 20,000;49;34;15;92;92;1
916120;Rascals;Adventure, Casual, Indie, RPG;0 - 20,000;4;0;4;0;0;0
916130;Meet the Miner - WDR VR Bergwerk;Action, Adventure, Casual, Free to Play, Indie, Early Access;20,000 - 50,000;38;7;31;0;0;0
916140;The Tale of Bistun;Adventure, Casual, Indie, Strategy;0 - 20,000;137;14;123;0;0;0
916150;Here Nya;Adventure, Indie, RPG, Simulation, Strategy;0 - 20,000;2;0;2;0;0;0
916160;Dreamwalker: Never Fall Asleep;Adventure, Indie, RPG, Strategy;0 - 20,000;157;35;122;0;0;0
916180;Doodle Derby;Action, Indie, Early Access;0 - 20,000;55;22;33;84;87;2
916210;Fabrication;Sports;20,000 - 50,000;1;0;1;0;0;0
916240;Madievals;Indie;0 - 20,000;15;1;14;0;0;0
916260;Cyclones Playground;Indie;0 - 20,000;2;5;-3;0;0;0
916290;Crime Girl;Adventure, Casual, Indie, RPG, Strategy;0 - 20,000;8;2;6;0;0;0
916320;Fair Deal: Las Vegas;Action, Indie;0 - 20,000;18;0;18;0;0;0
916340;Blue Time;Action, Adventure, Free to Play, Indie, Massively Multiplayer, RPG, Early Access;0 - 20,000;0;1;-1;0;0;0
916370;Tempo Wizard;Casual, Indie, Simulation;0 - 20,000;1;3;-2;0;0;0
916380;Panco's Journey;Action, Adventure, Early Access;0 - 20,000;7;1;6;0;0;0
916390;Team Up VR (Beta);Adventure, Indie;20,000 - 50,000;14;15;-1;0;0;0
916440;Anno 1800;Indie, RPG, Strategy;500,000 - 1,000,000;5321;1368;3953;641;705;1905
916470;Gimel Dimension;Casual, Indie, Simulation;0 - 20,000;8;3;5;0;0;0
916510;Running Man 3D Part2;Action, Casual, Free to Play;0 - 20,000;14;10;4;0;0;0
916540;Fatal Hour: Petroleum;Action, Adventure, Casual, Indie, Strategy;0 - 20,000;7;2;5;0;0;0
916620;Professor Chuckenhope;Casual, Free to Play, Indie;0 - 20,000;4;1;3;0;0;0
916630;Double Stretch;Action, Casual, Strategy;0 - 20,000;4;11;-7;0;0;0
916640;HecatoncheirStory;Adventure, Casual, RPG;0 - 20,000;4;14;-10;0;0;0
916730;Gato Roboto;Action, Casual, Indie;100,000 - 200,000;3119;164;2955;152;181;6
916780;Groundless;Action, Indie;0 - 20,000;2;2;0;0;0;0
916820;WAR_WAR_WAR: Smiles vs Ghosts;Adventure, Indie;0 - 20,000;7;19;-12;0;0;0
916820;WAR_WAR_WAR: Smiles vs Ghosts;Indie, Simulation, Strategy, Early Access;0 - 20,000;7;19;-12;0;0;0
916840;The Walking Dead: Saints & Sinners;Adventure, Indie;500,000 - 1,000,000;7298;953;6345;233;205;83
916860;Puzzle Monarch: Super Natural;RPG;0 - 20,000;11;20;-9;0;0;1
916880;Puzzle Monarch: Zombie;Action, Indie, Strategy;0 - 20,000;9;19;-10;0;0;0
916900;Paperbark;Simulation, Strategy;0 - 20,000;264;33;231;0;0;0
916910;Infommi;Adventure, Casual;0 - 20,000;6;1;5;0;0;0
916930;War Trigger Classic;Action, Adventure, Indie;20,000 - 50,000;501;333;168;0;0;0
916940;利刃 (Blade);Casual, Indie, Simulation;0 - 20,000;41;29;12;0;0;0
916950;Awesome Pea;Action, Indie, Early Access;0 - 20,000;66;12;54;0;0;0
916960;Skelittle: A Giant Party!!;Action, Adventure, Indie;0 - 20,000;13;3;10;0;0;0
916970;DUCK CASINO: BULLET;Action, Adventure, Indie;0 - 20,000;6;1;5;0;0;0
916980;CryptoFarm;Casual, Indie;0 - 20,000;5;17;-12;0;0;0
917000;WORLD  HENTAI;Simulation, Sports;0 - 20,000;45;12;33;0;0;0
917020;The Con Simulator;Casual, Indie, RPG;0 - 20,000;2;21;-19;0;0;0
917050;Find The Balance;Action, Adventure, Indie, Massively Multiplayer, RPG;0 - 20,000;2;0;2;0;0;0
917130;Lily;Casual, Indie;0 - 20,000;5;0;5;0;0;0
917140;Amberial Dreams;Free to Play, Indie, RPG;50,000 - 100,000;32;0;32;0;0;8
917150;Godhood;Action, Free to Play;50,000 - 100,000;716;259;457;99;99;10
917200;Kill the Dictator;Action, Indie, Strategy;0 - 20,000;24;4;20;0;0;0
917220;Trigger Finger;Indie, RPG, Early Access;0 - 20,000;6;0;6;0;0;0
917240;Heavy Dreams;Casual, Free to Play, Indie, Simulation;50,000 - 100,000;65;115;-50;0;0;0
917290;Duck Souls;Action, Adventure, Indie, RPG, Strategy;0 - 20,000;252;7;245;0;0;0
917380;Lancelot's Hangover: The Quest for the Holy Booze;Action, Indie, Simulation;0 - 20,000;45;2;43;0;0;0
917550;Checkmate!;Casual, Indie, Simulation, Early Access;0 - 20,000;6;8;-2;0;0;0
917600;Became The Hunted;Action;0 - 20,000;1;11;-10;0;0;0
917610;The Story of My Life;Action, Indie;0 - 20,000;1;3;-2;0;0;0
917680;one night, hot springs;Action, Simulation, Early Access;100,000 - 200,000;2118;89;2029;0;0;2
917690;VANILLA - GARDEN OF JUDGEMENT;Action, Indie, Simulation, Sports;0 - 20,000;27;1;26;0;0;1
917710;Decisions;Indie;0 - 20,000;1;2;-1;0;0;0
917720;Gamedec - Definitive Edition;Casual, Indie;100,000 - 200,000;969;212;757;277;315;9
917760;Survivor in Summer;Adventure, Casual, Indie;0 - 20,000;1;2;-1;0;0;0
917770;Mystery House -fivestones-;Action, Casual, Indie;0 - 20,000;7;0;7;0;0;0
917800;JOYDOOR;Indie, Simulation, Strategy;0 - 20,000;4;3;1;0;0;0
917810;Beast Modon;Action, Adventure, Indie;0 - 20,000;3;0;3;0;0;0
917830;Anima;Casual, Indie, Simulation, Strategy;0 - 20,000;16;9;7;0;0;0
917840;Wintermoor Tactics Club;Indie, Sports;20,000 - 50,000;430;36;394;31;31;3
917850;Elemental War - A Tower Defense Game;Adventure, Indie, RPG;0 - 20,000;20;7;13;0;0;0
917870;Gauge Of Rage;Casual, Indie, RPG, Simulation, Strategy, Early Access;0 - 20,000;18;1;17;0;0;0
917880;Misfit;Action, Casual, Indie, Strategy;0 - 20,000;0;0;0;0;0;0
917900;Monster Logic;Adventure, Indie, RPG;0 - 20,000;11;0;11;0;0;0
917910;Lucid Path;Adventure, Indie, RPG;0 - 20,000;17;2;15;0;0;0
917920;The Other Half;Adventure, Indie, RPG;0 - 20,000;77;13;64;0;0;0
917940;LEMURIA;Indie, Simulation;0 - 20,000;31;11;20;0;0;0
917990;Starboost EX;Casual, Indie, Strategy;0 - 20,000;1;1;0;0;0;0
918060;Obstruction : VR;Casual, Free to Play, Indie, Massively Multiplayer, Strategy;0 - 20,000;6;3;3;0;0;0
918070;JQ: Beautiful Japan;Action, Adventure, Casual, Free to Play, Massively Multiplayer, RPG, Simulation, Strategy;0 - 20,000;61;25;36;0;0;0
918080;Evolo.Evolution;Action, Adventure, Indie, Early Access;0 - 20,000;7;12;-5;0;0;0
918100;Space Cowboy;Action;0 - 20,000;4;0;4;0;0;0
918110;Animus - Stand Alone;Indie;0 - 20,000;46;11;35;0;0;0
918120;A.L.A.N.: Rift Breakers;Adventure, Indie, RPG, Strategy;0 - 20,000;5;1;4;0;0;0
918130;Entre-Deux: Cursed;Action, Adventure, Casual, Indie;0 - 20,000;7;1;6;0;0;0
918130;Entre-Deux: Cursed;Adventure, Casual, Indie;0 - 20,000;7;1;6;0;0;0
918140;Hack the Core;Adventure, Indie;0 - 20,000;38;10;28;0;0;0
918160;Smogpunk 湮霾之地;Free to Play, RPG;0 - 20,000;0;0;0;0;0;0
918170;Curiosity;Indie, RPG, Simulation;20,000 - 50,000;52;14;38;0;0;0
918180;Test your knowledge: Cats;Adventure, Indie;0 - 20,000;17;9;8;0;0;0
918260;Pachansky Mathematics 2+2=8;Casual, Indie, RPG, Simulation, Strategy;0 - 20,000;13;7;6;0;0;0
918300;TailzFromTheGrave;RPG, Simulation;0 - 20,000;1;0;1;0;0;0
918320;Swords with spice;Adventure, Indie, RPG;0 - 20,000;7;4;3;0;0;0
918380;Choice of Magics;Adventure, Casual, Indie;0 - 20,000;141;11;130;0;0;3
918430;Second Second;Action, Indie, Early Access;0 - 20,000;78;30;48;0;0;0
918440;SHEEP SLING;Action, Adventure, Indie;0 - 20,000;5;2;3;0;0;0
918450;Dumb Little Creatures;Indie;0 - 20,000;3;1;2;0;0;0
918480;Project GR-5LYR: Galactic Relocation;Casual, Indie, Simulation, Strategy, Early Access;0 - 20,000;2;0;2;0;0;0
918500;Fish Duel;Action, Adventure, Early Access;0 - 20,000;18;5;13;0;0;0
918530;The Dark Room;Indie, Early Access;0 - 20,000;108;11;97;0;0;0
918550;From Darkness;Casual;0 - 20,000;0;1;-1;0;0;0
918570;Century: Age of Ashes;Adventure, Indie;2,000,000 - 5,000,000;11322;3835;7487;99;61;183
918610;NearEscape;Action, Adventure, Casual, Free to Play, Indie, Racing, RPG, Simulation, Strategy;0 - 20,000;7;6;1;0;0;0
918620;Warships 3D;Simulation, Early Access;0 - 20,000;10;1;9;0;0;0
918670;Jewel Match Twilight Solitaire;Casual, Indie, Simulation;0 - 20,000;96;7;89;0;0;3
918680;Castle of Venia;Indie;0 - 20,000;13;18;-5;0;0;0
918690;Survival Ball;Casual, Free to Play, Indie;0 - 20,000;6;1;5;0;0;0
918700;Star99;Adventure, Casual, Free to Play, Indie, RPG, Strategy;0 - 20,000;8;0;8;0;0;0
918720;Help Me Escape! The Puzzle Maker's Office;Simulation;0 - 20,000;2;3;-1;0;0;0
918740;Flat Trip;Action, Adventure, Casual, Free to Play, Indie, Massively Multiplayer, Racing, RPG, Simulation, Sports, Strategy;0 - 20,000;20;1;19;0;0;1
918780;Sector Sweep;Action, Indie, Early Access;0 - 20,000;13;1;12;0;0;2
918820;Headliner: NoviNews;Adventure, Casual, Indie, RPG, Simulation, Strategy;100,000 - 200,000;621;68;553;46;46;3
918850;SPITE;Action, Adventure, Indie, RPG;0 - 20,000;0;0;0;0;0;0
918870;Legend of Assassin: Egypt;Adventure, Indie;0 - 20,000;16;15;1;0;0;0
918880;Aeioth RPG;Adventure, Indie;0 - 20,000;5;8;-3;0;0;0
918900;Girls Dance VR;Adventure, Casual, Indie, RPG;0 - 20,000;10;9;1;0;0;0
918950;WARBORN;Action, Adventure, Simulation;0 - 20,000;39;13;26;77;77;2
918990;Gladio;Adventure, Simulation;0 - 20,000;29;23;6;0;0;0
919040;Skywriter;Adventure, Casual, Indie;0 - 20,000;3;8;-5;0;0;0
919150;A Sun Of Salt;Action, Adventure, Casual, Indie, Strategy, Early Access;0 - 20,000;7;1;6;0;0;0
919160;Submerged: VR Escape the Room;Indie;0 - 20,000;22;8;14;0;0;0
919170;Dude Cops;Indie, Massively Multiplayer, Strategy;0 - 20,000;30;8;22;0;0;0
919190;Cube Full of Mines;Action, Indie, Strategy;0 - 20,000;1;0;1;0;0;0
919200;Special Warfare - 特战之王;Action, Casual, Indie;0 - 20,000;50;28;22;0;0;0
919220;Destiny or Fate;Action, Free to Play;20,000 - 50,000;258;188;70;0;0;2
919240;HappyBlock;Adventure, Indie;0 - 20,000;2;1;1;0;0;0
919260;Final Upgrade;Casual, Indie, Simulation;0 - 20,000;268;58;210;126;126;25
919260;Final Upgrade;Free to Play, Indie;0 - 20,000;268;58;210;126;126;25
919280;MovieMator Video Editor Pro - Movie Maker, Video Editing Software;Free to Play, Indie, Early Access;100,000 - 200,000;424;285;139;350;350;15
919300;Hentai Hexa Mosaic;Action, Indie;0 - 20,000;16;10;6;0;0;0
919320;Touch Down Football Solitaire;Casual, Indie, Strategy;0 - 20,000;10;0;10;0;0;0
919330;Ghost in the pool;Utilities;50,000 - 100,000;194;56;138;0;0;0
919360;Alaloth: Champions of The Four Kingdoms;Casual, Indie;50,000 - 100,000;504;162;342;381;381;17
919370;Overdungeon;Casual, Indie;200,000 - 500,000;2200;625;1575;300;420;19
919400;MOTION;Casual, Indie;0 - 20,000;3;2;1;0;0;0
919410;Felix The Reaper;Casual, Indie;20,000 - 50,000;283;101;182;245;245;2
919440;闇行者 Dark Xingzer;Indie;0 - 20,000;3;0;3;0;0;0
919560;Monster Farm;Casual, Indie;0 - 20,000;21;14;7;0;0;0
919610;The Ball Encounter;Action, Adventure, Indie, Simulation;0 - 20,000;7;6;1;0;0;0
919640;Steel Division 2;Casual, Indie;200,000 - 500,000;5397;1427;3970;2433;1409;804
919690;Click and Manage Tycoon;Action, Indie;0 - 20,000;44;43;1;0;0;0
919730;Project Z;Action, Adventure, Indie, RPG, Simulation, Early Access;0 - 20,000;2;0;2;0;0;0
919890;Navyblue and the Spectrum Killers;Action;0 - 20,000;4;0;4;0;0;0
920190;Greetings;Adventure, Indie, RPG, Early Access;50,000 - 100,000;502;95;407;0;0;0
920200;Artificial Mansion;Action, Adventure, Indie, Early Access;0 - 20,000;25;1;24;0;0;0
920210;LEGO Star Wars: The Skywalker Saga;Indie;1,000,000 - 2,000,000;33126;2922;30204;1198;930;1108
920280;Monster Pub;Casual, Indie, Massively Multiplayer, Simulation, Strategy;0 - 20,000;5;0;5;0;0;0
920320;Virgo Versus The Zodiac;Action, Casual, Indie;50,000 - 100,000;722;55;667;709;717;4
920450;Escape The Labyrinth;Casual, Indie;0 - 20,000;1;1;0;0;0;0
920460;Hentai Space;Adventure, Indie, RPG;0 - 20,000;38;12;26;0;0;0
920470;Dissolution;Casual, Indie, Strategy;50,000 - 100,000;106;79;27;0;0;0
920490;Driver Booster for Steam;Action, Adventure, Indie;200,000 - 500,000;4963;797;4166;3000;206;806
920500;Construction Charlie;Action, Casual, Indie;100,000 - 200,000;6;1;5;0;0;0
920510;Leisure Town;Casual, Indie, RPG, Simulation;0 - 20,000;5;6;-1;0;0;0
920520;Sexy Jigsaw | 性感拼图 | 섹시 퍼즐 | セクシーなパズル;Adventure, Indie, RPG;0 - 20,000;186;34;152;0;0;1
920620;Ghosting Gun S;Adventure, Indie, RPG;0 - 20,000;8;1;7;0;0;0
920640;Emitters - Drone Invasions;Adventure, Indie, RPG;20,000 - 50,000;11;0;11;0;0;0
920680;Fate Hunters;Casual, Indie, Simulation;20,000 - 50,000;623;169;454;860;860;4
920690;CardLife: Creative Survival;Action, Strategy;50,000 - 100,000;1591;922;669;24;43;9
920700;Piano Bar;Casual;0 - 20,000;1;8;-7;0;0;0
920710;Burndown;Adventure, Indie;0 - 20,000;9;11;-2;0;0;0
920770;Santa's Story of Christmas;Action, Adventure, Indie, RPG, Simulation;0 - 20,000;19;1;18;0;0;0
920780;Safe;Action, Adventure, Casual, Indie, Early Access;0 - 20,000;0;1;-1;0;0;0
920800;Lab.Gen.;Indie, Sports;0 - 20,000;10;2;8;0;0;0
920820;Skater Cally;Racing;0 - 20,000;9;3;6;0;0;0
921050;Jar Battlers;Simulation, Strategy, Early Access;0 - 20,000;5;1;4;0;0;0
921060;Modern Combat 5;Action, Indie, Strategy;1,000,000 - 2,000,000;2995;2522;473;118;30;29
921070;Spellwake;Casual, Indie, Simulation, Early Access;100,000 - 200,000;149;24;125;0;0;0
921390;武林志（Wushu Chronicles）;Casual, Indie, Strategy;200,000 - 500,000;1539;858;681;1549;1590;9
921420;Kingpin Royale;Action, Adventure, Casual, Indie, RPG, Early Access;0 - 20,000;2;0;2;0;0;0
921430;Genius! NAZI-GIRL GoePPels-Chan ep1;Action, Early Access;0 - 20,000;67;4;63;0;0;0
921450;King Randall's Party;Action, Casual, Indie, Simulation;0 - 20,000;2;1;1;0;0;0
921500;Jack Is Missing;Casual, Indie, RPG, Simulation;0 - 20,000;64;52;12;0;0;0
921520;Puppy Chef Academy;Action, Adventure, Casual, Indie, Racing, RPG, Simulation, Sports, Strategy;0 - 20,000;23;7;16;0;0;0
921530;Demon King Domination: Deluxe Edition;Indie, RPG, Simulation, Strategy, Early Access;0 - 20,000;0;0;0;12;14;0
921570;OCTOPATH TRAVELER;Action, Adventure, Indie, Simulation;200,000 - 500,000;10481;1633;8848;1379;883;828
921590;DISSIDIA FINAL FANTASY NT Free Edition;Indie, Massively Multiplayer, Simulation, Strategy, Early Access;500,000 - 1,000,000;1407;1832;-425;99;33;18
921630;音灵 INVAXION;Casual, Indie, Strategy;1,000,000 - 2,000,000;3380;2828;552;723;551;4
921660;Quirky Crystal RPG;Adventure, Indie, Simulation, Strategy, Early Access;0 - 20,000;1;0;1;0;0;0
921670;William and the Lands of Rage;Casual, Indie;0 - 20,000;2;0;2;0;0;0
921690;O2Jam x DancingParty;Adventure, Casual, Indie;0 - 20,000;0;1;-1;0;0;0
921700;Crashphalt;Action, Casual;0 - 20,000;63;4;59;0;0;22
921730;Abberbury;Action, Casual, Indie;0 - 20,000;25;5;20;0;0;0
921740;Shahrzad - The Storyteller;Casual, Indie, Strategy;0 - 20,000;4;1;3;0;0;0
921770;HANZ!;Simulation;0 - 20,000;21;9;12;0;0;0
921780;The Dark Occult;Action, Adventure, Casual, Indie;50,000 - 100,000;703;312;391;0;0;9
921800;Encased: A Sci-Fi Post-Apocalyptic RPG;Action, Adventure, Indie, Strategy;200,000 - 500,000;2945;763;2182;885;644;141
921840;Sabreurs - A Noble Duel;Action, Adventure, Indie, Sports, Early Access;0 - 20,000;2;0;2;0;0;0
921850;Jar Sam;Adventure, Casual;0 - 20,000;4;0;4;0;0;0
921890;Retro Rockets;Action, Adventure, Casual, Indie;0 - 20,000;4;0;4;0;0;0
921920;Robikon;Adventure, Indie, RPG, Strategy, Early Access;20,000 - 50,000;1;1;0;0;0;0
921940;Icarus Online;Casual, Indie, Simulation;50,000 - 100,000;138;88;50;30;30;0
921960;Koliseum Soccer VR;Action, Indie, Strategy;0 - 20,000;10;7;3;0;0;0
921970;Liberty Prime;Casual, Indie;0 - 20,000;29;63;-34;0;0;0
921970;Liberty Prime;Casual, Indie;0 - 20,000;29;63;-34;0;0;0
922020;Beyond The Veil;Casual, Simulation;0 - 20,000;8;1;7;0;0;0
922040;Hamsterdam;Free to Play, Simulation;20,000 - 50,000;94;23;71;0;0;1
922060;Ball run and rush;Action, Casual, Indie, Racing, Simulation, Sports;0 - 20,000;5;2;3;0;0;0
922080;Shards the Deckbuilder;Simulation;20,000 - 50,000;20;16;4;0;0;0
922090;CMD 2048;Action, Adventure, Indie;0 - 20,000;14;13;1;0;0;0
922100;Nauticrawl;Casual, Indie;50,000 - 100,000;262;15;247;0;0;1
922130;Land of Puzzles: Knights;Action, Casual, Indie, Strategy;0 - 20,000;13;20;-7;0;0;0
922140;Oh, you touch my balls ( ͡° ͜ʖ ͡°);Action, Adventure, Indie;0 - 20,000;92;36;56;0;0;1
922150;Ink Plane;Action, Adventure, Indie, Early Access;0 - 20,000;44;10;34;0;0;0
922170;The True Slime King;Casual, Simulation;0 - 20,000;6;0;6;0;0;0
922190;Beat Champion;Casual, Indie;0 - 20,000;11;0;11;0;0;0
922220;Khospis;Adventure, RPG, Strategy;0 - 20,000;5;4;1;0;0;0
922250;Heavy Burger;Casual, Indie, Simulation;0 - 20,000;62;10;52;0;0;0
922290;Flappy Flappy VR;Indie;0 - 20,000;26;2;24;0;0;1
922320;Sniper 3D Assassin: Free to Play;RPG, Strategy, Early Access;200,000 - 500,000;862;509;353;0;0;35
922400;DX-Ball 2: 20th Anniversary Edition;Casual;20,000 - 50,000;374;13;361;0;0;13
922410;DinoKnights;Strategy;0 - 20,000;10;2;8;0;0;0
922450;4X-Galaxy 无主之地：银河;Action, Massively Multiplayer, Simulation, Early Access;100,000 - 200,000;122;120;2;0;0;0
922460;Cheeky Chooks;Adventure, Indie, RPG, Early Access;200,000 - 500,000;2211;148;2063;0;0;7
922470;Space Mayhem;Casual;0 - 20,000;31;0;31;0;0;0
922480;Auto Battle Royale;Indie;0 - 20,000;12;8;4;0;0;0
922500;KILL la KILL -IF;Casual, Indie;20,000 - 50,000;970;412;558;101;129;4
922510;Jellyfish the Ghost;Action, Indie, Early Access;0 - 20,000;11;1;10;0;0;0
922520;Blood City;Action, Indie;0 - 20,000;19;0;19;0;0;0
922530;Bestiary of Sigillum;Casual, Indie, RPG, Simulation;0 - 20,000;61;5;56;0;0;0
922550;keyg;Action, Casual, Indie;0 - 20,000;112;17;95;0;0;1
922560;Blixten Quest;Animation & Modeling, Design & Illustration;0 - 20,000;2;0;2;0;0;0
922590;Enter The Moon;Action, Adventure, Indie, RPG, Early Access;0 - 20,000;4;3;1;0;0;0
922620;Kingshunt;Adventure, Indie, Simulation;20,000 - 50,000;124;117;7;0;0;2
922630;Mortal Royale;Action, Adventure, Casual, Free to Play, Indie, Massively Multiplayer, Racing, RPG, Simulation, Sports, Strategy;50,000 - 100,000;100;153;-53;10;10;0
922650;Caveman Chuck;Indie, Strategy;0 - 20,000;19;1;18;0;0;0
922660;MAGIX Video deluxe 2019 Steam Edition;Action, Adventure, Indie, RPG, Strategy;0 - 20,000;27;14;13;0;0;3
922670;MAGIX Video deluxe 2019 Plus Steam Edition;Action, Casual, Indie;0 - 20,000;15;11;4;0;0;0
922700;Hidden Animals: Photo Hunt. Seek and Find Objects Game;Action, Free to Play, Indie;0 - 20,000;72;5;67;0;0;0
922710;Knightin'+;Casual;20,000 - 50,000;199;32;167;0;0;0
922810;MeatPossible: Chapter 1.5;Adventure, Indie;0 - 20,000;15;17;-2;0;0;0
922820;Lotus Bloom;Casual, Free to Play, Indie;0 - 20,000;16;1;15;0;0;0
922880;Siberian Dawn;Casual, Indie;0 - 20,000;8;13;-5;0;0;0
922920;Knights of Tartarus;RPG, Strategy;0 - 20,000;30;5;25;0;0;0
923030;Rocket Swords;Casual, Simulation, Sports;0 - 20,000;6;3;3;0;0;0
923050;Don't Touch Me : Zombie Survival;Action;0 - 20,000;3;0;3;0;0;0
923080;Angel and Devil,ninja,sushi,tempura,panda and the statue of liberty;Action, Adventure, Indie;0 - 20,000;5;1;4;0;0;0
923120;Food Bomber;Casual, Indie;20,000 - 50,000;0;3;-3;0;0;0
923130;Plunder Squad;Casual, Indie;0 - 20,000;1;1;0;0;0;0
923180;The prophecy of statues;Action, Indie;0 - 20,000;1;8;-7;0;0;0
923230;DreamBack VR;Action, Adventure, Free to Play, Indie;20,000 - 50,000;16;5;11;0;0;0
923240;The Warrior Of Treasures 2: Skull Hunter;Action, Indie;0 - 20,000;8;14;-6;0;0;0
923260;Golf Peaks;Action, Adventure, Casual, Indie, Early Access;20,000 - 50,000;347;19;328;91;91;1
923270;Rome Reborn: Roman Forum;Indie;0 - 20,000;6;4;2;0;0;0
923340;Space Adventure TD;Casual, Indie, Simulation, Strategy;0 - 20,000;0;2;-2;0;0;0
923350;Sakura Day Mahjong;Action, Adventure, Indie;0 - 20,000;12;2;10;0;0;1
923400;苍夜;Action, Indie, RPG, Early Access;0 - 20,000;5;3;2;0;0;0
923400;苍夜;Action, Casual, Indie;0 - 20,000;5;3;2;0;0;0
923420;Farstorm;Action, Adventure, Casual, Indie, RPG;0 - 20,000;41;15;26;0;0;0
923420;Farstorm;Adventure, Indie, RPG;0 - 20,000;41;15;26;0;0;0
923460;Biodigital;Action, Casual, Indie;0 - 20,000;6;9;-3;0;0;0
923470;MOMO.EXE;Action, Casual, Indie;20,000 - 50,000;742;122;620;8;8;3
923480;Strategist;Indie, Simulation, Early Access;0 - 20,000;9;3;6;0;0;0
923500;Metanormal;Adventure, Casual, Indie;0 - 20,000;6;2;4;0;0;0
923530;RIP;Casual, Indie, Sports;0 - 20,000;13;7;6;0;0;0
923550;Rescale;Action, Indie;0 - 20,000;3;0;3;0;0;0
923570;Eternal Radiance;Action, Casual, Indie;20,000 - 50,000;374;70;304;0;0;1
923590;Forebearers;Adventure, Casual, Free to Play, Indie, RPG, Simulation;0 - 20,000;56;53;3;0;0;0
923590;Forebearers;Action, Adventure, Indie, Early Access;0 - 20,000;56;53;3;0;0;0
923630;Burger Lord;;0 - 20,000;6;1;5;0;0;0
923650;The Quest for Moe's;Action;0 - 20,000;6;0;6;0;0;0
923670;Super Shopper;Adventure, Casual, Indie, RPG;0 - 20,000;12;0;12;0;0;0
923690;Hacker.exe;Adventure, Indie, RPG;0 - 20,000;6;18;-12;0;0;0
923710;uFactory;Indie, Sports;0 - 20,000;44;13;31;0;0;0
923730;Monster MIX;Indie, Strategy;0 - 20,000;13;4;9;0;0;0
923790;Battle Royale Survival;Adventure, Indie, RPG;0 - 20,000;19;13;6;0;0;0
923820;尸狱末日 Dead Prison;Casual, RPG;0 - 20,000;26;9;17;0;0;0
923840;侠隐行录：困境疑云Wuxia archive: Crisis escape;Casual, Indie, Simulation;20,000 - 50,000;136;39;97;0;0;0
923880;Educator 2076: Basics in Education;Casual, Indie, Simulation;0 - 20,000;10;4;6;0;0;0
923890;Yet another tower defence;Action, Casual, Indie, Simulation;20,000 - 50,000;88;49;39;1;1;2
923900;Lightning Angel Litona Liliche 섬광천사 리토나 리리셰;Indie, Early Access;0 - 20,000;38;2;36;0;0;1
923910;Eve of Souls: Static Pod;Casual, Indie, Simulation, Early Access;20,000 - 50,000;426;16;410;0;0;1
923970;Space Company Simulator;Strategy;0 - 20,000;52;116;-64;0;0;0
924020;Spellrune: Realm of Portals;Free to Play, Indie, Massively Multiplayer;0 - 20,000;12;31;-19;0;0;0
924040;Fairy Tower Defense;Action, Adventure, Indie, RPG, Early Access;0 - 20,000;5;9;-4;0;0;0
924070;Arboria;Action, Adventure, Indie;0 - 20,000;470;101;369;21;21;4
924090;Trip in HELL;Adventure, Indie;0 - 20,000;8;7;1;0;0;0
924100;Helheim;Casual, Free to Play, Indie, Simulation;0 - 20,000;13;12;1;0;0;0
924130;Slime-san: Creator;Action, Casual, Indie;0 - 20,000;1;0;1;0;0;0
924140;Hand Simulator: Survival;Free to Play, Indie;500,000 - 1,000,000;8459;1302;7157;103;53;12
924250;PROZE: Enlightenment;Action, Casual, Free to Play, Strategy;0 - 20,000;79;34;45;158;158;0
924280;BingoBango;Action, Adventure, Casual, Indie;0 - 20,000;11;1;10;0;0;0
924310;VIDEO GAME;Casual, Indie;0 - 20,000;14;6;8;0;0;0
924360;Zenith Hunter;Casual, Indie, Racing, Simulation;0 - 20,000;15;6;9;0;0;0
924370;Kontrakt;Casual, Indie, Simulation;0 - 20,000;29;21;8;0;0;0
924390;Ozapell Mystery Text Adventure;Casual, Indie;0 - 20,000;1;2;-1;0;0;0
924420;Here to There;Adventure, Casual, Indie, RPG;0 - 20,000;2;2;0;0;0;0
924460;Vinylove;Action, Casual, Indie, Strategy;0 - 20,000;9;8;1;0;0;0
924500;街头英雄 Street Heroes;Action, Indie;0 - 20,000;1;4;-3;0;0;0
924520;Sunny Shine Funland!;Action, Adventure, Indie, Strategy;0 - 20,000;5;0;5;0;0;0
924530;One Last Try;Action, Indie;0 - 20,000;6;1;5;0;0;0
924560;Evocation;Action, Indie, Racing, Simulation, Sports, Early Access;0 - 20,000;6;0;6;0;0;0
924650;Hifuu Nightmare Diary ~ Violet Detector. ;Casual, Indie;50,000 - 100,000;204;63;141;0;0;3
924660;RollerPlay;Action, Indie, RPG, Early Access;0 - 20,000;1;1;0;0;0;0
924670;Need for Spirit: Drink & Drive Simulator/醉驾模拟器;Adventure, Casual, Indie;20,000 - 50,000;74;55;19;0;0;0
924710;骰子勇士 Dice Warrior;Action, Adventure, Casual, Indie, Early Access;0 - 20,000;14;7;7;0;0;0
924740;Beyond Senses;Action, Casual, Indie;0 - 20,000;22;16;6;0;0;0
924770;Colory Engine;Adventure, Indie, Simulation;0 - 20,000;12;5;7;0;0;0
924780;How to Sing to Open Your Heart;Casual, Indie;0 - 20,000;26;1;25;0;0;0
924790;Island Maze;Casual, Indie, Strategy;0 - 20,000;6;0;6;0;0;0
924800;TITANIC Shipwreck Exploration;Action, Adventure, Indie;0 - 20,000;42;16;26;151;151;0
924810;Idle Kingdom Builder;Adventure, Casual, Indie, RPG, Simulation, Sports;20,000 - 50,000;36;54;-18;8;8;2
924870;WARP-TEK;Action, Indie, Early Access;0 - 20,000;6;1;5;0;0;0
924900;One Gun: Cat;Casual, Indie;0 - 20,000;73;22;51;0;0;0
924900;One Gun: Cat;Action, Casual, Indie;0 - 20,000;73;22;51;0;0;0
924940;Guard of Wonderland;Action, Indie;0 - 20,000;49;6;43;0;0;0
924960;Conjure Strike;Action, Adventure;0 - 20,000;1;2;-1;0;0;0
924970;Back 4 Blood;Indie;1,000,000 - 2,000,000;29294;15361;13933;3047;788;6278
924980;Trials of Mana;Action, Indie;200,000 - 500,000;4372;350;4022;822;844;52
925010;Ghostship Chronicles;Action, Casual, Indie, Massively Multiplayer;0 - 20,000;21;11;10;0;0;0
925040;Ero Date;Adventure, Casual, Indie;0 - 20,000;23;13;10;0;0;0
925050;Crystal Path;Action, Casual, Indie;0 - 20,000;4;0;4;0;0;1
925060;Fiber Twig 2;Casual, Indie, Early Access;0 - 20,000;11;0;11;0;0;0
925070;Dark Asylum: Mystery Adventure;Casual, Indie;0 - 20,000;2;2;0;0;0;0
925090;Sharknado VR: Eye of the Storm;Indie;0 - 20,000;4;5;-1;0;0;0
925120;天牢 - Tianlao Sokoban -;Casual, Indie, Simulation;0 - 20,000;2;0;2;0;0;0
925160;Sky Residences at Ice District;Action, Adventure, Indie;0 - 20,000;7;0;7;0;0;0
925170;DinoTrek;Action, Adventure, Indie;0 - 20,000;20;4;16;0;0;0
925280;Lot'zAmonsters;Casual, Indie;0 - 20,000;1;0;1;0;0;0
925330;Chronophobia;Design & Illustration;0 - 20,000;1;0;1;0;0;0
925340;A Winter's Daydream;Casual, Indie;0 - 20,000;35;0;35;0;0;0
925360;Ape Hit;Casual;0 - 20,000;5;1;4;0;0;0
925370;Wizard Slime;Action, Adventure, Casual, Indie;0 - 20,000;26;1;25;0;0;0
925440;神社的百合香 ~ Floral Aroma in the Shrine;Adventure, Indie, RPG;20,000 - 50,000;575;27;548;0;0;1
925460;Vectronom;Casual;20,000 - 50,000;242;7;235;146;146;0
925470;Endless Jade Sea -Midori no Umi-;Adventure, Indie;20,000 - 50,000;292;59;233;292;582;1
925490;Test your knowledge: Dogs;Action, Casual, Indie;0 - 20,000;23;5;18;0;0;0
925520;Welcome to Bummertown;Adventure, Indie, Strategy, Early Access;0 - 20,000;71;16;55;0;0;0
925540;Lifespan 5seconds;Adventure, Casual, Indie;0 - 20,000;0;1;-1;0;0;0
925550;Cross Racing Championship Extreme;Adventure;0 - 20,000;55;6;49;0;0;2
925560;Bot Gaiden;Adventure, Free to Play, Indie, RPG, Simulation, Strategy;0 - 20,000;10;0;10;0;0;0
925570;The Uncertain: Light At The End;Adventure, Indie;50,000 - 100,000;561;305;256;0;0;4
925600;Afterlifes;Action, Casual, Indie;0 - 20,000;1;2;-1;0;0;0
925610;Legend of Assassin: Siberia;Adventure, Indie, RPG, Simulation, Strategy;0 - 20,000;16;14;2;0;0;0
925640;В поисках Атлантиды;Adventure, Indie;0 - 20,000;3;0;3;0;0;0
925670;Dungeon Kitty;Action;0 - 20,000;11;41;-30;0;0;0
925690;Witch The Bloodlines;Animation & Modeling, Education, Utilities, Video Production, Early Access;0 - 20,000;17;40;-23;0;0;0
925700;Evening Star;Adventure, Casual, Indie, RPG;0 - 20,000;3;3;0;0;0;0
925810;ICan;Casual, Indie;0 - 20,000;2;4;-2;0;0;0
925830;VR Anatomy;Action, Indie, Simulation, Sports, Early Access;0 - 20,000;9;1;8;0;0;0
925880;Seraphims of Astraeus;Action, Adventure, Casual, Free to Play, Indie;0 - 20,000;5;4;1;0;0;0
925900;Monica e a Guarda dos Coelhos;Adventure, Casual, Simulation, Strategy;0 - 20,000;45;5;40;0;0;7
925910;MMMmmm... Cake!;Indie;0 - 20,000;31;14;17;0;0;0
925930;Myst III: Exile;Adventure, Indie, RPG;100,000 - 200,000;298;19;279;359;359;8
925940;Myst IV: Revelation;Adventure, Indie;50,000 - 100,000;134;48;86;4;4;8
925950;Here Comes Niko!;Action, Casual, Indie;50,000 - 100,000;744;67;677;0;0;6
926010;Operation Lone Wolf;Education, Video Production;0 - 20,000;29;20;9;0;0;0
926070;Fear for Sale: City of the Past Collector's Edition;Indie, Simulation;0 - 20,000;5;0;5;0;0;0
926090;Reflections of Life: Tree of Dreams Collector's Edition;Casual, Indie, Simulation;0 - 20,000;6;2;4;0;0;0
926100;Mystery of the Ancients: Curse of the Black Water Collector's Edition;Indie, Simulation;0 - 20,000;8;0;8;0;0;1
926110;Death and Betrayal in Romania: A Dana Knightstone Novel Collector's Edition;Action, Adventure, Casual, Indie, Simulation, Early Access;0 - 20,000;7;0;7;0;0;0
926120;Mystery Trackers: Black Isle Collector's Edition;Adventure, Indie;0 - 20,000;9;1;8;0;0;0
926130;Living Legends: Wrath of the Beast Collector's Edition;Action, Adventure, Indie, Simulation, Strategy;0 - 20,000;6;2;4;0;0;0
926140;CHANGE: A Homeless Survival Experience;Action, Adventure, Casual, Indie;100,000 - 200,000;1809;163;1646;472;554;26
926170;Achromatic;Casual, Indie;20,000 - 50,000;45;13;32;490;490;1
926180;Bubsy: Paws on Fire!;Action, Adventure, Free to Play, RPG, Strategy, Early Access;0 - 20,000;45;22;23;0;0;0
926210;Incoming Evil;Adventure;0 - 20,000;44;9;35;0;0;0
926240;PsyBurst;Casual, Indie;0 - 20,000;1;1;0;0;0;0
926250;Mirror Angel's Paradise;Casual, Indie, Sports;0 - 20,000;9;0;9;0;0;0
926310;咕啾！文鸟恋爱物语 Love Story of Sparrow;Action, Adventure, Casual, Indie, RPG;0 - 20,000;259;28;231;0;0;2
926340;Roman's Christmas / 罗曼圣诞探案集;Action, Adventure, Indie;50,000 - 100,000;1323;42;1281;0;0;1
926350;ALIEN FIELD;Action, Adventure, Casual, Indie, Early Access;0 - 20,000;7;0;7;0;0;0
926370;Home Security;Action, Casual, Indie;0 - 20,000;32;26;6;0;0;0
926390;Infected Shelter;Casual, Indie;20,000 - 50,000;267;40;227;27;33;0
926400;Scatteria - Post-apocalyptic shooter;Simulation, Strategy;0 - 20,000;15;5;10;0;0;0
926410;Rabbit of Destiny;Casual, Indie, RPG, Simulation;0 - 20,000;13;11;2;0;0;0
926420;Model Railway Easily Christmas;Indie;50,000 - 100,000;26;12;14;0;0;2
926440;The Bloobles and the Quest for Chocolate;Adventure, Casual, Indie;0 - 20,000;0;1;-1;0;0;0
926450;Thibalryn;Casual, Indie, Simulation;20,000 - 50,000;17;5;12;0;0;0
926470;Kolkhoz: The Red Wedge;Indie, Strategy;0 - 20,000;11;8;3;0;0;0
926480;The Secret of Puffin Cove;Action, Indie;0 - 20,000;1;3;-2;0;0;0
926490;The Legend Of Vraz;Action, Adventure, Indie;0 - 20,000;6;0;6;0;0;0
926520;Love Letter;Action, Early Access;50,000 - 100,000;376;67;309;77;80;9
926540;Prime & Load : 1776;Adventure, Casual, Indie, Simulation;20,000 - 50,000;267;81;186;0;0;2
926580;Broken Lines;Adventure, Casual, Indie;20,000 - 50,000;484;123;361;0;0;2
926580;Broken Lines;Action, Adventure, Indie, Massively Multiplayer;20,000 - 50,000;484;123;361;0;0;2
926610;Superior Wizards;Casual, Free to Play, Indie;20,000 - 50,000;5;0;5;0;0;0
926720;Kyiv: from dusk till dawn with Lenovo Explorer;Casual, Indie;50,000 - 100,000;9;3;6;0;0;0
926730;Munchkin: Quacked Quest;Action, Indie;0 - 20,000;19;33;-14;0;0;0
926810;Dark Places;Action;20,000 - 50,000;68;53;15;0;0;1
926820;Eternal Space Battles;Design & Illustration, Utilities;0 - 20,000;17;2;15;0;0;0
926860;Bloody Rally Show;Casual, Indie, Simulation, Strategy;0 - 20,000;216;20;196;0;0;0
926870;Twin Synth;Casual, Indie, Strategy;0 - 20,000;1;0;1;0;0;0
926990;WolfQuest: Anniversary Edition;Indie, Simulation, Strategy;200,000 - 500,000;5259;148;5111;185;185;342
927050;Burning Instinct;Action, Adventure, Casual, Indie, Early Access;0 - 20,000;5;1;4;0;0;0
927080;Space Fox Kimi;Casual, Indie;20,000 - 50,000;7;0;7;0;0;0
927120;Quantum Covenant;Action, Adventure, Indie;0 - 20,000;2;0;2;0;0;0
927150;OrdinaryFamily;Action, Adventure, Casual, Indie, Simulation, Early Access;0 - 20,000;13;0;13;0;0;0
927190;Doll of Resurrection;Action, Casual, Indie;0 - 20,000;28;13;15;0;0;0
927250;Bladed fury;Action, Indie, Racing, Sports;100,000 - 200,000;2655;418;2237;148;200;2
927270;Accounting+;Indie, RPG, Strategy, Early Access;100,000 - 200,000;665;196;469;55;57;0
927310;巴伦西亚传说：索菲亚的重生 Valencia Saga:Sophia's rebirth;Adventure, Casual, Indie, RPG;20,000 - 50,000;196;47;149;0;0;12
927340;Viktor Crysworth;Casual;0 - 20,000;36;2;34;0;0;0
927350;Hood: Outlaws & Legends;Adventure, Casual, Free to Play, Indie, RPG, Simulation, Strategy;200,000 - 500,000;3707;3879;-172;611;523;19
927370;DoC God Mode Edition;Adventure, Casual, Indie, RPG, Simulation, Sports;20,000 - 50,000;3;0;3;0;0;1
927380;Yakuza Kiwami 2;Adventure, Casual, Free to Play, Indie, RPG, Strategy;200,000 - 500,000;11201;543;10658;2852;2907;419
927580;Smoker The Car Game;Casual, Indie, Simulation;0 - 20,000;3;2;1;0;0;0
927670;Extreme Painting Puzzles;Adventure;0 - 20,000;0;1;-1;0;0;0
927730;3D Earth Time Lapse PC Live Wallpaper;Adventure, Indie;50,000 - 100,000;105;63;42;0;0;20
927840;Clinically Dead;Indie;0 - 20,000;57;12;45;0;0;0
927850;Corrupt;Utilities;0 - 20,000;32;2;30;0;0;0
927860;Project Skylab 2;Adventure, Casual, Indie, Simulation, Strategy;50,000 - 100,000;44;22;22;0;0;0
927890;Hentai Girl Linda;Action, Casual, Free to Play, Indie, Early Access;50,000 - 100,000;1476;90;1386;78;32;4
927930;CRAKEN;Casual, Indie, RPG, Simulation;0 - 20,000;52;18;34;0;0;0
927930;CRAKEN;Adventure, Casual;0 - 20,000;52;18;34;0;0;0
927970;ForzeBreak;Adventure;0 - 20,000;7;2;5;0;0;0
927990;A Game About;Casual, Indie;100,000 - 200,000;724;81;643;0;0;0
928060;Hentai Lady;Casual, Indie;0 - 20,000;11;4;7;0;0;0
928070;MÅRD;Education, Software Training;0 - 20,000;4;14;-10;0;0;0
928130;Master of Rogues - The Seven Artifacts;Action, Indie, Massively Multiplayer, Strategy, Early Access;0 - 20,000;3;3;0;0;0;0
928140;Puzzles for smart: Dogs;Action, Indie;0 - 20,000;8;5;3;0;0;0
928160;Prototype TD;Education, Early Access;0 - 20,000;4;1;3;0;0;0
928170;Blazing Core;Action, Casual, Indie, Sports, Early Access;0 - 20,000;24;15;9;0;0;0
928180;Shop Manager : Video Game Tycoon;Adventure, Casual, Indie, RPG, Simulation;0 - 20,000;51;15;36;0;0;0
928210;Snake VR;Strategy;0 - 20,000;2;2;0;0;0;0
928230;DEFENDER 3D;Simulation;0 - 20,000;8;2;6;0;0;0
928300;Visionarium;Strategy;0 - 20,000;57;9;48;0;0;0
928350;Steven the Sperm;Strategy;0 - 20,000;8;1;7;0;0;0
928410;Zombies In The Dark;Strategy;20,000 - 50,000;7;7;0;0;0;0
928440;Azure Reflections;Action, Indie, Simulation;0 - 20,000;133;16;117;0;0;0
928460;The Love Boat - Second Chances;Action, Adventure, Casual, Indie, RPG;20,000 - 50,000;8;16;-8;0;0;0
928480;Darkness and Flame: The Dark Side Collector's Edition;Action, Casual, Indie;20,000 - 50,000;43;2;41;0;0;2
928520;Story of Eve - A Hero's Study;Adventure, Free to Play, Simulation, Strategy;0 - 20,000;66;10;56;94;94;2
928600;F1 2019;Action;500,000 - 1,000,000;19965;2263;17702;5049;2667;127
928610;aMAZE ABC;Utilities;0 - 20,000;41;51;-10;0;0;0
928610;aMAZE ABC;Indie;0 - 20,000;41;51;-10;0;0;0
928660;Count Logica;Action, Indie, Early Access;0 - 20,000;20;4;16;0;0;0
928670;Kids of Hellas: Back to Olympus;RPG;0 - 20,000;43;6;37;0;0;0
928680;Chicken in the Darkness;Action, Adventure, Casual, Indie;0 - 20,000;39;0;39;0;0;0
928690;覇県を握れ ～47都道府県大戦～;Casual, Indie, Sports, Early Access;0 - 20,000;9;0;9;0;0;2
928830;Choice of Broadsides: HMS Foraker;Adventure;0 - 20,000;5;3;2;0;0;0
928840;Cybarian: The Time Travelling Warrior;Indie;0 - 20,000;93;29;64;0;0;0
928880;FlyWings 2018 Flight Simulator;Indie, Audio Production, Utilities;0 - 20,000;9;31;-22;0;0;0
928940;Pirate Island Rescue;Adventure, Casual, Indie;0 - 20,000;3;1;2;0;0;1
928950;LOEK;Action, Adventure;50,000 - 100,000;902;67;835;0;0;0
928960;Godfall Ultimate Edition;Action, Casual, Indie, Strategy;100,000 - 200,000;1023;605;418;511;446;39
928970;Lost Frontier;Adventure, Casual, Free to Play, Sports;0 - 20,000;32;0;32;0;0;0
928990;Undungeon;Casual, Strategy;0 - 20,000;223;80;143;419;419;3
929000;Aesthetic World;Indie, Early Access;0 - 20,000;37;4;33;0;0;0
929010;Swag and Sorcery;Adventure, Casual, Indie;200,000 - 500,000;1533;1315;218;621;877;23
929020;Nuclear Powered Toaster;Action, Indie;0 - 20,000;2;0;2;0;0;0
929030;The Twelve Trials;Casual;0 - 20,000;4;4;0;0;0;0
929080;Be hate Free: Interactive;Adventure, Casual, Indie, Strategy;0 - 20,000;2;1;1;0;0;0
929120;Hop Step Sing! Nozokanaide Naked Heart (HQ Edition);Indie, Early Access;0 - 20,000;55;7;48;0;0;0
929140;Tank Royale;Casual, Indie, Simulation;0 - 20,000;61;5;56;0;0;0
929150;Final Islands;Adventure, Casual, Indie, Simulation;0 - 20,000;1;1;0;0;0;0
929170;Innocent Forest: The Bird of Light;Adventure, Casual;0 - 20,000;24;6;18;0;0;0
929180;Innocent Forest 2: The Bed in the Sky;Action, Casual, Indie, Strategy;0 - 20,000;6;1;5;0;0;0
929200;吞食孔明传 Tunshi Kongming Legends;Adventure;50,000 - 100,000;728;271;457;323;323;61
929210;CrazyDriving;Action, Adventure, Casual, Indie, Strategy;0 - 20,000;1;2;-1;0;0;0
929230;Raptor: Cretaceous Island;Adventure, Casual, Free to Play, RPG;0 - 20,000;5;4;1;0;0;0
929270;ViewTracker;Action, Adventure, Casual, Indie, Simulation;0 - 20,000;154;51;103;0;0;9
929270;ViewTracker;Action, Casual, Indie;0 - 20,000;154;51;103;0;0;9
929280;Tiska Buska;Action, Indie, Racing;0 - 20,000;5;1;4;0;0;0
929290;Strip Breaker : Hentai Girls;Indie, Early Access;0 - 20,000;8;7;1;0;0;0
929300;Chroma : Sexy Hentai Girls;Casual, Indie;0 - 20,000;22;6;16;0;0;0
929310;Kamasutra Connect : Sexy Hentai Girls;Utilities, Video Production, Web Publishing, Game Development;0 - 20,000;11;5;6;0;0;0
929320;RHEM II SE: The Cave;Casual, Indie;0 - 20,000;33;1;32;0;0;1
929330;Defending Camelot;Adventure, Indie;0 - 20,000;14;14;0;0;0;0
929330;Defending Camelot;Sports;0 - 20,000;14;14;0;0;0;0
929400;Mahjong Magic Journey 3;Casual;0 - 20,000;9;0;9;0;0;1
929410;Christmas Mahjong 2;Action, Adventure, Casual, Indie, Strategy;0 - 20,000;6;0;6;0;0;0
929420;Sakura Day 2 Mahjong;Animation & Modeling, Design & Illustration, Utilities;0 - 20,000;3;1;2;0;0;1
929430;Mahjong Magic Journey 2;Action, Adventure, Casual, Indie;0 - 20,000;11;8;3;22;22;0
929440;Christmas Mahjong;Animation & Modeling, Design & Illustration, Utilities;0 - 20,000;12;2;10;0;0;0
929460;Money Master;Audio Production, Utilities;0 - 20,000;9;6;3;0;0;0
929470;Mahjong Valentine's Day;Casual, Indie;0 - 20,000;3;2;1;0;0;0
929490;RAM Pressure;Action, Adventure, Casual, Indie;200,000 - 500,000;427;461;-34;0;0;19
929510;Type Fighter;Action, Adventure, Casual, Indie, RPG, Simulation;0 - 20,000;2;3;-1;0;0;0
929530;Glassteroids;Action, Adventure, Indie, Early Access;0 - 20,000;2;2;0;0;0;0
929570;A Familiar Fairytale Dyslexic Text Based Adventure;Action, Adventure, Casual, Indie, RPG, Simulation, Strategy;0 - 20,000;3;2;1;0;0;0
929600;Can You find it?;Action, Indie, Massively Multiplayer, Simulation, Early Access;0 - 20,000;29;5;24;0;0;0
929610;Dark Nebula VR;Indie;0 - 20,000;0;5;-5;0;0;0
929630;Luna Sky RDX;Casual, Indie, Simulation, Early Access;0 - 20,000;3;0;3;0;0;0
929640;Farragnarok;Action;0 - 20,000;8;0;8;0;0;0
929670;Orion Sandbox Enhanced;Casual, Free to Play;0 - 20,000;349;34;315;0;0;6
929670;Orion Sandbox Enhanced;Action, Casual;0 - 20,000;349;34;315;0;0;6
929690;Legend of Assassin: Jungle;Casual, Indie;0 - 20,000;8;14;-6;0;0;0
929740;Aeronaut;Casual, Free to Play, Indie;0 - 20,000;23;1;22;0;0;0
929800;Bikini Heaven;Action, Indie;0 - 20,000;1;4;-3;0;0;0
929850;Diamond Caves;Casual, Indie, Simulation, Early Access;0 - 20,000;41;1;40;0;0;3
929870;Defend The Keep;Indie;0 - 20,000;17;3;14;0;0;0
929910;Riftwalker;Casual, Indie;0 - 20,000;14;0;14;0;0;0
930010;Wallpaper Builder;Casual, Free to Play, Indie;0 - 20,000;11;19;-8;0;0;0
930030;Cyber Watch;Action, Adventure, Casual, Indie;0 - 20,000;2;1;1;0;0;0
930110;Sufoco;Adventure, Indie, Early Access;20,000 - 50,000;5;6;-1;0;0;0
930230;King under the Mountain;Action, Casual, Indie, Massively Multiplayer, Early Access;20,000 - 50,000;90;38;52;0;0;1
930280;Murder Mystery Machine;Indie, Simulation;0 - 20,000;49;42;7;0;0;0
930290;Duck's Inferno;Adventure, Indie, RPG;0 - 20,000;1;0;1;0;0;0
930300;Desolate Sands;Action, Indie;0 - 20,000;6;2;4;0;0;0
930310;Puzzle Plunder;Free to Play, Indie;20,000 - 50,000;120;19;101;0;0;0
930310;Puzzle Plunder;Indie;20,000 - 50,000;120;19;101;0;0;0
930320;Oops!!! I Slept With Your Mom;Action, Adventure, Strategy;0 - 20,000;26;7;19;0;0;3
930360;Engram;Casual, Indie, Simulation, Strategy;0 - 20,000;1;0;1;0;0;0
930430;Core Rescue;Indie;0 - 20,000;4;0;4;0;0;0
930460;BOLSOMITO;Adventure, Indie;20,000 - 50,000;207;39;168;0;0;0
930470;Crimson Souls;Indie, Simulation;0 - 20,000;1;0;1;0;0;0
930480;Mushroom rain;Action, Adventure, Indie, RPG, Simulation;0 - 20,000;12;7;5;0;0;1
930500;You Are Here;Action, Casual, Indie;0 - 20,000;7;1;6;0;0;0
930600;Chessboard Kingdoms;Indie;0 - 20,000;6;1;5;0;0;0
930630;The Lost Legends of Redwall: Escape the Gloomer;Adventure, Free to Play, Indie;0 - 20,000;22;0;22;0;0;0
930640;Code Brown;Strategy, Early Access;0 - 20,000;101;15;86;0;0;0
930650;Parkour Polygon;Casual, Indie;0 - 20,000;2;1;1;0;0;0
930690;Arcane Trials;Action;0 - 20,000;3;0;3;0;0;0
930710;Main Character Simulator;Adventure, Casual, Indie;0 - 20,000;0;0;0;0;0;0
930840;东方百问~TouHouAsked;Simulation;0 - 20,000;31;2;29;0;0;0
930850;Tale of the Fragmented Star: Single Fragment Version / 星の欠片の物語、ひとかけら版;Casual, Indie;0 - 20,000;13;5;8;0;0;0
930860;The Party of Demons;Casual, Indie;0 - 20,000;3;1;2;0;0;0
930910;STEINS;Adventure, Early Access;;;;0;;;
930940;Torii Path;Animation & Modeling, Audio Production, Utilities, Video Production;0 - 20,000;5;2;3;0;0;0
931000;"URUZ ""Return of The Er Kishi""";Action, Casual;50,000 - 100,000;375;94;281;33;33;1
931040;BreakHack;Adventure, Casual, Indie;0 - 20,000;2;2;0;0;0;0
931070;Echo of Combats;Action, Adventure, Indie;0 - 20,000;113;36;77;0;0;2
931090;Slither Link;Indie;0 - 20,000;30;1;29;0;0;1
931120;Pixel Maze;Casual, Indie;0 - 20,000;10;4;6;0;0;0
931140;Epic Game Theory;Action, Indie;0 - 20,000;2;6;-4;0;0;1
931150;Rento Fortune VR;Indie, RPG;0 - 20,000;4;0;4;0;0;0
931200;Rebound VR;Adventure, Indie;0 - 20,000;7;0;7;0;0;0
931210;Tabletop Basketball VR;Adventure, Indie;0 - 20,000;3;1;2;0;0;0
931220;Beat;Indie, Strategy;0 - 20,000;23;14;9;0;0;0
931250;Pixel Royale;Casual, Indie;0 - 20,000;4;14;-10;0;0;0
931260;Multibombers;Action, Adventure, Massively Multiplayer, RPG;20,000 - 50,000;83;37;46;0;0;0
931270;MicroTown;Action, Massively Multiplayer;100,000 - 200,000;391;17;374;0;0;1
931280;Iron Marines;Casual, Indie;100,000 - 200,000;1135;280;855;392;392;19
931310;Airplane Mode;Casual;0 - 20,000;171;102;69;0;0;3
931320;Agent Roswell;Casual, Indie, RPG;20,000 - 50,000;39;7;32;0;0;0
931360;Land of Puzzles: Battles;Action;0 - 20,000;16;24;-8;0;0;0
931430;Land of an Endless Journey;Action, Indie, RPG;0 - 20,000;11;7;4;0;0;0
931440;Run;Adventure, Casual, Indie;0 - 20,000;1;2;-1;0;0;0
931450;Solar Purge;Action, Adventure, Indie, Early Access;0 - 20,000;22;4;18;0;0;0
931470;夏荷 | Summer Lotus;Casual, Simulation, Strategy;0 - 20,000;46;15;31;0;0;0
931480;Lab Runner: X;Photo Editing, Utilities;20,000 - 50,000;1;1;0;0;0;0
931500;Touhou Genso Wanderer -Reloaded-;Casual, Indie, RPG;50,000 - 100,000;1592;98;1494;463;487;43
931540;RevelationTrestan-尸忆岛;Action, Adventure, Indie, RPG, Early Access;0 - 20,000;11;5;6;0;0;0
931560;Seven Days;Adventure, Indie;0 - 20,000;143;3;140;0;0;2
931570;The Twiggles VR;Casual, Indie;0 - 20,000;4;2;2;0;0;0
931620;Kai Entity;Action, Indie, RPG;0 - 20,000;9;1;8;0;0;0
931630;Viki Spotter: Zoo;Adventure, Casual, Indie, RPG, Simulation, Strategy;20,000 - 50,000;38;7;31;0;0;0
931630;Viki Spotter: Zoo;Casual, Indie, Simulation, Strategy;20,000 - 50,000;38;7;31;0;0;0
931650;Braveland Heroes;Casual;100,000 - 200,000;226;197;29;0;0;12
931680;Super Hyperspace Avenger;;0 - 20,000;2;0;2;0;0;0
931690;Himno;Adventure, Indie;1,000,000 - 2,000,000;4900;459;4441;29;11;4
931700;Shooting Hurts;Action, Casual, Free to Play, Massively Multiplayer, Strategy, Early Access;20,000 - 50,000;236;22;214;0;0;0
931820;Space Pirate Amai;Adventure, Casual, Indie;0 - 20,000;1;1;0;0;0;0
931830;morphe;Indie, Strategy;0 - 20,000;11;6;5;0;0;0
931840;Bunny Count;Indie, Strategy, Early Access;0 - 20,000;1;2;-1;0;0;0
931860;Sydney Hunter and the Curse of the Mayan;Casual, Indie;0 - 20,000;65;7;58;0;0;0
931870;怪奇幻想夢物語 怪獣綺譚 朧十夜;Adventure, Indie;0 - 20,000;2;0;2;0;0;0
931880;Tekling 2;Indie;0 - 20,000;4;0;4;0;0;0
931930;The Haunted Graveyard;Casual, Indie;20,000 - 50,000;61;3;58;0;0;0
931950;Labyrinth: The War on Terror;Action, Indie, Racing, Sports, Early Access;0 - 20,000;97;24;73;0;0;6
932070;七夜怪谈 - 都市校园禁锢传说;Indie, Simulation, Early Access;0 - 20,000;8;1;7;0;0;0
932120;TAL: Arctic 3;Casual;0 - 20,000;25;7;18;0;0;0
932150;WWTF;Casual;0 - 20,000;1;1;0;0;0;0
932160;Late at night;Casual;0 - 20,000;50;63;-13;0;0;0
932190;Aliens Attack VR;Action, Adventure;20,000 - 50,000;60;13;47;0;0;0
932210;Nexoria: Dungeon Rogue Heroes;Action, Adventure, Indie;0 - 20,000;36;10;26;0;0;0
932220;IMMURE;Adventure, Casual;0 - 20,000;69;6;63;0;0;0
932240;Pushing Through...;Adventure, Casual;0 - 20,000;20;4;16;0;0;0
932250;rOt 2;Adventure, Casual;0 - 20,000;17;20;-3;0;0;0
932270;July the Lost Child;Adventure, Casual;0 - 20,000;9;0;9;0;0;0
932290;Mochi Mochi Boy;Indie;0 - 20,000;3;0;3;0;0;0
932300;Taco Truck Madness;Action;0 - 20,000;5;1;4;0;0;0
932310;Hentball;Action, Adventure, Casual, Indie, Strategy;0 - 20,000;4;4;0;0;0;0
932330;Alchemia;Action;0 - 20,000;37;11;26;27;27;0
932330;Alchemia;RPG;0 - 20,000;37;11;26;27;27;0
932350;Intelligence: Dogs;Adventure, Indie;0 - 20,000;6;2;4;0;0;0
932420;Russpuppy Kid Games;Adventure, Casual, Indie, Racing, Early Access;0 - 20,000;27;0;27;0;0;2
932450;Blade of Acrimony;Action;0 - 20,000;11;1;10;0;0;0
932480;GraviSound;Adventure, Casual, Indie, Simulation;0 - 20,000;20;8;12;0;0;0
932500;Damned Daniel;Action, Casual, Indie;20,000 - 50,000;104;3;101;0;0;0
932530;Skull's Impossible Quest;Action, Indie, RPG, Early Access;0 - 20,000;15;1;14;0;0;0
932560;Battle Of Britain;Action, Adventure, Casual, Indie, Massively Multiplayer;0 - 20,000;5;0;5;0;0;0
932570;阿比斯的宝藏 - Treasure of abyss;Action, Casual;50,000 - 100,000;113;19;94;0;0;1
932670;Professor Watts Memory Match: Expressions;Casual;0 - 20,000;12;14;-2;0;0;0
932690;RE:OZMA;Action, Adventure, Indie;0 - 20,000;5;15;-10;0;0;0
932730;Formula XD;Casual, Indie;0 - 20,000;5;3;2;0;0;0
932790;ASCENT: Crash Landing;Action, Casual, Indie;0 - 20,000;26;8;18;0;0;0
932800;Letzte Worte VR;Indie, Strategy;0 - 20,000;25;4;21;0;0;0
932820;The Great Voyage - Visual Novel;Casual, Indie;0 - 20,000;9;0;9;0;0;0
932850;Simmiland;Casual;100,000 - 200,000;780;89;691;678;1057;24
932870;The Mark of Robot;Indie, Simulation, Sports, Strategy;0 - 20,000;19;21;-2;0;0;0
932920;RIFF VR for Arcades;Action, Adventure, Indie;0 - 20,000;1;1;0;0;0;0
932940;Archery;Indie;0 - 20,000;43;41;2;0;0;0
932950;Zombiotik;Indie, Strategy, Early Access;0 - 20,000;6;0;6;0;0;0
932970;Shopping Clutter 2: Christmas Square;Massively Multiplayer, RPG, Early Access;0 - 20,000;9;5;4;0;0;0
932970;Shopping Clutter 2: Christmas Square;Indie, RPG;0 - 20,000;9;5;4;0;0;0
932980;Axis Football 2018;Casual, Indie;20,000 - 50,000;89;47;42;423;423;0
933030;Heavy Recoil;Action, Indie;0 - 20,000;5;0;5;0;0;0
933050;Lost Cosmonauts ARG;Indie;0 - 20,000;1;8;-7;0;0;0
933060;Hentai Weed PuZZles;Casual, Indie, Simulation, Strategy;20,000 - 50,000;113;32;81;0;0;1
933070;Cold Blooded Cube;Casual, Indie;200,000 - 500,000;53;31;22;243;263;2
933080;Fire Place;Action, Simulation, Strategy;0 - 20,000;45;32;13;0;0;0
933110;Age of Empires III: Definitive Edition;Action, Indie;500,000 - 1,000,000;26100;5910;20190;1082;528;3986
933140;Drunkn Bar Fight on Halloween;Casual;0 - 20,000;48;10;38;2;2;0
933160;Space Cows;Adventure;0 - 20,000;23;3;20;29;29;0
933200;Ant Empire;Adventure, Casual, Indie, Early Access;0 - 20,000;23;9;14;0;0;0
933210;Heart Chain Kitty;Indie;0 - 20,000;8;1;7;0;0;0
933230;Signed and Sealed With a Kiss;Casual, Simulation;0 - 20,000;43;17;26;0;0;1
933250;Shining Orb Prequel;Indie;0 - 20,000;10;3;7;0;0;0
933290;PixelRPG;Action, Adventure, Massively Multiplayer, RPG, Early Access;0 - 20,000;14;10;4;0;0;0
933290;PixelRPG;Indie, Strategy;0 - 20,000;14;10;4;0;0;0
933300;Wuxia Master;Action, Adventure, Indie, RPG, Strategy;100,000 - 200,000;251;225;26;0;0;2
933390;Mythical;Simulation;0 - 20,000;13;6;7;0;0;0
933390;Mythical;Casual, Indie, Racing, Simulation, Early Access;0 - 20,000;13;6;7;0;0;0
933430;Sword of Rapier;Casual, RPG, Simulation;0 - 20,000;1;1;0;0;0;0
933450;Wenjia;Adventure, Indie;20,000 - 50,000;300;71;229;191;191;0
933540;Idle Space Raider;Casual, Indie, RPG, Simulation, Strategy;50,000 - 100,000;157;54;103;0;0;38
933590;Legends of Koyannis;Animation & Modeling, Design & Illustration;0 - 20,000;1;1;0;0;0;0
933630;Dawn of China: Rise of Qin;Action, Simulation, Strategy, Early Access;0 - 20,000;9;26;-17;0;0;0
933660;In Memory;Casual, Indie, Strategy, Early Access;0 - 20,000;15;3;12;0;0;0
933700;Death Trader: Cold War;Education;0 - 20,000;30;43;-13;0;0;0
933770;Star Sky 3;Free to Play, Strategy;0 - 20,000;29;4;25;0;0;0
933820;Endzone - A World Apart;Action, Indie;200,000 - 500,000;6003;1676;4327;398;289;171
933830;Of Ships & Scoundrels;Action, Casual, Indie;0 - 20,000;13;6;7;0;0;0
933840;World Enduro Rally;Adventure, Indie, RPG, Strategy, Early Access;0 - 20,000;3;2;1;0;0;0
933860;Discolored;Animation & Modeling, Audio Production, Utilities, Video Production;20,000 - 50,000;349;83;266;0;0;1
933900;The Amazonian Dread;Audio Production, Utilities, Video Production;0 - 20,000;0;8;-8;0;0;0
933920;GIRLS VR UNCENSORED!!!;Action, Adventure, Casual, Indie;0 - 20,000;3;2;1;0;0;0
933930;Tiny Love;Indie, Simulation;0 - 20,000;14;6;8;0;0;0
933940;假如我是人工智能 Big Brother Is Shaping You;Adventure, RPG;20,000 - 50,000;695;116;579;75;75;1
933970;Brainfuck;Action, Indie;0 - 20,000;8;13;-5;0;0;0
934060;Wish Giver 偿愿人;Action, Casual, Indie;50,000 - 100,000;173;49;124;0;0;0
934070;MochiMochi;Adventure, Indie, RPG;0 - 20,000;41;1;40;0;0;0
934120;Monkeys & Dragons;Strategy;0 - 20,000;20;11;9;0;0;0
934120;Monkeys & Dragons;Casual, Indie, Strategy;0 - 20,000;20;11;9;0;0;0
934180;Trials of Wilderness;Casual, Indie;0 - 20,000;39;17;22;0;0;0
934220;Buy Low Sell High;Action, Indie;0 - 20,000;7;6;1;0;0;0
934250;Tactics Rogue;Adventure, Casual, Free to Play, Indie, Simulation;0 - 20,000;1;1;0;0;0;0
934260;GroundFall;Casual, Indie, Simulation, Early Access;0 - 20,000;11;7;4;0;0;3
934410;ReThink 2;RPG, Strategy;0 - 20,000;34;0;34;0;0;0
934470;A Top-Down Job: Blood Gain;Adventure, Casual, Free to Play, Indie, RPG, Simulation, Strategy;0 - 20,000;1;3;-2;0;0;0
934480;Falling Plus;Adventure, Casual, Indie, Simulation, Strategy;0 - 20,000;3;0;3;0;0;0
934500;StoneDefence;Adventure, Casual, Indie, Strategy;0 - 20,000;5;6;-1;0;0;0
934510;Cubanoids;Casual, Indie, Strategy;0 - 20,000;0;1;-1;0;0;0
934520;RAYGUN COMMANDO VR 2;Action, Adventure, Indie;0 - 20,000;5;5;0;0;0;0
934540;Pleasure Puzzle:Sexy Girls 趣拼拼：性感少女;Action, Indie;0 - 20,000;172;35;137;0;0;1
934550;Duck Hunting Challenge;RPG, Simulation;0 - 20,000;1;0;1;0;0;0
934580;Hell Wedding 夜嫁;Casual, Indie;100,000 - 200,000;991;136;855;98;154;2
934590;Lamp Man Down;Action, Casual, Indie;0 - 20,000;0;2;-2;0;0;0
934600;Mech Rage;Indie, Simulation, Sports, Strategy;0 - 20,000;13;6;7;0;0;0
934630;Rocky Planet;Action, Casual, Indie;0 - 20,000;28;6;22;0;0;0
934670;Avernus;Action, Casual, Indie, Simulation, Sports;0 - 20,000;5;2;3;0;0;1
934710;英语杀;Adventure;0 - 20,000;6;14;-8;0;0;0
934780;American Fugitive;Adventure, Casual;200,000 - 500,000;1701;603;1098;354;451;9
934800;Little World Of Creatures;Action, Casual, Indie, Early Access;0 - 20,000;2;0;2;0;0;0
934810;酒店;Action, Adventure, Indie;0 - 20,000;32;8;24;0;0;0
934830;Circuit Slinger;Action, Adventure, Casual, Simulation;20,000 - 50,000;15;11;4;0;0;0
934840;FrostRunner;Action, Casual, Free to Play, Indie;500,000 - 1,000,000;3042;149;2893;0;0;4
934850;Cyberdrome;Action, Casual, Indie;50,000 - 100,000;196;25;171;0;0;0
934860;La Rana;Indie;50,000 - 100,000;390;19;371;0;0;0
934920;SparkChess;Action, Casual, Indie;0 - 20,000;2;2;0;0;0;0
934930;RDS - The Official Drift Videogame;RPG;50,000 - 100,000;867;221;646;14;14;3
934950;ARTé: Mecenas;Free to Play, Indie;0 - 20,000;10;6;4;0;0;0
934990;Cute Girls VR;Adventure, Casual, Free to Play, Indie, RPG;0 - 20,000;10;7;3;0;0;0
935070;Sakura MMO;Casual, Indie;20,000 - 50,000;241;40;201;126;160;5
935110;The Desert's Rose;Action, Adventure, Casual, Indie, RPG;20,000 - 50,000;5;6;-1;0;0;0
935180;Puzzle Monarch: Mummy;Casual, Indie;0 - 20,000;11;21;-10;0;0;0
935240;Puzzle Monarch: Forests;Simulation;0 - 20,000;4;15;-11;0;0;0
935250;Necrolance;Adventure, Indie, RPG;0 - 20,000;11;3;8;0;0;0
935270;Great Hero's Beard;Action;200,000 - 500,000;992;149;843;1015;1287;6
935320;Get To A Gun;;0 - 20,000;2;1;1;0;0;0
935340;Green Dragon/グリーンドラゴン;Adventure, Casual, Indie;0 - 20,000;1;2;-1;0;0;0
935350;Cat Fu Mi;Casual, Free to Play, Indie;0 - 20,000;7;1;6;0;0;0
935400;Alchemy Garden;Action, Casual, Indie, Simulation, Sports, Early Access;0 - 20,000;391;117;274;0;0;8
935440;Viki Spotter: Professions;Casual, Indie;20,000 - 50,000;37;6;31;0;0;0
935450;Forest Plague;Action;0 - 20,000;1;6;-5;0;0;0
935460;Girl Rugby Dash;Casual, Indie, RPG;0 - 20,000;1;10;-9;0;0;0
935490;AREAZ;Action, Casual, Indie, Strategy;0 - 20,000;40;21;19;0;0;0
935540;M-Plan;Action;0 - 20,000;1;0;1;0;0;0
935560;Hentai Strip Shot;Action, Adventure, Indie, Strategy, Early Access;0 - 20,000;26;0;26;0;0;0
935570;Ary and the Secret of Seasons;Adventure, Free to Play, Indie, RPG;0 - 20,000;104;63;41;0;0;0
935580;True Fear: Forsaken Souls Part 2;Adventure, Casual, Indie;20,000 - 50,000;450;34;416;308;308;11
935610;Eugenics;Action, Casual, Indie;0 - 20,000;3;10;-7;0;0;0
935640;Pixelarium;Action, Casual, Indie, Racing, Simulation, Sports;0 - 20,000;29;2;27;0;0;0
935680;Air Attack 3.0, Aerial Firefighting Game;Casual, Strategy;0 - 20,000;0;5;-5;0;0;0
935700;Love Hentai: Sexy Body;Casual, Indie, Simulation, Strategy;0 - 20,000;10;6;4;0;0;0
935720;Cinderella VR;Casual;0 - 20,000;3;2;1;0;0;0
935750;Antiquitas;Indie;0 - 20,000;11;3;8;0;0;0
935790;Angry Troll Simulator;Adventure, Free to Play, Indie;0 - 20,000;17;3;14;0;0;0
935860;The young mathematician: Easy difficulty;Casual, Indie, Simulation, Strategy, Early Access;0 - 20,000;26;6;20;0;0;0
935880;Glass Masquerade 2: Illusions;Indie, RPG;100,000 - 200,000;2352;188;2164;141;160;21
935910;Brrrainz: Feed your Hunger;Adventure, Indie, RPG;0 - 20,000;11;5;6;0;0;0
935920;Fallstreak;Action, Casual, Indie;20,000 - 50,000;136;30;106;0;0;1
935930;Reignfall;Action, Indie;50,000 - 100,000;344;37;307;3;3;2
935940;Croquet Pro 2;Simulation;0 - 20,000;2;3;-1;0;0;0
935950;Croquet Pro;Action, Adventure, Casual, Indie, RPG, Simulation, Strategy, Early Access;0 - 20,000;2;1;1;0;0;0
935960;Zuma Legend VR;Action, Indie;0 - 20,000;1;9;-8;0;0;0
935970;游离大陆 Uniland;Action;0 - 20,000;59;5;54;0;0;1
935980;AETERNITAS;Casual, Indie;0 - 20,000;13;14;-1;0;0;1
936000;A Mars Adventure: Redturtle;Animation & Modeling, Game Development;0 - 20,000;3;1;2;0;0;0
936010;Feed the Pets Origins;Action, Indie, RPG, Early Access;0 - 20,000;15;7;8;0;0;0
936020;Find Differences;Casual, Indie, Strategy;0 - 20,000;11;4;7;0;0;0
936030;Nature Relax;Casual, Simulation;0 - 20,000;25;5;20;0;0;0
936040;Master of Mutations;Casual, Indie, Simulation;20,000 - 50,000;12;8;4;0;0;0
936070;Apartment 327;Action, Adventure, Casual, Indie, Racing, RPG, Simulation, Sports, Strategy;0 - 20,000;13;4;9;0;0;0
936080;Globe Geography 3D;Action, Casual, Indie;0 - 20,000;1;1;0;0;0;0
936090;Geek Timer;Action, Casual, Indie;0 - 20,000;3;1;2;0;0;0
936100;Master of Typing;Adventure, Indie;0 - 20,000;6;9;-3;0;0;0
936140;Pro Cycling Manager 2019;Adventure, Indie, RPG;100,000 - 200,000;551;129;422;11541;11541;80
936150;怪奇幻想夢物語 怪獣綺譚 桜蛇伝;Action, Casual, Indie;0 - 20,000;1;0;1;0;0;0
936160;Atelier Rorona ~The Alchemist of Arland~ DX;Racing, Simulation, Sports;20,000 - 50,000;450;35;415;698;698;11
936170;DoodleVR;Action, Casual;0 - 20,000;8;0;8;0;0;0
936180;Atelier Totori ~The Adventurer of Arland~ DX;Casual, Indie;0 - 20,000;201;49;152;10539;10539;12
936180;Atelier Totori ~The Adventurer of Arland~ DX;Adventure, Casual, Indie;0 - 20,000;201;49;152;10539;10539;12
936190;Atelier Meruru ~The Apprentice of Arland~ DX;Casual, Free to Play, Indie, RPG;0 - 20,000;209;12;197;439;439;8
936270;Cave Racer;Action, Indie, Early Access;0 - 20,000;2;0;2;0;0;0
936470;Singularity Shooter;Casual, Indie;0 - 20,000;1;0;1;0;0;0
936490;Counter Terrorist Agency;Casual, Indie, Early Access;20,000 - 50,000;217;229;-12;345;523;2
936500;Transport INC;Action;100,000 - 200,000;559;196;363;93;125;16
936510;2nd Circle - Powerful Magic;Action, Casual, Indie;0 - 20,000;2;0;2;0;0;0
936530;Close Combat: Last Stand Arnhem;Simulation, Strategy;0 - 20,000;83;17;66;0;0;14
936560;Cubeverse;Casual, Indie, Strategy;0 - 20,000;2;0;2;0;0;0
936580;Avoidon;Action, Adventure, Casual, Indie, Strategy;0 - 20,000;1;0;1;0;0;0
936600;Shoot'n'Scroll 3D;Adventure, Free to Play, Indie;0 - 20,000;3;0;3;0;0;0
936610;Of Gods and Men: The Daybreak Empire;Casual, Indie, Racing, Early Access;0 - 20,000;35;9;26;0;0;0
936620;Petrolhead;Adventure, Casual, Indie, Simulation;0 - 20,000;20;18;2;0;0;0
936630;Garden Variety Body Horror - Rare Import;Action, Adventure, Indie, RPG;0 - 20,000;10;0;10;0;0;0
936650;Space Pilgrim Academy: Year 3;Action, Casual, Indie, Racing, Simulation, Strategy;0 - 20,000;39;2;37;0;0;0
936700;Ms. Squeaker's Home for the Sick;Action, Indie, Racing, Early Access;0 - 20,000;26;0;26;0;0;1
936700;Ms. Squeaker's Home for the Sick;Casual, Indie;0 - 20,000;26;0;26;0;0;1
936720;Wrench;Adventure, Indie;50,000 - 100,000;908;86;822;252;237;19
936740;Orogenesis;Indie;0 - 20,000;34;8;26;0;0;0
936770;Dead by Wheel: Battle Royal;Indie, Early Access;0 - 20,000;2;0;2;0;0;0
936780;Warplanes: WW2 Dogfight;Adventure, Indie, RPG;200,000 - 500,000;1099;198;901;0;0;29
936790;Life is Strange: True Colors;Action, Free to Play, Indie, Simulation, Early Access;200,000 - 500,000;10217;1097;9120;479;513;87
936800;Professor Watts Memory Match: Cats;Casual, Free to Play, Simulation, Early Access;0 - 20,000;18;18;0;0;0;0
936810;Professor Watts Memory Match: Puppies;Action, Adventure, Casual, Indie, Strategy;0 - 20,000;6;12;-6;0;0;0
936820;J-Girl;Casual, Free to Play, Indie;0 - 20,000;36;7;29;0;0;0
936890;Source :beginning;Adventure;0 - 20,000;2;1;1;0;0;0
936930;Oil Baron;Casual, Free to Play;0 - 20,000;16;27;-11;0;0;0
936950;BR Logic Pack;Action, Adventure, Indie, RPG, Early Access;0 - 20,000;10;6;4;0;0;0
936960;General Practitioner;Action, Indie;0 - 20,000;0;0;0;0;0;5
936980;Naval Battles Simulator;Adventure, Casual, Indie;0 - 20,000;36;28;8;0;0;0
937020;Super gamebear with its three girlfriends超级神经熊:你想知道关于超级喜欢游戏的一头黑色矮小的游戏熊是如何与它的“三个后宫团女朋友”购买到GBC游戏机的吗？;Adventure, Indie, RPG;0 - 20,000;44;4;40;0;0;0
937040;Bezirk;Adventure, Casual, Indie;0 - 20,000;0;1;-1;0;0;0
937050;JackQuest: The Tale of The Sword;Action, Adventure, Indie, Massively Multiplayer, RPG, Simulation, Early Access;0 - 20,000;21;8;13;0;0;0
937070;A Killer's Sorrow;Indie, Strategy;0 - 20,000;2;2;0;0;0;0
937090;Stacksquatch;Indie, Simulation;0 - 20,000;3;0;3;0;0;0
937120;Slingshot Explorer: The Twelve Towers;Indie;0 - 20,000;15;10;5;0;0;0
937130;Color Guardian;Simulation, Strategy;0 - 20,000;1;3;-2;0;0;0
937140;Pixel Girl 像素女孩;Action, Casual, Indie;0 - 20,000;22;5;17;0;0;0
937160;BRING IT DOWN!;Indie;0 - 20,000;2;5;-3;0;0;0
937170;Otaku's Adventure;Action, Indie;200,000 - 500,000;6140;350;5790;350;377;23
937180;Impixable;RPG;0 - 20,000;1;0;1;0;0;0
937210;МЫЛО УРОНИЛ;Indie;0 - 20,000;181;49;132;0;0;0
937300;The Long Return;Adventure, Indie, Simulation;0 - 20,000;97;14;83;0;0;0
937310;Infinitode 2 - Infinite Tower Defense;Action, Adventure, Indie;200,000 - 500,000;2185;167;2018;482;609;280
937320;Jay Walker;Adventure, Casual, Indie;0 - 20,000;4;5;-1;0;0;0
937350;Food Drive: Race against Hunger;Action, Indie;50,000 - 100,000;96;7;89;0;0;0
937360;Pantheon;Casual, Indie;20,000 - 50,000;1;1;0;0;0;0
937390;Ah, Love!;Action, Adventure, Free to Play, Indie, Strategy;0 - 20,000;10;3;7;0;0;0
937460;Survival Hell;Free to Play, Massively Multiplayer, Strategy;0 - 20,000;3;3;0;0;0;0
937490;Neighbor;Action, Casual, Indie;0 - 20,000;31;1;30;0;0;0
937520;Critter Kart;Action, Casual, Indie, Early Access;0 - 20,000;8;0;8;0;0;0
937530;Dungeon Crowley;Action, Adventure, Casual, Racing;0 - 20,000;59;21;38;0;0;0
937550;fhaMAZEin;Casual, Indie;0 - 20,000;0;0;0;0;0;0
937570;Danmaku Amanojaku ~ Impossible Spell Card.;Casual, Indie, Simulation;0 - 20,000;138;2;136;0;0;2
937580;Touhou Kanjuden ~ Legacy of Lunatic Kingdom.;Casual, Indie, Racing;20,000 - 50,000;983;17;966;848;848;5
937620;Zack Y;Adventure, Casual, Indie;20,000 - 50,000;2;9;-7;0;0;0
937690;冒险公会 Adventurer Guild;Action, Adventure, Free to Play, Indie, Massively Multiplayer, Strategy, Early Access;0 - 20,000;18;18;0;0;0;0
937730;Lady's Hentai Mosaic;Indie;0 - 20,000;21;4;17;0;0;0
937740;Anime Babes: Solitaire;Casual, Free to Play, Indie, Strategy;0 - 20,000;3;1;2;0;0;0
937780;♞ The Tactics of War ♞;Animation & Modeling, Design & Illustration;0 - 20,000;2;9;-7;0;0;0
937780;♞ The Tactics of War ♞;Animation & Modeling, Design & Illustration;0 - 20,000;2;9;-7;0;0;0
937820;Shadow Play;Adventure, Casual, Indie, Early Access;0 - 20,000;7;2;5;0;0;0
937850;Hidden Paws Mystery;Action, Free to Play, Indie;0 - 20,000;214;10;204;0;0;2
937860;Bigger Guns;Action, Free to Play, Indie;0 - 20,000;5;4;1;0;0;0
937870;Mist Hunter;Action, Free to Play, Indie, Strategy, Early Access;0 - 20,000;29;10;19;0;0;0
937910;Vulcan Sacrifice;Adventure, Casual, Indie;0 - 20,000;3;2;1;0;0;0
937910;Vulcan Sacrifice;Action, Simulation, Strategy;0 - 20,000;3;2;1;0;0;0
937940;Sea Dogs: City of Abandoned Ships;Action, Indie;20,000 - 50,000;126;41;85;0;0;12
937950;Not in Heaven;Action, Free to Play, Simulation;0 - 20,000;27;29;-2;0;0;0
937960;Classified Stories: The Tome of Myrkah;Audio Production, Design & Illustration, Utilities, Video Production;0 - 20,000;40;9;31;0;0;0
937970;Running Girl;Action, Adventure, Casual, Indie, Early Access;0 - 20,000;9;16;-7;0;0;0
937980;Jellyfish Season;Animation & Modeling, Design & Illustration, Utilities, Early Access;50,000 - 100,000;57;19;38;0;0;0
938000;Land of Puzzles: Elven Princess;Action, Strategy;0 - 20,000;13;17;-4;0;0;0
938050;The Anomaly;Action, Free to Play, Indie;0 - 20,000;11;1;10;0;0;0
938070;LOGistICAL 2: Belgium;Indie, Simulation;0 - 20,000;11;0;11;0;0;0
938100;Sacred Earth - Promise;Simulation;20,000 - 50,000;4;0;4;0;0;0
938170;Colette's Sugar Madness;Free to Play, Indie, Strategy;0 - 20,000;4;0;4;0;0;0
938200;Metric Racer;Casual, Indie;0 - 20,000;6;9;-3;0;0;0
938210;Jack & the creepy Castle;Action, Indie;0 - 20,000;4;1;3;0;0;0
938220;TAPSONIC BOLD;Action, Adventure, Casual, Indie, Strategy;100,000 - 200,000;867;296;571;0;0;2
938240;Cthulhu Mythos RPG -The Sleeping Girl of the Miasma Sea-;Indie, Massively Multiplayer, RPG, Simulation, Strategy, Early Access;0 - 20,000;19;2;17;0;0;1
938250;Hentai: The Shell Game;Action, Sports;0 - 20,000;47;12;35;0;0;0
938260;To Burn in Memory (Anniversary Edition);Indie;0 - 20,000;5;0;5;0;0;0
938270;LoveKami -Healing Harem-;Action, Indie;50,000 - 100,000;150;35;115;19;36;0
938280;ROLL!;Action, Casual, Indie;0 - 20,000;7;1;6;0;0;0
938300;CuberPunk 2089;Action, Casual, Indie, Massively Multiplayer;20,000 - 50,000;157;41;116;0;0;1
938310;12 Labours of Hercules VIII: How I Met Megara;Adventure, Indie, Simulation, Strategy, Early Access;0 - 20,000;134;5;129;0;0;2
938320;Nibû;Adventure, Indie, Simulation;0 - 20,000;16;7;9;0;0;0
938340;The Necklace Of Blood Part II;Casual, Indie;0 - 20,000;1;0;1;0;0;0
938350;Divine Business: Fantasy Trading Simulator;Animation & Modeling, Design & Illustration, Utilities, Early Access;0 - 20,000;7;4;3;0;0;0
938360;The last soldier;Adventure, Indie;20,000 - 50,000;3;2;1;0;0;0
938370;War in Pocket ;Adventure, Indie, RPG, Simulation;0 - 20,000;8;14;-6;0;0;0
938380;Townsmen - A Kingdom Rebuilt;Adventure, Indie, RPG, Simulation;100,000 - 200,000;613;308;305;883;951;20
938390;My Riding Stables: Your Horse breeding;Free to Play, Indie;0 - 20,000;10;18;-8;0;0;0
938480;The Savior's Gang;Sports;0 - 20,000;33;7;26;0;0;0
938510;Poly and the Marble Maze;Adventure, Indie;0 - 20,000;6;2;4;0;0;0
938520;Twenty One;Action, Adventure, Indie;0 - 20,000;3;14;-11;0;0;0
938560;INMOST;Indie;200,000 - 500,000;3692;341;3351;309;437;7
938600;Drift Stunt Racing 2019;Action, Adventure, Casual, Indie, RPG;0 - 20,000;13;7;6;0;0;0
938630;Jewel Tree;Action, Casual, Indie, Early Access;0 - 20,000;3;0;3;0;0;1
938640;STALINGRAD ABATIS;Adventure, Indie, Simulation;20,000 - 50,000;10;19;-9;0;0;0
938660;Achtung die Kugel!;Action, Adventure, Casual, Indie, Massively Multiplayer;0 - 20,000;6;7;-1;0;0;0
938680;Pixels Guide to Staying Dead;Adventure, Casual, Indie;0 - 20,000;1;0;1;0;0;0
938710;SKYRAID;Strategy;0 - 20,000;5;0;5;0;0;0
938740;MUSEUM VOLUME I;Action, Adventure, Indie, Simulation;0 - 20,000;6;5;1;0;0;0
938760;River Relaxation VR;Action, Casual, Indie;0 - 20,000;6;5;1;0;0;0
938810;雨鸦 - You are my sanctuary;Adventure, Casual, Indie, Strategy;0 - 20,000;189;11;178;0;0;1
938820;Puzzle Monarch: Egypt;Casual;0 - 20,000;10;21;-11;0;0;0
938820;Puzzle Monarch: Egypt;Action, Adventure, Casual, Indie, RPG, Early Access;0 - 20,000;10;21;-11;0;0;0
938840;Puzzle Monarch: Nile River;Casual;0 - 20,000;8;12;-4;0;0;0
938850;Infinity;Adventure, Indie;0 - 20,000;5;0;5;0;0;0
938860;Get In The Car, Loser!;Casual, Indie, Strategy;20,000 - 50,000;282;62;220;0;0;1
938870;Chronon;Action, Indie;20,000 - 50,000;1;4;-3;0;0;0
938940;天风之光 ~ Touhou Fan of Destiny;Free to Play, Massively Multiplayer, RPG;0 - 20,000;2;34;-32;0;0;0
938960;Soul-Ivy: C0;Education;0 - 20,000;4;1;3;0;0;0
938980;Lantern Bearer;Casual, Simulation;0 - 20,000;21;3;18;0;0;0
939000;Crisis VRigade;Adventure;20,000 - 50,000;203;56;147;17;17;0
939100;Darksburg;Action, Free to Play, Indie;100,000 - 200,000;1542;787;755;237;218;8
939120;Grand Guilds;Indie, Strategy;0 - 20,000;51;41;10;0;0;0
939120;Grand Guilds;Action;0 - 20,000;51;41;10;0;0;0
939150;CUBE 332;Action, Indie;0 - 20,000;3;6;-3;0;0;0
939200;Gold Magic 800;Action, Indie;0 - 20,000;2;2;0;0;0;0
939210;T3 - Take the Turn;Action, Casual;0 - 20,000;0;0;0;0;0;0
939230;BARDO;Casual, Racing, Simulation, Sports;0 - 20,000;14;4;10;0;0;0
939240;Super Commander XL;Adventure, Early Access;0 - 20,000;3;4;-1;0;0;0
939250;Dungeons and Dinners;Casual, Indie;0 - 20,000;4;0;4;0;0;0
939330;Tailor Tales;Action, Indie, Early Access;50,000 - 100,000;599;31;568;1;1;29
939350;Rugby Champions;Casual, Indie, Strategy;0 - 20,000;54;19;35;0;0;1
939360;Pixel FX Designer;Adventure;0 - 20,000;102;25;77;6;6;2
939390;The Life of One Dog;Casual, Free to Play, Indie, Simulation;0 - 20,000;48;63;-15;0;0;0
939400;LoveChoice;Adventure, Casual, Free to Play, Indie, RPG, Simulation;500,000 - 1,000,000;17024;804;16220;113;80;587
939410;Bloody Mary: Forgotten Curse;Casual, Indie;0 - 20,000;4;3;1;0;0;0
939450;Forklift Simulator 2019;Action, Casual, Indie;0 - 20,000;47;27;20;0;0;0
939470;TRIP;Indie;0 - 20,000;1;0;1;0;0;0
939510;Pandemic Express - Zombie Escape;Action, Casual, Indie;100,000 - 200,000;2610;1798;812;159;51;5
939520;HELLGATE: London;Casual, Indie;100,000 - 200,000;1118;839;279;180;180;30
939540;Space Ashes;Action, Indie, Sports;0 - 20,000;3;0;3;0;0;0
939560;Monster Trampoline;Casual, Indie, Simulation, Strategy;0 - 20,000;4;0;4;0;0;0
939580;Ladies;Action, Adventure, Indie, Strategy;0 - 20,000;0;5;-5;0;0;0
939600;LOVE³ -Love Cube-;Action, Casual, Indie, Early Access;100,000 - 200,000;2206;122;2084;93;88;4
939620;Pleasure Puzzle:Portrait 趣拼拼：肖像画;Casual, Indie, RPG;200,000 - 500,000;1546;146;1400;0;0;4
939740;Qian-Shan Village / 殭屍山莊;Indie, Strategy;0 - 20,000;2;3;-1;0;0;0
939750;秋叶|Autumn leaves;Casual, Indie, Strategy;0 - 20,000;12;23;-11;0;0;1
939810;Reflex Aim Trainer;Action, Casual;0 - 20,000;0;5;-5;0;0;0
939830;WHEEL TRAVEL;Casual, Indie;0 - 20,000;9;4;5;0;0;0
939850;The Dark Pictures Anthology: Man of Medan;Casual, Indie;500,000 - 1,000,000;6629;2314;4315;262;272;61
939870;BlackberryNOVA;Adventure;0 - 20,000;17;5;12;0;0;0
939920;FaceFun;Action, Casual, Indie, Racing, Sports, Strategy, Early Access;0 - 20,000;9;15;-6;0;0;0
939930;Beach Pong;Action, Adventure, Indie;50,000 - 100,000;11;6;5;0;0;0
939960;Far Cry New Dawn;Indie, Simulation, Early Access;1,000,000 - 2,000,000;18627;5638;12989;1228;1055;380
939990;Boxing School;Casual, Indie;50,000 - 100,000;338;44;294;0;0;4
940020;Survive Together;Adventure, Casual, Indie, Early Access;0 - 20,000;0;1;-1;0;0;0
940070;Robot Female Hero 1;Adventure, Casual, Indie, RPG, Simulation;0 - 20,000;1;0;1;0;0;0
940130;Red and Blue ~ Cycles of Existence;Adventure, Casual, Indie;0 - 20,000;15;13;2;0;0;0
940140;Project AETHER: First Contact;Casual, Indie;0 - 20,000;27;2;25;0;0;0
940180;Hailey;Simulation, Strategy;0 - 20,000;1;1;0;0;0;0
940190;Chuckie Egg 2017;Free to Play, RPG, Strategy, Early Access;0 - 20,000;10;4;6;0;0;0
940240;Jake and the Giant;Adventure;0 - 20,000;1;0;1;0;0;0
940290;Trip Troupe [Mixer Stream Host App];Action, Casual;0 - 20,000;7;6;1;0;0;0
940300;Escape Legacy: Ancient Scrolls;Indie;0 - 20,000;47;17;30;0;0;0
940310;Corpse Party 2: Dead Patient;Simulation;0 - 20,000;227;73;154;0;0;1
940320;Combo Jumper;Design & Illustration, Photo Editing, Utilities;0 - 20,000;4;0;4;0;0;0
940330;BBlocks;Adventure, Indie;0 - 20,000;3;6;-3;0;0;0
940350;Snakest;Casual, Indie;0 - 20,000;8;9;-1;0;0;0
940380;Ascend;Action, Indie;0 - 20,000;3;3;0;0;0;0
940580;FIA European Truck Racing Championship;Casual, Indie;0 - 20,000;181;88;93;109;109;2
940590;Double Pug Switch;Action, Indie;0 - 20,000;14;2;12;0;0;0
940600;Potion island;Free to Play, Indie;0 - 20,000;2;4;-2;0;0;0
940630;Hexen Hegemony;Casual, Indie;0 - 20,000;7;5;2;0;0;0
940640;Astronaut: The Moon Eclipse;Action, Indie, Massively Multiplayer, Early Access;0 - 20,000;17;4;13;0;0;0
940650;Our World Is Ended.;Casual, Indie;0 - 20,000;53;12;41;0;0;0
940680;The Textorcist: The Story of Ray Bibbia;Education, Utilities;100,000 - 200,000;934;200;734;352;483;6
940700;Infinity Disk;Action, Indie, Early Access;0 - 20,000;6;1;5;0;0;0
940710;Colt Canyon;Indie;20,000 - 50,000;723;101;622;324;333;7
940780;Royal Roads;Casual, Indie, Accounting, Design & Illustration, Software Training, Web Publishing, Documentary, Tutorial;0 - 20,000;18;6;12;0;0;1
940790;Gnomes Garden: Halloween;Casual, Indie;0 - 20,000;35;6;29;0;0;3
940800;Gnomes Garden: Christmas Story;Casual, Indie;0 - 20,000;36;0;36;0;0;1
940810;Lost Artifacts: Time Machine;Casual, Indie;0 - 20,000;19;5;14;0;0;1
940830;Legacy of Lina;Action, Indie;0 - 20,000;12;0;12;0;0;0
940850;Taptiles;Action;0 - 20,000;5;0;5;0;0;2
940870;Bloom;Adventure, Casual, Indie, RPG, Simulation, Strategy;0 - 20,000;27;11;16;0;0;0
940910;Minoria;Free to Play, Simulation, Sports;100,000 - 200,000;1657;362;1295;196;217;9
940920;BlastFX;Adventure;0 - 20,000;11;1;10;0;0;0
940980;Phantasmat: The Dread of Oakville Collector's Edition;Casual, Indie, Simulation;0 - 20,000;13;2;11;0;0;0
940990;Grim Facade: The Artist and The Pretender Collector's Edition;Casual, Indie;0 - 20,000;4;1;3;0;0;0
941000;Witches' Legacy: Lair of the Witch Queen Collector's Edition;Casual, Indie;0 - 20,000;9;0;9;0;0;0
941020;BAYANI - Fighting Game;Casual;0 - 20,000;59;8;51;0;0;0
941030;Spirits of Mystery: Chains of Promise Collector's Edition;Casual, Indie;0 - 20,000;4;0;4;0;0;0
941040;Dark Romance: The Swan Sonata Collector's Edition;Action, Casual, Indie, RPG, Early Access;0 - 20,000;9;3;6;0;0;0
941050;Sable Maze: Twelve Fears Collector's Edition;Action, Casual, Indie;0 - 20,000;3;0;3;0;0;0
941120;Optimum Link;Action, Casual, Indie;50,000 - 100,000;78;42;36;0;0;0
941150;PsiSyn: The Game;Adventure, Indie, RPG, Strategy;0 - 20,000;15;2;13;0;0;0
941160;Slavicus;Action, Adventure, Indie;0 - 20,000;18;11;7;0;0;0
941200;Red Beard Labyrinth;Animation & Modeling, Utilities;0 - 20,000;0;1;-1;0;0;0
941300;TouHou Nil Soul;Action, Adventure, Casual, Indie;0 - 20,000;143;27;116;0;0;0
941320;Mariner Accident;Animation & Modeling, Design & Illustration, Utilities, Early Access;0 - 20,000;8;1;7;0;0;0
941330;The detective ChuLin;Adventure, Indie, Simulation, Sports;0 - 20,000;2;2;0;0;0;0
941340;The Man with the Dog;Indie, Strategy, Early Access;0 - 20,000;2;1;1;0;0;0
941350;Connectome:Pain Control;Adventure, Indie;0 - 20,000;8;2;6;0;0;0
941390;Washed Up Wizard;Adventure, Indie, Strategy;0 - 20,000;3;0;3;0;0;0
941400;Scraps and Patches;Action, Free to Play, Indie;0 - 20,000;1;0;1;0;0;0
941410;Touhou: Dreaming Butterfly | 东方蝶梦志;Action, Indie;0 - 20,000;56;12;44;0;0;0
941460;Death Trash;Action, Adventure, Indie;500,000 - 1,000,000;2777;122;2655;310;310;10
941480;Giraffe Town;Adventure, Indie, RPG, Simulation, Strategy, Early Access;0 - 20,000;232;55;177;0;0;1
941490;Quixer;Adventure, Casual;0 - 20,000;32;4;28;0;0;0
941540;Candice DeBébé's Scandalous Secrets;Action, Free to Play, Indie;0 - 20,000;20;2;18;0;0;0
941570;Relicta;Casual;20,000 - 50,000;232;112;120;0;0;2
941580;Bad Day Betsy;Casual, Free to Play, Indie;0 - 20,000;1;0;1;0;0;0
941600;RoboBunnies In Space!;Simulation, Early Access;0 - 20,000;6;1;5;0;0;0
941620;Galactic Tree Frog;Strategy, Early Access;0 - 20,000;2;0;2;0;0;0
941630;Little Memories;Action, Adventure, Early Access;0 - 20,000;3;0;3;0;0;0
941640;Gundy;Indie, Simulation;0 - 20,000;21;2;19;0;0;0
941650;The Island: Into The Mist;Adventure;50,000 - 100,000;148;71;77;0;0;0
941710;NO-GO;Indie;0 - 20,000;0;4;-4;0;0;0
941710;NO-GO;Indie, RPG;0 - 20,000;0;4;-4;0;0;0
941730;Firebase Defence;Strategy;0 - 20,000;42;14;28;0;0;0
941790;Chocolate makes you happy: Halloween;Action, Indie;0 - 20,000;47;26;21;0;0;0
941800;Construct PRO;Casual, Indie;0 - 20,000;6;4;2;0;0;0
941850;Vanguard: Normandy 1944;Indie;0 - 20,000;101;68;33;0;0;0
941890;Mini Matches;Casual, Indie;0 - 20,000;19;0;19;0;0;0
941920;Classic Card Games 3D;Casual, Indie, RPG, Simulation, Strategy;0 - 20,000;47;22;25;0;0;13
941980;The Hot Dog would Explode;Action, Casual, Indie, Simulation;0 - 20,000;1;2;-1;0;0;0
942010;The 3rd Building 三教;Action, Casual, Indie;0 - 20,000;95;68;27;0;0;0
942020;Grimm & Tonic: Aperitif;Adventure, Indie;0 - 20,000;26;14;12;0;0;0
942030;Marvelous Designer 8 for Steam;Action, Casual, Simulation, Sports, Early Access;0 - 20,000;6;1;5;0;0;3
942050;2048;Free to Play, Indie, Massively Multiplayer, Strategy;0 - 20,000;102;18;84;0;0;4
942060;JUMPGRID;Indie;0 - 20,000;72;3;69;0;0;1
942140;Fap Queen;Adventure, Casual;0 - 20,000;0;0;0;0;0;1
942200;Rocket Boots Mania;Action, Adventure, Casual, Indie;20,000 - 50,000;54;0;54;0;0;0
942250;Smith and Winston;Action, Adventure, Indie, RPG, Early Access;0 - 20,000;28;3;25;0;0;0
942300;✌ Johnny Rocket;Casual;0 - 20,000;20;27;-7;0;0;0
942310;Blocky Snake;Action, Adventure, Casual, Indie, RPG, Simulation, Strategy;0 - 20,000;32;28;4;0;0;1
942320;Halzae: Heroes of Divinity;Adventure, Casual, Indie;0 - 20,000;11;8;3;0;0;0
942340;Achievement Collector: Space;Action, Early Access;0 - 20,000;2;24;-22;0;0;0
942370;Offside;Indie, RPG;0 - 20,000;5;3;2;0;0;0
942390;Captain ToonHead vs the Punks from Outer Space;Action, Adventure, Casual, Indie, Massively Multiplayer, RPG;0 - 20,000;24;0;24;0;0;0
942440;Death Cave;Casual, Indie, RPG, Strategy;0 - 20,000;1;0;1;0;0;0
942480;Criminal Pursuit Force;Adventure, Indie, Early Access;0 - 20,000;5;10;-5;0;0;0
942510;Scamp: High Hat Havoc;Action, Casual, Indie, Simulation, Sports;20,000 - 50,000;82;45;37;0;0;0
942520;Thrusty Ship;Action, Indie;0 - 20,000;38;0;38;0;0;0
942530;Two Till Midnight;Action, Adventure, Free to Play, Indie;0 - 20,000;5;1;4;0;0;0
942580;An Adventurer's Tale;Indie;0 - 20,000;16;18;-2;0;0;1
942600;Temporality;Action, Adventure, Indie;0 - 20,000;113;16;97;0;0;0
942760;Burnout Drift;Casual;0 - 20,000;11;9;2;0;0;0
942770;Fractal To Desktop;Indie, Strategy;0 - 20,000;1;5;-4;0;0;0
942870;Lolly Pang VR;Free to Play, Indie, Simulation, Strategy;0 - 20,000;1;0;1;0;0;0
942900;Goblin's Shop;Adventure, Simulation;0 - 20,000;44;25;19;0;0;0
942930;枕边少女 MOE Hypnotist - share dreams with you;Action, Indie, Strategy;0 - 20,000;628;50;578;12;12;1
942970;Unheard - Voices of Crime;Action, Indie;1,000,000 - 2,000,000;25428;898;24530;310;245;115
942990;Girls in Glasses;Indie, RPG, Strategy, Early Access;0 - 20,000;12;0;12;0;0;0
943010;Rapid Fire;Casual;0 - 20,000;24;2;22;0;0;1
943030;NIGHT FALLEN;Action, Adventure, Indie, Massively Multiplayer;0 - 20,000;2;2;0;0;0;0
943040;Inside Grass;Action, Casual, Indie, Sports, Early Access;0 - 20,000;9;0;9;0;0;0
943080;Siege - Battle of Ashington;Casual, Indie;0 - 20,000;0;2;-2;0;0;0
943130;Cattle Call: Hollywood Talent Manager;Indie, RPG;0 - 20,000;47;76;-29;0;0;0
943150;Nostos;Action, Adventure, Indie, RPG;20,000 - 50,000;409;497;-88;0;0;0
943150;Nostos;Action, Adventure, Casual, Indie, Early Access;20,000 - 50,000;409;497;-88;0;0;0
943170;Blast the Past;Action, Adventure, RPG, Strategy;20,000 - 50,000;115;18;97;0;0;0
943190;OCTOPTICOM;Adventure, Indie;0 - 20,000;48;3;45;0;0;0
943190;OCTOPTICOM;Casual, Indie, Simulation;0 - 20,000;48;3;45;0;0;0
943210;SUB FOUR -the uncle-;Action;0 - 20,000;0;0;0;0;0;0
943230;Thrill Rollercoasters;Action, Casual;0 - 20,000;4;2;2;0;0;1
943260;Stranded Sails - Explorers of the Cursed Islands;Action, Adventure, Casual, Indie;0 - 20,000;539;184;355;0;0;29
943290;Zombie school-丧尸学院;Adventure, Casual, Indie, Simulation;20,000 - 50,000;21;8;13;0;0;0
943310;ManGuin – Penguin Apocalypse;Adventure, Casual;0 - 20,000;1;0;1;0;0;0
943370;Bravery and Greed;Adventure, Casual;50,000 - 100,000;298;73;225;2202;167;30
943380;Timberman VS;Casual, Indie;200,000 - 500,000;2986;259;2727;368;448;21
943390;Pan Panda;Action;0 - 20,000;163;32;131;0;0;0
943410;Istanbul: Digital Edition;Audio Production;0 - 20,000;186;12;174;1;1;6
943440;Cards of Knight;Action, Indie, Racing, Simulation, Sports, Early Access;0 - 20,000;2;1;1;0;0;0
943490;Team Fortress 2008;Adventure, Indie, Early Access;0 - 20,000;0;0;0;0;0;0
943510;Blindia;Action, Indie, Early Access;0 - 20,000;12;0;12;0;0;0
943590;BlitzKeep Unleashed;Adventure, Indie, RPG;0 - 20,000;6;1;5;0;0;0
943640;Sacred Saga Online;Adventure, Indie, RPG;0 - 20,000;9;30;-21;0;0;0
943670;Contraverse;Adventure, Indie, RPG;0 - 20,000;6;7;-1;0;0;0
943680;Bargain Hunter;Action, Adventure, RPG;0 - 20,000;8;9;-1;0;0;0
943710;Arauco Saga - Rpg Action;Indie, RPG;0 - 20,000;2;4;-2;0;0;0
943810;Chaos Sector 混沌宙域;Action, Indie, Simulation;0 - 20,000;66;15;51;0;0;0
943900;Tombeaux;Casual, Indie;0 - 20,000;23;7;16;0;0;0
943920;Spinball;Casual, Indie;0 - 20,000;7;0;7;0;0;0
943950;Photo Finish;Casual, Indie;0 - 20,000;5;0;5;0;0;0
943960;3Buttons;Indie, Sports;0 - 20,000;32;20;12;0;0;0
943970;DJ Whip VR;Action;0 - 20,000;7;2;5;0;0;0
943980;The logic of the miniature garden;Casual, Indie;50,000 - 100,000;389;56;333;3;3;6
944010;S.W.I.N.E. HD Remaster;Action, Indie;50,000 - 100,000;854;79;775;246;347;18
944020;Dream Ending;Action, Indie;50,000 - 100,000;2402;66;2336;236;334;2
944030;战术狂想3-枪战足球(Chimera of Tactics 3-Gun and Soccer);Action, Casual, Free to Play, Indie, Massively Multiplayer, Early Access;0 - 20,000;4;0;4;0;0;0
944060;魔法洞穴２ The Enchanted Cave 2;Adventure, Casual;0 - 20,000;0;0;0;0;0;0
944080;Pode;Action, Casual, Free to Play;;;;0;;;
944100;The Poisoner (Prelude);Action, Indie, Early Access;0 - 20,000;13;7;6;0;0;0
944110;Pocket Waifu;Adventure, Casual, Free to Play, Indie, Strategy;0 - 20,000;0;0;0;30;30;15
944120;Abalyte;Action, Free to Play, Indie, Strategy, Early Access;20,000 - 50,000;128;66;62;0;0;0
944180;Titan Outpost;Action, Adventure, Casual, Free to Play, Massively Multiplayer, Simulation, Sports, Strategy;0 - 20,000;60;15;45;0;0;1
944200;El Pansas;Adventure, Casual, Indie, RPG;0 - 20,000;3;0;3;0;0;0
944220;Gachi Heroes;Action, Indie;50,000 - 100,000;1837;105;1732;228;272;82
944250;Castle Flipper;Action, Adventure, Casual, Indie, RPG;20,000 - 50,000;519;281;238;478;478;13
944260;GG Puzzler;Indie;0 - 20,000;7;7;0;0;0;0
944300;Byte Driver;Action, Adventure, Casual, Indie, RPG;0 - 20,000;12;0;12;0;0;0
944340;Vignettes;Action, Casual, Indie, Racing, Sports;0 - 20,000;70;5;65;83;83;0
944380;Drunk Puppet;Action, Adventure, Indie, RPG, Early Access;0 - 20,000;7;7;0;0;0;0
944420;King Of Gods: Angel The Awakening Of A Demon;Action, Indie;0 - 20,000;0;2;-2;0;0;0
944430;The Last Friend;Action, Adventure, Simulation;0 - 20,000;80;4;76;0;0;0
944440;POWERCUT, Inc.;Casual;0 - 20,000;14;2;12;0;0;0
944450;Escape Velocity;Free to Play, Strategy;0 - 20,000;20;7;13;0;0;1
944500;Antistatic;Free to Play, Strategy;0 - 20,000;4;1;3;0;0;0
944530;Sweet Seasons;Action, Indie;0 - 20,000;10;1;9;0;0;0
944590;Thunder Kid;Casual, Indie, Simulation;0 - 20,000;31;3;28;0;0;0
944610;Automobiels and the Eisenhower Hiway System the Game;Casual, Indie, Simulation, Strategy;0 - 20,000;8;2;6;0;0;0
944630;MOLOCH (Zero);Adventure, Indie;0 - 20,000;25;9;16;0;0;0
944640;Xenia's Ark;Utilities, Video Production;0 - 20,000;14;5;9;0;0;0
944650;The Mysteries of Baroque;Action, Casual, Indie, Strategy;0 - 20,000;16;4;12;0;0;0
944710;TurnTack;Adventure, Casual, Indie, Massively Multiplayer, RPG;20,000 - 50,000;38;6;32;0;0;0
944720;Hellbanger;Adventure, Casual, Simulation;0 - 20,000;1;1;0;0;0;0
944730;Trends;Adventure, Indie, Simulation;0 - 20,000;6;2;4;0;0;0
944740;三国虎将传VR2-Sanguo Warriors VR2;RPG, Early Access;0 - 20,000;12;7;5;0;0;0
944770;sheepChat;Casual, Indie;20,000 - 50,000;131;42;89;0;0;45
944810;Dr. Cares - Family Practice;Adventure, Indie, Early Access;0 - 20,000;33;2;31;0;0;0
944830;Swap Swap;Action, Adventure, Indie, RPG;0 - 20,000;3;0;3;0;0;0
944840;Mixed Estate;Action, Adventure, Casual, Indie;0 - 20,000;7;3;4;0;0;0
944910;Knife Sisters;Action, Adventure, Casual, Indie;0 - 20,000;0;0;0;0;0;0
944920;Nanotale - Typing Chronicles;Adventure, Casual, Indie;20,000 - 50,000;481;114;367;382;382;4
944960;Contact : Last Defence;Action, Indie, Early Access;0 - 20,000;3;0;3;0;0;0
945100;Bassline Sinker;Adventure, Casual, Indie, RPG, Early Access;0 - 20,000;14;2;12;0;0;0
945140;Indie Dev Simulator;Action, Adventure, Indie, RPG, Early Access;0 - 20,000;62;30;32;0;0;0
945160;Angelo and Deemon: One Hell of a Quest;Action, Indie;50,000 - 100,000;97;34;63;0;0;1
945240;Fly High;Action, Adventure, Free to Play;0 - 20,000;8;1;7;0;0;0
945310;Hyper Visualizer;Indie, Strategy;0 - 20,000;6;1;5;0;0;0
945340;Ravva and the Cyclops Curse;Indie, Simulation;0 - 20,000;81;5;76;0;0;0
945360;Among Us;Casual;20,000,000 - 50,000,000;601200;53643;547557;1181;578;6199
945390;Bala na manga;Casual, Indie, Strategy;20,000 - 50,000;5;0;5;0;0;0
945460;Zombie Builder Defense;Strategy;20,000 - 50,000;260;57;203;234;253;1
945490;Little Square Things;Action, Adventure, Casual, Indie, Simulation;200,000 - 500,000;51;9;42;0;0;0
945500;Steel Dungeon 钢铁地牢;Adventure, Indie;0 - 20,000;11;2;9;0;0;0
945520;The Perfectionist;Adventure, Indie;20,000 - 50,000;43;8;35;0;0;0
945530;Bohrdom;Free to Play, Massively Multiplayer, Simulation;0 - 20,000;3;0;3;0;0;0
945540;Knights of Riddle;Action, Casual, Indie;20,000 - 50,000;1;0;1;0;0;0
945550;Tiger Striker;Adventure, Indie;0 - 20,000;2;2;0;0;0;0
945580;Bubbles the Cat;Utilities;0 - 20,000;31;1;30;0;0;0
945590;Cliché - Critical Change;Adventure, Casual;0 - 20,000;9;2;7;0;0;0
945610;Lil' Arena;Casual, Indie, Early Access;20,000 - 50,000;29;17;12;0;0;0
945620;Tadpole Swimmer;Casual, Indie;0 - 20,000;0;0;0;0;0;0
945680;Here Be Dragons;Casual, Indie;0 - 20,000;97;37;60;17;17;0
945710;DreadOut 2;Adventure, Casual, Indie, RPG;50,000 - 100,000;1145;364;781;342;342;1
945740;Buildings Have Feelings Too!;Indie;0 - 20,000;32;38;-6;0;0;0
945810;bayala - the game;Indie, Strategy, Early Access;0 - 20,000;8;2;6;0;0;0
945820;Spotter;Action, Adventure, Casual, Indie, Simulation, Early Access;0 - 20,000;0;2;-2;0;0;0
945850;Hunter's Trial: The fight never ends;Adventure, Casual, Indie, Simulation, Strategy;0 - 20,000;4;4;0;0;0;0
945870;Starcross Arena;Adventure, Casual, Indie;0 - 20,000;0;0;0;0;0;0
945880;Beer'em Up;Action, Adventure, Indie, RPG;0 - 20,000;6;5;1;0;0;0
945890;Hentai no Hero;Action, Casual, Indie, RPG, Simulation;0 - 20,000;49;30;19;0;0;0
945910;Terror for Two;Utilities;0 - 20,000;1;3;-2;0;0;0
945920;Long Arm of the Law;Casual, Indie, Strategy;0 - 20,000;20;7;13;0;0;0
945950;Shopkeepers Tale;Casual, Indie, Simulation, Strategy;0 - 20,000;3;3;0;0;0;0
946000;Captain MaCaw;Adventure, Indie;0 - 20,000;21;1;20;0;0;0
946030;Axiom Verge 2;Casual, Indie, Racing, Sports;0 - 20,000;229;48;181;0;0;12
946040;Supply Chain Idle;Indie, Racing;50,000 - 100,000;263;66;197;0;0;14
946040;Supply Chain Idle;Action, Indie;50,000 - 100,000;263;66;197;0;0;14
946050;Soda Dungeon 2;Adventure, RPG, Strategy;500,000 - 1,000,000;4443;245;4198;11421;131;354
946070;Abstract;Casual, Indie, Simulation;0 - 20,000;12;9;3;0;0;0
946080;The Earth Dies Screaming;Indie;;;;0;;;
946090;Hentai Neighbors;Casual, Indie;0 - 20,000;228;29;199;14;14;1
946170;Papper Balls;Action, Casual, Indie;0 - 20,000;10;8;2;0;0;0
946190;Loveless cat;Adventure, Indie, RPG;0 - 20,000;15;6;9;0;0;0
946210;Secret Girl;Adventure, Indie;0 - 20,000;7;20;-13;0;0;0
946300;Shooting Chicken Insanity Chickens;Action, Casual, Indie, Strategy;0 - 20,000;4;0;4;0;0;0
946330;Fallen Threats;Action, Adventure, Indie, Early Access;0 - 20,000;3;0;3;0;0;0
946340;LOST CAVE;Adventure, Casual, Free to Play, Indie, RPG, Early Access;0 - 20,000;17;2;15;0;0;0
946380;TheMemory;Adventure, Casual, Indie;0 - 20,000;27;9;18;0;0;0
946400;Slime Quest;Casual;0 - 20,000;5;2;3;0;0;0
946500;Waifu Hunter - Episode 1 : The Runaway Samurai;Adventure, Indie;0 - 20,000;2;3;-1;0;0;0
946560;Don't Forget Our Esports Dream;Action, Adventure, Casual, Indie, Strategy, Early Access;0 - 20,000;77;6;71;0;0;0
946600;Girl with a big SWORD;Casual, Indie;20,000 - 50,000;7;34;-27;0;0;0
946610;Pocket Rogues;Casual, Free to Play;0 - 20,000;251;21;230;0;0;6
946610;Pocket Rogues;;0 - 20,000;251;21;230;0;0;6
946650;Streets of Red : Devil's Dare Deluxe;Action, Casual, Indie;20,000 - 50,000;168;40;128;95;169;1
946660;Loria;Indie, Strategy, Early Access;20,000 - 50,000;185;40;145;0;0;1
946670;School Owner;Action, Adventure, Indie, RPG, Early Access;0 - 20,000;16;43;-27;0;0;0
946690;RPGGAME;Adventure, Free to Play, Indie, RPG;0 - 20,000;6;1;5;0;0;0
946700;No King No Kingdom VR;Adventure, Indie;0 - 20,000;17;8;9;0;0;0
946720;To The Rescue!;Casual, Indie, RPG;50,000 - 100,000;962;453;509;1118;1274;13
946780;MOMO.EXE 2;Action, Indie;0 - 20,000;102;22;80;0;0;0
946790;Colo Grid Zation;Casual, Indie;0 - 20,000;0;5;-5;0;0;0
946800;Hentai 2+2=4;Utilities;0 - 20,000;10;6;4;0;0;0
946810;the Escape;Adventure, Casual, Indie;20,000 - 50,000;0;3;-3;0;0;0
946860;Stamp Boy / 跳跳小子;Action, Adventure, Casual, Indie, RPG;0 - 20,000;85;6;79;0;0;0
946950;BoxTheTop;Action, Indie, RPG, Early Access;0 - 20,000;1;0;1;0;0;0
946990;Secret Government;Action, RPG, Early Access;50,000 - 100,000;159;100;59;22;22;1
947060;Furry Shakespeare: To Date Or Not To Date Cat Girls?;Casual, Indie;0 - 20,000;11;1;10;0;0;0
947070;Furry Shakespeare: Dashing Dinosaurs & Sexy Centaurs;Adventure, Casual, Indie, RPG, Simulation, Early Access;0 - 20,000;3;1;2;0;0;0
947110;Fatal Hour: Roadkill;Action, Indie, Sports;0 - 20,000;1;1;0;0;0;0
947120;Where The Water Tastes Like Wine: Fireside Chats;Action, Adventure, Indie, Early Access;0 - 20,000;41;3;38;0;0;0
947240;神遊敦煌-莫高窟第61窟;Adventure, Casual, Indie;0 - 20,000;15;3;12;0;0;0
947250;Bibi & Tina - Adventures with Horses;Casual, Indie, Strategy, Early Access;0 - 20,000;11;10;1;0;0;0
947260;Bibi Blocksberg  - Big Broom Race 3;Action, Casual;0 - 20,000;8;2;6;0;0;0
947270;The 'I Love Money' Show;Adventure, Free to Play, Indie;0 - 20,000;20;5;15;0;0;0
947290;Arkane Rush;Adventure, Indie, RPG, Strategy;0 - 20,000;23;10;13;0;0;0
947300;Grim Nights;Action, Indie;100,000 - 200,000;1151;142;1009;157;169;9
947310;Wonderland Trails;Indie;100,000 - 200,000;1;4;-3;0;0;0
947330;Rome Reborn: Flight over Ancient Rome;Action, Casual, Indie, Racing;0 - 20,000;5;0;5;0;0;0
947340;Rome Reborn: The Pantheon;Casual, Indie;0 - 20,000;0;1;-1;0;0;0
947350;Rome Reborn: The Basilica of Maxentius;Casual, Indie;0 - 20,000;0;1;-1;0;0;0
947360;Rome Reborn: The Colosseum District;Utilities;0 - 20,000;2;0;2;0;0;0
947390;Doodle Farm;Adventure;0 - 20,000;14;4;10;0;0;0
947400;Mahjong Secrets;Casual;0 - 20,000;2;3;-1;0;0;1
947430;Kiritan VS Kanitan ~Zunda-mochi Defense!~;Casual, Indie, Strategy;0 - 20,000;23;0;23;0;0;0
947450;Super BOO Quest;Animation & Modeling;0 - 20,000;18;1;17;0;0;0
947470;Optica;Casual, Simulation;0 - 20,000;2;1;1;0;0;0
947490;Jam Studio VR - Education & Health Care Edition;Action, Adventure, Indie, Simulation;0 - 20,000;5;2;3;0;0;0
947530;The Cup;Action, Adventure, Indie, Racing, Simulation, Sports, Early Access;0 - 20,000;16;10;6;0;0;0
947540;Spacefarers!;Action, Indie, Strategy;0 - 20,000;2;3;-1;0;0;0
947580;Expedition Oregon;Action, Adventure, Indie;0 - 20,000;5;3;2;0;0;0
947830;Beyond;Action, Adventure, Indie;0 - 20,000;2;3;-1;0;0;0
947880;Radio Violence;Adventure, Indie, RPG, Simulation;0 - 20,000;1;0;1;0;0;0
947890;VirtualCast;Action, Adventure, Indie;20,000 - 50,000;71;20;51;0;0;10
947940;SCP: Nukalypse;Casual, Indie;100,000 - 200,000;457;190;267;0;0;1
947960;Ribbon Racer;Casual, Indie, Strategy;0 - 20,000;2;0;2;0;0;0
947970;Roads of Rome: New Generation 2;Casual, Indie;0 - 20,000;15;8;7;0;0;0
948020;Mojo 2;Casual, Indie, Simulation;0 - 20,000;0;0;0;0;0;0
948070;SNUSE 221;Action, Casual, Indie;0 - 20,000;7;9;-2;0;0;0
948080;Lights Out;Casual, RPG, Simulation, Strategy;0 - 20,000;17;9;8;0;0;0
948100;NINJASLAYER : AREA 4643;Indie, Simulation, Strategy, Early Access;0 - 20,000;84;1;83;0;0;0
948120;The Mummy Pharaoh;Casual, Indie, RPG, Simulation;0 - 20,000;2;19;-17;0;0;0
948200;Mini Golf Buddies;Indie;0 - 20,000;1;3;-2;0;0;0
948220;ColorTool;Casual, Indie;0 - 20,000;22;8;14;0;0;1
948240;Voltage Drop;Action, Indie;0 - 20,000;9;0;9;0;0;0
948270;Byte Chaser;Action, Casual, Indie;0 - 20,000;0;1;-1;0;0;0
948320;Dragon Simulator Multiplayer;Casual, Indie;0 - 20,000;81;24;57;0;0;0
948320;Dragon Simulator Multiplayer;Adventure, Casual, Indie, Simulation;0 - 20,000;81;24;57;0;0;0
948330;Werewolf Hunter X;Adventure, Indie, Simulation, Strategy;0 - 20,000;2;2;0;0;0;0
948340;Journey Through Memories;Action, Indie;0 - 20,000;5;1;4;0;0;0
948350;Royal Booty Quest;Casual;0 - 20,000;57;39;18;0;0;0
948370;Shaoye;Casual, RPG, Simulation;0 - 20,000;0;0;0;0;0;0
948420;EXAPUNKS: TEC Redshift Player;Action, Indie, RPG;0 - 20,000;23;2;21;0;0;0
948460;Wizard Prison;Casual, Free to Play, Indie;0 - 20,000;29;5;24;0;0;0
948470;Deadsiege;Indie, RPG, Strategy, Early Access;0 - 20,000;23;22;1;0;0;0
948490;Standard Legend;Action, Free to Play, Indie;0 - 20,000;1;1;0;0;0;0
948630;Hentai MineSweeper;RPG;20,000 - 50,000;545;87;458;67;70;3
948640;Wizardry: Labyrinth of Lost Souls;Action, Adventure, Casual, Free to Play, Indie, Massively Multiplayer, Racing, RPG, Simulation, Sports, Strategy;0 - 20,000;231;89;142;1023;1023;13
948650;Asdivine Hearts II;Casual, RPG, Simulation;0 - 20,000;5;5;0;0;0;0
948660;Alvastia Chronicles;Indie, Racing, Simulation, Sports;0 - 20,000;10;3;7;0;0;0
948690;Stickman Maverick : Bad Boys Killer;Casual, Indie, Simulation, Strategy;0 - 20,000;3;1;2;0;0;0
948740;AI: The Somnium Files;;200,000 - 500,000;5626;479;5147;1120;1512;277
948770;魔塔2018;Adventure, Indie;0 - 20,000;126;18;108;0;0;1
948790;Party Poppers;Action, Casual, Indie;0 - 20,000;1;0;1;0;0;0
948830;寄甡  Symbiotic Love;Casual;20,000 - 50,000;1174;50;1124;618;618;0
948840;死亡投票_Death Voting Game;Action, Casual, Indie;0 - 20,000;17;9;8;0;0;0
948850;魔神之战;Casual, Indie;0 - 20,000;25;11;14;0;0;1
948900;macdows 95;Casual, Simulation, Early Access;20,000 - 50,000;507;34;473;181;186;0
948960;Morphies Law: Remorphed;Action, Indie;0 - 20,000;76;14;62;0;0;0
948990;Grottesco Absurdus;Casual;0 - 20,000;49;5;44;0;0;0
949000;Marble Combat;Adventure, Casual, Indie;50,000 - 100,000;121;37;84;7;7;0
949030;aMAZE Halloween;Sports;0 - 20,000;60;12;48;0;0;0
949050;Virtual Villagers Origins 2;Adventure, Casual, Indie;100,000 - 200,000;115;142;-27;35;35;13
949060;Love Thyself - A Horatio Story;Action, Indie, Early Access;50,000 - 100,000;502;39;463;901;922;1
949070;Colonies;Action, Casual, Indie;0 - 20,000;7;1;6;0;0;0
949150;VR Party Club;Action, Early Access;0 - 20,000;6;1;5;0;0;0
949170;Killing random dudes online;Action, Adventure, Indie;0 - 20,000;4;3;1;0;0;0
949200;Ambition: A Minuet in Power;Adventure, Indie, RPG, Strategy;0 - 20,000;223;21;202;0;0;12
949210;Hinterhalt 2;Action, Adventure, Indie;0 - 20,000;15;7;8;0;0;0
949290;Winkeltje: The Little Shop;Action, Adventure, Indie, RPG, Early Access;50,000 - 100,000;1197;115;1082;38;38;61
949330;Magicae Mundi;Casual, Indie, Simulation;0 - 20,000;5;2;3;0;0;0
949370;Cateau;Adventure, Indie;20,000 - 50,000;322;11;311;0;0;0
949380;AV-17;Adventure, Indie, Early Access;20,000 - 50,000;47;13;34;0;0;0
949390;Puppet Blaster;Utilities;0 - 20,000;20;1;19;0;0;0
949420;The Energy Lab;Casual, Indie, Strategy, Early Access;0 - 20,000;19;11;8;0;0;0
949450;11th Dream;Casual, Free to Play, Simulation;0 - 20,000;10;3;7;0;0;0
949480;BROK the InvestiGator;Adventure, Casual, Indie, Simulation;20,000 - 50,000;645;7;638;911;911;3
949500;Atlantia Animation;Adventure, Indie;0 - 20,000;23;18;5;0;0;0
949510;Deadly Curse: Insane Nightmare;Adventure, Casual, RPG;0 - 20,000;1;1;0;0;0;0
949520;Lost On The Island;Action, Casual, Indie;0 - 20,000;1;3;-2;0;0;0
949530;Time Splatter;Adventure, Casual;0 - 20,000;47;21;26;0;0;0
949570;Rand-O-mazE;Indie, Strategy;0 - 20,000;0;1;-1;0;0;0
949600;Intergalactic Fishing;Education, Game Development;0 - 20,000;208;5;203;0;0;0
949630;Russian roulette;Action, Adventure, Indie;0 - 20,000;71;35;36;0;0;2
949650;Here Come the Mystery Teens!;Action, Adventure, Indie;0 - 20,000;12;0;12;0;0;0
949670;Event-D;Action, Indie;20,000 - 50,000;27;4;23;0;0;0
949680;Fantasy Monarch;Indie, Simulation, Strategy;0 - 20,000;6;4;2;0;0;0
949690;Record of Lodoss War Online;Casual, Indie, Racing, Simulation, Sports;20,000 - 50,000;63;60;3;0;0;0
949690;Record of Lodoss War Online;Adventure, Indie, RPG;20,000 - 50,000;63;60;3;0;0;0
949710;Exiled to the Void;Adventure, Casual, Indie;0 - 20,000;3;9;-6;0;0;0
949720;Dark Man;Action, Indie, Sports;0 - 20,000;2;1;1;0;0;0
949770;Spitkiss;Action, Casual, Indie;0 - 20,000;33;2;31;0;0;0
949790;Rogue Bit;Casual, Indie;0 - 20,000;90;8;82;21;21;0
949800;Skyland: Heart of the Mountain;Adventure, Indie;0 - 20,000;103;27;76;603;603;2
949810;Go Cabbies!GB;Indie, Strategy, Early Access;0 - 20,000;6;6;0;0;0;0
949820;Crazy Washing Machine;Action, Indie, RPG;0 - 20,000;14;0;14;0;0;0
949830;Shrines Of Sacred Essenсe;Action, Adventure, Indie;20,000 - 50,000;1;2;-1;0;0;0
949860;Goalkeeper VR Challenge;Indie;0 - 20,000;1;1;0;0;0;1
949880;Ninja Code;Action, Adventure, Indie, Early Access;0 - 20,000;19;11;8;0;0;0
949890;Physical Exorcism: Case 01;Action, Indie;20,000 - 50,000;58;10;48;0;0;0
949910;Refill your Roguelike;Adventure, Casual, Free to Play, Indie, RPG, Simulation;0 - 20,000;12;8;4;0;0;0
949930;HEAVEN AND HELL - the last war;Action, Casual, Indie;20,000 - 50,000;1;1;0;0;0;0
949960;Best Life Simulator;Adventure, Indie, Simulation, Strategy;0 - 20,000;18;21;-3;0;0;0
949990;Magical Monster Land;Indie;0 - 20,000;27;6;21;0;0;0
950050;Starlink: Battle for Atlas;Action, Indie;50,000 - 100,000;146;51;95;0;0;1
950100;PRO EVOLUTION SOCCER 2019 LITE;Casual, Indie, Simulation;500,000 - 1,000,000;1598;1007;591;788;74;2
950130;Evidence of Life;Adventure, Indie;0 - 20,000;9;1;8;0;0;0
950140;Hiding Spot;Casual;0 - 20,000;119;2;117;0;0;0
950160;Miracle Circus;Casual, Indie;0 - 20,000;25;10;15;0;0;0
950180;Lemnis Gate;Action, Indie, Massively Multiplayer, Early Access;100,000 - 200,000;816;142;674;0;0;1
950210;SUFFER;Adventure, Casual, Indie, Simulation;0 - 20,000;46;14;32;0;0;0
950240;Rise of the Pirates;Action;0 - 20,000;61;23;38;0;0;4
950240;Rise of the Pirates;Casual, Indie, RPG;0 - 20,000;61;23;38;0;0;4
950250;Halfway Home;Casual, Indie;0 - 20,000;5;1;4;0;0;0
950260;Divenia;Indie;0 - 20,000;2;4;-2;0;0;0
950300;REDO!;Action, Adventure, Casual, Indie, Simulation;0 - 20,000;135;16;119;0;0;0
950310;Glo Phlox;Indie, Strategy;0 - 20,000;10;0;10;0;0;0
950330;OIL PATCH SIMULATIONS;Adventure, Indie, Strategy, Early Access;0 - 20,000;1;2;-1;0;0;0
950360;Quest room: Hanon;Adventure, Indie, RPG, Simulation, Strategy, Early Access;20,000 - 50,000;90;47;43;0;0;0
950370;Tactics & Strategy Master 2:Princess of Holy Light（圣光战姬）;Indie, RPG;20,000 - 50,000;96;61;35;294;294;0
950380;Hang Up;Casual, Simulation, Animation & Modeling, Design & Illustration, Utilities;0 - 20,000;24;9;15;0;0;0
950400;Blame Him;Casual, Indie, Simulation;0 - 20,000;67;82;-15;0;0;0
950460;Paradise Cleaning!;Action, Adventure, Indie;0 - 20,000;0;0;0;0;0;2
950490;INFILTRIA;Adventure, Casual, Indie, RPG, Simulation, Early Access;0 - 20,000;7;1;6;0;0;0
950510;Volcan Defend the Tower;Indie, RPG, Strategy;0 - 20,000;7;15;-8;0;0;0
950530;Mojo 2: Mia;Adventure, Indie, RPG, Strategy;50,000 - 100,000;659;153;506;0;0;1
950570;Bitworm;Action, Adventure, Casual, Indie, Simulation;0 - 20,000;4;0;4;0;0;0
950600;Zoological Era;Action, Casual, Free to Play, Simulation, Early Access;20,000 - 50,000;0;2;-2;0;0;0
950620;Priest Simulator;Action, Adventure, Casual, Indie;100,000 - 200,000;474;15;459;0;0;3
950670;Gothic Playable Teaser;Casual, Indie, Strategy;500,000 - 1,000,000;10120;3925;6195;83;69;10
950700;VICCP;Casual, Indie;0 - 20,000;102;42;60;0;0;0
950730;Fallen Sky -Online-;Action;0 - 20,000;4;1;3;0;0;0
950740;China: Mao's legacy;Casual, Indie, RPG, Strategy;100,000 - 200,000;724;50;674;497;586;9
950750;Dega Madness;Action;0 - 20,000;1;1;0;0;0;0
950780;PRATAGON;Action, Casual, Indie;0 - 20,000;0;6;-6;0;0;0
950810;SquareWorld Unpixeled;Action;0 - 20,000;12;3;9;0;0;0
950830;The Pusher;Casual, Indie;0 - 20,000;17;8;9;0;0;0
950850;The Window Box;Adventure, Indie;0 - 20,000;53;14;39;0;0;0
950890;Game Master Plus;Casual, Indie;100,000 - 200,000;9;0;9;0;0;0
950910;Space Bugs;Action, Free to Play, Indie;0 - 20,000;1;2;-1;0;0;0
950950;In The Dark;Indie;0 - 20,000;0;4;-4;0;0;0
950990;Business Magnate;Casual, Indie;20,000 - 50,000;126;70;56;0;0;2
951000;Trap Shrine;Adventure, Casual, Indie, RPG;20,000 - 50,000;1434;89;1345;28;28;2
951010;Zero spring episode 1 English translation version;Adventure, Indie, Simulation;0 - 20,000;4;1;3;0;0;0
951030;Derelict (DO NOT BUY);Indie;0 - 20,000;6;8;-2;0;0;0
951050;Another Hardcore Game;Action, Adventure, Free to Play, Indie, Early Access;0 - 20,000;21;4;17;0;0;1
951070;Zero spring episode 1 Japanese version;Action, Indie;0 - 20,000;0;2;-2;0;0;0
951100;The Adventures of Team Australia;Action, Casual, Indie;0 - 20,000;1;0;1;0;0;0
951110;VR Cricket;Action;0 - 20,000;1;1;0;0;0;0
951130;心之檻;Action, Casual, Free to Play, Indie;0 - 20,000;67;16;51;0;0;0
951130;心之檻;Casual, Free to Play, Indie;0 - 20,000;67;16;51;0;0;0
951160;JUMP UP;Design & Illustration, Video Production;0 - 20,000;5;4;1;0;0;0
951190;Ancient lands: the Tsar awakening;Education;0 - 20,000;14;0;14;0;0;0
951220;Pumpkin Death Garden;Animation & Modeling;0 - 20,000;9;1;8;0;0;3
951240;Open Sewer;Indie, RPG, Strategy, Early Access;0 - 20,000;45;21;24;295;295;0
951250;Not Heaven;Action, Adventure, Indie, RPG, Early Access;0 - 20,000;15;9;6;0;0;0
951260;Shieldwall Chronicles: Swords of the North;Adventure, Indie, RPG, Strategy;20,000 - 50,000;121;37;84;0;0;1
951320;Not My Day!;Action, Adventure, Casual, Free to Play, Massively Multiplayer;0 - 20,000;5;18;-13;0;0;0
951330;Weaponry Dealer VR;Casual, Indie;0 - 20,000;36;17;19;0;0;0
951360;Super Potato Bruh;Indie;0 - 20,000;19;7;12;0;0;0
951370;Drawkanoid;Action, Adventure, Free to Play, Indie;0 - 20,000;30;4;26;0;0;0
951370;Drawkanoid;Action, Adventure, Casual, Indie, Simulation;0 - 20,000;30;4;26;0;0;0
951420;Refraction;Action, Indie, RPG, Simulation, Early Access;0 - 20,000;2;0;2;0;0;0
951430;Dead Age 2: The Zombie Survival RPG;Education;20,000 - 50,000;814;245;569;221;221;35
951440;Volcanoids;Casual, Free to Play, Indie, Strategy;200,000 - 500,000;4840;886;3954;421;412;223
951450;Fit It;Casual, Indie;0 - 20,000;9;2;7;0;0;0
951470;Unrest Indigo;Indie;0 - 20,000;3;5;-2;0;0;0
951490;Stream Battlecards;Indie, Racing, Simulation, Sports;0 - 20,000;11;1;10;0;0;0
951500;Poker Tower Defense;Indie, Strategy;50,000 - 100,000;1;14;-13;0;0;0
951530;Alien Shooter - Last Hope;Casual, Indie, Strategy;100,000 - 200,000;153;38;115;0;0;6
951570;Deadness;Action, Massively Multiplayer, Simulation, Early Access;0 - 20,000;101;30;71;0;0;0
951640;Gangsta Sniper;Casual, Simulation, Sports, Early Access;50,000 - 100,000;38;37;1;0;0;0
951680;Dream Home;Action, Casual, Indie, Early Access;0 - 20,000;20;10;10;0;0;0
951690;Surge;Action, Adventure, Indie;0 - 20,000;5;2;3;0;0;0
951700;Super Jigsaw Puzzle: Space;Action, Casual, Indie;0 - 20,000;21;2;19;0;0;0
951740;Nice Shot! The Gun Golfing Game;Adventure, Casual, Indie;0 - 20,000;56;8;48;0;0;0
951750;I Am Dead;Casual;0 - 20,000;233;39;194;554;562;0
951780;Zombie Deathrace Feeding Frenzy;Casual, Indie, Strategy;0 - 20,000;1;2;-1;0;0;0
951800;Softspace;Simulation;0 - 20,000;2;1;1;0;0;0
951820;Captain Bones;Action, Racing, Simulation;0 - 20,000;165;18;147;0;0;0
951920;Charlie's Conscious;Action, Indie;20,000 - 50,000;0;1;-1;0;0;0
951930;Typing Incremental;Simulation, Sports;20,000 - 50,000;67;23;44;0;0;2
951940;Almost There: The Platformer;Casual, Simulation, Strategy;20,000 - 50,000;262;141;121;44;63;1
952000;Be Vigilant!;Adventure, Indie;0 - 20,000;4;0;4;0;0;0
952010;The Martian Job;Adventure, Indie, RPG;0 - 20,000;4;5;-1;0;0;0
952020;Love at Elevation;Adventure, Indie, RPG;0 - 20,000;7;9;-2;0;0;0
952030;Gilded Rails;Indie, Simulation;0 - 20,000;1;7;-6;0;0;0
952040;MUSYNX;Indie;200,000 - 500,000;4156;572;3584;483;296;67
952050;Buddinpals - Take One Home With You !!;Adventure, Indie, Simulation;0 - 20,000;11;2;9;0;0;0
952060;Resident Evil 3;Action, Adventure, Casual, RPG;1,000,000 - 2,000,000;51223;13465;37758;897;433;598
952070;RESIDENT EVIL RESISTANCE;Indie, Sports;200,000 - 500,000;2800;4389;-1589;84;51;38
952090;Grand Strategy;Action, Casual, Free to Play, Indie, Early Access;20,000 - 50,000;37;34;3;0;0;0
952120;阿达三国志2019  竖版 Three Kingdoms 2019;Action, Casual, Free to Play, Indie, Early Access;0 - 20,000;27;13;14;0;0;0
952130;Origin of Decay;Casual, Indie;0 - 20,000;10;5;5;0;0;0
952140;Surrogate;Casual, Indie;0 - 20,000;1;0;1;0;0;0
952200;stikir;Indie, Simulation, Strategy, Early Access;0 - 20,000;162;14;148;0;0;0
952230;5 Star Miami Resort;Action, Adventure, Indie, Early Access;0 - 20,000;14;6;8;0;0;0
952240;Dieselpunk Wars;Casual, Indie;0 - 20,000;83;45;38;0;0;1
952250;SEPTEMBER 1999;Adventure, Casual, Indie;100,000 - 200,000;1673;265;1408;0;0;0
952290;Zueirama;Action, Adventure, Casual, Indie, Massively Multiplayer, Simulation;20,000 - 50,000;921;44;877;0;0;1
952330;Blackfoot Burrows;Adventure, Indie, RPG;0 - 20,000;6;2;4;0;0;0
952340;The Curator - Prologue;Casual;0 - 20,000;1;0;1;0;0;0
952370;Armored Fighter;Casual, Indie, Strategy;0 - 20,000;2;0;2;0;0;0
952400;Oculto;Action, Indie, Simulation, Early Access;0 - 20,000;32;6;26;0;0;0
952420;Shan Gui II: Sweet Osmanthus II;Casual;20,000 - 50,000;476;22;454;19;19;2
952460;Lovecraft Quest - A Comix Game;Casual, Free to Play, Indie;0 - 20,000;47;24;23;0;0;0
952510;Chronicles of Lurra;Action, Adventure, Casual, Indie, Simulation;0 - 20,000;8;7;1;0;0;0
952540;Romancing SaGa 3;Casual, Indie;50,000 - 100,000;289;76;213;2690;2690;25
952600;Fireflies;Action, Indie;0 - 20,000;6;1;5;0;0;0
952680;Blind Girl;Casual, Indie, Simulation, Strategy;0 - 20,000;13;7;6;0;0;0
952680;Blind Girl;Casual, Indie;0 - 20,000;13;7;6;0;0;0
952700;DEAD;Action, Adventure, Casual, Indie, RPG, Strategy;20,000 - 50,000;23;2;21;0;0;0
952850;败家仔 Last Wish;Indie;20,000 - 50,000;2;3;-1;0;0;0
952860;河洛群俠傳 (Ho Tu Lo Shu ： The Books of Dragon);Adventure, Casual, Indie;200,000 - 500,000;7174;1605;5569;3216;2625;710
952910;Lantern of Worlds - The First Quest;Action, Adventure, Casual, Simulation;0 - 20,000;2;0;2;0;0;0
952920;Hoyeonjigi;Adventure, Casual, Indie;0 - 20,000;47;10;37;0;0;1
952930;ArmZ VR;Casual, Indie, Sports, Early Access;0 - 20,000;8;3;5;0;0;0
952950;3.Nis;Action, Indie, Simulation, Sports;20,000 - 50,000;224;48;176;0;0;0
952970;Stick to the end;RPG;0 - 20,000;2;0;2;0;0;0
952980;Torn Earth;Adventure, Casual, Indie, Simulation;0 - 20,000;0;1;-1;0;0;0
953050;Dread of Laughter;Strategy, Early Access;0 - 20,000;13;21;-8;0;0;0
953060;Go to IT;Action, Indie;0 - 20,000;22;9;13;0;0;0
953120;ADK;Adventure, Casual, Indie, RPG, Simulation;20,000 - 50,000;2;6;-4;0;0;0
953150;TrivaTune;Free to Play, Indie, RPG, Simulation, Strategy, Early Access;0 - 20,000;3;2;1;0;0;0
953170;Witch's Tales;Action, Casual, Indie;0 - 20,000;9;3;6;0;0;0
953190;Dream Walker;Free to Play, Indie, Massively Multiplayer, Early Access;0 - 20,000;7;6;1;0;0;0
953220;Corrupted Commander;Free to Play;0 - 20,000;2;1;1;0;0;0
953230;Quiver Dick's Terrible Tale For Terrible Parents To Read To Their Equally Terrible Children;Free to Play, RPG, Strategy, Early Access;50,000 - 100,000;102;10;92;0;0;0
953250;War Machines: Free to Play;Adventure, Casual, Indie;50,000 - 100,000;151;73;78;0;0;0
953290;Dinosaur Safari VR;Casual, Indie, RPG, Simulation, Strategy;0 - 20,000;11;10;1;0;0;0
953330;Hyper Echelon;Action;0 - 20,000;36;3;33;0;0;1
953340;Colourless;Adventure, Indie;0 - 20,000;7;0;7;0;0;0
953370;ZED;RPG;0 - 20,000;86;56;30;0;0;0
953440;And You're There, Too;Indie, Simulation;20,000 - 50,000;21;9;12;0;0;0
953490;CARRION;Action, Indie, Strategy;500,000 - 1,000,000;17744;1041;16703;285;275;65
953550;Temple Scramble;Casual, Indie;0 - 20,000;1;0;1;0;0;0
953570;White Dove 白雀;Casual, Indie, Simulation;50,000 - 100,000;285;46;239;0;0;1
953580;Tourist Bus Simulator;Adventure, RPG, Strategy;50,000 - 100,000;1855;951;904;384;585;62
953610;HOT GIRLS VR;Action, Adventure, Casual, Indie, Strategy, Early Access;0 - 20,000;8;10;-2;0;0;0
953640;Gyro Buster;Action;0 - 20,000;1;1;0;0;0;0
953690;Doom & Destiny Worlds;Adventure;20,000 - 50,000;74;24;50;0;0;2
953700;I'm an adventurer;Action, Adventure, Casual, Indie, RPG, Simulation;0 - 20,000;27;3;24;0;0;0
953740;尸如潮水;Adventure, Indie, RPG;0 - 20,000;5;12;-7;0;0;0
953750;The Masked Mage;Adventure, Indie;0 - 20,000;1;5;-4;0;0;0
953760;Gravity Spin;Adventure, Casual, Indie;0 - 20,000;0;3;-3;0;0;0
953790;无敌荒野/Unbeatable wilderness;Casual, Indie, Strategy;0 - 20,000;0;1;-1;0;0;0
953820;Parkan: Iron Strategy;Indie, Simulation, Strategy;200,000 - 500,000;22;4;18;0;0;0
953840;Apollo 11 VR HD;Casual, Indie, Simulation;20,000 - 50,000;189;48;141;7;7;0
953870;Space Robinson: Hardcore Roguelike Action;Action, Adventure, RPG, Strategy;20,000 - 50,000;137;53;84;59;59;0
953880;First Class Trouble;Action, Free to Play;100,000 - 200,000;2522;647;1875;628;383;58
953900;Pantsu Hunter: Back to the 90s;Indie, Strategy;0 - 20,000;165;31;134;0;0;0
953920;Palace of the Azure Dragon;Action, Indie;0 - 20,000;5;0;5;0;0;0
953950;Kubble;Action;0 - 20,000;25;1;24;0;0;1
953990;Heart of the Kingdom: Rebellion;Action, Indie;0 - 20,000;16;12;4;0;0;0
954000;Cosa Nostra;Adventure, Casual, Indie;0 - 20,000;25;19;6;0;0;0
954010;Definitely Sneaky But Not Sneaky;Adventure, Casual, Free to Play, Indie, RPG, Simulation, Strategy, Early Access;0 - 20,000;42;2;40;0;0;0
954070;Beat Boxers;Indie, Racing, Simulation, Sports, Early Access;20,000 - 50,000;39;42;-3;0;0;0
954080;Memorrha;Action, Casual, Indie, RPG, Sports, Early Access;0 - 20,000;85;44;41;0;0;4
954150;Nowhere Girl;Adventure, Indie;0 - 20,000;36;9;27;0;0;0
954160;Angelus Brand VR Experience;Casual, Indie, RPG, Simulation;20,000 - 50,000;24;2;22;0;0;0
954170;Backyard Brawl;Adventure, Casual, Indie, Simulation, Early Access;20,000 - 50,000;38;25;13;0;0;0
954210;Symphonic Mayhem;Casual, Indie, Strategy;0 - 20,000;3;0;3;0;0;0
954240;Cuboid Keeper;Indie, RPG;0 - 20,000;19;0;19;0;0;0
954270;LOGistICAL 2;Casual;20,000 - 50,000;60;24;36;0;0;4
954280;3dSen VR;Action, Casual, Racing, Simulation;0 - 20,000;145;9;136;23;23;0
954350;NOLO HOME;Indie, RPG, Early Access;20,000 - 50,000;22;32;-10;0;0;4
954360;Color by Numbers - Halloween;Casual, Indie, Strategy;0 - 20,000;4;3;1;0;0;0
954400;Color by Numbers - Christmas;Adventure, Casual, Indie;0 - 20,000;2;0;2;0;0;0
954410;Color by Numbers - Animals;Casual, Strategy;0 - 20,000;2;1;1;0;0;0
954420;DotX;Free to Play, Indie, Massively Multiplayer, Racing, Simulation, Sports, Strategy;0 - 20,000;9;2;7;0;0;0
954530;The Momo Game;Utilities;20,000 - 50,000;55;74;-19;0;0;0
954590;TEXT;Adventure, Indie, RPG, Simulation, Early Access;0 - 20,000;38;10;28;0;0;0
954650;Druidstone: The Secret of the Menhir Forest;Adventure, Casual, Indie, RPG;50,000 - 100,000;1048;199;849;8;15;5
954710;BlockDoc;Adventure, Casual;0 - 20,000;1;0;1;0;0;0
954720;The Shedding;Casual, Simulation, Strategy;0 - 20,000;38;18;20;0;0;0
954740;Terminator: Resistance;Adventure, Casual, Strategy;500,000 - 1,000,000;10409;852;9557;355;326;86
954780;Zombie Soldier;RPG, Early Access;0 - 20,000;3;6;-3;0;0;0
954860;Mad Cat's World. Act - 1: Not by meat alone...;Action, Adventure, Indie;0 - 20,000;24;2;22;0;0;0
954870;Astrox Imperium;Action, Casual, Indie;50,000 - 100,000;722;69;653;651;651;33
954880;PanoPainter;Action, Casual, Indie;0 - 20,000;28;9;19;0;0;1
954920;Flank That Tank!;Action, Adventure, Indie;0 - 20,000;2;0;2;0;0;0
954970;Golden Key;Casual, Indie, RPG, Strategy;0 - 20,000;4;5;-1;0;0;0
955030;Metamorph;Casual, Simulation, Early Access;0 - 20,000;2;0;2;0;0;0
955050;Bright Memory;Adventure, Casual, Indie, RPG, Strategy, Early Access;1,000,000 - 2,000,000;29006;2665;26341;106;56;14
955060;The Watson-Scott Test;Action, Free to Play, Indie;50,000 - 100,000;464;225;239;38;38;4
955070;Forex Trading Master: Simulator;Action, Adventure, Casual, Indie, Simulation;0 - 20,000;19;18;1;0;0;0
955120;SCUOS;Casual, Free to Play, Indie, RPG;0 - 20,000;4;1;3;0;0;0
955170;铁道物语：陆王（Railway Saga:Land King）;Simulation, Strategy, Early Access;50,000 - 100,000;370;81;289;0;0;17
955190;Blueprint Word: Classroom;Action, Adventure, Casual, Indie;0 - 20,000;12;0;12;0;0;0
955260;Island Invasion;Action, Adventure, Indie, RPG;0 - 20,000;8;3;5;0;0;0
955290;The Blood Eclipse;Casual, Indie, Simulation, Strategy;0 - 20,000;0;4;-4;0;0;0
955300;ShotKill;Casual;0 - 20,000;5;1;4;0;0;0
955320;Dark Fantasy: Jigsaw Puzzle;Action, Indie, Strategy;20,000 - 50,000;298;28;270;0;0;1
955360;Stronghold: A Hero's Fate;Casual, Free to Play, Strategy, Early Access;0 - 20,000;10;5;5;0;0;0
955370;Weyrwood;Adventure, Indie, RPG;0 - 20,000;14;3;11;0;0;0
955380;Death Collector;Action, Casual, Indie;0 - 20,000;3;7;-4;0;0;0
955400;Bonds;Adventure, Strategy;0 - 20,000;94;3;91;0;0;0
955410;Armoured Alliance;Adventure;0 - 20,000;12;0;12;0;0;0
955490;Terror In The Atomic Desert;Action, Casual, Indie;0 - 20,000;8;4;4;0;0;0
955500;MagnetoBotty;Casual, Indie;0 - 20,000;3;0;3;0;0;0
955530;Wildest of the Wild;Indie, Racing, Simulation, Sports;0 - 20,000;2;2;0;0;0;0
955540;Telecube Nightmare;Adventure, Casual, Indie;0 - 20,000;11;2;9;0;0;0
955550;Root Beer On Tap;Casual;0 - 20,000;5;0;5;0;0;0
955570;Teck Boxing 3D;Action, Indie;0 - 20,000;1;1;0;0;0;0
955580;Rise: Race The Future;Action, Adventure, Indie;0 - 20,000;73;33;40;0;0;0
955600;Noble In Exile / 落魄之家;Indie, Strategy, Early Access;0 - 20,000;8;6;2;0;0;0
955610;OpenVR Benchmark;Action, Adventure, Indie, RPG, Simulation, Strategy;20,000 - 50,000;51;21;30;0;0;1
955620;Battle Arena: Euro Wars;Animation & Modeling, Utilities, Early Access;0 - 20,000;0;5;-5;0;0;0
955640;Go Outside Simulator;Casual, Indie;0 - 20,000;51;3;48;0;0;2
955670;Acropolis: The Archaic Age;Casual, Indie;0 - 20,000;6;2;4;0;0;0
955700;TITAN HUNTER;Casual, Indie, Simulation;0 - 20,000;4;7;-3;0;0;0
955740;Mini Healer;Adventure, Casual, Indie;200,000 - 500,000;1700;65;1635;283;283;23
955750;Antitetrise;Action, Indie, Strategy;0 - 20,000;2;0;2;0;0;0
955790;Breakout;Indie, Racing, Simulation, Sports;0 - 20,000;13;3;10;0;0;0
955840;Slide to finish;Action, Adventure, Indie, RPG;0 - 20,000;1;0;1;0;0;0
955860;Woodboy;Action, Adventure, Casual;0 - 20,000;9;3;6;0;0;0
955870;Battlecruisers;Casual, Free to Play, Indie;20,000 - 50,000;259;35;224;19;19;0
955890;War Platform;Indie, RPG, Simulation;0 - 20,000;1;10;-9;0;0;0
955900;Amazing Cultivation Simulator;Casual, Indie, Simulation;500,000 - 1,000,000;17900;2414;15486;13057;2667;1268
955980;Dive Inside;Action, Adventure, Casual, Indie, Massively Multiplayer;0 - 20,000;1;1;0;0;0;0
956000;Su Hack;Casual;100,000 - 200,000;4;1;3;0;0;0
956010;Hexanome;Adventure, Casual, Indie, Simulation;0 - 20,000;23;5;18;0;0;0
956030;Creaks;Action, Adventure, Indie;100,000 - 200,000;2622;142;2480;375;385;22
956060;Mittelborg: City of Mages;Adventure, Indie, Simulation;0 - 20,000;73;39;34;0;0;1
956060;Mittelborg: City of Mages;Action, Adventure, Indie, Early Access;0 - 20,000;73;39;34;0;0;1
956090;Animals Memory: Horses;Casual;0 - 20,000;15;0;15;0;0;0
956140;Lifeslide;Action, Adventure, Casual, Indie, RPG, Strategy;0 - 20,000;290;16;274;0;0;2
956150;Mars: Chaos Menace;Action;0 - 20,000;2;3;-1;0;0;0
956190;Cat's Puzzle  /ᐠ｡ꞈ｡ᐟ\;Casual, Indie, Simulation, Early Access;0 - 20,000;19;2;17;0;0;0
956200;Leopoldo Manquiseil;Adventure, Indie;0 - 20,000;6;1;5;0;0;0
956210;Spec Defense;Adventure, Casual, Indie, Simulation;0 - 20,000;7;1;6;0;0;0
956240;Simson Tuningwerkstatt 3D;Casual, Indie;0 - 20,000;180;1;179;0;0;14
956280;Joe's Wrath;Adventure, Free to Play, Indie, Massively Multiplayer, RPG;0 - 20,000;4;2;2;0;0;0
956310;Musashi vs Cthulhu;Action, Indie, Sports;0 - 20,000;26;3;23;0;0;0
956350;There Is No Turning Back!;Casual, Indie;0 - 20,000;2;0;2;0;0;0
956360;Badminton Warrior (羽毛球勇士 中国新年版);Adventure, Casual, Indie;0 - 20,000;15;5;10;0;0;0
956380;Dark Dimensions: Homecoming Collector's Edition;Utilities;0 - 20,000;6;1;5;0;0;0
956390;Final Cut: Fame Fatale Collector's Edition;Adventure, Casual, Indie, RPG;0 - 20,000;2;1;1;0;0;0
956400;Grim Tales: Bloody Mary Collector's Edition;Adventure, Indie, RPG, Simulation;0 - 20,000;13;1;12;0;0;0
956430;Steampunk Graveyard;Casual, Indie, Simulation;20,000 - 50,000;2;5;-3;0;0;0
956450;Rogue Fable III;Casual;20,000 - 50,000;557;35;522;0;0;58
956480;Aquarium Sandbox;Action, Adventure, Indie;0 - 20,000;3;6;-3;0;0;0
956500;Bow to Blood: Last Captain Standing;Adventure, Casual, Indie, Simulation;0 - 20,000;42;8;34;0;0;0
956540;Color Phase;Casual, Indie;20,000 - 50,000;34;17;17;0;0;1
956550;Devil Girl Needs Massages;Action, Adventure, Indie, Simulation, Strategy, Early Access;0 - 20,000;0;0;0;0;0;0
956560;StarCrossed;Casual;0 - 20,000;56;10;46;0;0;0
956580;9Dragons : Kung Fu Arena;Action, Adventure, Indie;50,000 - 100,000;182;96;86;0;0;0
956590;Yet Another Snake Game;Casual;0 - 20,000;2;3;-1;0;0;0
956620;Talk to Yuno;Action, Casual, Indie, Strategy;0 - 20,000;7;2;5;0;0;0
956680;M.A.S.S. Builder;Adventure, Casual, Indie, RPG;100,000 - 200,000;2972;335;2637;247;415;61
956780;x2Roulette;Adventure, Casual, Indie;20,000 - 50,000;15;24;-9;0;0;0
956870;Starship Zvezda;Strategy, Early Access;0 - 20,000;6;5;1;0;0;1
956880;Géants disparus VR;Casual, Indie;0 - 20,000;17;7;10;0;0;0
956990;Slavistan 2;Action;0 - 20,000;12;0;12;0;0;0
957050;Ultra Off-Road 2019: Alaska;Adventure, Casual, Indie, RPG;0 - 20,000;43;97;-54;6;6;0
957070;iB Cricket;Action;0 - 20,000;106;5;101;0;0;3
957080;EEP 15;Casual, Indie;0 - 20,000;20;17;3;0;0;7
957140;新世勇者传;Adventure, Casual, Indie;0 - 20,000;9;0;9;0;0;0
957150;冷月清辉照天涯(KUNG FU LEGEND);Adventure, Casual, Indie, RPG;0 - 20,000;3;2;1;0;0;0
957220;Our Worst Fears;Casual, Indie, Strategy;0 - 20,000;1;1;0;0;0;0
957280;COUCH VERSUS;Adventure, Free to Play, RPG, Simulation, Strategy, Early Access;0 - 20,000;3;1;2;0;0;0
957350;Rogue Rails;Adventure, Casual, Indie, RPG, Simulation, Strategy;0 - 20,000;8;2;6;0;0;0
957390;Chief's Quest;Action;0 - 20,000;3;2;1;0;0;0
957410;King of Queendoms;Action, Adventure, Indie;0 - 20,000;11;11;0;0;0;0
957430;Mentai Uncensored;Action, Adventure, Indie, Early Access;0 - 20,000;39;16;23;0;0;0
957440;Swords and Sandals Pirates;Action, Indie;0 - 20,000;29;6;23;6;6;0
957490;My Cabin And I;Utilities, Video Production;0 - 20,000;25;4;21;0;0;0
957510;The Hour Has Come;Action, Adventure, Indie;0 - 20,000;1;1;0;0;0;0
957570;The Qaedon Wars - The Story Begins;Action, Casual, Indie;0 - 20,000;19;4;15;0;0;1
957660;Catizens;Casual, Indie, Simulation, Strategy;0 - 20,000;176;24;152;286;316;2
957680;Doughlings: Invasion;Casual, Simulation;0 - 20,000;22;1;21;0;0;0
957710;The Waylanders;Simulation;0 - 20,000;228;212;16;0;0;3
957720;Strategic Command WWII: World at War;Casual, Indie, RPG;0 - 20,000;366;65;301;0;0;109
957770;WarpThrough;Casual, Indie;0 - 20,000;9;1;8;0;0;0
957780;Tower of Fate;Casual;0 - 20,000;22;10;12;0;0;0
957790;War Dust VR: 32v32 Battlefields;Action, Adventure, Casual;50,000 - 100,000;1191;291;900;191;299;16
957810;Season of War (Alpha);Action, Adventure, Indie, Early Access;0 - 20,000;6;1;5;0;0;0
957820;Across the Grooves;Casual, Free to Play, Indie;0 - 20,000;90;6;84;0;0;0
957850;Light Up the Holidays;Adventure, Free to Play, Indie;0 - 20,000;3;0;3;0;0;0
957890;The Horologist's Legacy;Indie;50,000 - 100,000;8;1;7;0;0;0
957930;Intelligence: Underwater Kingdom;Action, Casual, Indie;0 - 20,000;4;2;2;0;0;0
957960;Inkulinati;Action, Adventure, Indie, RPG, Simulation;0 - 20,000;100;15;85;41;41;13
958050;1001st Hyper Tower;Casual, Indie, Racing;0 - 20,000;36;6;30;0;0;0
958090;School of the Dead: Anastasia;Utilities;0 - 20,000;28;8;20;0;0;0
958130;NEET simulator;Action, Indie;0 - 20,000;16;10;6;0;0;0
958190;Surge Radio;;0 - 20,000;1;0;1;0;0;0
958200;Ralf;Casual, Indie, Simulation;0 - 20,000;4;0;4;0;0;0
958210;Pixelmash;Adventure, Indie;0 - 20,000;33;14;19;0;0;3
958220;The Endless Summer - Search For Surf;Casual, Indie;0 - 20,000;8;5;3;0;0;0
958230;AXE:SURVIVAL;Action, Adventure, Racing;0 - 20,000;5;22;-17;0;0;0
958280;Float Night;Action, Indie;0 - 20,000;46;17;29;0;0;0
958300;Cute Girls 可爱的女孩;Adventure, Casual, Indie, RPG, Simulation;0 - 20,000;14;12;2;0;0;0
958310;Evolo.SpiderSim;Adventure, Indie;0 - 20,000;2;2;0;0;0;0
958320;A Front Too Far: Normandy;Casual, Indie, Strategy;0 - 20,000;120;69;51;0;0;0
958320;A Front Too Far: Normandy;Adventure, Casual;0 - 20,000;120;69;51;0;0;0
958360;Silver Child;Action, Casual, Strategy;0 - 20,000;1;0;1;0;0;0
958400;Project CARS 3;Action, Adventure, Casual, Indie, RPG, Simulation;200,000 - 500,000;1708;1463;245;1276;2445;42
958480;Seed of the Dead;RPG;0 - 20,000;281;55;226;105;105;0
958480;Seed of the Dead;Action, Indie, Early Access;0 - 20,000;281;55;226;105;105;0
958490;Titan shield;Action, Adventure, Indie;20,000 - 50,000;8;1;7;0;0;0
958530;Fury of Dracula: Digital Edition;Utilities;0 - 20,000;150;52;98;0;0;0
958640;Super Turbo Sudoku;Action, Adventure;0 - 20,000;12;6;6;0;0;0
958650;Strange Encounter;Free to Play, RPG, Early Access;0 - 20,000;23;6;17;0;0;0
958670;MekaFighters;Action, Massively Multiplayer, RPG, Early Access;0 - 20,000;2;0;2;0;0;0
958680;Self-knowledge VR;Adventure;20,000 - 50,000;21;5;16;0;0;0
958690;The Sky Climber;Action;0 - 20,000;8;2;6;0;0;0
958740;Heretic Operative;Action, Adventure, Indie;0 - 20,000;68;14;54;0;0;1
958750;Re-O-Ri;Indie, Simulation;0 - 20,000;66;5;61;0;0;0
958790;Big Breezy Boat - Relaxing Sailing;Free to Play, Simulation, Early Access;0 - 20,000;20;7;13;0;0;0
958850;Let It Flow;Casual, Indie, Strategy;20,000 - 50,000;601;131;470;0;0;0
958850;Let It Flow;Indie, RPG, Simulation, Strategy;20,000 - 50,000;601;131;470;0;0;0
958880;Nick Bounty and the Dame with the Blue Chewed Shoe;Game Development;0 - 20,000;58;2;56;0;0;0
958900;BATTLE X Arcade;Casual;0 - 20,000;0;1;-1;0;0;0
958960;Darwin's Test;Action, Casual, Indie;0 - 20,000;32;13;19;0;0;0
958990;Blokin;Casual, Indie, Simulation, Early Access;0 - 20,000;2;4;-2;0;0;0
959000;Edna & Harvey: The Breakout - Anniversary Edition;Indie, Simulation, Strategy;20,000 - 50,000;400;34;366;183;277;5
959020;You Shall Not Break!;Action, Indie;0 - 20,000;11;2;9;0;0;0
959030;Zombie Cubes;Action;0 - 20,000;35;2;33;0;0;0
959030;Zombie Cubes;Action, Indie;0 - 20,000;35;2;33;0;0;0
959050;Bound Up & Squirming!;Adventure, Indie;0 - 20,000;30;2;28;0;0;1
959080;Unsung Warriors - Prologue;Casual, Indie, Simulation, Strategy;200,000 - 500,000;1293;69;1224;0;0;2
959090;WayDown;RPG;0 - 20,000;6;1;5;0;0;0
959150;Making History: The First World War;Adventure, Indie;50,000 - 100,000;64;21;43;5;5;4
959170;John:Condemned;Adventure, Casual, Indie;20,000 - 50,000;7;15;-8;0;0;0
959200;Battleships and Carriers - WW2 Battleship Game;Casual, Indie;0 - 20,000;10;10;0;0;0;0
959260;Aspect;Adventure, Indie;0 - 20,000;3;6;-3;0;0;0
959280;Total Seclusion;Action, Indie;0 - 20,000;8;11;-3;0;0;0
959340;Deconstruction Lab;Indie, RPG, Strategy;0 - 20,000;1;1;0;0;0;0
959380;War in Space;Casual, Indie, Early Access;0 - 20,000;0;0;0;0;0;0
959400;Save Thine Kingdom;Casual, Strategy;0 - 20,000;4;0;4;0;0;0
959410;The Endless Empty;Casual, Indie, Strategy;0 - 20,000;134;8;126;0;0;0
959510;The Master Club;RPG, Strategy;0 - 20,000;8;1;7;0;0;0
959520;Fantasy Blacksmith;Adventure;100,000 - 200,000;752;780;-28;131;162;6
959540;Devil's Toy;Action, Indie;0 - 20,000;13;9;4;0;0;0
959590;Super Keepy Ups;Action, Indie;0 - 20,000;1;2;-1;0;0;0
959700;Chuckie Egg 2017 Challenges;Casual, Indie, RPG, Simulation, Early Access;0 - 20,000;0;0;0;0;0;0
959730;Spider Lander;Indie;20,000 - 50,000;4;0;4;0;0;0
959750;A Book of Beasts and Buddies;Action, Indie;50,000 - 100,000;355;16;339;0;0;2
959770;Moe: The Boundary of Reality;Casual;0 - 20,000;8;7;1;0;0;0
959850;American Patriots: The Swamp Fox;Adventure, Indie;0 - 20,000;5;10;-5;0;0;0
959860;The Valiant;Action, Casual, Indie;0 - 20,000;141;67;74;0;0;4
959870;The Monster;Education;0 - 20,000;17;9;8;0;0;0
959880;Dungeon Town;Casual, Indie, Sports, Early Access;0 - 20,000;268;66;202;0;0;3
959890;Sister Travel;Indie;20,000 - 50,000;464;41;423;0;0;5
959890;Sister Travel;Action, Early Access;20,000 - 50,000;464;41;423;0;0;5
959920;VR Curling;Indie, RPG, Simulation;0 - 20,000;8;5;3;0;0;0
959930;Duality;Action, Free to Play, Massively Multiplayer;0 - 20,000;11;2;9;0;0;0
960030;Deca;Adventure, Indie;0 - 20,000;49;8;41;0;0;1
960040;Clash of Chefs VR;Indie, Racing;0 - 20,000;105;25;80;0;0;0
960070;Fish & Bubbles;Casual, Indie, Strategy;0 - 20,000;4;1;3;0;0;0
960090;Bloons TD 6;Casual, Indie;2,000,000 - 5,000,000;233025;6094;226931;3286;1314;17251
960130;Galaxity Beta;Indie;0 - 20,000;5;5;0;0;0;0
960140;Flower Design Ⅱ;RPG;0 - 20,000;9;1;8;0;0;0
960150;Rending Sky;Adventure, Casual, Indie, RPG, Simulation;0 - 20,000;17;29;-12;0;0;0
960170;DJMAX RESPECT V;Adventure, Indie, RPG, Simulation, Strategy;500,000 - 1,000,000;18450;2666;15784;3691;510;924
960190;Maytroid. I swear it's a nice game too;Adventure, Casual, Indie, Simulation;100,000 - 200,000;142;32;110;0;0;3
960200;One Night 2: The Beyond;Adventure;0 - 20,000;4;4;0;0;0;0
960220;Lufulus' Creatures;Indie;0 - 20,000;35;2;33;0;0;0
960240;Stunt Kite Party;Action, Indie, Strategy;0 - 20,000;13;1;12;0;0;0
960270;Dafen Oil Painting Village: An Immersive Reality;Casual;0 - 20,000;7;6;1;0;0;0
960320;Ego Hearts;Free to Play, Indie, Simulation;20,000 - 50,000;44;17;27;0;0;0
960330;Dark Gnome;Action, Adventure, Indie;50,000 - 100,000;53;43;10;0;0;1
960340;YUNA: Sugar hearts and Love;Action, Adventure, Indie, RPG, Early Access;0 - 20,000;3;2;1;0;0;0
960360;Yuzi Lims: Hentai;Adventure, Casual, Indie;0 - 20,000;2;1;1;0;0;0
960550;Distress: A Choice-Driven Sci-Fi Adventure;Adventure, Indie, Simulation, Early Access;0 - 20,000;9;0;9;0;0;0
960590;Courage for a Kiss;Casual, Indie;0 - 20,000;43;4;39;0;0;1
960600;Nanoswarm;RPG, Early Access;0 - 20,000;2;1;1;0;0;0
960610;The Gameshow;Adventure, Indie, RPG;0 - 20,000;5;18;-13;0;0;0
960630;Beyond Critical;Action, Adventure, Indie;0 - 20,000;0;1;-1;0;0;0
960660;Coldfall;Action, Adventure, Indie;0 - 20,000;25;4;21;0;0;0
960690;One Step From Eden;Action, Casual, Indie;200,000 - 500,000;6149;399;5750;1409;766;53
960700;GUNS 'n GUTS;Action, Adventure, Free to Play, Indie;0 - 20,000;9;0;9;0;0;0
960710;DON'T GIVE UP: A Cynical Tale;Indie, Simulation, Sports;0 - 20,000;76;10;66;0;0;1
960740;Girls' civilization;Indie, Simulation, Sports;0 - 20,000;156;92;64;24;24;0
960800;Second World: Air War S;Casual, Indie, RPG, Simulation, Strategy;0 - 20,000;1;0;1;0;0;0
960820;Data mining 2;Indie;0 - 20,000;15;15;0;0;0;0
960900;Lornsword Winter Chronicle;Indie, RPG;0 - 20,000;27;11;16;0;0;1
960910;Heavy Rain;Action, Casual, Indie, RPG, Simulation;500,000 - 1,000,000;7226;1509;5717;422;470;83
960980;Apsulov: End of Gods;Adventure, Indie;20,000 - 50,000;1135;154;981;406;561;5
960990;Beyond: Two Souls;Action;500,000 - 1,000,000;13999;1775;12224;637;456;127
961000;SURVIVORS LEFT: X;Action, Adventure, Indie;0 - 20,000;2;0;2;0;0;0
961010;The Hand of Glory;Action, Simulation, Early Access;0 - 20,000;146;4;142;0;0;2
961040;Down to Hell;Utilities, Game Development, Early Access;0 - 20,000;33;24;9;0;0;0
961060;GameEllen;Casual, Indie;0 - 20,000;3;3;0;0;0;0
961110;Prixel;Adventure, Casual, Indie, RPG, Strategy;0 - 20,000;4;2;2;0;0;0
961190;Abstract Hell;Indie, Strategy;0 - 20,000;2;2;0;0;0;0
961200;Predecessor;Casual, Indie, Strategy;1,000,000 - 2,000,000;3970;888;3082;322;200;1537
961210;7-minute HOP;Indie;0 - 20,000;5;9;-4;0;0;0
961220;Sanatorium Purgatorium;Action, Adventure;0 - 20,000;18;7;11;0;0;0
961230;Backgammon, Chess & Checkers;Adventure, Casual, Indie, Simulation, Strategy, Early Access;0 - 20,000;2;2;0;0;0;0
961240;CastleGuard;Casual, Free to Play, Indie;0 - 20,000;8;4;4;0;0;0
961410;Red Blue;Casual, Indie, Simulation;0 - 20,000;2;0;2;0;0;0
961420;Vile;Action, Adventure, Casual, Indie;0 - 20,000;35;5;30;0;0;0
961490;Travis Strikes Again: No More Heroes Complete Edition;Casual, Indie, RPG, Simulation, Strategy;0 - 20,000;333;59;274;0;0;1
961510;MarisaLand Legacy;Adventure, Casual, Indie, RPG, Simulation;20,000 - 50,000;107;26;81;0;0;0
961560;Dark Trail;Adventure, Casual, Indie;0 - 20,000;4;2;2;0;0;0
961620;Flashback;;50,000 - 100,000;322;77;245;55;101;2
961640;The Tower of Five Hearts;Action, Adventure, Casual, Indie, RPG, Strategy;0 - 20,000;16;0;16;0;0;0
961660;Nowhere Patrol;Adventure, Casual, Indie, Simulation;0 - 20,000;166;5;161;0;0;0
961680;Rampage Online;Action, Adventure;0 - 20,000;1;5;-4;0;0;0
961700;NekoCharm;Action, Adventure, Casual;0 - 20,000;6;5;1;0;0;0
961710;Puzzle Out VR;Action, Adventure, Casual, Indie, Racing, Early Access;0 - 20,000;0;4;-4;0;0;0
961720;Xenochamber;Adventure;0 - 20,000;1;4;-3;0;0;0
961740;Quantum Retribution;Adventure, Indie, RPG;0 - 20,000;2;6;-4;0;0;0
961750;Rope Racer O'Neon;Adventure, Casual, Indie, Strategy;0 - 20,000;1;0;1;0;0;0
961850;Circle of Sumo;Action, Casual, Indie, Early Access;0 - 20,000;7;2;5;0;0;0
961860;Super Blasting Boy;Simulation, Early Access;20,000 - 50,000;52;22;30;0;0;0
961870;Toltec and the mysteries of the Secret Island;RPG;0 - 20,000;3;0;3;0;0;0
961920;Romantic Journey;Action, Adventure;0 - 20,000;3;13;-10;0;0;0
961990;Photo & Graphic Designer 16 Steam Edition;Adventure;0 - 20,000;15;4;11;0;0;0
962050;Puzzles for smart: Birds;Casual, Free to Play, Indie, RPG, Simulation, Strategy;0 - 20,000;14;3;11;0;0;0
962060;Heaven & Hell 2;Indie, RPG, Strategy, Early Access;0 - 20,000;4;4;0;0;0;0
962070;Angry King;Action, Casual, Simulation, Strategy;0 - 20,000;0;9;-9;0;0;0
962090;Common'hood;RPG;0 - 20,000;126;97;29;0;0;8
962130;Grounded;Simulation;2,000,000 - 5,000,000;47170;6458;40712;1723;663;4567
962150;"Tactics V: ""Obsidian Brigade""";Action, Adventure, Indie;0 - 20,000;22;7;15;0;0;0
962170;Ultimate Legends;Indie, RPG, Strategy;20,000 - 50,000;1;0;1;0;0;0
962220;Singularity: Tactics Arena;Casual, Indie, Strategy;0 - 20,000;26;2;24;0;0;0
962230;Quicken WillMaker Plus 2019 and Living Trust;Casual, Indie;0 - 20,000;2;0;2;0;0;0
962240;Tiger Tank 59 A-Gun;Adventure, Indie;0 - 20,000;1;3;-2;0;0;0
962250;Solitaire: Learn the Flags!;Adventure, Casual, Indie, Racing, Simulation, Sports;0 - 20,000;4;0;4;0;0;0
962250;Solitaire: Learn the Flags!;Simulation, Early Access;0 - 20,000;4;0;4;0;0;0
962270;Time Virus;RPG;0 - 20,000;1;0;1;0;0;0
962280;Fantom Feast;RPG;0 - 20,000;2;1;1;0;0;0
962290;天罡星宿海 The sea of TianGang XinSu;Adventure;0 - 20,000;11;5;6;0;0;0
962370;The Silver Crusade: Aoorha Axeman;Action;0 - 20,000;2;3;-1;0;0;0
962380;HOT FIT!;Adventure, Indie, Early Access;0 - 20,000;28;7;21;1;1;1
962390;S.A.I.A.'s Awakening: A Robothorium Visual Novel;Indie, Simulation;0 - 20,000;15;9;6;0;0;0
962490;机能女孩-Energy Girl;Action, Adventure, Indie, Strategy;0 - 20,000;1;1;0;0;0;0
962510;The Darkest Woods 2;Indie, Simulation;0 - 20,000;20;4;16;0;0;0
962580;Summer in Mara;RPG, Simulation;100,000 - 200,000;1258;382;876;773;827;31
962610;IScream;Action, Adventure, Casual, Indie, Simulation, Sports;0 - 20,000;3;0;3;0;0;0
962630;Transient: Extended Edition;Indie, Strategy;50,000 - 100,000;167;67;100;2439;4562;1
962650;Paroniria 梦缚;Adventure;20,000 - 50,000;0;1;-1;0;0;0
962700;Chronicle of Innsmouth: Mountains of Madness;Indie;0 - 20,000;57;12;45;172;172;0
962710;We Must Praise Our Glorious Leader The Flumf;Action, Free to Play, Indie;0 - 20,000;3;2;1;0;0;0
962730;Skater XL - The Ultimate Skateboarding Game;Action, Indie;500,000 - 1,000,000;15499;2466;13033;743;290;422
962810;Dark Roll;Casual, Indie, RPG, Simulation, Strategy;20,000 - 50,000;191;30;161;0;0;0
962860;Madland;Action, Indie, RPG;0 - 20,000;0;4;-4;0;0;0
962950;执行人 Executor;Casual, Indie, Strategy;0 - 20,000;14;2;12;0;0;0
962970;My 1/6 Lover;Adventure, Indie, RPG;20,000 - 50,000;440;95;345;103;141;0
963000;Frog Detective 1: The Haunted Island;Action, Indie, Simulation, Sports, Early Access;100,000 - 200,000;3208;258;2950;53;51;10
963020;Ponkle;Adventure, Simulation, Strategy;0 - 20,000;3;0;3;0;0;0
963040;Webcam World View;Adventure, Indie, RPG, Strategy, Early Access;20,000 - 50,000;17;46;-29;0;0;0
963050;Toy Road Constructor;Action, RPG;0 - 20,000;0;1;-1;0;0;0
963150;Pirate Survival Fantasy Shooter;Audio Production, Video Production;0 - 20,000;4;3;1;0;0;0
963170;Citadale - The Ancestral Strain;Audio Production, Video Production;0 - 20,000;4;7;-3;0;0;0
963180;Trash Rage;Casual;0 - 20,000;1;0;1;0;0;0
963200;PixNautiCraft;Action, Adventure, Indie;0 - 20,000;1;3;-2;0;0;0
963210;Another Sight - Hodge's Journey;Action, Adventure, Casual, Free to Play, Indie, RPG, Strategy;50,000 - 100,000;58;30;28;0;0;0
963220;The Bluecoats: North & South;Design & Illustration, Utilities;20,000 - 50,000;59;37;22;0;0;2
963280;Talk to Strangers;Strategy;0 - 20,000;252;14;238;112;136;2
963290;Heroes of Fortunia;Free to Play, Indie, Strategy, Early Access;20,000 - 50,000;49;44;5;0;0;0
963300;Angel, Devil, Elf and Me!;Adventure, Indie;0 - 20,000;0;0;0;7;7;0
963330;Nya Nya Nya Girls (ʻʻʻ)_(=^･ω･^=)_(ʻʻʻ);Action, Indie;200,000 - 500,000;261;67;194;241;308;26
963370;PRiCERPG;Action, Indie;0 - 20,000;7;5;2;0;0;0
963400;SCP: Blackout;RPG;0 - 20,000;176;71;105;647;1103;0
963450;The Eternal Castle [REMASTERED];Casual, Indie;50,000 - 100,000;559;79;480;125;247;1
963470;A Sound Plan;Casual, Free to Play, Indie, Strategy;0 - 20,000;2;0;2;0;0;0
963490;Abyss Manager;Adventure;0 - 20,000;56;16;40;0;0;0
963510;Intersolar Overdrive;Action, Casual, Indie, Massively Multiplayer, Strategy;0 - 20,000;2;0;2;0;0;0
963570;SMOKED;Adventure, Indie;0 - 20,000;11;2;9;0;0;0
963590;Cubic Factory;Adventure, Indie;0 - 20,000;0;1;-1;0;0;0
963660;Write word;Adventure, Casual, Indie;0 - 20,000;12;4;8;0;0;0
963680;Clad in Iron: Sakhalin 1904;Indie;0 - 20,000;27;1;26;0;0;0
963690;Hentai Girl Hime;Action, Indie;50,000 - 100,000;1705;134;1571;140;89;6
963710;Lost in Vivo;Action, Adventure, Casual, Indie, RPG, Simulation, Early Access;100,000 - 200,000;2480;147;2333;134;151;9
963720;Beasts Shall Rise;Casual, Indie, RPG, Simulation;0 - 20,000;3;1;2;0;0;0
963770;Welcome To... Chichester 1/Redux : The Spy Of America And The Long Vacation;Action, Indie, Strategy;0 - 20,000;19;7;12;0;0;0
963830;A Flappy Bird in Real Life;Casual, Indie, Simulation;0 - 20,000;3;1;2;0;0;0
963860;Invaders from Dimension X;Casual, Simulation, Sports;0 - 20,000;7;2;5;0;0;0
963870;Valor & Victory;Action, Casual;0 - 20,000;94;41;53;0;0;1
963900;Chromatic Aberration;Indie, RPG, Strategy, Early Access;0 - 20,000;7;3;4;0;0;0
963910;They That Feast;Action, Adventure, Indie;0 - 20,000;17;19;-2;0;0;0
963930;Contractors;Action, Casual, Indie;200,000 - 500,000;2623;475;2148;147;189;122
963940;Edge;Action, Adventure, Casual, Indie, RPG, Simulation, Early Access;0 - 20,000;2;5;-3;0;0;0
963960;NEONARCADE: adventure puzzle muse;Adventure, Casual, Indie;0 - 20,000;6;0;6;0;0;0
964020;Make Your Kingdom;Casual, Indie;0 - 20,000;118;69;49;0;0;1
964040;Snood;Casual;50,000 - 100,000;159;50;109;0;0;11
964050;Turn the mirror, please.;Software Training, Utilities, Video Production;20,000 - 50,000;2;6;-4;0;0;0
964060;Brainmelter Deluxe;Action, Adventure, Massively Multiplayer, Simulation, Strategy, Early Access;0 - 20,000;6;1;5;0;0;0
964070;Aim Theory - Trainer;Adventure, Casual, Indie;50,000 - 100,000;6;3;3;0;0;0
964080;Endless Universe 2 PC Live Wallpaper;Adventure, RPG;0 - 20,000;33;15;18;0;0;6
964100;A meadow Piece;Action, Casual, Indie, Sports;0 - 20,000;3;2;1;0;0;0
964110;MonGirlTile;Action, Adventure, Indie, Racing, RPG;0 - 20,000;5;0;5;0;0;0
964130;My Colony;Casual, Indie;20,000 - 50,000;120;17;103;0;0;11
964170;PomboTroll;Adventure, Free to Play, Simulation;0 - 20,000;0;3;-3;0;0;0
964180;Late'O'Clock;Action, Adventure, Casual, Indie, Early Access;0 - 20,000;12;2;10;0;0;0
964190;ANSIBLE;Casual, Indie;0 - 20,000;1;2;-1;0;0;0
964210;Mr Husky;Casual, Indie;0 - 20,000;87;6;81;139;139;0
964220;Vampire Bloody Star X;Adventure;0 - 20,000;9;0;9;0;0;0
964230;FUTURE GPX CYBER FORMULA SIN VIER;Action, Massively Multiplayer, Early Access;0 - 20,000;69;22;47;0;0;1
964240;夜之归途 Night Homing;Action, Casual, Indie;0 - 20,000;29;17;12;0;0;0
964340;Fant Kids Matching Game;Casual, Indie, Simulation, Sports;0 - 20,000;4;0;4;0;0;0
964350;At Home Alone;Action, Casual, Indie;100,000 - 200,000;1528;272;1256;0;0;0
964390;Australian Road Trains;Free to Play, Simulation, Strategy;0 - 20,000;4;11;-7;0;0;0
964440;Hell is Others;Action, Casual, Indie, Early Access;200,000 - 500,000;681;264;417;0;0;9
964450;Control Freak;Indie, Early Access;0 - 20,000;0;3;-3;0;0;0
964460;VR Rome;Adventure;0 - 20,000;11;7;4;0;0;0
964570;DCL - The Game;Casual, Indie, RPG, Simulation, Sports, Strategy;20,000 - 50,000;575;132;443;188;191;30
964620;Shakes on a Plane;Indie;0 - 20,000;32;18;14;0;0;0
964650;Invasion Machine;Action, Strategy;20,000 - 50,000;368;116;252;0;0;3
964700;Dear Apothecary;Indie, Massively Multiplayer, Racing, Simulation;0 - 20,000;7;1;6;0;0;0
964750;Nelson and the Magic Cauldron;Action, Adventure, Casual, Indie;0 - 20,000;13;4;9;0;0;0
964770;Deathdays End;Animation & Modeling, Utilities, Early Access;0 - 20,000;5;2;3;0;0;0
964800;Prodeus;Action, Adventure, Indie;100,000 - 200,000;4736;262;4474;223;260;38
964810;SHELL;Action, Casual, Indie, Racing;0 - 20,000;4;0;4;0;0;0
964890;Dream;Adventure, Casual;0 - 20,000;8;2;6;0;0;0
964910;Sunshine & Overcast;Action, Indie, Early Access;0 - 20,000;5;7;-2;0;0;0
964920;Space Tycoon | 星际大亨;Action, Adventure, Indie, RPG;0 - 20,000;7;8;-1;0;0;0
964960;Plunder! All Hands Ahoy;Action, Adventure, Casual, Indie, Racing, Simulation;20,000 - 50,000;11;9;2;0;0;0
964990;Storm Boy;Action, Adventure, Early Access;0 - 20,000;88;13;75;0;0;0
965000;DriftKing 2D;Adventure, Casual, Indie;0 - 20,000;8;3;5;0;0;0
965010;Trinoline All Ages Version;Action, Adventure, Casual, Indie, RPG;0 - 20,000;87;7;80;0;0;0
965030;Run Naked Woman Run;Action, Indie;0 - 20,000;19;11;8;0;0;0
965070;EduNumbers;Casual, Indie;0 - 20,000;2;0;2;0;0;0
965080;江湖求生 Ganghood Survival;Indie;0 - 20,000;120;102;18;0;0;0
965080;江湖求生 Ganghood Survival;Adventure, Indie;0 - 20,000;120;102;18;0;0;0
965110;Space Gladiator;Casual, Indie, Racing, Simulation, Sports;0 - 20,000;1;0;1;0;0;0
965120;能量冲击 Energy Shock;Action, Adventure, Indie;0 - 20,000;59;5;54;0;0;0
965130;History Table: Lore & Quiz;Adventure, Free to Play, Indie, RPG;0 - 20,000;5;3;2;0;0;0
965140;VR Smash Park;Action, Casual, Indie, Strategy, Early Access;0 - 20,000;0;0;0;0;0;0
965200;Walking Zombie 2;Racing, Simulation, Early Access;200,000 - 500,000;8920;1234;7686;173;64;147
965210;Café International;Animation & Modeling, Design & Illustration, Web Publishing;0 - 20,000;15;3;12;0;0;2
965230;DORAEMON  STORY OF SEASONS;Casual, Indie, RPG, Simulation, Strategy, Early Access;50,000 - 100,000;1628;353;1275;0;0;30
965250;SubmarineCraft;Casual, Indie;0 - 20,000;9;3;6;0;0;0
965300;The Settlers : Heritage of Kings - History Edition;Adventure, Indie;50,000 - 100,000;461;77;384;2581;3641;12
965310;The Settlers : Rise of an Empire - History Edition;Casual;50,000 - 100,000;346;95;251;0;0;22
965320;The Settlers 7 : History Edition;Casual, Indie;50,000 - 100,000;391;236;155;56;56;104
965340;;Action, Indie;0 - 20,000;55;7;48;0;0;0
965340;;Indie, Simulation, Early Access;0 - 20,000;55;7;48;0;0;0
965410;Desolate City: The Bloody Dawn Enhanced Edition;Casual, Indie;0 - 20,000;12;2;10;0;0;1
965460;Jungle Guardians;Casual, Indie;0 - 20,000;46;24;22;0;0;0
965470;ROGO;Adventure, Casual, Indie, Strategy;0 - 20,000;18;1;17;0;0;0
965480;Campfire Pro;Casual, Indie, Early Access;50,000 - 100,000;210;67;143;0;0;15
965490;Propaganda Llama;Casual, Indie, Simulation, Strategy;0 - 20,000;16;1;15;0;0;0
965510;Neon Junctions;Adventure, Casual, Indie, Strategy;0 - 20,000;14;1;13;0;0;0
965580;Root;Action, Adventure, Indie, Massively Multiplayer, Simulation, Early Access;100,000 - 200,000;2374;224;2150;355;498;105
965590;Sagrada;Casual, Indie, Simulation;0 - 20,000;224;8;216;104;104;6
965610;Reiner Knizia Yellow & Yangtze;Action, Casual, Indie;0 - 20,000;79;8;71;0;0;1
965620;Wings of Glory;Adventure, Indie, RPG;0 - 20,000;63;10;53;0;0;0
965640;Horror Legends;Indie;20,000 - 50,000;99;12;87;0;0;0
965670;Niplheim's Hunter - Branded Azel;Adventure, Free to Play, Indie;20,000 - 50,000;667;66;601;0;0;11
965680;Boomerang Fu;Casual, Indie;100,000 - 200,000;1410;59;1351;865;320;39
965730;Evoke;Action, Adventure, Indie;0 - 20,000;0;3;-3;0;0;0
965760;Super Darts VR;Casual, Indie;0 - 20,000;1;1;0;0;0;0
965810;Kara no Shojo;Action, Indie;0 - 20,000;61;3;58;0;0;0
965820;沉睡的法则 Things as They Are;Action, Adventure, Indie;20,000 - 50,000;929;22;907;12;12;30
965830;Deported: Drain the Swamp;Casual, Indie, Simulation, Early Access;20,000 - 50,000;49;7;42;0;0;0
965840;Club Lighting;Action, Adventure, Indie;0 - 20,000;3;7;-4;0;0;0
965860;SnowNight;Utilities;0 - 20,000;338;25;313;0;0;0
965880;Whimsical Quest;Action, Indie;0 - 20,000;4;1;3;0;0;0
965890;我是渣男-Dishonest;Casual, Indie, RPG, Simulation;20,000 - 50,000;256;24;232;0;0;0
965900;Animal Force;Indie, Simulation, Strategy;0 - 20,000;3;2;1;0;0;0
965920;RocketGO;Casual, Early Access;0 - 20,000;22;4;18;0;0;0
965940;Qu-tros;Casual, Indie;0 - 20,000;10;14;-4;0;0;0
965960;VRetired;Action, Indie;0 - 20,000;4;1;3;0;0;0
965970;My Exotic Farm;RPG;0 - 20,000;0;3;-3;0;0;0
965990;Destiny's Sword;Action, Casual, Indie;50,000 - 100,000;16;7;9;0;0;0
966000;Detective Sherlock Pug - Hidden Object. Relaxing games;Casual, Indie, RPG;0 - 20,000;38;18;20;0;0;0
966010;Anstorm;Adventure, Casual, Indie, RPG, Simulation, Strategy;0 - 20,000;44;11;33;0;0;0
966070;Relow;Action, Indie;0 - 20,000;80;7;73;0;0;0
966090;Canasta 3D Premium;Action, Adventure, Indie, Massively Multiplayer, Simulation, Strategy;0 - 20,000;37;12;25;0;0;8
966140;MagicJam;Casual;0 - 20,000;0;1;-1;0;0;0
966160;Seek Love;Casual, Indie;0 - 20,000;9;16;-7;0;0;0
966180;Slime Research;Free to Play, Indie, RPG, Early Access;20,000 - 50,000;6;0;6;0;0;0
966190;Lost Marbles;Casual, Indie;0 - 20,000;16;0;16;0;0;0
966210;Tippy Tree;Indie, Simulation, Sports;0 - 20,000;9;2;7;0;0;0
966240;Ocean's Treasures;Action, Adventure, Casual, Indie, Racing;0 - 20,000;2;1;1;0;0;0
966250;Homestead;Casual, Strategy;0 - 20,000;1;1;0;0;0;0
966320;Later Alligator;Action, Indie, Early Access;50,000 - 100,000;1765;54;1711;71;78;6
966330;Flower;Action, Adventure, Indie;200,000 - 500,000;2806;617;2189;41;62;5
966370;Bravado;Casual;0 - 20,000;6;7;-1;0;0;0
966400;Speaking Simulator;Action, Free to Play, Indie;0 - 20,000;40;8;32;0;0;1
966420;Hell Breaker;Adventure;50,000 - 100,000;7;2;5;0;0;0
966430;Neverinth;Action, Adventure, Indie;20,000 - 50,000;703;281;422;0;0;2
966430;Neverinth;Action, Adventure, Indie, Strategy, Early Access;20,000 - 50,000;703;281;422;0;0;2
966450;I'm the Koala;Adventure, Casual, Free to Play, Indie;0 - 20,000;7;0;7;0;0;0
966470;Tale of Ninja: Fall of the Miyoshi;Adventure;0 - 20,000;29;12;17;0;0;0
966530;You have a drunk friend;Action, Adventure, Indie;0 - 20,000;194;110;84;13;13;0
966530;You have a drunk friend;Adventure, Indie, Simulation;0 - 20,000;194;110;84;13;13;0
966540;Bedtime Blues;Action, Adventure, RPG, Early Access;0 - 20,000;5;6;-1;0;0;0
966560;ROGAN: The Thief in the Castle;Action, Adventure, Indie, RPG;0 - 20,000;76;69;7;0;0;0
966580;Zquirrels Jump;Casual, Indie;0 - 20,000;31;11;20;0;0;0
966590;Beat Blocks VR;Action, Indie, Early Access;0 - 20,000;19;0;19;0;0;0
966610;FPS Monitor – hardware in-game & desktop overlays;Adventure, RPG;50,000 - 100,000;1257;203;1054;1534;1892;196
966630;qop 4;Adventure, RPG, Simulation;20,000 - 50,000;189;7;182;0;0;3
966630;qop 4;Adventure, Free to Play, Indie, RPG;20,000 - 50,000;189;7;182;0;0;3
966660;Invisible Fist;Indie, Simulation, Sports;0 - 20,000;12;1;11;0;0;0
966670;The Wanderer: Frankenstein’s Creature;Adventure, RPG, Strategy;0 - 20,000;139;26;113;0;0;1
966680;Red Matter;Action, Adventure, Indie;20,000 - 50,000;786;78;708;139;139;5
966720;Pumped BMX Pro;Casual, Indie, Simulation, Strategy;0 - 20,000;85;24;61;1;1;0
966730;Leprechaun Shadow;Action, Adventure, Free to Play, Indie;0 - 20,000;2;0;2;0;0;0
966760;The Yellow Quiz;Action, Indie;0 - 20,000;5;7;-2;0;0;0
967050;Pacify;Action, Casual, Indie;2,000,000 - 5,000,000;31227;4493;26734;201;127;492
967060;Raffle Blast;Indie, Simulation, Sports;0 - 20,000;1;0;1;0;0;0
967100;Curfew;Action, Indie;0 - 20,000;3;2;1;0;0;0
967120;Cursed Mansion;Action, Indie, RPG;20,000 - 50,000;28;4;24;0;0;0
967130;XWidget;Action, Indie;50,000 - 100,000;282;88;194;6570;6542;14
967180;Frozen Mystery;Indie;20,000 - 50,000;2;7;-5;0;0;0
967210;Spark Five;Indie, Simulation;20,000 - 50,000;3;0;3;0;0;0
967240;MONKEY KING: HERO IS BACK;Indie, Simulation, Sports;0 - 20,000;209;240;-31;0;0;0
967250;DOKA 2 KISHKI EDITION;Action, Adventure, Free to Play, Indie;100,000 - 200,000;2727;485;2242;156;176;143
967290;Mò The Frog;Casual, Indie;0 - 20,000;6;2;4;0;0;0
967330;Starfighter: Infinity;Action, Casual, Indie;0 - 20,000;104;11;93;0;0;3
967370;Dungeons of Necromancers;Audio Production, Utilities, Video Production;0 - 20,000;6;4;2;0;0;0
967390;Chronos: Before the Ashes;Action, Adventure, Casual, Indie, Strategy;20,000 - 50,000;317;166;151;1522;1522;2
967410;Creatures Inc;Adventure;0 - 20,000;91;70;21;0;0;0
967430;Nights at the Clown Maze;Casual, Indie, Simulation;0 - 20,000;5;9;-4;0;0;0
967440;Kick The Anime Simulator;Casual, Free to Play, Indie, Racing, Strategy;0 - 20,000;36;72;-36;0;0;0
967450;Special Counter Force Attack;Action, Casual, Indie, Strategy;0 - 20,000;8;5;3;0;0;0
967460;Red Eclipse 2;Action, Indie;100,000 - 200,000;501;93;408;0;0;2
967490;Microsoft Maquette;Adventure, Free to Play, Indie, Massively Multiplayer, RPG, Early Access;50,000 - 100,000;73;7;66;2;3;0
967910;Galactic Incoming;Action, Adventure, Casual, Indie;0 - 20,000;1;0;1;0;0;0
967940;Assault On Metaltron;Action, Casual, Indie, Simulation;0 - 20,000;2;0;2;0;0;0
967960;Spray Dynamite X Radioactive Insects;Action, Indie;0 - 20,000;1;2;-1;0;0;0
968170;[it's possible] Classic;Free to Play, Strategy, Early Access;0 - 20,000;11;0;11;0;0;0
968200;Jump Jumpz;Action, Indie, Early Access;0 - 20,000;18;13;5;0;0;0
968210;Predicate;Action, Casual, Free to Play, Indie;0 - 20,000;4;0;4;0;0;0
968250;King of Retail;Adventure, Indie, Strategy;100,000 - 200,000;2715;271;2444;1012;1329;92
968290;Deported 2: Build That Wall;Action, Adventure, Indie, RPG, Early Access;0 - 20,000;36;3;33;0;0;0
968310;Breathe Peace World;Casual, Indie;0 - 20,000;18;2;16;0;0;0
968320;Alpha & Beta;Action;0 - 20,000;22;3;19;0;0;0
968350;Hotel Sowls;Adventure, Indie;20,000 - 50,000;472;16;456;0;0;0
968360;Recursive Pain;Adventure, Casual;0 - 20,000;13;5;8;0;0;0
968370;The Blind Prophet;Action, Casual;0 - 20,000;242;28;214;0;0;1
968380;Perfect Life VR;Adventure, Indie;0 - 20,000;4;2;2;0;0;0
968410;AstroGenesis;Action, Casual, Indie;0 - 20,000;1;4;-3;0;0;0
968420;Fururu Project : Ruby;Casual, Indie, Simulation;0 - 20,000;119;5;114;0;0;0
968430;Colonization of the Moon;Adventure, Casual, Indie;0 - 20,000;2;8;-6;0;0;0
968440;Artist Idle;Casual, Indie, Simulation, Sports;50,000 - 100,000;284;141;143;0;0;22
968450;Hentai Puzzle Classic;Action, Adventure, Casual, Indie, Simulation;0 - 20,000;13;10;3;0;0;0
968460;Mine Royale - Battle Royale;Casual, Indie, Simulation;0 - 20,000;18;8;10;0;0;0
968470;Bunny Mahjo;Action, Casual, Indie, Simulation;0 - 20,000;31;2;29;0;0;0
968480;The Portal Dimension - Bizarre Huntseeker;Action, Casual, Simulation;0 - 20,000;5;1;4;0;0;0
968500;A Bewitching Revolution;Casual, Indie, Simulation;0 - 20,000;251;13;238;0;0;0
968500;A Bewitching Revolution;Casual, Early Access;0 - 20,000;251;13;238;0;0;0
968540;Too Hot!;Casual, Indie;0 - 20,000;2;2;0;0;0;0
968570;Chaordic;Indie;0 - 20,000;17;3;14;0;0;0
968580;Halloween Puzzles;Casual, Indie, Strategy;0 - 20,000;1;2;-1;0;0;0
968590;Super Urban Wizard;Adventure, Indie;0 - 20,000;0;6;-6;0;0;0
968600;Angry Punisher;Casual, Free to Play, Indie;0 - 20,000;8;0;8;0;0;0
968620;Bomb N' Bats;;0 - 20,000;2;1;1;0;0;0
968700;The Kite;Action;100,000 - 200,000;609;130;479;0;0;0
968760;Blood Card 2: Dark Mist;Action, Casual, Indie;0 - 20,000;198;32;166;0;0;3
968790;DYNASTY WARRIORS 7: Xtreme Legends Definitive Edition;Audio Production;50,000 - 100,000;974;158;816;1186;2026;68
968820;Stormhill Mystery: Family Shadows;Adventure, Indie;0 - 20,000;91;23;68;31;31;2
968870;Close to the Sun;Action, Adventure, Indie, Simulation;100,000 - 200,000;607;210;397;391;391;7
968920;It's Not A Moon;Indie, Racing, Simulation;0 - 20,000;1;4;-3;0;0;0
968950;Sakura MMO 2;Action, Casual, Indie, Strategy;0 - 20,000;136;18;118;97;149;2
968970;Lumberjack's Dynasty;Indie;50,000 - 100,000;1572;612;960;1121;1562;138
968980;Glass Painting: Winter Art;Utilities;0 - 20,000;2;11;-9;0;0;0
968990;Mean Routine;Action, Free to Play, Indie;0 - 20,000;6;6;0;0;0;0
969020;Movavi Video Editor 15 Plus - Video Editing Software;Sports, Early Access;0 - 20,000;367;85;282;1162;1904;15
969060;mikapyon;Action, Casual, Indie;0 - 20,000;8;1;7;0;0;0
969130;The Lost Soul;Indie;0 - 20,000;15;3;12;0;0;0
969200;OkunoKA Madness;Action, Casual, Indie, Racing, Sports;0 - 20,000;7;3;4;0;0;0
969220;Up in the Air;Casual;0 - 20,000;27;5;22;0;0;1
969230;Death Space;Casual;0 - 20,000;10;21;-11;0;0;0
969240;Siam Twinstick;Simulation;0 - 20,000;5;1;4;0;0;0
969250;Flynguin Station;Action, Indie, Simulation;0 - 20,000;34;2;32;0;0;0
969340;The Dungeon Paradox;Adventure, Indie;0 - 20,000;5;0;5;0;0;0
969350;Hentai Memorama;;0 - 20,000;5;1;4;0;0;0
969480;Warp Glider;Action, Indie;0 - 20,000;25;0;25;0;0;0
969530;Cope Island: Adrift;Action;0 - 20,000;6;0;6;0;0;0
969540;Pattern;Casual, Free to Play, Simulation, Sports;0 - 20,000;25;7;18;0;0;0
969680;Steel Circus;Action, Indie, RPG, Early Access;0 - 20,000;1581;761;820;64;20;0
969690;Brave Hero Yuusha EX;Action, Adventure, Indie;0 - 20,000;30;2;28;0;0;0
969740;Yearning;Indie, Sports, Early Access;0 - 20,000;9;0;9;0;0;0
969760;Omno;Casual;100,000 - 200,000;1351;106;1245;137;137;8
969860;Corrupt The Priest;Casual, Indie;0 - 20,000;1;6;-5;0;0;0
969880;Terrible Beast from the East;Action, Indie;0 - 20,000;46;55;-9;0;0;0
969940;Car Transporter 2013;Adventure, RPG;0 - 20,000;4;5;-1;0;0;0
969950;Woodcutter Simulator 2011;Action, Strategy;0 - 20,000;1;3;-2;0;0;0
969970;BattleRush: Ardennes Assault;Action, Adventure;0 - 20,000;35;31;4;0;0;0
969990;SpongeBob SquarePants: Battle for Bikini Bottom - Rehydrated;Adventure, RPG;500,000 - 1,000,000;12788;699;12089;350;226;135
970000;Puzzles for smart: Horses;;0 - 20,000;9;2;7;0;0;0
970090;Snares of Ruin Zero;Indie;0 - 20,000;11;0;11;0;0;0
970130;Trinity VR;Adventure, Casual, Indie;0 - 20,000;10;11;-1;0;0;0
970140;Reynard;Indie, Simulation, Strategy, Early Access;0 - 20,000;27;7;20;0;0;0
970150;Hentai Plus Girl;Casual, Free to Play, Indie;0 - 20,000;0;0;0;0;0;0
970180;3 Days in the Abyss;Action;0 - 20,000;3;4;-1;0;0;0
970190;Sierra Madre: The Wild West;Indie;0 - 20,000;28;18;10;0;0;0
970200;Campido;Action, Casual, Indie;0 - 20,000;4;1;3;0;0;0
970210;Witoo VR photo viewer;Action, Adventure, RPG;0 - 20,000;8;4;4;0;0;0
970220;Ancra;Casual, Free to Play, Indie, Simulation;20,000 - 50,000;13;0;13;0;0;1
970240;Dr. Schplot's Nanobots;RPG;0 - 20,000;4;0;4;0;0;0
970260;Hulì The Mage;Free to Play, Indie;0 - 20,000;4;3;1;0;0;0
970300;Re.poly;Adventure, Casual, Indie, Simulation, Early Access;0 - 20,000;61;4;57;0;0;3
970360;The Last Sphinx ARG;Casual, Indie;0 - 20,000;0;1;-1;0;0;0
970370;Gala Collider;Adventure, Strategy;0 - 20,000;27;16;11;0;0;1
970370;Gala Collider;Indie, RPG;0 - 20,000;27;16;11;0;0;1
970400;Our Lovely Escape;Action, Adventure, Indie;;;;0;;;
970450;Descent of Man;Adventure, Casual, Indie;0 - 20,000;7;8;-1;0;0;0
970460;Spot The Oddity;Adventure, Casual, Indie;0 - 20,000;3;2;1;0;0;0
970470;Emerald Shores;Action, Indie;0 - 20,000;6;0;6;0;0;0
970500;秦殇 (Prince of Qin);Casual;200,000 - 500,000;1509;452;1057;27;39;72
970510;蓝宝石般的被害妄想少女/Damsel with persecutory delusion;Casual, Indie, Massively Multiplayer, Simulation, Strategy;20,000 - 50,000;686;82;604;781;781;19
970530;黑暗料理?!;Adventure, Indie, RPG;0 - 20,000;11;7;4;0;0;0
970550;Color Chain;Adventure, Indie, RPG;0 - 20,000;1;2;-1;0;0;0
970560;STEINS;Adventure, Indie, Strategy;;;;0;;;
970570;CHAOS;Casual, Early Access;;;;0;;;
970580;Cubicity: Slide puzzle;Casual, Indie;0 - 20,000;36;7;29;0;0;0
970600;Paranoia: Deliver Me;Action, Indie, Strategy, Early Access;0 - 20,000;98;29;69;0;0;1
970610;CHECKMATE : Battle Arenas;Free to Play, Indie, Strategy;0 - 20,000;10;8;2;0;0;0
970620;Castle Rencounter;Adventure, Indie;0 - 20,000;5;15;-10;0;0;0
970650;Dig to the Stars;Simulation, Strategy;0 - 20,000;0;8;-8;0;0;0
970660;Nuclear Power Station Creator;Racing, Sports;0 - 20,000;9;55;-46;0;0;0
970680;Snowballed: Crazy Downhill;Casual, Early Access;20,000 - 50,000;0;4;-4;0;0;0
970690;Operation Snowman;Action, Casual;0 - 20,000;3;5;-2;0;0;0
970710;Kolumno;Casual;0 - 20,000;20;14;6;0;0;0
970730;Ball Out;Casual, Indie, Strategy;0 - 20,000;38;5;33;0;0;0
970760;Khaos Wind;Action, Indie;0 - 20,000;5;0;5;0;0;0
970800;Short Circuit VR;Action, Casual, Indie;20,000 - 50,000;95;22;73;0;0;0
970810;Julie's Sweets;Action, Indie, Early Access;0 - 20,000;7;1;6;0;0;0
970830;The Dungeon Of Naheulbeuk: The Amulet Of Chaos;Action, Adventure, Casual, Indie, RPG, Simulation, Sports, Strategy;500,000 - 1,000,000;5372;703;4669;77;82;158
970840;OVERPASS;Adventure, Casual;0 - 20,000;71;96;-25;0;0;0
970850;1001 Jigsaw. Legends of Mystery;Adventure, Free to Play, Simulation;0 - 20,000;14;3;11;0;0;0
970870;1001 Jigsaw. Earth Chronicles;Adventure, Casual, Indie, RPG, Simulation, Strategy;0 - 20,000;12;4;8;0;0;0
970880;1001 Jigsaw. World Tour: Australian Puzzles;Action, Indie;0 - 20,000;5;4;1;0;0;0
970890;1001 Jigsaw. World Tour: London;Action, Indie, Sports;0 - 20,000;5;2;3;0;0;1
970900;1001 Jigsaw. Home Sweet Home;Casual, Indie;0 - 20,000;9;2;7;0;0;0
970910;1001 Jigsaw. World Tour: Great America;Casual;0 - 20,000;7;3;4;0;0;0
970940;The Unicorn Princess;Adventure, Casual, Indie;0 - 20,000;25;18;7;0;0;1
970940;The Unicorn Princess;Simulation;0 - 20,000;25;18;7;0;0;1
970960;Rebel Cops;Casual, Indie, Strategy;100,000 - 200,000;993;311;682;279;259;8
970970;Crappy Tube;Adventure, Indie;0 - 20,000;3;13;-10;0;0;0
970980;VR INTERACTIVE TRAILER: Runes;Casual, Free to Play, Indie;20,000 - 50,000;8;0;8;0;0;0
971030;SkateBIRD;Free to Play, Strategy;20,000 - 50,000;462;86;376;10;10;4
971040;Pipeline VR;Action, Adventure, Indie, Simulation;0 - 20,000;13;2;11;0;0;0
971060;Mystery Case Files: The Countess Collector's Edition;Adventure, Casual, Indie, Simulation;0 - 20,000;12;5;7;0;0;0
971070;Dark Parables: The Match Girl's Lost Paradise Collector's Edition;Action, Adventure, Casual, Indie;0 - 20,000;12;2;10;0;0;0
971080;Shadow Wolf Mysteries: Under the Crimson Moon Collector's Edition;Adventure;0 - 20,000;4;0;4;0;0;0
971090;Hidden Object: Home Makeover;Adventure, Indie, Strategy, Early Access;0 - 20,000;2;3;-1;0;0;0
971100;Haunted Legends: The Dark Wishes Collector's Edition;Adventure, Simulation;0 - 20,000;1;0;1;0;0;0
971120;Forgiveness : Escape Room;Indie;0 - 20,000;76;34;42;0;0;0
971130;Anubis' Challenge;Casual, Indie;0 - 20,000;14;0;14;0;0;0
971150;B.O.T.S. and the Robofriends;Casual, Indie;0 - 20,000;9;0;9;0;0;0
971160;Möbius Front '83;Casual, Indie;20,000 - 50,000;266;118;148;122;122;3
971180;8bit Arena;Casual, Indie, Strategy;0 - 20,000;2;3;-1;0;0;0
971210;ChronoBreach;Casual;20,000 - 50,000;259;5;254;0;0;0
971230;Daedalic Complex;Casual, Indie;20,000 - 50,000;1;1;0;0;0;0
971280;Bomber Arena;Indie, Simulation, Strategy;0 - 20,000;9;8;1;0;0;0
971340;Orc Towers VR;Adventure, Free to Play, Indie;0 - 20,000;2;1;1;0;0;0
971350;Robert Rodriguez’s THE LIMIT: An Immersive Cinema Experience;Adventure, Indie, RPG;0 - 20,000;43;29;14;0;0;0
971430;From Beyond Prologue;Indie, Simulation;0 - 20,000;86;2;84;0;0;0
971460;FPS Training;Action;0 - 20,000;52;25;27;0;0;0
971460;FPS Training;Action;0 - 20,000;52;25;27;0;0;0
971480;Kitten Love Emulator;Action, Adventure, Indie;0 - 20,000;30;6;24;0;0;0
971500;Bubble Burst;Simulation;0 - 20,000;22;1;21;0;0;0
971530;VoidGate;Casual, Indie;0 - 20,000;3;1;2;0;0;0
971540;SAMS;Indie, Simulation, Strategy, Early Access;0 - 20,000;14;8;6;0;0;0
971610;Gyro Boss DX;Adventure, Indie, RPG;0 - 20,000;11;3;8;0;0;0
971620;Puyo Puyo Champions;Action, Early Access;100,000 - 200,000;570;143;427;385;385;102
971640;DragonScales 5: The Frozen Tomb;Casual, Indie;0 - 20,000;1;1;0;0;0;0
971650;Failspace;Casual, Indie;0 - 20,000;27;16;11;0;0;4
971680;Montaro RE;Action, Casual, Indie;50,000 - 100,000;1155;49;1106;11;11;2
971690;Cake Bash;Action, Indie;20,000 - 50,000;220;23;197;0;0;3
971740;The Wizard's Tower;Action, Early Access;0 - 20,000;7;0;7;0;0;0
971780;Elemental Connection;Adventure, Casual, Indie;0 - 20,000;8;0;8;0;0;0
971880;Solitaire Mystery: Four Seasons;Casual, Free to Play, Indie;0 - 20,000;8;5;3;0;0;0
971900;Draft Day Sports: Pro Basketball 2019;Action, Indie;0 - 20,000;3;6;-3;0;0;0
972010;Raiders! Forsaken Earth;Action, Adventure, Indie;50,000 - 100,000;181;41;140;0;0;1
972050;Super Captain 3D;Adventure, Indie;0 - 20,000;6;1;5;0;0;0
972080;Bots Rush;Action;0 - 20,000;3;0;3;0;0;0
972160;The Witch's Love Diary;Action, Adventure, Casual, Indie;0 - 20,000;77;5;72;0;0;0
972170;ECHO OF SOUL;Action, Casual, Indie;0 - 20,000;329;133;196;34;34;0
972180;Geno The Fallen King;Action;0 - 20,000;11;2;9;0;0;0
972200;祛魅·入灭（祛魅2） - Disenchantment Nirvana;Action, Casual, Indie;0 - 20,000;30;9;21;0;0;0
972230;WatchFamily;Casual, Indie, RPG, Simulation;0 - 20,000;4;2;2;0;0;0
972280;Deep Space Shooter;Adventure, Casual, Indie;50,000 - 100,000;17;6;11;0;0;0
972290;FlyingMetalSuit;Action, Casual, Indie;0 - 20,000;11;3;8;0;0;0
972390;DashboardX;Indie, Simulation, Strategy;0 - 20,000;39;1;38;0;0;0
972420;Houdini's Castle;Adventure, Casual, Indie, RPG, Simulation, Sports, Strategy;0 - 20,000;8;1;7;0;0;0
972430;Super Jigsaw Puzzle: Anime;Casual, Indie, Racing, Simulation, Sports;0 - 20,000;8;4;4;0;0;0
972480;Dog In A Box;Action, Casual, Free to Play;0 - 20,000;1;1;0;0;0;0
972510;Thingamajig;Casual, Indie;0 - 20,000;3;0;3;0;0;0
972520;The Misadventure Of Melon;Casual;0 - 20,000;9;2;7;0;0;0
972560;Termite;Casual;0 - 20,000;15;8;7;0;0;0
972600;Block Pooper 9;Casual;0 - 20,000;14;7;7;0;0;0
972620;Gems Kingdom;Casual;20,000 - 50,000;1;3;-2;0;0;0
972650;Actual Volleyball;Casual;0 - 20,000;1;1;0;0;0;0
972660;Spiritfarer: Farewell Edition;Action, Adventure, Indie, Simulation;500,000 - 1,000,000;27665;1213;26452;731;436;948
972740;KOBOLD: Chapter I;Adventure, Indie, RPG;20,000 - 50,000;216;48;168;26;26;0
972760;Secret Saga: Xamadeon Stone;Action, Adventure, Indie;0 - 20,000;52;15;37;0;0;1
972760;Secret Saga: Xamadeon Stone;Action, Adventure, Casual, Indie;0 - 20,000;52;15;37;0;0;1
972770;Thousand Threads;Action, Adventure, Free to Play, Indie;0 - 20,000;65;12;53;60;60;1
972850;The Blame;Action, Adventure, Casual, Indie;0 - 20,000;23;3;20;0;0;0
972890;RideOp - VR Thrill Ride Experience;Casual, Indie;20,000 - 50,000;43;20;23;0;0;0
972910;Timore 6;Indie, RPG;0 - 20,000;29;7;22;0;0;0
972920;Rebirth;Action, Adventure, Indie, RPG;0 - 20,000;14;22;-8;0;0;0
972940;stepbystep;Indie;0 - 20,000;9;2;7;0;0;0
972960;Invasion;Action, Adventure, Casual, Indie;0 - 20,000;21;0;21;0;0;0
972990;Hopper Rabbit;Indie;0 - 20,000;20;1;19;0;0;0
973000;Die Young: Prologue;Action, Adventure, Indie, RPG;50,000 - 100,000;281;85;196;23;38;0
973040;Kobold Slayer;Education;0 - 20,000;2;2;0;0;0;0
973050;Ashes of the Night;Indie, Early Access;0 - 20,000;44;7;37;0;0;1
973060;Evil Maze 2 | 惡魔迷宮 2;Action, Adventure, Indie, RPG;0 - 20,000;66;29;37;0;0;1
973070;Bound By Blades;Action, Casual, Indie, RPG, Simulation;0 - 20,000;55;2;53;0;0;0
973090;Toilet Simulator 2020;Casual;20,000 - 50,000;347;154;193;0;0;0
973100;Super Realistic Autocross;Casual, Indie, Simulation;0 - 20,000;11;0;11;0;0;0
973110;Hay Day Farm 2019 - 卡通农场;Adventure, Free to Play, Indie;0 - 20,000;4;11;-7;0;0;0
973170;RoboBall;Free to Play, Indie, RPG;0 - 20,000;24;7;17;0;0;0
973200;Case Simulator Weapons and Armors;Action, Casual, Indie;0 - 20,000;3;0;3;0;0;0
973230;We Who Are About To Die;Adventure, Indie;100,000 - 200,000;3132;354;2778;264;426;296
973240;Anime And Your Life;Action, Adventure, Casual, Indie, Strategy;0 - 20,000;59;32;27;0;0;0
973250;Altered;Casual, Indie;0 - 20,000;72;0;72;0;0;0
973260;Aurora;Casual, Indie;0 - 20,000;1;2;-1;0;0;0
973300;Super Lolicon Puzzle Simulator 2019;Casual, Indie;0 - 20,000;34;6;28;0;0;1
973310;Symphony of Stars;Action, Adventure, Casual;0 - 20,000;1;3;-2;0;0;0
973350;Warriors Of Ragnarök;Action, Adventure;0 - 20,000;2;0;2;0;0;0
973360;Evenness Sensory Space;Indie;0 - 20,000;1;0;1;0;0;0
973390;Empires:The Rise;Free to Play, Indie, Simulation;20,000 - 50,000;37;24;13;0;0;0
973410;The Elementalist;Action, Adventure, Indie;0 - 20,000;9;0;9;0;0;0
973440;Otokomizu～漢水～;Simulation, Strategy;0 - 20,000;30;4;26;0;0;0
973450;Ancient Abyss;Action, Casual, Indie;0 - 20,000;131;53;78;0;0;0
973560;踏马的世界;Action, Casual, Indie;0 - 20,000;3;5;-2;0;0;0
973580;Sniper Ghost Warrior Contracts;Casual, Indie;500,000 - 1,000,000;7340;2603;4737;483;455;284
973590;Movavi Video Converter Premium 19;Action, Adventure, Casual, Indie;0 - 20,000;22;12;10;0;0;1
973600;Movavi Video Suite 18 - Video Making Software - Edit, Convert, Capture Screen, and more;Casual, Indie, Sports, Early Access;0 - 20,000;691;194;497;128;128;61
973640;The Breach: A VR Escape Game;Casual;0 - 20,000;1;9;-8;0;0;0
973690;Antrum;Adventure, Indie;0 - 20,000;1;0;1;0;0;0
973700;Disassembly VR;Indie, Strategy;0 - 20,000;84;62;22;137;137;2
973760;Thronebreaker: The Witcher Tales;Adventure, Free to Play, Indie;500,000 - 1,000,000;12553;1630;10923;1320;325;160
973800;Dragon World;Adventure, Indie;0 - 20,000;43;21;22;0;0;0
973810;Journey To The Savage Planet;Action;200,000 - 500,000;4054;539;3515;327;323;35
973850;Gorytale;Casual;0 - 20,000;60;6;54;0;0;0
973860;CYPEST Underground;Action, Adventure, Indie, Simulation;0 - 20,000;5;1;4;0;0;0
974010;Zero spring episode 2;Casual, Free to Play, Indie, Strategy;0 - 20,000;3;5;-2;0;0;0
974040;BattleMore;Adventure, Free to Play, RPG;0 - 20,000;5;1;4;0;0;0
974070;Juggly;Casual;0 - 20,000;1;0;1;0;0;0
974090;Gravity Bone;Adventure, Casual;20,000 - 50,000;302;23;279;0;0;0
974110;Zeroptian Invasion;Adventure, Casual;0 - 20,000;24;1;23;0;0;0
974150;WellTown;Casual, Indie;0 - 20,000;19;7;12;0;0;0
974160;Stupid Cupid;Adventure, Indie, RPG, Early Access;0 - 20,000;8;1;7;0;0;0
974180;Falnarion Tactics;Casual, Indie;0 - 20,000;22;5;17;0;0;0
974200;异霊 皓月空华;Action, Adventure, Casual, Indie;20,000 - 50,000;68;12;56;0;0;0
974240;Detective escape1;Action, Casual, Indie, Sports;0 - 20,000;8;4;4;0;0;0
974250;Grooming Adventure;Indie, Simulation;0 - 20,000;7;1;6;0;0;0
974310;A Matter of Time;Casual, Indie, Simulation;0 - 20,000;7;4;3;0;0;0
974320;Hentai Dreams;Adventure, Casual, Indie;0 - 20,000;0;0;0;0;0;0
974370;Chop is dish;Action, Casual, Indie, Early Access;0 - 20,000;34;15;19;0;0;0
974390;Metaloid : Origin;Casual, Indie, Racing, Simulation, Sports;0 - 20,000;25;6;19;0;0;0
974430;Galactic Campaign;Action, Casual, Indie;0 - 20,000;1;0;1;0;0;0
974450;三和大神;Indie, Simulation, Sports;20,000 - 50,000;15;27;-12;0;0;0
974470;Girls Free;Action, Casual, Indie;0 - 20,000;0;0;0;0;0;1
974520;Ultimo Reino;Action, Casual, Indie;0 - 20,000;9;16;-7;0;0;0
974530;Draft Day Sports: Pro Football 2019;Casual, Indie, Simulation;0 - 20,000;3;3;0;0;0;0
974600;Retro Wing Prime;Adventure, Casual, RPG, Strategy;0 - 20,000;7;1;6;0;0;0
974620;Ultrawings FLAT;Action, Indie, Racing, Simulation;0 - 20,000;8;10;-2;0;0;0
974670;DREAM GIRLS VR;Adventure, Casual, Indie, RPG, Strategy;0 - 20,000;5;5;0;0;0;0
974830;The Art Theft by Jay Doherty;Animation & Modeling, Design & Illustration, Utilities, Early Access;0 - 20,000;29;2;27;0;0;0
974850;Flan;Adventure, Casual, Indie;0 - 20,000;12;2;10;0;0;0
974860;Condition Red;Adventure, Casual, Indie;0 - 20,000;3;0;3;0;0;0
974870;FIREWORK;Adventure, Casual, Indie;0 - 20,000;37;3;34;0;0;0
974910;Magical Diary: Wolf Hall;Action, Adventure, Casual, Massively Multiplayer;0 - 20,000;166;13;153;0;0;4
974920;New Adult Reality;Casual, Indie;0 - 20,000;1;1;0;0;0;0
974950;DAMNOSAUR;Indie, Strategy, Early Access;50,000 - 100,000;272;21;251;0;0;2
974970;Blocky McBlockFace;Adventure, Casual, Indie, Early Access;0 - 20,000;14;3;11;0;0;0
975000;NO, THANK YOU!!!;Action, Casual, Indie;0 - 20,000;9;1;8;0;0;0
975020;The Spirit Master of Retarnia -Conqueror of the Labyrinth-;Action, Casual, Indie;0 - 20,000;22;7;15;104;104;1
975030;Abandoned;Action, Adventure, Casual, Indie, RPG, Early Access;0 - 20,000;31;49;-18;0;0;0
975050;Orphan of the Petal;Casual, Indie;20,000 - 50,000;48;17;31;0;0;0
975100;Justice: Fallen Clan;Casual, Indie, Strategy;0 - 20,000;1;1;0;0;0;0
975110;No Crossing;Action, Indie;0 - 20,000;1;0;1;0;0;0
975120;~necromancy~Emily's Escape;Casual;20,000 - 50,000;285;169;116;0;0;1
975150;Resolutiion;Adventure, Casual, Indie, Racing, Simulation, Sports;0 - 20,000;85;32;53;2;2;0
975200;Red points;Action, Casual, Indie;0 - 20,000;16;17;-1;0;0;0
975220;A Business Power;Action, Indie;0 - 20,000;0;2;-2;0;0;0
975230;Das Geisterschiff / The Ghost Ship;Action, Early Access;0 - 20,000;26;5;21;0;0;0
975240;Hentai Shooter 3D: Christmas Party;Action, Adventure, Indie;0 - 20,000;139;36;103;0;0;0
975270;军团战棋Legion War;Action, Casual, Indie;;;;0;;;
975290;The Pepper Prince: Episode 1 - Red Hot Chili Wedding;Action, Adventure, Casual, Free to Play, Racing, Simulation, Sports;0 - 20,000;22;1;21;0;0;0
975350;Mojo XXX;Action, Indie, Simulation, Strategy, Early Access;0 - 20,000;0;0;0;0;0;1
975370;Dwarf Fortress;Action, Adventure, Free to Play, Indie, RPG;500,000 - 1,000,000;18214;843;17371;1733;869;3601
975390;Dodgeball Simulator VR;Action, Indie;0 - 20,000;36;6;30;0;0;0
975410;VESTIGE;Adventure, Indie, RPG;0 - 20,000;27;7;20;0;0;0
975470;Silver Chains;Adventure, Indie;20,000 - 50,000;503;188;315;713;989;3
975510;Panzer Paladin;Action, Casual;20,000 - 50,000;362;109;253;60;66;4
975520;SHNIPERS;Casual, Indie, Simulation;0 - 20,000;1;0;1;0;0;0
975550;SoundPackager 10;Action, Indie;0 - 20,000;10;5;5;0;0;0
975600;RogueLite;Action, Adventure, Indie;0 - 20,000;10;3;7;0;0;0
975620;Project DeepWeb;Action, Adventure, Casual, Free to Play, Indie, Simulation, Strategy;0 - 20,000;68;13;55;0;0;0
975640;Adolf Hitler Humiliation Simulator;Action, Adventure, RPG, Early Access;0 - 20,000;97;22;75;0;0;1
975660;Discharge;Casual, Indie;0 - 20,000;16;14;2;11;18;0
975670;Neon Blast;Action, Adventure, Casual, Indie, Strategy;0 - 20,000;2;0;2;0;0;0
975680;METAL SLUG XX;Action, Adventure, Casual, Indie, Early Access;100,000 - 200,000;407;405;2;25;25;13
975690;ELASH;Adventure;0 - 20,000;2;1;1;0;0;0
975700;KóterGame;Casual, Indie, RPG, Strategy;0 - 20,000;51;8;43;0;0;1
975710;Qipa World-Hello Big Adventure;Action, Indie, Early Access;0 - 20,000;18;3;15;0;0;0
975770;Escape From The Dragons;Action, Adventure, Casual, Indie;0 - 20,000;5;3;2;0;0;0
975800;CosmoDrive:Zero;Action, Adventure, Casual, Indie;0 - 20,000;19;4;15;0;0;0
975860;拖拉机;Casual, Indie, Simulation;0 - 20,000;5;1;4;0;0;2
975910;HENTAI SHADOW;Casual, Massively Multiplayer, Simulation, Strategy;0 - 20,000;7;1;6;0;0;0
975950;Effie;Adventure, Casual, Indie, RPG, Strategy;20,000 - 50,000;296;88;208;160;160;1
975980;Mahjong Fest: Winterland;Adventure, Casual, Indie;0 - 20,000;1;0;1;0;0;0
976010;I hate this game;Casual, Indie;50,000 - 100,000;1456;109;1347;257;373;7
976020;The True Tales of Bloodstreet 13 - Chapter 1;Casual, Indie, Simulation;0 - 20,000;41;13;28;0;0;0
976030;Drafting Tales;Adventure, Indie;0 - 20,000;54;22;32;19;19;1
976060;In The Ember 余烬之中;Action, Adventure, Casual, Indie;0 - 20,000;24;1;23;0;0;0
976070;Bad Note 破碎的笔记;Casual, Indie;0 - 20,000;13;8;5;0;0;0
976090;Fight for Gold II;Action, Indie, Early Access;0 - 20,000;2;0;2;0;0;0
976120;WARPZONE DRIFTER;Casual, Indie;0 - 20,000;77;19;58;0;0;0
976120;WARPZONE DRIFTER;Adventure, Indie;0 - 20,000;77;19;58;0;0;0
976160;Beer Bar;Casual;50,000 - 100,000;23;25;-2;0;0;0
976230;TV189;Action, Casual, Simulation;0 - 20,000;20;7;13;0;0;0
976240;Spaceguy: Red Space;Action, Adventure, Indie;0 - 20,000;3;4;-1;0;0;0
976260;The Last Monsters;Indie;0 - 20,000;12;1;11;0;0;0
976310;Mortal Kombat 11;Casual, Indie, Massively Multiplayer, Early Access;2,000,000 - 5,000,000;63201;9475;53726;1828;599;2822
976320;Drawz;Casual, Indie, RPG, Simulation, Strategy;0 - 20,000;3;3;0;0;0;0
976330;kHED;Action, Racing;0 - 20,000;22;4;18;0;0;0
976340;You Can(Not) Survive;Action, Casual, Indie;0 - 20,000;18;10;8;0;0;0
976390;9-nine-:Episode 1;Casual, Indie;20,000 - 50,000;989;54;935;141;141;4
976410;Infinite Children;Casual, Indie;20,000 - 50,000;87;49;38;0;0;0
976420;My So-called Future Girlfriend;RPG, Strategy;0 - 20,000;241;15;226;752;1398;1
976500;Venineth;Casual, Indie, Simulation;20,000 - 50,000;153;26;127;0;0;1
976570;CODE SHIFTER;Adventure, Casual, Indie, Simulation;0 - 20,000;21;31;-10;0;0;0
976590;Bus Simulator 21;Action, Adventure, Indie, RPG, Simulation, Early Access;100,000 - 200,000;2213;1015;1198;630;211;153
976680;Minimal Move;Adventure, Indie;0 - 20,000;7;4;3;0;0;0
976700;Size Matters;Action, Casual, Indie;20,000 - 50,000;336;50;286;82;82;1
976720;Case Opener Guns;Casual;0 - 20,000;7;1;6;0;0;0
976730;Halo: The Master Chief Collection;Casual, Indie, Strategy;5,000,000 - 10,000,000;186472;14656;171816;2241;954;4530
976780;NeonCode;Action, Indie;0 - 20,000;172;46;126;0;0;0
976800;九劫曲：诅咒之地 NINE TRIALS;Casual, Indie, Simulation;200,000 - 500,000;2003;1327;676;1346;173;1
976830;Diaper Quest 2055;Casual, Indie, Simulation;0 - 20,000;9;1;8;0;0;0
976840;Happy Vampire Girl;Indie;0 - 20,000;3;3;0;0;0;0
976840;Happy Vampire Girl;Indie;0 - 20,000;3;3;0;0;0;0
976850;Trafic Road Rush;Action, Adventure, Indie;0 - 20,000;34;12;22;0;0;0
976870;Kukoo Kitchen;Action, Casual, Indie, Strategy;0 - 20,000;9;0;9;0;0;0
976890;Hidden Deep;Action, Indie;200,000 - 500,000;2104;572;1532;431;565;11
976900;Lumberhill;Action, Indie;20,000 - 50,000;125;26;99;0;0;0
976920;Dance of Death: Du Lac & Fey;Indie, RPG, Early Access;0 - 20,000;117;24;93;0;0;2
976930;Groove Gunner;Adventure;0 - 20,000;26;4;22;0;0;0
976940;永冻之壳 The Shell of Permafrost;Action, Casual, Indie;50,000 - 100,000;1001;20;981;0;0;1
976950;Defeat the Beat;Action, Adventure, Free to Play, RPG, Simulation, Early Access;0 - 20,000;2;1;1;0;0;0
976960;Heart of Moon : The Mask of Seasons;Casual;0 - 20,000;33;0;33;0;0;2
976970;A Cheesy Game;Adventure;0 - 20,000;3;0;3;0;0;0
976980;The Great Emu War;Adventure, Indie;0 - 20,000;21;5;16;0;0;0
977050;Action: Source;Casual, Indie;20,000 - 50,000;88;26;62;0;0;0
977080;The Clean Up Clyde Collection;Indie;0 - 20,000;8;0;8;0;0;0
977100;Unblock Gridlock;Adventure, Indie, RPG;0 - 20,000;22;2;20;0;0;0
977110;Elite Archery;Casual;0 - 20,000;4;1;3;0;0;0
977160;HORSE;Action, Casual, Indie, Strategy;0 - 20,000;83;66;17;0;0;0
977180;Burnt Rubber;Action, Early Access;0 - 20,000;8;0;8;0;0;0
977210;尘沙的选择 THE CHOICE OF SAND;Action, Adventure, Casual, Indie, Simulation, Early Access;0 - 20,000;13;3;10;0;0;0
977230;Mars Power Industries Deluxe;Action, Indie, RPG;20,000 - 50,000;488;26;462;6;6;1
977270;RCRacer VR;Adventure, Casual;0 - 20,000;2;0;2;0;0;0
977290;Thirty Two;Action, Indie, RPG, Simulation, Early Access;0 - 20,000;4;1;3;0;0;0
977290;Thirty Two;Adventure;0 - 20,000;4;1;3;0;0;0
977300;Fenimore Fillmore: 3 Skulls of the Toltecs;Adventure, Casual, Indie;0 - 20,000;60;10;50;0;0;0
977310;Sea Birds: End of an Age;Adventure;0 - 20,000;6;0;6;0;0;0
977340;Skinny;Simulation;0 - 20,000;38;30;8;51;51;1
977380;Spice Pirates in Space: A Retro RPG;Action, Adventure, Massively Multiplayer;0 - 20,000;2;0;2;0;0;0
977390;Tokyo Warfare Turbo;Strategy;0 - 20,000;333;64;269;35;65;0
977400;Cell to Singularity - Evolution Never Ends;Indie, RPG;1,000,000 - 2,000,000;14937;1535;13402;0;0;2129
977410;The Dealer;Casual, Indie, Racing, Simulation, Early Access;0 - 20,000;5;2;3;0;0;0
977430;Money Maker;Sports;0 - 20,000;16;2;14;0;0;0
977450;Where Thoughts Go: Resolutions;Adventure, Casual, Free to Play, Indie;20,000 - 50,000;10;2;8;0;0;0
977460;Steam Prison;Adventure, RPG;20,000 - 50,000;273;38;235;0;0;1
977490;Jigsaw Masterpieces;Casual, Indie, Strategy;20,000 - 50,000;37;17;20;0;0;2
977500;克苏鲁异闻录;Action, Adventure, Indie;20,000 - 50,000;152;75;77;124;124;1
977540;Super Hero Fight Club: Reloaded;Indie;0 - 20,000;11;3;8;0;0;0
977570;The Experiment: Escape Room;Indie, Simulation, Sports;20,000 - 50,000;139;101;38;74;74;0
977590;バインドを解除する(unbind);Action, Adventure, Indie, Simulation;0 - 20,000;4;5;-1;0;0;0
977590;バインドを解除する(unbind);Action;0 - 20,000;4;5;-1;0;0;0
977650;DwarfHeim;Free to Play, Indie, Early Access;20,000 - 50,000;331;227;104;450;547;2
977670;Snow Ash Land;Action, Indie;0 - 20,000;9;0;9;0;0;0
977690;Skyworld: Kingdom Brawl;Action, Massively Multiplayer, Early Access;0 - 20,000;45;14;31;0;0;0
977720;Starpoint Gemini 3;Action, Indie;20,000 - 50,000;374;353;21;283;283;3
977780;Tactics: Age of Affliction;Adventure;0 - 20,000;1;0;1;0;0;0
977790;Fairground 2 - The Ride Simulation;Adventure, Indie;0 - 20,000;4;5;-1;0;0;0
977810;THE ENIGMA MACHINE;Action, Indie;0 - 20,000;122;13;109;0;0;0
977830;Lost Bazaar;Animation & Modeling, Design & Illustration, Utilities, Game Development;0 - 20,000;4;0;4;0;0;0
977840;EMERGENCY 2;Indie;0 - 20,000;34;6;28;409;409;4
977880;Eastward;Casual, Indie;200,000 - 500,000;11144;1943;9201;541;405;55
977900;Kick The Puppet;Action, Adventure, Indie;0 - 20,000;13;11;2;0;0;1
977920;Balsa Model Flight Simulator;Adventure, Casual;0 - 20,000;181;48;133;0;0;6
977950;A Dance of Fire and Ice;Adventure, Indie, RPG;1,000,000 - 2,000,000;46550;3032;43518;1537;242;1850
977980;Paintball Chibis;Indie, Simulation, Sports, Strategy;0 - 20,000;1;1;0;0;0;0
978010;Epic of Serinor: Dawnshadow;Action, Adventure, Casual, Indie, RPG, Simulation, Strategy;0 - 20,000;4;0;4;0;0;0
978020;You are Never Alone;Action, Adventure, Indie, RPG;0 - 20,000;0;2;-2;0;0;0
978040;Starquake Academy;Casual, Free to Play, Indie;0 - 20,000;2;2;0;0;0;0
978110;Mutland;Action;0 - 20,000;0;1;-1;0;0;0
978180;Stay Silent;Action, Free to Play, Indie;0 - 20,000;13;13;0;0;0;0
978190;Steel Sword Story;Casual, Indie, Early Access;20,000 - 50,000;57;23;34;0;0;0
978200;逗国科举 | Douguo Keju;Adventure, Indie, RPG;0 - 20,000;17;9;8;0;0;0
978210;TAL: Jungle;Action, Adventure, Casual, Free to Play, Indie;0 - 20,000;19;4;15;0;0;0
978250;Matter;Casual, Indie;20,000 - 50,000;145;14;131;0;0;0
978270;Sam & Dan: Floaty Flatmates;Action, Casual, Indie, Massively Multiplayer, RPG, Early Access;200,000 - 500,000;579;45;534;0;0;0
978290;Total Battle;Casual, Indie;0 - 20,000;32;34;-2;0;0;0
978300;Saints Row: The Third Remastered;Action, Adventure, Indie;20,000 - 50,000;1262;693;569;788;467;41
978340;RGB RUN;Action, Adventure, Indie, RPG;0 - 20,000;20;8;12;0;0;0
978380;Spinheads;Indie;0 - 20,000;2;1;1;0;0;0
978440;Mining Rail;Casual, Indie, Strategy;0 - 20,000;8;0;8;0;0;0
978450;Data mining 3;Adventure, Casual, Free to Play, Indie;0 - 20,000;12;10;2;0;0;0
978460;Emily is Away <3;Action, Adventure, Indie;200,000 - 500,000;4163;322;3841;221;285;26
978490;Yo My Yo!;Action, Adventure, Casual, Free to Play, Massively Multiplayer, Racing, RPG, Simulation;0 - 20,000;2;1;1;0;0;0
978510;Settlers of Orion;Casual, Indie;0 - 20,000;11;2;9;0;0;0
978520;Legend of Keepers: Career of a Dungeon Manager;Adventure, Casual, Indie;100,000 - 200,000;3105;771;2334;499;484;65
978580;Oops!!! Puzzles!!!;Action, Adventure, Casual, Indie;0 - 20,000;2;3;-1;0;0;0
978610;★Fallalypse ★ Disconnect ❄;Adventure, Massively Multiplayer, RPG;0 - 20,000;0;16;-16;0;0;0
978620;Corma: The Next Level;Casual, Indie;100,000 - 200,000;231;292;-61;0;0;0
978630;Juro Janosik;Adventure, Casual, Indie;0 - 20,000;69;3;66;0;0;0
978650;SpaceFrog VR;Adventure;0 - 20,000;0;1;-1;0;0;0
978660;Parity;Adventure;0 - 20,000;2;0;2;0;0;0
978670;Christmas Clicker: Idle Gift Builder;Adventure, Indie;0 - 20,000;44;20;24;0;0;3
978680;Substance Painter 2019;Casual, Indie, Early Access;0 - 20,000;202;36;166;0;0;14
978690;Substance Designer 2019;Action, Adventure, Racing, Simulation, Early Access;0 - 20,000;49;4;45;0;0;7
978700;Ironsmith Medieval Simulator;Casual, Free to Play, Indie, RPG, Simulation;0 - 20,000;73;137;-64;53;53;0
978710;Dinosaurus Life VR;Action, Adventure, Free to Play, Indie, Massively Multiplayer, RPG;0 - 20,000;2;2;0;0;0;0
978780;STORY OF SEASONS: Friends of Mineral Town;Action, Casual, Indie;100,000 - 200,000;4036;234;3802;1126;1431;117
978790;Frantic Dimension;Adventure, Indie;0 - 20,000;51;5;46;0;0;0
978800;Rolling Bird;Action, Free to Play, Indie, Massively Multiplayer, Early Access;20,000 - 50,000;166;14;152;0;0;1
978840;Nanobotic;Action, Adventure, Indie, Massively Multiplayer, RPG, Strategy, Early Access;50,000 - 100,000;108;57;51;0;0;0
978870;Lilycle Rainbow Stage!!!;Indie, Simulation, Strategy, Early Access;20,000 - 50,000;109;9;100;0;0;0
978910;Necro Defense;Indie;0 - 20,000;3;2;1;0;0;0
978920;Wings of Virtus;Action, Free to Play, Strategy;0 - 20,000;9;8;1;0;0;0
978920;Wings of Virtus;RPG;0 - 20,000;9;8;1;0;0;0
978960;Starters Orders 7 Horse Racing;Action, Adventure, Casual, Free to Play, Indie, Massively Multiplayer, Racing, RPG, Simulation, Sports, Strategy;0 - 20,000;85;31;54;0;0;19
978970;God Hand;Racing;0 - 20,000;29;7;22;0;0;1
978980;Paradigm Blast;Adventure, Indie, RPG;0 - 20,000;2;0;2;0;0;0
978990;Cyberlink Screen Recorder 4  - Record your games, RPG, car game, shooting gameplay - Game Recording and Streaming Software;Action, Casual, Indie;0 - 20,000;17;8;9;0;0;1
979000;Abrakadaboom;Casual;0 - 20,000;3;1;2;0;0;0
979010;Ultimate Desktop Character Engine;Casual, Indie;0 - 20,000;49;44;5;11;11;1
979060;Bloons Adventure Time TD;Casual, Sports;200,000 - 500,000;2531;375;2156;411;223;176
979070;Just Die Already;Casual, Indie, Simulation;100,000 - 200,000;1593;370;1223;277;333;43
979080;Rebel Forces;Action, Casual, Indie, RPG, Strategy;200,000 - 500,000;1285;280;1005;0;0;1
979090;Stunt Simulator Multiplayer;Action, Casual, Indie;0 - 20,000;72;4;68;0;0;0
979100;Experience: Colorblindness;Action, Adventure, Indie;0 - 20,000;27;2;25;0;0;0
979110;Space Haven;Action, Free to Play, Indie;200,000 - 500,000;5758;829;4929;603;331;364
979120;Autonauts;Action, Adventure, Casual, Indie;200,000 - 500,000;3743;439;3304;1507;401;168
979160;Moi Mei;Action, Adventure, Casual, Indie, RPG, Simulation, Sports, Strategy;0 - 20,000;27;13;14;0;0;0
979170;CARDCORE;Action, Adventure, Indie, Simulation;50,000 - 100,000;18;20;-2;0;0;0
979220;Girls and Tests;Casual, Indie;0 - 20,000;1;3;-2;0;0;0
979260;Gizmo;Action, Adventure, Indie;50,000 - 100,000;264;15;249;0;0;0
979290;Christmas Defence;Indie, Sports, Strategy;0 - 20,000;15;9;6;0;0;0
979300;Allied Nations;Casual, Indie;0 - 20,000;2;1;1;0;0;0
979310;Disjunction;Action, Adventure, Indie, Racing, Simulation;50,000 - 100,000;91;21;70;0;0;0
979350;Sunset Giant;Adventure, Indie;0 - 20,000;3;0;3;0;0;0
979390;Laser Party;Action, Indie, Early Access;0 - 20,000;17;5;12;0;0;0
979400;Last Labyrinth（ラストラビリンス）;Action, Adventure, Indie;0 - 20,000;67;17;50;0;0;0
979400;Last Labyrinth（ラストラビリンス）;Indie, Strategy;0 - 20,000;67;17;50;0;0;0
979450;Brick Breaker Halloween;Adventure, Free to Play, Indie;0 - 20,000;14;1;13;0;0;0
979480;Born Punk;Indie;0 - 20,000;95;14;81;0;0;0
979500;雪策边境-BSP;Casual;0 - 20,000;11;22;-11;0;0;0
979520;Starblazer;Casual, Indie;0 - 20,000;28;6;22;0;0;0
979530;Endless Maneuver;Casual;0 - 20,000;18;11;7;0;0;0
979530;Endless Maneuver;Casual, Indie, Simulation, Sports, Strategy;0 - 20,000;18;11;7;0;0;0
979550;Evolo.Mine;Action, Adventure, Casual, Indie, Simulation;0 - 20,000;2;3;-1;0;0;0
979560;RainWallpaper;Indie, RPG;50,000 - 100,000;366;221;145;125;125;46
979580;祭品的逆襲 The Counterattack Of Sacrifice;Action, Free to Play;0 - 20,000;16;2;14;0;0;0
979590;JumpoPitec;Simulation;0 - 20,000;0;1;-1;0;0;0
979600;Kaori After Story;Adventure, Casual, Indie, Simulation, Strategy;20,000 - 50,000;441;6;435;0;0;0
979620;Atrocity;Action;0 - 20,000;5;1;4;0;0;0
979640;Cepheus Protocol;Casual, Indie;50,000 - 100,000;1526;347;1179;236;344;29
979680;In your Shadow;Adventure, Casual, Indie;0 - 20,000;5;4;1;0;0;0
979690;The Ascent;Action, Indie;500,000 - 1,000,000;13205;4346;8859;547;349;260
979710;Easy Pose;Action, Adventure, Casual, Indie, Simulation;20,000 - 50,000;606;33;573;262;393;131
979720;Big Bash Boom;Casual, Indie, Simulation, Early Access;20,000 - 50,000;7;4;3;0;0;0
979720;Big Bash Boom;Action, Adventure, Indie;20,000 - 50,000;7;4;3;0;0;0
979740;Profundum;Indie;0 - 20,000;19;7;12;0;0;0
979760;PASKA BATTLE STYLE!;Action, Adventure, Casual, Indie, RPG, Simulation, Sports, Strategy;0 - 20,000;3;3;0;0;0;0
979790;Change : A Little Story;Action, Free to Play;0 - 20,000;26;3;23;0;0;0
979800;Haxity;Casual, Indie;0 - 20,000;58;18;40;0;0;0
979810;Grave Keeper;Adventure, Indie;0 - 20,000;41;49;-8;38;38;0
979880;Fast Food Fighters;Casual, Free to Play, Indie, RPG;0 - 20,000;3;0;3;0;0;0
979890;Allison's Diary: Rebirth;Casual, Indie;0 - 20,000;7;8;-1;0;0;0
979900;RRRR;Casual;0 - 20,000;14;9;5;0;0;0
979920;Supremacy 1914: World War 1;Action, Adventure, Indie;200,000 - 500,000;1682;571;1111;161;154;300
979970;IMAZE.EXE;Adventure, Indie;0 - 20,000;44;14;30;0;0;0
979990;Ancient Frontier: Steel Shadows BETA;Adventure, Casual, Indie, Simulation, Sports;0 - 20,000;8;1;7;0;0;0
980160;UBERCOLD;Indie;0 - 20,000;22;18;4;0;0;0
980160;UBERCOLD;Action, Indie, RPG;0 - 20,000;22;18;4;0;0;0
980170;Tenko's Magical Sword Quest;Indie, Simulation, Strategy, Early Access;0 - 20,000;16;0;16;0;0;1
980190;Flaky Bakery;Indie, Strategy;0 - 20,000;9;2;7;0;0;0
980210;HordeCore;Casual, Indie, RPG;20,000 - 50,000;82;30;52;0;0;4
980210;HordeCore;Action, Casual, Indie, Early Access;20,000 - 50,000;82;30;52;0;0;4
980300;One Finger Death Punch 2;Adventure, Casual;100,000 - 200,000;3885;134;3751;428;449;23
980320;Haunting Hour;Action, Adventure, Indie;0 - 20,000;9;5;4;0;0;0
980360;Melody Flight;Casual, Indie, Strategy;0 - 20,000;2;0;2;0;0;0
980380;HelpTheAlien;Casual, Simulation, Strategy;0 - 20,000;0;0;0;0;0;0
980440;Knights Rubbish;RPG, Early Access;0 - 20,000;1;1;0;0;0;0
980480;Towertale;Casual, Indie, Racing, Simulation;0 - 20,000;61;3;58;0;0;0
980490;Heaven & Hell;Adventure, Casual, Indie, Simulation;0 - 20,000;23;7;16;0;0;0
980520;Azurael's Circle: Chapter 3;Action, Casual, Indie;0 - 20,000;12;1;11;0;0;0
980600;Maze 4D;Casual, Free to Play, Massively Multiplayer, RPG, Early Access;20,000 - 50,000;3;1;2;0;0;0
980610;Quaver;Casual;200,000 - 500,000;10712;874;9838;0;0;240
980630;Mission Evilguy;Casual, Free to Play, Sports;0 - 20,000;3;0;3;0;0;0
980640;Empire of Ember;Action, Adventure, Indie, Simulation, Early Access;0 - 20,000;94;40;54;0;0;1
980690;Heavy Memories;Action, Indie;0 - 20,000;13;3;10;0;0;0
980730;Underlight;Action, Free to Play, Indie;100,000 - 200,000;68;38;30;0;0;3
980740;Boise Historic Natatorium;Action, Adventure, Free to Play, Indie;0 - 20,000;6;2;4;0;0;0
980750;Santa's Workshop;Casual, Indie;0 - 20,000;5;0;5;0;0;0
980760;GoodColor;Utilities, Video Production;0 - 20,000;1;1;0;0;0;0
980760;GoodColor;Casual, Indie;0 - 20,000;1;1;0;0;0;0
980770;Flying Circus;Adventure, Free to Play, Indie, RPG, Strategy;;;;0;;;
980800;BEAK SQUADRON;Action, Adventure, Casual, Indie;0 - 20,000;2;0;2;0;0;0
980830;Spirit Hunter: Death Mark;Free to Play;0 - 20,000;244;47;197;0;0;10
980850;Pixel Battle Royale;Casual;100,000 - 200,000;370;250;120;0;0;0
980880;Twinfold;Casual, Indie;0 - 20,000;12;1;11;0;0;0
980940;My Little Blacksmith Shop;Indie, RPG, Early Access;100,000 - 200,000;613;183;430;85;85;10
980950;Crome: Before Purgatory;Strategy;0 - 20,000;33;5;28;0;0;0
981020;Clea;Action, Indie, Massively Multiplayer, RPG;20,000 - 50,000;351;7;344;301;301;0
981040;Comit in Krater Returns;Casual, Indie, Strategy;0 - 20,000;0;0;0;0;0;0
981050;Comit in Cosmo Knight's Revenge;Adventure, Casual, Indie, Simulation;0 - 20,000;1;1;0;0;0;0
981080;Burst Drive;Adventure, Casual, Indie;0 - 20,000;3;0;3;0;0;0
981120;Tiger Soldier Ⅰ;Action, Indie;0 - 20,000;0;2;-2;0;0;0
981130;Lucky Skiing;Action, Casual, Indie, Simulation, Early Access;0 - 20,000;1;2;-1;0;0;0
981140;混乱使者;Indie;0 - 20,000;9;9;0;0;0;0
981160;Woman's body;Adventure, Casual, Indie;0 - 20,000;0;0;0;0;0;0
981250;C.Q.C. - Close Quarters Combat;Adventure, Casual, Indie;0 - 20,000;3;0;3;0;0;0
981260;Love In Drawing;;20,000 - 50,000;194;31;163;0;0;0
981270;Runa's School Story;Action, Casual, Indie, RPG;0 - 20,000;12;1;11;0;0;0
981290;CGENcore;Adventure, Indie;50,000 - 100,000;50;43;7;0;0;2
981310;Ishmael;Adventure, Indie, Simulation;0 - 20,000;40;34;6;0;0;0
981320;Whale Island;Adventure, Indie;0 - 20,000;0;1;-1;0;0;0
981420;Game Soup;Action, Indie, Early Access;0 - 20,000;101;6;95;0;0;0
981430;Gordian Quest;Casual, Indie;200,000 - 500,000;4465;458;4007;865;1419;131
981440;The Great Emu War Of 1932;Action, Adventure, Casual, Indie, Simulation;0 - 20,000;3;1;2;0;0;0
981450;GeminiArms;Casual, Indie;0 - 20,000;5;0;5;0;0;0
981500;Market Dominion;Casual, Indie;0 - 20,000;4;1;3;0;0;0
981540;Stellar Sphere;Action, Adventure, Indie, RPG;0 - 20,000;1;0;1;0;0;0
981550;GACHIMUCHI M♂NLY PUZZLE;Indie;0 - 20,000;66;15;51;0;0;0
981590;VSXu Player;Action, Adventure, Casual, Indie;20,000 - 50,000;179;23;156;114;114;10
981620;Hexa;Action, Adventure, Casual, Indie, Early Access;0 - 20,000;12;0;12;0;0;0
981630;Guntastic;Adventure, Indie;0 - 20,000;16;1;15;0;0;0
981660;The Detective Chapters: Part One;Action, Indie, Simulation, Early Access;0 - 20,000;4;4;0;0;0;0
981670;Agent 9;Adventure, Casual, Indie, RPG, Early Access;0 - 20,000;5;3;2;0;0;0
981690;Gun Chain;Adventure, Indie, Early Access;0 - 20,000;4;7;-3;0;0;0
981710;Just Roll With It;Adventure, Casual, Indie, Simulation;0 - 20,000;2;0;2;0;0;0
981750;Crystar;Indie;20,000 - 50,000;774;185;589;250;250;21
981770;SENRAN KAGURA Reflexions;Adventure, Casual, Indie;0 - 20,000;351;48;303;64;64;1
981830;GIGABUSTER;Action, Adventure, Indie;0 - 20,000;10;8;2;0;0;3
981850;BATALJ;Action, Casual, Indie;0 - 20,000;15;10;5;0;0;0
981880;GrowRilla VR;Adventure, Casual, Indie;0 - 20,000;64;6;58;0;0;1
981890;Olympic Games Tokyo 2020 – The Official Video Game;Adventure, Casual, Indie;200,000 - 500,000;1178;1370;-192;236;322;11
981900;Kings' Cross;;0 - 20,000;4;3;1;0;0;0
981910;Hentai Girl in Space;;0 - 20,000;20;20;0;0;0;0
981960;Horror Girl Puzzle;;0 - 20,000;51;12;39;0;0;0
981980;Panda Hero;;0 - 20,000;1;2;-1;0;0;0
981990;Don't Shoot Rabbit / 不要射中兔子;;0 - 20,000;5;0;5;0;0;0
982010;ZDF History 360° – Tempelhof;;50,000 - 100,000;3;7;-4;0;0;0
982020;Eurobi Racing;;0 - 20,000;2;0;2;0;0;0
982040;Don't Die, Minerva!;;0 - 20,000;53;12;41;0;0;0
982050;Caracoland;;0 - 20,000;1;0;1;0;0;0
982060;Undholm;;0 - 20,000;56;32;24;0;0;0
982090;Noms the Fish;;0 - 20,000;1;0;1;0;0;0
982100;Samozbor: Rebellion;;0 - 20,000;22;3;19;0;0;0
982100;Samozbor: Rebellion;;0 - 20,000;22;3;19;0;0;0
982120;Giant Celebration;;0 - 20,000;6;0;6;0;0;0
982150;Hentai Secrets;;0 - 20,000;184;15;169;27;27;0
982220;Globesweeper;;0 - 20,000;223;24;199;242;242;8
982240;Urban Legends : The Dry Body;;0 - 20,000;3;13;-10;0;0;0
982250;Spoils of Plunder;;0 - 20,000;10;3;7;0;0;0
982270;Dealer's Life;;0 - 20,000;1034;82;952;237;237;8
982290;Airborne Kingdom;;50,000 - 100,000;1329;190;1139;664;819;18
982320;Battle of the Boros;;20,000 - 50,000;1;0;1;0;0;0
982320;Battle of the Boros;;20,000 - 50,000;1;0;1;0;0;0
982350;Mon Amour;;0 - 20,000;56;2;54;0;0;0
982380;Gods and Kings;;20,000 - 50,000;25;16;9;0;0;0
982390;Boom Boom Bovine;;0 - 20,000;3;0;3;0;0;0
982400;赫炎的印加诺克 Fullvoice ReBORN;;0 - 20,000;126;15;111;0;0;0
982440;Slightly Heroes VR;;0 - 20,000;50;25;25;5;5;0
982450;Truth: Disorder III — Gemini / 真実：障害III - 双子座;;0 - 20,000;34;14;20;0;0;0
982480;Supreme Casino City;;0 - 20,000;4;6;-2;0;0;0
982510;Dungeon Hunter 5;;200,000 - 500,000;202;189;13;30;30;0
982520;Movavi Photo Editor;;0 - 20,000;173;79;94;536;536;3
982540;Hyss;;0 - 20,000;29;1;28;0;0;0
982580;女巫与六便士 the sibyl and sixpence;;50,000 - 100,000;603;128;475;0;0;0
982670;Clan N;;0 - 20,000;28;11;17;0;0;0
982690;DATAFLOW;;0 - 20,000;1;3;-2;0;0;0
982700;Space Battle VR;;0 - 20,000;61;27;34;0;0;0
982710;Cop Academy;;0 - 20,000;16;4;12;0;0;0
982720;Paradise Lost;;100,000 - 200,000;1234;640;594;183;183;2
982750;Puzzles for smart: Underwater Kingdom;;0 - 20,000;5;1;4;0;0;0
982760;Medieval Towns;;0 - 20,000;10;14;-4;0;0;0
982770;Hir Corruption;;0 - 20,000;5;1;4;0;0;0
982800;Moon Tycoon;;0 - 20,000;10;10;0;0;0;0
982830;Cappasity Demo;;0 - 20,000;6;3;3;0;0;0
982840;Bomber Barn;;0 - 20,000;31;22;9;0;0;0
982850;Tess Elated;;0 - 20,000;9;3;6;0;0;0
982920;HammerBorn: Tears Of Mani;;0 - 20,000;0;1;-1;0;0;0
982990;Muzzleloaded;;0 - 20,000;4;1;3;0;0;0
983040;Koboomballs;;0 - 20,000;0;1;-1;0;0;0
983050;Sticky Apps :: Monitor Ping;;0 - 20,000;31;5;26;4;4;5
983070;Hyperborea;;20,000 - 50,000;22;8;14;0;0;0
983100;Walk On the Ground Simulator;;0 - 20,000;2;0;2;0;0;0
983120;TendyTrainer;;0 - 20,000;12;6;6;0;0;0
983140;Monster Jaunt;;0 - 20,000;25;0;25;0;0;0
983150; Sakura no Mori † Dreamers 2;;0 - 20,000;377;11;366;1;1;4
983160;Junk on Wheels;;0 - 20,000;5;5;0;0;0;0
983170;Infinite Chili Sauce  无尽的辣酱;;0 - 20,000;24;4;20;0;0;0
983240;Boobs or [redacted];;0 - 20,000;0;0;0;0;0;0
983280;Chocolate makes you happy: New Year;;0 - 20,000;22;5;17;0;0;0
983290;Lightstep Chronicles;;0 - 20,000;28;7;21;0;0;0
983340;Waifu Hunter - Secret of Pirates;;0 - 20,000;2;1;1;0;0;0
983350;Sea Salt;;50,000 - 100,000;462;111;351;72;121;1
983450;Astral Towers;;0 - 20,000;38;5;33;0;0;0
983520;Bizango Blast;;0 - 20,000;8;9;-1;0;0;0
983590;Tank Blazers;;0 - 20,000;3;0;3;0;0;0
983610;Burning Out;;0 - 20,000;5;3;2;0;0;0
983640;Theseus: Journey to Athens;;0 - 20,000;11;1;10;0;0;0
983650;Jumper Tree;;0 - 20,000;1;0;1;0;0;0
983670;Pangeon;;0 - 20,000;29;23;6;0;0;0
983760;Chrono Ghost;;0 - 20,000;11;0;11;0;0;0
983780;XSprite;;0 - 20,000;5;3;2;0;0;1
983790;Arcane Domains;;0 - 20,000;4;0;4;0;0;0
983820;RainWidget;;0 - 20,000;16;37;-21;5;5;1
983830;Rogue;;0 - 20,000;13;3;10;0;0;0
983840;HUNTING SIMULATOR VR;;0 - 20,000;6;15;-9;0;0;0
983880;Arctic Fleet;;0 - 20,000;11;19;-8;0;0;0
983890;Digging Dragon;;0 - 20,000;3;16;-13;0;0;0
983900;Mojack - Quest of Jackal : Puzzle game;;0 - 20,000;1;1;0;0;0;0
983970;Haven;;100,000 - 200,000;3527;319;3208;202;239;139
983980;Euclidean Skies;;0 - 20,000;35;15;20;0;0;1
983990;Steel Alcimus;;0 - 20,000;30;4;26;0;0;0
984020;Super Ninja Meow Cat;;0 - 20,000;12;2;10;0;0;0
984030;Killer Clowns;;0 - 20,000;2;1;1;0;0;0
984070;Chaos Theory;;0 - 20,000;6;9;-3;0;0;0
984080;Christmas Carol;;0 - 20,000;3;15;-12;0;0;0
984110;SYNTHETIK: Arena;;200,000 - 500,000;1972;196;1776;104;39;14
984150;Powerless;;0 - 20,000;0;1;-1;0;0;0
984230;X Archetype;;0 - 20,000;0;2;-2;0;0;0
984240;School Grounds;;50,000 - 100,000;35;43;-8;0;0;0
984250;Red Tractor Tycoon;;0 - 20,000;25;8;17;0;0;0
984300;Robozarro;;0 - 20,000;5;1;4;0;0;0
984360;Pocoman;;0 - 20,000;14;0;14;0;0;0
984450;Super Crome: Bullet Purgatory;;0 - 20,000;36;0;36;0;0;0
984450;Super Crome: Bullet Purgatory;;0 - 20,000;36;0;36;0;0;0
984470;Big Dipper;;20,000 - 50,000;139;14;125;0;0;0
984510;Adventure Boy Cheapskate DX;;0 - 20,000;30;15;15;0;0;0
984520;Weightless: An immersive and relaxing experience;;0 - 20,000;2;6;-4;0;0;0
984540;Hostile User Interface;;0 - 20,000;15;0;15;0;0;0
984560;HEARTBEAT;;50,000 - 100,000;607;94;513;258;258;1
984570;Chess Sphere;;20,000 - 50,000;41;5;36;0;0;0
984580;Stone In Galaxy;;0 - 20,000;1;2;-1;0;0;0
984590;Coloring Book;;0 - 20,000;8;1;7;0;0;0
984600;Trinoline Genesis;;0 - 20,000;17;1;16;0;0;1
984610;Mech Merc Company;;0 - 20,000;76;12;64;0;0;0
984660;Strike of Horror;;0 - 20,000;80;36;44;0;0;0
984680;Interstellar Space: Genesis;;50,000 - 100,000;516;103;413;8;8;18
984690;Otter of My Life;;0 - 20,000;30;13;17;0;0;0
984720;Hentai Summer;;0 - 20,000;117;12;105;0;0;0
984730;Battles For Spain;;0 - 20,000;22;6;16;0;0;1
984780;MotoGP19;;100,000 - 200,000;1324;163;1161;810;592;13
984790;It'sRoachTime!;;0 - 20,000;16;4;12;0;0;0
984800;Automachef;;50,000 - 100,000;534;214;320;528;740;4
984810;Nightmare Trails;;0 - 20,000;0;2;-2;0;0;0
984820;Counter Fight 3;;0 - 20,000;8;11;-3;0;0;0
984830;Magician of Fire;;0 - 20,000;14;1;13;0;0;0
984870;Tecroroid Assault;;20,000 - 50,000;2;1;1;0;0;0
984870;Tecroroid Assault;;20,000 - 50,000;2;1;1;0;0;0
984880;The Pilgrimage I;;0 - 20,000;1;1;0;0;0;0
984910;Rocket Golf;;0 - 20,000;4;0;4;0;0;0
984930;The Black Widow;;0 - 20,000;6;2;4;0;0;0
984990;Alien Jelly: Food For Thought!;;0 - 20,000;1;0;1;0;0;0
985000;Potion Paws;;0 - 20,000;43;22;21;0;0;0
985020;Three Kingdoms：Ancient battlefield | 三国古战略;;0 - 20,000;22;5;17;0;0;0
985040;NPCs;;0 - 20,000;29;6;23;0;0;1
985070;Darkheart: Flight of the Harpies;;0 - 20,000;15;9;6;0;0;1
985080;食用系少女 Food Girls;;0 - 20,000;399;21;378;0;0;1
985090;Color Knight;;0 - 20,000;2;2;0;0;0;0
985240;Woodfel;;0 - 20,000;13;3;10;0;0;0
985260;The Morrigan;;0 - 20,000;212;32;180;21;21;1
985280;The Trials of Olympus;;0 - 20,000;9;5;4;0;0;0
985340;Secret Savings;;0 - 20,000;0;0;0;0;0;0
985420;Esc: From Planet;;0 - 20,000;0;1;-1;0;0;0
985430;Terrible Laboratory;;20,000 - 50,000;275;65;210;0;0;2
985500;EF Universe: Reclaiming the World;;0 - 20,000;7;3;4;0;0;0
985510;Necken;;20,000 - 50,000;30;3;27;0;0;0
985530;Hunter;;0 - 20,000;46;15;31;0;0;0
985540;Shaverma: Ravshan Edition;;0 - 20,000;9;5;4;0;0;0
985560;Magic Mouse;;0 - 20,000;22;4;18;0;0;0
985580;Ultra Pig;;0 - 20,000;15;12;3;0;0;0
985590;Necrolepsy;;0 - 20,000;31;0;31;0;0;0
985620;Space Captain McCallery - Episode 2: Pilgrims in Purple Moss;;0 - 20,000;11;2;9;0;0;0
985640;Amanda's Sticker Book;;0 - 20,000;10;5;5;0;0;0
985650;Olaguna Chronicles;;0 - 20,000;100;21;79;0;0;2
985680;闯关杀II;;0 - 20,000;28;14;14;0;0;7
985690;Fall In Love - My Billionaire Boss;;0 - 20,000;2;0;2;0;0;0
985710;Wall Street Tycoon;;0 - 20,000;54;73;-19;0;0;0
985720;RUINS Survival;;0 - 20,000;32;33;-1;0;0;0
985740;同居指南 | Cohabitation Guide;;0 - 20,000;16;10;6;0;0;0
985760;3D Custom Lady Maker;;20,000 - 50,000;180;80;100;0;0;0
985770;Artillery Globe;;0 - 20,000;0;7;-7;0;0;0
985780;Jack Axe;;0 - 20,000;67;27;40;0;0;0
985800;BATTLLOON - バトルーン;;0 - 20,000;15;7;8;0;0;0
985830;SUCCUBUS;;200,000 - 500,000;2893;719;2174;488;515;36
985840;Greedy Crush;;0 - 20,000;1;0;1;0;0;0
985870;The Tourist Trap;;0 - 20,000;1;0;1;0;0;0
985890;Streets of Rage 4;;500,000 - 1,000,000;13929;1138;12791;1161;270;181
985900;Young Souls;;20,000 - 50,000;344;60;284;964;964;3
985920;Mining Empire: Earth Resources;;0 - 20,000;6;22;-16;0;0;0
985930;::CallBack;;0 - 20,000;3;0;3;0;0;0
985940;Beat Me!;;0 - 20,000;51;19;32;0;0;0
985950;Operencia: The Stolen Sun;;20,000 - 50,000;357;94;263;0;0;2
986010;FIT IN;;0 - 20,000;1;0;1;0;0;0
986020;Kunoichi Botan;;20,000 - 50,000;351;78;273;0;0;5
986040;The Unliving;;20,000 - 50,000;254;157;97;100;123;7
986070;Spirit Oath;;0 - 20,000;24;3;21;0;0;0
986080;Zombie Apocalypse;;0 - 20,000;32;13;19;0;0;0
986280;Lingua Fleur: Lily;;20,000 - 50,000;188;4;184;0;0;0
986310;Recompile;;0 - 20,000;92;44;48;0;0;0
986320;AA Touch Gun!;;0 - 20,000;0;6;-6;0;0;0
986340;Raid on the Ruhr;;0 - 20,000;6;4;2;0;0;0
986350;Nemezis: Mysterious Journey III;;0 - 20,000;66;40;26;0;0;1
986370;Try To Reach 10;;0 - 20,000;14;4;10;0;0;0
986400;Helidefence;;0 - 20,000;2;2;0;0;0;0
986480;Sharknado VR (Arcade Edition);;0 - 20,000;4;2;2;0;0;0
986670;Steady;;0 - 20,000;5;0;5;0;0;1
986680;PAGUI打鬼;;0 - 20,000;726;147;579;377;377;23
986710;Nusantara: Legend of The Winged Ones;;0 - 20,000;38;1;37;0;0;1
986790;Cyber City Escape;;0 - 20,000;3;1;2;0;0;0
986800;AVICII Invector;;50,000 - 100,000;2668;87;2581;254;325;9
986820;Lost Lands: Mistakes of the Past;;0 - 20,000;72;5;67;0;0;3
986830;The Legacy: The Tree of Might;;0 - 20,000;60;4;56;0;0;1
986920;Exploding Babies;;0 - 20,000;1;0;1;0;0;0
986930;Perchang;;0 - 20,000;13;0;13;0;0;0
986990;aMAZE Christmas;;0 - 20,000;77;18;59;0;0;1
987000;Shadow Uprising;;0 - 20,000;40;8;32;0;0;0
987000;Shadow Uprising;;0 - 20,000;40;8;32;0;0;0
987010;ACID Pro 8 Steam Edition;;0 - 20,000;4;7;-3;0;0;0
987020;DRONE The Game;;50,000 - 100,000;842;491;351;13;10;0
987040;Goblin Squad - Total Division;;0 - 20,000;2;3;-1;0;0;0
987060;Auri's Tales;;0 - 20,000;4;2;2;0;0;0
987150;BMX The Game;;0 - 20,000;349;231;118;8;8;0
987180;Black Salt Coreuption;;0 - 20,000;9;5;4;0;0;0
987190;The Aether: Life as a God;;0 - 20,000;29;6;23;0;0;0
987200;Dragon Racer;;0 - 20,000;16;8;8;0;0;0
987210;Crossroads: Lucky Edition;;0 - 20,000;37;10;27;0;0;0
987210;Crossroads: Lucky Edition;;0 - 20,000;37;10;27;0;0;0
987230;Shadow Legend VR;;20,000 - 50,000;389;108;281;0;0;2
987240;Arcadia;;0 - 20,000;92;31;61;0;0;0
987250;Kalling Kingdom;;0 - 20,000;0;2;-2;0;0;0
987290;DUSTNET;;0 - 20,000;31;6;25;0;0;0
987330;Street Outlaws: The List;;0 - 20,000;32;32;0;418;418;0
987350;PlanetSide Arena;;500,000 - 1,000,000;866;1058;-192;120;181;0
987370;ライフワン- lifeOne;;0 - 20,000;1;1;0;0;0;0
987400;Disney's Hercules;;50,000 - 100,000;321;40;281;70;87;22
987410;Maui Mallard in Cold Shadow;;0 - 20,000;38;20;18;0;0;3
987450;胸怀三国 OL / 삼국지를 품다 / Embrace the Three Kingdoms OL;;20,000 - 50,000;73;57;16;4;4;0
987480;花落冬陽 Snowdreams -lost in winter-;;0 - 20,000;227;4;223;0;0;1
987490;DOKA 2 GUTS OUT NINJA;;0 - 20,000;5;7;-2;0;0;0
987570;Chain Reaction : Sexy Hentai Girls;;0 - 20,000;0;0;0;0;0;0
987580;Reach 50 : Sexy Hentai Girls;;0 - 20,000;11;5;6;0;0;0
987590;Dots Pop : Sexy Hentai Girls;;0 - 20,000;15;9;6;0;0;0
987620;Ski Drive: Biathlon;;0 - 20,000;2;1;1;0;0;0
987630;Opencast Mining;;0 - 20,000;8;19;-11;0;0;0
987660;ASTRONEST VR;;0 - 20,000;1;4;-3;0;0;0
987670;Chocolat Rush;;0 - 20,000;17;6;11;0;0;0
987710;BLASK;;0 - 20,000;15;0;15;0;0;0
987720;ONINAKI;;20,000 - 50,000;267;133;134;78;78;3
987740;Donald VS Martians;;0 - 20,000;25;14;11;0;0;0
987770;Singularity 5;;0 - 20,000;59;19;40;0;0;0
987780;Dark Shiny;;0 - 20,000;1;2;-1;0;0;0
987790;Call of Pixel : Close Quarters;;0 - 20,000;18;16;2;0;0;0
987800;CandyVenture;;0 - 20,000;14;5;9;0;0;0
987800;CandyVenture;;0 - 20,000;14;5;9;0;0;0
987810;Ayre;;0 - 20,000;12;2;10;0;0;0
987820;CHRONO;;20,000 - 50,000;87;26;61;0;0;0
987840;Expeditions: Rome;;200,000 - 500,000;3503;426;3077;912;1308;237
987850;2084;;20,000 - 50,000;73;43;30;0;0;0
987880;Moo Moo Move;;0 - 20,000;36;3;33;0;0;0
987900;Seeker;;50,000 - 100,000;565;70;495;0;0;0
987910;WarZone Flashpoint;;50,000 - 100,000;40;37;3;0;0;0
987950;eBall;;20,000 - 50,000;72;31;41;0;0;0
987980;王者战车;;0 - 20,000;8;14;-6;0;0;0
987990;Hyperborean Charter;;0 - 20,000;3;1;2;0;0;0
988070;All Of ZHEM;;0 - 20,000;0;4;-4;0;0;0
988080;3 on 3 Super Robot Hockey;;0 - 20,000;0;1;-1;0;0;0
988100;Super Phantom Cat;;20,000 - 50,000;174;36;138;0;0;1
988110;Breacher Story;;0 - 20,000;6;2;4;0;0;0
988240;Urban Trial Playground;;20,000 - 50,000;67;30;37;0;0;0
988250;TowerHex;;0 - 20,000;4;1;3;0;0;0
988310;Viola: The Heroine's Melody;;0 - 20,000;79;4;75;0;0;0
988330;One minute of death;;0 - 20,000;4;1;3;0;0;0
988340;Mad Hunting Simulator VR;;0 - 20,000;7;13;-6;0;0;0
988430;Lightseekers;;50,000 - 100,000;96;34;62;0;0;1
988480;Warhammer Age of Sigmar: Champions;;100,000 - 200,000;217;125;92;0;0;0
988490;Black Powder Red Earth;;20,000 - 50,000;156;17;139;578;578;1
988500;Trigger Table;;0 - 20,000;1;0;1;0;0;0
988590;SHELL_BREAK;;0 - 20,000;1;2;-1;0;0;0
988640;Christmas Wonderland;;0 - 20,000;1;0;1;0;0;0
988650;Inclement;;0 - 20,000;28;4;24;0;0;1
988890;The.Thend.End;;0 - 20,000;6;3;3;0;0;0
988910;Super Mega Baseball 3;;100,000 - 200,000;1596;157;1439;140;140;122
988920;NexVR Video Player;;0 - 20,000;0;3;-3;0;0;0
988930;Alveole;;0 - 20,000;51;9;42;0;0;0
988980;GLAD VALAKAS TOWER DEFENCE;;0 - 20,000;139;11;128;0;0;0
989000;Ruthless Water;;100,000 - 200,000;1;4;-3;0;0;0
989010;The Scenic Treasures - Japanese Learning;;0 - 20,000;1;2;-1;0;0;0
989040;After Hours;;0 - 20,000;13;8;5;0;0;0
989050;Greylaw: Season 1;;0 - 20,000;17;12;5;0;0;0
989060;Virtual Home Theater Video Player;;0 - 20,000;78;2;76;0;0;6
989110;Crystal Chameleon;;0 - 20,000;0;2;-2;0;0;0
989140;Damnaze;;0 - 20,000;2;0;2;0;0;0
989160;Throne Quest Deluxe;;0 - 20,000;8;2;6;0;0;0
989190;Slay All Goblins;;0 - 20,000;14;5;9;0;0;0
989250;Fight For Love;;0 - 20,000;4;3;1;0;0;0
989260;Home Plate Baseball;;0 - 20,000;2;2;0;0;0;0
989340;Aliens Don't Exist;;0 - 20,000;26;11;15;0;0;0
989370;More and More;;0 - 20,000;2;1;1;0;0;0
989380;Beard of Stone;;0 - 20,000;4;0;4;0;0;0
989390;NAR - Not Another Royale;;0 - 20,000;0;0;0;0;0;0
989400;Wild Ride;;0 - 20,000;1;0;1;0;0;0
989430;随风而逝 Story About Times;;0 - 20,000;61;12;49;0;0;0
989440;Phantom Abyss;;200,000 - 500,000;1689;269;1420;105;153;11
989450;时之回廊/Corridor of time;;20,000 - 50,000;335;190;145;0;0;1
989460;脚本塔防 Massacre  Tower;;0 - 20,000;30;22;8;0;0;0
989490;The Emulator;;20,000 - 50,000;50;37;13;0;0;0
989540;THE LAST SURVIVOR;;0 - 20,000;42;24;18;0;0;0
989550;Million Arthur: Arcana Blood;;0 - 20,000;196;53;143;240;240;1
989560;NeoGeometry;;0 - 20,000;15;9;6;0;0;0
989640;The Chronicles of King Arthur - Episode 1: Excalibur;;0 - 20,000;14;8;6;0;0;1
989650;Impossible Tower Defense 2D;;0 - 20,000;1;8;-7;0;0;0
989690;Conan Unconquered;;100,000 - 200,000;1147;517;630;336;536;4
989710;夕鬼 零 Yuoni: Rises;;0 - 20,000;8;5;3;0;0;0
989750;Life In Helsinki;;0 - 20,000;3;0;3;0;0;0
989750;Life In Helsinki;;0 - 20,000;3;0;3;0;0;0
989770;Biker Garage: Mechanic Simulator;;20,000 - 50,000;291;115;176;640;640;2
989780;Paradise City VR;;0 - 20,000;5;19;-14;0;0;0
989790;The Vale: Shadow of the Crown;;0 - 20,000;236;6;230;0;0;1
989870;Northern Tales;;0 - 20,000;1;0;1;0;0;0
990020;SINNERS;;0 - 20,000;29;1;28;0;0;0
990030;Deep Diving Simulator;;0 - 20,000;57;30;27;4;4;0
990050;Death end re;;;;;0;;;
990080;Hogwarts Legacy;;10,000,000 - 20,000,000;123097;8755;114342;1355;1109;402023
990090;The Dandelion Girl: Don't You Remember Me?;;0 - 20,000;115;6;109;0;0;0
990110;87 Aftermath: A Rolling Ball Game;;20,000 - 50,000;3;1;2;0;0;0
990160;ToyShot VR;;0 - 20,000;2;3;-1;0;0;0
990180;The Ghost of You;;0 - 20,000;25;1;24;0;0;0
990230;Mind Massaging Machine;;0 - 20,000;11;3;8;0;0;0
990250;Darkness and Flame: The Dark Side f2p;;50,000 - 100,000;133;46;87;0;0;4
990260;Collapse: A Political Simulator;;50,000 - 100,000;102;42;60;544;544;2
990280;Olimdal;;0 - 20,000;10;1;9;0;0;0
990360;SKYHILL: Black Mist;;0 - 20,000;104;83;21;0;0;0
990390;Riddles of the Owls' Kingdom. Magic Wings;;0 - 20,000;5;0;5;0;0;0
990400;Solitaire. Dragon Light;;0 - 20,000;16;5;11;0;0;0
990410;Slashvival;;0 - 20,000;3;2;1;0;0;0
990500;PANTY SLIDE VR;;0 - 20,000;9;5;4;0;0;0
990630;The Last Campfire;;200,000 - 500,000;4662;98;4564;206;226;24
990640;Numgeon;;0 - 20,000;61;18;43;0;0;0
990720;Bookend;;0 - 20,000;20;3;17;0;0;0
990750;RoboSnakes: Core Wars Legacy;;0 - 20,000;6;1;5;0;0;0
990850;Yanpai Simulator;;0 - 20,000;17;26;-9;0;0;0
990900;Neon Noodles - Cyberpunk Kitchen Automation;;0 - 20,000;34;1;33;0;0;0
990920;Sea of Craft;;20,000 - 50,000;328;100;228;0;0;2
990940;Full Of Love;;0 - 20,000;8;12;-4;0;0;0
990950;Indiana Boy Steam Edition;;0 - 20,000;10;4;6;0;0;0
991070;Destroy The World;;0 - 20,000;45;13;32;0;0;0
991080;HEXMAPMAKER;;0 - 20,000;4;3;1;0;0;0
991130;GUNSMOKE;;0 - 20,000;0;2;-2;0;0;0
991170;Barn Finders;;200,000 - 500,000;2905;590;2315;573;522;24
991240;Trivia Throwdown;;0 - 20,000;21;3;18;0;0;0
991260;Borderlands 2 VR;;20,000 - 50,000;678;547;131;59;82;12
991270;The Legend of Heroes: Trails of Cold Steel III;;50,000 - 100,000;2274;197;2077;4258;4473;92
991280;Air Combat XF;;20,000 - 50,000;13;15;-2;0;0;0
991430;You're Not Special;;20,000 - 50,000;18;0;18;0;0;0
991480;Santa Simulator;;0 - 20,000;17;3;14;12;12;0
991490;The Black Knight;;0 - 20,000;1;0;1;0;0;0
991500;Make A Jigsaw Puzzle;;0 - 20,000;4;1;3;0;0;0
991510;Epic Food Fight;;0 - 20,000;7;0;7;0;0;0
991510;Epic Food Fight;;0 - 20,000;7;0;7;0;0;0
991530;Choice or Fate;;0 - 20,000;8;2;6;0;0;0
991620;RepairBot;;0 - 20,000;12;3;9;0;0;0
991660;Voxel Sword;;0 - 20,000;5;1;4;0;0;0
991680;炎之陨落 The Fallen of The Blaze Empire;;0 - 20,000;9;7;2;0;0;0
991740;Era Of Newborns;;50,000 - 100,000;40;37;3;0;0;1
991750;Super Grower;;0 - 20,000;11;4;7;0;0;0
991760;Summer Sports Games;;0 - 20,000;8;5;3;0;0;0
991780;Notes of Soul;;500,000 - 1,000,000;16078;4655;11423;1087;229;225
991790;Magnesia;;20,000 - 50,000;55;18;37;0;0;0
991800;Puzzle game for kids;;0 - 20,000;9;2;7;0;0;0
991810;Strategic Mind: The Pacific;;20,000 - 50,000;444;129;315;153;153;11
991860;IMAZE.EXE 2;;0 - 20,000;11;4;7;0;0;0
991930;Psycho Boys;;0 - 20,000;13;1;12;0;0;0
991960;Greed: The Mad Scientist;;0 - 20,000;29;6;23;0;0;0
992000;Telekinetic;;0 - 20,000;3;9;-6;0;0;0
992040;Moot District;;0 - 20,000;7;11;-4;0;0;0
992050;Oik 5;;0 - 20,000;107;12;95;0;0;0
992070;Idle Wizard;;100,000 - 200,000;1008;153;855;0;0;737
992120;Inch by Inch;;0 - 20,000;52;2;50;0;0;0
992200;Feathery Ears 羽耳;;0 - 20,000;20;2;18;0;0;0
992210;Waves of the Atlantide;;0 - 20,000;29;4;25;0;0;0
992250;Space Hockey;;0 - 20,000;3;2;1;0;0;0
992300;嗜血印 Bloody Spell;;2,000,000 - 5,000,000;24092;3081;21011;759;234;5938
992310;Backbone: Prologue;;200,000 - 500,000;4009;110;3899;58;30;2
992330;Nightmare (Incubo);;20,000 - 50,000;163;42;121;0;0;0
992360;Otiiz's adventure - Sushi Champ;;0 - 20,000;0;2;-2;0;0;0
992420;Cotropitorii;;0 - 20,000;11;1;10;0;0;0
992480;Sudoku3D;;0 - 20,000;1;2;-1;0;0;0
992490;iVRy Driver for SteamVR;;100,000 - 200,000;157;59;98;1;1;3
992520;Meadow Fun!!;;0 - 20,000;7;0;7;0;0;0
992560;快乐蓝熊HappyBlueBear;;0 - 20,000;2;0;2;0;0;0
992610;Let's Create! Pottery VR;;0 - 20,000;25;8;17;0;0;0
992620;妖怪俱乐部 Demon Club;;0 - 20,000;14;11;3;0;0;0
992640;Pagan: Absent Gods;;100,000 - 200,000;1408;1368;40;1001;1103;1
992680;The Lovebirds;;0 - 20,000;11;4;7;0;0;0
992700;Lighter;;0 - 20,000;51;6;45;0;0;0
992720;東方苦粗芸物語 Touhou KSG Story;;0 - 20,000;5;6;-1;0;0;0
992730;Project Downfall;;0 - 20,000;258;52;206;0;0;0
992740;祈風 Inorikaze;;0 - 20,000;342;0;342;0;0;1
992740;祈風 Inorikaze;;0 - 20,000;342;0;342;0;0;1
992750;社稷终于幻想 ~ A Finality with Sheji;;0 - 20,000;28;1;27;0;0;0
992790;Switch & Ditch;;0 - 20,000;7;1;6;0;0;0
992860;Intrepid;;20,000 - 50,000;47;53;-6;0;0;0
992870;The Secret of Gillwood;;0 - 20,000;16;5;11;0;0;0
992880;Space Cruise;;0 - 20,000;1;0;1;0;0;0
992890;Tank raid;;0 - 20,000;4;3;1;0;0;0
992910;The Black Masses;;20,000 - 50,000;628;316;312;207;207;0
992950;Circle Rally Party;;0 - 20,000;12;1;11;0;0;0
992960;A Lullaby of Colors VR;;0 - 20,000;4;3;1;0;0;0
992970;Super Blackout;;0 - 20,000;3;0;3;0;0;0
992990;Beyond Extinct;;0 - 20,000;25;2;23;0;0;0
993090;Lossless Scaling;;20,000 - 50,000;924;132;792;1141;1379;87
993110;Skinwalker Hunt;;0 - 20,000;573;50;523;0;0;4
993110;Skinwalker Hunt;;0 - 20,000;573;50;523;0;0;4
993170;THE DEVIL HAUNTS ME;;20,000 - 50,000;154;15;139;0;0;1
993200;Calcul8²;;0 - 20,000;3;1;2;0;0;0
993220;FirstPlanet;;0 - 20,000;0;0;0;0;0;0
993250;Cover Sky;;0 - 20,000;7;4;3;0;0;0
993270;Bobs Track Builder Pro;;20,000 - 50,000;33;14;19;24;24;8
993290;JOBU-KI;;0 - 20,000;1;3;-2;0;0;0
993330;ISLAND 404;;0 - 20,000;5;10;-5;0;0;0
993340;Virtual Surfing;;0 - 20,000;86;50;36;0;0;0
993370;Killing Trials;;0 - 20,000;6;1;5;0;0;0
993400;Finding summer;;0 - 20,000;8;13;-5;0;0;0
993490;Tower Tank: TD Reversal;;0 - 20,000;1;1;0;0;0;0
993500;Ritual of the Moon;;0 - 20,000;7;2;5;0;0;0
993520;The Mars Agenda;;0 - 20,000;4;4;0;0;0;0
993530;Codename Nemesis;;0 - 20,000;0;1;-1;0;0;0
993580;Enchanted Path;;0 - 20,000;16;5;11;0;0;0
993630;Data mining 4;;0 - 20,000;9;5;4;0;0;0
993640;Boy Teen Dream;;0 - 20,000;31;16;15;0;0;0
993650;Bullynoid;;0 - 20,000;1;2;-1;0;0;0
993680;东方驾考模拟器|Chinese Driving License Test;;0 - 20,000;53;33;20;0;0;0
993690;Transport Services;;0 - 20,000;40;34;6;0;0;0
993740;Hentai Mosaique Puzzle;;0 - 20,000;0;0;0;95;138;2
993750;Girls & sweets;;0 - 20,000;2;9;-7;0;0;0
993780;Jewel Match Solitaire Winterscapes;;0 - 20,000;58;6;52;0;0;3
993790;Ancient Enemy;;0 - 20,000;375;35;340;0;0;1
993810;Lost City of Vampires;;0 - 20,000;24;8;16;0;0;0
993810;Lost City of Vampires;;0 - 20,000;24;8;16;0;0;0
993840;Drive;;0 - 20,000;11;7;4;0;0;0
993850;Tsukumono / つくもの / 付者;;0 - 20,000;15;2;13;0;0;0
993860;圈圈工坊 OO.Inc;;0 - 20,000;1;0;1;0;0;0
993870;CODE2040;;200,000 - 500,000;361;506;-145;0;0;0
993890;Scribble Plus;;0 - 20,000;4;1;3;0;0;0
993980;梅塔特隆 Metatron;;0 - 20,000;125;38;87;0;0;0
993990;Hunger Apartment （蚀狱）;;0 - 20,000;60;40;20;0;0;0
993990;Hunger Apartment （蚀狱）;;0 - 20,000;60;40;20;0;0;0
994030;Anime Girl Slide Puzzle;;0 - 20,000;3;0;3;0;0;0
994040;Lichtspeer: Double Speer Edition;;0 - 20,000;37;7;30;0;0;1
994140;Lightmatter;;200,000 - 500,000;2114;197;1917;208;198;5
994160;The Seduction of Shaqeera;;0 - 20,000;0;0;0;0;0;0
994170;Statue Defender;;0 - 20,000;1;1;0;0;0;0
994180;Tennis Fighters;;0 - 20,000;27;1;26;0;0;0
994190;Sound Slide;;100,000 - 200,000;382;126;256;0;0;0
994200;天际起源 The Ark of Horizon;;100,000 - 200,000;351;320;31;0;0;0
994220;NEOVERSE;;200,000 - 500,000;3073;559;2514;287;264;9
994230;Farming Village;;0 - 20,000;4;4;0;0;0;0
994250;肥肥大作战 fat battle;;0 - 20,000;0;1;-1;0;0;0
994260;Accel;;20,000 - 50,000;74;13;61;0;0;0
994280;古剑奇谭三(Gujian3);;500,000 - 1,000,000;37765;5959;31806;1543;764;480
994290;Five Day Great Escape 五日大逃亡;;0 - 20,000;42;6;36;0;0;0
994310;Let's Sing 2019;;0 - 20,000;13;24;-11;0;0;1
994320;Night City 2177;;0 - 20,000;20;39;-19;0;0;0
994340;Cat and Ghostly Road;;0 - 20,000;132;7;125;0;0;0
994350;The Seduction of Shaqeera VR;;0 - 20,000;0;0;0;0;0;0
994360;CoderBear;;0 - 20,000;6;0;6;0;0;0
994450;Steel Fight;;0 - 20,000;3;0;3;0;0;0
994500;Sky Racket;;20,000 - 50,000;156;5;151;0;0;0
994520;Oh Trap!;;;;;0;;;
994590;Pixel Fish;;0 - 20,000;11;1;10;0;0;0
994610;RelayCars;;0 - 20,000;9;2;7;0;0;0
994650;Space Struck Run;;0 - 20,000;1;2;-1;0;0;0
994670;ThreatGEN: Red vs. Blue;;0 - 20,000;57;6;51;0;0;2
994730;Banner of the Maid;;200,000 - 500,000;5854;695;5159;1739;1072;55
994750;景行 | Encourage;;0 - 20,000;6;13;-7;0;0;0
994790;熊孩子WildKids;;0 - 20,000;48;23;25;0;0;0
994860;Gunpowder on The Teeth: Arcade;;0 - 20,000;33;4;29;0;0;0
994870;Mysteries of Neverville: The Runestone of Light;;0 - 20,000;34;14;20;0;0;1
994900;Christmas Wonderland 2;;0 - 20,000;4;1;3;0;0;0
994910;Poker Master;;100,000 - 200,000;1557;102;1455;0;0;39
994930;Soccer Manager 2019;;200,000 - 500,000;552;168;384;0;0;9
995000;Escape Legacy VR;;0 - 20,000;19;8;11;0;0;0
995050;Havocado: Ragdoll Fighter;;50,000 - 100,000;429;86;343;43;43;6
995060;Fant Kids Animated Puzzle;;0 - 20,000;1;0;1;0;0;0
995060;Fant Kids Animated Puzzle;;0 - 20,000;1;0;1;0;0;0
995070;Rise Eterna;;0 - 20,000;56;74;-18;0;0;0
995140;Hand to Hand Combat;;0 - 20,000;8;10;-2;0;0;0
995160;Impulsow;;0 - 20,000;17;0;17;0;0;0
995170;Aim Bot;;0 - 20,000;12;2;10;0;0;0
995230;FREEDIVER: Triton Down;;20,000 - 50,000;243;45;198;0;0;0
995240;RemiLore: Lost Girl in the Lands of Lore;;0 - 20,000;25;20;5;0;0;0
995270;DeMagnete VR;;0 - 20,000;21;4;17;0;0;0
995270;DeMagnete VR;;0 - 20,000;21;4;17;0;0;0
995280;Stary;;0 - 20,000;7;10;-3;0;0;0
995310;Marble Odyssey;;0 - 20,000;3;1;2;0;0;1
995330;干支セトラ　陰ノ卷｜干支etc.　陰之卷;;0 - 20,000;21;4;17;0;0;0
995340;The Magnet Trials;;0 - 20,000;2;3;-1;0;0;0
995430;Zombieland: Double Tap - Road Trip;;0 - 20,000;21;14;7;0;0;0
995450;Geeksos;;0 - 20,000;44;11;33;0;0;0
995460;Miracle Snack Shop;;100,000 - 200,000;2149;57;2092;243;243;6
995470;Threshold;;0 - 20,000;154;40;114;0;0;0
995470;Threshold;;0 - 20,000;154;40;114;0;0;0
995480;Super president How to rule the country;;0 - 20,000;14;16;-2;0;0;0
995490;Kadath;;0 - 20,000;13;0;13;0;0;0
995660;XLaunchpad;;0 - 20,000;24;16;8;0;0;0
995700;Jewel Puzzle Click;;0 - 20,000;23;11;12;0;0;1
995720;Coffee VendoR;;0 - 20,000;19;3;16;0;0;0
995790;Dark Sauce;;0 - 20,000;19;15;4;0;0;0
995840;Road to Guangdong - Road Trip Car Driving Simulator Story-Based Indie Title (公路旅行驾驶游戏);;0 - 20,000;53;92;-39;8;8;0
995850;M.E.M.E.S.;;0 - 20,000;4;1;3;0;0;0
995870;Toddler Shooter;;0 - 20,000;23;5;18;0;0;0
995880;BLOCK Multiplayer: RPG;;20,000 - 50,000;87;94;-7;0;0;0
995890;Echoes of the Past: The Citadels of Time Collector's Edition;;0 - 20,000;2;2;0;0;0;1
995900;Haunted Hotel: Eclipse Collector's Edition;;0 - 20,000;10;2;8;0;0;0
995910;Redemption Cemetery: Children's Plight Collector's Edition;;0 - 20,000;4;2;2;0;0;1
995920;Myths of the World: Black Rose Collector's Edition;;0 - 20,000;7;0;7;0;0;0
995930;Maestro: Dark Talent Collector's Edition;;0 - 20,000;4;0;4;0;0;0
995980;Fae Tactics;;50,000 - 100,000;1044;178;866;724;1375;13
996000;Dark Data;;50,000 - 100,000;24;1;23;0;0;0
996050;Chieftain;;0 - 20,000;11;8;3;0;0;0
996080;King's League II;;0 - 20,000;80;19;61;0;0;2
996140;Strange and weird museum;;0 - 20,000;1;1;0;0;0;0
996150;SUBURI;;0 - 20,000;1;0;1;0;0;0
996160;Quest for the Golden Duck;;0 - 20,000;14;3;11;0;0;0
996170;Mage VR -Mini Version-;;20,000 - 50,000;1;1;0;0;0;0
996170;Mage VR -Mini Version-;;20,000 - 50,000;1;1;0;0;0;0
996180;Cryptofall: Investor simulator;;0 - 20,000;34;5;29;0;0;2
996230;tia.sav;;0 - 20,000;5;0;5;0;0;0
996280;Buttle Tank;;0 - 20,000;9;3;6;0;0;0
996370;Watch Me Stream My Mental Breakdown;;0 - 20,000;34;4;30;0;0;0
996380;Smartphone Tycoon;;100,000 - 200,000;815;684;131;169;251;5
996430;Pilot Sports;;0 - 20,000;3;1;2;0;0;0
996450;7th Sea: A Pirate's Pact;;0 - 20,000;20;4;16;0;0;1
996470;eFootball  PES 2020;;1,000,000 - 2,000,000;18590;7672;10918;2054;179;505
996550;持猫少女凯蒂/Kaidi, armed with a cat;;0 - 20,000;25;0;25;0;0;0
996580;Spyro Reignited Trilogy;;500,000 - 1,000,000;15666;868;14798;629;333;618
996620;LCD Sports: American Football;;0 - 20,000;2;0;2;0;0;0
996650;A Christmas Peril;;0 - 20,000;3;0;3;0;0;0
996710;天火(TianHuo);;0 - 20,000;3;3;0;0;0;0
996730;Unknown;;0 - 20,000;6;2;4;0;0;0
996770;Moving Out;;100,000 - 200,000;1327;384;943;433;318;30
996830;Rules of The Mafia: Trade & Blood;;0 - 20,000;3;44;-41;0;0;0
996860;Planet Nine;;0 - 20,000;8;2;6;0;0;0
996920;CONTINUE;;0 - 20,000;9;2;7;0;0;0
996980;Dis Pontibus;;0 - 20,000;24;2;22;0;0;0
997000;OSIRIS;;0 - 20,000;8;2;6;0;0;0
997010;Police Simulator: Patrol Officers;;500,000 - 1,000,000;9574;1722;7852;455;381;342
997020;Aye Aye, Captain;;0 - 20,000;0;1;-1;0;0;0
997030;Earth Atlantis;;0 - 20,000;37;21;16;0;0;0
997030;Earth Atlantis;;0 - 20,000;37;21;16;0;0;0
997050;Hentai Like a Boss;;0 - 20,000;7;5;2;0;0;0
997060;Kotodama: The 7 Mysteries of Fujisawa;;0 - 20,000;36;22;14;0;0;0
997070;Marvel's Avengers;;500,000 - 1,000,000;18731;9405;9326;1347;1026;214
997170;Zombie Scrapper;;0 - 20,000;9;1;8;0;0;0
997180;be you;;50,000 - 100,000;164;38;126;0;0;0
997260;Hyper Scuffle;;0 - 20,000;13;3;10;0;0;0
997270;傲皇忆剑诀;;0 - 20,000;2;3;-1;0;0;0
997280;Final_SIM;;0 - 20,000;7;0;7;0;0;0
997310;Rolly's Adventure;;0 - 20,000;2;0;2;0;0;0
997340;Star Destroyer;;0 - 20,000;4;4;0;0;0;0
997370;SimpleMovie;;0 - 20,000;8;2;6;0;0;0
997380;The Sapling;;50,000 - 100,000;322;41;281;15;15;19
997480;The Far Kingdoms: Age of Solitaire;;0 - 20,000;24;4;20;0;0;0
997480;The Far Kingdoms: Age of Solitaire;;0 - 20,000;24;4;20;0;0;0
997530;Caladria Chronicles;;0 - 20,000;3;0;3;0;0;0
997560;Flash Point - Online FPS;;0 - 20,000;36;27;9;0;0;0
997670;Ninja Power Slasher;;0 - 20,000;3;1;2;0;0;0
997700;瓶中精灵 - Fairy in a Jar;;20,000 - 50,000;177;10;167;0;0;0
997710;Ravenland;;0 - 20,000;11;9;2;0;0;0
997720;Let's Learn Japanese! Hiragana;;0 - 20,000;69;7;62;0;0;2
997730;Deez;;0 - 20,000;51;11;40;0;0;0
997730;Deez;;0 - 20,000;51;11;40;0;0;0
997870;City Defense;;0 - 20,000;4;8;-4;0;0;1
997950;Folding Edge;;0 - 20,000;16;2;14;0;0;0
998020;Unearthing Mars 2: The Ancient War;;0 - 20,000;12;9;3;0;0;0
998150;荒野大蛮神;;0 - 20,000;10;8;2;0;0;0
998220;The Dungeon of Lulu Farea;;0 - 20,000;162;18;144;374;374;2
998270;The Other: Airi's Adventure;;0 - 20,000;15;0;15;0;0;0
998300;欢乐块队;;0 - 20,000;2;3;-1;0;0;0
998330;My Desktop Alive;;0 - 20,000;17;9;8;0;0;0
998340;DragonFang - Drahn's Mystery Dungeon;;50,000 - 100,000;52;45;7;10;10;0
998470;Adult Math;;0 - 20,000;55;21;34;0;0;0
998470;Adult Math;;0 - 20,000;55;21;34;0;0;0
998480;Gangsta Sniper 2: Revenge;;0 - 20,000;16;20;-4;0;0;0
998530;Winter Sports Games;;0 - 20,000;0;2;-2;0;0;0
998570;De'Vine: Card Battles;;0 - 20,000;19;8;11;0;0;0
998590;Infernum;;0 - 20,000;2;2;0;0;0;0
998630;Fated Era;;0 - 20,000;8;2;6;0;0;0
998660;Sopwith VR;;50,000 - 100,000;283;45;238;0;0;0
998690;Run Away;;0 - 20,000;2;0;2;0;0;0
998730;Hail To The King;;0 - 20,000;8;5;3;0;0;0
998740;Ring of Pain;;100,000 - 200,000;3417;322;3095;334;345;57
998790;Piczle Lines DX+α;;0 - 20,000;32;6;26;0;0;2
998820;Cortex;;20,000 - 50,000;13;1;12;0;0;0
998830;The Last Roman Village;;0 - 20,000;12;6;6;0;0;0
998850;Knights of the Card Table;;0 - 20,000;22;8;14;0;0;0
998890;The Colony;;0 - 20,000;2;4;-2;0;0;0
998930;Seek Girl;;200,000 - 500,000;3680;973;2707;726;23;15
998950;Rhythm Nights;;0 - 20,000;0;2;-2;0;0;0
998990;Psyvariar Delta;;0 - 20,000;39;3;36;0;0;0
999020;Mega Man Zero/ZX Legacy Collection;;50,000 - 100,000;1206;314;892;4;4;28
999040;K.O.M.A;;0 - 20,000;6;4;2;0;0;0
999190;EndZ Village;;0 - 20,000;20;17;3;0;0;0
999200;Offendron Warrior;;0 - 20,000;40;7;33;0;0;0
999220;Amnesia: Rebirth;;500,000 - 1,000,000;5323;1620;3703;1083;1902;27
999250;Chucky;;0 - 20,000;5;0;5;0;0;0
999270;War Builder League;;50,000 - 100,000;100;63;37;0;0;1
999310;THE NED BALLS;;0 - 20,000;10;7;3;0;0;0
999350;Uzak Diyar Destanları 1: Remastered;;20,000 - 50,000;82;13;69;0;0;0
999360;soul room;;0 - 20,000;7;2;5;0;0;0
999410;Magnibox;;0 - 20,000;48;2;46;0;0;1
999410;Magnibox;;0 - 20,000;48;2;46;0;0;1
999430;Santa Tracker;;0 - 20,000;6;2;4;0;0;0
999540;Scroll2Read;;0 - 20,000;2;3;-1;0;0;0
999560;Fragile Equilibrium;;0 - 20,000;10;1;9;0;0;0
999640;Cube Defense;;0 - 20,000;42;26;16;0;0;0
999660;SAMURAI SHODOWN NEOGEO COLLECTION;;0 - 20,000;164;31;133;0;0;4
999730;Secret Neighbor Beta;;200,000 - 500,000;2405;475;1930;137;80;1
999750;BLASTER LiLO;;0 - 20,000;2;0;2;0;0;0
999760;Mobile Wars X;;20,000 - 50,000;20;7;13;0;0;0
999830;Becalm;;50,000 - 100,000;288;55;233;0;0;0
999840;RONE;;0 - 20,000;7;0;7;0;0;0
999860;Enemy On Board;;100,000 - 200,000;1148;423;725;39;40;1
999880;NASA's Exoplanet Excursions;;0 - 20,000;15;4;11;0;0;0
999890;Bruken;;0 - 20,000;2;0;2;0;0;0
999900;Studio by RADiCAL;;20,000 - 50,000;12;19;-7;0;0;0
999930;Fantasy Sino-Japanese War 幻想甲午;;0 - 20,000;2;2;0;0;0;0
999990;Bouncing Hero;;0 - 20,000;10;0;10;0;0;0
1000000;ASCENXION;;0 - 20,000;26;6;20;0;0;0
1000010;Crown Trick;;200,000 - 500,000;4139;661;3478;559;431;48
1000030;Cook, Serve, Delicious! 3?!;;100,000 - 200,000;1654;124;1530;153;169;34
1000040;细胞战争;;0 - 20,000;0;1;-1;0;0;0
1000080;Zengeon;;100,000 - 200,000;1012;468;544;97;148;5
1000100;干支セトラ　陽ノ卷｜干支etc.　陽之卷;;0 - 20,000;18;6;12;0;0;0
1000130;Cube Defender;;0 - 20,000;6;0;6;0;0;0
1000280;Tower of Origin2-Worm's Nest;;0 - 20,000;31;14;17;0;0;0
1000310;人气动漫大乱斗;;0 - 20,000;1;5;-4;0;0;0
1000360;Hellish Quart;;200,000 - 500,000;4649;417;4232;239;251;51
1000370;SurReal Subway;;0 - 20,000;0;1;-1;0;0;0
1000380;Rogue Reaper;;100,000 - 200,000;311;88;223;0;0;0
1000410;WRATH: Aeon of Ruin;;50,000 - 100,000;1246;344;902;179;219;4
1000440;东方雪莲华 ～ Abyss Soul Lotus.;;0 - 20,000;272;24;248;89;89;4
1000460;Arsonist;;0 - 20,000;0;0;0;0;0;0
1000470;Drawngeon: Dungeons of Ink and Paper;;20,000 - 50,000;55;14;41;0;0;0
1000480;Battle Motion;;0 - 20,000;9;6;3;0;0;0
1000500;The Undisputables : Online Multiplayer Shooter;;100,000 - 200,000;10;3;7;0;0;0
1000510;The Marvellous Machine;;20,000 - 50,000;109;22;87;0;0;0
1000540;Tactical Control;;20,000 - 50,000;54;12;42;0;0;0
1000550;Love Hentai: Endgame;;0 - 20,000;0;0;0;0;0;0
1000600;The ScreaMaze;;0 - 20,000;7;1;6;0;0;0
1000640;Clam Man;;20,000 - 50,000;113;8;105;0;0;2
1000650;Fist Of Heaven & Hell;;0 - 20,000;7;0;7;0;0;0
1000700;Insomnis;;0 - 20,000;182;14;168;0;0;1
1000750;Rotund Rebound;;0 - 20,000;7;0;7;0;0;0
1000760;Foregone;;20,000 - 50,000;828;178;650;412;512;19
1000770;Urban Tale;;0 - 20,000;77;42;35;0;0;1
1000790;Flex Apocalypse Racing;;0 - 20,000;6;4;2;0;0;0
1000810;RogueCraft Squadron;;0 - 20,000;5;1;4;0;0;0
1000830;Gachi Finder 3000;;0 - 20,000;162;4;158;0;0;0
1000860;Allspace;;0 - 20,000;40;19;21;0;0;0
1000870;On Target VR Darts;;0 - 20,000;5;5;0;0;0;0
1000880;REPTOMOM;;0 - 20,000;0;1;-1;0;0;0
1000900;Zero spring episode 3;;0 - 20,000;1;0;1;0;0;0
1000980;Kill Tiger;;0 - 20,000;1;0;1;0;0;0
1000990;Gun Beat;;0 - 20,000;8;3;5;0;0;0
1001010;雪·疑 Sknow;;0 - 20,000;9;3;6;0;0;0
1001040;Glorious Companions;;0 - 20,000;66;41;25;0;0;0
1001070;Koi;;0 - 20,000;111;22;89;0;0;0
1001070;Koi;;0 - 20,000;111;22;89;0;0;0
1001100;Kooring VR Wonderland:Mecadino's Attack;;0 - 20,000;12;0;12;0;0;0
1001140;Angry Birds VR: Isle of Pigs;;20,000 - 50,000;273;28;245;148;148;6
1001170;Master Of Secrets: Dark Europe;;0 - 20,000;1;11;-10;0;0;0
1001200;ROWROW;;0 - 20,000;13;2;11;0;0;0
1001230;Partial Control;;0 - 20,000;29;3;26;0;0;0
1001240;VR Flight Simulator New York - Cessna;;0 - 20,000;11;13;-2;0;0;0
1001380;SNAILS;;0 - 20,000;5;3;2;0;0;0
1001390;VireFit;;0 - 20,000;2;6;-4;0;0;0
1001430;Next Stop 3;;0 - 20,000;17;0;17;0;0;0
1001450;The Town;;0 - 20,000;1;1;0;0;0;0
1001490;Tower Behind the Moon;;0 - 20,000;8;6;2;0;0;0
1001500;Chronicon Apocalyptica;;0 - 20,000;6;2;4;0;0;0
1001550;In Orbit;;0 - 20,000;8;3;5;0;0;0
1001570;GUIDE;;0 - 20,000;2;0;2;0;0;0
1001590;Grab Lab;;0 - 20,000;9;0;9;0;0;0
1001600;Diggerman;;0 - 20,000;34;2;32;0;0;0
1001640;Where the Bees Make Honey;;0 - 20,000;23;36;-13;0;0;0
1001660;The Demon Crystal;;0 - 20,000;11;0;11;0;0;0
1001690;Mars Flight VR;;0 - 20,000;7;4;3;0;0;0
1001730;Twisting Mower;;0 - 20,000;1;0;1;0;0;0
1001740;Diamonds;;0 - 20,000;4;0;4;0;0;0
1001760;Xtreme League;;0 - 20,000;0;3;-3;0;0;0
1001800;KUNAI;;0 - 20,000;397;82;315;254;484;0
1001810;Virus Expansion;;0 - 20,000;1;3;-2;0;0;0
1001860;Casual Desktop Game;;20,000 - 50,000;149;26;123;0;0;0
1001870;RoboVirus;;0 - 20,000;29;1;28;0;0;0
1001880;aMAZE Valentine;;0 - 20,000;50;9;41;0;0;0
1001910;Fused;;0 - 20,000;6;4;2;0;0;0
1001950;There Was A Dream;;0 - 20,000;9;5;4;0;0;0
1001960;Zibbs - Alien Survival;;0 - 20,000;12;9;3;0;0;0
1001970;Rhythmy;;0 - 20,000;26;2;24;0;0;0
1001980;Archeo: Shinar;;0 - 20,000;80;22;58;0;0;0
1001990;WARED;;20,000 - 50,000;1;4;-3;0;0;0
1002000;SPITLINGS;;0 - 20,000;33;4;29;0;0;0
1002000;SPITLINGS;;0 - 20,000;33;4;29;0;0;0
1002020;INTERPOINT;;20,000 - 50,000;38;14;24;0;0;0
1002030;Hentai beautiful girls;;0 - 20,000;0;0;0;0;0;0
1002180;AUSSIE BATTLER TANKS;;0 - 20,000;6;3;3;0;0;0
1002200;Vasilis;;20,000 - 50,000;10;6;4;0;0;0
1002210;孤岛(Isolated Island);;0 - 20,000;22;1;21;0;0;0
1002230;War of Three Kingdoms;;0 - 20,000;7;21;-14;0;0;0
1002270;PiiSim;;0 - 20,000;52;5;47;0;0;0
1002280;The Far Kingdoms: Elements;;0 - 20,000;19;9;10;0;0;0
1002290;某1种青春;;20,000 - 50,000;343;13;330;0;0;0
1002310;The Childs Sight;;0 - 20,000;6;2;4;0;0;0
1002360;バグダス - デバッガー検定 -;;0 - 20,000;60;12;48;0;0;0
1002410;The Five Cores Remastered;;0 - 20,000;12;9;3;0;0;0
1002420;Agartha;;0 - 20,000;7;3;4;0;0;0
1002430;Victory Road;;0 - 20,000;167;10;157;0;0;1
1002440;Fantastic Creatures;;0 - 20,000;11;3;8;0;0;0
1002480;Condors Vs Ocelots;;0 - 20,000;2;1;1;0;0;0
1002490;Roulette Simulator 2;;0 - 20,000;15;11;4;0;0;0
1002500;M.C.I. Escapes;;0 - 20,000;1;0;1;0;0;0
1002510;The Spell - A Kinetic Novel;;0 - 20,000;23;0;23;0;0;0
1002520;Eggys Games Flash Collection;;0 - 20,000;6;1;5;0;0;0
1002540;HA/CK;;0 - 20,000;14;4;10;0;0;0
1002560;Tiny Snow;;50,000 - 100,000;3292;154;3138;157;164;6
1002580;Cell Defender;;0 - 20,000;3;1;2;0;0;0
1002590;N-GON;;0 - 20,000;5;0;5;0;0;0
1002600;Temple of Pizza;;0 - 20,000;3;5;-2;0;0;0
1002630;AWAKE - Definitive Edition;;0 - 20,000;45;19;26;0;0;0
1002650;Puttin' Around;;0 - 20,000;4;3;1;0;0;0
1002670;SOF - RAIDERS;;0 - 20,000;3;2;1;0;0;0
1002690;Hand of Horzasha;;0 - 20,000;12;0;12;0;0;0
1002750;Ordo Et Chao: New World;;0 - 20,000;1;2;-1;0;0;0
1002800;Tsumi;;0 - 20,000;14;1;13;0;0;0
1002830;Latte Stand Tycoon;;0 - 20,000;23;10;13;0;0;0
1002850;古战三国 Ancient War: Three Kingdoms;;50,000 - 100,000;75;46;29;0;0;0
1002860;Magus Over Fool;;0 - 20,000;3;0;3;0;0;0
1002910;Twisty Puzzle Simulator;;0 - 20,000;4;0;4;0;0;0
1002920;The Last Dinner;;20,000 - 50,000;18;15;3;0;0;0
1002930;War of Tanks: Blitzkrieg;;50,000 - 100,000;92;66;26;0;0;33
1002930;War of Tanks: Blitzkrieg;;50,000 - 100,000;92;66;26;0;0;33
1002950;Gravity Panda;;0 - 20,000;0;1;-1;0;0;0
1002960;Hentai NetWalk;;0 - 20,000;37;11;26;0;0;0
1002970;Freefall 3050AD;;200,000 - 500,000;14;4;10;0;0;0
1002980;Symploke: Legend of Gustavo Bueno (Chapter 3);;0 - 20,000;8;0;8;0;0;0
1003000;Punishment Darkness Online;;0 - 20,000;4;4;0;0;0;0
1003010;Clicker Warriors;;20,000 - 50,000;46;69;-23;0;0;1
1003020;Alluna and Brie;;0 - 20,000;29;1;28;0;0;0
1003070;Groomer;;0 - 20,000;26;14;12;0;0;0
1003090;Through the Darkest of Times;;50,000 - 100,000;771;141;630;37;47;4
1003120;Hitchhiker - A Mystery Game;;0 - 20,000;102;34;68;0;0;0
1003150;TRANSIT;;0 - 20,000;2;8;-6;0;0;0
1003190;Alpacapaca Double Dash;;0 - 20,000;15;2;13;0;0;0
1003230;AIRA VR;;0 - 20,000;11;2;9;0;0;0
1003320;Nya Nya Nya Girls 2 (ʻʻʻ)_(=^･ω･^=)_(ʻʻʻ);;0 - 20,000;5;2;3;0;0;0
1003360;ШХД: ЗИМА / IT'S WINTER;;50,000 - 100,000;533;173;360;0;0;2
1003370;Graywalkers: Purgatory;;0 - 20,000;21;9;12;0;0;0
1003400;The Lord of the Rings: Journeys in Middle-earth;;100,000 - 200,000;573;59;514;1170;2338;60
1003450;Terrorarium;;20,000 - 50,000;21;6;15;0;0;0
1003480;Fireboy & Watergirl: Elements;;20,000 - 50,000;531;62;469;125;146;9
1003490;cat notebook;;0 - 20,000;44;13;31;0;0;0
1003520;Hentai Crush;;50,000 - 100,000;1335;197;1138;105;147;5
1003530;学院英雄梦 HeroDreamOfSchool;;0 - 20,000;0;5;-5;0;0;0
1003560;Crumbling World;;0 - 20,000;12;5;7;0;0;0
1003590;Tetris Effect: Connected;;200,000 - 500,000;4665;216;4449;691;725;209
1003600;NashBored;;0 - 20,000;20;2;18;0;0;0
1003650;Abandonment;;0 - 20,000;0;4;-4;0;0;0
1003670;Vacation Adventures: Park Ranger;;0 - 20,000;2;4;-2;0;0;0
1003690;CrossTrix;;0 - 20,000;1;0;1;0;0;0
1003730;Soko Loco Deluxe;;0 - 20,000;42;2;40;0;0;3
1003750;她2 : 我还想再见到你   Her2 : I Want To See You Again;;0 - 20,000;134;12;122;0;0;0
1003760;Aether Way;;0 - 20,000;2;1;1;0;0;0
1003830;Cold Silence;;0 - 20,000;3;2;1;0;0;1
1003840;ШПМЛ5 (ShPML5);;0 - 20,000;4;0;4;0;0;0
1003850;Dark Sun Pictures' Dark Sun - The Space Shooter;;0 - 20,000;1;1;0;0;0;0
1003860;Gravity Ace;;0 - 20,000;26;1;25;0;0;0
1003880;Sky of Destruction;;0 - 20,000;20;13;7;0;0;0
1003880;Sky of Destruction;;0 - 20,000;20;13;7;0;0;0
1003890;Blacksad: Under the Skin;;200,000 - 500,000;3698;646;3052;276;393;25
1003940;Invasion Zero;;0 - 20,000;16;18;-2;0;0;0
1003940;Invasion Zero;;0 - 20,000;16;18;-2;0;0;0
1003960;De Profundis;;0 - 20,000;1;0;1;0;0;0
1004000;Card Brawl;;0 - 20,000;20;9;11;0;0;0
1004030;Rhythm Overdrive;;0 - 20,000;10;1;9;0;0;0
1004050;time of the zombies;;0 - 20,000;5;13;-8;0;0;0
1004100;Chaos Caves;;0 - 20,000;2;3;-1;0;0;0
1004150;Madorica Real Estate;;0 - 20,000;54;3;51;0;0;1
1004170;The Truck Game;;0 - 20,000;1;0;1;0;0;1
1004180;Boundary VR;;0 - 20,000;0;2;-2;0;0;0
1004190;Flowers in Dark;;20,000 - 50,000;68;13;55;0;0;0
1004200;Biathlon Battle VR;;0 - 20,000;16;12;4;0;0;0
1004210;Pandamonia 潘德莫尼亚;;0 - 20,000;126;8;118;0;0;0
1004230;The Revenge of Johnny Bonasera: Episode 3;;0 - 20,000;10;1;9;0;0;0
1004240;Hentai Girl Karen;;20,000 - 50,000;522;19;503;95;49;8
1004270;My Island;;20,000 - 50,000;1026;463;563;70;70;7
1004310;Maze 3D;;0 - 20,000;5;0;5;0;0;0
1004320;Sick Love - An RPG Maker Novel;;0 - 20,000;2;3;-1;0;0;0
1004330;My Exercise;;0 - 20,000;353;22;331;20;20;0
1004350;Area Cooperation Economic Simulation: North Korea (ACES);;0 - 20,000;3;1;2;0;0;0
1004370;Paper Cut Mansion;;0 - 20,000;35;10;25;0;0;1
1004490;Tools Up!;;20,000 - 50,000;659;216;443;344;217;16
1004500;The Chronicles of Jonah and the Whale;;0 - 20,000;16;5;11;0;0;1
1004510;DownStream: VR Whitewater Kayaking;;0 - 20,000;42;4;38;0;0;0
1004550;Stickman Racer Road Draw 2;;0 - 20,000;6;12;-6;0;0;0
1004560;Everpath;;0 - 20,000;54;24;30;0;0;1
1004570;blocks;;0 - 20,000;2;1;1;0;0;0
1004600;Find-Life EP1;;0 - 20,000;7;2;5;0;0;0
1004610;Roombo: First Blood;;20,000 - 50,000;266;33;233;24;24;0
1004620;KungFu Kickball;;0 - 20,000;47;10;37;0;0;0
1004650;Unlock Me;;0 - 20,000;35;1;34;0;0;0
1004710;POCKET CAR : VRGROUND;;0 - 20,000;6;12;-6;0;0;0
1004710;POCKET CAR : VRGROUND;;0 - 20,000;6;12;-6;0;0;0
1004740;iDancer;;0 - 20,000;88;15;73;6;6;1
1004750;WRC 8 FIA World Rally Championship;;0 - 20,000;775;279;496;72;96;24
1004770;Maiden and Spell;;20,000 - 50,000;574;11;563;57;57;6
1004770;Maiden and Spell;;20,000 - 50,000;574;11;563;57;57;6
1004780;Noel's Hope;;0 - 20,000;2;2;0;0;0;0
1004790;PsyOps Solutions;;0 - 20,000;1;1;0;0;0;0
1004860;The Secret Order 7: Shadow Breach;;0 - 20,000;129;19;110;476;476;4
1005000;Argonauts Agency: Golden Fleece;;0 - 20,000;35;2;33;0;0;3
1005050;Fabulous - Angela's True Colors;;0 - 20,000;44;5;39;0;0;1
1005060;Fabulous - New York to LA;;0 - 20,000;29;6;23;0;0;1
1005080;Yukinas Diary;;0 - 20,000;7;1;6;0;0;0
1005130;Delicious - Emily's Road Trip;;0 - 20,000;87;19;68;0;0;2
1005240;Pixel Puzzles Illustrations & Anime;;20,000 - 50,000;82;17;65;0;0;17
1005250;Arkane Rush Multiverse Mayhem;;0 - 20,000;4;1;3;0;0;0
1005300;The Jackbox Party Pack 6;;200,000 - 500,000;2407;115;2292;437;353;220
1005310;Snake vs Snake;;0 - 20,000;24;0;24;0;0;0
1005330;The Polynesian Cultural Center VR Experience;;0 - 20,000;12;3;9;0;0;0
1005340;Myths and Legends - Card Game;;50,000 - 100,000;309;202;107;0;0;7
1005390;Anti-Grav Bamboo-copter;;0 - 20,000;1;0;1;0;0;0
1005400;Star Drift Evolution;;20,000 - 50,000;197;11;186;237;316;1
1005410;Freedom Finger;;50,000 - 100,000;116;8;108;0;0;0
1005450;Vision Soft Reset;;0 - 20,000;67;3;64;0;0;2
1005480;ELISEISK 2074;;0 - 20,000;6;1;5;0;0;0
1005490;The Deep Diving of FloodDragon;;0 - 20,000;9;7;2;0;0;0
1005530;Club Soccer Director PRO 2020;;0 - 20,000;8;16;-8;0;0;1
1005580;Agricola Revised Edition;;20,000 - 50,000;72;67;5;0;0;6
1005580;Agricola Revised Edition;;20,000 - 50,000;72;67;5;0;0;6
1005630;Hope For Village;;20,000 - 50,000;12;8;4;0;0;0
1005730;The First Track;;0 - 20,000;17;4;13;0;0;0
1005780;Card Adventures;;0 - 20,000;1;1;0;0;0;0
1005820;Chishiki Runner;;0 - 20,000;0;1;-1;0;0;0
1005870;HYPERFIGHT;;50,000 - 100,000;751;83;668;0;0;7
1005890;KALEIDO STELLA;;0 - 20,000;9;2;7;0;0;0
1005900;Christmas Time 2019;;0 - 20,000;40;5;35;0;0;0
1005910;TAKANARIA;;50,000 - 100,000;219;23;196;0;0;0
1005920;Muscles And Bullets;;0 - 20,000;14;0;14;0;0;0
1005930;Timeflow – Life Sim;;50,000 - 100,000;1299;81;1218;438;438;38
1005950;大老爷;;20,000 - 50,000;59;132;-73;0;0;3
1005990;Swordbreaker: Back to The Castle;;0 - 20,000;51;27;24;0;0;0
1006090;Retro Space Shooter;;0 - 20,000;1;0;1;0;0;0
1006120;Tetsumo Party;;0 - 20,000;11;2;9;0;0;0
1006140;Heroes of a Broken Land 2;;0 - 20,000;17;4;13;0;0;0
1006150;Urban Justice;;0 - 20,000;16;13;3;0;0;0
1006160;Dungeons of Legend: Cast Within;;0 - 20,000;9;0;9;0;0;0
1006170;消灭魔王军 Destroy the demon army;;50,000 - 100,000;5;10;-5;0;0;0
1006190;Colorvore;;0 - 20,000;1;0;1;0;0;0
1006220;Type Knight;;0 - 20,000;101;9;92;0;0;1
1006270;oldbI tyt ?;;0 - 20,000;107;19;88;0;0;1
1006390;プランZ PlanZ;;0 - 20,000;6;3;3;0;0;0
1006400;Fantasia of the Wind 2 风之幻想曲 第二部;;0 - 20,000;84;9;75;5372;5372;1
1006410;Tanks Endeavor;;0 - 20,000;1;0;1;0;0;0
1006430;Hectic Highways;;0 - 20,000;3;0;3;0;0;0
1006440;The Dame Was Loaded;;20,000 - 50,000;14;3;11;0;0;0
1006450;Eric The Unready;;0 - 20,000;8;2;6;0;0;0
1006460;Mission Critical;;0 - 20,000;13;1;12;0;0;0
1006470;The Legacy of Music;;0 - 20,000;1;7;-6;0;0;0
1006600;Hentai Octoq Puzzle;;0 - 20,000;1;2;-1;0;0;0
1006680;Expanse;;0 - 20,000;3;5;-2;0;0;1
1006700;3Gun Nation VR;;0 - 20,000;13;9;4;0;0;0
1006710;Decent Icons 2;;0 - 20,000;58;12;46;1;1;8
1006720;PUZZLE: BIRDS;;0 - 20,000;13;4;9;0;0;0
1006730;Cantrip Cafe;;0 - 20,000;7;0;7;0;0;0
1006770;the LAST LETTER;;0 - 20,000;2;2;0;0;0;0
1006800;汉末求生  Survival in Three kingdoms;;0 - 20,000;40;8;32;0;0;0
1006830;Moonlight thief;;0 - 20,000;7;3;4;0;0;0
1006850;XDeskClock;;0 - 20,000;34;13;21;0;0;7
1006880;Chocolate makes you happy: Valentine's Day;;0 - 20,000;16;12;4;0;0;1
1006900;Last Line VR: A Zombie Defense Game;;0 - 20,000;4;7;-3;0;0;0
1006920;Pull Ball;;0 - 20,000;12;2;10;0;0;0
1006930;Hentai Jigsaw Puzzle;;0 - 20,000;0;0;0;46;46;1
1007040;EARTH DEFENSE FORCE 5;;500,000 - 1,000,000;7315;409;6906;1692;1527;606
1007050;Dark Hill Museum of Death;;0 - 20,000;34;2;32;0;0;0
1007070;BorderStrain;;0 - 20,000;8;3;5;0;0;0
1007080;Death Rpg;;0 - 20,000;7;11;-4;0;0;0
1007140;Future Aero Racing S Ultra;;0 - 20,000;9;4;5;0;0;0
1007180;Retromancer;;0 - 20,000;6;0;6;0;0;0
1007200;Mutagen Extinction;;0 - 20,000;5;4;1;0;0;0
1007210;Trouble Travel TT;;0 - 20,000;19;9;10;0;0;0
1007230;VRLab Academy Anatomy VR;;0 - 20,000;1;1;0;0;0;0
1007240;Stage of Light;;0 - 20,000;6;6;0;0;0;0
1007260;BubbleGum-Push;;0 - 20,000;14;5;9;0;0;0
1007260;BubbleGum-Push;;0 - 20,000;14;5;9;0;0;0
1007350;Mirror Maker;;100,000 - 200,000;683;269;414;270;8;7
1007360;SZEN;;0 - 20,000;7;0;7;0;0;0
1007390;Ling: A Road Alone;;20,000 - 50,000;147;82;65;0;0;0
1007400;Alien Shooter 2 - The Legend;;20,000 - 50,000;468;451;17;280;291;18
1007430;SixCubes;;0 - 20,000;15;5;10;0;0;0
1007440;Solitaire: Learn Chemistry;;20,000 - 50,000;4;2;2;0;0;0
1007490;Gladiator: Blades of Fury;;0 - 20,000;4;6;-2;0;0;0
1007520;Willy Jetman: Astromonkey's Revenge;;0 - 20,000;80;5;75;0;0;1
1007540;TankDestruction;;0 - 20,000;20;9;11;0;0;0
1007560;Fun VR Farm;;0 - 20,000;3;4;-1;0;0;0
1007630;Wraithslayer;;0 - 20,000;70;5;65;0;0;1
1007630;Wraithslayer;;0 - 20,000;70;5;65;0;0;1
1007730;Greed 2: Forbidden Experiments;;0 - 20,000;26;8;18;0;0;0
1007740;Refight:The Last Warship;;50,000 - 100,000;199;105;94;0;0;0
1007800;Single Diary: Fresh Graduate;;0 - 20,000;118;45;73;0;0;1
1007810;重明鸟 Bright Bird;;50,000 - 100,000;576;195;381;0;0;3
1007820;Brawl;;0 - 20,000;9;2;7;0;0;0
1007830;Edgar - Bokbok in Boulzac;;0 - 20,000;82;14;68;0;0;0
1007870;B画少说;;0 - 20,000;9;4;5;0;0;0
1007880;I am Ball;;0 - 20,000;8;1;7;0;0;0
1007930;Space Digger;;0 - 20,000;2;0;2;0;0;0
1007940;Classic Jigsaw Puzzles;;0 - 20,000;17;4;13;0;0;2
1007950;Birchian Flight Simulator;;0 - 20,000;7;11;-4;0;0;0
1007970;This Side (Early Access Game);;0 - 20,000;0;13;-13;0;0;0
1007980;Santa in search of toys;;0 - 20,000;15;2;13;0;0;0
1007990;Dodge Dummy;;0 - 20,000;9;25;-16;0;0;0
1008000;Aetheria Online;;0 - 20,000;59;27;32;0;0;0
1008000;Aetheria Online;;0 - 20,000;59;27;32;0;0;0
1008010;Spykebots;;0 - 20,000;8;1;7;0;0;0
1008060;The HARDEST BrickBreaker;;0 - 20,000;8;0;8;0;0;0
1008140;The Chills;;0 - 20,000;19;12;7;0;0;0
1008160;SubnetPing;;0 - 20,000;3;1;2;0;0;0
1008250;ProMV-Music-Video-Maker;;0 - 20,000;1;0;1;0;0;0
1008260;Where Is The Beach?;;0 - 20,000;3;1;2;0;0;0
1008280;Fairy Picturebook of Hero and Sorceress / 勇者と魔法使いとおとぎの絵本;;0 - 20,000;33;2;31;0;0;1
1008290;Lucky Of Love;;0 - 20,000;40;46;-6;0;0;0
1008320;Epic Adventures: La Jangada;;0 - 20,000;9;12;-3;0;0;0
1008370;Achievement Collector: Dog;;0 - 20,000;3;12;-9;0;0;0
1008390;Crazy Mosquito;;0 - 20,000;3;1;2;0;0;0
1008430;Alpha Command;;0 - 20,000;1;0;1;0;0;0
1008450;Maze Quest 2: The Desert;;20,000 - 50,000;1;0;1;0;0;0
1008510;Who Is This Man;;20,000 - 50,000;160;86;74;0;0;0
1008520;Mahjong Strip Solitaire: Harem Guild;;0 - 20,000;0;0;0;0;0;0
1008580;Overstep;;100,000 - 200,000;361;147;214;0;0;0
1008600;Shadowy Contracts;;0 - 20,000;4;0;4;0;0;0
1008610;The Trials of Olympus II: Wrath of the Gods;;0 - 20,000;9;8;1;0;0;0
1008650;Elf Epizode One;;0 - 20,000;2;4;-2;0;0;1
1008680;Crazy Archery;;0 - 20,000;12;8;4;0;0;0
1008690;Lost Daughter;;50,000 - 100,000;77;287;-210;0;0;0
1008700;Golf Pool VR;;0 - 20,000;16;5;11;0;0;0
1008710;Wet Girl;;200,000 - 500,000;4680;711;3969;907;29;1
1008740;Cube Mission;;0 - 20,000;22;6;16;0;0;0
1008800;Shards of Infinity;;0 - 20,000;110;17;93;0;0;5
1008800;Shards of Infinity;;0 - 20,000;110;17;93;0;0;5
1008820;LOTUS Minigames: United Nations;;0 - 20,000;10;2;8;0;0;0
1008830;孙悟空大战机器金刚 / Sun Wukong VS Robot;;0 - 20,000;79;7;72;0;0;0
1008850;Bounty Hunter;;0 - 20,000;1;2;-1;0;0;0
1008870;Excive A-1000;;0 - 20,000;25;9;16;0;0;0
1008910;心塞男孩 Sadboy;;20,000 - 50,000;100;25;75;0;0;0
1008920;Photographs;;0 - 20,000;130;22;108;0;0;0
1008950;Armored Front: Tiger Command;;0 - 20,000;27;14;13;0;0;1
1008970;Cavyrn;;20,000 - 50,000;1;1;0;0;0;0
1008990;Trinity.Town: Monastery | Martial Arts and Meditation;;0 - 20,000;0;1;-1;0;0;0
1009030;Hello Emoji: Drawing to Solve Puzzles;;20,000 - 50,000;1;0;1;0;0;0
1009040;Last Days Motel;;20,000 - 50,000;47;63;-16;0;0;0
1009070;没猫病制作人 / Psychosoft Ltd.;;0 - 20,000;7;19;-12;0;0;0
1009100;Zombie Killer - Type to Shoot!;;0 - 20,000;1;3;-2;0;0;0
1009150;Choconoa;;0 - 20,000;3;2;1;0;0;0
1009180;Block of Rum;;0 - 20,000;23;10;13;0;0;0
1009210;Trikumax;;0 - 20,000;6;0;6;0;0;0
1009240;Again;;0 - 20,000;3;1;2;0;0;0
1009290;SWORD ART ONLINE Alicization Lycoris;;100,000 - 200,000;3830;2363;1467;1483;1995;147
1009300;Achievement Collector: Zombie;;0 - 20,000;1;0;1;0;0;0
1009330;batch (Video Uploader);;0 - 20,000;15;5;10;0;0;0
1009350;Keepers Dungeon;;0 - 20,000;13;1;12;0;0;0
1009370;Elephants Can't Jump;;0 - 20,000;1;0;1;0;0;0
1009390;Insanus Express;;0 - 20,000;12;0;12;0;0;0
1009450;Sankaku Renai: Love Triangle Trouble;;50,000 - 100,000;207;10;197;0;0;2
1009460;Hello, Goodbye;;0 - 20,000;54;5;49;0;0;1
1009510;Insect Revolution VR;;0 - 20,000;0;1;-1;0;0;0
1009560;The Tenants;;200,000 - 500,000;4653;912;3741;1232;907;138
1009590;Little Lost Robots;;0 - 20,000;7;1;6;0;0;0
1009690;Saving Simon;;20,000 - 50,000;5;5;0;0;0;0
1009700;Jewel Match Solitaire L'Amour;;0 - 20,000;50;6;44;0;0;4
1009750;Flappatron;;0 - 20,000;126;4;122;0;0;0
1009770;One Million Worlds;;0 - 20,000;0;1;-1;0;0;0
1009780;Tales of Sorrow: Strawsbrough Town;;0 - 20,000;13;4;9;0;0;0
1009810;Blood Island;;0 - 20,000;4;8;-4;0;0;0
1009850;OVR Advanced Settings;;500,000 - 1,000,000;2390;96;2294;0;0;2656
1009900;Date Write;;0 - 20,000;8;12;-4;0;0;0
1009910;Ninja?;;0 - 20,000;9;8;1;0;0;0
1009920;Carrier Trail;;0 - 20,000;17;2;15;0;0;0
1009940;Rival Nation Wars;;0 - 20,000;1;2;-1;0;0;0
1009950;Once10;;0 - 20,000;64;14;50;0;0;0
1009950;Once10;;0 - 20,000;64;14;50;0;0;0
1009960;Project Hedra;;0 - 20,000;13;6;7;0;0;0
1009990;SCP022;;100,000 - 200,000;556;182;374;0;0;0
1010000;Super Alpaca Bros.;;0 - 20,000;4;0;4;0;0;0
1010070;Heroes Of Maidan 2;;0 - 20,000;76;15;61;0;0;0
1010100;Airborn;;0 - 20,000;85;9;76;32;32;1
1010120;UNDERWATER: STAY ALIVE;;0 - 20,000;0;2;-2;0;0;0
1010150;PASHTET;;0 - 20,000;20;6;14;0;0;0
1010170;Discord Bot - Controls;;20,000 - 50,000;113;81;32;0;0;0
1010180;Space Rabbits in Space;;0 - 20,000;7;0;7;0;0;0
1010230;Bleep Bloop;;;;;0;;;
1010260;The Coroner Saga;;0 - 20,000;3;8;-5;0;0;0
1010270;Nether: The Untold Chapter;;0 - 20,000;151;117;34;0;0;2
1010290;Find the Letter H;;0 - 20,000;21;0;21;0;0;0
1010330;THE TEAR;;0 - 20,000;9;6;3;0;0;0
1010380;Tales of Ancient Nights;;0 - 20,000;4;4;0;0;0;0
1010410;Dragon Roller Coaster HD;;0 - 20,000;10;3;7;0;0;0
1010420;Crash-Site: Conquest;;0 - 20,000;2;0;2;0;0;0
1010430;Meister;;0 - 20,000;1;1;0;0;0;0
1010460;CivilContract;;0 - 20,000;5;23;-18;0;0;0
1010480;TRE HUN: Unity-Chan x Action;;0 - 20,000;5;1;4;0;0;0
1010490;Spot Girls Difference;;0 - 20,000;16;12;4;0;0;0
1010520;Space Journey;;0 - 20,000;1;4;-3;0;0;0
1010540;Ancient Anathema;;0 - 20,000;14;11;3;0;0;0
1010560;Here I Come;;0 - 20,000;3;5;-2;0;0;0
1010590;Train Manager;;0 - 20,000;5;3;2;0;0;0
1010600;The Princess, the Stray Cat, and Matters of the Heart;;20,000 - 50,000;223;24;199;856;856;1
1010650;T.A.P.;;0 - 20,000;17;1;16;0;0;0
1010650;T.A.P.;;0 - 20,000;17;1;16;0;0;0
1010660;GACHIMUCHI REBIRTH;;0 - 20,000;50;9;41;0;0;0
1010670;Dungeon Dreams;;0 - 20,000;187;12;175;0;0;4
1010710;The Pack;;0 - 20,000;0;1;-1;0;0;0
1010740;Scrapyard Robot Rampage;;0 - 20,000;0;1;-1;0;0;0
1010750;Blood Fresh Supply;;200,000 - 500,000;5305;241;5064;294;159;47
1010780;Wings of Glass 玻璃の羽;;0 - 20,000;38;5;33;0;0;0
1010800;Wallpaper Maker （造物主视频桌面）;;200,000 - 500,000;1252;252;1000;0;0;50
1010830;Mech Chip;;0 - 20,000;26;4;22;0;0;0
1010840;VR Party Pack;;0 - 20,000;5;5;0;0;0;0
1010850;東方翠神廻廊 〜 Faith in the Goddess of Suwa.;;20,000 - 50,000;140;44;96;0;0;1
1010860;Hide and Seek;;50,000 - 100,000;451;284;167;91;143;0
1010870;最后的47小时 - The Last 47 Hours;;20,000 - 50,000;656;39;617;83;83;0
1010890;Touhou Fantasia / 东方梦想曲;;100,000 - 200,000;1348;57;1291;0;0;2
1010920;Catalyst;;0 - 20,000;6;0;6;0;0;0
1010930;Aztec Tower;;0 - 20,000;2;1;1;0;0;0
1010950;SmartyTale 2D;;0 - 20,000;58;5;53;0;0;0
1010970;Dead Wishes;;0 - 20,000;62;5;57;0;0;0
1011000;Infinite Art Museum;;20,000 - 50,000;31;3;28;0;0;0
1011030;HENTAI MINESWEEPER;;0 - 20,000;32;17;15;0;0;0
1011070;Nomads of the Fallen Star;;20,000 - 50,000;26;10;16;0;0;0
1011090;ANDROMALIUS;;0 - 20,000;56;16;40;0;0;0
1011110;Nero GameVR;;0 - 20,000;12;7;5;0;0;0
1011120;Hero Staff;;0 - 20,000;3;0;3;0;0;0
1011130;Life is Pointless;;0 - 20,000;73;13;60;0;0;1
1011140;Border Control;;0 - 20,000;1;4;-3;0;0;0
1011190;SIMULACRA 2;;100,000 - 200,000;1166;165;1001;144;152;4
1011220;从前有个仙儿 Taoist immortal;;0 - 20,000;24;32;-8;0;0;0
1011220;从前有个仙儿 Taoist immortal;;0 - 20,000;24;32;-8;0;0;0
1011240;Dragon Chase;;0 - 20,000;9;3;6;0;0;0
1011260;Settlement Zero;;0 - 20,000;3;1;2;0;0;0
1011270;Bleeding Hunt VR Chap.1;;0 - 20,000;50;24;26;0;0;0
1011290;Hotel R'n'R;;;;;0;;;
1011300;UNI;;50,000 - 100,000;235;161;74;0;0;0
1011310;PARSE ALLY;;0 - 20,000;2;4;-2;0;0;0
1011370;Outliver: Redemption;;0 - 20,000;0;6;-6;0;0;0
1011390;Field of Glory: Empires;;20,000 - 50,000;620;127;493;0;0;64
1011420;Bus Mechanic Simulator;;0 - 20,000;86;61;25;140;140;1
1011420;Bus Mechanic Simulator;;0 - 20,000;86;61;25;140;140;1
1011440;Balloon Girl;;0 - 20,000;1;2;-1;0;0;0
1011460;Caverns of Karvella;;0 - 20,000;1;0;1;0;0;0
1011470;PacketStorm;;0 - 20,000;10;4;6;0;0;0
1011510;Wizard And Minion Idle;;50,000 - 100,000;559;57;502;0;0;202
1011550;Light The Way;;0 - 20,000;14;14;0;0;0;0
1011610;Radio General;;20,000 - 50,000;350;57;293;336;336;4
1011620;Electric Sleep;;0 - 20,000;13;0;13;0;0;0
1011630;Border Force;;20,000 - 50,000;29;52;-23;0;0;0
1011650;flyingshapes° – VR Modeling for Designers;;20,000 - 50,000;13;9;4;0;0;0
1011670;Totally Reliable Delivery Service;;50,000 - 100,000;752;165;587;85;86;12
1011700;Walden, a game;;0 - 20,000;76;8;68;0;0;0
1011740;DOZA 2 - NOVOGODNIY PEREDOZ;;0 - 20,000;54;16;38;0;0;0
1011760;Dragon Iris;;0 - 20,000;3;1;2;0;0;0
1011820;Millionaire Dancer;;0 - 20,000;2;2;0;0;0;0
1011830;Rocwood Academy;;0 - 20,000;71;11;60;0;0;0
1011860;答题英雄——细胞生物学;;20,000 - 50,000;6;0;6;0;0;0
1011870;萌盟大冒险 Cute Adventure 生存 Survival 生き残ります Sopravvivere Überleben Выживать  Survivre 생존하다 Sobrevivir   冒險  avventura  aventura 冒険  모험   aventure приключение     Abenteuer;;0 - 20,000;4;3;1;0;0;0
1011940;Ideology in Friction;;100,000 - 200,000;1306;159;1147;403;439;28
1011960;Arena of Shaelo;;0 - 20,000;5;3;2;0;0;0
1011970;三国佣兵传奇;;20,000 - 50,000;59;20;39;0;0;0
1011980;Depth Of Consciousness;;0 - 20,000;5;4;1;0;0;0
1011990;Dies irae ~Interview with Kaziklu Bey~;;0 - 20,000;48;0;48;0;0;0
1012030;Detective Girl of the Steam City;;200,000 - 500,000;1397;124;1273;613;613;27
1012110;Military Conflict: Vietnam;;0 - 20,000;531;80;451;3244;3244;8
1012120;The Great Mushroom Hunt;;0 - 20,000;0;0;0;0;0;0
1012160;SkyGameChanger-AirCombat II-;;0 - 20,000;2;5;-3;0;0;0
1012180;在线教育开发实习生 Elearning Development Intern;;0 - 20,000;16;0;16;0;0;0
1012210;Waves Of Death VR;;0 - 20,000;1;9;-8;0;0;0
1012240;旅燕归航 Swallow Homing;;50,000 - 100,000;577;13;564;0;0;0
1012280;Beekyr;;0 - 20,000;7;0;7;0;0;1
1012360;Gunslugs 3:Rogue Tactics;;0 - 20,000;7;2;5;0;0;0
1012370;Afterlife;;0 - 20,000;4;4;0;0;0;0
1012390;Fruitlockers Reborn! 2;;0 - 20,000;7;3;4;0;0;0
1012430;Furs of Fury;;0 - 20,000;5;1;4;0;0;0
1012450;HopSquash!;;0 - 20,000;11;0;11;0;0;0
1012460;Through Abandoned: The Refuge;;20,000 - 50,000;54;49;5;0;0;0
1012490;Time to Fight;;0 - 20,000;3;1;2;0;0;0
1012510;Greenland Melting;;0 - 20,000;16;0;16;0;0;0
1012530;Soccering;;0 - 20,000;24;3;21;0;0;0
1012560;Snakeybus;;100,000 - 200,000;1838;141;1697;121;181;12
1012580;Triumph in the Skies;;0 - 20,000;10;4;6;0;0;0
1012600;Why Chicken? Why?;;0 - 20,000;1;0;1;0;0;0
1012610;Buoyancy;;20,000 - 50,000;469;178;291;439;439;6
1012640;Mission Ring Possible;;0 - 20,000;2;0;2;0;0;0
1012650;Galactic Tower Defense;;0 - 20,000;3;0;3;0;0;0
1012670;Gnubbl;;0 - 20,000;2;0;2;0;0;0
1012710;Endzeit;;0 - 20,000;0;1;-1;0;0;0
1012720;Pix Tower;;0 - 20,000;9;3;6;0;0;0
1012730;九劫曲:诅咒之地 NineTrials Test Server;;50,000 - 100,000;146;129;17;14;14;0
1012790;Into the Radius VR;;200,000 - 500,000;6640;444;6196;350;353;240
1012800;WhiTaers: Gongren Edition;;0 - 20,000;36;13;23;0;0;0
1012840;Moons of Madness;;100,000 - 200,000;1725;480;1245;719;399;3
1012850;ANDERSON;;0 - 20,000;23;10;13;0;0;0
1012860;Data mining 5;;0 - 20,000;9;4;5;0;0;0
1012880;60 Seconds! Reatomized;;500,000 - 1,000,000;9555;642;8913;264;195;196
1012970;Extricate;;0 - 20,000;49;8;41;0;0;0
1012990;mini PVP;;0 - 20,000;14;2;12;0;0;0
1013000;Kingdom-Heroes;;0 - 20,000;4;5;-1;0;0;0
1013070;Estellium Legends;;0 - 20,000;5;4;1;0;0;0
1013100;Mage;;0 - 20,000;7;0;7;0;0;0
1013120;HotPuzzle:Video;;0 - 20,000;8;2;6;0;0;0
1013130;Happy Anime Puzzle;;0 - 20,000;42;21;21;0;0;0
1013130;Happy Anime Puzzle;;0 - 20,000;42;21;21;0;0;0
1013180;Funbag Fantasy;;0 - 20,000;21;0;21;14;14;7
1013190;Retro Vision;;0 - 20,000;16;0;16;0;0;0
1013200;Truecolors;;0 - 20,000;1;1;0;0;0;0
1013220;River City Saga: Three Kingdoms;;20,000 - 50,000;133;40;93;0;0;11
1013280;RagTag;;0 - 20,000;26;0;26;0;0;0
1013290;Beat Your Meat;;0 - 20,000;3;0;3;0;0;0
1013310;Peaky Blinders: Mastermind;;20,000 - 50,000;619;177;442;88;131;4
1013320;Firestone Idle RPG;;200,000 - 500,000;3479;879;2600;415;568;1489
1013340;brainCloud Bombers;;0 - 20,000;10;6;4;0;0;0
1013350;The Voice from Heaven;;0 - 20,000;23;11;12;0;0;0
1013360;Feditor;;0 - 20,000;17;5;12;0;0;0
1013400;FanaticBlader;;0 - 20,000;0;1;-1;0;0;0
1013410;REDVIIL;;20,000 - 50,000;26;35;-9;0;0;0
1013450;Triton Survival;;0 - 20,000;23;7;16;0;0;0
1013540;Evospace;;20,000 - 50,000;225;51;174;0;0;12
1013570;Escape Room Academy;;0 - 20,000;6;2;4;0;0;0
1013580;Manna for our Malices;;0 - 20,000;17;1;16;0;0;0
1013600;Rodent Warriors;;0 - 20,000;12;0;12;0;0;0
1013630;Frigus İnferos;;0 - 20,000;13;1;12;0;0;0
1013650;Tiny Dangerous Dungeons;;0 - 20,000;66;2;64;0;0;0
1013660;Pursuer;;0 - 20,000;7;5;2;0;0;0
1013670;Mr Boom's Firework Factory;;0 - 20,000;5;0;5;0;0;0
1013680;Saint Paul Pre-Alpha;;20,000 - 50,000;82;30;52;0;0;0
1013700;Draft Day Sports: College Football 2019;;0 - 20,000;9;5;4;0;0;0
1013710;Draft Day Sports: College Basketball 2019;;0 - 20,000;11;7;4;0;0;0
1013750;Legal Dungeon;;20,000 - 50,000;320;93;227;0;0;3
1013790;TheVeryHardPuzzleGame&Editor;;0 - 20,000;0;0;0;0;0;0
1013810;The Legendary Assassin KAL;;0 - 20,000;1;3;-2;0;0;0
1013820;Stars and Snowdrops;;0 - 20,000;14;3;11;0;0;0
1013830;Agent Of Love - Josei Otome Visual Novel;;0 - 20,000;20;13;7;0;0;0
1013870;Leanna's Slice of Life;;100,000 - 200,000;555;112;443;0;0;6
1013890;青蛙跳模拟器;;0 - 20,000;59;23;36;0;0;0
1013910;Aron's Adventure;;0 - 20,000;152;45;107;0;0;0
1013940;Bob and Kuura: Lost in Snowglobe;;0 - 20,000;1;1;0;0;0;0
1013950;AntiPodal;;0 - 20,000;15;4;11;0;0;0
1013950;AntiPodal;;0 - 20,000;15;4;11;0;0;0
1013960;Open Wheel Manager;;0 - 20,000;27;9;18;0;0;0
1013970;Suwarudo;;0 - 20,000;3;2;1;0;0;0
1014010;Hotel Ever After - Ella's Wish;;20,000 - 50,000;34;14;20;0;0;0
1014030;Molly - Can you survive 100 nights?;;0 - 20,000;0;2;-2;0;0;0
1014050;Hockey Manager 20|20;;0 - 20,000;55;23;32;0;0;2
1014100;Shivering Sky;;0 - 20,000;15;7;8;0;0;0
1014110;Fish Simulator: Aquarium Manager;;0 - 20,000;21;11;10;0;0;0
1014130;Jitsumi's Game Booster;;0 - 20,000;88;33;55;0;0;4
1014140;Snakebird Primer;;20,000 - 50,000;148;13;135;0;0;1
1014180;化者天狱 Revenant in the Paradise;;0 - 20,000;5;2;3;0;0;1
1014200;Markerboard Jungle: Frogs;;0 - 20,000;0;1;-1;0;0;0
1014240;Starship Saboteur Prototype;;20,000 - 50,000;7;2;5;0;0;0
1014270;Plaguepunk Justice;;0 - 20,000;13;0;13;0;0;0
1014280;The Devil's Calculator;;0 - 20,000;98;3;95;0;0;1
1014310;Top Torch;;0 - 20,000;1;0;1;0;0;0
1014350;Once A Stray;;100,000 - 200,000;7;2;5;0;0;0
1014360;Adventures Diary of Merchant;;0 - 20,000;58;23;35;0;0;0
1014370;Bouncing DVD : The Game;;0 - 20,000;162;27;135;0;0;0
1014370;Bouncing DVD : The Game;;0 - 20,000;162;27;135;0;0;0
1014420;Blind Date;;0 - 20,000;23;3;20;0;0;0
1014450;Spacelair;;0 - 20,000;1;2;-1;0;0;0
1014460;Nothing!;;0 - 20,000;45;19;26;0;0;0
1014470;Fates 8 Stories (F8S);;;;;0;;;
1014550;One Synth;;0 - 20,000;44;7;37;0;0;0
1014570;AlienAfterlife;;0 - 20,000;30;2;28;0;0;0
1014580;RB: Axolotl;;0 - 20,000;38;5;33;0;0;1
1014590;Time To Parkour;;0 - 20,000;28;17;11;0;0;0
1014600;Crash Landed;;0 - 20,000;3;1;2;0;0;0
1014620;Rollman;;0 - 20,000;3;2;1;0;0;0
1014660;Baby Bee;;0 - 20,000;1;0;1;0;0;0
1014710;sCATter;;0 - 20,000;21;4;17;0;0;0
1014720;Asteroid Navigation;;0 - 20,000;1;0;1;0;0;0
1014730;Cyndy;;0 - 20,000;16;6;10;0;0;6
1014750;Dupli_City;;0 - 20,000;6;0;6;0;0;0
1014790;Bewildebots;;0 - 20,000;2;0;2;0;0;0
1014810;Happy Words;;0 - 20,000;51;58;-7;271;271;4
1014820;The Angry Banana;;0 - 20,000;5;2;3;0;0;0
1014840;Heart and Axe;;0 - 20,000;3;4;-1;0;0;0
1014850;Iridium;;0 - 20,000;9;0;9;0;0;0
1014880;By Moonlight;;20,000 - 50,000;107;12;95;0;0;0
1014890;Warforged;;0 - 20,000;2;3;-1;0;0;0
1014900;Hex Defense;;0 - 20,000;13;6;7;0;0;0
1014920;Favor Chess;;0 - 20,000;28;12;16;0;0;1
1014970;Saloon VR;;0 - 20,000;19;6;13;0;0;0
1014990;Aivolution;;0 - 20,000;12;5;7;0;0;0
1015020;记忆重构/Memories;;0 - 20,000;173;62;111;0;0;0
1015080;Vampire & Monsters: Mystery Hidden Object Games - Puzzle;;0 - 20,000;50;18;32;0;0;1
1015100;Sloth: Heart to Heart;;0 - 20,000;4;3;1;0;0;0
1015120;Hot Earth: inVasion;;0 - 20,000;1;0;1;0;0;0
1015130;Wounded - The Beginning;;0 - 20,000;155;48;107;0;0;1
1015140;10 Miles To Safety;;100,000 - 200,000;647;231;416;534;1001;4
1015150;PrincessGuardians;;0 - 20,000;1;3;-2;0;0;0
1015180;Malicious Payload;;0 - 20,000;3;4;-1;0;0;0
1015240;The Expedition;;0 - 20,000;5;9;-4;0;0;0
1015250;Caramel Port;;0 - 20,000;9;2;7;0;0;0
1015290;Trapped in Fear;;0 - 20,000;1;0;1;0;0;0
1015350;Your Home;;0 - 20,000;32;18;14;0;0;0
1015430;The Dead Tree of Ranchiuna;;0 - 20,000;46;22;24;0;0;0
1015470;Need for Spirit: Off-Road Edition;;0 - 20,000;45;30;15;0;0;1
1015500;WWE 2K20;;200,000 - 500,000;2512;3384;-872;734;887;39
1015530;Bonds of the Skies;;0 - 20,000;4;3;1;12;12;0
1015540;Sephirothic Stories;;0 - 20,000;8;2;6;0;0;0
1015550;Asdivine Dios;;0 - 20,000;5;0;5;0;0;0
1015580;Jungle Z;;0 - 20,000;6;5;1;0;0;0
1015610;THE LAST PLAYER:VR Battle Royale;;0 - 20,000;198;62;136;872;1713;1
1015650;The Virtual Reality Museum of Immersive Experiences;;0 - 20,000;4;2;2;0;0;0
1015660;Hentai Shooter 2: World Tour;;0 - 20,000;50;13;37;0;0;1
1015700;Land Of The Void;;0 - 20,000;42;20;22;0;0;0
1015710;Holy Road;;20,000 - 50,000;138;67;71;202;202;1
1015720;Alternate DiMansion Diary;;0 - 20,000;334;45;289;0;0;1
1015730;Apostle;;0 - 20,000;268;41;227;0;0;7
1015750;Escape from Fortress Lugohm;;0 - 20,000;71;25;46;0;0;1
1015770;Tina: Swordswoman of the Scarlet Prison;;50,000 - 100,000;340;65;275;673;673;9
1015790;Dark Hero Party;;20,000 - 50,000;198;102;96;0;0;0
1015820;Deadly Kingdom;;0 - 20,000;2;0;2;0;0;0
1015830;DreamEater 噬梦者;;0 - 20,000;362;101;261;22;22;0
1015890;TASOMACHI: Behind the Twilight;;20,000 - 50,000;318;96;222;0;0;2
1015920;Ynglet;;0 - 20,000;276;7;269;0;0;0
1015930;Blood Rage: Digital Edition;;50,000 - 100,000;380;331;49;9;9;6
1015940;Welcome to Elk;;0 - 20,000;181;4;177;174;174;1
1016000;NERVE;;0 - 20,000;44;3;41;0;0;0
1016010;W4RR-i/o-RS: Descent;;0 - 20,000;5;4;1;0;0;0
1016030;Wawa United;;0 - 20,000;2;0;2;0;0;0
1016100;3rd Invasion - Zombies vs. Steel;;0 - 20,000;1;1;0;0;0;0
1016110;Self Reliance 自我性赖;;50,000 - 100,000;612;75;537;0;0;0
1016120;PGA TOUR 2K21;;200,000 - 500,000;5939;1147;4792;694;662;439
1016180;Terror of Hemasaurus;;20,000 - 50,000;397;24;373;0;0;1
1016250;100$;;0 - 20,000;104;33;71;0;0;0
1016260;Magic Combat VR;;0 - 20,000;8;0;8;0;0;0
1016260;Magic Combat VR;;0 - 20,000;8;0;8;0;0;0
1016330;Bot War;;0 - 20,000;3;0;3;0;0;0
1016350;Land of Dread;;50,000 - 100,000;2;2;0;0;0;0
1016360;PERISH;;0 - 20,000;226;91;135;0;0;29
1016390;Perspectives: Paradise;;50,000 - 100,000;134;17;117;0;0;1
1016420;Tenebrous Dungeon;;0 - 20,000;9;2;7;0;0;0
1016430;Tokyo Snap;;0 - 20,000;17;2;15;0;0;0
1016600;Devil Slayer - Raksasi;;100,000 - 200,000;2241;373;1868;1006;1219;19
1016610;Four-color Fantasy;;0 - 20,000;1;7;-6;0;0;0
1016630;Drag Star!;;0 - 20,000;20;1;19;0;0;0
1016650;DOCHKA;;0 - 20,000;8;9;-1;0;0;0
1016660;Age Of Omens;;0 - 20,000;7;1;6;0;0;0
1016690;DUST-UP;;0 - 20,000;3;1;2;0;0;0
1016700;BOY BEATS WORLD;;0 - 20,000;33;0;33;0;0;0
1016700;BOY BEATS WORLD;;0 - 20,000;33;0;33;0;0;0
1016710;Balanced Politics Simulator;;0 - 20,000;4;12;-8;0;0;0
1016720;Save Koch;;0 - 20,000;101;46;55;374;374;0
1016730;Deck of Ashes;;20,000 - 50,000;711;245;466;137;137;4
1016740;God Monster;;0 - 20,000;1;4;-3;0;0;0
1016750;TRACKER《追踪者》;;0 - 20,000;2;2;0;0;0;0
1016760;Citizens of Space;;0 - 20,000;21;16;5;0;0;0
1016770;Interrogation: You will be deceived;;20,000 - 50,000;217;46;171;70;70;3
1016790;West of Dead;;50,000 - 100,000;1009;356;653;82;78;4
1016800;Chernobylite Enhanced Edition;;500,000 - 1,000,000;8490;1692;6798;536;285;182
1016810;VEGAS Movie Studio 16 Steam Edition;;0 - 20,000;34;31;3;6585;6585;0
1016820;Miles of Cubes;;0 - 20,000;1;0;1;0;0;0
1016840;VEGAS Movie Studio 16 Platinum Steam Edition;;0 - 20,000;126;68;58;0;0;6
1016850;The Enthralling Realms: An Alchemist's Tale;;0 - 20,000;9;4;5;0;0;0
1016860;Boiling Steel;;20,000 - 50,000;287;61;226;0;0;0
1016890;Arch Drift;;0 - 20,000;1;0;1;0;0;0
1016920;Unrailed!;;500,000 - 1,000,000;14557;1056;13501;384;255;292
1016940;The Otterman Empire;;0 - 20,000;21;6;15;0;0;0
1016960;Super Neptunia RPG;;50,000 - 100,000;757;192;565;243;288;5
1016970;Ellen and the Degenerates RPG;;20,000 - 50,000;43;9;34;0;0;0
1016980;Pirates of the Asteroid Belt VR;;0 - 20,000;8;4;4;0;0;0
1017060;Planet Evolution PC Live Wallpaper;;50,000 - 100,000;123;51;72;48;48;38
1017080;RWBY Deckbuilding Game;;20,000 - 50,000;133;60;73;0;0;0
1017080;RWBY Deckbuilding Game;;20,000 - 50,000;133;60;73;0;0;0
1017100;Territory Idle;;100,000 - 200,000;1170;265;905;0;0;251
1017130;Ikao The Lost Souls;;0 - 20,000;22;3;19;0;0;0
1017160;Gearshifters;;0 - 20,000;56;12;44;0;0;0
1017180;The Long Drive;;500,000 - 1,000,000;16898;1559;15339;648;528;1253
1017240;DEEP HOLE;;0 - 20,000;6;0;6;0;0;0
1017270;TRIDENT BARRAGE;;0 - 20,000;2;0;2;0;0;0
1017340;FitnessVR;;0 - 20,000;0;1;-1;0;0;0
1017350;aMAZE St.Patrick;;0 - 20,000;26;11;15;0;0;0
1017360;IgKnight Golf Defender;;0 - 20,000;0;4;-4;0;0;0
1017370;Dangerous Orbit;;0 - 20,000;0;3;-3;0;0;0
1017410;Tetra Project - 原石计划;;50,000 - 100,000;520;34;486;234;431;1
1017440;Vacation Adventures: Cruise Director;;0 - 20,000;3;0;3;0;0;0
1017480;WarGround;;0 - 20,000;12;9;3;0;0;0
1017490;Mortadelo y Filemón: La banda de Corvino;;0 - 20,000;4;0;4;0;0;0
1017560;Falling Bullets;;0 - 20,000;11;6;5;0;0;0
1017580;The Explorer of Night;;0 - 20,000;17;6;11;0;0;0
1017600;Sophica - Temples Of Mystery;;0 - 20,000;7;4;3;0;0;0
1017610;Butterfly;;0 - 20,000;28;2;26;0;0;0
1017630;Robot King Part 2: Boss Battles;;0 - 20,000;4;0;4;0;0;0
1017650;It's a Long Way To the Top (If You Wanna Be a CEO);;0 - 20,000;3;0;3;0;0;0
1017660;Don't Go into the Woods;;0 - 20,000;4;0;4;0;0;0
1017670;New World Horizon;;0 - 20,000;8;5;3;0;0;0
1017750;Jump Doper;;0 - 20,000;3;1;2;0;0;0
1017780;Hammer & Anvil VR;;0 - 20,000;32;22;10;0;0;0
1017800;AirShock;;0 - 20,000;2;6;-4;0;0;0
1017820;Cybershift;;20,000 - 50,000;13;2;11;0;0;0
1017820;Cybershift;;20,000 - 50,000;13;2;11;0;0;0
1017880;The Dark Side;;0 - 20,000;10;5;5;0;0;0
1017900;Age of Empires: Definitive Edition;;500,000 - 1,000,000;8973;1671;7302;476;212;900
1017940;King of Texas;;0 - 20,000;9;11;-2;0;0;0
1018000;Anniversary Collection Arcade Classics;;50,000 - 100,000;165;101;64;56;56;1
1018010;Castlevania Anniversary Collection;;100,000 - 200,000;1003;227;776;55;71;18
1018020;Contra Anniversary Collection;;50,000 - 100,000;585;172;413;38;57;5
1018060;The Mercenary Rise;;0 - 20,000;42;37;5;0;0;0
1018080;Sneaker;;0 - 20,000;8;1;7;0;0;0
1018090;2100;;0 - 20,000;3;11;-8;0;0;0
1018110;DEAD;;0 - 20,000;2;1;1;0;0;0
1018130;Castle Break;;0 - 20,000;76;5;71;0;0;0
1018160;MXGP 2019 - The Official Motocross Videogame;;20,000 - 50,000;914;93;821;1092;1092;15
1018170;光之迷城 / Dawn of the Lost Castle;;0 - 20,000;50;17;33;0;0;0
1018240;Hooklings;;0 - 20,000;5;0;5;0;0;0
1018270;Anthropomachy;;0 - 20,000;26;20;6;0;0;0
1018380;怪獣綺譚 朧十夜 空狐万華鏡;;0 - 20,000;1;0;1;0;0;0
1018420;uuu so smislom;;20,000 - 50,000;43;5;38;0;0;0
1018560;Emoji Charades;;0 - 20,000;8;0;8;0;0;0
1018590;Virtual Diary;;0 - 20,000;3;2;1;0;0;0
1018610;Dawn Break -Origin-;;;;;0;;;
1018640;Pixel Happy Game Girls;;0 - 20,000;10;2;8;0;0;0
1018680;Screenbits - Screen Recorder;;0 - 20,000;149;31;118;1247;1247;26
1018700;Kabitis 2: Fire Sword;;0 - 20,000;0;3;-3;0;0;0
1018720;X-POINT;;0 - 20,000;12;1;11;0;0;0
1018730;Tobit;;0 - 20,000;15;21;-6;0;0;1
1018750;Rubble Rush;;0 - 20,000;12;7;5;0;0;0
1018770;Lizardquest-Alien waters;;0 - 20,000;0;4;-4;0;0;0
1018800;DEEEER Simulator: Your Average Everyday Deer Game;;100,000 - 200,000;2623;253;2370;76;76;16
1018810;Drumpfy Walls;;0 - 20,000;2;0;2;0;0;0
1018820;Fleet Scrapper;;0 - 20,000;4;2;2;0;0;0
1018830;Element TD 2 - Tower Defense;;100,000 - 200,000;2047;183;1864;6759;1570;97
1018850;Smile For Me;;100,000 - 200,000;2034;60;1974;211;236;6
1018860;Bombing Quest;;0 - 20,000;27;1;26;0;0;0
1018870;VR Racing;;0 - 20,000;15;22;-7;0;0;0
1018900;Let's Learn Japanese! Katakana;;0 - 20,000;30;2;28;0;0;0
1018950;What The Fork;;0 - 20,000;1;2;-1;0;0;0
1018960;Thugs Law;;0 - 20,000;9;8;1;0;0;0
1018980;VKT Prime System Crash;;0 - 20,000;5;0;5;0;0;0
1018990;Cherry Creek;;0 - 20,000;18;1;17;0;0;1
1019020;The Abbey - Director's cut;;0 - 20,000;17;2;15;0;0;0
1019040;Smash team;;0 - 20,000;5;5;0;0;0;0
1019060;5.84 Wing;;20,000 - 50,000;9;4;5;0;0;0
1019070;Soft cookie;;0 - 20,000;0;0;0;0;0;0
1019080;The Toymaker's Apprentice;;0 - 20,000;0;2;-2;0;0;0
1019150;Apolune;;0 - 20,000;2;2;0;0;0;0
1019170;Umbrella;;0 - 20,000;0;1;-1;0;0;0
1019190;Urizen Frosty Plus The New Warriors;;20,000 - 50,000;1;1;0;0;0;0
1019230;Mr.Hack Jack: Robot Detective;;0 - 20,000;32;3;29;0;0;0
1019250;WWII TCG - World War 2: The Card Game;;100,000 - 200,000;261;113;148;0;0;0
1019260;Micro Mayhem;;0 - 20,000;1;0;1;0;0;0
1019310;VirtuaVerse;;100,000 - 200,000;791;148;643;510;510;3
1019340;7776 II: Dwarven Greed;;20,000 - 50,000;45;11;34;0;0;0
1019370;Radioactive;;0 - 20,000;1;1;0;0;0;0
1019400;BeatShips;;0 - 20,000;3;0;3;0;0;0
1019450;Table Manners: Physics-Based Dating Game;;20,000 - 50,000;261;189;72;22;25;3
1019500;Super Beam;;0 - 20,000;0;1;-1;0;0;0
1019550;Thief Simulator VR;;50,000 - 100,000;664;296;368;300;546;4
1019560;PLAYspace Virtual Music Library;;0 - 20,000;2;0;2;0;0;0
1019580;Mortadelo y Filemón: Una aventura de cine - Edición especial;;0 - 20,000;16;9;7;0;0;0
1019590;Lovely Planet 2: April Skies;;0 - 20,000;133;9;124;107;126;0
1019630;ECCHI NEKO GIRLS PUZZLE;;0 - 20,000;16;4;12;0;0;0
1019690;Ghost Buster 3D;;0 - 20,000;3;1;2;0;0;0
1019710;Repel Aliens 3D;;0 - 20,000;0;1;-1;0;0;0
1019730;Chipmonk!;;0 - 20,000;18;3;15;0;0;1
1019740;Korona:Nemesis;;0 - 20,000;6;3;3;0;0;0
1019790;Supernatural Super Squad Fight!;;0 - 20,000;5;2;3;0;0;0
1019820;Galaxicus;;0 - 20,000;2;1;1;0;0;0
1019910;Cube Man;;0 - 20,000;4;1;3;0;0;0
1019920;Gensokyo Defenders;;0 - 20,000;106;8;98;0;0;3
1019940;Race for Tuning;;50,000 - 100,000;334;138;196;409;801;1
1020010;Fantasy Island;;0 - 20,000;1;3;-2;0;0;0
1020020;Dimension Two;;0 - 20,000;14;3;11;0;0;0
1020030;Quantum Suicide;;0 - 20,000;83;24;59;0;0;1
1020050;Startup Valley Adventure;;0 - 20,000;23;11;12;0;0;0
1020080;Alicia Quatermain 4: Da Vinci and the Time Machine;;0 - 20,000;11;2;9;0;0;0
1020090;Overcome;;0 - 20,000;16;2;14;0;0;0
1020120;A Giant Problem;;0 - 20,000;3;0;3;0;0;0
1020250;Flying in Labyrinth;;0 - 20,000;5;2;3;0;0;0
1020270;Demon Hunter 5: Ascendance;;0 - 20,000;155;21;134;188;188;3
1020270;Demon Hunter 5: Ascendance;;0 - 20,000;155;21;134;188;188;3
1020310;Gravity Heroes;;0 - 20,000;25;1;24;0;0;0
1020330;Khan VS Kahn;;50,000 - 100,000;158;102;56;0;0;0
1020340;AUDICA: Rhythm Shooter;;20,000 - 50,000;478;85;393;0;0;2
1020360;魔杖战争 Wand Wars: Rise;;0 - 20,000;0;2;-2;0;0;0
1020390;Beat Blaster;;0 - 20,000;9;4;5;0;0;0
1020410;Narco Strike;;20,000 - 50,000;37;28;9;0;0;0
1020420;Snowrifters VEX;;0 - 20,000;7;2;5;0;0;0
1020420;Snowrifters VEX;;0 - 20,000;7;2;5;0;0;0
1020430;Joe Jump Impossible Quest;;0 - 20,000;5;0;5;0;0;0
1020440;Doodle Creatures;;0 - 20,000;15;7;8;0;0;0
1020450;There Will Be Ink;;0 - 20,000;11;0;11;0;0;0
1020470;Evoland Legendary Edition;;100,000 - 200,000;1566;344;1222;689;764;23
1020480;Nasty;;0 - 20,000;2;2;0;0;0;0
1020490;Woman's body 2;;0 - 20,000;0;0;0;0;0;0
1020520;Hellink;;50,000 - 100,000;45;2;43;0;0;0
1020540;CONTRA: ROGUE CORPS;;20,000 - 50,000;78;115;-37;0;0;0
1020560;Theme Park Worker;;0 - 20,000;2;1;1;0;0;0
1020590;Space Pilgrim Academy: Reunion;;50,000 - 100,000;54;2;52;0;0;0
1020600;Extreme Truck Simulator;;0 - 20,000;28;23;5;0;0;0
1020610;Apoapsis;;0 - 20,000;1;4;-3;0;0;0
1020640;R.I.C.A;;20,000 - 50,000;193;27;166;0;0;0
1020650;Commando Fodder: War Dogs;;0 - 20,000;6;1;5;0;0;0
1020660;Wrecked Destruction Simulator;;0 - 20,000;13;19;-6;0;0;0
1020730;Dark Bestiary;;20,000 - 50,000;427;42;385;76;76;4
1020800;CAR TUNE: Project;;50,000 - 100,000;347;64;283;0;0;12
1020820;KumaKuma Manga Editor;;50,000 - 100,000;605;156;449;148;279;3
1020830;Something is wrong/有毛病;;0 - 20,000;22;1;21;0;0;0
1020840;豆腐脑模拟器 Tofu Pudding Simulator;;0 - 20,000;39;28;11;0;0;0
1020910;War Of Gods;;0 - 20,000;25;17;8;0;0;21
1020930;在末日前夕等待放晴;;0 - 20,000;10;0;10;0;0;0
1020940;Owyn's Adventure;;0 - 20,000;51;1;50;0;0;0
1020980;Match Three Pirates! Heir to Davy Jones;;0 - 20,000;6;6;0;0;0;0
1021030;CyberLink PowerDVD 19 Ultra;;0 - 20,000;2;1;1;0;0;0
1021060;Brix VR;;0 - 20,000;2;0;2;0;0;0
1021070;Spaceland: Sci-Fi Indie Tactics;;50,000 - 100,000;279;86;193;312;312;2
1021100;Aircraft Carrier Survival;;50,000 - 100,000;488;306;182;88;88;22
1021120;PraeBot;;0 - 20,000;10;13;-3;0;0;0
1021130;Trucking;;0 - 20,000;5;3;2;0;0;0
1021220;The Seven Deadly Seas;;0 - 20,000;36;15;21;0;0;0
1021260;Chocolate makes you happy: St.Patrick's Day;;0 - 20,000;21;13;8;0;0;0
1021290;CubeRace;;0 - 20,000;0;3;-3;0;0;0
1021370;Slave RPG;;0 - 20,000;4;0;4;0;0;0
1021640;Fold;;0 - 20,000;11;0;11;0;0;0
1021650;Perhaps When We Dream;;0 - 20,000;1;2;-1;0;0;0
1021670;机退怪兽;;50,000 - 100,000;189;103;86;0;0;1
1021680;Music Escape;;0 - 20,000;12;2;10;0;0;0
1021690;Game Studio Simulator（我要做游戏）;;20,000 - 50,000;146;34;112;0;0;0
1021770;Wanba Warriors;;200,000 - 500,000;2003;192;1811;239;187;21
1021780;The Region;;0 - 20,000;14;40;-26;0;0;0
1021800;Million Dungeon;;20,000 - 50,000;197;83;114;0;0;0
1021820;Dumb test: Check your teammates;;0 - 20,000;11;6;5;0;0;0
1021840;Asteroid Hideout;;0 - 20,000;4;2;2;0;0;0
1021850;Blood Memery|血色记忆;;0 - 20,000;83;10;73;0;0;0
1021860;Unravel Cyndy;;0 - 20,000;2;0;2;0;0;1
1021880;StarWheels;;0 - 20,000;33;0;33;0;0;0
1021890;Hero Swing VR;;0 - 20,000;2;3;-1;0;0;0
1021940;Space Warfare;;0 - 20,000;40;30;10;0;0;0
1021950;When the Darkness comes;;200,000 - 500,000;7309;604;6705;118;51;6
1022000;Lyantei;;0 - 20,000;3;1;2;0;0;0
1022010;Oliver's Adventures in the Fairyland;;0 - 20,000;34;5;29;0;0;0
1022040;Candy Mandy;;20,000 - 50,000;2;3;-1;0;0;0
1022130;CLASH! - Battle Arena;;0 - 20,000;9;3;6;0;0;0
1022150;Bios Ex - Yami no Wakusei;;0 - 20,000;8;3;5;0;0;0
1022160;Rollossus;;0 - 20,000;2;1;1;0;0;0
1022170;VehiCraft;;0 - 20,000;0;3;-3;0;0;0
1022180;And I Must Scream;;0 - 20,000;9;20;-11;0;0;0
1022180;And I Must Scream;;0 - 20,000;9;20;-11;0;0;0
1022230;Magic Borderless;;20,000 - 50,000;89;45;44;0;0;31
1022270;Cartacombs;;0 - 20,000;2;0;2;0;0;0
1022280;CosPuzzle;;0 - 20,000;11;6;5;0;0;0
1022310;Warhammer Underworlds: Online;;50,000 - 100,000;929;564;365;37;37;3
1022320;Crypto Crisis: Education Edition;;0 - 20,000;1;0;1;0;0;0
1022380;Neon Slashers;;0 - 20,000;0;1;-1;0;0;0
1022450;War Selection;;1,000,000 - 2,000,000;14618;2203;12415;0;0;1079
1022480;KAMIKO;;0 - 20,000;129;17;112;127;127;2
1022530;SUBARACITY;;0 - 20,000;11;5;6;0;0;0
1022550;Neon Infinity;;0 - 20,000;5;0;5;0;0;0
1022610;Alchemic Dungeons DX;;20,000 - 50,000;12;2;10;0;0;0
1022630;Tankorama;;0 - 20,000;4;0;4;0;0;0
1022640;Lgnorant girl doll;;0 - 20,000;2;2;0;0;0;0
1022650;LeonWaan MineSweeper;;0 - 20,000;9;2;7;0;0;0
1022650;LeonWaan MineSweeper;;0 - 20,000;9;2;7;0;0;0
1022690;SOUND FORGE Audio Cleaning Lab Steam Edition;;0 - 20,000;2;0;2;0;0;0
1022700;SOUND FORGE Audio Studio 13 Steam Edition;;0 - 20,000;8;8;0;0;0;0
1022710;Conglomerate 451;;0 - 20,000;141;69;72;0;0;1
1022770;Beyond Enemy Lines: Operation Arctic Hawk;;0 - 20,000;6;14;-8;0;0;0
1022820;STEELPAW;;0 - 20,000;3;0;3;0;0;0
1022840;The Adventures of Jason and the Argonauts;;0 - 20,000;22;4;18;0;0;2
1022870;Luminos;;0 - 20,000;15;0;15;0;0;0
1022920;Two Clusters: Kain;;0 - 20,000;6;7;-1;0;0;0
1022980;Ostranauts;;50,000 - 100,000;490;172;318;1886;1886;14
1022990;Dement;;0 - 20,000;22;9;13;0;0;1
1023010;Escargot;;0 - 20,000;1;1;0;0;0;0
1023020;Slime Crunch;;20,000 - 50,000;1;3;-2;0;0;0
1023020;Slime Crunch;;20,000 - 50,000;1;3;-2;0;0;0
1023030;Blood Moon;;0 - 20,000;12;4;8;0;0;0
1023040;Hockey Camp - Goaltender;;0 - 20,000;5;2;3;0;0;0
1023060;Yet Another Survival Game;;20,000 - 50,000;12;13;-1;0;0;0
1023090;Super Agent: Drunk Kent;;0 - 20,000;0;1;-1;0;0;0
1023100;VCuber;;0 - 20,000;1;0;1;0;0;0
1023110;Seven Red Lines;;0 - 20,000;3;1;2;0;0;0
1023130;Defection;;0 - 20,000;2;2;0;0;0;0
1023150;Cyborg Invasion Shooter 3: Savior Of The World;;0 - 20,000;11;8;3;0;0;0
1023180;Combat Overrun;;0 - 20,000;1;0;1;0;0;0
1023250;因缘;;0 - 20,000;6;4;2;0;0;0
1023280;Solitaire Bliss Collection;;0 - 20,000;6;0;6;0;0;5
1023310;Logical Now!;;0 - 20,000;4;0;4;0;0;0
1023340;Radiant Ascent VR;;0 - 20,000;5;0;5;0;0;0
1023390;People;;0 - 20,000;9;9;0;0;0;0
1023410;3 GEEKS - La version Gauloise pour les francophones !;;50,000 - 100,000;16;3;13;0;0;0
1023420;四国志でらっくす ～酒池肉うどん戦記～;;0 - 20,000;0;1;-1;0;0;0
1023510;Matanga;;0 - 20,000;22;18;4;0;0;0
1023550;Rogue Star Rescue;;0 - 20,000;114;7;107;0;0;2
1023560;Cornflake Crisis;;0 - 20,000;12;0;12;0;0;0
1023570;PUZZLE: ANIMALS;;0 - 20,000;32;7;25;0;0;0
1023610;Royale Storm Bowling;;0 - 20,000;1;2;-1;0;0;0
1023640;Sweet Galaxy Adventure!;;0 - 20,000;6;2;4;0;0;0
1023650;Gun Man;;0 - 20,000;7;9;-2;0;0;0
1023680;Brass Town Wrestling;;0 - 20,000;9;6;3;0;0;0
1023690;Nurse Love Syndrome;;0 - 20,000;170;6;164;0;0;2
1023700;Palais de Reine;;0 - 20,000;94;16;78;0;0;1
1023710;KameaVR;;0 - 20,000;4;0;4;0;0;0
1023720;Hidden Mysteries: Royal Family Secrets;;0 - 20,000;6;5;1;0;0;0
1023740;7 Sexy Sins;;0 - 20,000;173;23;150;0;0;0
1023750;INVITATION;;0 - 20,000;44;22;22;0;0;0
1023760;Creation and Conquest：The Future War;;0 - 20,000;7;0;7;0;0;0
1023790;Rick Henderson;;0 - 20,000;26;0;26;0;0;0
1023860;GORSD;;0 - 20,000;7;0;7;0;0;0
1023870;Northern Lights;;0 - 20,000;29;30;-1;0;0;0
1023940;VR-CPR Personal Edition;;0 - 20,000;0;1;-1;0;0;0
1023960;Easter!;;0 - 20,000;3;10;-7;0;0;0
1023980;V.L.A.D.i.K;;0 - 20,000;257;225;32;0;0;0
1024010;Ultimate Fishing Simulator VR;;20,000 - 50,000;425;87;338;33;33;3
1024070;Ribbon Racer Next;;0 - 20,000;0;1;-1;0;0;0
1024080;The Scuttle;;0 - 20,000;14;4;10;0;0;0
1024100;Adventures of Isabelle Fine: Murder on Rails;;0 - 20,000;6;1;5;0;0;0
1024150;Valentines Cafe;;20,000 - 50,000;1;10;-9;0;0;0
1024160;Lord Winklebottom Investigates;;0 - 20,000;108;3;105;0;0;2
1024210;Leowald;;0 - 20,000;10;1;9;0;0;0
1024220;Death Waves;;0 - 20,000;5;10;-5;0;0;0
1024250;Firon;;0 - 20,000;4;1;3;0;0;0
1024330;Bhavacakra Grace;;0 - 20,000;5;3;2;0;0;0
1024380;Second Extinction;;200,000 - 500,000;3913;1509;2404;586;995;41
1024400;Marenian Tavern Story: Patty and the Hungry God;;0 - 20,000;45;12;33;0;0;2
1024430;Super Arcade Soccer;;0 - 20,000;28;23;5;0;0;0
1024450;DINO VR;;0 - 20,000;0;2;-2;0;0;0
1024460;Destructive Physics - Destruction Simulator;;0 - 20,000;85;21;64;373;373;0
1024470;La Fuga;;0 - 20,000;1;0;1;0;0;0
1024480;Immortal Realms: Vampire Wars;;200,000 - 500,000;301;182;119;0;0;3
1024490;Super Jigsaw Puzzle: Anime Reloaded;;0 - 20,000;8;3;5;0;0;0
1024520;Viking: Sigurd's Adventure;;0 - 20,000;7;2;5;0;0;0
1024530;Art by Numbers;;0 - 20,000;3;1;2;0;0;1
1024540;Alien League;;0 - 20,000;7;1;6;0;0;0
1024600;SkydiVeR;;0 - 20,000;2;11;-9;0;0;0
1024630;Fighters Legacy;;0 - 20,000;41;20;21;5;5;0
1024640;AppGameKit Studio;;0 - 20,000;70;19;51;0;0;2
1024650;Port Royale 4;;100,000 - 200,000;895;637;258;425;674;42
1024670;Ruination;;0 - 20,000;21;8;13;0;0;0
1024670;Ruination;;0 - 20,000;21;8;13;0;0;0
1024690;Chaos Village;;0 - 20,000;3;4;-1;0;0;0
1024720;Pagans Must Die;;0 - 20,000;0;1;-1;0;0;0
1024730;Murder Machine Mini;;0 - 20,000;2;0;2;0;0;0
1024780;Capture the planet: Cute War;;0 - 20,000;4;10;-6;0;0;0
1024790;Kare wa Kanojo;;0 - 20,000;48;12;36;0;0;0
1024790;Kare wa Kanojo;;0 - 20,000;48;12;36;0;0;0
1024850;Flow Weaver;;0 - 20,000;3;0;3;0;0;0
1024860;BFGE (Bartender Flair Game);;0 - 20,000;4;0;4;0;0;0
1024890;Sector's Edge;;200,000 - 500,000;2484;556;1928;0;0;10
1024950;Starship Horizons: Bridge Simulator;;0 - 20,000;23;4;19;0;0;1
1024970;Quantum Legend - VR Experience;;20,000 - 50,000;12;17;-5;0;0;0
1024980;Tornado!;;0 - 20,000;107;23;84;0;0;2
1025000;Puzzle 101: Edge of Galaxy 宇宙边际;;0 - 20,000;7;2;5;0;0;0
1025010;Cursor - by Mr iLyn.;;0 - 20,000;1;0;1;0;0;0
1025020;Wondershare Uniconverter-Video Converter, Video Editor, Video Compressor, Video Recorder, DVD Burner;;0 - 20,000;1;7;-6;0;0;1
1025070;Hello Lady! -New Division-;;0 - 20,000;294;13;281;0;0;3
1025130;Oik Memory 3;;0 - 20,000;62;5;57;0;0;0
1025140;LAMUNATION! -international-;;0 - 20,000;529;36;493;0;0;2
1025160;Xander the Monster Morpher: Universe Breaker;;0 - 20,000;8;0;8;0;0;0
1025200;The Floor Is Really Cheap Lava;;0 - 20,000;92;17;75;0;0;0
1025230;Minda;;0 - 20,000;10;3;7;0;0;0
1025240;GLAD VALAKAS TOWER DEFENCE 2;;0 - 20,000;97;4;93;0;0;0
1025250;Shadow Corridor;;200,000 - 500,000;1341;146;1195;0;0;12
1025260;Rebirth Fantasy;;20,000 - 50,000;100;43;57;0;0;0
1025270;Nogalious MSX;;0 - 20,000;2;4;-2;0;0;0
1025320;Forever Lost: Episode 2;;0 - 20,000;1;0;1;0;0;0
1025330;Full Pitch;;0 - 20,000;1;0;1;0;0;0
1025360;Woodcutter Survival;;0 - 20,000;3;0;3;0;0;0
1025420;Homing Shapes;;0 - 20,000;1;0;1;0;0;0
1025430;Delta Squad;;0 - 20,000;3;4;-1;0;0;0
1025440;Fantasy General II;;20,000 - 50,000;863;175;688;130;130;23
1025450;Forever Lost: Episode 3;;0 - 20,000;0;1;-1;0;0;0
1025460;Rift Racoon;;0 - 20,000;58;3;55;0;0;0
1025480;1-Bit Revival: The Residuals of Null;;0 - 20,000;16;0;16;0;0;0
1025500;Age-Old Cities VR;;20,000 - 50,000;22;13;9;0;0;0
1025510;Ancient Battle: Successors;;0 - 20,000;5;2;3;0;0;0
1025520;Ancient Battle: Alexander;;0 - 20,000;3;1;2;0;0;0
1025530;100 Years’ War;;0 - 20,000;5;2;3;0;0;0
1025540;Rebels & Redcoats;;0 - 20,000;4;1;3;0;0;0
1025550;Great Battles of the American Civil War;;0 - 20,000;5;3;2;0;0;0
1025580;Vainglory;;500,000 - 1,000,000;2722;1461;1261;0;0;1
1025600;Battle Realms: Zen Edition;;100,000 - 200,000;2219;299;1920;1093;1093;241
1025650;Astrog;;0 - 20,000;3;5;-2;0;0;0
1025710;Real Al's Humanity Academy;;0 - 20,000;27;3;24;0;0;0
1025740;The Woods: VR Escape the Room;;0 - 20,000;7;10;-3;0;0;0
1025870;MONSTERS:SURVIVAL;;0 - 20,000;4;7;-3;0;0;0
1025890;Other Submarine;;0 - 20,000;13;7;6;0;0;0
1025890;Other Submarine;;0 - 20,000;13;7;6;0;0;0
1025960;BURIED STARS;;100,000 - 200,000;1096;174;922;843;1557;35
1025990;Human Cube;;20,000 - 50,000;3;3;0;0;0;0
1026020;Zyphoid;;0 - 20,000;7;1;6;0;0;0
1026060;Brutal Games;;0 - 20,000;4;7;-3;0;0;0
1026070;12 Labours of Hercules IX: A Hero's Moonwalk;;0 - 20,000;28;1;27;0;0;3
1026080;The Antidote;;0 - 20,000;9;4;5;0;0;0
1026110;Racing Classics: Drag Race Simulator;;100,000 - 200,000;409;133;276;0;0;5
1026130;STAB STAB STAB!;;0 - 20,000;64;8;56;0;0;3
1026160;Misadventures of Laura Silver;;20,000 - 50,000;209;30;179;265;271;0
1026180;420 Button Clicker;;0 - 20,000;1;0;1;0;0;0
1026210;BAD BILLY 2D VR;;0 - 20,000;2;4;-2;0;0;0
1026370;My Fair Princess;;0 - 20,000;18;0;18;0;0;0
1026390;Magic Heart;;0 - 20,000;13;8;5;0;0;0
1026400;TAMASHII;;20,000 - 50,000;264;9;255;0;0;1
1026420;WARSAW;;20,000 - 50,000;634;244;390;148;211;2
1026430;Book of Eos;;0 - 20,000;4;0;4;0;0;0
1026450;ClipChap;;0 - 20,000;1;0;1;0;0;0
1026560;LOGistICAL 2: USA - Nevada;;0 - 20,000;6;0;6;0;0;1
1026610;Deathless Dungeon;;0 - 20,000;19;0;19;0;0;0
1026680;FINAL FANTASY VIII - REMASTERED;;100,000 - 200,000;2147;989;1158;648;951;128
1026760;DepthQVR_AQUA;;0 - 20,000;25;7;18;0;0;0
1026770;Lightmare Castle;;0 - 20,000;4;7;-3;0;0;0
1026810;A Story of Us - ep. 1 - First Memories;;0 - 20,000;2;3;-1;0;0;0
1026820;Coloring Game;;500,000 - 1,000,000;3322;260;3062;696;305;22
1026840;Ultra Fight Da ! Kyanta 2;;50,000 - 100,000;721;29;692;0;0;11
1026880;FIREGROUND Modern War;;50,000 - 100,000;39;19;20;0;0;0
1026920;ACID Music Studio 11 Steam Edition;;0 - 20,000;3;17;-14;0;0;1
1026940;Hei;;0 - 20,000;13;0;13;0;0;0
1026960;Professional Thief;;0 - 20,000;11;15;-4;0;0;0
1027060;CreatorCrate;;0 - 20,000;14;1;13;0;0;0
1027120;Bravery Network Online;;0 - 20,000;142;10;132;0;0;1
1027130;NEKO-NIN exHeart 2 Love +PLUS;;0 - 20,000;103;7;96;2;2;0
1027190;Hot Squat 2: New Glory;;0 - 20,000;20;1;19;0;0;0
1027200;Cold Bite;;0 - 20,000;4;5;-1;0;0;0
1027230;Woman's body: For adults;;0 - 20,000;0;0;0;0;0;0
1027250;The Alliance Alive HD Remastered;;0 - 20,000;160;34;126;0;0;3
1027280;MocuMocuVRM;;0 - 20,000;3;3;0;0;0;0
1027530;Robohazard 2077;;0 - 20,000;4;1;3;0;0;0
1027550;Bikini Surfer Girl - Wild Wahine;;0 - 20,000;1;0;1;0;0;0
1027610;Wampee Helicopters;;0 - 20,000;5;1;4;0;0;0
1027620;The Language of Love;;0 - 20,000;112;5;107;0;0;0
1027650;Supernova Tactics;;0 - 20,000;13;3;10;0;0;0
1027690;Mazania;;0 - 20,000;0;1;-1;0;0;0
1027700;Shmup Moments;;0 - 20,000;4;2;2;0;0;0
1027710;FIL;;0 - 20,000;8;0;8;0;0;0
1027720;Push Pull;;0 - 20,000;7;0;7;0;0;0
1027790;Maze Ninja;;0 - 20,000;1;0;1;0;0;0
1027800;Fly Flew Flown;;0 - 20,000;8;4;4;0;0;0
1027810;ZooKeeper;;0 - 20,000;28;11;17;0;0;3
1027820;Hand Simulator: Horror;;20,000 - 50,000;535;203;332;248;352;0
1027830;Sin;;;;;0;;;
1027930;Keystones;;20,000 - 50,000;2;0;2;0;0;0
1027960;World Peace Simulator 2019;;0 - 20,000;4;3;1;0;0;0
1027970;LesLove.Club: Jessica and Ashley;;0 - 20,000;28;10;18;0;0;0
1027990;Antenna Dilemma;;50,000 - 100,000;178;9;169;0;0;0
1028010;Speedrun Ninja;;0 - 20,000;2;1;1;0;0;0
1028030;Shuriken and Aliens;;0 - 20,000;4;3;1;0;0;0
1028090;Eruption 爆发;;0 - 20,000;27;2;25;0;0;1
1028110;Cooking Trip;;0 - 20,000;16;7;9;0;0;1
1028130;Gamble Fight Plus;;0 - 20,000;80;69;11;5;5;0
1028160;222;;0 - 20,000;4;6;-2;0;0;0
1028170;Tahko Alpine Ski;;20,000 - 50,000;43;5;38;0;0;0
1028250;Magic Gun;;0 - 20,000;6;0;6;0;0;0
1028280;Bridge! 3;;0 - 20,000;4;7;-3;0;0;0
1028300;Katana Soul;;0 - 20,000;48;1;47;0;0;0
1028330;FAN CLUB;;0 - 20,000;0;1;-1;0;0;0
1028340;Spare Teeth VR;;0 - 20,000;8;2;6;0;0;0
1028350;Pupperazzi;;0 - 20,000;335;12;323;110;110;3
1028360;Robo Miner 2;;0 - 20,000;1;2;-1;0;0;0
1028380;Data mining 6;;0 - 20,000;7;8;-1;0;0;0
1028410;Don't Look Back - VR;;0 - 20,000;0;4;-4;0;0;0
1028460;Spellcasting Collection;;0 - 20,000;7;0;7;0;0;1
1028470;Dis The Game;;200,000 - 500,000;941;631;310;0;0;3
1028480;Minskies;;0 - 20,000;4;1;3;0;0;0
1028490;Radical Rex;;0 - 20,000;11;4;7;0;0;0
1028500;Nightshade;;0 - 20,000;19;0;19;0;0;0
1028520;Brave Battle Saga - The Legend of The Magic Warrior;;0 - 20,000;15;5;10;0;0;0
1028550;Sinewave;;0 - 20,000;4;1;3;0;0;0
1028570;Lofi Ping Pong;;50,000 - 100,000;804;119;685;41;41;1
1028590;The WILDS;;0 - 20,000;56;11;45;0;0;0
1028610;Shift Shaft;;0 - 20,000;6;1;5;0;0;0
1028630;Cricket 19;;50,000 - 100,000;2577;256;2321;2374;2374;180
1028660;Pirouette;;0 - 20,000;5;1;4;0;0;0
1028730;Creo God Simulator;;0 - 20,000;48;17;31;5;5;1
1028740;Herd is Coming;;0 - 20,000;35;16;19;0;0;0
1028740;Herd is Coming;;0 - 20,000;35;16;19;0;0;0
1028750;Ultimate Logic Puzzle Collection;;20,000 - 50,000;58;14;44;0;0;6
1028760;Snow Battle Princess SAYUKI | 雪ん娘大旋風;;0 - 20,000;21;2;19;0;0;0
1028770;Kanji in Motion;;0 - 20,000;7;3;4;0;0;0
1028800;Survival Camp;;0 - 20,000;101;114;-13;0;0;0
1028820;Horror Stories;;0 - 20,000;5;4;1;0;0;0
1028830;Destiny Hunter;;0 - 20,000;2;3;-1;0;0;0
1028840;Super Toy Cars 2;;0 - 20,000;17;8;9;0;0;0
1028850;Baldina's Basis in Education Literary Grammar;;0 - 20,000;19;6;13;0;0;1
1028860;Star Chef: Cooking & Restaurant Game;;50,000 - 100,000;171;135;36;0;0;56
1028880;Mistero a Villa MilaFlora;;0 - 20,000;11;2;9;0;0;0
1028900;Operation Valderon;;0 - 20,000;3;0;3;0;0;0
1028910;Sparkle 4 Tales;;0 - 20,000;5;5;0;0;0;0
1028930;It Moves;;20,000 - 50,000;241;32;209;0;0;0
1028950;Transhaping;;0 - 20,000;5;9;-4;0;0;0
1028990;Maze Of Time;;0 - 20,000;0;2;-2;0;0;0
1029020;BionicBlitz;;0 - 20,000;1;0;1;0;0;0
1029040;Baby Redemption;;0 - 20,000;11;3;8;0;0;0
1029050;Dodge Diego;;0 - 20,000;19;3;16;0;0;0
1029070;Spark of Light;;0 - 20,000;14;3;11;0;0;0
1029080;Nowhere Station;;0 - 20,000;19;0;19;0;0;0
1029100;Worse Than Death;;0 - 20,000;41;8;33;0;0;1
1029110;Trash Time;;0 - 20,000;26;2;24;0;0;0
1029120;Space Expand;;0 - 20,000;10;15;-5;0;0;0
1029130;Sordwin: The Evertree Saga;;0 - 20,000;25;0;25;0;0;0
1029150;Totem Force;;0 - 20,000;8;1;7;0;0;0
1029160;Sunset Planet;;0 - 20,000;11;3;8;0;0;0
1029170;Skautfold: Moonless Knight;;0 - 20,000;41;7;34;0;0;0
1029210;30XX;;50,000 - 100,000;1063;76;987;1014;1014;50
1029220;Terraforming Earth;;0 - 20,000;24;0;24;0;0;0
1029230;Two For One;;0 - 20,000;1;0;1;0;0;0
1029240;Hentai Survive Island;;0 - 20,000;100;45;55;0;0;0
1029260;Unsung Story;;0 - 20,000;23;28;-5;0;0;0
1029340;Stream Animals;;0 - 20,000;13;2;11;0;0;0
1029380;Monster Hunting... For Love!;;0 - 20,000;30;0;30;0;0;0
1029470;Angry Farm;;0 - 20,000;4;5;-1;0;0;0
1029500;中华三国志 the Three Kingdoms of China;;200,000 - 500,000;1072;178;894;0;0;32
1029530;Aqua Rally;;0 - 20,000;2;3;-1;0;0;0
1029540;Super Kittens;;0 - 20,000;1;0;1;0;0;0
1029550;Torque Drift;;1,000,000 - 2,000,000;6239;2026;4213;135;19;300
1029560;Bandits;;0 - 20,000;23;3;20;0;0;0
1029570;Perfect Round Disc Golf;;0 - 20,000;55;10;45;0;0;1
1029630;Power & Revolution 2019 Edition;;20,000 - 50,000;737;463;274;0;0;22
1029640;reaktron;;0 - 20,000;1;0;1;0;0;0
1029650;יום פתוח (Open Day);;20,000 - 50,000;95;0;95;0;0;0
1029660;Athletics Games VR;;0 - 20,000;2;5;-3;0;0;0
1029690;Sniper Elite 5;;200,000 - 500,000;7509;1947;5562;1039;1129;2005
1029730;VR Ping Pong Pro;;0 - 20,000;30;28;2;0;0;0
1029750;Voipas;;0 - 20,000;0;1;-1;0;0;0
1029760;TANKNAROK;;0 - 20,000;95;7;88;0;0;0
1029780;Going Medieval;;500,000 - 1,000,000;12455;1396;11059;925;526;1338
1029790;Qubes;;0 - 20,000;8;0;8;0;0;0
1029840;Ne Touchez Pas 5;;0 - 20,000;1;0;1;0;0;0
1029860;Amber's Airline - 7 Wonders;;20,000 - 50,000;71;7;64;0;0;1
1029870;Unsung Heroes: The Golden Mask;;0 - 20,000;57;17;40;0;0;1
1029890;Layers of Fear 2 (2019);;100,000 - 200,000;1573;612;961;265;284;6
1029900;Rummy 3D Premium;;0 - 20,000;36;16;20;0;0;2
1029920;Twinship;;0 - 20,000;15;5;10;0;0;0
1029930;Bud Blitz;;0 - 20,000;0;1;-1;0;0;0
1029950;Big Boot Baseball;;0 - 20,000;1;0;1;0;0;0
1029970;Dig Deep;;0 - 20,000;63;5;58;0;0;0
1029980;UBERMOSH Vol.7;;0 - 20,000;151;22;129;0;0;1
1030060;Seed of Life;;20,000 - 50,000;58;25;33;0;0;0
1030060;Seed of Life;;20,000 - 50,000;58;25;33;0;0;0
1030090;Legend of GBC Tycoon GBC土豪金传说;;0 - 20,000;43;10;33;0;0;0
1030170;Fear for Sale: Endless Voyage Collector's Edition;;0 - 20,000;6;1;5;0;0;0
1030180;Dark Tales: Edgar Allan Poe's The Premature Burial Collector's Edition;;0 - 20,000;8;2;6;0;0;0
1030190;Amaranthine Voyage: The Orb of Purity Collector's Edition;;0 - 20,000;5;3;2;0;0;0
1030210;Torchlight III;;200,000 - 500,000;4938;5601;-663;1859;1748;46
1030240;Dino Tour VR;;0 - 20,000;7;10;-3;0;0;0
1030330;Wolf or Boy;;0 - 20,000;0;3;-3;0;0;0
1030350;Kingdomfall;;0 - 20,000;0;1;-1;0;0;0
1030360;Midnight Evil;;0 - 20,000;12;3;9;0;0;0
1030380;Real Fishing VR;;0 - 20,000;8;13;-5;0;0;0
1030410;Cryptrunner;;0 - 20,000;14;7;7;0;0;0
1030430;ARCADE;;0 - 20,000;17;2;15;0;0;0
1030470;With Loneliness;;0 - 20,000;22;6;16;0;0;0
1030520;Grater;;0 - 20,000;2;1;1;0;0;0
1030520;Grater;;0 - 20,000;2;1;1;0;0;0
1030530;Eleven Islands;;0 - 20,000;21;4;17;0;0;0
1030580;Your Future Self;;0 - 20,000;72;18;54;0;0;0
1030730;VIP Shuttle;;0 - 20,000;5;3;2;0;0;0
1030760;SteamDolls - Order Of Chaos : Concept Demo;;50,000 - 100,000;96;17;79;0;0;0
1030830;Mafia II: Definitive Edition;;1,000,000 - 2,000,000;12024;5239;6785;431;204;1102
1030840;Mafia: Definitive Edition;;1,000,000 - 2,000,000;45380;6889;38491;681;604;1704
1030950;Seventh Circle;;0 - 20,000;7;17;-10;0;0;0
1030960;Land War;;0 - 20,000;12;0;12;0;0;0
1030970;Dream Rose;;0 - 20,000;42;3;39;0;0;0
1031110;Unroaded;;20,000 - 50,000;255;15;240;0;0;0
1031120;Bakery Simulator;;0 - 20,000;496;183;313;33;33;17
1031120;Bakery Simulator;;0 - 20,000;496;183;313;33;33;17
1031130;Bat Hotel;;0 - 20,000;1;6;-5;0;0;0
1031140;The Horus Heresy: Legions;;200,000 - 500,000;1439;691;748;3467;4602;195
1031200;Mad Gun Range VR Simulator;;0 - 20,000;4;6;-2;0;0;0
1031220;Champions of Thora;;0 - 20,000;2;0;2;0;0;0
1031230;Midnight's Curse;;20,000 - 50,000;0;2;-2;0;0;0
1031270;Farming Life;;0 - 20,000;79;37;42;32;32;2
1031290;Grove flowers;;0 - 20,000;6;3;3;0;0;0
1031310;Polygon's Royale : Season 1;;0 - 20,000;1;2;-1;0;0;0
1031320;Malevolence;;0 - 20,000;5;0;5;0;0;0
1031330;Lyratha: Labyrinth - Survival - Escape;;20,000 - 50,000;10;2;8;0;0;0
1031370;Space Bound;;0 - 20,000;1;0;1;0;0;0
1031380;Long Z-Night;;0 - 20,000;1;0;1;0;0;0
1031440;TOKYO CHRONOS;;20,000 - 50,000;250;35;215;0;0;1
1031440;TOKYO CHRONOS;;20,000 - 50,000;250;35;215;0;0;1
1031460;Sail Forth;;0 - 20,000;254;14;240;0;0;8
1031470;Beasty Karts;;0 - 20,000;0;1;-1;0;0;0
1031480;TouHou Makuka Sai ~ Fantastic Danmaku Festival Part II;;50,000 - 100,000;2004;49;1955;283;283;8
1031540;aMAZE Lunar;;0 - 20,000;43;18;25;0;0;0
1031560;Sudoku3D 2: The Cube;;0 - 20,000;0;2;-2;0;0;0
1031570;Hookshot;;0 - 20,000;11;9;2;0;0;0
1031580;4DSnake;;0 - 20,000;6;0;6;0;0;0
1031590;The Adventures of Perseus;;0 - 20,000;18;8;10;0;0;0
1031630;Vaporspace;;0 - 20,000;4;2;2;0;0;0
1031640;Super Orb Collector;;0 - 20,000;13;5;8;0;0;0
1031650;Emu War!;;0 - 20,000;11;3;8;0;0;0
1031660;Mango Cart;;0 - 20,000;5;3;2;0;0;0
1031670;FPSBois;;20,000 - 50,000;22;20;2;0;0;0
1031700;Survivor;;20,000 - 50,000;73;41;32;0;0;0
1031770;Воин Хинора;;20,000 - 50,000;9;1;8;0;0;0
1031770;Воин Хинора;;20,000 - 50,000;9;1;8;0;0;0
1031790;Eternower;;0 - 20,000;43;4;39;0;0;0
1031800;Codex Temondera: Lost Vision;;0 - 20,000;13;6;7;0;0;0
1031830;Constructionary;;0 - 20,000;3;0;3;0;0;0
1031840;Shop Battle;;0 - 20,000;6;3;3;0;0;0
1031850;The Witchcraft of Skysword - 天翔と剣のウィッチクラフト;;0 - 20,000;2;2;0;0;0;0
1031900;You Can Kana - Learn Japanese Hiragana & Katakana;;0 - 20,000;140;1;139;0;0;5
1031910;The Path To Die;;0 - 20,000;14;3;11;0;0;0
1031920;Симулятор Сидения у Подъезда;;20,000 - 50,000;457;73;384;0;0;2
1032020;Shantalia and Corali'hulu;;0 - 20,000;10;4;6;0;0;0
1032040;龍炎高校伝説２ The Legend of the Dragonflame High School 2;;0 - 20,000;4;1;3;0;0;0
1032060;Carreras de Velocidad;;0 - 20,000;4;0;4;0;0;0
1032070;Mostly Scared of Spiders;;0 - 20,000;5;0;5;0;0;0
1032080;Boxed Out;;0 - 20,000;1;0;1;0;0;0
1032090;War of Power: The Last Fight;;0 - 20,000;1;4;-3;0;0;0
1032120;Stellar Survivor;;;;;0;;;
1032140;Let's Worm;;0 - 20,000;1;1;0;0;0;0
1032170;Robo Instructus;;0 - 20,000;55;9;46;222;222;1
1032210;2014.Aftermath;;0 - 20,000;4;5;-1;0;0;0
1032230;Bob's Cat Challenge;;0 - 20,000;3;0;3;0;0;0
1032240;Line Loops - Logic Puzzles;;0 - 20,000;5;1;4;0;0;0
1032260;Dodge This!;;20,000 - 50,000;9;16;-7;0;0;0
1032260;Dodge This!;;20,000 - 50,000;9;16;-7;0;0;0
1032340;Gekido Kintaro's Revenge;;0 - 20,000;32;12;20;0;0;0
1032430;Blood Trail;;100,000 - 200,000;2664;713;1951;102;118;41
1032440;Board Quizz Adventure;;0 - 20,000;4;0;4;0;0;0
1032450;Fallen Hearts;;0 - 20,000;10;4;6;0;0;0
1032510;Balance Roll;;0 - 20,000;10;2;8;0;0;0
1032520;JermaSlots;;50,000 - 100,000;497;28;469;0;0;2
1032560;Faux;;0 - 20,000;3;4;-1;0;0;0
1032570;Pilot Unknown;;0 - 20,000;3;2;1;0;0;0
1032580;Eldritch Academy;;0 - 20,000;10;1;9;0;0;0
1032590;Heaven Dust;;20,000 - 50,000;441;39;402;547;547;0
1032660;Romans from Mars (Free-to-Play);;0 - 20,000;19;3;16;0;0;0
1032670;FOCUS on YOU;;20,000 - 50,000;511;49;462;185;289;0
1032700;Bus Driving Sim 22;;0 - 20,000;145;71;74;26;26;8
1032730;Sticks And Bones;;20,000 - 50,000;113;11;102;0;0;0
1032750;Zombie Shooter: Ares Virus;;0 - 20,000;50;67;-17;0;0;2
1032770;Haprokon;;0 - 20,000;1;0;1;0;0;0
1032790;Journey of Greed;;50,000 - 100,000;1144;121;1023;717;717;8
1032830;Eldervale;;0 - 20,000;107;10;97;0;0;0
1033000;Shoot The Zombirds VR;;0 - 20,000;18;1;17;0;0;0
1033080;Letters - a written adventure;;20,000 - 50,000;118;8;110;119;119;1
1033090;Age of Darkness: Die Suche nach Relict;;0 - 20,000;3;1;2;0;0;0
1033100;Mobler;;50,000 - 100,000;127;17;110;0;0;0
1033110;Forgotten Trace: Thanatos in Nostalgia;;0 - 20,000;8;6;2;0;0;0
1033130;Monovert DX;;0 - 20,000;11;0;11;0;0;0
1033140;Church Era;;0 - 20,000;42;4;38;0;0;0
1033150;Gravinoid;;0 - 20,000;1;0;1;0;0;0
1033170;Talisman: Origins;;20,000 - 50,000;128;48;80;400;400;7
1033210;Winter Fury: The Longest Road;;0 - 20,000;26;6;20;0;0;0
1033220;The Amazing Shrinking Giraffe;;0 - 20,000;97;21;76;0;0;0
1033230;Sheep Collision;;0 - 20,000;3;2;1;0;0;0
1033240;Nystagmus;;0 - 20,000;14;10;4;0;0;0
1033250;BluBoy: The Journey Begins;;0 - 20,000;1;2;-1;0;0;0
1033330;Primordium - Day Zero;;0 - 20,000;1;11;-10;0;0;0
1033340;biorhythm;;0 - 20,000;23;2;21;0;0;0
1033360;Bears in Tanks;;0 - 20,000;1;0;1;0;0;0
1033370;Fruit Crawler;;20,000 - 50,000;2;0;2;0;0;0
1033410;Fragsurf;;0 - 20,000;110;22;88;0;0;1
1033420;9-nine-:Episode 2;;20,000 - 50,000;968;14;954;0;0;12
1033420;9-nine-:Episode 2;;20,000 - 50,000;968;14;954;0;0;12
1033450;Treasure chest Corps-結界を維持するため、魔物を退治した;;20,000 - 50,000;149;68;81;38;38;0
1033510;Red Room;;0 - 20,000;27;10;17;0;0;0
1033580;Nano Driller;;0 - 20,000;8;1;7;0;0;0
1033580;Nano Driller;;0 - 20,000;8;1;7;0;0;0
1033630;Tiger Tank 59 Ⅰ Break The Fog;;0 - 20,000;0;2;-2;0;0;0
1033640;SYNAPTIC DRIVE;;0 - 20,000;24;56;-32;0;0;0
1033660;Destruction;;0 - 20,000;0;1;-1;0;0;0
1033670;Defoliation;;0 - 20,000;5;8;-3;0;0;0
1033700;Kingdoms Of Rhea;;20,000 - 50,000;63;68;-5;0;0;0
1033710;Froggo;;0 - 20,000;8;7;1;0;0;0
1033720;The Psychiatrist: Major Depression;;0 - 20,000;0;7;-7;0;0;0
1033780;Lootbox Lyfe;;0 - 20,000;32;5;27;0;0;0
1033810;New Age;;50,000 - 100,000;66;42;24;0;0;16
1033860;Art of Horology;;0 - 20,000;5;3;2;0;0;0
1033880;Press F to pay respects;;0 - 20,000;177;36;141;0;0;0
1033930;Animal Doctor;;0 - 20,000;7;18;-11;0;0;0
1033950;Lamentum;;0 - 20,000;373;44;329;0;0;1
1033950;Lamentum;;0 - 20,000;373;44;329;0;0;1
1033960;Wet Dog Corp;;0 - 20,000;26;5;21;0;0;0
1034030;Bashed.OS;;0 - 20,000;5;0;5;0;0;0
1034040;Causa, Voices of the Dusk;;0 - 20,000;242;72;170;0;0;1
1034120;GACHIMUCHI The Card Game;;0 - 20,000;11;4;7;0;0;0
1034130;Dungeon Bosses;;0 - 20,000;4;7;-3;0;0;0
1034150;Mosaic Chronicles;;0 - 20,000;27;3;24;0;0;2
1034160;Extreme Racing on Highway;;0 - 20,000;77;23;54;0;0;0
1034200;Its Simple, SHOOT;;0 - 20,000;60;3;57;0;0;0
1034230;***;;0 - 20,000;6;7;-1;0;0;0
1034240;The Far Kingdoms: Awakening Solitaire;;0 - 20,000;22;5;17;0;0;0
1034250;The far Kingdoms: Winter Solitaire;;0 - 20,000;23;9;14;0;0;1
1034260;The Far Kingdoms: Sacred Grove Solitaire;;0 - 20,000;11;4;7;0;0;0
1034270;Luxor Solitaire;;0 - 20,000;13;4;9;0;0;0
1034280;Greed 3: Old Enemies Returning;;0 - 20,000;23;7;16;0;0;0
1034370;Iron Heart;;0 - 20,000;12;9;3;0;0;0
1034380;Alice's Jigsaw. Wonderland Chronicles;;0 - 20,000;6;1;5;0;0;0
1034390;Alice's Jigsaw. Wonderland Chronicles 2;;0 - 20,000;5;0;5;0;0;0
1034400;Mystery Solitaire The Black Raven;;0 - 20,000;17;2;15;0;0;1
1034410;Strike Solitaire;;0 - 20,000;6;3;3;0;0;0
1034440;Roach Killer;;0 - 20,000;2;3;-1;0;0;0
1034540;Lorenzo il Magnifico;;0 - 20,000;61;20;41;0;0;0
1034560;Tales of Nebezem RPG: Red Peril;;0 - 20,000;6;2;4;0;0;0
1034610;In.My.Mind;;0 - 20,000;5;2;3;0;0;0
1034700;GRAY;;0 - 20,000;0;0;0;0;0;0
1034740;Hard Light Vector;;0 - 20,000;44;13;31;0;0;0
1034750;The Flower Collectors;;0 - 20,000;115;25;90;0;0;0
1034810;Pax Romana: Romulus;;0 - 20,000;56;15;41;0;0;0
1034820;Puss in Boots: Fear Not Hooman;;0 - 20,000;1;3;-2;0;0;0
1034830;oscar and paul;;0 - 20,000;0;1;-1;0;0;0
1034850;Best Friend Forever;;0 - 20,000;126;42;84;0;0;2
1034860;GRANDIA HD Remaster;;20,000 - 50,000;1007;89;918;345;551;28
1034870;Norman's Night In;;0 - 20,000;6;2;4;0;0;0
1034880;DoraKone;;20,000 - 50,000;157;5;152;0;0;0
1034890;Obey Me;;0 - 20,000;64;8;56;0;0;0
1034900;Blaster Master Zero;;20,000 - 50,000;692;45;647;319;344;1
1034910;Blaster Master Zero 2;;0 - 20,000;344;36;308;1934;1934;5
1034920;Whipseey and the Lost Atlas;;0 - 20,000;17;7;10;0;0;0
1034930;Nine Witches: Family Disruption - Prologue;;0 - 20,000;46;1;45;0;0;0
1034940;Higurashi When They Cry Hou - Ch.7 Minagoroshi;;0 - 20,000;323;11;312;0;0;10
1034950;Mad Princess: The Great Gladiators;;0 - 20,000;11;0;11;0;0;0
1035010;Mini Gal4Xy;;0 - 20,000;30;6;24;0;0;0
1035050;Alt-Frequencies;;20,000 - 50,000;106;17;89;0;0;1
1035110;Moonrise Fall;;0 - 20,000;28;2;26;0;0;0
1035180;Crescendo;;0 - 20,000;0;2;-2;0;0;0
1035190;Zombies In The Forest;;0 - 20,000;9;8;1;0;0;0
1035260;A Game For You, Josh;;0 - 20,000;2;0;2;0;0;0
1035270;Furry Chronicles;;0 - 20,000;3;4;-1;0;0;0
1035280;Stoppa!;;0 - 20,000;1;0;1;0;0;0
1035300;cockroach Planet Survival;;0 - 20,000;0;1;-1;0;0;0
1035310;Outbreak: Lost Hope;;0 - 20,000;17;9;8;0;0;0
1035320;MarineVerse Cup - Sailboat Racing;;0 - 20,000;26;4;22;2;2;0
1035340;眼睛（眼球）结构研究;;0 - 20,000;1;0;1;0;0;0
1035410;xMoon;;20,000 - 50,000;3;0;3;0;0;0
1035410;xMoon;;20,000 - 50,000;3;0;3;0;0;0
1035430;Table Games VR;;0 - 20,000;1;0;1;0;0;0
1035470;Takotan - 星のタコ;;0 - 20,000;3;0;3;0;0;0
1035490;EURGAVA: Tomb of Senza;;0 - 20,000;4;0;4;0;0;0
1035500;Escape from the tomb tower;;0 - 20,000;0;1;-1;0;0;0
1035510;Ultimate Zombie Defense;;100,000 - 200,000;1175;174;1001;482;817;17
1035530;Disobedient Sheep;;0 - 20,000;9;5;4;0;0;0
1035530;Disobedient Sheep;;0 - 20,000;9;5;4;0;0;0
1035550;Galaxy Forces VR;;0 - 20,000;14;1;13;0;0;0
1035560;Struggling;;20,000 - 50,000;498;80;418;126;168;2
1035600;The Dawn: Sniper's Way;;0 - 20,000;5;12;-7;0;0;0
1035610;Hentai Mosaique Vip Room;;20,000 - 50,000;296;21;275;111;145;3
1035660;Chromosome Evil;;0 - 20,000;208;34;174;9;9;2
1035690;Great Adventure in the World of Sky;;0 - 20,000;8;2;6;0;0;1
1035700;Reflections ~Dreams and Reality~;;0 - 20,000;8;2;6;0;0;0
1035750;文字獄;;50,000 - 100,000;268;26;242;0;0;1
1035760;Glimmer in Mirror;;20,000 - 50,000;470;130;340;0;0;10
1035770;Jewel Match Solitaire 2 Collector's Edition;;0 - 20,000;33;6;27;0;0;1
1035790;Laruaville 7 - Match 3 Adventure;;0 - 20,000;3;0;3;0;0;0
1035800;Mistress of Maids: First Castle;;20,000 - 50,000;77;11;66;0;0;1
1035830;Dracologic;;0 - 20,000;1;0;1;0;0;0
1035850;Balancelot;;0 - 20,000;93;26;67;0;0;0
1035860;Super Space Jump Man;;0 - 20,000;5;6;-1;0;0;0
1035880;Block Dodge Challenge;;0 - 20,000;6;3;3;0;0;0
1035890;vApe Escape;;20,000 - 50,000;99;7;92;0;0;0
1035900;Prison Escape;;0 - 20,000;3;4;-1;0;0;0
1035920;Chocolate makes you happy: Lunar New Year;;0 - 20,000;17;12;5;0;0;0
1035930;Nyasha;;200,000 - 500,000;343;79;264;814;305;0
1035950;Philophobia: The Fear of Love;;0 - 20,000;66;4;62;0;0;0
1035960;Recycler's Terminal;;0 - 20,000;1;1;0;0;0;0
1035990;Dialtown: Phone Dating Sim;;20,000 - 50,000;911;8;903;122;122;19
1036000;The Ploshers;;0 - 20,000;14;4;10;0;0;0
1036010;polyfuru feat. MIYA KIMINO / ポリフる feat. キミノミヤ;;0 - 20,000;0;2;-2;0;0;0
1036030;EscapeRoute;;0 - 20,000;1;1;0;0;0;0
1036120;病毒恶化 VirusCrisis;;0 - 20,000;118;42;76;0;0;1
1036120;病毒恶化 VirusCrisis;;0 - 20,000;118;42;76;0;0;1
1036200;Song Animals;;0 - 20,000;45;14;31;0;0;0
1036240;Definitely Not Fried Chicken;;50,000 - 100,000;374;112;262;558;558;63
1036260;Journey For Elysium;;0 - 20,000;74;13;61;0;0;0
1036270;Bug Aviators in Theme Park;;0 - 20,000;19;10;9;0;0;0
1036320;Once Upon A Death;;20,000 - 50,000;0;15;-15;0;0;0
1036330;BattleCubes: Arena;;0 - 20,000;0;1;-1;0;0;0
1036340;Hit N' Rush;;20,000 - 50,000;57;32;25;0;0;0
1036340;Hit N' Rush;;20,000 - 50,000;57;32;25;0;0;0
1036370;Flying Red Barrel - The Diary of a Little Aviator;;0 - 20,000;90;1;89;1;1;1
1036400;Mage VR: The Lost Memories;;0 - 20,000;2;3;-1;0;0;0
1036420;Command: Desert Storm;;0 - 20,000;8;2;6;0;0;0
1036440;Kingdom Wars 2: Definitive Edition;;20,000 - 50,000;264;112;152;0;0;2
1036460;Similars: Climb;;0 - 20,000;1;0;1;0;0;0
1036490;Space Smash;;20,000 - 50,000;47;1;46;0;0;0
1036530;A way up!;;0 - 20,000;9;8;1;0;0;0
1036540;PaymoneyWubby: The Game;;0 - 20,000;16;0;16;0;0;0
1036550;Levers & Buttons;;0 - 20,000;2;2;0;0;0;0
1036580;National Park Girls;;20,000 - 50,000;147;13;134;0;0;0
1036580;National Park Girls;;20,000 - 50,000;147;13;134;0;0;0
1036600;Junglex;;0 - 20,000;22;12;10;0;0;0
1036620;Alien Cow Farm;;0 - 20,000;2;0;2;0;0;0
1036640;RPG Developer Bakin;;0 - 20,000;123;23;100;0;0;26
1036660;MiniGolf Maker;;0 - 20,000;60;13;47;996;996;1
1036700;My Beautiful Paper Smile;;500,000 - 1,000,000;284;39;245;0;0;0
1036740;METAL DOGS;;20,000 - 50,000;548;101;447;0;0;8
1036780;Pokris;;0 - 20,000;2;1;1;0;0;0
1036800;Night Island;;0 - 20,000;17;6;11;0;0;0
1036820;Marvin The Hatter;;0 - 20,000;11;13;-2;0;0;0
1036840;Cat Defense;;0 - 20,000;9;6;3;0;0;0
1036850;Auf Abwegen;;100,000 - 200,000;256;95;161;0;0;0
1036870;Night Catcher;;0 - 20,000;23;5;18;0;0;0
1036890;Shadow Warrior 3: Definitive Edition;;100,000 - 200,000;2002;1061;941;208;275;74
1036900;Seven Bullets Zombie Apocalypse;;0 - 20,000;23;5;18;0;0;0
1036910;€100;;0 - 20,000;64;19;45;0;0;0
1036920;DooM in the Dark;;0 - 20,000;7;15;-8;0;0;0
1036930;PC Fútbol Stars;;20,000 - 50,000;59;24;35;0;0;0
1036950;Super Jigsaw Puzzle: Generations;;50,000 - 100,000;715;33;682;3134;4254;193
1036970;HENTAI GIRL PUZZLE;;0 - 20,000;0;0;0;0;0;0
1036980;Mysteries of the Undead;;0 - 20,000;56;34;22;0;0;0
1036990;Royal Gems;;0 - 20,000;22;3;19;0;0;0
1037000;Where are My Pipes?;;0 - 20,000;4;0;4;0;0;0
1037010;Mystery Solitaire Grimm's Tales;;0 - 20,000;13;4;9;0;0;0
1037080;Zedfest;;0 - 20,000;158;18;140;0;0;1
1037090;GREEN The Life Algorithm;;0 - 20,000;17;5;12;0;0;0
1037100;You Died but a Necromancer revived you;;0 - 20,000;38;3;35;0;0;0
1037110;GoK;;0 - 20,000;17;8;9;0;0;0
1037120;Mutropolis;;0 - 20,000;141;10;131;0;0;1
1037130;Dandy Ace;;20,000 - 50,000;836;99;737;146;209;20
1037140;Mow Problem;;0 - 20,000;2;1;1;0;0;0
1037190;Shipped;;20,000 - 50,000;560;17;543;0;0;2
1037260;Diacrisis;;0 - 20,000;4;4;0;0;0;0
1037270;酔いどれクイズshow 標鍛;;0 - 20,000;1;0;1;0;0;0
1037330;Senpai Teaches Me Japanese;;0 - 20,000;5;4;1;0;0;0
1037340;Over The Cloud : Lost Planet;;0 - 20,000;0;1;-1;0;0;0
1037350;Back to 1998;;0 - 20,000;13;4;9;0;0;0
1037410;Captain Starshot;;20,000 - 50,000;189;70;119;0;0;0
1037430;Hell Hole;;0 - 20,000;1;2;-1;0;0;0
1037460;DEEP 8;;0 - 20,000;22;1;21;0;0;1
1037480;Classic Racers;;20,000 - 50,000;372;51;321;0;0;3
1037560;Fat Prisoner Simulator;;20,000 - 50,000;344;62;282;0;0;0
1037570;Sellswords: Ashen Company;;0 - 20,000;51;21;30;32;32;0
1037590;Neptunia Shooter;;50,000 - 100,000;615;73;542;126;143;0
1037600;Lord Democrat Strikes Out!;;0 - 20,000;1;2;-1;0;0;0
1037690;BIOSZARD Corporation;;0 - 20,000;21;10;11;0;0;0
1037750;Looking for Heals;;0 - 20,000;83;24;59;0;0;0
1037760;Hold The Fort;;0 - 20,000;46;11;35;0;0;0
1037820;Warsworn: DRAGON OF JAPAN - EMPIRE EDITION;;0 - 20,000;12;19;-7;0;0;0
1037830;Rascal Fight | 捣蛋大作战;;0 - 20,000;28;12;16;0;0;0
1037840;Running Ninja;;20,000 - 50,000;21;16;5;0;0;0
1037850;Pirate Cannons AHOY!;;0 - 20,000;2;0;2;0;0;0
1037910;Paw Paw Paw;;20,000 - 50,000;170;141;29;184;184;2
1037930;Era of Miracles;;0 - 20,000;11;5;6;0;0;0
1037940;Dead Monarchy;;0 - 20,000;47;10;37;0;0;5
1037950;迷宫战争(Maze Wars);;0 - 20,000;2;3;-1;0;0;0
1037960;Grand Dude Simulator;;20,000 - 50,000;83;60;23;0;0;0
1037970;I'm Hungry;;0 - 20,000;9;1;8;0;0;0
1037990;PHAGEBORN Online Card Game;;0 - 20,000;90;23;67;0;0;0
1038000;Makross;;0 - 20,000;23;8;15;0;0;0
1038070;Physics Drop;;0 - 20,000;2;1;1;0;0;0
1038100;Trap for Winners;;0 - 20,000;13;2;11;0;0;0
1038120;b.m.g 19 - bike messenger go!;;0 - 20,000;4;1;3;0;0;0
1038240;RainDesktop;;0 - 20,000;40;33;7;0;0;2
1038250;DIRT 5;;100,000 - 200,000;2951;2629;322;136;125;52
1038280;Nobodies: Murder Cleaner;;0 - 20,000;248;25;223;0;0;3
1038300;New Super Lucky's Tale;;0 - 20,000;227;9;218;121;121;4
1038370;Trials of Fire;;100,000 - 200,000;2479;355;2124;696;888;49
1038380;PuppetShow: Porcelain Smile Collector's Edition;;0 - 20,000;8;0;8;0;0;0
1038410;ShooterSpheres;;0 - 20,000;0;1;-1;0;0;0
1038430;Dráscula: The Vampire Strikes Back;;0 - 20,000;5;1;4;0;0;1
1038440;Mortadelo y Filemón: El sulfato atómico;;0 - 20,000;14;6;8;0;0;0
1038450;Nancy Drew: Midnight in Salem;;100,000 - 200,000;531;423;108;575;575;8
1038620;House of 1000 Doors: Evil Inside;;0 - 20,000;72;28;44;0;0;6
1038620;House of 1000 Doors: Evil Inside;;0 - 20,000;72;28;44;0;0;6
1038630;Eternal Journey: New Atlantis;;0 - 20,000;46;5;41;0;0;0
1038640;Joan Jade and the Gates of Xibalba;;0 - 20,000;15;13;2;0;0;1
1038650;Love Alchemy: A Heart In Winter;;0 - 20,000;24;26;-2;0;0;0
1038670;Mind's Eye: Secrets of the Forgotten;;0 - 20,000;10;32;-22;0;0;0
1038680;凯旋岛;;0 - 20,000;11;11;0;0;0;0
1038740;Fluffy Store;;100,000 - 200,000;2858;81;2777;171;264;3
1038810;GOD WARS The Complete Legend;;20,000 - 50,000;141;43;98;0;0;4
1038820;拯救大魔王2:逆流 Falsemen2:Upstream;;0 - 20,000;107;82;25;0;0;0
1038830;Author Clicker;;0 - 20,000;6;8;-2;0;0;0
1038850;Boom! Boom!;;0 - 20,000;4;7;-3;0;0;0
1039040;Copperbell;;0 - 20,000;26;2;24;0;0;0
1039060;pepeizq's Cities;;0 - 20,000;0;1;-1;0;0;0
1039080;Brood;;0 - 20,000;17;5;12;0;0;0
1039100;No Place for Bravery;;20,000 - 50,000;80;35;45;0;0;1
1039110;Ikarus;;20,000 - 50,000;46;7;39;0;0;0
1039200;Poggers;;0 - 20,000;75;4;71;0;0;0
1039310;REGOLA;;0 - 20,000;23;8;15;0;0;0
1039320;Summer Girl;;0 - 20,000;9;5;4;0;0;1
1039330;NOTE;;0 - 20,000;14;3;11;0;0;0
1039350;StoneTide: Age of Pirates;;0 - 20,000;29;13;16;0;0;0
1039360;Eyes in the Dark;;0 - 20,000;88;21;67;0;0;1
1039370;Draw With Unknown;;0 - 20,000;78;41;37;0;0;2
1039380;Bunny Parking;;0 - 20,000;19;3;16;0;0;0
1039430;Hyper Flight;;0 - 20,000;3;0;3;0;0;0
1039470;Over My Dead Pixel;;0 - 20,000;14;0;14;0;0;0
1039550;礎の楯 -AEGIS-;;0 - 20,000;3;1;2;0;0;0
1039560;Amanda's Sticker Book 2 - Amazing Wildlife;;0 - 20,000;11;8;3;0;0;0
1039570;Find the Oil Racing Edition;;0 - 20,000;19;24;-5;0;0;0
1039580;Super Welder;;0 - 20,000;17;4;13;0;0;0
1039590;Snake-a-roni;;0 - 20,000;14;8;6;0;0;0
1039800;BlueGlow;;0 - 20,000;1;0;1;0;0;0
1039830;彼岸画廊/Nether Gallery;;0 - 20,000;174;27;147;0;0;0
1039860;Lifeless Vanguard;;0 - 20,000;5;0;5;0;0;0
1039880;Hellsplit: Arena;;100,000 - 200,000;2400;428;1972;240;347;32
1039890;EARTH DEFENSE FORCE: IRON RAIN;;100,000 - 200,000;665;452;213;568;721;13
1039910;Buckler 2;;0 - 20,000;4;0;4;0;0;0
1039960;Grisaia Phantom Trigger Vol.5.5;;0 - 20,000;63;4;59;0;0;0
1039970;Grisaia Phantom Trigger Vol.6;;0 - 20,000;89;4;85;0;0;0
1040000;SpaceBullet;;0 - 20,000;2;0;2;0;0;0
1040070;Merchant of the Skies;;100,000 - 200,000;1157;158;999;13;25;6
1040080;Please The Gods;;0 - 20,000;30;11;19;0;0;0
1040150;Frame Of Reference;;0 - 20,000;2;0;2;0;0;0
1040190;SleepWalker;;0 - 20,000;5;0;5;0;0;0
1040230;Curious Expedition 2;;200,000 - 500,000;2671;300;2371;597;692;87
1040310;I Know Everything;;0 - 20,000;14;7;7;0;0;0
1040370;Thigh Climbers;;0 - 20,000;2;0;2;0;0;0
1040390;Later Daters - Premium;;0 - 20,000;66;7;59;0;0;1
1040420;Dreamscaper;;100,000 - 200,000;2163;237;1926;1363;1363;13
1040430;Adventure Climb VR;;200,000 - 500,000;193;72;121;0;0;3
1040460;Space Scavenger;;20,000 - 50,000;198;27;171;1468;2888;5
1040480;Daka Dara;;0 - 20,000;1;0;1;0;0;0
1040490;Prologue for a Vacant Kingdom;;20,000 - 50,000;225;9;216;0;0;0
1040550;Spring Falls;;20,000 - 50,000;617;17;600;83;165;0
1040590;Killer Chambers;;0 - 20,000;45;7;38;0;0;0
1040610;Zero One / 杀戮世界;;0 - 20,000;14;4;10;0;0;0
1040620;Tournament: Blood & Steel;;0 - 20,000;9;4;5;0;0;0
1040630;Alchemy Story;;0 - 20,000;139;27;112;0;0;0
1040720;The Color of the Roses;;0 - 20,000;13;2;11;0;0;0
1040740;Legend of the Tetrarchs;;0 - 20,000;23;6;17;47;47;0
1040750;Kim Shooter;;0 - 20,000;2;0;2;0;0;0
1040810;Attack Noids;;0 - 20,000;3;1;2;0;0;0
1040820;Rumble Arena;;20,000 - 50,000;130;69;61;0;0;0
1040860;Lustlock Labyrinth;;0 - 20,000;6;4;2;0;0;0
1040890;Slime Simulator Games;;0 - 20,000;13;6;7;0;0;0
1040900;Massive Air Combat;;0 - 20,000;1;2;-1;0;0;0
1040910;Epic World;;0 - 20,000;1;3;-2;0;0;0
1040940;Protocol VR;;0 - 20,000;21;25;-4;0;0;0
1041060;Future Futures - Command Z;;0 - 20,000;5;1;4;0;0;0
1041070;The Driver's Mission;;0 - 20,000;1;1;0;0;0;0
1041100;LocoMotives;;20,000 - 50,000;18;1;17;0;0;0
1041100;LocoMotives;;20,000 - 50,000;18;1;17;0;0;0
1041130;Darkest Depths;;0 - 20,000;13;3;10;0;0;0
1041140;Chill II;;0 - 20,000;4;6;-2;0;0;0
1041160;Observers;;0 - 20,000;1;0;1;0;0;0
1041210;Mission: It's Complicated;;0 - 20,000;167;11;156;123;123;0
1041270;Exogenesis ~Perils of Rebirth~;;0 - 20,000;9;4;5;0;0;0
1041300;Human Sacrifice;;0 - 20,000;3;4;-1;0;0;0
1041320;Lords Mobile;;500,000 - 1,000,000;3250;1492;1758;7568;512;2635
1041330;Tiger Fighter 1931 Tora!;;0 - 20,000;0;2;-2;0;0;0
1041390;Legend of Cina;;0 - 20,000;8;1;7;0;0;0
1041400;Fight Angel/格斗天使;;0 - 20,000;58;3;55;0;0;0
1041450;RRRR2;;0 - 20,000;18;4;14;0;0;0
1041500;Dead Quest;;0 - 20,000;9;0;9;0;0;0
1041520;World of Aircraft: Glider Simulator;;0 - 20,000;27;25;2;0;0;0
1041630;Jungle Adventure;;0 - 20,000;0;1;-1;0;0;0
1041650;Time Warrior Z VR;;;;;0;;;
1041660;Welcome To... Chichester 3 : Plenty Of Time To Live;;0 - 20,000;1;1;0;0;0;0
1041670;Money Bath VR / 札束風呂VR;;0 - 20,000;24;21;3;0;0;0
1041680;Wave Circles: Rhythm Dance Music;;0 - 20,000;43;28;15;0;0;0
1041690;Mace and Grace: action fight blood fitness arcade;;0 - 20,000;46;6;40;0;0;0
1041710;Sim Empire;;0 - 20,000;77;99;-22;0;0;9
1041720;Kingdoms of Amalur: Re-Reckoning;;500,000 - 1,000,000;3991;1340;2651;1313;637;263
1041760;Brother & Sister;;0 - 20,000;14;12;2;0;0;0
1041780;Soul Valley;;0 - 20,000;16;8;8;0;0;0
1041840;Fight Angel Special Edition;;50,000 - 100,000;1088;334;754;1356;2664;8
1041890;iMemory;;0 - 20,000;10;6;4;0;0;0
1041920;If Found...;;50,000 - 100,000;1260;138;1122;523;775;5
1041940;Fort Sumter: The Secession Crisis;;0 - 20,000;59;9;50;0;0;1
1042010;OMEGA: The Beginning - Episode 1;;0 - 20,000;6;6;0;0;0;0
1042020;Trapped on Monster Island;;20,000 - 50,000;77;47;30;79;79;0
1042030;Nyasha Winter;;0 - 20,000;19;16;3;0;0;0
1042090;Melting pot.;;0 - 20,000;2;0;2;0;0;0
1042100;Dimense: Chapter 1;;0 - 20,000;1;0;1;0;0;0
1042110;BreakFest;;0 - 20,000;6;1;5;0;0;0
1042130;Under Water : Abyss Survival VR;;0 - 20,000;8;1;7;0;0;0
1042150;Data mining 7;;0 - 20,000;12;9;3;0;0;0
1042160;The Islander: Town Architect;;0 - 20,000;74;25;49;0;0;0
1042170;Summon of Asmodeus;;0 - 20,000;103;60;43;0;0;0
1042210;Guts And Goals;;0 - 20,000;38;3;35;0;0;0
1042230;Zeta Complex;;0 - 20,000;9;5;4;0;0;0
1042290;Duckumentary;;0 - 20,000;1;4;-3;0;0;0
1042310;Glacial;;0 - 20,000;2;3;-1;0;0;0
1042330;Tricky Cat;;0 - 20,000;43;4;39;0;0;0
1042380;Hundred Days - Winemaking Simulator;;50,000 - 100,000;542;158;384;1180;1180;31
1042460;Newt's Voyage;;0 - 20,000;12;2;10;0;0;0
1042490;Call of the Sea;;200,000 - 500,000;2881;317;2564;527;742;14
1042530;POWER;;20,000 - 50,000;65;44;21;0;0;0
1042550;Digimon Story Cyber Sleuth: Complete Edition;;200,000 - 500,000;7089;652;6437;1627;1197;384
1042560;城堡传说：魔王觉醒;;0 - 20,000;152;39;113;0;0;0
1042560;城堡传说：魔王觉醒;;0 - 20,000;152;39;113;0;0;0
1042570;Human Rights;;0 - 20,000;25;2;23;0;0;0
1042590;新巨商;;0 - 20,000;3;8;-5;0;0;0
1042600;Demon Queen Melissa;;0 - 20,000;52;10;42;0;0;10
1042670;Orangeblood;;100,000 - 200,000;242;90;152;11;11;1
1042750;Night shot;;0 - 20,000;9;6;3;0;0;0
1042780;Pine;;100,000 - 200,000;1233;414;819;292;411;14
1042800;Warhammer 40,000: Inquisitor - Prophecy;;100,000 - 200,000;1826;455;1371;216;295;116
1042820;Baobabs Mausoleum Ep.3: Un Pato en Muertoburgo;;0 - 20,000;14;6;8;0;0;0
1042860;Golden war spirit;;0 - 20,000;2;4;-2;0;0;0
1042880;Chaos;;0 - 20,000;0;5;-5;0;0;0
1042900;Borderlight;;50,000 - 100,000;1;5;-4;0;0;0
1042910;Desdemona;;50,000 - 100,000;4;8;-4;0;0;0
1042920;Unsouled;;0 - 20,000;187;33;154;0;0;1
1042930;Trackmaster;;0 - 20,000;17;9;8;0;0;1
1042980;Zen Chess: Mate in Two;;0 - 20,000;66;12;54;0;0;0
1042980;Zen Chess: Mate in Two;;0 - 20,000;66;12;54;0;0;0
1042990;Zen Chess: Mate in Three;;0 - 20,000;36;13;23;0;0;0
1043000;Zen Chess: Mate in Four;;0 - 20,000;35;16;19;0;0;0
1043020;Dust On Wheels;;0 - 20,000;2;18;-16;0;0;0
1043030;The Long Sky;;0 - 20,000;5;0;5;0;0;0
1043040;Picross Floof;;0 - 20,000;5;8;-3;0;0;0
1043060;Rupert and Riley Shipwrecked;;0 - 20,000;3;0;3;0;0;0
1043120;Bowling Over It;;0 - 20,000;10;4;6;0;0;0
1043130;Flavortown:VR;;0 - 20,000;5;0;5;0;0;0
1043140;灵界  Sprites（测试版）;;0 - 20,000;16;0;16;0;0;0
1043150;Danger Gazers;;0 - 20,000;50;19;31;0;0;0
1043160;You Versus 27 Elves;;0 - 20,000;2;0;2;0;0;0
1043180;Lovers of Aether;;100,000 - 200,000;1358;102;1256;44;43;1
1043200;International Affairs;;0 - 20,000;11;0;11;0;0;0
1043240;Touhou Kishinjou ~ Double Dealing Character.;;20,000 - 50,000;273;2;271;0;0;2
1043250;StreamPad;;0 - 20,000;12;3;9;0;0;0
1043260;Gladiator Guild Manager;;100,000 - 200,000;1522;291;1231;1815;3254;38
1043340;No Time;;20,000 - 50,000;1153;35;1118;112;112;32
1043350;1406;;50,000 - 100,000;42;56;-14;0;0;1
1043360;Massive Effect;;0 - 20,000;11;6;5;0;0;0
1043370;SABAT Fight Arena;;0 - 20,000;0;1;-1;0;0;0
1043380;The Trials of Olympus III: King of the World;;0 - 20,000;7;8;-1;0;0;0
1043390;FlowScape;;50,000 - 100,000;1062;171;891;13;16;5
1043430;Tidal Tribe;;0 - 20,000;67;10;57;0;0;0
1043470;弹幕那个恶人;;0 - 20,000;11;5;6;0;0;0
1043480;Destruction;;0 - 20,000;1;0;1;0;0;0
1043500;Tree Simulator 2020;;0 - 20,000;442;17;425;0;0;5
1043510;Hotdog Man;;0 - 20,000;2;1;1;0;0;0
1043560;Static;;20,000 - 50,000;12;0;12;0;0;0
1043580;PipeWorks;;0 - 20,000;3;0;3;0;0;0
1043610;Cold Cable: Lifeshift;;100,000 - 200,000;13;8;5;0;0;0
1043690;Investi-Gator: The Case of the Big Crime;;0 - 20,000;34;0;34;0;0;0
1043710;Unlanded;;20,000 - 50,000;12;1;11;0;0;0
1043760;涅槃之路;;0 - 20,000;9;1;8;0;0;0
1043790;Ogrez;;0 - 20,000;2;0;2;0;0;0
1043860;Glad Valakas: Cyberban;;0 - 20,000;126;3;123;0;0;0
1043870;Dark Forest;;0 - 20,000;14;0;14;0;0;0
1043890;Tipping Point;;0 - 20,000;17;1;16;0;0;0
1044020;Potata: fairy flower;;0 - 20,000;66;14;52;0;0;1
1044020;Potata: fairy flower;;0 - 20,000;66;14;52;0;0;1
1044030;Japanese: A-N;;0 - 20,000;1;0;1;0;0;0
1044040;Survive the Blackout;;0 - 20,000;55;27;28;0;0;0
1044070;Monster Crush - C4 Demolition Edition;;0 - 20,000;3;0;3;0;0;0
1044110;Reforged TD - Tower Defense;;0 - 20,000;26;7;19;0;0;0
1044130;不惑英雄传(puzzled heroes);;0 - 20,000;55;22;33;0;0;0
1044170;Lord of the click;;20,000 - 50,000;43;35;8;0;0;0
1044180;Planet;;0 - 20,000;4;4;0;0;0;0
1044180;Planet;;0 - 20,000;4;4;0;0;0;0
1044200;Wasteland Survival;;500,000 - 1,000,000;3255;2300;955;0;0;38
1044210;Mahjong Solitaire Refresh;;20,000 - 50,000;13;1;12;0;0;0
1044220;Oik Reloaded;;0 - 20,000;65;6;59;0;0;0
1044220;Oik Reloaded;;0 - 20,000;65;6;59;0;0;0
1044300;Human Pinball : Iceage;;0 - 20,000;0;5;-5;0;0;0
1044340;The 7th Guest: 25th Anniversary Edition;;20,000 - 50,000;131;32;99;0;0;1
1044350;The Crater;;0 - 20,000;5;2;3;0;0;0
1044410;DOOR:Inner Child;;20,000 - 50,000;25;7;18;0;0;0
1044450;Hentai Waifu;;0 - 20,000;36;3;33;147;147;1
1044460;Wild Cats of Wasteland;;0 - 20,000;1;2;-1;0;0;0
1044480;Alexio;;0 - 20,000;28;2;26;0;0;0
1044490;The Expression Amrilato;;20,000 - 50,000;559;16;543;0;0;4
1044620;Aokana - Four Rhythms Across the Blue;;50,000 - 100,000;3800;69;3731;1536;2085;71
1044630;Choice of the Dragon;;0 - 20,000;11;11;0;0;0;0
1044640;Mundus - Impossible Universe;;0 - 20,000;20;11;9;0;0;4
1044720;Farthest Frontier;;200,000 - 500,000;9587;1687;7900;522;373;2329
1044750;Q&A: A Light-Roasted Romance;;0 - 20,000;7;4;3;0;0;0
1044760;Garden Of Mooj;;0 - 20,000;21;5;16;0;0;0
1044770;Goddess of Math 数学女神;;0 - 20,000;41;3;38;0;0;0
1044790;Gado Fight;;20,000 - 50,000;67;33;34;0;0;0
1044800;Global Fortune;;0 - 20,000;3;0;3;0;0;0
1044820;Agtnan: Monster Shutdown Sequence;;0 - 20,000;1;0;1;0;0;0
1044840;Moonstone Crossroads;;0 - 20,000;5;0;5;0;0;0
1044870;Zero-based World-从零开始;;0 - 20,000;132;53;79;0;0;0
1044900;圣山ShenShan;;0 - 20,000;1;0;1;0;0;0
1044920;Grand Battle;;0 - 20,000;12;8;4;0;0;0
1044930;恋爱公寓（My Girl：Love Story）;;20,000 - 50,000;18;38;-20;0;0;0
1044950;Picross Hansel and Gretel - Nonograms;;0 - 20,000;8;12;-4;0;0;0
1044980;Mech Mechanic Simulator;;50,000 - 100,000;318;151;167;271;481;7
1045010;Russia Roguelike;;0 - 20,000;76;9;67;0;0;0
1045020;Blanket Heavy With Nightmares;;0 - 20,000;37;5;32;0;0;0
1045060;The Copper Canyon Shoot Out;;0 - 20,000;6;4;2;0;0;0
1045070;Please Find Me;;0 - 20,000;30;13;17;0;0;0
1045080;Curious Cases;;100,000 - 200,000;247;80;167;0;0;3
1045110;Space Ops VR: Reloaded;;0 - 20,000;39;38;1;0;0;0
1045120;Brunch Club;;0 - 20,000;42;16;26;2;2;0
1045130;Raatihuone;;50,000 - 100,000;8;1;7;0;0;0
1045140;ESKO;;0 - 20,000;10;0;10;0;0;0
1045150;Contort Effect;;0 - 20,000;1;0;1;0;0;0
1045180;Shattered - Tale of the Forgotten King;;20,000 - 50,000;402;168;234;580;734;7
1045220;Cyber Rage Retribution;;0 - 20,000;6;6;0;0;0;0
1045280;eCrossminton;;0 - 20,000;1;0;1;0;0;0
1045300;Prismatic Maze;;0 - 20,000;5;0;5;0;0;0
1045310;Escape From Earth;;0 - 20,000;3;4;-1;0;0;0
1045390;D20 Dungeons;;0 - 20,000;9;0;9;0;0;0
1045430;Circadian City;;0 - 20,000;106;40;66;0;0;1
1045510;Call of Fries;;0 - 20,000;25;12;13;0;0;0
1045530;Stupid Quest - Medieval Adventures;;0 - 20,000;11;0;11;0;0;0
1045580;Deleveled;;0 - 20,000;264;64;200;123;212;2
1045580;Deleveled;;0 - 20,000;264;64;200;123;212;2
1045590;Kaisuo;;20,000 - 50,000;39;12;27;0;0;0
1045590;Kaisuo;;20,000 - 50,000;39;12;27;0;0;0
1045610;Startup Panic;;20,000 - 50,000;95;66;29;0;0;1
1045620;Atelier Lulua ~The Scion of Arland~;;50,000 - 100,000;434;43;391;0;0;7
1045650;My Stunt Life;;0 - 20,000;153;32;121;0;0;0
1045720;The Coma 2: Vicious Sisters;;50,000 - 100,000;2164;89;2075;271;306;10
1045740;Hit&Run VR baseball;;0 - 20,000;2;6;-4;0;0;0
1045840;Intruders: Hide and Seek;;20,000 - 50,000;197;74;123;31;31;0
1045850;The Walsingham Files - Chapter 1;;50,000 - 100,000;38;7;31;0;0;0
1045900;Outpost On Syrinx;;0 - 20,000;16;0;16;0;0;0
1045930;1vs1: Battle Royale for the throne;;0 - 20,000;37;13;24;0;0;0
1046030;ISLANDERS;;500,000 - 1,000,000;13849;701;13148;302;98;62
1046060;Dark Romance: Hunchback of Notre-Dame Collector's Edition;;0 - 20,000;7;0;7;0;0;0
1046070;Helltower;;0 - 20,000;3;1;2;0;0;0
1046110;Shadow Runner;;0 - 20,000;0;1;-1;0;0;0
1046130;Tiki Trials;;0 - 20,000;14;0;14;0;0;0
1046140;Epic Food Fight VR;;0 - 20,000;0;2;-2;0;0;0
1046210;Munchie Match;;0 - 20,000;10;0;10;0;0;0
1046230;Soccer Player Simulator;;20,000 - 50,000;176;39;137;0;0;0
1046240;Creature Hunt;;0 - 20,000;15;24;-9;0;0;1
1046300;Pirates Outlaws;;20,000 - 50,000;465;81;384;0;0;14
1046330;BUTCHERBOX;;0 - 20,000;5;1;4;0;0;0
1046350;Aerial Raver;;0 - 20,000;3;1;2;0;0;0
1046370;Meaty McSkinBones;;20,000 - 50,000;75;30;45;0;0;0
1046400;Astalon: Tears of the Earth;;20,000 - 50,000;616;37;579;3;3;9
1046470;Deep the Game;;100,000 - 200,000;701;221;480;0;0;2
1046490;Action Entities;;0 - 20,000;49;24;25;0;0;0
1046530;Universe 24;;0 - 20,000;5;2;3;0;0;0
1046560;Sounds of Talent: Kpop Adventure;;0 - 20,000;0;3;-3;0;0;0
1046570;Cardlings;;0 - 20,000;9;3;6;0;0;0
1046600;勇者有点太嚣张。G(No Hero Allowed: No Puzzle Either!);;50,000 - 100,000;33;27;6;0;0;1
1046610;foreverloops BEATS;;0 - 20,000;2;0;2;0;0;0
1046630;Tank Maniacs;;0 - 20,000;30;0;30;0;0;0
1046660;Charterstone: Digital Edition;;20,000 - 50,000;168;54;114;0;0;3
1046670;Delirium VR;;0 - 20,000;13;4;9;0;0;0
1046740;TimeTraveler;;20,000 - 50,000;7;3;4;0;0;0
1046750;Extinction: Alien Invasion;;0 - 20,000;5;6;-1;0;0;0
1046770;Juice FX;;0 - 20,000;78;19;59;80;80;1
1046790;Eternal Threads;;20,000 - 50,000;246;23;223;0;0;5
1046820;I'm on Observation Duty;;50,000 - 100,000;1143;57;1086;292;307;23
1046910;Dissection Simulator: Frog Edition;;0 - 20,000;1;0;1;0;0;0
1046930;Dota Underlords;;5,000,000 - 10,000,000;74000;15781;58219;3085;280;2445
1046980;HORGIHUGH (ホーギーヒュー);;0 - 20,000;12;5;7;0;0;0
1047010;Synergia;;50,000 - 100,000;483;63;420;45;79;0
1047020;Dice Keeper;;0 - 20,000;1;1;0;0;0;0
1047120;Gorilla Unko;;0 - 20,000;27;1;26;0;0;0
1047140;THE SOUL HUNTER;;0 - 20,000;16;7;9;0;0;0
1047160;ItazuraVR Safe for Work;;0 - 20,000;6;3;3;0;0;0
1047170;Forgotten Fables: Wolves on the Westwind;;20,000 - 50,000;50;3;47;0;0;0
1047190;Lantern of Worlds - The Story of Layla;;0 - 20,000;15;0;15;0;0;0
1047220;Frog Detective 2: The Case of the Invisible Wizard;;50,000 - 100,000;1254;62;1192;99;108;4
1047240;"Game club ""Waka-Waka""";;0 - 20,000;60;25;35;0;0;0
1047340;TimeFall;;20,000 - 50,000;2;0;2;0;0;0
1047350;Asteroid Wars;;0 - 20,000;1;0;1;0;0;0
1047380;MMA Arena;;0 - 20,000;57;26;31;0;0;0
1047380;MMA Arena;;0 - 20,000;57;26;31;0;0;0
1047410;Steambirds Alliance Beta;;20,000 - 50,000;234;33;201;183;207;0
1047430;Zulin Time;;0 - 20,000;6;4;2;0;0;0
1047440;DATE A LIVE: Rio Reincarnation;;100,000 - 200,000;2534;153;2381;199;263;21
1047480;Miner Lou;;20,000 - 50,000;64;21;43;0;0;0
1047580;Ghost Grab 3000;;0 - 20,000;43;1;42;0;0;0
1047620;Rasen no Sora;;0 - 20,000;4;1;3;0;0;0
1047640;Helios;;0 - 20,000;62;26;36;0;0;0
1047680;ALILIA 亚利利亚的精灵们;;0 - 20,000;136;10;126;0;0;0
1047720;Dolphin Swim;;20,000 - 50,000;19;23;-4;0;0;0
1047750;Chili The Chipmunk Pinball Adventure;;0 - 20,000;6;8;-2;0;0;0
1047780;Die Already;;0 - 20,000;2;2;0;0;0;0
1047800;Ladderhead;;0 - 20,000;6;0;6;0;0;0
1047810;Tropia;;0 - 20,000;10;1;9;0;0;0
1047840;The Volcano;;0 - 20,000;2;0;2;0;0;0
1047850;Narwhal Heist;;0 - 20,000;11;0;11;0;0;0
1047860;Dunrog;;0 - 20,000;25;15;10;0;0;0
1047870;Something Ate My Alien;;0 - 20,000;52;6;46;0;0;0
1047910;Slow.Bullet VR;;0 - 20,000;3;5;-2;0;0;0
1047930;Templum de Malum;;0 - 20,000;5;1;4;0;0;0
1047950;GUILT: The Deathless;;0 - 20,000;37;7;30;0;0;1
1047960;TOK 2;;0 - 20,000;114;7;107;0;0;0
1048020;Harvest Moon: Mad Dash;;0 - 20,000;8;4;4;0;0;0
1048080;aMAZE Easter;;0 - 20,000;31;14;17;0;0;0
1048090;The Fifth Horseman;;0 - 20,000;6;1;5;0;0;0
1048100;Peekaboo;;100,000 - 200,000;2538;668;1870;222;178;1
1048260;Super Catscape;;0 - 20,000;2;1;1;0;0;0
1048270;Sexy Breakout;;0 - 20,000;27;5;22;0;0;0
1048280;UNKNOWN REGION;;0 - 20,000;22;21;1;0;0;0
1048300;STUMPER;;0 - 20,000;20;2;18;0;0;0
1048320;都市恐怖故事;;0 - 20,000;3;1;2;0;0;0
1048350;Nigate Tale;;20,000 - 50,000;473;179;294;115;115;5
1048410;Becoming a Dandelion Spore;;0 - 20,000;2;2;0;0;0;0
1048420;Vacation Adventures: Park Ranger 2;;0 - 20,000;4;1;3;0;0;0
1048470;迷雾 The Mist;;0 - 20,000;6;1;5;0;0;0
1048530;Rise of Humanity;;0 - 20,000;39;10;29;0;0;1
1048540;Kao the Kangaroo: Round 2 (2003 re-release);;500,000 - 1,000,000;6968;472;6496;204;123;41
1048560;Voidrun;;0 - 20,000;28;6;22;0;0;0
1048570;In the Pause Between the Ringing;;0 - 20,000;91;20;71;0;0;0
1048580;Terje Haakonsen's Powder VR;;0 - 20,000;51;15;36;0;0;0
1048600;Stela;;50,000 - 100,000;550;149;401;101;160;1
1048640;At Home;;0 - 20,000;7;37;-30;0;0;0
1048660;Knight Squad 2;;0 - 20,000;164;11;153;0;0;3
1048690;Cosmic Cash;;0 - 20,000;2;3;-1;0;0;0
1048740;Half Past Fate;;0 - 20,000;222;13;209;0;0;0
1048790;Phantasmata;;20,000 - 50,000;13;1;12;0;0;0
1048830;Horse Riding Tales;;100,000 - 200,000;261;178;83;0;0;17
1048850;Jelly Blocks;;0 - 20,000;4;0;4;0;0;0
1048860;Crypterion;;0 - 20,000;8;1;7;0;0;0
1048880;Emberlight;;0 - 20,000;42;9;33;0;0;0
1048900;The Fog: Trap for Moths;;20,000 - 50,000;45;30;15;0;0;3
1048920;The Jolly Gang's Misadventures in Africa / Масяня в полной Африке;;0 - 20,000;84;7;77;0;0;1
1048950;Desert Skies;;20,000 - 50,000;264;105;159;506;573;1
1048960;Leaf;;0 - 20,000;7;1;6;0;0;0
1049000;Chronoraptor;;0 - 20,000;15;1;14;0;0;0
1049010;Out of Frame / ノベルゲームの枠組みを変えるノベルゲーム。;;0 - 20,000;6;6;0;0;0;0
1049030;Day: 40;;0 - 20,000;7;3;4;0;0;0
1049040;Wind Force;;0 - 20,000;2;3;-1;0;0;0
1049070;Fidelity;;0 - 20,000;27;6;21;0;0;0
1049080;Candy Adventure;;0 - 20,000;2;3;-1;0;0;0
1049090;Virtual Arctic Expedition;;0 - 20,000;7;2;5;0;0;0
1049100;泡沫冬景;;20,000 - 50,000;4059;188;3871;352;607;3
1049130;SPECIAL FORCE VR: INFINITY WAR;;0 - 20,000;33;21;12;0;0;0
1049140;The Cinema Rosa;;0 - 20,000;27;4;23;0;0;0
1049220;Naxia;;0 - 20,000;64;42;22;0;0;0
1049220;Naxia;;0 - 20,000;64;42;22;0;0;0
1049230;Gray Memory;;0 - 20,000;1;1;0;0;0;0
1049270;The Prison;;0 - 20,000;5;2;3;0;0;0
1049280;Pilgrims;;50,000 - 100,000;2677;102;2575;480;480;5
1049310;Backpack Twins;;0 - 20,000;9;0;9;0;0;0
1049320;River City Girls;;100,000 - 200,000;2226;389;1837;734;1019;41
1049360;Orbitron;;0 - 20,000;11;6;5;0;0;0
1049370;F18 Carrier Landing;;0 - 20,000;4;3;1;0;0;0
1049380;SurviVR - Castle Defender;;0 - 20,000;2;0;2;0;0;0
1049400;Answer Knot;;20,000 - 50,000;549;60;489;0;0;1
1049410;Superliminal;;1,000,000 - 2,000,000;19711;1091;18620;170;154;184
1049420;Hotel Tutwin;;0 - 20,000;38;9;29;0;0;0
1049490;Trysaria;;0 - 20,000;4;2;2;0;0;0
1049510;These Lands;;0 - 20,000;4;2;2;0;0;0
1049530;SUBS: Sharks And Submarines;;0 - 20,000;11;2;9;0;0;0
1049560;Run For Cover;;0 - 20,000;16;0;16;0;0;0
1049570;Bloodstream;;0 - 20,000;12;6;6;0;0;0
1049590;Eternal Return: Black Survival;;2,000,000 - 5,000,000;35433;9373;26060;1899;233;5237
1049660;stein.world;;50,000 - 100,000;507;260;247;0;0;7
1049670;The Final Boss;;0 - 20,000;59;5;54;0;0;0
1049680;Snipiyo / スナイピヨ;;0 - 20,000;2;1;1;0;0;0
1049690;Catch the Head;;0 - 20,000;8;0;8;0;0;0
1049710;Minute of Islands;;20,000 - 50,000;350;87;263;0;0;2
1049720;Sqvishy;;0 - 20,000;1;0;1;0;0;0
1049730;Callisto;;0 - 20,000;1;5;-4;0;0;0
1049800;BLOCKADE;;500,000 - 1,000,000;7803;2597;5206;0;0;25
1049820;Must Dash Amigos;;0 - 20,000;22;13;9;0;0;0
1049840;Haramatia;;0 - 20,000;11;2;9;0;0;0
1049850;UFO2: Extraterrestrials;;0 - 20,000;78;52;26;0;0;6
1049870;Blocksplode;;0 - 20,000;7;3;4;0;0;0
1049890;Little Witch Nobeta;;200,000 - 500,000;8624;1920;6704;429;437;45
1049910;Onslaught: Armoured Assault;;0 - 20,000;4;2;2;0;0;0
1049930;Frank and 10 roots;;0 - 20,000;1;1;0;0;0;0
1049950;Arena Stars;;20,000 - 50,000;79;36;43;0;0;0
1050000;Bear With Me: The Lost Robots;;20,000 - 50,000;90;13;77;4;4;1
1050010;Even For Eternia;;20,000 - 50,000;6;0;6;0;0;0
1050080;Project Skylab 3: A New Frontier;;0 - 20,000;3;7;-4;0;0;0
1050150;Sexy Miss;;0 - 20,000;0;2;-2;7;7;0
1050160;Sacrifice Your Friends;;20,000 - 50,000;15;4;11;0;0;0
1050170;Terramancer;;50,000 - 100,000;1;1;0;0;0;0
1050180;Life source: episode one;;0 - 20,000;5;5;0;0;0;0
1050190;Fast Travel: Loot Delivery Service;;0 - 20,000;7;1;6;0;0;0
1050210;The Superlatives: Shattered Worlds;;0 - 20,000;5;2;3;0;0;0
1050230;Dodge Bubble;;0 - 20,000;33;12;21;0;0;0
1050240;MiniGolf;;0 - 20,000;24;19;5;0;0;0
1050240;MiniGolf;;0 - 20,000;24;19;5;0;0;0
1050260;Isle of Pan;;0 - 20,000;20;1;19;0;0;1
1050280;Kaion Tale MMORPG;;50,000 - 100,000;181;55;126;0;0;18
1050330;Ambient DM;;0 - 20,000;7;5;2;0;0;0
1050340;HOLOGRA;;0 - 20,000;10;13;-3;0;0;0
1050350;Ultimate Poker;;0 - 20,000;2;3;-1;0;0;0
1050430;UNI TURRET;;0 - 20,000;1;0;1;0;0;0
1050500;Feed  A Titanosaur;;0 - 20,000;8;0;8;0;0;0
1050510;Super Tennis Blast;;0 - 20,000;61;13;48;0;0;0
1050520;Super Pig X;;0 - 20,000;26;0;26;0;0;0
1050540;Valley Of The Moon;;0 - 20,000;2;7;-5;0;0;0
1050540;Valley Of The Moon;;0 - 20,000;2;7;-5;0;0;0
1050560;TAG WAR VR;;0 - 20,000;5;7;-2;0;0;0
1050580;Adventure In Aellion;;0 - 20,000;12;8;4;0;0;0
1050620;Hitchhiker;;0 - 20,000;1;0;1;0;0;0
1050660;Noodle Jump;;0 - 20,000;1;0;1;0;0;0
1050670;Fear in Hospital;;200,000 - 500,000;176;180;-4;0;0;0
1050690;火柴人和七色彩虹 Stickman's Rainbow;;0 - 20,000;4;0;4;0;0;0
1050720;S.C.A.R;;0 - 20,000;36;14;22;0;0;0
1050730;Uriel’s Chasm 3: Gelshock;;0 - 20,000;12;0;12;0;0;0
1050810;The Hunt in the Forest;;0 - 20,000;6;15;-9;0;0;0
1050880;Wavey The Rocket;;0 - 20,000;26;2;24;0;0;0
1050900;Die Bloody Nazi Die!;;0 - 20,000;6;0;6;0;0;0
1050910;GALAXY MONSTER;;0 - 20,000;0;3;-3;0;0;0
1051060;Cookie Invaders;;0 - 20,000;4;1;3;0;0;0
1051130;Trial of the Towers;;20,000 - 50,000;26;9;17;0;0;0
1051160;Snowball Rush;;20,000 - 50,000;8;5;3;0;0;0
1051170;家园（Home Land）;;0 - 20,000;24;15;9;0;0;0
1051190;Reel Fishing: Road Trip Adventure;;0 - 20,000;4;4;0;0;0;0
1051200;Trover Saves the Universe;;200,000 - 500,000;2555;231;2324;184;193;5
1051220;busy spider;;20,000 - 50,000;3;1;2;0;0;0
1051250;Try To Survive;;0 - 20,000;29;45;-16;0;0;0
1051260;Forklift: Simulator;;0 - 20,000;15;12;3;0;0;1
1051280;Ballista Legend;;0 - 20,000;5;2;3;0;0;1
1051290;ZIC – Zombies in City;;0 - 20,000;30;7;23;0;0;1
1051300;Parking 3D;;0 - 20,000;11;3;8;0;0;0
1051310;Paper Dolls: Original / 纸人;;200,000 - 500,000;3249;507;2742;268;283;39
1051320;Mahjong: Magic Chips;;0 - 20,000;1;2;-1;0;0;1
1051330;Crossroads Extreme;;0 - 20,000;6;2;4;0;0;0
1051350;Dead Forest;;0 - 20,000;37;0;37;0;0;2
1051410;Wanderlust: Travel Stories;;0 - 20,000;87;10;77;0;0;1
1051420;Jey's Empire;;0 - 20,000;38;1;37;0;0;1
1051420;Jey's Empire;;0 - 20,000;38;1;37;0;0;1
1051470;Animal Friends Adventure;;0 - 20,000;7;3;4;0;0;0
1051500;Digital Diamond Baseball V8;;0 - 20,000;21;1;20;0;0;2
1051570;Hockey Player VR;;0 - 20,000;30;19;11;0;0;0
1051580;Skjoldur Story;;0 - 20,000;28;5;23;0;0;0
1051600;Surface: The Soaring City Collector's Edition;;0 - 20,000;2;0;2;0;0;0
1051630;Memorial Park of Hypoxia;;0 - 20,000;1;15;-14;0;0;0
1051690;Nightmare Reaper;;50,000 - 100,000;2666;162;2504;173;256;41
1051830;House of Evil 2;;20,000 - 50,000;5;15;-10;0;0;0
1051840;Paradox Vector;;0 - 20,000;45;9;36;0;0;0
1051850;Free Company VR;;0 - 20,000;21;15;6;0;0;0
1051870;RoboArena;;0 - 20,000;17;14;3;0;0;0
1051890;BLOCKADE War Stories;;0 - 20,000;54;19;35;0;0;0
1051900;Exit Limbo: Opening;;50,000 - 100,000;28;10;18;0;0;0
1051920;CD-RUN;;0 - 20,000;21;2;19;0;0;0
1051940;The Artifacts;;0 - 20,000;1;0;1;0;0;0
1051950;Voyage;;0 - 20,000;94;15;79;0;0;0
1051960;Fly Punch Boom!;;0 - 20,000;115;10;105;0;0;0
1051960;Fly Punch Boom!;;0 - 20,000;115;10;105;0;0;0
1051990;TARS;;0 - 20,000;17;0;17;0;0;0
1052010;Heidentum;;0 - 20,000;0;4;-4;0;0;0
1052030;Star Impact;;0 - 20,000;11;0;11;0;0;0
1052080;Resistance is Fruitile;;0 - 20,000;12;0;12;0;0;0
1052100;Heart of Smoke;;0 - 20,000;12;1;11;0;0;0
1052140;Function World Gym;;0 - 20,000;1;0;1;0;0;0
1052150;WoozyHero 乌贼英雄-欢乐联机版;;0 - 20,000;38;6;32;0;0;0
1052210;Barney's Dream Cruise;;0 - 20,000;16;6;10;0;0;0
1052220;GlassSmash;;0 - 20,000;33;7;26;0;0;0
1052250;Tiger Tank 59 Ⅰ Black Hill Fortress;;0 - 20,000;0;2;-2;0;0;0
1052310;TUBWT;;0 - 20,000;6;8;-2;0;0;0
1052330;Atlasee;;0 - 20,000;0;1;-1;0;0;0
1052360;Combate Monero;;0 - 20,000;18;6;12;0;0;0
1052370;Echo Royale;;0 - 20,000;10;2;8;0;0;0
1052370;Echo Royale;;0 - 20,000;10;2;8;0;0;0
1052380;Ikeda : The Scrap Hunter E.P.;;20,000 - 50,000;97;35;62;0;0;0
1052420;Badland Caravan;;0 - 20,000;10;15;-5;0;0;0
1052440;Croixleur Sigma - Deluxe Edition;;0 - 20,000;95;22;73;0;0;0
1052470;OFFICE ESCAPE;;0 - 20,000;2;1;1;0;0;0
1052480;Adecke - Cards Games Deluxe;;0 - 20,000;4;3;1;0;0;0
1052500;御龙在天-平衡国战版;;20,000 - 50,000;35;64;-29;0;0;0
1052500;御龙在天-平衡国战版;;20,000 - 50,000;35;64;-29;0;0;0
1052540;Toolboy;;0 - 20,000;3;4;-1;0;0;0
1052550;Global Soccer: A Management Game 2019;;0 - 20,000;6;9;-3;0;0;0
1052550;Global Soccer: A Management Game 2019;;0 - 20,000;6;9;-3;0;0;0
1052560;Murder On The Island;;0 - 20,000;1;3;-2;0;0;0
1052580;farewell planet / おわかれのほし;;0 - 20,000;19;1;18;0;0;0
1052590;ZYKRUN;;0 - 20,000;0;1;-1;0;0;0
1052600;Amortizer Off-Road;;0 - 20,000;5;6;-1;0;0;0
1052640;Retrace;;0 - 20,000;31;3;28;0;0;0
1052670;Trainspotting Simulator;;0 - 20,000;3;0;3;0;0;0
1052760;Hexa Path;;0 - 20,000;12;1;11;0;0;0
1052850;Perplexity: Suburban Home;;0 - 20,000;0;1;-1;0;0;0
1052870;Pixel Puzzles 2: Paintings;;0 - 20,000;14;5;9;0;0;0
1052900;Assault of the Robots;;0 - 20,000;21;12;9;0;0;0
1052920;Caelus Trident;;20,000 - 50,000;55;112;-57;0;0;0
1052970;Soul of Giga;;0 - 20,000;26;10;16;0;0;1
1052990;A Monster's Expedition;;50,000 - 100,000;930;38;892;3;3;7
1053000;PLANES ATTACK;;100,000 - 200,000;285;85;200;0;0;0
1053020;Galak Zed;;0 - 20,000;17;0;17;0;0;0
1053040;Zom-bie, or Not Zom-bie;;0 - 20,000;3;1;2;0;0;0
1053060;KillStreak.tv;;50,000 - 100,000;333;63;270;0;0;0
1053090;Virtual Skydiving;;0 - 20,000;4;1;3;0;0;0
1053160;Witch Ring Meister;;0 - 20,000;28;9;19;0;0;1
1053170;Idle Cooking Emperor;;20,000 - 50,000;63;38;25;0;0;33
1053190;Lover Bands;;0 - 20,000;19;2;17;0;0;0
1053250;TOK HARDCORE;;0 - 20,000;99;6;93;0;0;0
1053300;Archibald 2;;0 - 20,000;2;2;0;0;0;0
1053330;SCRAP RUSH!!;;0 - 20,000;8;2;6;0;0;0
1053390;Kowloon High-School Chronicle;;0 - 20,000;11;1;10;0;0;3
1053560;Saint Hazel's Horsepital;;0 - 20,000;19;4;15;0;0;0
1053620;MIDNIGHT Remastered;;0 - 20,000;11;1;10;0;0;0
1053640;RockaBowling VR;;0 - 20,000;2;0;2;0;0;0
1053650;Drive for Your Life;;0 - 20,000;18;7;11;0;0;0
1053660;Chaos Starter;;20,000 - 50,000;25;21;4;0;0;0
1053680;Granny Simulator;;200,000 - 500,000;3643;347;3296;162;79;25
1053700;Fishy Dungeon Delving;;0 - 20,000;1;0;1;0;0;0
1053710;The Red Lantern;;0 - 20,000;128;18;110;0;0;2
1053720;Knife Only;;0 - 20,000;3;2;1;0;0;0
1053730;Foxyland 2;;0 - 20,000;20;7;13;0;0;0
1053740;Bunker - Nightmare Begins;;0 - 20,000;9;0;9;0;0;0
1053750;The Red Reactor;;0 - 20,000;9;4;5;0;0;0
1053760;Arkio;;0 - 20,000;26;3;23;0;0;0
1053780;Pixel Art Monster - Color by Number;;0 - 20,000;13;3;10;0;0;0
1053820;Eternal Concord;;0 - 20,000;2;0;2;0;0;0
1053830;Ninja Legends;;0 - 20,000;49;3;46;0;0;0
1053850;Last Hope Z - VR;;0 - 20,000;11;8;3;0;0;0
1053870;Ruins to Rumble;;0 - 20,000;10;12;-2;0;0;0
1053920;Emergency Water Landing;;0 - 20,000;4;0;4;0;0;0
1053940;Countermark Saga Frozen sword;;0 - 20,000;26;11;15;0;0;0
1053960;Bot Battles;;20,000 - 50,000;32;11;21;0;0;0
1054030;Hobo Knight;;0 - 20,000;22;6;16;0;0;0
1054040;Warlander;;20,000 - 50,000;38;34;4;0;0;0
1054050;Hero must die. again;;0 - 20,000;26;5;21;0;0;0
1054090;TECHNOSPHERE RELOAD;;20,000 - 50,000;22;3;19;0;0;0
1054110;There The Light;;0 - 20,000;76;23;53;0;0;0
1054150;Fantasy Battles;;0 - 20,000;1;0;1;0;0;0
1054180;Cheeky Beetle And The Unlikely Heroes;;100,000 - 200,000;6;1;5;0;0;0
1054240;Easy puzzle: Animals;;0 - 20,000;11;0;11;0;0;0
1054250;krAsAvA Shot;;0 - 20,000;3;4;-1;0;0;0
1054270;RASHLANDER;;0 - 20,000;42;2;40;0;0;0
1054290;Dezzan;;0 - 20,000;15;15;0;0;0;0
1054300;the fairytale of DEATH;;20,000 - 50,000;15;15;0;0;0;0
1054310;Fade Out;;50,000 - 100,000;7;4;3;0;0;0
1054340;Logic World;;0 - 20,000;233;16;217;4;4;4
1054350;Lost and Hound;;0 - 20,000;32;0;32;0;0;0
1054370;Sandbox Anything;;0 - 20,000;23;9;14;0;0;0
1054430;Fling to the Finish;;50,000 - 100,000;763;131;632;112;126;8
1054450;The Raintime;;0 - 20,000;32;13;19;0;0;0
1054490;Wingspan;;200,000 - 500,000;6206;372;5834;585;385;761
1054500;Ducks in Space;;0 - 20,000;12;0;12;0;0;0
1054510;Survivalist: Invisible Strain;;100,000 - 200,000;2282;304;1978;1344;1482;101
1054520;누가 그녀를 죽였나;;0 - 20,000;0;5;-5;0;0;0
1054550;Phantom Rose;;50,000 - 100,000;583;177;406;422;434;4
1054560;Alice in Stardom - A Free Idol Visual Novel;;0 - 20,000;100;22;78;0;0;0
1054570;SushiVR;;0 - 20,000;1;2;-1;0;0;0
1054580;Easy Cat Timer;;0 - 20,000;157;8;149;0;0;16
1054590;Moonlight Warrior;;0 - 20,000;1;0;1;0;0;0
1054610;Chocolate makes you happy: Easter;;0 - 20,000;17;9;8;0;0;0
1054620;Vengeful Bat Dungeon Crawler;;0 - 20,000;5;3;2;0;0;0
1054640;The Tower of Worth;;0 - 20,000;6;1;5;0;0;0
1054650;JQ: cosmos;;0 - 20,000;22;3;19;0;0;0
1054660;Factory Balls;;0 - 20,000;95;1;94;0;0;0
1054690;Dreadlands;;20,000 - 50,000;120;65;55;328;328;2
1054700;Back To Ashes;;0 - 20,000;70;13;57;0;0;0
1054710;Driven Out;;20,000 - 50,000;189;41;148;0;0;1
1054720;DUMB FIGHT;;0 - 20,000;12;3;9;0;0;0
1054750;Magic Farm 2: Fairy Lands (Premium Edition);;0 - 20,000;26;5;21;0;0;2
1054770;Gear：治愈齿轮;;0 - 20,000;22;3;19;0;0;0
1054790;Elon Must - Road to Respect;;0 - 20,000;33;17;16;0;0;0
1054800;变量 Variables;;100,000 - 200,000;843;129;714;582;727;3
1054850;Storms;;0 - 20,000;2;3;-1;0;0;0
1054900;DevilShaft: TheTower;;0 - 20,000;1;4;-3;0;0;0
1054930;Mine the Gold;;0 - 20,000;28;31;-3;0;0;0
1054980;The Cat and the Box;;0 - 20,000;7;1;6;0;0;0
1054990;Race With Ryan;;0 - 20,000;22;5;17;0;0;0
1055000;EndlessHell;;0 - 20,000;9;10;-1;0;0;0
1055010;Energy Engine PC Live Wallpaper;;50,000 - 100,000;204;129;75;33481;33481;50
1055020;InfinityVR;;0 - 20,000;5;0;5;0;0;0
1055030;Ghoul Britannia: Land of Hope and Gorey;;0 - 20,000;3;1;2;0;0;0
1055090;Embark;;0 - 20,000;238;127;111;0;0;6
1055120;CoronaViruses;;0 - 20,000;0;3;-3;0;0;0
1055150;Eva Reynes;;0 - 20,000;10;4;6;0;0;0
1055170;Sir Lovelot;;0 - 20,000;63;7;56;0;0;0
1055180;Icarus - Prima Regula;;0 - 20,000;3;0;3;0;0;0
1055210;Retrograde Arena;;50,000 - 100,000;393;22;371;13;13;0
1055240;Hollow 2;;0 - 20,000;8;10;-2;0;0;0
1055280;Wizardas;;0 - 20,000;1;0;1;0;0;0
1055310;The Myth Seekers 2: The Sunken City;;0 - 20,000;75;22;53;0;0;2
1055360;Infested Inside Multiplayer Online;;0 - 20,000;1;1;0;0;0;0
1055380;Code S-44: Episode 1;;20,000 - 50,000;64;21;43;0;0;0
1055420;The Highscore;;0 - 20,000;1;1;0;0;0;0
1055430;Swords and Sandals Classic Collection;;100,000 - 200,000;1585;120;1465;237;305;69
1055460;Claw Staff;;0 - 20,000;0;1;-1;0;0;0
1055490;Weed Farmer Simulator;;0 - 20,000;113;75;38;0;0;3
1055540;A Short Hike;;100,000 - 200,000;12503;90;12413;152;136;23
1055610;Deep Space Battle Simulator;;20,000 - 50,000;291;59;232;0;0;1
1055620;Minions Battle;;0 - 20,000;78;22;56;0;0;0
1055660;十日;;20,000 - 50,000;3;3;0;0;0;0
1055660;十日;;20,000 - 50,000;3;3;0;0;0;0
1055690;Awakening: The Dreamless Castle;;0 - 20,000;28;2;26;0;0;0
1055760;Prince Maker美少年梦工厂3：重生;;20,000 - 50,000;263;9;254;0;0;2
1055770;Metal Country;;0 - 20,000;2;1;1;0;0;0
1055780;Plunger Knight - Washers of Truth;;0 - 20,000;4;1;3;0;0;0
1055850;Inspector Waffles;;0 - 20,000;192;12;180;0;0;1
1055870;Siberian Run VR;;20,000 - 50,000;0;1;-1;0;0;0
1055890;Game Of Puzzles: Nature;;0 - 20,000;23;3;20;0;0;0
1055930;The Elemental Heart;;0 - 20,000;0;1;-1;0;0;0
1055940;Sentenced;;0 - 20,000;1;0;1;0;0;0
1055950;Feels;;0 - 20,000;11;0;11;0;0;0
1055960;Thistledown: A Tragedy of Blood;;0 - 20,000;6;0;6;0;0;0
1055970;Argonauts Agency: Pandora's Box;;0 - 20,000;22;1;21;0;0;4
1055990;Erannorth Reborn;;0 - 20,000;302;46;256;403;403;6
1056010;Ne Padai!;;0 - 20,000;15;6;9;0;0;0
1056070;Instinct Rush 本能冲撞;;0 - 20,000;4;1;3;0;0;0
1056080;Epic Adventures: Cursed Onboard;;0 - 20,000;11;10;1;0;0;0
1056140;LOTUS Minigames: Berlin Traffic;;0 - 20,000;9;1;8;0;0;0
1056170;SUPERVERSE;;0 - 20,000;27;13;14;0;0;0
1056180;Cathedral;;20,000 - 50,000;250;65;185;0;0;1
1056230;Medicinal Herbs - Cannabis Grow Simulator;;0 - 20,000;21;7;14;0;0;1
1056280;Grotesque Beauty - A Horror Visual Novel;;0 - 20,000;35;3;32;0;0;0
1056290;Soul Island;;0 - 20,000;12;0;12;0;0;0
1056320;Island Town Zombie Paradise;;0 - 20,000;2;0;2;0;0;0
1056330;L.S.S II;;20,000 - 50,000;9;1;8;0;0;0
1056350;Wizard Warfare;;0 - 20,000;46;1;45;0;0;1
1056390;Ultra Savage;;50,000 - 100,000;333;81;252;0;0;1
1056420;Azure Wing: Rising Gale;;0 - 20,000;6;7;-1;0;0;0
1056480;The Garden Pub;;0 - 20,000;9;4;5;0;0;0
1056490;The World is Your Weapon;;20,000 - 50,000;531;17;514;668;668;11
1056510;Root Letter Last Answer;;0 - 20,000;119;23;96;0;0;1
1056570;TAISHO x ALICE episode 1;;0 - 20,000;698;86;612;0;0;5
1056570;TAISHO x ALICE episode 1;;0 - 20,000;698;86;612;0;0;5
1056580;Family Hidden Secret - Hidden Objects Puzzle Adventure;;0 - 20,000;31;35;-4;0;0;2
1056590;梦乡 The Dreamcatcher;;0 - 20,000;97;17;80;0;0;0
1056600;Home Sweet Home : Survive;;500,000 - 1,000,000;4567;3687;880;520;764;1
1056610;Heal;;50,000 - 100,000;338;63;275;0;0;1
1056640;Phantasy Star Online 2;;2,000,000 - 5,000,000;15119;5824;9295;2551;159;2466
1056650;Haunted Jail: Alcatas;;0 - 20,000;5;4;1;0;0;0
1056660;3x3 mini-Shogi;;0 - 20,000;4;7;-3;0;0;0
1056690;Drink More Glurp;;0 - 20,000;139;18;121;18;28;5
1056710;VTB Basketball League VR;;0 - 20,000;10;1;9;0;0;0
1056720;Knight Club +;;20,000 - 50,000;230;27;203;0;0;2
1056750;Shera and the Three Treasures;;20,000 - 50,000;212;47;165;0;0;5
1056840;Arcanium: Rise of Akhan;;20,000 - 50,000;516;102;414;1459;1459;14
1056960;Wolfenstein: Youngblood;;2,000,000 - 5,000,000;5244;6364;-1120;701;234;95
1056970;Wolfenstein: Cyberpilot;;0 - 20,000;117;138;-21;0;0;0
1057090;Ori and the Will of the Wisps;;2,000,000 - 5,000,000;96397;3471;92926;902;763;1287
1057120;Mahjong Infinity;;0 - 20,000;2;0;2;0;0;0
1057130;Exogen VR;;20,000 - 50,000;37;3;34;0;0;0
1057150;Adventure in King Caries Land;;0 - 20,000;1;1;0;0;0;0
1057180;Border Officer;;50,000 - 100,000;595;431;164;141;174;6
1057220;MIDI RANGER;;0 - 20,000;27;2;25;0;0;0
1057240;Crucible Beta;;2,000,000 - 5,000,000;4715;6250;-1535;179;66;0
1057310;A five-day tour in the morgue;;0 - 20,000;1;6;-5;0;0;0
1057390;The Kaiju Offensive;;0 - 20,000;6;1;5;0;0;0
1057420;Earthshakers;;20,000 - 50,000;18;12;6;0;0;0
1057430;Geometry May. I swear it's a nice free game;;50,000 - 100,000;459;113;346;0;0;0
1057500;Sim 4K VR MediaPlayer;;0 - 20,000;12;6;6;0;0;0
1057540;Cthulhu Saves Christmas;;20,000 - 50,000;203;23;180;337;337;1
1057540;Cthulhu Saves Christmas;;20,000 - 50,000;203;23;180;337;337;1
1057560;Rebound Dodgeball Evolved;;0 - 20,000;5;5;0;0;0;0
1057640;Onirism;;0 - 20,000;267;30;237;0;0;1
1057680;人间 The Lost We Lost;;100,000 - 200,000;2134;100;2034;8995;9044;4
1057700;Battle Grounds III;;200,000 - 500,000;2692;485;2207;0;0;9
1057710;Funny Bunny: Adventures;;0 - 20,000;8;0;8;0;0;0
1057720;Shattered Lights;;100,000 - 200,000;335;41;294;0;0;0
1057730;VRAdventure;;0 - 20,000;0;4;-4;0;0;0
1057740;World Of Conquerors;;20,000 - 50,000;58;35;23;0;0;0
1057750;The Suicide of Rachel Foster;;100,000 - 200,000;3518;1502;2016;349;152;8
1057770;Story of one Night;;0 - 20,000;12;10;2;0;0;0
1057780;Jump Off The Bridge;;20,000 - 50,000;184;23;161;126;126;3
1057800;Floppy Knights;;0 - 20,000;176;28;148;0;0;3
1057850;Neon Boost;;200,000 - 500,000;2231;243;1988;0;0;2
1057980;Radiant Arc;;0 - 20,000;21;0;21;0;0;0
1057990;Viking Trickshot;;100,000 - 200,000;50;6;44;0;0;0
1058020;STAR WARS Battlefront (Classic, 2004);;2,000,000 - 5,000,000;3290;120;3170;173;187;114
1058060;Princesses Never Lose!;;20,000 - 50,000;316;60;256;123;151;7
1058060;Princesses Never Lose!;;20,000 - 50,000;316;60;256;123;151;7
1058110;Metro Trip Simulator;;0 - 20,000;37;30;7;0;0;0
1058130;Queen's Wish: The Conqueror;;100,000 - 200,000;276;52;224;299;299;7
1058140;Yumeutsutsu Re:Master;;0 - 20,000;263;23;240;0;0;3
1058150;Twinkle Star - 未来はすぐそこで待っている;;0 - 20,000;4;5;-1;0;0;0
1058200;Pixel Puzzles Traditional Jigsaws;;100,000 - 200,000;262;85;177;185;186;22
1058210;Pixel Puzzles 2: Halloween;;0 - 20,000;8;5;3;0;0;0
1058220;Emoji TD;;0 - 20,000;7;0;7;0;0;0
1058270;Inn Legend;;20,000 - 50,000;217;32;185;252;252;2
1058280;Speed Limit;;0 - 20,000;149;21;128;0;0;1
1058320;Toki;;20,000 - 50,000;342;45;297;9;16;2
1058330;Fort Boyard;;0 - 20,000;28;29;-1;0;0;0
1058350;Nyasha Land of Elves;;0 - 20,000;54;17;37;0;0;0
1058370;Bone Voyage;;50,000 - 100,000;231;117;114;0;0;0
1058380;Streamer Daily;;200,000 - 500,000;883;121;762;689;689;0
1058430;A Legionary's Life;;50,000 - 100,000;1615;256;1359;50;50;17
1058450;MY HERO ONE'S JUSTICE 2;;50,000 - 100,000;2468;317;2151;351;476;47
1058470;Beyond a Total Loss;;0 - 20,000;22;0;22;0;0;0
1058490;Hobo Living VR;;0 - 20,000;2;13;-11;0;0;0
1058500;Muscle Car Robot;;0 - 20,000;20;17;3;0;0;0
1058510;Zunius;;0 - 20,000;9;0;9;0;0;0
1058530;H-Rescue;;20,000 - 50,000;385;113;272;124;124;0
1058550;Rainbow Hunter;;0 - 20,000;15;1;14;0;0;0
1058560;Deathbloom: Chapter 1;;0 - 20,000;75;11;64;0;0;0
1058570;Ride with The Reaper;;0 - 20,000;6;0;6;0;0;0
1058590;Franchise Wars;;20,000 - 50,000;11;1;10;0;0;0
1058630;Crazy Ball;;20,000 - 50,000;6;2;4;0;0;0
1058640;RED HOT VENGEANCE;;200,000 - 500,000;2731;102;2629;0;0;5
1058650;Beyond The Wire;;100,000 - 200,000;4588;2197;2391;131;185;15
1058660;ArchMMO 2;;0 - 20,000;6;11;-5;0;0;0
1058680;VR Emergency Response Sim;;0 - 20,000;2;3;-1;0;0;0
1058690;Signs of the Sojourner;;0 - 20,000;141;19;122;0;0;0
1058710;Medieval Monarch;;20,000 - 50,000;230;55;175;0;0;1
1058730;Pirates Are BLANKing Awesome;;0 - 20,000;0;1;-1;0;0;0
1058740;AntQueen 3D;;0 - 20,000;47;17;30;0;0;1
1058750;无奇刀 Wookie's Blade;;0 - 20,000;12;0;12;0;0;0
1058760;Tiger Tank 59 Ⅰ Rainstorm;;0 - 20,000;1;2;-1;0;0;0
1058770;我来自江湖 From Jianghu;;50,000 - 100,000;1581;418;1163;5029;6849;95
1058800;Miner's Mettle;;0 - 20,000;41;22;19;0;0;0
1058830;Spin Rhythm XD;;100,000 - 200,000;2594;82;2512;316;493;23
1058840;Super Web Kittens: Act I;;20,000 - 50,000;6;1;5;0;0;0
1058930;Top Burger;;0 - 20,000;40;18;22;0;0;1
1058940;Treasure Masters, Inc.: The Lost City;;0 - 20,000;3;4;-1;0;0;1
1058980;Dinosaur Bone Digging;;0 - 20,000;18;18;0;0;0;0
1058990;MissionMaker;;0 - 20,000;7;3;4;0;0;0
1059040;Grunt1914;;0 - 20,000;23;16;7;0;0;0
1059080;ROAD HOMEWARD 2: river trip;;0 - 20,000;6;7;-1;0;0;0
1059090;The Underground Watcher/地下监察员;;0 - 20,000;35;2;33;0;0;0
1059120;Kinoko;;100,000 - 200,000;830;151;679;0;0;1
1059150;Ritual: Crown of Horns;;0 - 20,000;37;12;25;0;0;0
1059160;Deep Race: Space;;0 - 20,000;19;16;3;0;0;0
1059190;Skully Pinball;;0 - 20,000;12;14;-2;0;0;0
1059230;When I Was Young;;0 - 20,000;90;33;57;0;0;1
1059240;Room 208;;0 - 20,000;9;9;0;0;0;0
1059260;Data mining 0;;0 - 20,000;5;5;0;0;0;0
1059280;The Renovator;;0 - 20,000;60;28;32;0;0;0
1059300;Gravitura;;0 - 20,000;7;0;7;0;0;0
1059310;Herald of the Depths;;0 - 20,000;4;1;3;0;0;0
1059320;Hocus Potions;;0 - 20,000;3;4;-1;0;0;0
1059370;IMPALE YOUR FRIENDS!;;0 - 20,000;4;0;4;0;0;0
1059420;5Leaps (Space Tower Defense);;0 - 20,000;23;0;23;0;0;0
1059460;Drunken Fist ;;0 - 20,000;49;13;36;0;0;0
1059460;Drunken Fist ;;0 - 20,000;49;13;36;0;0;0
1059470;Wolfgate;;0 - 20,000;1;0;1;0;0;0
1059470;Wolfgate;;0 - 20,000;1;0;1;0;0;0
1059500;PUZZLE: OCEAN;;0 - 20,000;10;5;5;0;0;0
1059500;PUZZLE: OCEAN;;0 - 20,000;10;5;5;0;0;0
1059620;Mystery Trackers: Winterpoint Tragedy Collector's Edition;;0 - 20,000;3;4;-1;0;0;1
1059640;Deepsea Salvor;;0 - 20,000;4;0;4;0;0;0
1059660;Life Combinations;;0 - 20,000;4;1;3;0;0;0
1059690;Make Route: Escape the police;;0 - 20,000;6;3;3;0;0;0
1059710;New Yankee 6: In Pharaoh's Court;;0 - 20,000;7;0;7;0;0;3
1059740;Gunslingers & Zombies;;0 - 20,000;18;5;13;0;0;0
1059760;Sicier's Zweck;;0 - 20,000;2;0;2;0;0;0
1059830;Magic Encyclopedia: Moon Light;;0 - 20,000;18;19;-1;0;0;0
1059840;Continuum;;0 - 20,000;9;3;6;0;0;0
1059850;Vain Riser;;0 - 20,000;70;24;46;0;0;1
1059860;打击者打字游戏集（Striker A Type Game Pack）;;0 - 20,000;5;3;2;0;0;0
1059880;Devious Dungeon;;20,000 - 50,000;300;63;237;0;0;0
1059890;Devious Dungeon 2;;0 - 20,000;61;14;47;0;0;0
1059980;Just King;;20,000 - 50,000;898;71;827;260;325;37
1059980;Just King;;20,000 - 50,000;898;71;827;260;325;37
1060000;Only After;;0 - 20,000;8;0;8;0;0;0
1060020;Boxwrecker Arena;;0 - 20,000;1;0;1;0;0;0
1060060;GOLF in PAPER;;0 - 20,000;4;6;-2;0;0;0
1060110;Space Trade Fleet 1.5;;0 - 20,000;0;4;-4;0;0;0
1060160;Not Dead Yet;;0 - 20,000;30;8;22;0;0;0
1060170;Azurael's Circle: Chapter 4;;0 - 20,000;9;1;8;0;0;0
1060180;Cyber Driver;;0 - 20,000;121;25;96;0;0;0
1060210;Disaster Report 4: Summer Memories;;20,000 - 50,000;273;112;161;0;0;2
1060220;Langrisser I & II;;20,000 - 50,000;502;163;339;249;249;16
1060230;Sapiens;;50,000 - 100,000;1144;194;950;396;692;77
1060240;Rumia in the darkness;;0 - 20,000;29;6;23;0;0;0
1060300;Homeless Simulator;;20,000 - 50,000;131;106;25;0;0;0
1060310;Great Toilet Simulator;;0 - 20,000;334;82;252;0;0;0
1060320;One Drop Bot;;100,000 - 200,000;93;302;-209;0;0;1
1060350;War of the Seraphim;;0 - 20,000;1;0;1;0;0;0
1060360;血腥之日228-Vampire Martina-Bloody Day 2.28;;0 - 20,000;11;3;8;0;0;0
1060370;Crazy space pirate;;0 - 20,000;6;5;1;0;0;0
1060380;Slime Adventure 2;;0 - 20,000;7;6;1;0;0;0
1060400;Mystic RUS-files;;0 - 20,000;4;4;0;0;0;0
1060450;Sky Shepherd;;0 - 20,000;18;6;12;0;0;0
1060450;Sky Shepherd;;0 - 20,000;18;6;12;0;0;0
1060460;Apollo 17 - Moonbuggy VR;;0 - 20,000;8;1;7;0;0;0
1060470;Global Infection;;0 - 20,000;2;5;-3;0;0;0
1060510;Heaven's Voice Feast of Famine;;0 - 20,000;3;0;3;0;0;0
1060550;LETHAL STRIKE;;0 - 20,000;2;0;2;0;0;0
1060560;GNRBLEX;;0 - 20,000;7;1;6;0;0;0
1060600;Lair of the Clockwork God;;20,000 - 50,000;644;35;609;0;0;0
1060630;ぶんまわしヒーロー / Full Swing Hero;;20,000 - 50,000;58;9;49;0;0;0
1060670;Taboos: Cracks;;100,000 - 200,000;1293;337;956;35;11;2
1060690;Mission XAM;;0 - 20,000;1;5;-4;0;0;0
1060770;Die, zombie sausage, die!;;0 - 20,000;14;5;9;0;0;0
1060810;The Sphere of Abyss;;0 - 20,000;27;6;21;0;0;1
1060820;DanCop - Daniela on Duty;;0 - 20,000;9;1;8;0;0;0
1060840;Maze of Memories;;0 - 20,000;1;0;1;0;0;0
1060870;Hello, World.;;0 - 20,000;4;0;4;0;0;0
1060890;Get Out;;0 - 20,000;2;2;0;0;0;0
1060980;Scooter Delivery VR;;0 - 20,000;4;2;2;0;0;0
1061010;深海：即刻抉择;;50,000 - 100,000;279;350;-71;57;57;0
1061090;Jump King;;500,000 - 1,000,000;8546;907;7639;397;232;127
1061100;Hunter's Arena: Legends;;50,000 - 100,000;780;529;251;0;0;0
1061120;Summer Resort Mogul;;0 - 20,000;3;1;2;0;0;0
1061150;Muscle Magic;;20,000 - 50,000;39;4;35;0;0;1
1061160;Orc Raid;;0 - 20,000;17;8;9;0;0;0
1061180;Crumble;;20,000 - 50,000;534;56;478;154;215;3
1061200;DomiDo;;0 - 20,000;2;0;2;0;0;0
1061220;Discontinue;;0 - 20,000;11;6;5;0;0;0
1061240;Quiet Sleep;;0 - 20,000;8;18;-10;0;0;0
1061250;时间旅者(TimeWalker);;0 - 20,000;7;9;-2;0;0;0
1061260;Click Space Miner 2;;20,000 - 50,000;13;39;-26;0;0;0
1061270;Blacklist Brigade;;0 - 20,000;29;4;25;0;0;0
1061300;Surprising My Neighbors;;0 - 20,000;36;14;22;0;0;0
1061360;Time Loop Fighter;;0 - 20,000;4;0;4;0;0;0
1061390;Block Run;;0 - 20,000;3;0;3;0;0;0
1061420;Obscure Doubt;;0 - 20,000;3;0;3;0;0;0
1061430;Adagio;;0 - 20,000;8;6;2;0;0;0
1061470;Nyasha Valkyrie;;0 - 20,000;55;11;44;0;0;1
1061540;Mystery of the Ancients: Three Guardians Collector's Edition;;0 - 20,000;15;0;15;0;0;0
1061550;Sneak In: a sphere matcher game;;0 - 20,000;10;0;10;0;0;1
1061600;Dodge the Wall!;;20,000 - 50,000;18;6;12;0;0;0
1061610;Tenderfoot Tactics;;0 - 20,000;174;32;142;0;0;2
1061620;Galaxy in Peril;;0 - 20,000;3;3;0;0;0;0
1061640;How To Be A Real Dude;;0 - 20,000;28;37;-9;0;0;0
1061650;Idle Portal Guardian;;0 - 20,000;2;4;-2;0;0;0
1061680;Angela's Odyssey;;0 - 20,000;24;8;16;0;0;0
1061690;CameraBag Pro;;0 - 20,000;18;3;15;0;0;0
1061730;Super Monkey Ball: Banana Blitz HD;;20,000 - 50,000;186;137;49;0;0;0
1061790;Chopper To Hell;;0 - 20,000;1;2;-1;0;0;0
1061820;XMusicVisualizer;;20,000 - 50,000;30;47;-17;0;0;0
1061850;Hotel Mogul: Las Vegas;;0 - 20,000;5;1;4;0;0;1
1061880;Conan Chop Chop;;100,000 - 200,000;357;192;165;2431;4501;29
1061900;ThunderGod;;0 - 20,000;11;3;8;0;0;0
1061910;Metal: Hellsinger;;500,000 - 1,000,000;8237;219;8018;262;319;67
1061970;Great Ball of Fire;;0 - 20,000;8;6;2;0;0;0
1062000;Starmancer;;20,000 - 50,000;507;294;213;8;8;16
1062020;Who Are You, Mr. Cooper?;;0 - 20,000;9;4;5;0;0;0
1062040;Dragon Star Varnir;;20,000 - 50,000;369;78;291;100;100;6
1062050;Secrets of War;;0 - 20,000;0;1;-1;0;0;0
1062060;Rhome;;0 - 20,000;581;68;513;0;0;2
1062070;Tex-Mechs;;20,000 - 50,000;169;15;154;0;0;0
1062080;Goofballs;;0 - 20,000;27;3;24;0;0;0
1062090;Timberborn;;500,000 - 1,000,000;15964;952;15012;2738;1398;2135
1062100;HaberDashers;;50,000 - 100,000;52;26;26;0;0;0
1062110;UNSIGHTED;;20,000 - 50,000;1056;61;995;1261;1261;36
1062120;Peas Adventure;;0 - 20,000;4;2;2;0;0;0
1062130;Gun Skaters;;0 - 20,000;9;2;7;0;0;0
1062140;Garden Story;;50,000 - 100,000;671;58;613;207;207;15
1062160;Poly Bridge 2;;200,000 - 500,000;5785;269;5516;384;225;176
1062200;大时代：三国立志;;0 - 20,000;10;19;-9;0;0;0
1062210;Spikes Are Dangerous;;0 - 20,000;0;2;-2;0;0;0
1062240;地铁：恐怖末班车;;0 - 20,000;1;6;-5;0;0;0
1062260;末法仙路;;0 - 20,000;30;39;-9;0;0;0
1062340;KATANA KAMI: A Way of the Samurai Story;;20,000 - 50,000;187;129;58;0;0;18
1062340;KATANA KAMI: A Way of the Samurai Story;;20,000 - 50,000;187;129;58;0;0;18
1062390;Triangle Mania;;0 - 20,000;3;0;3;0;0;0
1062410;Nekoland Studio;;0 - 20,000;12;3;9;0;0;0
1062470;Frank & the TimeTwister Machine;;0 - 20,000;4;2;2;0;0;0
1062480;Songs of Skydale;;0 - 20,000;17;8;9;0;0;0
1062520;Dinkum;;500,000 - 1,000,000;13658;698;12960;1241;508;2642
1062530;Obsidian Crown;;0 - 20,000;1;1;0;0;0;0
1062540;PUZZLETIME: Lovely Girls;;0 - 20,000;23;2;21;0;0;0
1062550;Suicide For Him;;0 - 20,000;18;2;16;0;0;0
1062660;Ortolan;;0 - 20,000;4;3;1;0;0;0
1062670;Blacksmith Run;;0 - 20,000;19;8;11;0;0;0
1062680;Crystallo;;0 - 20,000;2;0;2;0;0;0
1062830;Embr;;50,000 - 100,000;1121;170;951;551;436;15
1062850;Sage Mountain;;0 - 20,000;1;3;-2;0;0;0
1062960;Under the Sand REDUX - a road trip game;;50,000 - 100,000;704;318;386;133;133;63
1063020;Elemental War 2;;0 - 20,000;12;6;6;0;0;1
1063040;Ben 10: Power Trip;;0 - 20,000;147;24;123;0;0;2
1063050;Lumina;;0 - 20,000;19;6;13;0;0;0
1063060;MonteCube Dodge;;0 - 20,000;2;0;2;0;0;0
1063070;Body Discovery;;20,000 - 50,000;3;0;3;0;0;0
1063080;Genius! NAZI-GIRL GoePPels-Chan ep2;;0 - 20,000;17;0;17;0;0;0
1063100;Re[Map];;0 - 20,000;5;0;5;0;0;0
1063110;The Nine Lives of Nim: Fortune's Fool;;0 - 20,000;7;0;7;0;0;0
1063110;The Nine Lives of Nim: Fortune's Fool;;0 - 20,000;7;0;7;0;0;0
1063120;Damaged In Transit;;0 - 20,000;12;0;12;0;0;0
1063140;Under Spire 尖塔自走棋;;0 - 20,000;3;0;3;0;0;0
1063160;The Legends of Class one 嗨哥一班大冒险;;0 - 20,000;6;6;0;0;0;0
1063210;Narazumono;;0 - 20,000;1;2;-1;0;0;0
1063220;ChessBase 15 Steam Edition;;0 - 20,000;10;3;7;0;0;0
1063230;6120;;0 - 20,000;14;18;-4;0;0;0
1063240;Tusker's Number Adventure [Malware Detected];;0 - 20,000;28;9;19;0;0;0
1063280;Combat Helicopter- Surgical Strike;;0 - 20,000;4;2;2;0;0;0
1063300;Chipmunk's Adventures;;0 - 20,000;12;3;9;0;0;0
1063310;Vane;;;;;0;;;
1063330;麻神消消乐;;0 - 20,000;3;3;0;0;0;0
1063340;灵幻先生 : 致敬一代僵尸道长！The Exorcist;;0 - 20,000;6;2;4;0;0;0
1063350;Viking Brothers 5;;0 - 20,000;15;1;14;0;0;0
1063360;Necronomistore Classic;;0 - 20,000;3;0;3;0;0;1
1063440;Homeless Simulator 2;;0 - 20,000;30;38;-8;0;0;0
1063440;Homeless Simulator 2;;0 - 20,000;30;38;-8;0;0;0
1063470;Ski Jumping Pro VR;;0 - 20,000;13;9;4;0;0;0
1063490;Still There;;50,000 - 100,000;927;122;805;217;300;2
1063500;Shield of Shalwend;;0 - 20,000;2;1;1;0;0;0
1063520;Universal Character Generator;;0 - 20,000;10;2;8;0;0;0
1063530;Cartoon Network Journeys VR;;0 - 20,000;108;8;100;0;0;4
1063540;Space Wreck;;0 - 20,000;59;6;53;0;0;1
1063560;12 HOURS;;0 - 20,000;40;27;13;0;0;0
1063560;12 HOURS;;0 - 20,000;40;27;13;0;0;0
1063570;Dino Lost;;0 - 20,000;1;0;1;0;0;0
1063580;Aeon's End;;0 - 20,000;265;55;210;0;0;4
1063580;Aeon's End;;0 - 20,000;265;55;210;0;0;4
1063660;Bendy and the Dark Revival;;100,000 - 200,000;6622;305;6317;325;389;161
1063710;Tubetastic: World Splashfest;;0 - 20,000;14;1;13;0;0;0
1063730;New World;;50,000,000 - 100,000,000;175521;75739;99782;10672;3607;23733
1063770;Pew Dew Redemption;;100,000 - 200,000;1405;269;1136;0;0;0
1063790;Citizen of Rome - Dynasty Ascendant;;50,000 - 100,000;153;37;116;4616;4616;4
1063820;疯狂西部/INSANE WEST;;0 - 20,000;15;0;15;0;0;0
1063830;Dreadborne Drifters;;0 - 20,000;40;5;35;0;0;0
1063850;Jinxed;;0 - 20,000;7;6;1;0;0;0
1063870;Solstice;;0 - 20,000;3;1;2;0;0;0
1063890;Fat Dude Simulator;;0 - 20,000;68;29;39;0;0;0
1063890;Fat Dude Simulator;;0 - 20,000;68;29;39;0;0;0
1063910;四圣传说之黑暗森林;;0 - 20,000;30;7;23;0;0;0
1063930;The Purge Man;;0 - 20,000;16;20;-4;0;0;0
1063950;SUPER RECOILFIGHT;;20,000 - 50,000;76;23;53;0;0;0
1063960;Ritual: Sorcerer Angel;;0 - 20,000;22;2;20;0;0;0
1063980;Hell Architect;;20,000 - 50,000;258;95;163;0;0;3
1063990;Tank Battle Heroes: Esports War;;0 - 20,000;9;3;6;0;0;0
1064010;Escape until Friday;;0 - 20,000;148;27;121;0;0;0
1064030;King of the Cul-De-Sac;;0 - 20,000;41;4;37;0;0;0
1064050;Rick Rack;;0 - 20,000;3;1;2;0;0;0
1064060;The Mystery of Bikini Island;;0 - 20,000;29;21;8;0;0;0
1064080;Rhythm Defender;;0 - 20,000;14;3;11;0;0;0
1064090;Lawnmower Game 4: The Final Cut;;0 - 20,000;32;12;20;0;0;0
1064100;Krakout challenge;;20,000 - 50,000;2;1;1;0;0;0
1064130;Sakura MMO 3;;0 - 20,000;144;12;132;55;86;1
1064150;Late City Riders;;20,000 - 50,000;75;11;64;0;0;0
1064150;Late City Riders;;20,000 - 50,000;75;11;64;0;0;0
1064160;Holoception;;0 - 20,000;34;21;13;0;0;0
1064170;Avast Ye;;0 - 20,000;15;13;2;0;0;0
1064200;Brewer;;0 - 20,000;45;12;33;0;0;1
1064310;A Place for the Unwilling;;0 - 20,000;47;16;31;0;0;0
1064320;Ferret Scoundrels;;0 - 20,000;11;3;8;0;0;0
1064340;Chess Evolved Online;;50,000 - 100,000;515;40;475;0;0;33
1064360;Beatcrash;;0 - 20,000;5;0;5;0;0;0
1064420;Phucker in the Gulag;;0 - 20,000;187;16;171;0;0;0
1064440;Xiu's SuperMarket;;0 - 20,000;1;1;0;0;0;0
1064450;BL00;;0 - 20,000;1;0;1;0;0;0
1064460;Murder House;;50,000 - 100,000;1549;57;1492;57;77;6
1064480;Deadly Path;;0 - 20,000;2;0;2;0;0;0
1064520;Helm Realm;;0 - 20,000;2;0;2;0;0;0
1064540;Puzzle Pelago - A Drag & Drop Economy;;0 - 20,000;29;3;26;0;0;0
1064580;CaptainMarlene;;0 - 20,000;15;4;11;0;0;0
1064590;BAX;;0 - 20,000;27;5;22;0;0;0
1064600;BattleSteam;;0 - 20,000;13;9;4;0;0;2
1064610;Neon Beats;;500,000 - 1,000,000;5843;227;5616;45;23;5
1064620;Forest of Evil;;0 - 20,000;1;0;1;0;0;0
1064650;Rogue Slash;;0 - 20,000;2;2;0;0;0;0
1064660;The Death of Erin Myers;;20,000 - 50,000;109;27;82;0;0;0
1064670;Pathos;;0 - 20,000;41;12;29;0;0;0
1064690;Danger Crew;;0 - 20,000;43;0;43;0;0;0
1064710;Wrath of the Samurai;;0 - 20,000;1;2;-1;0;0;0
1064730;Fantasy Girl;;100,000 - 200,000;4723;227;4496;15;17;2
1064750;Space Tower;;20,000 - 50,000;0;1;-1;0;0;0
1064840;Tamarin;;0 - 20,000;66;43;23;0;0;0
1064860;约拍女神 Private Model;;0 - 20,000;85;73;12;0;0;1
1064900;Buzludzha VR;;0 - 20,000;42;3;39;0;0;0
1064910;Flyeeex;;0 - 20,000;14;4;10;0;0;0
1064920;VR Party Pack;;0 - 20,000;1;0;1;0;0;0
1064930;Divine D.I.V.A.;;20,000 - 50,000;2;1;1;0;0;0
1064950;Fluid Lander - フリュードランダー;;0 - 20,000;168;6;162;0;0;0
1064960;The Legion: FringeBound;;0 - 20,000;1;0;1;0;0;0
1064990;Thunder Paw;;0 - 20,000;30;11;19;0;0;0
1065020;Micro Mages;;0 - 20,000;304;15;289;1;1;2
1065030;模拟家装修;;0 - 20,000;2;7;-5;0;0;0
1065050;Gunship Recon;;0 - 20,000;1;2;-1;0;0;0
1065100;Golden Treasure: The Great Green;;0 - 20,000;415;18;397;73;73;3
1065100;Golden Treasure: The Great Green;;0 - 20,000;415;18;397;73;73;3
1065110;Homeward Duck;;0 - 20,000;22;2;20;0;0;0
1065160;Deatherem;;0 - 20,000;3;12;-9;0;0;0
1065180;Azure Striker Gunvolt 2;;0 - 20,000;386;29;357;0;0;6
1065200;Visitor2 / 来访者2;;0 - 20,000;132;41;91;0;0;0
1065210;ZIC: Survival;;0 - 20,000;31;12;19;0;0;0
1065230;Room of Pandora;;20,000 - 50,000;31;14;17;0;0;0
1065250;第四空间Fourth Space;;0 - 20,000;6;2;4;0;0;0
1065260;GENSOU Skydrift;;20,000 - 50,000;506;60;446;79;80;8
1065310;Evil West;;200,000 - 500,000;3501;1111;2390;334;422;125
1065320;REKT! High Octane Stunts;;0 - 20,000;86;5;81;0;0;1
1065390;Virtual Hero VR;;20,000 - 50,000;42;20;22;0;0;0
1065410;That's Pretty Clever;;0 - 20,000;11;2;9;0;0;0
1065460;ReThink | Evolved 3;;0 - 20,000;23;1;22;0;0;1
1065520;Autobahn Police Simulator 3;;0 - 20,000;98;126;-28;0;0;20
1065550;Block Busters;;0 - 20,000;19;8;11;0;0;0
1065570;Cyber Gun;;0 - 20,000;48;25;23;0;0;0
1065580;Castle Woodwarf 2;;0 - 20,000;55;18;37;0;0;0
1065630;Beats Warrior: Nian;;0 - 20,000;37;7;30;0;0;0
1065650;Super Star Blast;;0 - 20,000;2;1;1;0;0;0
1065670;4004-022;;0 - 20,000;7;15;-8;0;0;0
1065680;The Chronicles of King Arthur: Episode 2 - Knights of the Round Table;;0 - 20,000;14;3;11;0;0;0
1065680;The Chronicles of King Arthur: Episode 2 - Knights of the Round Table;;0 - 20,000;14;3;11;0;0;0
1065690;Peku - Space Dragon;;0 - 20,000;2;0;2;0;0;0
1065710;ClassiCube;;0 - 20,000;85;12;73;0;0;0
1065750;Spark and The Digital Daydream;;0 - 20,000;59;4;55;0;0;0
1065770;Home A Drone;;0 - 20,000;6;1;5;0;0;0
1065780;Run Gun Die Ultimate;;0 - 20,000;2;1;1;0;0;0
1065830;FORGOTTEN IN HELL;;0 - 20,000;7;7;0;0;0;0
1065850;Giant Bear Rampage! ☢️;;0 - 20,000;34;0;34;0;0;1
1065870;BRG's Alice in Wonderland Visual Novel;;0 - 20,000;1;0;1;0;0;0
1065880;Dungeon Scavenger;;0 - 20,000;97;5;92;0;0;1
1065890;LOGistICAL 2: France;;0 - 20,000;8;1;7;0;0;0
1065920;DoomAI;;0 - 20,000;49;11;38;0;0;0
1065930;Prototype-CUBE;;0 - 20,000;2;1;1;0;0;0
1065940;Country Girl Keiko;;20,000 - 50,000;161;52;109;0;0;1
1065950;Cage of the Succubi;;0 - 20,000;85;47;38;0;0;1
1065960;狼人杀单机版;;0 - 20,000;14;10;4;0;0;1
1065970;狼と香辛料VR/Spice&WolfVR;;50,000 - 100,000;972;71;901;0;0;3
1066010;Herakles and the Princess of Troy;;0 - 20,000;4;0;4;0;0;0
1066030;Heroland;;0 - 20,000;12;5;7;0;0;0
1066040;Simple Dot;;0 - 20,000;23;1;22;0;0;0
1066090;守护未来 GUARD THE FUTURE;;0 - 20,000;15;10;5;0;0;0
1066110;Room Planner - Design Home 3D - Pro;;0 - 20,000;78;27;51;0;0;21
1066130;Truck Life;;20,000 - 50,000;865;605;260;0;0;5
1066140;Now You See - A Hand Painted Horror Adventure;;0 - 20,000;129;27;102;0;0;0
1066180;Crisis Brigade 2 reloaded;;0 - 20,000;219;42;177;0;0;6
1066200;The Brink 尘与土;;0 - 20,000;12;5;7;0;0;0
1066210;Soviet Souls;;0 - 20,000;9;4;5;0;0;0
1066230;Project Katharsis;;20,000 - 50,000;18;13;5;0;0;0
1066240;Tankex;;0 - 20,000;44;15;29;0;0;0
1066260;Devolver Bootleg;;50,000 - 100,000;955;111;844;9;10;2
1066290;猎魔者战纪;;0 - 20,000;82;15;67;0;0;1
1066310;OFFSIDE;;0 - 20,000;14;1;13;0;0;0
1066400;Doctor Who: The Runaway;;0 - 20,000;124;21;103;0;0;0
1066420;Clodhoppers;;0 - 20,000;45;2;43;0;0;5
1066430;Kwaidan ～Azuma manor story～;;0 - 20,000;32;10;22;0;0;0
1066440;Yggdrasil;;0 - 20,000;0;3;-3;0;0;0
1066460;The Firelord;;0 - 20,000;23;4;19;0;0;0
1066470;Dextram;;0 - 20,000;14;0;14;0;0;0
1066490;Linklight;;0 - 20,000;26;0;26;0;0;0
1066600;Criss Cross;;0 - 20,000;90;101;-11;0;0;0
1066620;Bugs 'N Boo Hags;;0 - 20,000;2;0;2;0;0;0
1066630;Master Magistrate;;0 - 20,000;120;13;107;0;0;0
1066670;PULSOR;;0 - 20,000;18;7;11;0;0;0
1066670;PULSOR;;0 - 20,000;18;7;11;0;0;0
1066680;Fleet Commander: Pacific;;0 - 20,000;10;1;9;0;0;0
1066700;New Yankee 7: Deer Hunters;;0 - 20,000;10;1;9;0;0;0
1066730;PARTY BINGO;;0 - 20,000;0;1;-1;0;0;0
1066760;Moonshine Inc.;;20,000 - 50,000;70;39;31;0;0;4
1066780;Transport Fever 2;;500,000 - 1,000,000;17300;2119;15181;3883;1725;4416
1066810;Forge and Fight!;;0 - 20,000;47;13;34;0;0;0
1066840;R_sin;;0 - 20,000;1;1;0;0;0;0
1066860;RPG Paper Maker;;20,000 - 50,000;109;21;88;0;0;3
1066890;Automobilista 2;;200,000 - 500,000;5244;555;4689;690;810;588
1066930;Eternal Elements;;0 - 20,000;1;0;1;0;0;0
1066940;They Came From the Sky;;0 - 20,000;54;2;52;0;0;0
1066940;They Came From the Sky;;0 - 20,000;54;2;52;0;0;0
1067030;Meta Revelations - Ring Spirits;;0 - 20,000;18;6;12;0;0;0
1067030;Meta Revelations - Ring Spirits;;0 - 20,000;18;6;12;0;0;0
1067040;Four Seals;;0 - 20,000;1;1;0;0;0;0
1067050;Deep Dungeon: Gym;;0 - 20,000;9;2;7;0;0;0
1067080;BH Trials;;0 - 20,000;16;1;15;0;0;0
1067100;Smart Gecko;;0 - 20,000;2;2;0;0;0;1
1067110;Idle Chess Story;;20,000 - 50,000;25;23;2;0;0;0
1067200;Plagueworld;;0 - 20,000;29;21;8;0;0;0
1067220;RoboCo;;0 - 20,000;89;5;84;403;403;5
1067250;Dead Castle / 不思议魔城;;0 - 20,000;5;17;-12;0;0;0
1067280;ReflexShot;;0 - 20,000;5;1;4;0;0;0
1067310;Gravitas;;200,000 - 500,000;5864;117;5747;0;0;6
1067350;Sophie's Dice;;0 - 20,000;105;2;103;0;0;5
1067370;Achievement Machine: Cubic Chaos;;0 - 20,000;3;1;2;0;0;0
1067380;Tiny World;;0 - 20,000;1;0;1;0;0;0
1067390;Churchgoers;;0 - 20,000;6;0;6;0;0;0
1067400;Drawn Down;;0 - 20,000;12;3;9;0;0;0
1067410;El Remedio de Aldorf;;0 - 20,000;2;1;1;0;0;0
1067430;Beam;;0 - 20,000;53;5;48;0;0;0
1067440;RollingSky2;;0 - 20,000;87;3;84;0;0;3
1067450;Never Let Me Awake;;0 - 20,000;6;6;0;0;0;0
1067460;The Tower;;0 - 20,000;0;2;-2;0;0;0
1067520;Call of Otechestvo Donbass;;0 - 20,000;21;7;14;0;0;0
1067540;Röki;;100,000 - 200,000;1952;187;1765;750;1058;22
1067580;Bonfire;;0 - 20,000;25;6;19;0;0;0
1067600;The Defender: Farm and Castle;;200,000 - 500,000;913;107;806;0;0;4
1067700;Muspell;;0 - 20,000;1;1;0;0;0;0
1067720;Hellsinker.;;0 - 20,000;159;19;140;0;0;3
1067730;Digital Rose;;0 - 20,000;0;1;-1;0;0;0
1067760;Gallic Wars: Battle Simulator;;0 - 20,000;12;13;-1;0;0;0
1067810;First Day;;50,000 - 100,000;28;22;6;0;0;2
1067850;Kindergarten 2;;100,000 - 200,000;3134;65;3069;467;679;55
1067860;NewCity;;20,000 - 50,000;297;111;186;0;0;2
1067900;HOME;;200,000 - 500,000;2992;326;2666;0;0;1
1067930;this was for you.;;0 - 20,000;106;14;92;0;0;0
1068100;Vinios;;0 - 20,000;1;3;-2;0;0;0
1068110;MPaliens;;0 - 20,000;9;1;8;0;0;0
1068120;CrunchTime;;0 - 20,000;13;2;11;0;0;0
1068130;Hippo eating banana;;20,000 - 50,000;3;7;-4;0;0;0
1068190;重生轮回/Reborn Not Again;;0 - 20,000;1;0;1;0;0;0
1068210;The Maze VR;;0 - 20,000;5;5;0;0;0;0
1068230;Forestation: Circles Of Nature;;0 - 20,000;2;3;-1;0;0;0
1068230;Forestation: Circles Of Nature;;0 - 20,000;2;3;-1;0;0;0
1068340;THE RITUAL (Indie Horror Game);;0 - 20,000;5;3;2;0;0;0
1068350;Battle Life Online;;0 - 20,000;4;15;-11;0;0;0
1068360;Fearmonium;;0 - 20,000;268;33;235;0;0;4
1068420;Iceroyds!;;0 - 20,000;2;0;2;0;0;0
1068480;Eldarune: Tides of Existence;;0 - 20,000;11;3;8;0;0;0
1068490;Peanut;;0 - 20,000;6;7;-1;0;0;0
1068490;Peanut;;0 - 20,000;6;7;-1;0;0;0
1068510;Stigfinnare;;0 - 20,000;6;1;5;0;0;0
1068520;Muppy The Bunny : The Danger of Wishes;;0 - 20,000;23;7;16;0;0;0
1068530;Wytchsun: Elleros Origins;;0 - 20,000;47;40;7;0;0;0
1068540;Aurora Hex - Pattern Puzzles;;0 - 20,000;6;1;5;0;0;0
1068600;Waking;;0 - 20,000;59;52;7;0;0;0
1068620;The Crystal Reef;;0 - 20,000;5;8;-3;0;0;0
1068640;Village Feud;;50,000 - 100,000;228;92;136;61;61;3
1068680;Looking Back;;20,000 - 50,000;6;0;6;0;0;0
1068700;Mystery of the Ancients: Deadly Cold Collector's Edition;;0 - 20,000;10;2;8;0;0;0
1068720;Partition Sector;;0 - 20,000;2;0;2;0;0;0
1068770;The Tower - The Order of XII;;0 - 20,000;6;1;5;0;0;0
1068800;Alphaman;;0 - 20,000;12;6;6;0;0;0
1068820;OVR Toolkit;;200,000 - 500,000;1992;245;1747;7546;2440;995
1068860;非正式警探 Informal Detective;;0 - 20,000;7;4;3;0;0;0
1068900;Dear Ashely;;0 - 20,000;0;2;-2;0;0;0
1068910;Submarine Attack!;;0 - 20,000;8;3;5;0;0;0
1068980;It Runs Red;;50,000 - 100,000;8;5;3;0;0;0
1068990;Magnetic Pull;;0 - 20,000;4;0;4;0;0;0
1069000;Rescue bomber;;0 - 20,000;2;1;1;0;0;0
1069030;EarthX;;20,000 - 50,000;577;65;512;196;245;5
1069050;Little Dungeon Stories;;0 - 20,000;83;21;62;178;178;0
1069080;Player Goes Jump;;0 - 20,000;4;1;3;0;0;0
1069090;PureDesktop;;20,000 - 50,000;22;24;-2;0;0;1
1069120;失落的地下城 Lost Dungeon;;0 - 20,000;6;0;6;0;0;0
1069140;Cthulhu's Catharsis;;0 - 20,000;10;2;8;0;0;0
1069150;Hieroglyph: Prologue;;0 - 20,000;8;1;7;0;0;0
1069190;Flight Of Nova;;0 - 20,000;157;7;150;0;0;6
1069210;Pulang Insanity - Director's Cut;;0 - 20,000;93;34;59;0;0;0
1069220;Miniturn;;;;;0;;;
1069230;月影魅像-解放之羽-;;20,000 - 50,000;2574;56;2518;384;404;10
1069250;Eslander Alpha;;0 - 20,000;4;2;2;0;0;0
1069270;Rotatex;;0 - 20,000;18;7;11;0;0;0
1069290;Elpida: Crônicas de uma guerreira;;0 - 20,000;6;0;6;0;0;0
1069360;Plasticity;;50,000 - 100,000;494;121;373;0;0;0
1069380;Flaws in the People We Love;;0 - 20,000;24;11;13;0;0;0
1069460;Rune Lord;;0 - 20,000;22;5;17;0;0;0
1069480;Worldwide Sports Fishing;;0 - 20,000;40;7;33;0;0;0
1069500;Ultimate Shotgun Championship;;0 - 20,000;0;1;-1;0;0;0
1069520;Green Field Silver Tree / 绿野白银树;;0 - 20,000;7;1;6;0;0;0
1069530;Narita Boy;;20,000 - 50,000;884;221;663;23;25;4
1069540;Super Lumberjack;;0 - 20,000;4;2;2;0;0;0
1069610;Exile of the Gods;;0 - 20,000;10;2;8;0;0;0
1069640;This Land Is My Land;;100,000 - 200,000;2656;1004;1652;180;284;279
1069650;Ultimate Admiral: Age of Sail;;20,000 - 50,000;1328;343;985;587;587;70
1069660;Ultimate Admiral: Dreadnoughts;;100,000 - 200,000;2328;919;1409;88;88;1296
1069670;EILF;;0 - 20,000;17;15;2;0;0;0
1069670;EILF;;0 - 20,000;17;15;2;0;0;0
1069690;Rogue Lords;;100,000 - 200,000;979;347;632;1291;2442;10
1069710;Gear City Against Chaos;;0 - 20,000;12;8;4;0;0;0
1069720;Vacation Adventures: Cruise Director 2;;0 - 20,000;1;0;1;0;0;0
1069740;Seen;;200,000 - 500,000;7749;629;7120;201;184;241
1069750;Balance Breakers - A Battle Party Game;;0 - 20,000;17;0;17;0;0;0
1069760;Ethereal Enigma;;20,000 - 50,000;435;23;412;0;0;2
1069820;Fog of War: The Battle for Cerberus;;0 - 20,000;7;4;3;0;0;0
1069840;Grit : Overworld Survival;;0 - 20,000;1;0;1;0;0;0
1069910;Factory Coin Mining;;0 - 20,000;17;15;2;0;0;0
1069920;To the Stars and Beyond!;;0 - 20,000;3;0;3;0;0;0
1069940;Blood Brothers;;0 - 20,000;12;2;10;0;0;0
1069960;Pythagorean Complex;;0 - 20,000;2;1;1;0;0;0
1069970;Gabbuchi;;0 - 20,000;6;0;6;0;0;0
1070020;我的纸片人女友/Make butter together!;;0 - 20,000;585;44;541;583;583;1
1070030;Under Stranger Stars;;0 - 20,000;3;0;3;0;0;0
1070030;Under Stranger Stars;;0 - 20,000;3;0;3;0;0;0
1070110;ELYSION;;0 - 20,000;23;6;17;0;0;0
1070150;SLAYERS FOR HIRE;;0 - 20,000;114;8;106;0;0;0
1070160;Avis Rapida - Aerobatic Racing;;0 - 20,000;6;1;5;0;0;0
1070180;Rescue Team 6;;0 - 20,000;10;1;9;0;0;0
1070190;Spellsword Cards: Origins;;0 - 20,000;46;21;25;0;0;0
1070220;Detective Kobayashi - A Visual Novel;;0 - 20,000;22;3;19;0;0;0
1070230;Ethanol in dungeon;;0 - 20,000;14;2;12;0;0;0
1070240;Peace of Evil;;0 - 20,000;7;13;-6;0;0;0
1070250;NOTES;;0 - 20,000;24;2;22;0;0;0
1070260;Graduated;;0 - 20,000;292;65;227;0;0;1
1070280;Endless Defence 2;;0 - 20,000;2;6;-4;0;0;0
1070300;Power Brain Trainer;;0 - 20,000;25;5;20;0;0;0
1070320;Ring the City;;0 - 20,000;86;34;52;0;0;1
1070330;Russian Life Simulator;;200,000 - 500,000;5298;621;4677;213;164;15
1070390;Fakespearean: Overdramatic;;0 - 20,000;1;0;1;0;0;0
1070400;Maldrin Journey;;0 - 20,000;0;1;-1;0;0;0
1070410;Nevrosa: Primal Ritual;;0 - 20,000;18;8;10;0;0;0
1070430;Space Duke;;0 - 20,000;1;2;-1;0;0;0
1070440;Dark Miasma;;0 - 20,000;11;0;11;0;0;0
1070450;GoVenture TYPING;;0 - 20,000;1;1;0;0;0;0
1070460;Plague of Days;;0 - 20,000;1;0;1;0;0;0
1070460;Plague of Days;;0 - 20,000;1;0;1;0;0;0
1070510;Militia 2;;0 - 20,000;29;0;29;0;0;0
1070550;Don't Escape Trilogy;;20,000 - 50,000;242;1;241;118;129;5
1070580;Drift86;;100,000 - 200,000;4224;376;3848;111;91;269
1070590;Butterfly 2;;0 - 20,000;8;1;7;0;0;0
1070690;RollerCoaster VR Universe;;0 - 20,000;78;34;44;40;40;0
1070710;Kind Words (lo fi chill beats to write to);;100,000 - 200,000;7930;135;7795;421;481;16
1070770;Skat 3D Premium;;0 - 20,000;11;11;0;0;0;0
1070780;Under Pressure;;0 - 20,000;73;13;60;0;0;0
1070790;Freshly Frosted;;0 - 20,000;217;2;215;0;0;3
1070800;Depths of Madness;;20,000 - 50,000;20;28;-8;0;0;0
1070840;Quest Together;;0 - 20,000;55;12;43;0;0;4
1070850;Today Is My Birthday;;0 - 20,000;53;41;12;0;0;0
1070860;Serin Fate;;20,000 - 50,000;392;113;279;0;0;12
1070890;Zombie Rush : Extinction;;0 - 20,000;14;7;7;0;0;0
1070910;Are you ready for Valve Index?;;100,000 - 200,000;639;72;567;0;0;14
1070950;My University 我的大学;;0 - 20,000;14;14;0;0;0;0
1070980;Astro4x;;0 - 20,000;3;2;1;0;0;0
1070990;Flux;;0 - 20,000;5;0;5;0;0;0
1071030;Hilda Bewildered;;0 - 20,000;0;1;-1;0;0;0
1071060;KUMACURE;;0 - 20,000;11;4;7;0;0;0
1071070;Adventure of Great Wolf;;0 - 20,000;2;0;2;0;0;0
1071080;Lapya;;0 - 20,000;8;15;-7;0;0;0
1071090;Clean VR;;0 - 20,000;7;5;2;0;0;0
1071100;Boom 3D;;50,000 - 100,000;487;59;428;116;226;168
1071120;Mushroom Cats;;50,000 - 100,000;1383;46;1337;0;0;0
1071130;The Procession to Calvary;;20,000 - 50,000;712;13;699;381;381;5
1071170;Claude Monet - The Water Lily obsession;;0 - 20,000;23;4;19;0;0;0
1071190;MineRalph;;0 - 20,000;32;0;32;0;0;0
1071220;After I met that catgirl, my questlist got too long!;;0 - 20,000;97;8;89;0;0;1
1071240;Earthlingo;;20,000 - 50,000;124;5;119;0;0;5
1071260;Horizon Shift '81;;0 - 20,000;13;1;12;0;0;0
1071280;Q - A Neon Platformer;;0 - 20,000;42;5;37;0;0;0
1071290;Wild West and Wizards;;20,000 - 50,000;274;83;191;13;13;1
1071310;1, 2, 3... Bruegel!;;0 - 20,000;17;8;9;0;0;0
1071320;Isle of the Dead;;20,000 - 50,000;34;8;26;0;0;0
1071330;Dark Fantasy 2: Jigsaw Puzzle;;0 - 20,000;102;21;81;0;0;0
1071350;Little One - A Visual Novel;;0 - 20,000;16;6;10;0;0;0
1071490;Miss Lisette's Assassin Maid;;20,000 - 50,000;93;34;59;14;14;2
1071510;And All Would Cry Beware!;;0 - 20,000;59;12;47;0;0;0
1071510;And All Would Cry Beware!;;0 - 20,000;59;12;47;0;0;0
1071580;TopDownFarter;;0 - 20,000;2;2;0;0;0;0
1071640;Open Ocean;;0 - 20,000;1;0;1;0;0;0
1071660;Ruine;;0 - 20,000;15;0;15;0;0;0
1071660;Ruine;;0 - 20,000;15;0;15;0;0;0
1071700;DeathMatch;;20,000 - 50,000;41;24;17;0;0;0
1071740;Pirates of First Star;;20,000 - 50,000;1;0;1;0;0;0
1071760;Idunn Guardians;;0 - 20,000;2;0;2;0;0;0
1071770;Princess's Peak;;0 - 20,000;11;21;-10;0;0;0
1071860;Click-chan;;0 - 20,000;10;0;10;0;0;0
1071870;Biped;;200,000 - 500,000;5068;698;4370;175;154;166
1071880;New Yankee in King Arthur's Court 4;;0 - 20,000;7;3;4;0;0;2
1071890;New Yankee in King Arthur's Court 5;;0 - 20,000;4;1;3;0;0;3
1071900;后遗症／Sequela;;0 - 20,000;23;2;21;0;0;0
1071920;;;0 - 20,000;19;0;19;0;0;0
1071940;Streamer's Life;;0 - 20,000;102;32;70;293;293;1
1071950;EscapeeZ;;0 - 20,000;1;1;0;0;0;0
1071970;Rayball;;0 - 20,000;1;0;1;0;0;0
1072000;Alice in CyberCity;;0 - 20,000;22;14;8;0;0;0
1072040;Panzer Corps 2;;50,000 - 100,000;2413;491;1922;2062;2820;788
1072050;Core Of Darkness;;0 - 20,000;2;6;-4;0;0;0
1072100;Action Arcade Wrestling;;0 - 20,000;106;28;78;0;0;2
1072110;Tartapolis;;0 - 20,000;14;3;11;0;0;0
1072140;Rigid Chess;;0 - 20,000;1;0;1;0;0;0
1072150;Hedon Bloodrite;;200,000 - 500,000;1383;120;1263;1929;1929;12
1072170;Order Up VR;;20,000 - 50,000;61;18;43;0;0;0
1072180;Grim Facade: Hidden Sins Collector's Edition;;0 - 20,000;8;0;8;0;0;1
1072190;Crossfire: Legion;;20,000 - 50,000;397;249;148;393;393;13
1072210;Strike Master Apocalypse;;0 - 20,000;5;1;4;0;0;0
1072270;K-9 Dog Job;;20,000 - 50,000;38;16;22;0;0;0
1072280;Cossanox;;0 - 20,000;3;0;3;0;0;0
1072310;Kurr Snaga;;0 - 20,000;32;11;21;0;0;0
1072340;VR takibi;;0 - 20,000;4;4;0;0;0;0
1072350;America's Retribution Term 2;;0 - 20,000;8;1;7;0;0;0
1072390;BirdGut;;200,000 - 500,000;3860;188;3672;0;0;2
1072420;DRAGON QUEST BUILDERS 2;;200,000 - 500,000;5255;467;4788;2126;3162;361
1072450;iTube HD Video Downloader - Download videos from 10000+ sites, 3X Faster Download Speed, Download Entire Playlist, Record Online Video.;;0 - 20,000;15;7;8;0;0;0
1072480;The Fisherman - Fishing Planet;;20,000 - 50,000;661;392;269;188;219;14
1072490;KiKiMiMi / 听能力搜查官;;0 - 20,000;43;1;42;0;0;0
1072500;AO Tennis 2;;50,000 - 100,000;801;359;442;258;360;49
1072530;Sheaf - Together EP;;20,000 - 50,000;144;5;139;0;0;0
1072590;Game Of Puzzles: Dragons;;0 - 20,000;57;5;52;0;0;1
1072600;Until September;;0 - 20,000;5;2;3;0;0;0
1072610;AvoCuddle;;0 - 20,000;27;2;25;0;0;0
1072620;Weakless;;0 - 20,000;78;23;55;0;0;0
1072660;Loco Parentis VR;;0 - 20,000;13;21;-8;0;0;0
1072710;Soviet Jump Game;;200,000 - 500,000;1189;247;942;24;39;0
1072750;That Flipping Mountain;;0 - 20,000;120;6;114;299;299;0
1072760;Nick Logic for Kids;;0 - 20,000;4;1;3;0;0;0
1072800;Ufflegrim;;0 - 20,000;11;0;11;0;0;0
1072850;RifleRange;;0 - 20,000;0;1;-1;0;0;0
1072860;Real Scary;;0 - 20,000;60;6;54;0;0;0
1072870;Random War;;0 - 20,000;13;1;12;0;0;0
1072890;Oneironaut;;0 - 20,000;15;8;7;0;0;0
1072920;HomeWork Is Crazy / 作业疯了;;200,000 - 500,000;326;826;-500;514;537;2
1072930;Blood Magic;;0 - 20,000;3;3;0;0;0;0
1073020;In the beginning;;0 - 20,000;1;5;-4;0;0;0
1073020;In the beginning;;0 - 20,000;1;5;-4;0;0;0
1073040;Retro Pixel Racers;;0 - 20,000;1;4;-3;0;0;0
1073050;Happy Geography Fun;;0 - 20,000;5;3;2;0;0;0
1073060;Lonely Skies;;0 - 20,000;6;4;2;0;0;0
1073080;TUTUTUTU - Tea party;;0 - 20,000;4;2;2;0;0;0
1073100;Speedrun Squad;;0 - 20,000;10;0;10;0;0;0
1073130;Atlantis Royale;;0 - 20,000;38;9;29;0;0;0
1073140;Castra;;0 - 20,000;2;3;-1;0;0;0
1073210;Mermaid Colony;;0 - 20,000;19;13;6;0;0;1
1073220;Teeth Brushing Simulator;;0 - 20,000;192;29;163;0;0;1
1073280;Spy Tactics;;0 - 20,000;16;3;13;0;0;0
1073320;Meteorfall: Krumit's Tale;;0 - 20,000;676;60;616;366;366;7
1073350;Curves;;0 - 20,000;5;0;5;0;0;0
1073360;Paycheck: City RPG;;0 - 20,000;9;23;-14;0;0;0
1073370;Inori's House;;0 - 20,000;4;5;-1;0;0;0
1073390;Aircar;;200,000 - 500,000;1845;103;1742;0;0;4
1073400;Tiger Tank 59 Ⅰ Winter Assault;;0 - 20,000;2;2;0;0;0;0
1073410;Boxing Champs;;0 - 20,000;14;6;8;0;0;0
1073420;Aimersoft iMusic;;0 - 20,000;0;1;-1;0;0;0
1073490;Monster X Monster;;0 - 20,000;132;29;103;0;0;0
1073610;Miss Cat;;0 - 20,000;21;0;21;0;0;0
1073620;Not So Heart;;0 - 20,000;1;1;0;0;0;0
1073640;JetX Space Edition;;0 - 20,000;3;4;-1;0;0;0
1073710;Legion of Scorn;;0 - 20,000;1;0;1;0;0;0
1073720;Navigation Bar;;0 - 20,000;12;8;4;0;0;0
1073770;XANARTHRAXIA;;0 - 20,000;36;5;31;0;0;0
1073790;The Astrolarix;;0 - 20,000;1;0;1;0;0;0
1073810;Shapik: The Moon Quest;;0 - 20,000;197;11;186;0;0;2
1073840;Nocked! True Tales of Robin Hood;;0 - 20,000;62;3;59;0;0;1
1073860;Idle Guardians;;0 - 20,000;25;27;-2;0;0;6
1073870;Self Shot;;0 - 20,000;60;14;46;0;0;0
1073870;Self Shot;;0 - 20,000;60;14;46;0;0;0
1073890;Dragon Fight VR;;0 - 20,000;10;1;9;0;0;0
1073890;Dragon Fight VR;;0 - 20,000;10;1;9;0;0;0
1073900;Brukel;;0 - 20,000;177;22;155;0;0;0
1073910;Before We Leave;;50,000 - 100,000;1019;260;759;354;195;35
1073960;Exemption;;20,000 - 50,000;3;1;2;0;0;0
1074040;The Red Prison;;0 - 20,000;33;7;26;0;0;0
1074040;The Red Prison;;0 - 20,000;33;7;26;0;0;0
1074070;Dust to the End;;100,000 - 200,000;838;187;651;954;954;6
1074080;SENRAN KAGURA Peach Ball;;0 - 20,000;482;60;422;84;140;4
1074150;Little Savior / リトルセイバー;;0 - 20,000;5;1;4;0;0;0
1074170;SELF;;0 - 20,000;196;49;147;124;124;0
1074180;Smart City Plan;;0 - 20,000;72;35;37;0;0;1
1074180;Smart City Plan;;0 - 20,000;72;35;37;0;0;1
1074220;The Cult: Marduk's Longest Night;;0 - 20,000;23;3;20;0;0;0
1074250;Kunoichi;;0 - 20,000;0;1;-1;0;0;0
1074300;Dragon Castle: The Board Game;;0 - 20,000;28;2;26;0;0;0
1074310;The Real Man Summer Championship 2019;;0 - 20,000;14;0;14;0;0;0
1074330;Minesweeper Peak VR;;0 - 20,000;7;2;5;0;0;0
1074340;Viking Sisters;;0 - 20,000;18;0;18;0;0;0
1074370;Spherecraft;;0 - 20,000;25;19;6;0;0;0
1074390;Scikor - Final Scale;;0 - 20,000;5;0;5;0;0;0
1074400;Herman 2;;0 - 20,000;2;1;1;0;0;0
1074500;Cranked Up;;0 - 20,000;38;0;38;0;0;0
1074510;Beekeeper;;0 - 20,000;27;7;20;0;0;0
1074520;A Sceptic's Guide to Magic;;0 - 20,000;50;2;48;0;0;1
1074530;Goto Family's- ''The Island Murder Case'';;0 - 20,000;14;3;11;0;0;0
1074550;Pon Para and the Great Southern Labyrinth;;0 - 20,000;17;3;14;0;0;0
1074610;COLLAPSED;;20,000 - 50,000;132;50;82;85;85;1
1074620;Adore;;0 - 20,000;287;27;260;402;402;13
1074640;Diorama Dungeoncrawl;;0 - 20,000;15;2;13;0;0;0
1074700;Witches' Legacy: The Charleston Curse Collector's Edition;;0 - 20,000;13;1;12;0;0;0
1074820;Eudemons Online;;20,000 - 50,000;58;47;11;0;0;2
1074860;Click Defense;;0 - 20,000;1;0;1;0;0;0
1074870;Typing Instructor for Kids Gold;;0 - 20,000;0;1;-1;0;0;0
1074880;Typing Instructor Gold;;0 - 20,000;2;0;2;0;0;0
1074900;Professor Teaches Excel 2019;;0 - 20,000;3;2;1;0;0;0
1074910;Professor Teaches Publisher 2019;;0 - 20,000;1;0;1;0;0;0
1074920;Professor Teaches Word 2019;;0 - 20,000;1;0;1;0;0;0
1074930;Professor Teaches PowerPoint 2019;;0 - 20,000;2;0;2;0;0;0
1075000;Beyond the Stars VR;;0 - 20,000;33;11;22;0;0;0
1075080;Falcon Age;;0 - 20,000;134;37;97;47;47;1
1075120;梦涯;;0 - 20,000;6;12;-6;0;0;0
1075140;Super Friends Party;;20,000 - 50,000;271;129;142;0;0;0
1075170;Weaving Tides;;0 - 20,000;91;7;84;0;0;0
1075190;A Game of Thrones: The Board Game - Digital Edition;;200,000 - 500,000;1088;434;654;133;160;63
1075200;TOHU;;20,000 - 50,000;427;69;358;86;86;6
1075370;Skywalk;;0 - 20,000;26;7;19;0;0;0
1075390;Cafe Crush;;0 - 20,000;24;7;17;0;0;0
1075400;Doctor Who: The Edge Of Time;;0 - 20,000;148;68;80;0;0;0
1075430;Cowpocalypse - Episode 0;;50,000 - 100,000;160;27;133;0;0;0
1075480;Summer Rush;;0 - 20,000;10;5;5;0;0;0
1075550;Bite the Bullet;;0 - 20,000;43;32;11;0;0;1
1075570;Transcender Starship;;0 - 20,000;2;0;2;0;0;0
1075740;Banners of Ruin;;100,000 - 200,000;1883;463;1420;325;431;43
1075750;Reflections of Life: Equilibrium Collector's Edition;;0 - 20,000;8;2;6;0;0;0
1075790;Fox and Bunny;;0 - 20,000;11;11;0;0;0;0
1075850;Professor Teaches Outlook 2019;;0 - 20,000;2;0;2;0;0;0
1075860;Professor Teaches Access 2019;;0 - 20,000;2;0;2;0;0;0
1075910;Space Bomb;;0 - 20,000;4;0;4;0;0;0
1075950;Disintegration Technical Beta;;0 - 20,000;1140;341;799;0;0;0
1075960;Simple Fear;;0 - 20,000;1;1;0;0;0;0
1076020;Viro Move;;0 - 20,000;17;12;5;0;0;0
1076040;Welcome To... Chichester OVN 1 : The Beach;;0 - 20,000;12;9;3;0;0;0
1076050;Run Jump Rabbit Turtle;;0 - 20,000;4;0;4;0;0;0
1076070;Alice and You in the planet of numbers;;0 - 20,000;22;0;22;0;0;0
1076100;Illusion of L'Phalcia;;0 - 20,000;6;2;4;0;0;0
1076110;Asdivine Menace;;0 - 20,000;8;0;8;0;0;0
1076120;Dwarven Skykeep;;20,000 - 50,000;67;17;50;0;0;0
1076120;Dwarven Skykeep;;20,000 - 50,000;67;17;50;0;0;0
1076130;fox soldier;;0 - 20,000;198;2;196;0;0;0
1076140;Super Indie Square;;0 - 20,000;22;1;21;0;0;0
1076160;Command: Modern Operations;;20,000 - 50,000;836;146;690;0;0;109
1076200;Roguebook;;100,000 - 200,000;2308;419;1889;1264;1981;64
1076210;Who wants to strip this babe? Streamer Girl;;0 - 20,000;89;15;74;0;0;1
1076280;Showdown Bandit;;50,000 - 100,000;467;300;167;169;47;0
1076290;The Poisoner;;0 - 20,000;5;5;0;0;0;0
1076300;The Battles of Spwak;;20,000 - 50,000;0;1;-1;0;0;0
1076350;Sky Realm: Essences;;0 - 20,000;1;0;1;0;0;0
1076360;Square Weapons Dungeon;;0 - 20,000;4;0;4;0;0;0
1076410;VRRCC;;0 - 20,000;4;4;0;0;0;0
1076480;Dream Flash;;0 - 20,000;35;0;35;0;0;1
1076500;Valgrave: Immortal Plains;;100,000 - 200,000;764;155;609;0;0;0
1076530;Drop;;50,000 - 100,000;141;208;-67;0;0;1
1076550;SAMURAI SHODOWN V SPECIAL / サムライスピリッツ零スペシャル;;20,000 - 50,000;406;32;374;59;59;3
1076550;SAMURAI SHODOWN V SPECIAL / サムライスピリッツ零スペシャル;;20,000 - 50,000;406;32;374;59;59;3
1076600;Red Gate;;50,000 - 100,000;47;160;-113;0;0;0
1076610;Guardian of the future;;0 - 20,000;26;6;20;0;0;0
1076620;Svoboda 1945: Liberation;;20,000 - 50,000;119;1;118;0;0;0
1076640;Cricket Captain 2019;;0 - 20,000;54;31;23;0;0;9
1076730;Attached;;0 - 20,000;0;1;-1;0;0;0
1076750;Dream Engines: Nomad Cities;;0 - 20,000;310;97;213;0;0;12
1076770;ACardShooter;;0 - 20,000;6;0;6;0;0;0
1076790;Cube Runner 2;;0 - 20,000;11;4;7;0;0;0
1076830;Quest For Wartorn Brotherhood;;0 - 20,000;8;4;4;0;0;0
1076880;Air Marty;;0 - 20,000;286;11;275;0;0;0
1076920;Generals & Rulers;;20,000 - 50,000;252;137;115;525;525;0
1076940;Contract Work;;0 - 20,000;3;0;3;0;0;0
1076950;Sniper Commando Attack;;0 - 20,000;6;7;-1;0;0;0
1077030;Chernomeat Survival Game;;0 - 20,000;2;0;2;0;0;0
1077080;Börnies Journey;;20,000 - 50,000;5;2;3;0;0;0
1077090;Bucket Knight;;0 - 20,000;24;4;20;0;0;0
1077150;Planet Jump 2;;0 - 20,000;1;2;-1;0;0;0
1077150;Planet Jump 2;;0 - 20,000;1;2;-1;0;0;0
1077160;Game Of Puzzles: Animals;;0 - 20,000;92;7;85;0;0;1
1077200;Attack Of The Retro Bots;;0 - 20,000;7;3;4;0;0;0
1077210;C.H.A.S.E.D.;;20,000 - 50,000;21;6;15;0;0;0
1077230;Dissolving;;0 - 20,000;322;44;278;0;0;0
1077250;Age of Pixels;;0 - 20,000;10;1;9;0;0;0
1077290;SuperSmash: Physics Battle;;20,000 - 50,000;721;54;667;377;377;21
1077320;Sarah, you are way too heavy;;0 - 20,000;1;7;-6;0;0;0
1077330;Ivanoile ~ Christalixeur Corruption;;0 - 20,000;2;0;2;0;0;0
1077340;Downtown Drift;;0 - 20,000;99;24;75;0;0;5
1077390;Cannibal Chickens;;0 - 20,000;1;0;1;0;0;0
1077420;Ambidangerous;;0 - 20,000;10;0;10;0;0;0
1077430;There's a Butcher Around;;0 - 20,000;319;51;268;145;203;1
1077440;卡片地下城Card Monsters: Dungeon;;50,000 - 100,000;299;96;203;0;0;0
1077450;Wally and the FANTASTIC PREDATORS;;0 - 20,000;179;5;174;0;0;1
1077470;Syntherapy;;0 - 20,000;27;4;23;0;0;0
1077490;Guns of Midnight;;0 - 20,000;10;4;6;0;0;0
1077520;The Light Remake;;50,000 - 100,000;991;109;882;164;164;1
1077530;SUPER BUILD;;0 - 20,000;202;31;171;0;0;1
1077530;SUPER BUILD;;0 - 20,000;202;31;171;0;0;1
1077540;酒店二 The Hotel 2;;0 - 20,000;4;4;0;0;0;0
1077550;Jump with Friends;;20,000 - 50,000;41;29;12;0;0;0
1077560;무연;;0 - 20,000;6;2;4;0;0;0
1077570;Neverland Treasure;;0 - 20,000;1;2;-1;0;0;0
1077600;Song Beater: Quite My Tempo!;;0 - 20,000;67;7;60;0;0;0
1077630;Australian Football Coach 2020;;0 - 20,000;23;12;11;0;0;6
1077680;MadCowBalls2;;0 - 20,000;4;0;4;0;0;0
1077730;HRDINA;;50,000 - 100,000;460;56;404;0;0;0
1077740;Anomaly Hunter - Prologue;;0 - 20,000;12;7;5;0;0;0
1077760;AGENT 00111;;0 - 20,000;13;5;8;0;0;0
1077850;Grave of the Petrified;;0 - 20,000;34;9;25;0;0;0
1077890;Catch a Duck;;0 - 20,000;56;14;42;0;0;0
1077890;Catch a Duck;;0 - 20,000;56;14;42;0;0;0
1077970;Dry Drowning;;100,000 - 200,000;347;70;277;525;1044;2
1078000;Gamecraft;;50,000 - 100,000;665;210;455;42;68;2
1078040;BRG's Red Riding Hood;;0 - 20,000;1;0;1;0;0;0
1078060;BRG's The Stonecutter;;0 - 20,000;1;1;0;0;0;0
1078080;DISONANTE;;0 - 20,000;2;2;0;0;0;0
1078130;Cannon Arena;;0 - 20,000;6;4;2;0;0;0
1078200;Spirits Abyss;;0 - 20,000;318;9;309;3;3;1
1078280;Ruins Seeker;;20,000 - 50,000;559;36;523;0;0;6
1078320;Public Defense Corp;;20,000 - 50,000;232;35;197;0;0;2
1078330;Liz ~The Tower and the Grimoire~;;0 - 20,000;384;35;349;338;338;3
1078340;Mongrel;;0 - 20,000;8;0;8;0;0;0
1078350;Ambrosia;;100,000 - 200,000;1618;110;1508;167;222;50
1078360;To Your Stations!;;20,000 - 50,000;12;1;11;0;0;1
1078370;Succubus x Saint;;0 - 20,000;54;19;35;0;0;1
1078380;Zefira;;0 - 20,000;78;37;41;0;0;0
1078420;Critters for Sale;;20,000 - 50,000;709;22;687;241;241;1
1078450;Falnarion Tactics II;;0 - 20,000;6;3;3;0;0;0
1078460;Cops Kissing Each Other;;0 - 20,000;1;0;1;0;0;0
1078490;Seed Hunter 猎源;;20,000 - 50,000;248;102;146;0;0;0
1078520;Ghost Stories;;0 - 20,000;55;22;33;0;0;0
1078550;Voltron: Cubes of Olkarion;;0 - 20,000;34;1;33;0;0;0
1078560;Turok: Escape from Lost Valley;;0 - 20,000;22;17;5;0;0;0
1078590;虚幻深渊 The Illusory abyss;;50,000 - 100,000;1;0;1;0;0;0
1078640;Eggoria;;0 - 20,000;42;20;22;0;0;0
1078670;Another Dawn;;0 - 20,000;4;4;0;0;0;0
1078730;Soccer Manager 2020;;200,000 - 500,000;1145;359;786;0;0;23
1078750;Duskless: The Clockwork Army;;0 - 20,000;7;2;5;0;0;0
1078760;Motorcycle Mechanic Simulator 2021;;20,000 - 50,000;741;287;454;53;86;33
1078770;New Day: Cataclysm;;0 - 20,000;28;18;10;0;0;0
1078780;Martians Vs Robots;;0 - 20,000;2;4;-2;0;0;0
1078800;U-BOOT The Board Game;;20,000 - 50,000;46;24;22;0;0;2
1078820;Horresco Referens;;0 - 20,000;1;0;1;0;0;0
1078870;SHEEP.IO;;0 - 20,000;12;5;7;0;0;0
1078920;Main Assembly;;50,000 - 100,000;959;134;825;1223;1196;13
1078930;Fatty Space;;0 - 20,000;9;0;9;0;0;0
1078950;打豹虎 Spider Derby;;0 - 20,000;2;0;2;0;0;0
1078960;The Saga of Nino's Transmigration (尼諾的異世界物語 ~ 光與影與各自的信仰 ~);;20,000 - 50,000;171;12;159;0;0;0
1078960;The Saga of Nino's Transmigration (尼諾的異世界物語 ~ 光與影與各自的信仰 ~);;20,000 - 50,000;171;12;159;0;0;0
1078970;局外人 L'Etranger;;20,000 - 50,000;284;59;225;0;0;1
1079000;Ord.;;0 - 20,000;183;13;170;0;0;1
1079050;Laser Paddles;;0 - 20,000;3;0;3;0;0;0
1079160;Touhou Kikeijuu ~ Wily Beast and Weakest Creature.;;50,000 - 100,000;905;23;882;320;320;1
1079200;Piko Piko;;0 - 20,000;80;34;46;0;0;0
1079210;Spark the Electric Jester 2;;0 - 20,000;438;39;399;0;0;6
1079210;Spark the Electric Jester 2;;0 - 20,000;438;39;399;0;0;6
1079230;Himno - The Silent Melody;;20,000 - 50,000;219;21;198;0;0;0
1079260;Fireworks Mania - An Explosive Simulator;;200,000 - 500,000;3868;133;3735;1364;1396;136
1079310;Elemental Girls;;200,000 - 500,000;235;56;179;238;279;2
1079320;Dragon Extinction;;0 - 20,000;70;20;50;0;0;0
1079330;Corner Cathouse / 街角的猫咪花园;;0 - 20,000;12;14;-2;0;0;0
1079340;homicide;;0 - 20,000;0;15;-15;0;0;0
1079420;Wheelie King VR;;0 - 20,000;1;3;-2;0;0;0
1079430;Surrounded by mice;;0 - 20,000;4;2;2;0;0;0
1079440;Bad Business;;0 - 20,000;16;6;10;0;0;0
1079450;Escape Lala 2 - Retro Point and Click Adventure;;0 - 20,000;138;1;137;0;0;0
1079470;Chronac;;0 - 20,000;2;0;2;0;0;0
1079480;BeiJing Courier Simulator;;0 - 20,000;7;7;0;0;0;0
1079520;PoupeIIe Of ChimneyTown VR ～into the world～;;0 - 20,000;5;5;0;0;0;0
1079550;Escape again;;0 - 20,000;5;4;1;0;0;0
1079560;Zero Strain;;0 - 20,000;20;2;18;0;0;0
1079570;Staden under Gamlestaden;;0 - 20,000;63;14;49;0;0;0
1079570;Staden under Gamlestaden;;0 - 20,000;63;14;49;0;0;0
1079600;E06-Anomaly;;0 - 20,000;4;1;3;0;0;0
1079610;Counterspell;;20,000 - 50,000;4;0;4;0;0;0
1079620;Infinity: Battlescape;;20,000 - 50,000;467;112;355;0;0;2
1079630;Death Jump;;20,000 - 50,000;81;19;62;0;0;0
1079730;Ehandcipation;;0 - 20,000;4;0;4;0;0;0
1079780;Dark Space Conqueror;;0 - 20,000;0;2;-2;0;0;0
1079790;Orc Colony;;0 - 20,000;22;17;5;0;0;0
1079800;Pistol Whip;;200,000 - 500,000;3143;227;2916;204;115;35
1079810;KreisReise;;0 - 20,000;14;3;11;0;0;0
1079830;Cris Tales;;20,000 - 50,000;213;111;102;0;0;0
1079860;Where Shadows Slumber;;0 - 20,000;10;1;9;0;0;0
1079870;Otiiz's adventure 2;;0 - 20,000;0;1;-1;0;0;0
1079890;Happy World;;0 - 20,000;0;1;-1;0;0;0
1079910;BloXoR;;0 - 20,000;2;0;2;0;0;0
1079940;Hippocampus;;0 - 20,000;23;20;3;0;0;0
1079970;Mundus - Impossible Universe 2;;0 - 20,000;43;2;41;0;0;4
1080010;Witchtastic;;0 - 20,000;140;15;125;0;0;6
1080020;Electrician Simulator;;20,000 - 50,000;886;196;690;12;12;25
1080040;Moo Lander;;0 - 20,000;32;1;31;0;0;0
1080060;Axan Ships - Low Poly;;0 - 20,000;7;3;4;0;0;0
1080090;Project ONe プロジェクト・ワン ～ハロルドはつらいよ～;;20,000 - 50,000;1;0;1;0;0;0
1080110;F1 2020;;1,000,000 - 2,000,000;37107;2579;34528;3634;1690;539
1080120;FinalAdventure;;0 - 20,000;6;1;5;0;0;0
1080130;QuietMansion2;;0 - 20,000;38;13;25;0;0;0
1080200;Aries;;0 - 20,000;3;2;1;0;0;0
1080240;It's Raining Fists and Metal;;0 - 20,000;3;2;1;0;0;0
1080250;Fool!;;0 - 20,000;20;2;18;0;0;0
1080310;Humans 101;;0 - 20,000;2;0;2;0;0;0
1080330;Super Mega Space Blaster Special;;0 - 20,000;22;0;22;0;0;0
1080360;Rampart Tactics;;0 - 20,000;0;1;-1;0;0;0
1080370;Dive with Sylvia VR;;0 - 20,000;2;2;0;0;0;0
1080410;Bake 'n Switch;;0 - 20,000;64;17;47;0;0;0
1080440;Dark Blood;;0 - 20,000;1;9;-8;0;0;0
1080450;Wayward Strand;;0 - 20,000;57;3;54;24;24;0
1080490;Georifters;;0 - 20,000;7;0;7;0;0;0
1080630;Hero Express;;0 - 20,000;19;1;18;0;0;0
1080700;Swordbreaker: Origins;;0 - 20,000;31;2;29;0;0;3
1080750;Mutazione;;20,000 - 50,000;756;28;728;0;0;5
1080780;reYal;;0 - 20,000;17;7;10;0;0;0
1080790;Jack-In-A-Castle;;0 - 20,000;31;0;31;0;0;0
1080930;The Incredible Adventures of Super Panda;;0 - 20,000;7;1;6;0;0;0
1080950;Kaos;;0 - 20,000;1;0;1;0;0;0
1080990;叙事曲2：星空下的诺言 / Ballade2: the Celestial Promise;;0 - 20,000;77;6;71;0;0;0
1081020;Blockus' Adventures;;0 - 20,000;1;0;1;0;0;0
1081040;Twin Peaks VR;;0 - 20,000;30;13;17;0;0;0
1081070;Gooberries;;0 - 20,000;10;1;9;0;0;0
1081090;H Chan: Girl;;0 - 20,000;23;12;11;0;0;0
1081100;Insurgence - Second Assault;;0 - 20,000;18;0;18;0;0;1
1081110;Milly the dog;;0 - 20,000;2;4;-2;0;0;0
1081120;hoVRboard;;0 - 20,000;34;2;32;0;0;0
1081160;Into The Core;;0 - 20,000;40;2;38;0;0;0
1081170;STRASHILKA;;0 - 20,000;2;4;-2;0;0;0
1081190;Ninja Roquinexu;;0 - 20,000;10;3;7;0;0;0
1081200;Truck the System;;0 - 20,000;4;0;4;0;0;0
1081240;Scarytales: All Hail King Mongo;;0 - 20,000;18;3;15;0;0;0
1081250;Giant Life;;0 - 20,000;13;2;11;0;0;0
1081250;Giant Life;;0 - 20,000;13;2;11;0;0;0
1081260;Crisis of the Middle Ages;;0 - 20,000;9;1;8;0;0;0
1081320;Aura;;20,000 - 50,000;1;1;0;0;0;0
1081350;Master Cube;;0 - 20,000;1;0;1;0;0;0
1081370;BornWild • Versus Season 1, Vol.1;;0 - 20,000;3;2;1;0;0;0
1081400;Where is my family;;0 - 20,000;3;4;-1;0;0;0
1081410;GourMelee;;0 - 20,000;11;2;9;0;0;0
1081420;Altorius;;0 - 20,000;1;0;1;0;0;0
1081430;Tale Of Starship;;0 - 20,000;2;0;2;0;0;0
1081450;Criminal Dissidia;;0 - 20,000;84;38;46;0;0;3
1081460;PrincessGuardiansParodyH;;0 - 20,000;2;1;1;0;0;0
1081470;Born of Fire;;20,000 - 50,000;64;39;25;0;0;0
1081490;Hyper Bit Chasm;;0 - 20,000;6;0;6;0;0;0
1081500;Side Decide;;0 - 20,000;3;1;2;0;0;0
1081510;She Sees Red - Interactive Movie;;100,000 - 200,000;2171;604;1567;70;79;1
1081520;Glimpse;;0 - 20,000;1;0;1;0;0;0
1081550;Caliper 2;;0 - 20,000;9;0;9;0;0;0
1081560;GOLD EXPRESS;;50,000 - 100,000;371;176;195;224;224;0
1081590;Quest? Quest!;;0 - 20,000;30;6;24;0;0;1
1081600;Fractal Gallery VR;;0 - 20,000;4;2;2;0;0;0
1081630;Yet Another Level;;0 - 20,000;5;0;5;0;0;0
1081650;Celaria;;0 - 20,000;97;14;83;0;0;1
1081650;Celaria;;0 - 20,000;97;14;83;0;0;1
1081670;Fitforce;;20,000 - 50,000;184;50;134;0;0;2
1081710;Most Correct Football Simulator;;20,000 - 50,000;36;18;18;0;0;0
1081720;Robo Run;;0 - 20,000;1;5;-4;0;0;0
1081730;3D Organon VR Anatomy;;0 - 20,000;16;17;-1;0;0;2
1081730;3D Organon VR Anatomy;;0 - 20,000;16;17;-1;0;0;2
1081740;Easter Clicker: Idle Manager;;0 - 20,000;38;14;24;0;0;3
1081760;BAFF;;0 - 20,000;17;17;0;0;0;0
1081800;101010;;0 - 20,000;16;4;12;0;0;0
1081810;时之扉;;50,000 - 100,000;18;21;-3;0;0;0
1081840;ANONYMOUS || AGONY;;0 - 20,000;51;12;39;0;0;0
1081850;Artemis: God-Queen of The Hunt;;0 - 20,000;23;21;2;0;0;0
1081870;WarForwards;;0 - 20,000;36;8;28;0;0;0
1081880;死亡旅店 / Death Inn;;0 - 20,000;44;8;36;0;0;0
1081890;BonVoyage!;;0 - 20,000;21;1;20;0;0;0
1081910;Fancy Skiing: Speed;;0 - 20,000;1;3;-2;0;0;0
1081960;Il Sole e la Luna;;20,000 - 50,000;3;2;1;0;0;0
1081990;jwing - the next puzzle game;;0 - 20,000;4;0;4;0;0;0
1082000;A Night at the Races;;0 - 20,000;23;1;22;0;0;0
1082110;HentaiNYA;;0 - 20,000;26;8;18;0;0;0
1082180;TT Isle of Man: Ride on the Edge 2;;50,000 - 100,000;917;214;703;171;278;27
1082220;Outbreak: Epidemic;;20,000 - 50,000;46;41;5;0;0;0
1082430;Before Your Eyes;;100,000 - 200,000;9497;217;9280;131;162;8
1082440;hack.88;;0 - 20,000;18;0;18;0;0;0
1082450;Gold Hunter;;0 - 20,000;197;202;-5;228;228;20
1082460;Ninja Turdle;;0 - 20,000;13;1;12;0;0;0
1082470;Mystery Case Files: Key to Ravenhearst Collector's Edition;;0 - 20,000;30;1;29;0;0;0
1082470;Mystery Case Files: Key to Ravenhearst Collector's Edition;;0 - 20,000;30;1;29;0;0;0
1082480;Buzz Kill Zero;;0 - 20,000;1;0;1;0;0;0
1082500;Grim Tales: The Vengeance Collector's Edition;;0 - 20,000;8;4;4;0;0;0
1082620;PhilGood;;0 - 20,000;3;1;2;0;0;0
1082640;Polities;;0 - 20,000;1;3;-2;0;0;0
1082650;Link the Animals;;0 - 20,000;8;5;3;0;0;0
1082680;The Walking Dead Onslaught;;50,000 - 100,000;414;535;-121;13;13;2
1082700;Dinosaur Shakespeare: To Date or Not To Date?;;0 - 20,000;0;1;-1;0;0;0
1082710;Bug Fables: The Everlasting Sapling;;50,000 - 100,000;3869;91;3778;138;168;78
1082720;Click Legends;;0 - 20,000;17;15;2;0;0;2
1082730;Niara: Rebellion Of the King Visual Novel RPG;;0 - 20,000;2;2;0;0;0;0
1082750;Wacktory;;0 - 20,000;20;7;13;0;0;0
1082770;Surviving Medieval;;0 - 20,000;19;12;7;0;0;0
1082780;ADM 2(WHEN WORLDS COLLIDE);;0 - 20,000;0;8;-8;0;0;0
1082860;Simgirls: Lovemore College RPG;;0 - 20,000;4;0;4;0;0;0
1082890;Viking Vengeance;;0 - 20,000;59;44;15;0;0;0
1082930;The Signifier Director's Cut;;0 - 20,000;195;37;158;0;0;1
1082940;Pop'n'splat;;0 - 20,000;3;2;1;0;0;0
1082990;D.A.M.A.G.E;;0 - 20,000;1;3;-2;0;0;0
1083000;The Last Town;;0 - 20,000;1;3;-2;0;0;0
1083070;Sapper - Defuse The Bomb Simulator;;0 - 20,000;37;34;3;0;0;1
1083190;Disc Creatures;;0 - 20,000;146;23;123;0;0;4
1083210;符文女孩/Rune Girl;;50,000 - 100,000;1077;482;595;48;49;1
1083240;CREEP RIDES;;0 - 20,000;13;0;13;0;0;0
1083260;Wingsuit: Gudvangen;;0 - 20,000;2;4;-2;0;0;0
1083270;HeroOfMetal-Episode01;;0 - 20,000;2;0;2;0;0;0
1083290;Life of a Capitalist;;0 - 20,000;2;5;-3;0;0;0
1083300;Drill Deal – Oil Tycoon;;0 - 20,000;96;12;84;0;0;1
1083310;OUTBUDDIES DX;;20,000 - 50,000;160;63;97;25;25;2
1083350;SRX;;0 - 20,000;10;1;9;0;0;0
1083410;Coast team;;0 - 20,000;1;6;-5;0;0;0
1083430;Snow Jewels;;0 - 20,000;20;7;13;0;0;0
1083450;Tricky Fox;;0 - 20,000;16;2;14;0;0;0
1083460;Rencia;;0 - 20,000;7;0;7;0;0;0
1083480;Armadusa;;0 - 20,000;36;16;20;0;0;0
1083600;Grow Defense;;100,000 - 200,000;387;117;270;0;0;60
1083700;3D Text Adventure;;0 - 20,000;9;14;-5;0;0;0
1083750;Yet Another Hero Legend 英雄传说又一则;;0 - 20,000;13;0;13;0;0;0
1083760;Knights of the Chalice;;20,000 - 50,000;63;8;55;0;0;3
1083800;Glitch Arena;;;;;0;;;
1083810;War Solution - Casual Math Game;;0 - 20,000;32;6;26;0;0;1
1083820;Eternal Dread 2;;0 - 20,000;71;17;54;0;0;2
1083850;Fantasy Hero Manager;;0 - 20,000;7;13;-6;0;0;0
1083990;Yume Puzzle;;0 - 20,000;7;2;5;0;0;0
1084010;Bombuzal;;0 - 20,000;3;4;-1;0;0;0
1084020;TheoTown;;50,000 - 100,000;1345;97;1248;631;631;53
1084050;Legends of Catalonia: The Land of Barcelona;;0 - 20,000;6;7;-1;0;0;0
1084080;Save Daddy Trump;;0 - 20,000;83;27;56;0;0;2
1084090;Kerfuffight;;0 - 20,000;3;0;3;0;0;0
1084120;Hindsight 20/20 - Wrath of the Raakshasa;;0 - 20,000;17;8;9;0;0;0
1084220;Cavity Busters;;0 - 20,000;78;2;76;0;0;1
1084350;Fear of Dark;;0 - 20,000;54;39;15;0;0;0
1084360;Mister Burnhouse;;20,000 - 50,000;20;4;16;0;0;0
1084420;The First Day;;0 - 20,000;4;2;2;0;0;0
1084460;Percy's Last Stand;;0 - 20,000;2;1;1;0;0;0
1084480;Wanna Survive;;20,000 - 50,000;238;15;223;50;50;0
1084520;雀姬/姫麻雀;;200,000 - 500,000;1367;985;382;0;0;119
1084530;Zone 10;;0 - 20,000;11;2;9;0;0;0
1084560;Cumulus;;0 - 20,000;1;0;1;0;0;0
1084570;The Lar;;100,000 - 200,000;874;44;830;0;0;1
1084600;My Time at Sandrock;;500,000 - 1,000,000;10470;1465;9005;1274;1062;903
1084640;Chicken Police - Paint it RED!;;100,000 - 200,000;1552;71;1481;318;414;8
1084710;Climbros;;0 - 20,000;16;2;14;0;0;0
1084770;Gregor Hills Haunted Hospital;;0 - 20,000;7;5;2;0;0;0
1084790;WarPlan;;0 - 20,000;128;29;99;0;0;7
1084840;Living Dead;;0 - 20,000;8;2;6;0;0;0
1084870;OSK - The End of Time;;0 - 20,000;50;32;18;0;0;0
1084870;OSK - The End of Time;;0 - 20,000;50;32;18;0;0;0
1084880;Ritbone;;0 - 20,000;1;1;0;0;0;0
1084910;Dark Skeleton Survival;;0 - 20,000;2;0;2;0;0;0
1084920;Fatal Evidence: Cursed Island Collector's Edition;;0 - 20,000;8;0;8;0;0;0
1084930;Sack of Bots;;0 - 20,000;14;1;13;0;0;0
1084970;Bridge Builder Racer;;0 - 20,000;10;2;8;0;0;0
1084980;Front Lines;;50,000 - 100,000;157;69;88;0;0;0
1084990;Old Gods Rising;;0 - 20,000;86;29;57;2749;2749;0
1085010;Make a Killing;;0 - 20,000;12;7;5;0;0;0
1085070;Strawhart;;0 - 20,000;13;1;12;0;0;1
1085080;Tiger Tank 59 Ⅰ Volcano;;0 - 20,000;1;3;-2;0;0;0
1085150;Golf Defied;;0 - 20,000;73;39;34;0;0;0
1085160;Palmyra Orphanage;;20,000 - 50,000;546;63;483;153;153;2
1085180;Gunvolt Chronicles: Luminous Avenger iX;;20,000 - 50,000;571;59;512;150;150;6
1085190;Black Baron;;0 - 20,000;18;11;7;0;0;0
1085210;Fruit Mess;;0 - 20,000;1;3;-2;0;0;0
1085230;Zumou Battoru;;0 - 20,000;1;0;1;0;0;0
1085240;Park assault;;0 - 20,000;6;6;0;0;0;0
1085260;Ports of Call Classic;;0 - 20,000;49;6;43;0;0;9
1085270;Fat Prisoner Simulator 2;;20,000 - 50,000;90;37;53;0;0;0
1085280;Buoyant;;0 - 20,000;8;1;7;0;0;0
1085340;Flandre's dream.  - 36000 ft deep -;;0 - 20,000;52;3;49;0;0;0
1085390;Angler's Life;;0 - 20,000;12;6;6;0;0;0
1085510;Garfield Kart - Furious Racing;;200,000 - 500,000;10408;1395;9013;112;79;41
1085520;Offroad Racing - Buggy X ATV X Moto;;0 - 20,000;42;39;3;0;0;1
1085540;Purple Noise Echo;;0 - 20,000;2;0;2;0;0;0
1085570;Fables of Talumos;;0 - 20,000;8;0;8;0;0;0
1085630;VASARA Collection;;20,000 - 50,000;105;17;88;0;0;0
1085660;Destiny 2;;20,000,000 - 50,000,000;433951;86349;347602;8267;351;82425
1085730;Breach Point;;0 - 20,000;0;1;-1;0;0;0
1085790;Forever Someday;;0 - 20,000;14;0;14;0;0;0
1085800;Zenkat;;0 - 20,000;0;1;-1;0;0;0
1085820;Au fil de l'eau;;0 - 20,000;2;2;0;0;0;0
1085840;World Leader Card Game;;20,000 - 50,000;3;2;1;0;0;0
1085840;World Leader Card Game;;20,000 - 50,000;3;2;1;0;0;0
1085880;Eclipse Horde;;0 - 20,000;7;0;7;0;0;0
1085880;Eclipse Horde;;0 - 20,000;7;0;7;0;0;0
1085900;PING REDUX;;0 - 20,000;6;1;5;0;0;0
1085930;Light Tracer 2 ~The Two Worlds~;;0 - 20,000;15;5;10;0;0;0
1085940;Orders Of The Ruler;;0 - 20,000;1;4;-3;0;0;0
1085990;XEYYEX;;0 - 20,000;36;3;33;0;0;0
1086010;198X;;20,000 - 50,000;1358;442;916;76;113;1
1086030;Dating Life: Miley X Emily;;0 - 20,000;38;13;25;2;2;0
1086060;Tunnel Vision;;0 - 20,000;4;1;3;0;0;0
1086140;Weaving;;0 - 20,000;3;0;3;0;0;0
1086160;Space War: Infinity;;0 - 20,000;90;9;81;0;0;0
1086180;Vestige of the Past;;0 - 20,000;4;1;3;0;0;0
1086240;Offscreen Colonies: VR Edition;;0 - 20,000;22;0;22;0;0;0
1086250;Civitas Nova;;0 - 20,000;2;1;1;0;0;0
1086260;Deck Box Dungeons;;20,000 - 50,000;3;2;1;0;0;0
1086270;Space BloX;;0 - 20,000;1;1;0;0;0;0
1086410;Golf Around!;;20,000 - 50,000;904;49;855;288;292;20
1086450;Oik Memory: Endgame;;0 - 20,000;54;3;51;0;0;0
1086450;Oik Memory: Endgame;;0 - 20,000;54;3;51;0;0;0
1086460;Supermarket Shriek;;0 - 20,000;20;2;18;0;0;0
1086470;996的真实老板篇;;0 - 20,000;41;15;26;0;0;1
1086490;First Customer;;0 - 20,000;3;5;-2;0;0;0
1086630;Spelling Quest Online;;20,000 - 50,000;9;1;8;0;0;0
1086640;Dude Simulator 3;;200,000 - 500,000;1331;640;691;108;109;2
1086670;Roll+Heart;;0 - 20,000;1;0;1;0;0;0
1086680;Violet rE:-The Final reExistence-;;0 - 20,000;114;27;87;0;0;0
1086690;C-War 2;;0 - 20,000;4;8;-4;0;0;0
1086750;Flux Caves;;0 - 20,000;59;7;52;0;0;0
1086820;End of Realms;;0 - 20,000;4;2;2;0;0;0
1086840;Operation Sniff;;0 - 20,000;57;13;44;0;0;0
1086850;Garden of the Sea;;0 - 20,000;514;37;477;191;191;7
1086860;TOUHOU SKY ARENA MATSURI CLIMAX;;0 - 20,000;148;16;132;0;0;1
1086900;Houdini Redux;;0 - 20,000;8;0;8;0;0;0
1086920;Gallery in a Box;;0 - 20,000;4;1;3;0;0;0
1086940;Baldur's Gate 3;;2,000,000 - 5,000,000;50079;7257;42822;2111;1044;2684
1086970;Battle Bruise 2;;0 - 20,000;21;5;16;0;0;1
1086980;Nebulas Lasso;;0 - 20,000;1;0;1;0;0;0
1086990;Commander '85;;0 - 20,000;9;17;-8;0;0;0
1087020;Neko Jump;;0 - 20,000;13;7;6;0;0;0
1087040;Alien invasion;;0 - 20,000;1;8;-7;0;0;0
1087050;Mondrian - Plastic Reality;;0 - 20,000;6;0;6;0;0;0
1087060;Duncan and the Wisp;;0 - 20,000;33;6;27;0;0;0
1087070;Poly Fishing;;0 - 20,000;0;1;-1;0;0;0
1087080;Critical Compendium;;0 - 20,000;59;5;54;0;0;2
1087100;The Last Cowboy;;0 - 20,000;9;12;-3;0;0;0
1087110;Football School;;0 - 20,000;61;21;40;0;0;0
1087270;Franchise Hockey Manager 6;;0 - 20,000;259;71;188;0;0;9
1087280;Out of the Park Baseball 21;;50,000 - 100,000;1530;138;1392;0;0;56
1087310;DOOMTANK;;20,000 - 50,000;3;0;3;0;0;0
1087320;"Smithsonian American Art Museum ""Beyond The Walls""";;0 - 20,000;37;12;25;0;0;0
1087330;Royal Merchant;;0 - 20,000;29;16;13;0;0;0
1087440;Jay and Silent Bob: Mall Brawl;;0 - 20,000;48;10;38;0;0;0
1087460;Super Life (RPG);;20,000 - 50,000;426;41;385;975;1113;8
1087480;Knighty Night;;0 - 20,000;9;2;7;0;0;0
1087500;Groundhog Day: Like Father Like Son;;0 - 20,000;68;19;49;0;0;0
1087530;Crazy World;;0 - 20,000;0;3;-3;0;0;0
1087600;FINAL ARCHER VR;;0 - 20,000;13;10;3;0;0;0
1087610;Red Death: 8Feet;;0 - 20,000;4;0;4;0;0;0
1087620;Life In Yima / 依玛村生活;;0 - 20,000;14;2;12;0;0;0
1087700;Corpse Killer - 25th Anniversary Edition;;0 - 20,000;29;10;19;0;0;0
1087720;Your Island -KIMI NO SIMA-;;0 - 20,000;79;19;60;0;0;4
1087730;Iron Blade: Medieval RPG;;50,000 - 100,000;100;55;45;3;3;1
1087760;The Gunk;;0 - 20,000;378;66;312;0;0;0
1087760;The Gunk;;0 - 20,000;378;66;312;0;0;0
1087770;Card Throw VR;;0 - 20,000;0;1;-1;0;0;0
1087780;STURMWIND EX;;0 - 20,000;29;7;22;0;0;0
1087800;Arranged;;0 - 20,000;12;3;9;0;0;0
1087810;Forgetful Dictator;;0 - 20,000;52;4;48;0;0;0
1087910;Mountain Rescue Simulator;;0 - 20,000;3;6;-3;0;0;0
1087940;Incredible Dracula 3: Family Secret;;0 - 20,000;21;0;21;0;0;0
1087950;.fall;;0 - 20,000;9;4;5;0;0;0
1087960;《鬼畜战记：金坷垃传说》;;50,000 - 100,000;97;12;85;0;0;0
1087970;Nevrosa: Spider Song;;0 - 20,000;25;7;18;0;0;0
1088010;WW2 Zombie Range VR;;0 - 20,000;3;3;0;0;0;0
1088040;MMA Executive;;0 - 20,000;5;5;0;0;0;0
1088060;WarpZone vs THE DIMENSION;;0 - 20,000;9;1;8;0;0;0
1088070;HUNTERS FOR YOUR BRAIN;;0 - 20,000;17;8;9;0;0;0
1088090;Day of Dragons;;200,000 - 500,000;3198;1311;1887;16054;23918;524
1088110;Meowk and Frocco;;0 - 20,000;2;3;-1;0;0;0
1088130;Sextris Effect;;0 - 20,000;2;11;-9;0;0;0
1088150;Scribble It!;;1,000,000 - 2,000,000;5669;926;4743;185;85;238
1088160;Led It Rain VR;;0 - 20,000;18;6;12;0;0;0
1088420;Wings Of Bluestar;;0 - 20,000;50;4;46;0;0;1
1088440;The Panel Remake;;20,000 - 50,000;4;1;3;0;0;0
1088590;love love love;;0 - 20,000;171;60;111;14;18;0
1088600;Space Mercs;;0 - 20,000;32;12;20;0;0;0
1088630;萌萌２次大戰（略）３ Moe Moe World War II-3;;0 - 20,000;23;6;17;0;0;0
1088710;Yakuza 3 Remastered;;500,000 - 1,000,000;4176;986;3190;1366;1501;174
1088720;All Evil Night 2;;0 - 20,000;2;2;0;0;0;0
1088750;Soda Story - Brewing Tycoon;;0 - 20,000;52;3;49;0;0;2
1088770;Car Mechanic Simulator VR;;0 - 20,000;157;104;53;69;69;7
1088790;Rebel Inc: Escalation;;100,000 - 200,000;3957;776;3181;197;223;163
1088800;Horror Ville Maze Escape;;0 - 20,000;0;2;-2;0;0;0
1088850;Marvel's Guardians of the Galaxy;;200,000 - 500,000;24130;1300;22830;1048;1104;199
1088870;奇幻与砍杀 Fantasy & Blade;;20,000 - 50,000;171;51;120;314;314;0
1088880;Пацанский цитатник / Russian Test;;0 - 20,000;51;28;23;0;0;0
1088910;DestructoPod;;0 - 20,000;2;0;2;0;0;0
1088950;Touring Karts;;0 - 20,000;99;26;73;8;8;5
1088950;Touring Karts;;0 - 20,000;99;26;73;8;8;5
1088960;PsycoCat;;0 - 20,000;4;1;3;0;0;0
1088980;Energy Hunter Boy;;0 - 20,000;0;1;-1;0;0;0
1089000;Wing Pro 7;;0 - 20,000;13;1;12;0;0;0
1089030;The Prophecy Lies!;;0 - 20,000;7;0;7;0;0;0
1089050;Speakerman;;0 - 20,000;7;1;6;0;0;0
1089080;Superstar Hero;;50,000 - 100,000;11;8;3;0;0;0
1089090;ONE PIECE: PIRATE WARRIORS 4;;500,000 - 1,000,000;11854;1034;10820;1731;1305;345
1089100;Power Block;;0 - 20,000;0;1;-1;0;0;0
1089110;Musasabi;;0 - 20,000;22;1;21;0;0;0
1089130;Quake II RTX;;500,000 - 1,000,000;3467;467;3000;0;0;19
1089140;Stroke Fill;;0 - 20,000;8;3;5;0;0;0
1089290;Truefish;;0 - 20,000;2;2;0;0;0;0
1089310;Nordlicht;;0 - 20,000;103;20;83;0;0;0
1089330;Life Hutch VR;;0 - 20,000;3;6;-3;0;0;0
1089350;NBA 2K20;;5,000,000 - 10,000,000;30507;30406;101;7537;2363;931
1089520;Nigel: The Minuscule Adventure;;20,000 - 50,000;1;0;1;0;0;0
1089570;AO Tennis 2 Tools;;0 - 20,000;15;14;1;3;3;0
1089590;Ashes 2;;0 - 20,000;17;6;11;0;0;0
1089600;LYSER;;0 - 20,000;59;4;55;0;0;0
1089630;奇迹一刻 Surmount;;20,000 - 50,000;1244;87;1157;37;37;6
1089640;Devellage;;0 - 20,000;2;2;0;0;0;0
1089650;Project Zero Deaths;;100,000 - 200,000;422;116;306;0;0;0
1089660;Queen's Quest 5: Symphony of Death;;0 - 20,000;88;24;64;0;0;2
1089710;Fruit Postal Service;;100,000 - 200,000;1044;371;673;0;0;1
1089760;Mini Transport;;0 - 20,000;16;5;11;0;0;0
1089770;Isotiles 2;;0 - 20,000;15;0;15;0;0;0
1089780;Tales Of Glory 2 - Retaliation;;0 - 20,000;149;49;100;129;129;1
1089790;Winter Resort Simulator;;20,000 - 50,000;690;168;522;2373;2373;9
1089800;Axan Ships;;0 - 20,000;0;1;-1;0;0;0
1089810;下一层的封魔塔 Forever War;;20,000 - 50,000;88;39;49;0;0;1
1089820;Reanimation Inc.;;0 - 20,000;84;15;69;0;0;1
1089830;Monster Energy Supercross - The Official Videogame 3;;20,000 - 50,000;954;132;822;2621;3752;39
1089840;Armored Brigade;;0 - 20,000;250;24;226;0;0;5
1089860;Blautopf VR - Geheimnis der Lau;;0 - 20,000;41;9;32;0;0;0
1089880;Sudoku 9x16x25;;0 - 20,000;7;3;4;0;0;0
1089930;Aeon Must Die!;;0 - 20,000;52;32;20;0;0;2
1089980;The Henry Stickmin Collection;;1,000,000 - 2,000,000;35256;470;34786;301;310;194
1090020;JETBOY;;0 - 20,000;11;1;10;0;0;0
1090030;Asteroid Run: No Questions Asked;;0 - 20,000;26;2;24;0;0;1
1090060;Weapon Hacker;;0 - 20,000;31;2;29;0;0;0
1090100;Scorchlands;;0 - 20,000;37;1;36;0;0;12
1090190;Winds of Change - The Opening Act;;20,000 - 50,000;64;9;55;0;0;0
1090250;Crunch Element;;20,000 - 50,000;322;129;193;0;0;1
1090340;Asteroid Invaders;;0 - 20,000;1;0;1;0;0;0
1090350;Animal Notes;;0 - 20,000;1;0;1;0;0;0
1090370;Aozora Under Girls - Karisome Irony;;0 - 20,000;4;0;4;0;0;0
1090380;Lilith-M;;0 - 20,000;4;0;4;0;0;0
1090390;House of 1000 Doors: Serpent Flame;;0 - 20,000;70;10;60;0;0;0
1090420;Astralojia: Episode 1;;0 - 20,000;10;2;8;0;0;0
1090440;Kelipot;;20,000 - 50,000;629;116;513;2542;2542;2
1090470;New England Detective: Breakfast in Boston;;0 - 20,000;17;10;7;0;0;0
1090490;Tiktalec And The Dino Moonbase;;20,000 - 50,000;1;0;1;0;0;0
1090520;Scenner;;0 - 20,000;2;3;-1;0;0;0
1090540;Tiger Tank 59 Ⅰ Air Strike;;0 - 20,000;1;5;-4;0;0;0
1090560;Boy VS Genius 贫穷少年与校园名人的生死对决;;0 - 20,000;89;16;73;0;0;0
1090580;Gamehunt;;50,000 - 100,000;13;5;8;0;0;0
1090590;AlCHeMoS;;0 - 20,000;16;0;16;0;0;0
1090630;Granblue Fantasy: Versus;;100,000 - 200,000;5156;1108;4048;544;688;273
1090650;Unknown Castle;;0 - 20,000;6;0;6;0;0;0
1090660;MOK: Super Space Taxi;;0 - 20,000;2;1;1;0;0;0
1090670;Orbi Universo;;20,000 - 50,000;140;49;91;1125;1125;5
1090670;Orbi Universo;;20,000 - 50,000;140;49;91;1125;1125;5
1090680;Effigy : The Descent;;0 - 20,000;7;0;7;0;0;0
1090690;Sapper;;0 - 20,000;4;0;4;0;0;0
1090700;Lights Orb;;0 - 20,000;9;0;9;0;0;0
1090760;Distant Kingdoms;;20,000 - 50,000;133;161;-28;0;0;0
1090790;Magicolors;;20,000 - 50,000;37;3;34;0;0;0
1090800;Northern Lights;;0 - 20,000;170;79;91;0;0;1
1090920;Gubble;;0 - 20,000;35;0;35;0;0;0
1090930;Endless RPG;;0 - 20,000;37;8;29;0;0;0
1090940;BLAST-AXIS;;0 - 20,000;13;1;12;0;0;0
1090960;DunkRatz;;0 - 20,000;4;0;4;0;0;0
1091010;Dark Swords;;50,000 - 100,000;170;90;80;0;0;22
1091030;LithoBreak;;0 - 20,000;4;1;3;0;0;0
1091040;Sougetsu Ninja: Kikyou;;0 - 20,000;18;2;16;0;0;0
1091090;They Are Beasts;;0 - 20,000;25;14;11;0;0;0
1091100;Devil_catching_bees;;0 - 20,000;0;3;-3;0;0;0
1091110;Night of the Scarecrows;;0 - 20,000;9;5;4;0;0;0
1091170;Face Your Demons;;0 - 20,000;14;5;9;0;0;0
1091180;Shadowland;;0 - 20,000;9;1;8;0;0;0
1091190;Web Spice Purple World;;0 - 20,000;5;5;0;0;0;0
1091210;Kissing Simulator;;0 - 20,000;62;24;38;0;0;0
1091220;Wavelength;;0 - 20,000;0;3;-3;0;0;0
1091240;LOCO Railroad;;0 - 20,000;10;4;6;0;0;0
1091250;Total Party Kill;;0 - 20,000;132;7;125;0;0;1
1091260;Crunch;;0 - 20,000;12;1;11;0;0;0
1091270;Frequency Garden;;0 - 20,000;14;4;10;0;0;0
1091320;DEPO : Death Epileptic Pixel Origins;;100,000 - 200,000;101;7;94;0;0;2
1091350;Valley Run;;0 - 20,000;1;2;-1;0;0;0
1091380;Dain Squares;;0 - 20,000;10;0;10;0;0;0
1091390;Demonizer;;0 - 20,000;31;3;28;0;0;0
1091400;Online Simulator;;0 - 20,000;34;7;27;0;0;0
1091460;剑魄 JianPo;;0 - 20,000;432;122;310;116;116;0
1091470;Put In - Run Out;;0 - 20,000;76;14;62;0;0;0
1091500;Cyberpunk 2077;;20,000,000 - 50,000,000;465100;132286;332814;3650;2557;15471
1091520;鸿门一宴(Malicious Dinner);;0 - 20,000;10;4;6;0;0;0
1091570;Transporter Truck Simulator;;0 - 20,000;33;12;21;0;0;0
1091580;GameDevVR;;0 - 20,000;10;7;3;0;0;0
1091640;Paths Taken;;0 - 20,000;76;22;54;0;0;0
1091650;XMagicMouse;;20,000 - 50,000;49;35;14;0;0;2
1091670;Absolute Fall;;0 - 20,000;2;1;1;0;0;0
1091720;叙事曲：难忘的回忆 / Ballade: with Memories;;0 - 20,000;43;2;41;0;0;0
1091910;PonGlow;;0 - 20,000;12;2;10;0;0;0
1091960;Drowning Cross;;20,000 - 50,000;161;14;147;0;0;0
1091970;MEDICALHOLODECK PRO FREE TRIAL | FULL FEATURES FOR 30 DAYS | Medical Virtual Reality | Medical VR | DICOM Viewer;;0 - 20,000;8;4;4;0;0;0
1091980;The Bard's Tale IV: Director's Cut;;20,000 - 50,000;790;237;553;54;61;15
1092040;BOMJMAN;;20,000 - 50,000;498;123;375;46;62;1
1092050;Fire On Fight : Online Multiplayer Shooter;;0 - 20,000;15;5;10;0;0;1
1092060;Hiscores! Gold;;0 - 20,000;7;1;6;0;0;0
1092070;Pencil vs. Eraser;;0 - 20,000;1;0;1;0;0;0
1092080;Pet Puzzle;;0 - 20,000;0;4;-4;0;0;0
1092140;Exit From;;50,000 - 100,000;444;56;388;18;18;0
1092150;DrainLive;;20,000 - 50,000;56;18;38;0;0;0
1092180;Vollun;;0 - 20,000;2;1;1;0;0;0
1092190;Astonishing Baseball 2019;;0 - 20,000;1;3;-2;0;0;0
1092260;Come on Baby!;;0 - 20,000;54;13;41;165;165;0
1092270;Hunt the Thailand Hidden;;0 - 20,000;6;1;5;0;0;0
1092270;Hunt the Thailand Hidden;;0 - 20,000;6;1;5;0;0;0
1092300;Drone Racer;;0 - 20,000;0;4;-4;0;0;0
1092400;月球坠落时 Moon Fall;;20,000 - 50,000;657;68;589;1051;1082;0
1092430;Budget Cuts 2: Mission Insolvency;;100,000 - 200,000;350;86;264;7;13;6
1092500;AQUARYOUNS World;;0 - 20,000;22;19;3;0;0;0
1092510;Incredible Dracula 4: Games Of Gods;;0 - 20,000;14;3;11;0;0;0
1092580;Bikerz;;0 - 20,000;2;2;0;0;0;0
1092590;沙雕之路;;50,000 - 100,000;903;31;872;57;57;1
1092630;Rogue Glitch;;50,000 - 100,000;1060;65;995;278;396;15
1092650;GraFi 2;;0 - 20,000;16;9;7;0;0;0
1092660;Blair Witch;;500,000 - 1,000,000;4337;1227;3110;359;383;10
1092700;Hello Neighbor Pre-Alpha;;100,000 - 200,000;955;97;858;21;19;16
1092710;Hello Neighbor Alpha 1;;100,000 - 200,000;1745;149;1596;48;61;29
1092720;Hello Neighbor Alpha 2;;200,000 - 500,000;2083;120;1963;33;29;28
1092730;Hello Neighbor Alpha 3;;200,000 - 500,000;732;158;574;22;24;15
1092750;Boon Boon;;0 - 20,000;6;3;3;0;0;0
1092760;Story in the Dream World -Volcano And Possession-;;0 - 20,000;2;0;2;0;0;0
1092780;Depixtion;;0 - 20,000;50;3;47;0;0;2
1092790;Inscryption;;2,000,000 - 5,000,000;83568;2504;81064;890;625;1202
1092800;Summit of the Wolf;;0 - 20,000;18;0;18;0;0;0
1092830;Coffee Runner Black and Mocha;;0 - 20,000;2;0;2;0;0;0
1092850;Zeus Begins;;0 - 20,000;11;1;10;0;0;0
1092950;Piposh;;0 - 20,000;113;7;106;0;0;1
1092980;Mountain Taxi Driver;;0 - 20,000;190;61;129;0;0;0
1093120;Box Labyrinth;;0 - 20,000;3;0;3;0;0;0
1093130;Ms. Holmes: The Monster of the Baskervilles Collector's Edition;;0 - 20,000;21;2;19;0;0;0
1093150;Just Sleep - Meditate, Focus, Relax;;0 - 20,000;17;4;13;0;0;0
1093170;Monstrum 2;;50,000 - 100,000;297;235;62;0;0;2
1093220;Eat this!;;0 - 20,000;1;1;0;0;0;0
1093280;Ancient Stories: Gods of Egypt;;0 - 20,000;4;3;1;0;0;1
1093290;The Wild at Heart;;0 - 20,000;349;14;335;14;14;8
1093300;NOYO-!;;0 - 20,000;26;4;22;0;0;0
1093310;Reebyte : Visual Novel and Interactive App Maker;;0 - 20,000;3;7;-4;0;0;0
1093320;Devil's Deck;;0 - 20,000;186;83;103;0;0;3
1093330;Conscious Existence - A Journey Within;;20,000 - 50,000;502;69;433;0;0;0
1093340;Thailand VR Gallery;;0 - 20,000;6;0;6;0;0;0
1093360;Ghost Parade;;0 - 20,000;24;9;15;0;0;0
1093370;Hexelectric;;0 - 20,000;10;1;9;0;0;0
1093670;ATTACK OF THE EVIL POOP;;0 - 20,000;35;4;31;0;0;0
1093690;Couch Storm: Battle Royale;;0 - 20,000;1;0;1;0;0;0
1093720;SlipSlop: World's Hardest Platformer Game;;100,000 - 200,000;1449;315;1134;0;0;0
1093750;John's Wizard Dungeon;;0 - 20,000;7;2;5;0;0;0
1093760;Shogun's Empire: Hex Commander;;20,000 - 50,000;41;13;28;0;0;0
1093770;Chlorophos;;0 - 20,000;1;0;1;0;0;0
1093790;Seals of the Bygone;;0 - 20,000;67;11;56;0;0;3
1093800;Zeke's Peak;;0 - 20,000;19;1;18;0;0;0
1093830;Asterism;;0 - 20,000;1;2;-1;0;0;0
1093840;NiGHT SIGNAL;;0 - 20,000;21;5;16;0;0;1
1093850;JoustMania;;0 - 20,000;10;1;9;0;0;0
1093870;Block;;0 - 20,000;8;1;7;0;0;0
1093880;XWallpaper;;50,000 - 100,000;75;75;0;0;0;8
1093900;神谋;;0 - 20,000;13;3;10;0;0;0
1093910;Tales of the Black Forest;;100,000 - 200,000;8936;179;8757;263;291;17
1093920;ORTHOISO;;0 - 20,000;27;1;26;0;0;0
1093950;Inbound UFO;;0 - 20,000;4;2;2;0;0;0
1094000;Survive on Raft;;50,000 - 100,000;512;311;201;0;0;6
1094010;火柴人联盟2;;20,000 - 50,000;17;12;5;0;0;0
1094020;天下往事 Journey of the world;;0 - 20,000;3;1;2;0;0;0
1094030;Lurk in the Dark : Prologue;;200,000 - 500,000;1575;186;1389;0;0;8
1094050;INTERSTELLAR ROGUE;;0 - 20,000;21;7;14;0;0;0
1094060;Escape First 2;;20,000 - 50,000;146;111;35;177;177;2
1094070;Fares;;0 - 20,000;9;1;8;0;0;0
1094080;Valley of Decay;;20,000 - 50,000;70;35;35;0;0;0
1094110;WEJAM;;0 - 20,000;10;3;7;0;0;0
1094120;Bepuzzled Puppy Dog Jigsaw Puzzle;;0 - 20,000;1;0;1;0;0;0
1094130;Bugs!;;0 - 20,000;5;2;3;0;0;0
1094170;The Hunter's Journals - Pale Harbour;;0 - 20,000;5;0;5;0;0;0
1094190;故郷をさがす三姉妹/ The Three Sisters looking for their back home.;;0 - 20,000;2;3;-1;0;0;0
1094250;It Stares Back;;0 - 20,000;84;2;82;0;0;0
1094290;幻想异乡曲 Butterfly~Rin;;0 - 20,000;38;5;33;0;0;0
1094320;莫比乌斯之环-不属于任何人的交响悲歌-MOBIUS & ELEGY BELONGS TO NOBODY;;0 - 20,000;207;80;127;0;0;0
1094340;Cardboard Ground;;0 - 20,000;18;2;16;0;0;0
1094390;Waltz of the Wizard: Natural Magic;;0 - 20,000;205;22;183;168;278;2
1094400;Twin Ruin;;0 - 20,000;15;2;13;0;0;0
1094410;B.U.G. Force;;0 - 20,000;1;0;1;0;0;0
1094420;Rainy Season;;0 - 20,000;409;22;387;81;142;0
1094440;Highball;;0 - 20,000;3;1;2;0;0;0
1094460;Tiger Tank 59 Ⅰ Battleship;;0 - 20,000;2;3;-1;0;0;0
1094520;Sands of Salzaar;;500,000 - 1,000,000;17379;3397;13982;843;750;527
1094530;ALIA’s CARNIVAL！;;0 - 20,000;476;18;458;1167;1355;3
1094540;Smelter;;0 - 20,000;130;47;83;0;0;1
1094580;Ecio;;0 - 20,000;23;12;11;0;0;0
1094590;Helvetii;;0 - 20,000;32;1;31;0;0;18
1094660;EBOLA;;0 - 20,000;53;75;-22;0;0;1
1094690;Imagination - Online Board game;;0 - 20,000;30;24;6;0;0;0
1094710;Royal Crown;;200,000 - 500,000;2228;1003;1225;227;152;0
1094730;Black Legend;;20,000 - 50,000;119;62;57;0;0;0
1094760;Stonedeep;;0 - 20,000;47;45;2;0;0;1
1094780;Fisher Online;;100,000 - 200,000;2455;345;2110;1422;1694;634
1094820;Adabana Odd Tales;;0 - 20,000;639;17;622;0;0;1
1094820;Adabana Odd Tales;;0 - 20,000;639;17;622;0;0;1
1094870;Acron: Attack of the Squirrels!;;0 - 20,000;142;9;133;0;0;3
1094880;Vegas Slot;;0 - 20,000;25;14;11;0;0;0
1094920;Hazel Sky;;20,000 - 50,000;115;30;85;0;0;3
1094930;Ninja Girl and the Mysterious Army of Urban Legend Monsters! ~Hunt of the Headless Horseman~;;0 - 20,000;50;6;44;0;0;0
1094960;Soul Scathe;;0 - 20,000;44;11;33;0;0;1
1095040;Unexplored 2: The Wayfarer's Legacy;;50,000 - 100,000;177;63;114;0;0;6
1095070;Sideral;;0 - 20,000;9;8;1;0;0;0
1095080;Back Home;;0 - 20,000;0;1;-1;0;0;0
1095090;The Remission of Sins;;0 - 20,000;6;4;2;0;0;0
1095120;Helheim Hassle;;0 - 20,000;185;14;171;0;0;1
1095140;PrimeOrbial;;0 - 20,000;4;0;4;0;0;0
1095200;CYNOROID -GENTAGELSE-;;0 - 20,000;7;1;6;0;0;0
1095260;Airtight City 密闭之城1.0;;20,000 - 50,000;368;10;358;29;29;1
1095260;Airtight City 密闭之城1.0;;20,000 - 50,000;368;10;358;29;29;1
1095280;Covid 2069;;0 - 20,000;0;2;-2;0;0;0
1095300;Tiger Tank 59 Ⅰ Super Tank;;0 - 20,000;2;3;-1;0;0;0
1095320;Revenge on the Streets;;0 - 20,000;16;1;15;0;0;0
1095360;Lost;;0 - 20,000;1;1;0;0;0;0
1095370;Voxel Bot;;0 - 20,000;16;2;14;0;0;1
1095380;Bepuzzled Kittens Jigsaw Puzzle;;0 - 20,000;7;2;5;0;0;0
1095400;Cryptographer;;0 - 20,000;1;0;1;0;0;0
1095450;Puzzle Walker (Demo);;0 - 20,000;25;11;14;0;0;0
1095460;Neko Match;;0 - 20,000;0;1;-1;0;0;0
1095520;The Itch;;0 - 20,000;84;10;74;0;0;0
1095540;原体;;0 - 20,000;3;1;2;0;0;0
1095550;Pumpkin Dog Islands;;0 - 20,000;5;1;4;0;0;0
1095590;方解夢異聞 ～ Avant-Garde Discerning Paralleler (東方二次創作STG);;0 - 20,000;7;3;4;0;0;0
1095650;Island 1979;;0 - 20,000;1;6;-5;0;0;0
1095680;Beyond the Wizard;;0 - 20,000;8;3;5;0;0;0
1095700;Joyfess Ep1: Martin's Secret Recipe;;0 - 20,000;21;3;18;0;0;0
1095710;Björk Vulnicura Virtual Reality Album;;0 - 20,000;16;4;12;0;0;0
1095750;Faith of Fate;;0 - 20,000;22;2;20;0;0;0
1095790;恋爱总动员/Love Date;;0 - 20,000;86;14;72;0;0;0
1095810;WhiteBird 白鸟;;0 - 20,000;2;0;2;0;0;0
1095820;Boogie Bot;;0 - 20,000;3;0;3;0;0;0
1095840;Fairytale Solitaire: Red Riding Hood;;0 - 20,000;10;1;9;0;0;0
1095850;1001 Jigsaw. 6 Magic Elements (拼图);;0 - 20,000;17;4;13;0;0;0
1095860;Mystery Solitaire Grimm's tales 2;;0 - 20,000;6;0;6;0;0;0
1095870;1001 Jigsaw. World Tour: France;;0 - 20,000;2;2;0;0;0;0
1096000;Too White Basketball;;0 - 20,000;18;8;10;0;0;0
1096010;Hentai Sudoku;;0 - 20,000;28;18;10;0;0;0
1096060;Teenage Blob;;0 - 20,000;132;3;129;0;0;0
1096100;Skellboy Refractured;;0 - 20,000;74;12;62;0;0;1
1096130;Rose Riddle 2: Werewolf Shadow;;0 - 20,000;12;1;11;0;0;0
1096140;Timemelters;;0 - 20,000;62;3;59;0;0;7
1096180;Ato;;0 - 20,000;252;6;246;0;0;0
1096200;The Orville - Interactive Fan Experience;;200,000 - 500,000;815;88;727;0;0;2
1096210;Mekabolt;;0 - 20,000;134;20;114;0;0;0
1096230;Decker;;0 - 20,000;5;2;3;0;0;0
1096240;7 Lives;;0 - 20,000;23;10;13;0;0;0
1096290;Real Man Got 100 |  是男人上100层;;20,000 - 50,000;5;0;5;0;0;0
1096300;九霄缳神记 JIU XIAO;;20,000 - 50,000;284;194;90;0;0;0
1096310;Bombrigade: Battlegrounds;;0 - 20,000;11;10;1;0;0;0
1096330;兽耳攻略 - TFK Faculty;;0 - 20,000;53;5;48;0;0;1
1096340;NOXIAM -miserable sinners-;;0 - 20,000;2;2;0;0;0;0
1096360;Fate of WINDSHIFT;;100,000 - 200,000;22;3;19;0;0;0
1096410;Vampire: The Masquerade - Coteries of New York;;50,000 - 100,000;1712;614;1098;185;185;19
1096420;Re Painter;;0 - 20,000;16;1;15;0;0;0
1096510;Seven Nations;;0 - 20,000;10;10;0;0;0;0
1096530;Solasta: Crown of the Magister;;1,000,000 - 2,000,000;13407;1739;11668;1403;1914;1351
1096540;XMagicTyping;;0 - 20,000;14;13;1;0;0;1
1096550;Desktop Magic Engine;;200,000 - 500,000;583;209;374;1811;623;27
1096560;Windy Kingdom;;20,000 - 50,000;63;66;-3;480;480;0
1096570;SONG OF HORROR COMPLETE EDITION;;100,000 - 200,000;992;215;777;276;436;21
1096590;Atma;;100,000 - 200,000;524;53;471;0;0;0
1096600;Quash;;0 - 20,000;6;1;5;0;0;0
1096610;Incident Commander;;0 - 20,000;41;34;7;0;0;0
1096630;Space Mercenary Shooter : Episode 1;;0 - 20,000;7;6;1;0;0;0
1096650;CUBG: Car Unknown's Battlegrounds;;0 - 20,000;1;1;0;0;0;0
1096690;Mighty Fight Federation;;0 - 20,000;44;7;37;0;0;0
1096710;Hello Neighbor Alpha 4;;200,000 - 500,000;2471;354;2117;71;66;68
1096720;CATGIRL LOVER;;50,000 - 100,000;709;206;503;56;70;0
1096750;Girls & Dungeons 2;;0 - 20,000;3;1;2;0;0;0
1096900;RPG Maker MZ;;50,000 - 100,000;948;207;741;1119;1255;647
1096930;Strategic Command: World War I;;0 - 20,000;289;24;265;0;0;55
1096950;Psycho Train;;0 - 20,000;15;8;7;0;0;1
1096960;Amazing: A House In Kansas VR;;0 - 20,000;2;1;1;0;0;0
1096980;Timothy and the Mysterious Forest;;0 - 20,000;10;4;6;0;0;0
1097000;Orpheus's Dream;;100,000 - 200,000;160;65;95;0;0;0
1097090;New Colony;;0 - 20,000;4;8;-4;0;0;0
1097100;Please, Touch The Artwork;;0 - 20,000;119;6;113;0;0;1
1097110;Willy Morgan and the Curse of Bone Town;;0 - 20,000;300;41;259;0;0;4
1097120;The Scream;;20,000 - 50,000;113;20;93;0;0;0
1097130;Circuit Superstars;;200,000 - 500,000;1436;195;1241;263;524;12
1097150;Fall Guys: Ultimate Knockout;;20,000,000 - 50,000,000;385198;88678;296520;1120;525;2888
1097160;Run Roll Rumble;;0 - 20,000;7;1;6;0;0;0
1097170;Backspace Bouken;;0 - 20,000;57;4;53;0;0;0
1097180;Time Travelling Navy Seal Ninja Warrior;;0 - 20,000;18;4;14;0;0;0
1097200;Twelve Minutes;;200,000 - 500,000;4504;1644;2860;358;377;17
1097210;WoMen in Science;;0 - 20,000;52;13;39;0;0;0
1097240;Crawling Of The Dead;;0 - 20,000;36;18;18;0;0;0
1097270;Forgotten;;0 - 20,000;9;8;1;0;0;0
1097280;Chimeras: Wailing Waters Collector's Edition;;0 - 20,000;3;1;2;0;0;1
1097300;Ostrofa;;20,000 - 50,000;48;29;19;0;0;0
1097310;Night Sing;;0 - 20,000;108;53;55;0;0;0
1097330;Fork Knights;;0 - 20,000;12;4;8;0;0;0
1097340;Night & Day;;0 - 20,000;2;2;0;0;0;0
1097350;Weird West;;100,000 - 200,000;1946;550;1396;895;1140;27
1097400;Warhead Destined;;0 - 20,000;1;2;-1;0;0;0
1097420;No-brainer Heroes 挂机吧！勇者;;200,000 - 500,000;1218;348;870;7302;7628;45
1097430;Book of Yog Idle RPG;;500,000 - 1,000,000;4328;1227;3101;5290;7932;2269
1097470;Roopocket;;0 - 20,000;2;0;2;0;0;0
1097530;Mortal Glory;;50,000 - 100,000;442;59;383;478;478;24
1097550;王国幻境 fantastic kingdom;;0 - 20,000;31;12;19;0;0;0
1097570;The Hunter's Journals - Vile Philosophy;;0 - 20,000;4;0;4;0;0;0
1097580;CUSTOM ORDER MAID 3D2 It's a Night Magic;;50,000 - 100,000;1118;214;904;46;46;24
1097600;Hardcore Parkour;;0 - 20,000;1;4;-3;0;0;0
1097620;Fast and Low;;0 - 20,000;423;108;315;78;78;13
1097630;C.A.T.S. - Carefully Attempting not To Screw up;;0 - 20,000;2;0;2;0;0;0
1097650;Insectipede;;0 - 20,000;0;1;-1;0;0;0
1097670;Keeper of the Sun and Moon;;0 - 20,000;33;6;27;0;0;2
1097690;Gladiator: Road to the Colosseum;;0 - 20,000;3;8;-5;0;0;0
1097710;The Grim and I;;0 - 20,000;15;1;14;0;0;0
1097750;Ezaron Defense;;0 - 20,000;70;16;54;0;0;1
1097760;Uh Oh Bartender;;0 - 20,000;6;0;6;0;0;0
1097770;Aeolis Tournament;;0 - 20,000;71;15;56;0;0;0
1097780;We Met in May;;0 - 20,000;26;0;26;0;0;0
1097790;The Dark Crystal: Age of Resistance Tactics;;0 - 20,000;79;24;55;0;0;0
1097800;Stranger Things 3: The Game;;20,000 - 50,000;495;66;429;415;415;1
1097820;The Hunger: Games Ensemble;;0 - 20,000;54;6;48;0;0;0
1097820;The Hunger: Games Ensemble;;0 - 20,000;54;6;48;0;0;0
1097830;Banished Monsters;;0 - 20,000;1;0;1;0;0;0
1097840;Gears 5;;500,000 - 1,000,000;13735;6195;7540;1268;758;318
1097860;Corrupted;;0 - 20,000;1;0;1;0;0;0
1097870;Polyrun;;0 - 20,000;8;1;7;0;0;0
1097900;Everything is Mayo;;0 - 20,000;5;1;4;0;0;0
1097960;ClickRaid2;;0 - 20,000;82;38;44;0;0;0
1097960;ClickRaid2;;0 - 20,000;82;38;44;0;0;0
1098000;Rifle Storm;;0 - 20,000;6;2;4;0;0;0
1098040;Soulscape;;0 - 20,000;38;1;37;0;0;1
1098080;3000th Duel;;50,000 - 100,000;385;136;249;0;0;7
1098090;Bunny Reversi;;0 - 20,000;9;1;8;0;0;0
1098100;OhShape;;0 - 20,000;216;53;163;0;0;3
1098140;Drawing Path;;0 - 20,000;9;4;5;0;0;0
1098150;Trickster VR: Horde Attack!;;20,000 - 50,000;43;16;27;0;0;0
1098170;Dark Nights with Poe and Munro;;50,000 - 100,000;292;78;214;0;0;2
1098190;VersaillesVR | the Palace is yours;;50,000 - 100,000;85;30;55;0;0;0
1098200;Vaporwave Drift;;0 - 20,000;25;19;6;0;0;0
1098210;Axis Football 2019;;0 - 20,000;81;35;46;0;0;0
1098220;Making it Home;;0 - 20,000;28;1;27;0;0;0
1098230;Eidolon adventure;;20,000 - 50,000;0;1;-1;0;0;0
1098250;Grid Magic;;0 - 20,000;3;0;3;0;0;0
1098270;ColdSide;;20,000 - 50,000;300;81;219;319;319;1
1098280;Mago;;20,000 - 50,000;465;23;442;0;0;12
1098292;DOOM Eternal: The Ancient Gods - Part One;;200,000 - 500,000;3651;1483;2168;0;0;0
1098293;DOOM Eternal: The Ancient Gods - Part Two;;200,000 - 500,000;2625;1583;1042;0;0;0
1098340;Zup! 9;;50,000 - 100,000;1385;61;1324;157;165;2
1098360;Tank Nova;;0 - 20,000;1;0;1;0;0;0
1098370;Akash: Path of the Five;;0 - 20,000;104;8;96;0;0;0
1098390;Project Wasteland: The Mythiclands;;0 - 20,000;9;2;7;0;0;0
1098420;SpritePile;;0 - 20,000;56;4;52;0;0;0
1098430;DungeonEpic;;0 - 20,000;0;3;-3;0;0;0
1098440;Spider shooting bee;;0 - 20,000;4;2;2;0;0;0
1098470;The Gardener and the Wild Vines;;0 - 20,000;47;0;47;0;0;0
1098480;Fruit Factory;;0 - 20,000;5;0;5;0;0;0
1098490;Explore Fushimi Inari;;100,000 - 200,000;1332;76;1256;14;14;1
1098510;LOST EGG;;0 - 20,000;110;20;90;1;1;1
1098510;LOST EGG;;0 - 20,000;110;20;90;1;1;1
1098530;ZorroMoro;;0 - 20,000;1;7;-6;0;0;0
1098540;Monsters sandbox;;200,000 - 500,000;13;5;8;0;0;0
1098560;Dungeon Crusher Kiritan;;0 - 20,000;45;2;43;21;21;0
1098570;Layers Of The Machine;;0 - 20,000;1;2;-1;0;0;0
1098620;Matter of the Dreams;;0 - 20,000;2;3;-1;0;0;0
1098640;Eormor: Shattered Lands;;0 - 20,000;6;4;2;0;0;0
1098650;Madhouse;;0 - 20,000;1;1;0;0;0;0
1098660;NEKOPUGI;;0 - 20,000;5;0;5;0;0;0
1098670;CHAIN SAW;;0 - 20,000;10;15;-5;0;0;0
1098680;世界尽头的蔷薇花园;;0 - 20,000;38;6;32;0;0;0
1098700;Escape from Chernobyl;;0 - 20,000;37;9;28;0;0;0
1098720;Court of Ashes;;0 - 20,000;29;4;25;0;0;1
1098730;Cursed Roots;;0 - 20,000;9;1;8;0;0;0
1098760;The Ring of Truth;;0 - 20,000;13;10;3;0;0;0
1098790;Okay, Panic!;;0 - 20,000;7;10;-3;0;0;0
1098810;我们的房屋 OUR HOUSE;;0 - 20,000;5;4;1;0;0;0
1098840;ZACH-LIKE;;20,000 - 50,000;130;3;127;236;236;0
1098870;Metro Explosion Simulator;;0 - 20,000;8;10;-2;0;0;0
1098940;Home Sweet Home EP2;;100,000 - 200,000;665;218;447;0;0;2
1098980;ZomB;;0 - 20,000;2;3;-1;0;0;0
1099010;Bocce VR;;0 - 20,000;4;3;1;0;0;0
1099070;Legendary gun;;0 - 20,000;31;4;27;0;0;0
1099090;Outpost Delta;;0 - 20,000;7;2;5;0;0;1
1099110;愚者地牢-UP主的消失;;20,000 - 50,000;167;33;134;0;0;0
1099140;她3 : 复乐园之曦 Her3 : The Light of Paradise Regained;;0 - 20,000;44;3;41;0;0;0
1099170;Battle Planet - Judgement Day;;0 - 20,000;62;6;56;0;0;0
1099220;The Alien Cube;;20,000 - 50,000;224;44;180;0;0;0
1099400;唤境引擎 Evkworld;;50,000 - 100,000;33;14;19;0;0;0
1099410;A Total War Saga: TROY;;100,000 - 200,000;1624;626;998;1071;1769;298
1099440;Rude Racers: 2D Combat Racing;;0 - 20,000;83;14;69;0;0;0
1099450;The Endless White;;20,000 - 50,000;13;13;0;0;0;0
1099460;The Forgotten Land;;0 - 20,000;40;15;25;0;0;2
1099470;Karl BOOM;;0 - 20,000;2;1;1;0;0;0
1099500;The Curious Tale of the Stolen Pets;;0 - 20,000;231;23;208;0;0;3
1099550;3D Organon Anatomy;;20,000 - 50,000;36;35;1;0;0;28
1099630;Alive 2 Survive: Tales from the Zombie Apocalypse;;0 - 20,000;8;10;-2;0;0;0
1099640;Jack Move;;20,000 - 50,000;383;80;303;0;0;4
1099660;The Lattice Grimoire;;0 - 20,000;3;0;3;0;0;0
1099840;1000$;;0 - 20,000;30;18;12;0;0;0
1099920;Pro Strategy Football 2020;;0 - 20,000;27;7;20;0;0;0
1099960;Mini Tone - Minimalist Puzzle;;20,000 - 50,000;44;16;28;0;0;0
1100030;Iseshima mystery annai: Itsuwari no Kuro shinnjyu;;0 - 20,000;30;4;26;0;0;0
1100030;Iseshima mystery annai: Itsuwari no Kuro shinnjyu;;0 - 20,000;30;4;26;0;0;0
1100050;Perfect;;0 - 20,000;0;2;-2;0;0;0
1100070;Master of the Forbidden Sea;;0 - 20,000;1;1;0;0;0;0
1100140;Touhou Fuujinroku ~ Mountain of Faith.;;50,000 - 100,000;702;5;697;0;0;13
1100150;Touhou Chireiden ~ Subterranean Animism.;;50,000 - 100,000;369;11;358;3111;3111;2
1100160;Touhou Seirensen ~ Undefined Fantastic Object.;;20,000 - 50,000;219;6;213;0;0;2
1100170;Double Spoiler;;0 - 20,000;52;1;51;0;0;2
1100180;Yousei Daisensou ~ Touhou Sangetsusei;;0 - 20,000;79;1;78;0;0;2
1100200;Chibi Volleyball;;0 - 20,000;44;7;37;0;0;0
1100210;Everybody Loves Skeletons;;0 - 20,000;20;2;18;0;0;0
1100260;Circle Empires Rivals;;200,000 - 500,000;1317;150;1167;148;204;39
1100270;The Far Rings: A Space Opera Visual Novella;;0 - 20,000;58;11;47;0;0;0
1100300;Gamedev Beatdown;;0 - 20,000;28;5;23;0;0;0
1100350;#Funtime;;0 - 20,000;15;3;12;0;0;0
1100410;Commandos 2 - HD Remaster;;200,000 - 500,000;1038;858;180;18;18;44
1100420;Praetorians - HD Remaster;;20,000 - 50,000;679;66;613;0;0;22
1100430;Spirit Hunter: NG;;0 - 20,000;180;9;171;0;0;5
1100500;Last Contingency;;20,000 - 50,000;1;2;-1;0;0;0
1100510;Demo;;20,000 - 50,000;103;42;61;0;0;0
1100560;Drones;;0 - 20,000;2;0;2;0;0;0
1100600;Football Manager 2020;;5,000,000 - 10,000,000;28245;3438;24807;14128;9141;3828
1100620;Football Manager 2020 Touch;;100,000 - 200,000;879;128;751;6946;10426;97
1100840;Everyone Goes Home;;0 - 20,000;2;0;2;0;0;0
1100880;Battle Siege Royale;;0 - 20,000;1;1;0;0;0;0
1100900;Artifact Adventure Gaiden DX;;0 - 20,000;29;4;25;90;90;0
1100920;DrumMasterVR;;0 - 20,000;3;7;-4;0;0;0
1100930;LEGIONCRAFT;;20,000 - 50,000;1066;256;810;327;345;7
1100970;Dancing Girl;;100,000 - 200,000;697;348;349;16;18;0
1100990;Aimbeast;;200,000 - 500,000;1469;116;1353;1875;1738;28
1101000;Nubla;;0 - 20,000;4;6;-2;0;0;0
1101030;Noara: The Conspiracy;;0 - 20,000;74;16;58;0;0;1
1101050;Celestial;;0 - 20,000;21;10;11;0;0;0
1101050;Celestial;;0 - 20,000;21;10;11;0;0;0
1101060;Lumen;;20,000 - 50,000;1;1;0;0;0;0
1101080;Hidden;;0 - 20,000;13;7;6;0;0;0
1101100;Chaos Dream: Retribution;;0 - 20,000;4;1;3;0;0;0
1101130;My Typing Skill;;0 - 20,000;41;12;29;0;0;0
1101140;Fishing Adventure;;50,000 - 100,000;1122;185;937;65;80;2
1101170;Mage Mania;;0 - 20,000;18;3;15;0;0;0
1101180;EverStopped;;20,000 - 50,000;390;13;377;149;149;0
1101190;Dungeon Defenders: Awakened;;100,000 - 200,000;2846;1376;1470;1549;2161;82
1101200;After The Suns;;0 - 20,000;1;6;-5;0;0;0
1101220;Anticorps VR;;0 - 20,000;2;0;2;0;0;0
1101270;Anime Artist;;0 - 20,000;123;28;95;1;1;1
1101290;0Gravity;;0 - 20,000;3;3;0;0;0;0
1101310;Vengeful Heart;;20,000 - 50,000;20;0;20;0;0;0
1101340;Fighting Frenzy: Swole Simulator;;0 - 20,000;2;0;2;0;0;0
1101360;Rock of Ages 3: Make & Break;;50,000 - 100,000;617;231;386;66;31;10
1101420;Dragon Call;;0 - 20,000;64;25;39;0;0;1
1101450;Miss Neko;;100,000 - 200,000;3080;347;2733;85;55;9
1101480;Turn Me On;;0 - 20,000;6;2;4;0;0;0
1101570;Cliper: A clipboard enhancement tool;;0 - 20,000;10;9;1;0;0;0
1101620;Deichgraf;;0 - 20,000;21;3;18;0;0;0
1101660;Cooking Trip: Back on the road;;0 - 20,000;22;3;19;0;0;0
1101760;CRAZY DRIVER;;20,000 - 50,000;110;29;81;0;0;0
1101770;Ancient Knowledge;;0 - 20,000;7;0;7;0;0;0
1101780;Bakery Biz Tycoon;;0 - 20,000;15;14;1;0;0;0
1101790;War Mongrels;;20,000 - 50,000;831;356;475;0;0;18
1101800;10mg: Always Down;;0 - 20,000;30;1;29;0;0;0
1101840;WBTR - Welcome Back To Reality;;0 - 20,000;7;2;5;0;0;0
1101850;reD:起始的旋转之音(The beginning of the Melody);;100,000 - 200,000;5;2;3;0;0;0
1101910;Warriors: Rise to Glory! Online Multiplayer Open Beta;;50,000 - 100,000;451;93;358;0;0;0
1101930;Monsters of Little Haven;;0 - 20,000;260;29;231;0;0;0
1101940;Victorian Mysteries: Woman in White;;0 - 20,000;23;17;6;0;0;0
1101960;WREN;;0 - 20,000;2;1;1;0;0;0
1101980;白石洲往事;;0 - 20,000;16;42;-26;0;0;0
1102000;Pillowheads: It's Party Time;;0 - 20,000;3;0;3;0;0;0
1102040;Obversion;;0 - 20,000;14;1;13;0;0;0
1102060;Gun Blaze;;0 - 20,000;12;4;8;0;0;0
1102080;Planaris 2+;;0 - 20,000;16;1;15;0;0;0
1102100;TINY METAL: FULL METAL RUMBLE;;0 - 20,000;116;22;94;0;0;7
1102130;Florence;;200,000 - 500,000;8380;560;7820;79;90;15
1102140;Glizzy Gobbler;;0 - 20,000;2;1;1;0;0;0
1102150;Defending Territory;;0 - 20,000;6;11;-5;0;0;0
1102190;Monster Train;;500,000 - 1,000,000;17026;661;16365;2158;951;1566
1102200;Oceans We Make;;0 - 20,000;4;6;-2;0;0;0
1102210;The Legend of Viccess;;0 - 20,000;2;0;2;0;0;0
1102230;Lost In Sweets;;0 - 20,000;5;0;5;0;0;0
1102260;RANK RUNNER;;0 - 20,000;12;4;8;0;0;0
1102370;Dr. Derk's Mutant Battlegrounds;;0 - 20,000;17;6;11;0;0;1
1102390;Neckbeardia;;0 - 20,000;10;0;10;0;0;0
1102410;LOST:SMILE memories;;0 - 20,000;31;1;30;0;0;3
1102420;Palette Wizard;;0 - 20,000;9;4;5;0;0;0
1102490;The Tree;;0 - 20,000;1;2;-1;0;0;0
1102500;A Glider's Journey;;20,000 - 50,000;43;26;17;0;0;0
1102510;Come Back: Chapter 1;;0 - 20,000;9;0;9;0;0;0
1102580;Traffix;;0 - 20,000;42;17;25;0;0;0
1102650;Neon City Riders;;0 - 20,000;45;5;40;0;0;0
1102680;Ash Asylum;;0 - 20,000;14;17;-3;0;0;0
1102700;Alpha Dog;;0 - 20,000;7;1;6;0;0;0
1102720;THE UNCLEARNESS;;0 - 20,000;24;14;10;0;0;0
1102740;"""Going Up?""";;0 - 20,000;2;1;1;0;0;0
1102740;"""Going Up?""";;0 - 20,000;2;1;1;0;0;0
1102750;Zorg The Typing Warrior;;20,000 - 50,000;11;4;7;0;0;0
1102770;Cappasity VR Store Demo;;0 - 20,000;4;0;4;0;0;0
1102780;Desert Of The Dead;;20,000 - 50,000;262;132;130;0;0;0
1102880;Kawaii Deathu Desu;;20,000 - 50,000;123;55;68;0;0;3
1102890;Square Norm;;0 - 20,000;1;2;-1;0;0;0
1102940;Mogh;;0 - 20,000;2;0;2;0;0;0
1102980;英雄群侠传;;20,000 - 50,000;425;36;389;0;0;1
1103000;Qwerty's Prison;;0 - 20,000;1;0;1;0;0;0
1103040;Bepuzzled Space Jigsaw Puzzle;;20,000 - 50,000;0;1;-1;0;0;0
1103050;Bepuzzled Jigsaw Puzzle: Animals 103 Puzzles;;0 - 20,000;0;1;-1;0;0;0
1103060;Run Thief;;0 - 20,000;0;2;-2;0;0;0
1103070;Bepuzzled Jigsaw Puzzle: Japan;;0 - 20,000;1;0;1;0;0;0
1103080;Bepuzzled Jigsaw Puzzle: Nature;;0 - 20,000;0;1;-1;0;0;0
1103100;1000 days to escape;;50,000 - 100,000;282;58;224;0;0;2
1103120;Dune Sea;;0 - 20,000;20;3;17;0;0;0
1103130;Trials of Guinevere;;20,000 - 50,000;22;2;20;0;0;0
1103140;Powelus's Audio Visualizer;;0 - 20,000;9;11;-2;0;0;0
1103160;Beat Boxing;;0 - 20,000;5;0;5;0;0;0
1103210;We Become What We Behold [Fan-Made Port];;200,000 - 500,000;3095;103;2992;0;0;10
1103250;FORT;;0 - 20,000;2;1;1;0;0;0
1103290;Mind Trap;;0 - 20,000;1;1;0;0;0;0
1103300;Escape from Classroom;;0 - 20,000;0;3;-3;0;0;0
1103310;Sea Bubble;;0 - 20,000;58;1;57;0;0;0
1103320;Snow Arena;;0 - 20,000;27;14;13;0;0;0
1103340;YUT YUT;;0 - 20,000;4;0;4;0;0;0
1103390;ThreeStep;;0 - 20,000;2;0;2;0;0;0
1103400;Codemancer;;0 - 20,000;2;2;0;0;0;1
1103410;The Tower Of TigerQiuQiu;;0 - 20,000;6;5;1;0;0;0
1103430;Detonation;;0 - 20,000;3;4;-1;0;0;0
1103460;Break my body;;0 - 20,000;4;1;3;0;0;0
1103510;异世江湖录(JiangHu Record  Of Another World);;0 - 20,000;14;19;-5;0;0;0
1103520;Foodie Bear;;0 - 20,000;21;2;19;0;0;0
1103540;Stupid Bat;;0 - 20,000;2;0;2;0;0;0
1103550;Princess Castle Quest;;0 - 20,000;42;0;42;0;0;0
1103590;蹩脚的炼金术师(Incompetent Alchemist);;0 - 20,000;2;4;-2;0;0;0
1103620;青岚血枫;;0 - 20,000;5;0;5;0;0;0
1103630;Event Horizon - Frontier;;0 - 20,000;7;20;-13;0;0;1
1103640;Escape Game Cake;;0 - 20,000;5;0;5;0;0;0
1103650;Commando Dog;;0 - 20,000;1;4;-3;0;0;0
1103690;Interregnum-Alpha;;0 - 20,000;0;2;-2;0;0;0
1103730;Shing!;;20,000 - 50,000;223;68;155;0;0;5
1103770;Super Arcade Racing;;0 - 20,000;77;4;73;0;0;1
1103780;Top Speed 2: Racing Legends;;50,000 - 100,000;80;57;23;0;0;1
1103790;Dave-Man;;0 - 20,000;10;1;9;0;0;0
1103800;World War Zero;;0 - 20,000;78;15;63;60;74;1
1103860;The Wizards - Dark Times;;20,000 - 50,000;318;85;233;824;824;4
1103870;Space Dance;;0 - 20,000;7;0;7;0;0;0
1103880;Bullet Roulette VR;;0 - 20,000;371;70;301;355;355;12
1103890;Opening Up;;0 - 20,000;7;5;2;0;0;0
1103920;Clickable Coffee Shop;;0 - 20,000;11;18;-7;0;0;0
1103930;Shrine of the God-Ape;;0 - 20,000;35;1;34;0;0;0
1103940;New Zealand Virtual Debating Chamber;;0 - 20,000;24;0;24;0;0;0
1103950;ANAREA Battle Royale;;100,000 - 200,000;849;1004;-155;69;69;0
1103960;The Missing Few;;0 - 20,000;2;3;-1;0;0;0
1103970;Departure Dash;;0 - 20,000;1;0;1;0;0;0
1103980;Six Temples;;0 - 20,000;1;2;-1;0;0;0
1104030;Vermin Hunter;;0 - 20,000;3;1;2;0;0;0
1104050;Deep Diving VR;;0 - 20,000;7;12;-5;0;0;0
1104150;Ashi;;0 - 20,000;5;0;5;0;0;0
1104170;Cosmo Chaser;;20,000 - 50,000;1;1;0;0;0;0
1104220;Kyle Simulator;;0 - 20,000;108;18;90;0;0;0
1104230;The Last Escape of Yeti;;0 - 20,000;5;1;4;0;0;0
1104250;Poly Mole;;0 - 20,000;9;2;7;0;0;0
1104280;The Slormancer;;200,000 - 500,000;2938;728;2210;1187;1563;118
1104320;The Treasure of the Dragon;;100,000 - 200,000;6;2;4;0;0;0
1104330;Founders' Fortune;;100,000 - 200,000;1464;288;1176;344;419;36
1104380;The Room VR: A Dark Matter;;100,000 - 200,000;2948;73;2875;339;439;6
1104450;Bombergrounds: Battle Royale;;500,000 - 1,000,000;6977;927;6050;0;0;113
1104460;Gourmet Warriors;;0 - 20,000;14;2;12;0;0;0
1104470;Super Hero League of Hoboken;;0 - 20,000;7;0;7;0;0;1
1104480;Soccer Kid;;0 - 20,000;3;5;-2;0;0;0
1104490;Water Margin - The Tale of Clouds and Wind;;0 - 20,000;11;2;9;0;0;0
1104510;Rainbow Run;;0 - 20,000;1;1;0;0;0;0
1104610;Touhou Fan-made Virtual Autography;;0 - 20,000;18;3;15;0;0;0
1104620;The Lost VR;;0 - 20,000;17;2;15;0;0;0
1104640;New Frontier;;500,000 - 1,000,000;1853;1888;-35;158;62;1
1104660;MO:Astray;;200,000 - 500,000;4090;344;3746;532;644;8
1104670;BAFF 2;;0 - 20,000;8;12;-4;0;0;0
1104690;Hard to be a King;;0 - 20,000;9;2;7;0;0;0
1104830;Mystery Masterpiece: The Moonstone;;0 - 20,000;12;7;5;0;0;0
1104840;Vacation Adventures: Park Ranger 3;;0 - 20,000;2;0;2;0;0;0
1104870;TKKG - Die Feuerprobe;;0 - 20,000;13;13;0;0;0;1
1104890;From Head to Toe;;0 - 20,000;71;22;49;0;0;0
1104910;Midnight Grub Session;;0 - 20,000;3;0;3;0;0;0
1104930;Dots: Revamped!;;0 - 20,000;14;0;14;0;0;0
1104960;Alien Kingdom;;0 - 20,000;7;7;0;0;0;0
1105040;Alchemist Simulator;;0 - 20,000;225;72;153;63;63;0
1105110;OXXO;;0 - 20,000;196;10;186;0;0;0
1105150;Reverse Me! Rez/Ru;;0 - 20,000;2;0;2;0;0;0
1105160;Sharpshooter Plus;;0 - 20,000;1;0;1;0;0;0
1105240;Pakicetus;;0 - 20,000;6;6;0;0;0;0
1105300;The Cube;;0 - 20,000;9;1;8;0;0;0
1105410;Shine's Adventures 2 (Zombie Attack);;0 - 20,000;107;9;98;0;0;0
1105420;Game of Thrones Winter is Coming;;200,000 - 500,000;1178;791;387;45;59;667
1105430;Bandit Point;;0 - 20,000;11;3;8;0;0;0
1105450;Aartform Curvy 3D 4.0;;0 - 20,000;10;2;8;0;0;0
1105460;Flight of the Amazon Queen: 25th Anniversary Edition;;0 - 20,000;24;7;17;0;0;0
1105480;GGG Collection;;0 - 20,000;6;4;2;0;0;0
1105480;GGG Collection;;0 - 20,000;6;4;2;0;0;0
1105490;Over Sky;;0 - 20,000;2;0;2;0;0;0
1105500;Yakuza 4 Remastered;;100,000 - 200,000;2869;225;2644;2255;2401;181
1105510;Yakuza 5 Remastered;;200,000 - 500,000;2978;308;2670;3401;4281;241
1105530;Light Hunters: Battalion of Darkness;;20,000 - 50,000;5;5;0;0;0;0
1105560;Kra-Ken;;20,000 - 50,000;21;4;17;0;0;0
1105570;Final Crash Demo;;0 - 20,000;8;0;8;0;0;0
1105590;Dream Cycle;;20,000 - 50,000;159;65;94;0;0;1
1105600;Welcome To... Chichester 2 - Part II : No Regrets For The Future;;0 - 20,000;11;3;8;0;0;0
1105620;Exertus;;0 - 20,000;220;32;188;0;0;1
1105660;Stay Safe: Labyrinth of the Mad;;0 - 20,000;32;11;21;0;0;0
1105670;The Last Spell;;500,000 - 1,000,000;5876;530;5346;1960;1839;364
1105710;Grind: Skateboarding;;0 - 20,000;5;4;1;0;0;0
1105730;HANGMAN;;0 - 20,000;16;6;10;0;0;0
1105740;Wheel of Fate;;0 - 20,000;44;11;33;0;0;0
1105810;Onset;;20,000 - 50,000;567;177;390;471;471;1
1105810;Onset;;20,000 - 50,000;567;177;390;471;471;1
1105870;Hallway Simulator 2020;;0 - 20,000;4;0;4;0;0;0
1105890;Tilesetter;;0 - 20,000;98;10;88;0;0;7
1105960;TOGUM;;0 - 20,000;2;1;1;0;0;0
1105970;不死/IMMORTAL;;0 - 20,000;9;13;-4;0;0;0
1105970;不死/IMMORTAL;;0 - 20,000;9;13;-4;0;0;0
1106030;ROAD HOMEWARD 3 underwater world;;0 - 20,000;3;11;-8;0;0;0
1106080;Princess Project;;20,000 - 50,000;320;85;235;199;199;2
1106140;The Drift Challenge;;50,000 - 100,000;443;105;338;87;87;1
1106150;Yet Another Hero Story;;0 - 20,000;41;9;32;0;0;0
1106180;SpriteStack;;0 - 20,000;56;32;24;45;45;0
1106200;Overseas;;0 - 20,000;18;6;12;0;0;0
1106340;Legend Bowl;;0 - 20,000;640;68;572;0;0;18
1106350;Pyrax;;0 - 20,000;12;6;6;0;0;0
1106530;GemCraft - Frostborn Wrath;;200,000 - 500,000;2013;264;1749;170;214;172
1106670;Diastone: Confusion;;0 - 20,000;7;8;-1;0;0;0
1106690;巫师超凡者 Legend of the wizard;;0 - 20,000;72;38;34;0;0;0
1106690;巫师超凡者 Legend of the wizard;;0 - 20,000;72;38;34;0;0;0
1106710;On The Verge II;;0 - 20,000;20;3;17;0;0;0
1106720;Try 'n Cry - Prologue;;0 - 20,000;19;9;10;0;0;0
1106730;Paradox Escape Route;;0 - 20,000;2;0;2;0;0;0
1106740;The Beast of Gevaudan;;0 - 20,000;4;1;3;0;0;0
1106750;Fault;;200,000 - 500,000;2421;1649;772;1925;3586;1
1106770;Shepherd of Light;;100,000 - 200,000;697;37;660;0;0;0
1106790;Red Horizon;;0 - 20,000;8;19;-11;0;0;0
1106830;Rainbow Billy: The Curse of the Leviathan;;0 - 20,000;131;6;125;0;0;0
1106840;Hydroneer;;500,000 - 1,000,000;14014;1983;12031;912;537;434
1106850;Totally Reliable Delivery Service Beta;;500,000 - 1,000,000;3189;504;2685;90;25;2
1106880;Tribes of Midgard - Open Beta;;200,000 - 500,000;433;58;375;0;0;0
1106920;Nyanco;;0 - 20,000;52;12;40;0;0;1
1106940;How to Raise a Wolf Girl;;0 - 20,000;301;19;282;0;0;1
1106950;Furries & Scalies: Friendswood;;0 - 20,000;1;0;1;0;0;0
1106970;Insect Simulator;;0 - 20,000;5;5;0;0;0;0
1106970;Insect Simulator;;0 - 20,000;5;5;0;0;0;0
1106980;Bulletorium;;0 - 20,000;6;0;6;0;0;0
1107040;You Don't Have Time;;0 - 20,000;29;9;20;0;0;0
1107050;人工智能 阿尔法猫-AI Alpha Cat;;0 - 20,000;48;57;-9;0;0;0
1107050;人工智能 阿尔法猫-AI Alpha Cat;;0 - 20,000;48;57;-9;0;0;0
1107060;Lighthouse of guiding flames;;20,000 - 50,000;40;8;32;0;0;0
1107060;Lighthouse of guiding flames;;20,000 - 50,000;40;8;32;0;0;0
1107100;Second Final;;0 - 20,000;0;2;-2;0;0;0
1107130;The Way of Cinnamon;;0 - 20,000;20;9;11;0;0;0
1107160;Pew Pew Puzzle Defense;;0 - 20,000;2;2;0;0;0;0
1107170;Champions;;0 - 20,000;2;0;2;0;0;0
1107190;The Fragment;;0 - 20,000;1;3;-2;0;0;0
1107210;Jumping Over It With Kang KiYun;;20,000 - 50,000;18;14;4;0;0;0
1107230;The 13th Doll: A Fan Game of The 7th Guest;;0 - 20,000;160;9;151;0;0;2
1107300;Down in Bermuda;;;;;0;;;
1107340;LONN;;0 - 20,000;78;35;43;0;0;2
1107340;LONN;;0 - 20,000;78;35;43;0;0;2
1107350;Unsolved Mystery Club: Ancient Astronauts (Collector´s Edition);;0 - 20,000;18;12;6;0;0;0
1107370;Demoniaca: Everlasting Night;;20,000 - 50,000;146;59;87;396;396;0
1107370;Demoniaca: Everlasting Night;;20,000 - 50,000;146;59;87;396;396;0
1107390;Project Polygun;;0 - 20,000;0;1;-1;0;0;0
1107440;Last Warrior;;0 - 20,000;23;8;15;0;0;0
1107450;Dreams of Solari - Chapter 1;;0 - 20,000;6;4;2;0;0;0
1107470;Applewood;;0 - 20,000;36;1;35;0;0;0
1107490;The Searchers of Legends : Origin;;0 - 20,000;10;8;2;0;0;0
1107510;Favo!+;;0 - 20,000;5;7;-2;0;0;0
1107580;mAIn COMPetition;;0 - 20,000;3;3;0;0;0;0
1107620;Mystery Island - Hidden Object Games;;20,000 - 50,000;115;57;58;0;0;1
1107660;Round Rooms;;0 - 20,000;3;1;2;0;0;0
1107720;Spider Solitaire F;;0 - 20,000;5;7;-2;0;0;0
1107730;DAHALO;;0 - 20,000;14;8;6;0;0;0
1107750;Faraday Protocol;;0 - 20,000;52;4;48;0;0;2
1107790;The Complex;;50,000 - 100,000;1978;572;1406;114;161;15
1107820;Pushy and Pully in Blockland;;0 - 20,000;37;6;31;0;0;0
1107860;Dofense;;0 - 20,000;5;0;5;0;0;0
1107920;8bit Pigeon Hunter;;0 - 20,000;2;0;2;0;0;0
1107950;Kiku Wallpaper Launcher;;0 - 20,000;2;1;1;0;0;1
1108000;Children of Silentown;;0 - 20,000;304;35;269;0;0;29
1108020;Bepuzzled Jigsaw Puzzle: Sweets;;0 - 20,000;1;0;1;0;0;0
1108030;Bepuzzled Jigsaw Puzzle: Paradise;;0 - 20,000;0;1;-1;0;0;0
1108040;Bepuzzled Jigsaw Puzzle: Aquatic;;20,000 - 50,000;1;0;1;0;0;0
1108090;Climb With Wheelbarrow;;0 - 20,000;162;23;139;0;0;0
1108120;The Unseen Fears: Stories Untold Collector's Edition;;0 - 20,000;1;0;1;0;0;1
1108130;The Last AntLion;;0 - 20,000;3;3;0;0;0;0
1108170;Plot of the Druid;;0 - 20,000;57;0;57;0;0;2
1108190;Victorian Mysteries: The Yellow Room;;0 - 20,000;25;6;19;0;0;0
1108240;Code/The Werewolf Party;;0 - 20,000;16;19;-3;0;0;0
1108250;All Systems Operational;;0 - 20,000;3;0;3;0;0;0
1108310;The Demon - Nicolas Eymerich Inquisitor Audiogame;;0 - 20,000;2;1;1;0;0;0
1108320;妄想破绽 Broken Delusion;;500,000 - 1,000,000;2476;1491;985;2675;4928;3
1108350;Boet Fighter;;0 - 20,000;100;13;87;0;0;0
1108360;AOS Manager;;0 - 20,000;0;1;-1;0;0;0
1108370;Ratropolis;;200,000 - 500,000;4276;532;3744;985;1343;98
1108380;Highlight;;0 - 20,000;7;0;7;0;0;0
1108390;Cartonfall: Fortress - Defend Cardboard Castle;;0 - 20,000;15;4;11;0;0;0
1108540;Zen Chess: Champion's Moves;;0 - 20,000;19;14;5;0;0;0
1108550;Zen Chess: Blindfold Masters;;0 - 20,000;16;12;4;0;0;0
1108590;Eldest Souls;;100,000 - 200,000;1623;500;1123;386;642;25
1108640;OMNIMUS;;0 - 20,000;42;7;35;0;0;0
1108660;Crystal Defense;;0 - 20,000;2;3;-1;0;0;0
1108740;Stick Em Up;;20,000 - 50,000;91;52;39;0;0;1
1108750;Timerunner;;100,000 - 200,000;78;13;65;0;0;13
1108780;The Pirate Queen;;0 - 20,000;1;1;0;0;0;0
1108800;Android Hunter A;;0 - 20,000;13;12;1;0;0;0
1108820;Polar Jump;;0 - 20,000;4;1;3;0;0;0
1109070;接头 / Contact Point;;0 - 20,000;22;7;15;0;0;0
1109080;Prison Ball: Full Blown;;0 - 20,000;7;3;4;0;0;0
1109100;El Tesoro de Isla Alcachofa;;20,000 - 50,000;2;0;2;0;0;0
1109110;Ghost Land;;0 - 20,000;10;18;-8;0;0;0
1109130;逝去的回忆3：四叶草之梦;;0 - 20,000;562;18;544;0;0;1
1109160;Giants Uprising;;0 - 20,000;126;51;75;0;0;1
1109170;Happy Grumps;;0 - 20,000;5;0;5;0;0;0
1109220;Pencil Fantastic;;0 - 20,000;10;2;8;0;0;0
1109280;Back To Hell;;0 - 20,000;1;4;-3;0;0;0
1109300;Volt Patrol - Stealth Driving;;0 - 20,000;38;0;38;0;0;0
1109310;Expansion;;0 - 20,000;10;7;3;0;0;0
1109350;ANCIENT SOULS : The Governor;;0 - 20,000;6;1;5;0;0;0
1109380;[it's possible];;0 - 20,000;1;1;0;0;0;0
1109400;Dino Delivery;;0 - 20,000;23;18;5;0;0;0
1109410;Perspective;;50,000 - 100,000;457;8;449;0;0;0
1109420;The Luminist;;20,000 - 50,000;32;5;27;0;0;0
1109460;There is No GreenDam;;100,000 - 200,000;1552;57;1495;0;0;3
1109490;The Cherry Orchard;;0 - 20,000;30;0;30;0;0;0
1109550;CricVRX - VR Cricket;;0 - 20,000;1;1;0;0;0;0
1109570;Word Game;;100,000 - 200,000;4638;283;4355;221;294;25
1109680;Regiments;;50,000 - 100,000;1354;199;1155;283;474;75
1109690;Asterix & Obelix XXL 3  - The Crystal Menhir;;20,000 - 50,000;174;119;55;569;569;6
1109700;Last warrior;;0 - 20,000;3;5;-2;0;0;0
1109720;DOTORI;;0 - 20,000;16;4;12;0;0;0
1109740;Kakuro;;0 - 20,000;5;10;-5;0;0;0
1109750;Terracotta - Shards of Doom;;0 - 20,000;10;0;10;0;0;0
1109790;Creatures;;0 - 20,000;3;0;3;0;0;0
1109800;Love on Paper;;0 - 20,000;9;3;6;0;0;0
1109820;Pile Up! Box by Box;;0 - 20,000;60;2;58;0;0;0
1109840;Réussir : Code de la Route - Nouvelle Édition (French Highway Code);;20,000 - 50,000;260;33;227;0;0;9
1109880;Just Random Squares;;0 - 20,000;7;1;6;0;0;0
1109890;Planet Invasion;;0 - 20,000;1;0;1;0;0;0
1109940;RailRoadVR;;0 - 20,000;5;0;5;0;0;0
1109960;The Tales of Epicton Kingdom;;0 - 20,000;0;1;-1;0;0;0
1109980;SARE  Inception;;0 - 20,000;0;4;-4;0;0;0
1110010;The Doulos Study;;0 - 20,000;2;1;1;0;0;0
1110020;Image of Perfection;;0 - 20,000;3;0;3;0;0;0
1110030;Heroes of Myth;;0 - 20,000;47;12;35;0;0;0
1110050;Evan's Remains;;100,000 - 200,000;1063;142;921;119;178;3
1110090;Cyber-Ante;;0 - 20,000;2;0;2;0;0;0
1110090;Cyber-Ante;;0 - 20,000;2;0;2;0;0;0
1110100;Power Rangers: Battle for the Grid;;100,000 - 200,000;1123;177;946;191;191;4
1110200;Spaceman Defender;;0 - 20,000;1;2;-1;0;0;0
1110210;Adam's Ascending;;0 - 20,000;2;3;-1;0;0;0
1110220;Shinobi Spirits S Legend of Heroes/忍スピリッツS 真田獣勇士伝;;0 - 20,000;9;1;8;0;0;0
1110230;香山31号;;0 - 20,000;2;4;-2;0;0;0
1110280;Royal Life: Hard to be a Queen;;0 - 20,000;6;1;5;0;0;0
1110340;Detective Bot;;0 - 20,000;3;1;2;0;0;0
1110350;fishman;;0 - 20,000;8;0;8;0;0;0
1110380;Fit For a King;;0 - 20,000;58;2;56;0;0;1
1110390;Unturned - Dedicated Server;;200,000 - 500,000;962;188;774;0;0;6
1110410;VEGAS Pro 17 Edit Steam Edition;;0 - 20,000;91;44;47;193;193;15
1110460;Myoubouh Catcher;;0 - 20,000;1;0;1;0;0;0
1110490;LAB Defence;;0 - 20,000;6;9;-3;0;0;0
1110580;Flex - Figure Reference;;0 - 20,000;51;12;39;0;0;0
1110650;别以为你是开发者我就不敢打你;;0 - 20,000;21;14;7;0;0;0
1110650;别以为你是开发者我就不敢打你;;0 - 20,000;21;14;7;0;0;0
1110670;Under The Ground;;0 - 20,000;7;1;6;0;0;0
1110690;Banter Schooldays!!三〇一室无一人;;20,000 - 50,000;647;69;578;761;761;0
1110720;The Last Companion-我与我行将离去的小友。;;0 - 20,000;164;7;157;0;0;0
1110770;About Love, Hate And The Other Ones 2;;0 - 20,000;34;1;33;0;0;0
1110830;篮球计划 Project Dunk;;0 - 20,000;97;63;34;0;0;0
1110840;KEIKA - A Puzzle Adventure;;0 - 20,000;13;4;9;0;0;0
1110870;Alien Shooter in Space Cradle - Virtual Reality;;0 - 20,000;1;1;0;0;0;0
1110890;MY WOLF - Desktop Wild Pet;;0 - 20,000;151;36;115;16;16;8
1110910;Mortal Shell;;100,000 - 200,000;3104;1157;1947;481;517;43
1110980;Warden of the Isles;;0 - 20,000;30;4;26;0;0;0
1111040;Global Aviation Dream;;0 - 20,000;14;18;-4;0;0;1
1111090;Alpha Lyrae Discovery;;0 - 20,000;18;2;16;0;0;0
1111100;Oasis Shooting Ops;;0 - 20,000;1;4;-3;0;0;0
1111110;Euro NumismatCy! Coin Collector;;0 - 20,000;1;1;0;0;0;0
1111120;Snares of Ruin 2;;0 - 20,000;10;1;9;0;0;0
1111200;Car Soccer World Cup;;0 - 20,000;7;4;3;0;0;0
1111210;The Backrooms Game FREE Edition;;200,000 - 500,000;2680;518;2162;0;0;10
1111220;Genius! NAZI-GIRL GoePPels-Chan ep3;;0 - 20,000;8;0;8;0;0;0
1111250;Corporate America;;0 - 20,000;1;1;0;0;0;0
1111270;I Wanna Brother;;0 - 20,000;11;15;-4;0;0;0
1111300;Aim FTW;;20,000 - 50,000;39;27;12;0;0;2
1111300;Aim FTW;;20,000 - 50,000;39;27;12;0;0;2
1111310;Duck in Town - A Rising Knight;;0 - 20,000;6;1;5;0;0;0
1111330;Rolling Rumble;;0 - 20,000;5;1;4;0;0;0
1111340;Dream Jump Adventure;;0 - 20,000;1;1;0;0;0;0
1111370;A Summer's End - Hong Kong 1986;;50,000 - 100,000;1364;46;1318;0;0;3
1111380;ROBOTICS;;;;;0;;;
1111380;ROBOTICS;;;;;0;;;
1111390;ROBOTICS;;;;;0;;;
1111410;Think_;;0 - 20,000;5;5;0;0;0;0
1111410;Think_;;0 - 20,000;5;5;0;0;0;0
1111420;Infinite Skyline: Superflight;;0 - 20,000;1;1;0;0;0;0
1111450;Youth Feather;;20,000 - 50,000;611;59;552;52;52;0
1111460;小白兔电商~Bunny e-Shop;;200,000 - 500,000;8618;417;8201;1705;1661;52
1111540;Room 40;;20,000 - 50,000;69;22;47;0;0;0
1111540;Room 40;;20,000 - 50,000;69;22;47;0;0;0
1111590;Linked Mask;;0 - 20,000;22;14;8;0;0;6
1111600;Klang 2;;0 - 20,000;49;0;49;0;0;0
1111610;All That Remains: A story about a child's future;;0 - 20,000;4;4;0;0;0;0
1111620;Gloomy Eyes;;0 - 20,000;139;17;122;0;0;0
1111620;Gloomy Eyes;;0 - 20,000;139;17;122;0;0;0
1111650;Never BreakUp;;20,000 - 50,000;20;15;5;0;0;0
1111660;C15;;0 - 20,000;10;5;5;0;0;0
1111760;World of Guns: VR;;20,000 - 50,000;24;41;-17;1;1;1
1111830;Sentenced VR;;0 - 20,000;36;15;21;0;0;0
1111870;Admiral Stepinski;;0 - 20,000;1;0;1;0;0;0
1111880;Block Granny Horror Survival;;0 - 20,000;9;11;-2;0;0;0
1111940;Quiplash 2 InterLASHional;;20,000 - 50,000;260;23;237;88;99;15
1111960;Tsuro - The Game of The Path - VR Edition;;0 - 20,000;7;1;6;0;0;0
1111970;Zeminator;;0 - 20,000;59;4;55;0;0;0
1111990;Einn;;0 - 20,000;1;5;-4;0;0;0
1112010;Afloat;;0 - 20,000;1;3;-2;0;0;0
1112050;Time For Quest;;0 - 20,000;25;7;18;0;0;0
1112100;Tarzan VR  The Trilogy Edition;;0 - 20,000;26;17;9;0;0;0
1112110;Redemption Cemetery: Dead Park Collector's Edition;;0 - 20,000;5;3;2;0;0;0
1112120;Space Viking Raiders VR;;0 - 20,000;0;2;-2;0;0;0
1112150;Nekour;;0 - 20,000;23;0;23;0;0;0
1112200;Rize of the Summonds;;0 - 20,000;1;1;0;0;0;0
1112230;Furries & Scalies: Super Scary Halloween Spooky Times;;0 - 20,000;2;0;2;0;0;0
1112240;Wonder Boy Returns Remix;;0 - 20,000;62;22;40;166;166;0
1112250;Umbraseal;;0 - 20,000;3;0;3;0;0;0
1112330;NORR part I: Ace Shot;;0 - 20,000;2;3;-1;0;0;0
1112340;The Dreadful Whispers;;0 - 20,000;142;19;123;0;0;0
1112350;荒凉城市;;0 - 20,000;1;0;1;0;0;0
1112360;Blind Spot VR / 盲点 VR;;0 - 20,000;6;1;5;0;0;0
1112370;Now I Am There;;0 - 20,000;45;7;38;0;0;0
1112380;Wer weiß denn sowas? - Das 2. Spiel;;0 - 20,000;16;10;6;1;1;0
1112400;Project Torque - Free 2 Play MMO Racing Game;;200,000 - 500,000;1195;440;755;0;0;17
1112440;Falco Engine;;0 - 20,000;8;1;7;0;0;0
1112570;Crime Cities;;0 - 20,000;17;10;7;0;0;0
1112580;A pirate quartermaster;;0 - 20,000;40;10;30;0;0;0
1112620;Isles of Adalar;;0 - 20,000;74;61;13;0;0;3
1112670;Yet Another Waveshooter;;0 - 20,000;1;0;1;0;0;0
1112690;Coffin Rot Brewing Co.;;20,000 - 50,000;34;8;26;0;0;0
1112700;Guroopia!;;0 - 20,000;5;0;5;0;0;0
1112710;Neon Tower Blast;;0 - 20,000;0;4;-4;0;0;0
1112760;Farrealm: The Prince of Winds;;0 - 20,000;2;0;2;0;0;0
1112790;Automation Empire;;100,000 - 200,000;1605;795;810;822;1043;51
1112830;The Watchers;;0 - 20,000;276;94;182;78;78;6
1112840;Shelter in Place;;0 - 20,000;2;2;0;0;0;0
1112860;KingAndSlaves;;0 - 20,000;1;4;-3;0;0;0
1112870;Cardaria;;0 - 20,000;17;12;5;0;0;0
1112890;Calico;;100,000 - 200,000;3336;405;2931;188;208;34
1112930;Dredgers;;100,000 - 200,000;387;41;346;1745;1745;2
1112940;Hero Legends;;0 - 20,000;6;7;-1;0;0;0
1112950;Japocaliptyca/ Япокалиптика;;0 - 20,000;0;4;-4;0;0;0
1112960;Wildland;;0 - 20,000;13;12;1;0;0;0
1113000;Persona 4 Golden;;1,000,000 - 2,000,000;59406;1791;57615;2904;1708;1569
1113030;Stellar Warfare;;20,000 - 50,000;174;30;144;16;30;5
1113060;Magic Farm 3: The Ice Danger;;0 - 20,000;8;7;1;0;0;1
1113090;Crown of the Empire;;0 - 20,000;16;1;15;0;0;1
1113110;The Stranger: Interactive Film;;0 - 20,000;2;4;-2;0;0;0
1113120;IXION;;200,000 - 500,000;6729;2519;4210;582;546;802
1113210;Jomp The Jumper;;0 - 20,000;1;0;1;0;0;0
1113220;ASCIIDENT;;0 - 20,000;21;5;16;0;0;0
1113230;TerTD;;0 - 20,000;1;0;1;0;0;0
1113240;Voxel Crusade;;0 - 20,000;13;3;10;0;0;0
1113300;To Battle!: Hell's Crusade;;0 - 20,000;45;10;35;0;0;0
1113310;Post Soviet Zombies;;0 - 20,000;74;11;63;0;0;1
1113340;Mr  Joshua Carrot;;0 - 20,000;7;2;5;0;0;0
1113360;Last Man;;0 - 20,000;1;0;1;0;0;0
1113370;Drone Wars VR;;20,000 - 50,000;9;1;8;0;0;0
1113380;Deep Sea Tycoon: Diver's Paradise;;0 - 20,000;1;0;1;0;0;0
1113390;Handy;;0 - 20,000;7;4;3;0;0;0
1113490;River Legends: A Fly Fishing Adventure;;0 - 20,000;21;2;19;0;0;0
1113530;SAMOSBOR 2D;;0 - 20,000;5;8;-3;0;0;0
1113560;NieR Replicant ver.1.22474487139...;;500,000 - 1,000,000;17689;2373;15316;1037;845;309
1113570;Voice of Cards: The Isle Dragon Roars;;20,000 - 50,000;890;203;687;505;737;8
1113580;シニサギ;;0 - 20,000;9;3;6;0;0;0
1113620;Transparent Taskbar;;0 - 20,000;54;12;42;0;0;27
1113640;Escape from Labyrinth;;0 - 20,000;27;16;11;0;0;0
1113650;Jaxon The Thief;;0 - 20,000;1;6;-5;0;0;0
1113680;Hentai Girl Division;;20,000 - 50,000;507;84;423;130;244;1
1113690;Senna and the Forest;;0 - 20,000;18;0;18;0;0;0
1113730;Cubico;;20,000 - 50,000;126;30;96;0;0;0
1113740;EasySave Backup;;0 - 20,000;1;1;0;0;0;0
1113750;Lost Artifacts: Frozen Queen;;0 - 20,000;8;17;-9;0;0;0
1113760;Roads of time;;0 - 20,000;10;1;9;0;0;0
1113770;Lunch A Palooza;;0 - 20,000;26;5;21;0;0;0
1113850;Sanguine Soul;;0 - 20,000;7;1;6;0;0;0
1113860;Cyborgs Attack;;0 - 20,000;3;0;3;0;0;0
1113880;Best in the West;;20,000 - 50,000;76;51;25;0;0;1
1113930;Don't Die;;0 - 20,000;6;4;2;0;0;0
1113940;Electronic Super Joy 2;;;;;0;;;
1113950;Puzzle: Fire Sticks;;0 - 20,000;13;2;11;0;0;0
1113960;Pictures of Life;;0 - 20,000;10;1;9;0;0;0
1113970;Little Brother Jim;;0 - 20,000;44;9;35;0;0;0
1114000;King of Dragon Balls;;0 - 20,000;24;21;3;0;0;0
1114020;ZomB: Battlegrounds;;0 - 20,000;4;4;0;0;0;0
1114030;The Room Syndrome;;20,000 - 50,000;287;10;277;0;0;2
1114070;My Child Lebensborn;;20,000 - 50,000;1212;76;1136;148;290;5
1114090;Life Tastes Like Cardboard;;0 - 20,000;184;12;172;0;0;0
1114110;Nightmare Game (噩梦游戏);;0 - 20,000;8;12;-4;0;0;0
1114130;My Koi;;20,000 - 50,000;576;42;534;66;66;7
1114140;Fortune Telling;;0 - 20,000;2;0;2;0;0;0
1114210;Colloc;;0 - 20,000;24;0;24;0;0;0
1114220;Gedonia;;200,000 - 500,000;2220;259;1961;42;42;45
1114230;Gear Puzzle: the inheritance of grandpa;;0 - 20,000;44;15;29;0;0;0
1114260;Under What?;;20,000 - 50,000;463;99;364;0;0;0
1114270;1912 Titanic Mystery;;0 - 20,000;16;19;-3;0;0;0
1114290;Windjammers 2;;50,000 - 100,000;428;52;376;0;0;4
1114340;Mortadelo y Filemón: Operación Moscú;;0 - 20,000;1;6;-5;0;0;0
1114380;Orgynizer;;0 - 20,000;46;4;42;0;0;0
1114420;PLAY'A VR  Video Player;;50,000 - 100,000;104;65;39;0;0;20
1114430;Ballex;;20,000 - 50,000;371;46;325;35;35;7
1114460;Paranormal Detective: Escape from the 80's;;0 - 20,000;64;3;61;0;0;0
1114520;Hero Among Us;;0 - 20,000;14;4;10;0;0;0
1114530;TTV3;;20,000 - 50,000;86;12;74;0;0;0
1114620;Cloak and Dasher;;0 - 20,000;40;0;40;0;0;0
1114630;Dr. Tacocat;;0 - 20,000;7;2;5;0;0;0
1114650;HorrorVale;;0 - 20,000;120;2;118;0;0;1
1114660;4K Bricks Breaker Plus;;0 - 20,000;3;1;2;0;0;0
1114700;Fight For Freedom;;0 - 20,000;4;4;0;0;0;0
1114710;KANNA;;0 - 20,000;1;5;-4;0;0;0
1114720;四景山水圖．秋景 Landscapes of the Four Seasons;;0 - 20,000;13;1;12;0;0;0
1114740;Red Island;;0 - 20,000;40;2;38;0;0;0
1114830;Armor Clash 3;;0 - 20,000;83;61;22;0;0;0
1114860;Hobs;;100,000 - 200,000;1084;169;915;0;0;0
1114900;Ayo the Clown;;0 - 20,000;60;3;57;0;0;0
1114910;Alone in the War;;0 - 20,000;6;2;4;0;0;0
1114940;I Wanna Maker;;200,000 - 500,000;3131;147;2984;0;0;67
1114950;Learn Japanese RPG: Hiragana Forbidden Speech;;0 - 20,000;16;0;16;0;0;0
1114960;Corridor Crusaders;;0 - 20,000;8;3;5;0;0;0
1114990;It Pays To Be A Winner;;0 - 20,000;0;1;-1;0;0;0
1115020;老板攻略;;0 - 20,000;2;0;2;0;0;0
1115030;Running Black;;0 - 20,000;4;3;1;0;0;0
1115040;SincereMen;;0 - 20,000;0;6;-6;0;0;0
1115050;Will You Snail?;;20,000 - 50,000;2104;45;2059;716;824;9
1115060;Trace of the past;;0 - 20,000;10;3;7;0;0;0
1115090;My Planet [RTS];;0 - 20,000;1;0;1;0;0;0
1115110;Airborne: Trials;;0 - 20,000;5;3;2;0;0;0
1115380;BallBoi;;20,000 - 50,000;39;14;25;0;0;1
1115400;Speed Mazing;;0 - 20,000;6;3;3;0;0;0
1115450;Bastide;;0 - 20,000;215;74;141;0;0;1
1115450;Bastide;;0 - 20,000;215;74;141;0;0;1
1115570;Forest Mage;;0 - 20,000;3;6;-3;0;0;0
1115580;Grand Brix Shooter;;0 - 20,000;70;2;68;0;0;0
1115610;The Lost and The Wicked;;0 - 20,000;19;4;15;0;0;1
1115620;Super Pig;;0 - 20,000;16;2;14;0;0;0
1115630;Magnetic Daydream;;0 - 20,000;3;0;3;0;0;0
1115640;英雄群侠传II;;100,000 - 200,000;1710;178;1532;0;0;15
1115660;Apollo 11 VR HD: First Steps;;0 - 20,000;8;11;-3;0;0;0
1115670;C64 & AMIGA Classix Remakes Sixpack 3;;0 - 20,000;1;2;-1;0;0;0
1115690;Yes, Your Grace;;500,000 - 1,000,000;5833;1002;4831;449;511;79
1115760;Singaria;;0 - 20,000;14;0;14;0;0;0
1115780;The Almost Gone;;100,000 - 200,000;723;149;574;97;139;2
1115820;MIND SWITCH;;0 - 20,000;5;2;3;0;0;0
1115830;Fun Fantasy Girls Jigsaw;;0 - 20,000;1;0;1;0;0;0
1115840;Dungeons Again;;0 - 20,000;15;4;11;0;0;0
1115860;BOMTILES;;0 - 20,000;9;3;6;0;0;0
1115870;Inner Tao;;0 - 20,000;15;0;15;0;0;0
1115960;Struggle;;0 - 20,000;1;0;1;0;0;0
1115970;Victim Cache the RPG - An 80s JRPG Parody;;0 - 20,000;1;1;0;0;0;0
1115980;Something for Someone Else;;20,000 - 50,000;338;50;288;0;0;0
1116010;Blockoid;;0 - 20,000;0;2;-2;0;0;0
1116030;Oceanum Mortis;;0 - 20,000;8;4;4;0;0;0
1116090;Psychose;;0 - 20,000;15;6;9;0;0;0
1116100;BEETLES;;0 - 20,000;11;1;10;0;0;0
1116110;Raifu Wars;;0 - 20,000;66;8;58;0;0;0
1116110;Raifu Wars;;0 - 20,000;66;8;58;0;0;0
1116180;Amora Crystal;;0 - 20,000;9;2;7;0;0;0
1116190;Flutter Bombs;;0 - 20,000;2;0;2;0;0;0
1116200;Greetings From Krampus;;0 - 20,000;5;0;5;0;0;0
1116210;Our world has not decayed;;20,000 - 50,000;295;48;247;84;102;2
1116230;The Story of Henry Bishop;;20,000 - 50,000;398;73;325;107;107;3
1116240;Android Amazones;;0 - 20,000;6;3;3;0;0;0
1116260;SAMUDRA;;0 - 20,000;64;10;54;0;0;0
1116280;8-Bit Attack;;20,000 - 50,000;16;13;3;0;0;0
1116290;Alien Escape;;20,000 - 50,000;27;3;24;0;0;0
1116300;Bounce;;20,000 - 50,000;2;2;0;0;0;0
1116350;Exsys;;0 - 20,000;0;2;-2;0;0;0
1116360;JERRY JOBHOPPER;;0 - 20,000;3;0;3;0;0;0
1116430;Mostly Intense Monster Defense;;0 - 20,000;52;4;48;0;0;0
1116490;Lie In My Heart;;0 - 20,000;50;5;45;0;0;0
1116500;HVAC Simulator;;0 - 20,000;0;2;-2;0;0;0
1116520;The Backrooms;;0 - 20,000;10;37;-27;0;0;0
1116550;Elon Simulator 2019;;50,000 - 100,000;398;73;325;0;0;0
1116580;Shady Part of Me;;50,000 - 100,000;1094;63;1031;174;317;23
1116590;Full Animal Party;;0 - 20,000;13;5;8;0;0;0
1116600;Art Of Air War;;0 - 20,000;1;5;-4;0;0;0
1116650;CAPCOM GO! Apollo VR Planetarium;;20,000 - 50,000;60;11;49;0;0;0
1116660;Neon Tide;;0 - 20,000;5;2;3;0;0;0
1116670;Simple Railroad;;0 - 20,000;6;2;4;0;0;0
1116700;Vermillion Watch: Parisian Pursuit Collector's Edition;;0 - 20,000;8;1;7;0;0;0
1116770;Shovel Knight Showdown;;0 - 20,000;70;6;64;0;0;1
1116770;Shovel Knight Showdown;;0 - 20,000;70;6;64;0;0;1
1116780;Shovel Knight: King of Cards;;0 - 20,000;146;15;131;0;0;4
1116800;PLAY DOG PLAY TAG;;0 - 20,000;8;0;8;0;0;0
1116860;The Gun Knight;;0 - 20,000;26;1;25;0;0;0
1116870;Duel Girl;;0 - 20,000;12;17;-5;0;0;0
1116880;The Heroic Legend of Eagarlnia;;50,000 - 100,000;1283;205;1078;293;293;12
1116890;Unsolved Mystery Club: Amelia Earhart;;0 - 20,000;14;6;8;0;0;0
1116910;;;0 - 20,000;12;16;-4;0;0;0
1116960;UNDEFEATED;;500,000 - 1,000,000;5033;660;4373;0;0;66
1116990;Legend of Cenama;;0 - 20,000;42;4;38;0;0;0
1117000;CyberRunner;;0 - 20,000;5;1;4;0;0;0
1117040;武道戰姬 - 女僕(武道戦姫 - メイド / Budo Girl War - Maid);;0 - 20,000;39;5;34;0;0;0
1117120;The Cross Horror Game;;0 - 20,000;16;11;5;0;0;0
1117150;GarbageClassification;;0 - 20,000;1;0;1;0;0;0
1117160;Minds of Nations;;50,000 - 100,000;363;122;241;0;0;4
1117200;Redemption's Guild;;0 - 20,000;4;3;1;0;0;0
1117220;WizardCraft Colonies;;0 - 20,000;2;2;0;0;0;1
1117310;Sandwich Sudoku;;0 - 20,000;140;2;138;0;0;3
1117330;Bouncy Bob: Episode 2;;0 - 20,000;5;6;-1;0;0;0
1117340;Gods of Havoc: Into the Void;;0 - 20,000;6;0;6;0;0;0
1117360;Word Forward;;0 - 20,000;7;1;6;0;0;0
1117420;Bryce's Movement Engine¹;;100,000 - 200,000;22;3;19;0;0;0
1117470;Seven Wonders of St. Clementine;;0 - 20,000;1;9;-8;0;0;0
1117480;Dead Hand;;0 - 20,000;17;4;13;0;0;0
1117490;Theater Commander: The Coming Wars, Modern War Game;;0 - 20,000;1;6;-5;0;0;0
1117520;G.A.C.K. - Gaming App Construction Kit;;0 - 20,000;3;3;0;0;0;0
1117560;南国育ち/Nangoku Sodachi;;0 - 20,000;3;0;3;0;0;0
1117590;Learn Spanish! Easy Vocabulary;;0 - 20,000;10;2;8;0;0;0
1117600;Day of vaccination;;0 - 20,000;13;0;13;0;0;0
1117660;Mines of Volantis;;0 - 20,000;9;6;3;0;0;0
1117660;Mines of Volantis;;0 - 20,000;9;6;3;0;0;0
1117670;GONNER2;;0 - 20,000;80;32;48;0;0;1
1117710;Contraptions;;0 - 20,000;2;1;1;0;0;0
1117760;Deadly Step;;0 - 20,000;8;5;3;0;0;0
1117810;Git Gud or Get Rekt;;0 - 20,000;34;12;22;0;0;0
1117840;Azurebreak Heroes;;0 - 20,000;11;0;11;0;0;0
1117880;Biolab Wars;;0 - 20,000;93;12;81;0;0;0
1117890;Tamiku;;0 - 20,000;13;0;13;0;0;0
1117930;惊奇剑士;;0 - 20,000;39;17;22;0;0;0
1117970;Monochrome Order;;0 - 20,000;8;1;7;0;0;0
1117980;Asdivine Kamura;;0 - 20,000;6;0;6;0;0;0
1117990;Wizards of Brandel;;0 - 20,000;7;0;7;0;0;0
1118000;Revenant March;;0 - 20,000;16;1;15;0;0;0
1118050;Terminal squad: Sentinel;;0 - 20,000;20;9;11;0;0;1
1118070;1976 - Back to midway;;0 - 20,000;111;11;100;3;3;0
1118100;曲阿小将 Minor Leader;;0 - 20,000;10;5;5;0;0;0
1118200;People Playground;;2,000,000 - 5,000,000;166996;1975;165021;2442;671;9216
1118240;Lake;;100,000 - 200,000;2304;354;1950;223;223;28
1118310;RetroArch;;500,000 - 1,000,000;3811;415;3396;0;0;504
1118320;Nation Breakers: Steam Arena;;0 - 20,000;9;1;8;0;0;0
1118350;Meegah Mem 2;;0 - 20,000;38;24;14;0;0;0
1118380;Discord Bot Studio;;50,000 - 100,000;372;80;292;22;22;12
1118410;GLADIUM;;0 - 20,000;46;10;36;0;0;0
1118470;Wood 'n Stones;;0 - 20,000;10;1;9;0;0;0
1118500;Thugsters Battle Royale;;0 - 20,000;0;1;-1;0;0;0
1118550;Fury's Sky;;0 - 20,000;6;1;5;0;0;0
1118570;Erstwhile Tower;;0 - 20,000;6;0;6;0;0;0
1118580;Wintercearig;;0 - 20,000;13;1;12;0;0;0
1118580;Wintercearig;;0 - 20,000;13;1;12;0;0;0
1118640;Meta: Assembled;;0 - 20,000;4;0;4;0;0;0
1118670;Space raven quest - Tiny planet;;0 - 20,000;1;1;0;0;0;0
1118690;Radical Gear;;0 - 20,000;4;2;2;0;0;0
1118700;Super Demon Boy;;0 - 20,000;20;9;11;0;0;0
1118730;Super Lee World;;0 - 20,000;4;7;-3;0;0;0
1118740;Cruel Bands Career;;0 - 20,000;42;4;38;0;0;0
1118790;VQD;;0 - 20,000;2;1;1;0;0;0
1118820;Seraphic Destroyer;;0 - 20,000;7;14;-7;0;0;0
1118840;My name is You and it's the only unusual thing in my life;;20,000 - 50,000;600;106;494;62;98;1
1118850;Lock;;;;;0;;;
1118870;Sort Battle: Dungeon;;0 - 20,000;0;1;-1;0;0;0
1118880;Rituals in the Dark;;0 - 20,000;83;10;73;0;0;0
1118920;TrenchesWIP;;200,000 - 500,000;1001;362;639;0;0;2
1118920;TrenchesWIP;;200,000 - 500,000;1001;362;639;0;0;2
1118930;FRENZY PLANTS;;0 - 20,000;12;16;-4;0;0;0
1118940;Robot terminator;;0 - 20,000;8;5;3;0;0;0
1118950;Engineer Arena;;0 - 20,000;1;0;1;0;0;0
1119010;Flippin Kaktus;;0 - 20,000;8;4;4;0;0;0
1119060;The Designer's Curse;;100,000 - 200,000;631;70;561;0;0;1
1119110;The Creature;;0 - 20,000;8;3;5;0;0;0
1119380;Trump Vs Rocketman;;0 - 20,000;9;6;3;0;0;0
1119430;The Backrooms Simulator;;0 - 20,000;21;12;9;0;0;0
1119500;FIGHT BALL - BOXING VR;;0 - 20,000;2;2;0;0;0;0
1119520;HITOTSU NO MORI;;0 - 20,000;98;8;90;0;0;0
1119530;ZHIVE;;0 - 20,000;10;7;3;0;0;0
1119560;Indian Legends Solitaire;;0 - 20,000;20;13;7;0;0;0
1119570;Discord Bot Builder;;0 - 20,000;138;55;83;225;225;7
1119590;Δ Time;;20,000 - 50,000;10;3;7;0;0;0
1119600;Help Will Come Tomorrow;;20,000 - 50,000;593;136;457;25;25;8
1119610;The Wednesday;;20,000 - 50,000;56;63;-7;0;0;0
1119620;Beyond Shattered Isles;;20,000 - 50,000;29;11;18;0;0;0
1119620;Beyond Shattered Isles;;20,000 - 50,000;29;11;18;0;0;0
1119630;DarkFairyTales SleepingBeauty;;20,000 - 50,000;1;3;-2;0;0;0
1119640;Hentai MatchUp;;0 - 20,000;2;1;1;0;0;0
1119670;HoloSprint;;0 - 20,000;3;1;2;0;0;0
1119680;Jade's Ascension;;0 - 20,000;1;0;1;0;0;0
1119690;LAMO The Game;;50,000 - 100,000;69;42;27;0;0;0
1119700;As Far As The Eye;;100,000 - 200,000;1417;487;930;305;305;11
1119730;Ranch Simulator - Build, Farm, Hunt;;200,000 - 500,000;11003;2017;8986;798;447;731
1119740;The Tower 2;;0 - 20,000;9;0;9;0;0;0
1119770;VaporFly;;0 - 20,000;10;6;4;0;0;0
1119790;RTSM;;0 - 20,000;8;0;8;0;0;0
1119800;Brume;;0 - 20,000;86;17;69;0;0;0
1119840;Sands of Aura;;0 - 20,000;154;48;106;94;94;6
1119860;Emberheart;;0 - 20,000;21;11;10;0;0;0
1119870;Bot Land;;0 - 20,000;56;27;29;0;0;0
1119890;Babylonia;;0 - 20,000;8;3;5;0;0;0
1119940;Storm Tale;;0 - 20,000;50;3;47;0;0;4
1119970;Elf Manor;;0 - 20,000;57;37;20;0;0;0
1119980;In Sound Mind;;50,000 - 100,000;2195;115;2080;597;677;20
1120050;Hyacinthus;;0 - 20,000;15;3;12;0;0;0
1120090;Gobligeddon;;20,000 - 50,000;23;2;21;0;0;0
1120160;Tricky Cow;;0 - 20,000;4;2;2;0;0;0
1120210;Make War;;0 - 20,000;62;23;39;0;0;0
1120240;Ded Inside;;0 - 20,000;37;6;31;0;0;0
1120280;Treasure Fleet;;0 - 20,000;10;6;4;0;0;0
1120310;Game Dashboard;;0 - 20,000;16;4;12;0;0;3
1120320;Builder Simulator;;50,000 - 100,000;806;234;572;140;165;37
1120340;Meu Mundo;;0 - 20,000;3;1;2;0;0;0
1120360;At Home Alone II;;20,000 - 50,000;178;22;156;0;0;0
1120370;場外人生;;20,000 - 50,000;260;33;227;524;524;5
1120390;Tri6: Infinite;;0 - 20,000;5;0;5;0;0;0
1120400;Terra Randoma;;0 - 20,000;80;11;69;0;0;0
1120410;Apollo 11 VR;;0 - 20,000;8;6;2;0;0;0
1120420;Infini;;0 - 20,000;29;0;29;0;0;0
1120480;The Anacrusis;;50,000 - 100,000;663;803;-140;129;258;4
1120560;Sense - 不祥的预感: A Cyberpunk Ghost Story;;20,000 - 50,000;398;91;307;0;0;2
1120580;Clans to Kingdoms;;0 - 20,000;6;8;-2;0;0;0
1120600;From The Earth (프롬 더 어스);;0 - 20,000;8;1;7;0;0;0
1120640;Kaiju Kite Attack;;0 - 20,000;2;1;1;0;0;0
1120680;ViVO;;0 - 20,000;2;4;-2;0;0;0
1120690;Knock Harder: Useless;;20,000 - 50,000;357;21;336;0;0;0
1120700;Rescue Lucy 2;;0 - 20,000;17;4;13;0;0;0
1120750;One Way To Exit 2;;0 - 20,000;11;1;10;0;0;0
1120770;Gods of Havoc: Fall to Earth;;0 - 20,000;2;2;0;0;0;0
1120800;Alex Hunter: Lord of the Mind;;0 - 20,000;41;4;37;0;0;0
1120810;Eastern Exorcist;;500,000 - 1,000,000;5126;884;4242;143;172;10
1120820;N.E.O;;0 - 20,000;1;2;-1;0;0;0
1120850;Old Town Stories;;50,000 - 100,000;16;6;10;0;0;0
1120900;Hoodo;;0 - 20,000;1;3;-2;0;0;0
1120920;ELON on MARS;;0 - 20,000;16;13;3;0;0;0
1120940;Forgotten Passages;;0 - 20,000;18;4;14;0;0;0
1120950;Chameleon Run Deluxe Edition;;0 - 20,000;75;5;70;0;0;0
1120960;Crafting Block World;;20,000 - 50,000;14;23;-9;0;0;0
1120970;Dream Keeper;;0 - 20,000;4;0;4;0;0;0
1120980;bit Dungeon;;0 - 20,000;117;12;105;0;0;0
1121000;Bhavacakra Maco;;0 - 20,000;15;1;14;0;0;0
1121100;Color Slayer;;0 - 20,000;6;0;6;0;0;0
1121120;Smooth Mover;;0 - 20,000;1;1;0;0;0;0
1121140;Ionia;;0 - 20,000;64;25;39;0;0;0
1121200;Silicon City;;0 - 20,000;31;7;24;0;0;0
1121230;Bomb Bowling;;0 - 20,000;22;1;21;0;0;0
1121250;ChatAid;;0 - 20,000;2;2;0;0;0;0
1121270;Impossible Soaring;;50,000 - 100,000;25;1;24;0;0;0
1121290;Just Another Memory;;0 - 20,000;7;0;7;0;0;0
1121300;Mizuchi 白蛇心傳;;0 - 20,000;72;2;70;0;0;0
1121340;Secret City: The Human Threat Collector's Edition;;0 - 20,000;1;1;0;0;0;1
1121400;Drums of War;;0 - 20,000;10;2;8;0;0;0
1121460;Puzzle Bear;;0 - 20,000;1;0;1;0;0;0
1121490;Time Break 2121;;0 - 20,000;8;14;-6;0;0;0
1121530;Globesweeper: Hex Puzzler;;0 - 20,000;101;12;89;0;0;2
1121530;Globesweeper: Hex Puzzler;;0 - 20,000;101;12;89;0;0;2
1121550;Prisoner 518;;0 - 20,000;24;6;18;0;0;0
1121560;Atelier Ryza: Ever Darkness & the Secret Hideout;;200,000 - 500,000;5794;870;4924;1328;1208;208
1121570;Avalo Legends;;0 - 20,000;5;2;3;0;0;0
1121590;Adam - Lost Memories;;0 - 20,000;145;29;116;439;439;0
1121640;The Wandering Village;;200,000 - 500,000;2916;299;2617;194;247;118
1121650;Dark Zone Defense;;20,000 - 50,000;29;6;23;0;0;0
1121680;Remnants;;20,000 - 50,000;89;17;72;0;0;0
1121710;Total Lockdown;;20,000 - 50,000;617;189;428;1307;1307;2
1121710;Total Lockdown;;20,000 - 50,000;617;189;428;1307;1307;2
1121720;Monsters' Den Chronicles;;20,000 - 50,000;32;6;26;0;0;4
1121770;Animal war;;0 - 20,000;3;6;-3;0;0;0
1121780;Astria Ascending;;50,000 - 100,000;132;99;33;0;0;7
1121780;Astria Ascending;;50,000 - 100,000;132;99;33;0;0;7
1121820;Go For A Walk;;0 - 20,000;14;4;10;0;0;0
1121860;Flat Earths!;;0 - 20,000;5;1;4;0;0;0
1121910;I Love You, Colonel Sanders! A Finger Lickin’ Good Dating Simulator;;500,000 - 1,000,000;10866;926;9940;0;0;18
1121930;Synth Riders Beatmap Editor;;0 - 20,000;31;5;26;0;0;8
1121980;看不见的爱;;0 - 20,000;35;5;30;0;0;0
1122040;Kaede the Eliminator / Eliminator 小枫;;0 - 20,000;276;33;243;287;287;3
1122050;Gensokyo Night Festival;;200,000 - 500,000;3571;602;2969;97;112;1
1122090;DanceGirl-Swimwear;;0 - 20,000;3;3;0;0;0;0
1122090;DanceGirl-Swimwear;;0 - 20,000;3;3;0;0;0;0
1122100;Giraffe and Annika;;0 - 20,000;259;23;236;0;0;1
1122110;CENTRALIA;;20,000 - 50,000;4;33;-29;0;0;0
1122120;STATIONflow;;50,000 - 100,000;381;58;323;910;1738;8
1122150;ELEA;;0 - 20,000;24;20;4;0;0;0
1122180;Curse of Anabelle;;0 - 20,000;89;45;44;0;0;0
1122210;Guns Craft;;0 - 20,000;5;3;2;0;0;0
1122250;THE FATE OF THE BULLY;;0 - 20,000;11;5;6;0;0;0
1122280;Witchcrafty;;0 - 20,000;30;16;14;0;0;0
1122290;Nyanco Project;;20,000 - 50,000;110;22;88;0;0;0
1122310;Guildmaster Story;;0 - 20,000;8;0;8;0;0;0
1122360;Westwood Shadows;;0 - 20,000;43;9;34;0;0;0
1122440;Proxyah v3.1;;0 - 20,000;1;0;1;0;0;0
1122460;Alien Infection;;0 - 20,000;3;4;-1;0;0;0
1122490;Battleheart Legacy;;0 - 20,000;32;2;30;0;0;1
1122680;The Artful Escape;;20,000 - 50,000;1078;77;1001;53;53;2
1122690;Last Stop;;0 - 20,000;135;45;90;387;387;0
1122700;Hindsight;;0 - 20,000;46;10;36;0;0;1
1122710;The Werewolf Hills;;0 - 20,000;3;3;0;0;0;0
1122720;Sayonara Wild Hearts;;100,000 - 200,000;6817;203;6614;79;109;12
1122730;Magna Fortuna;;0 - 20,000;63;34;29;0;0;1
1122740;To the Hell;;0 - 20,000;20;2;18;0;0;0
1122750;异化之恶〇Abnormal Treatment;;200,000 - 500,000;2832;64;2768;0;0;6
1122760;XENOS Defense;;0 - 20,000;0;3;-3;0;0;0
1122780;Highly Likely;;0 - 20,000;118;39;79;0;0;0
1122810;DarkSpace 暗宇战纪;;0 - 20,000;16;2;14;0;0;0
1122830;Atomorf;;0 - 20,000;19;6;13;0;0;0
1122860;Stop it - Driving Simulation;;0 - 20,000;2;6;-4;0;0;0
1122870;MINI Wars;;0 - 20,000;4;9;-5;0;0;0
1122870;MINI Wars;;0 - 20,000;4;9;-5;0;0;0
1122880;Stones of Solace;;0 - 20,000;118;9;109;0;0;0
1122900;Sine Wave City;;0 - 20,000;1;1;0;0;0;0
1122920;Path Of Aurora;;0 - 20,000;2;2;0;0;0;0
1122960;Horizon Beyond;;50,000 - 100,000;149;17;132;0;0;0
1122970;Zombie Island;;20,000 - 50,000;82;42;40;0;0;0
1123000;Jitsumi's Blue-Light Filter;;0 - 20,000;6;1;5;0;0;0
1123030;WHO IS AWESOME;;0 - 20,000;86;12;74;0;0;0
1123050;GRIME;;100,000 - 200,000;3083;479;2604;899;1145;54
1123060;Alien Creatures;;0 - 20,000;2;6;-4;0;0;0
1123070;REFLASER;;0 - 20,000;6;0;6;0;0;0
1123080;FadeZone 消逝之地;;0 - 20,000;32;3;29;0;0;0
1123080;FadeZone 消逝之地;;0 - 20,000;32;3;29;0;0;0
1123090;Langton's Ant;;0 - 20,000;14;2;12;0;0;0
1123150;Church Art Of Sweden;;0 - 20,000;11;4;7;0;0;0
1123230;HEXTERMINATE;;0 - 20,000;17;3;14;0;0;0
1123300;Castle Woodwarf;;20,000 - 50,000;129;24;105;0;0;0
1123310;Super Lobster Run;;0 - 20,000;30;2;28;0;0;0
1123340;Run! Bunny 绿绿小先生;;0 - 20,000;26;2;24;0;0;0
1123360;In Retrospect;;0 - 20,000;14;0;14;0;0;1
1123400;The Land of Exile;;0 - 20,000;77;16;61;0;0;0
1123410;Tailypo: The Game;;0 - 20,000;0;2;-2;0;0;0
1123450;Chicory: A Colorful Tale;;50,000 - 100,000;2182;47;2135;692;1172;23
1123460;Fateline(命运线);;0 - 20,000;23;7;16;0;0;2
1123500;Hell of Men : Blood Brothers;;0 - 20,000;19;7;12;0;0;0
1123510;Самозванец;;0 - 20,000;12;7;5;0;0;0
1123550;Desire Gambling House/欲望赌馆;;0 - 20,000;35;42;-7;0;0;0
1123570;FlyCatcher;;0 - 20,000;4;1;3;0;0;0
1123610;Indiecalypse;;0 - 20,000;19;22;-3;0;0;0
1123770;Curse of the Dead Gods;;200,000 - 500,000;5324;814;4510;831;513;113
1123830;Farm Manager 2021;;100,000 - 200,000;1323;345;978;308;308;78
1123850;Red Black Poker;;0 - 20,000;1;0;1;0;0;0
1123870;The Man with the Ivory Cane;;0 - 20,000;2;4;-2;0;0;1
1123900;Dark Tales: Edgar Allan Poe's Ligeia Collector's Edition;;0 - 20,000;6;0;6;0;0;0
1123910;The Pointless Car Chase;;0 - 20,000;4;2;2;0;0;0
1124000;Meu;;0 - 20,000;9;0;9;0;0;0
1124010;Princesses vs Dragons: Royal Rumble;;0 - 20,000;0;1;-1;0;0;0
1124050;Ogre Tale;;0 - 20,000;63;44;19;29;29;0
1124060;Touhou Shoujo Tale of Beautiful Memories / 東方少女綺想譚;;0 - 20,000;154;10;144;0;0;1
1124070;Tower VR;;0 - 20,000;23;14;9;0;0;0
1124080;Active DBG: Brave's Rage;;0 - 20,000;198;18;180;160;160;63
1124090;告死天使之言 Death angel;;50,000 - 100,000;271;61;210;0;0;2
1124130;Streets of Neotokio;;0 - 20,000;3;1;2;0;0;0
1124170;Spiralagon;;0 - 20,000;1;0;1;0;0;0
1124180;Rail Route;;50,000 - 100,000;961;60;901;91;112;172
1124190;Police Stunt Cars;;0 - 20,000;7;2;5;0;0;0
1124210;Heroes of Shaola;;20,000 - 50,000;9;4;5;0;0;0
1124260;Snowtopia: Ski Resort Builder;;20,000 - 50,000;506;269;237;204;333;13
1124270;Cosmic Monsters;;0 - 20,000;2;1;1;0;0;0
1124300;HUMANKIND;;500,000 - 1,000,000;14582;6922;7660;2189;1737;1079
1124310;Android Helipad;;0 - 20,000;1;0;1;0;0;0
1124380;One Gun 2: Stickman;;0 - 20,000;2;0;2;0;0;1
1124390;Paradigm City;;0 - 20,000;3;2;1;0;0;0
1124400;Zombien;;0 - 20,000;4;2;2;0;0;0
1124410;Tokyo Wizard;;0 - 20,000;4;0;4;0;0;0
1124430;The Adventures of Sullivan;;0 - 20,000;9;2;7;0;0;0
1124510;Crosser;;0 - 20,000;0;1;-1;0;0;0
1124520;Laranga;;0 - 20,000;1;1;0;0;0;0
1124530;Draft Day Sports: Pro Football 2020;;0 - 20,000;10;14;-4;0;0;0
1124550;ARC;;0 - 20,000;2;0;2;0;0;0
1124560;Fallen Angel;;0 - 20,000;110;36;74;0;0;1
1124600;Naau: The Lost Eye;;0 - 20,000;27;15;12;0;0;2
1124630;Lonepath;;0 - 20,000;1;1;0;0;0;0
1124640;Sacred Siren;;20,000 - 50,000;20;9;11;0;0;0
1124660;STORM AREA 51: AYY LMAO EDITION;;200,000 - 500,000;659;181;478;194;260;147
1124710;IS -Infinite Stratos- Versus Colors;;0 - 20,000;12;2;10;0;0;0
1124790;Hentai LightUp;;0 - 20,000;2;1;1;0;0;0
1124800;Aura Shift;;0 - 20,000;2;0;2;0;0;0
1124810;Tower of the Alchemist;;0 - 20,000;8;1;7;0;0;0
1124850;閃電對決Lightning Wings II;;0 - 20,000;6;7;-1;0;0;0
1124860;Otter Space Rescue;;0 - 20,000;4;1;3;0;0;0
1124940;Super Squad;;20,000 - 50,000;74;29;45;0;0;0
1124950;Hyperplex 3D;;0 - 20,000;9;0;9;0;0;0
1124960;EMMA: Lost in Memories;;0 - 20,000;12;0;12;0;0;0
1124980;Watchers;;100,000 - 200,000;433;155;278;23;26;0
1124990;Destructivator 2;;0 - 20,000;47;2;45;0;0;0
1125000;Touhou Multi Scroll Shooting;;0 - 20,000;9;8;1;0;0;0
1125000;Touhou Multi Scroll Shooting;;0 - 20,000;9;8;1;0;0;0
1125100;akeytsu Indie 2020;;0 - 20,000;14;3;11;0;0;0
1125110;Obsurity;;20,000 - 50,000;160;47;113;0;0;0
1125130;Area 51;;0 - 20,000;7;3;4;0;0;0
1125240;Ancient Dungeon;;20,000 - 50,000;707;28;679;366;511;19
1125290;moofa;;0 - 20,000;2;0;2;0;0;0
1125330;Griefhelm;;20,000 - 50,000;212;68;144;0;0;0
1125340;Tales of Lazo;;0 - 20,000;3;0;3;0;0;0
1125350;Geocells Quadcells;;0 - 20,000;4;0;4;0;0;0
1125360;Fantasy Little Jobs;;0 - 20,000;12;0;12;0;0;0
1125370;Space Grunts 2;;0 - 20,000;5;0;5;0;0;0
1125390;Atrio: The Dark Wild;;0 - 20,000;311;50;261;0;0;42
1125420;Death and Progress;;50,000 - 100,000;16;1;15;0;0;0
1125450;Sanitarium Rush;;0 - 20,000;1;0;1;0;0;0
1125480;School Years;;50,000 - 100,000;1195;232;963;151;220;5
1125490;STORM AREA 51: CUTE ALIEN GIRL EDITION;;0 - 20,000;11;4;7;0;0;0
1125600;TAG WAR;;0 - 20,000;2;1;1;0;0;0
1125620;Wizhood: The Epic of Freedom;;0 - 20,000;12;0;12;0;0;0
1125650;Rogue Production Facility;;0 - 20,000;0;1;-1;0;0;0
1125690;Eggness;;0 - 20,000;0;2;-2;0;0;0
1125700;Endless Void;;0 - 20,000;3;1;2;0;0;0
1125710;Gatewalkers;;20,000 - 50,000;209;95;114;0;0;11
1125730;VR Puzzle Box;;0 - 20,000;8;2;6;0;0;0
1125770;Monoa City Parking;;0 - 20,000;0;1;-1;0;0;0
1125800;Endless Ski;;0 - 20,000;11;1;10;0;0;0
1125820;ClearIt5;;0 - 20,000;5;0;5;0;0;1
1125860;Rabisco;;0 - 20,000;52;0;52;0;0;0
1125870;Public Enemy: Revolution Simulator;;20,000 - 50,000;53;7;46;0;0;0
1125880;LaserZone;;0 - 20,000;41;0;41;0;0;0
1125890;Party Maker;;0 - 20,000;63;23;40;0;0;1
1125910;Crowns and Pawns: Kingdom of Deceit;;0 - 20,000;244;40;204;0;0;1
1125930;UNFAIR;;0 - 20,000;18;0;18;0;0;0
1125980;VoxelSuite;;50,000 - 100,000;5;0;5;0;0;0
1126060;Bunker 56;;0 - 20,000;14;6;8;0;0;0
1126070;Let's See What You Got;;0 - 20,000;8;0;8;0;0;0
1126090;Booby And The Booby Trap;;0 - 20,000;39;6;33;0;0;0
1126100;WELCOME;;0 - 20,000;0;2;-2;0;0;0
1126110;Keep the Keep;;0 - 20,000;21;0;21;0;0;2
1126120;Lucd;;0 - 20,000;8;1;7;0;0;0
1126130;The Pillar;;0 - 20,000;29;17;12;0;0;0
1126190;Disney Classic Games: Aladdin and The Lion King;;20,000 - 50,000;165;52;113;270;460;32
1126220;EasyPianoGame;;0 - 20,000;13;7;6;0;0;0
1126260;Serpent Fusion;;0 - 20,000;29;5;24;0;0;0
1126270;Neon Tail;;0 - 20,000;69;7;62;0;0;0
1126280;河南1942 The Henan Famine;;0 - 20,000;8;2;6;0;0;0
1126290;Lost;;200,000 - 500,000;6055;1409;4646;99;95;10
1126300;DragonClash;;0 - 20,000;3;2;1;0;0;0
1126310;风信楼;;100,000 - 200,000;2979;196;2783;699;824;79
1126340;Raid on Area 51;;0 - 20,000;7;1;6;0;0;0
1126420;REMOTE LIFE;;0 - 20,000;196;19;177;0;0;0
1126430;香江之龙，Dragon of Hongkong;;0 - 20,000;2;2;0;0;0;0
1126440;Rogue Rocks;;0 - 20,000;27;7;20;0;0;0
1126470;Jewel Match Atlantis Solitaire - Collector's Edition;;0 - 20,000;64;12;52;0;0;6
1126510;Sad :');;0 - 20,000;40;5;35;0;0;0
1126510;Sad :');;0 - 20,000;40;5;35;0;0;0
1126550;I'm from area 51;;20,000 - 50,000;8;3;5;0;0;0
1126550;I'm from area 51;;20,000 - 50,000;8;3;5;0;0;0
1126560;Video deluxe 2020 Plus Steam Edition;;0 - 20,000;3;5;-2;0;0;0
1126570;Video deluxe 2020 Steam Edition;;0 - 20,000;3;5;-2;0;0;0
1126580;The Captain is Dead;;0 - 20,000;54;12;42;0;0;0
1126600;Before I Forget;;0 - 20,000;102;11;91;59;59;1
1126630;Elder Village;;0 - 20,000;0;1;-1;0;0;0
1126640;The Forgotten;;0 - 20,000;7;14;-7;0;0;0
1126680;Neonis;;0 - 20,000;1;0;1;0;0;0
1126710;魔法使いハナビィ Hanaby the Witch;;0 - 20,000;41;1;40;0;0;0
1126750;Mr. DRILLER DrillLand;;0 - 20,000;188;43;145;0;0;10
1126770;My Bones Remastered;;0 - 20,000;25;31;-6;0;0;0
1126820;Heroic Mercenaries;;0 - 20,000;3;0;3;0;0;0
1126840;12 HOURS 2;;0 - 20,000;9;7;2;0;0;0
1126850;Power;;0 - 20,000;26;1;25;0;0;0
1126860;Nauseous Pines;;0 - 20,000;5;1;4;0;0;0
1126880;Pixel Puzzles 4k: Japan;;0 - 20,000;5;0;5;0;0;0
1126890;Urban Cards;;0 - 20,000;123;28;95;0;0;2
1126950;Extreme Tactical Executioners;;0 - 20,000;4;0;4;0;0;0
1126970;Strazeal;;0 - 20,000;2;0;2;0;0;0
1127010;Ebullition LBVR;;0 - 20,000;2;0;2;0;0;1
1127030;Throw The Ball In the Hole;;0 - 20,000;12;3;9;0;0;0
1127070;Familiar Travels - Volume One;;0 - 20,000;91;12;79;0;0;1
1127100;PamPam Kana Students;;0 - 20,000;7;1;6;0;0;0
1127110;Outpost;;200,000 - 500,000;559;72;487;0;0;13
1127120;R42;;0 - 20,000;3;0;3;0;0;0
1127130;Happy Oshare Time;;0 - 20,000;26;0;26;0;0;0
1127140;初开在平安夜之花 -The Flower on Christmas Eve-;;0 - 20,000;28;1;27;0;0;0
1127170;DreamFly;;0 - 20,000;47;22;25;0;0;1
1127180;Robot Vacuum Simulator X;;0 - 20,000;7;2;5;0;0;0
1127200;A Wanderer's Adventure;;0 - 20,000;4;2;2;0;0;0
1127210;Mystery at Stonyford Bridge;;0 - 20,000;6;0;6;0;0;0
1127230;Shooting Blaster Big Bang Boom;;0 - 20,000;4;0;4;0;0;0
1127250;Deadly Maze: Phase 1;;0 - 20,000;2;4;-2;0;0;0
1127290;Battle Survive Hentai;;0 - 20,000;11;6;5;0;0;0
1127310;HelixVision;;20,000 - 50,000;87;51;36;0;0;0
1127320;Railroads;;0 - 20,000;9;0;9;0;0;0
1127330;MechCube: Escape;;0 - 20,000;27;5;22;0;0;0
1127350;Mazes and Mages 2;;0 - 20,000;2;2;0;0;0;0
1127360;Cup Of Ethanol;;0 - 20,000;62;17;45;0;0;0
1127400;Mindustry;;500,000 - 1,000,000;13243;531;12712;1375;814;723
1127460;Mod and Play;;50,000 - 100,000;743;907;-164;51;67;1
1127470;Skater Frog;;20,000 - 50,000;169;15;154;0;0;0
1127480;WHAT'S LEFT;;0 - 20,000;1;0;1;0;0;0
1127500;Mini Motorways;;500,000 - 1,000,000;14803;593;14210;475;269;399
1127520;TREE HOUSE : AVOCADO MAYHEM;;0 - 20,000;1;0;1;0;0;0
1127530;SKYCAT;;0 - 20,000;10;2;8;0;0;0
1127560;Flip Polygon;;0 - 20,000;2;0;2;0;0;0
1127580;Smaller;;0 - 20,000;2;0;2;0;0;0
1127610;Iris and the Giant;;20,000 - 50,000;938;117;821;317;442;3
1127620;ByLo;;0 - 20,000;18;13;5;0;0;0
1127620;ByLo;;0 - 20,000;18;13;5;0;0;0
1127680;Hypnocult;;0 - 20,000;40;1;39;0;0;0
1127690;Winter Magic Factory;;0 - 20,000;16;7;9;0;0;0
1127730;Animal Up!;;0 - 20,000;23;2;21;0;0;0
1127820;Repressed;;0 - 20,000;14;5;9;0;0;0
1127840;Landlord's Super;;20,000 - 50,000;869;95;774;518;518;32
1127850;Apple Slash;;0 - 20,000;186;6;180;0;0;1
1127860;CyberLink PowerDirector 18 Ultimate - Video editing, Video editor, making videos;;0 - 20,000;18;5;13;0;0;0
1127870;CyberLink PowerDirector 18 Ultra - Video editing, Video editor, making videos;;0 - 20,000;12;3;9;0;0;0
1127880;CyberLink PhotoDirector 11 Ultra - Photo editor, photo editing software;;0 - 20,000;12;5;7;0;0;0
1127920;Loser Reborn;;0 - 20,000;57;9;48;0;0;0
1127930;My Bike;;0 - 20,000;26;16;10;0;0;0
1127970;Retro Machina;;200,000 - 500,000;162;22;140;0;0;1
1127980;NASCAR Heat 4;;100,000 - 200,000;1311;306;1005;434;760;34
1128000;Cube World;;500,000 - 1,000,000;6739;11294;-4555;704;569;35
1128010;Zoological Era II;;0 - 20,000;1;0;1;0;0;0
1128100;ZeroZone2020;;20,000 - 50,000;109;19;90;0;0;0
1128140;Under: Depths of Fear;;0 - 20,000;166;80;86;0;0;0
1128150;祭壇の花/Saidan no Hana;;0 - 20,000;0;1;-1;0;0;0
1128160;Saturday of Piercing Screams;;0 - 20,000;10;4;6;0;0;0
1128170;Power Stealers;;0 - 20,000;4;2;2;0;0;0
1128180;CROSSNIQ+;;0 - 20,000;68;6;62;0;0;0
1128190;Achievement Simulator;;0 - 20,000;62;14;48;0;0;0
1128210;Orion13;;0 - 20,000;10;5;5;0;0;0
1128220;ZAAM;;0 - 20,000;40;13;27;0;0;0
1128260;The Princess, the Stray Cat, and Matters of the Heart 2;;0 - 20,000;123;6;117;0;0;3
1128280;IGOR MAKS The Meme Lord;;0 - 20,000;7;1;6;0;0;0
1128310;Koi Unleashed;;0 - 20,000;4;3;1;0;0;0
1128310;Koi Unleashed;;0 - 20,000;4;3;1;0;0;0
1128370;Try again!;;0 - 20,000;23;0;23;0;0;0
1128420;Solitaire Jack Frost Winter Adventures;;0 - 20,000;3;1;2;0;0;0
1128430;Solitaire Match 2 Cards. Valentine's Day;;0 - 20,000;5;2;3;0;0;1
1128440;Solitaire Legend of the Pirates;;0 - 20,000;4;2;2;0;0;0
1128450;光與暗之戀曲;;0 - 20,000;41;18;23;0;0;0
1128480;Nice Jumper;;20,000 - 50,000;255;43;212;0;0;0
1128520;Rezist: Tower Defense;;0 - 20,000;7;0;7;0;0;0
1128570;Weeping Willow - Detective Visual Novel;;0 - 20,000;53;12;41;0;0;0
1128570;Weeping Willow - Detective Visual Novel;;0 - 20,000;53;12;41;0;0;0
1128610;Affinity;;0 - 20,000;7;0;7;0;0;0
1128630;Cross Country Express;;0 - 20,000;2;2;0;0;0;0
1128660;Roots Of The Woods;;0 - 20,000;13;4;9;0;0;0
1128680;DOUBLE INVASION!!;;0 - 20,000;2;0;2;0;0;0
1128770;Use Your Brain!;;0 - 20,000;3;0;3;0;0;0
1128810;RISK: Global Domination;;2,000,000 - 5,000,000;24785;5335;19450;341;102;2442
1128830;1001 Jigsaw World Tour: Europe;;0 - 20,000;5;2;3;0;0;0
1128840;Solitaire Victorian Picnic;;0 - 20,000;6;3;3;0;0;1
1128890;Light Trail Rush;;0 - 20,000;1;2;-1;0;0;0
1128900;live Desktop Beauty;;0 - 20,000;132;72;60;13;13;1
1128910;Magic Quest: TCG;;0 - 20,000;31;16;15;0;0;0
1128920;EVERSPACE 2;;200,000 - 500,000;4757;706;4051;239;288;100
1128960;最后的巫后：众王纷争的年代 Witch Queen;;0 - 20,000;40;7;33;0;0;0
1128970;Eterna: Heroes Fall;;0 - 20,000;19;8;11;0;0;0
1129030;Endless Fables 4: Shadow Within;;0 - 20,000;96;13;83;217;217;3
1129080;Forex Demo Accelerator;;0 - 20,000;2;2;0;0;0;0
1129090;Sticky Paws;;0 - 20,000;34;6;28;0;0;0
1129110;Magistrangers;;50,000 - 100,000;6;2;4;0;0;0
1129180;Glitch Puzzle;;0 - 20,000;17;1;16;0;0;0
1129190;Our Life: Beginnings & Always;;200,000 - 500,000;8564;92;8472;196;196;217
1129200;Minesweep World;;20,000 - 50,000;1;1;0;0;0;0
1129210;A Million Conquests;;50,000 - 100,000;1;1;0;0;0;0
1129220;BEARS, VODKA, BALALAIKA! ;;50,000 - 100,000;1705;178;1527;14;16;1
1129230;Luna Sanctus;;0 - 20,000;1;0;1;0;0;0
1129240;Mystic Mayhem Unleashed;;0 - 20,000;2;0;2;0;0;0
1129250;NEKO-NIN exHeart 3;;0 - 20,000;191;12;179;335;340;1
1129310;Receiver 2;;200,000 - 500,000;2059;187;1872;761;941;21
1129330;Spark and Sparkle;;0 - 20,000;18;0;18;0;0;0
1129350;Murgles;;20,000 - 50,000;8;2;6;0;0;0
1129410;The Shattered Blade;;0 - 20,000;4;0;4;0;0;0
1129480;El Culto;;0 - 20,000;5;3;2;0;0;0
1129550;edataconsulting VR Office;;0 - 20,000;7;1;6;0;0;0
1129580;Medieval Dynasty;;1,000,000 - 2,000,000;26687;2705;23982;2325;1011;2481
1129610;Book Seeker;;20,000 - 50,000;4;1;3;0;0;0
1129650;Lodestone -  The crazy cave adventures of mad Stony Tony and his encounter with the exploding rolling stones;;0 - 20,000;29;5;24;0;0;0
1129660;Runefall 2;;0 - 20,000;35;10;25;0;0;7
1129680;GraFi 3;;0 - 20,000;24;8;16;0;0;0
1129690;3x64;;0 - 20,000;19;1;18;0;0;0
1129700;Synzzball;;0 - 20,000;1;0;1;0;0;0
1129720;Area 51 Defense;;0 - 20,000;4;0;4;0;0;0
1129730;Lost Existence;;0 - 20,000;37;16;21;0;0;0
1129920;Tales From Off-Peak City Vol. 1;;20,000 - 50,000;440;5;435;255;255;0
1130400;Symmetry: Early Access;;0 - 20,000;10;1;9;0;0;0
1130410;Cyber Hook;;200,000 - 500,000;1976;100;1876;37;49;9
1130430;Escape from Chernobyl: Jailbreak;;0 - 20,000;9;1;8;0;0;0
1130440;10 Second Shuriken;;0 - 20,000;1;0;1;0;0;0
1130510;Floaty Fighters;;0 - 20,000;17;2;15;0;0;0
1130560;RPG NPC Simulator VR;;0 - 20,000;53;21;32;0;0;0
1130570;The Sword and the Slime;;0 - 20,000;10;0;10;0;0;0
1130590;Aleesha's Tower;;0 - 20,000;18;7;11;0;0;0
1130620;[Chilla's Art] Aka Manto | 赤マント;;20,000 - 50,000;619;66;553;0;0;3
1130660;Tiger Fighter 1931 Tora!Tora!;;0 - 20,000;0;2;-2;0;0;0
1130710;Bookbound Brigade;;0 - 20,000;25;10;15;0;0;0
1130880;Absolute Territory;;0 - 20,000;21;5;16;0;0;0
1130900;黎明霞光;;0 - 20,000;7;4;3;0;0;0
1130970;The Yellow Ladder;;0 - 20,000;0;1;-1;0;0;0
1130990;Roman Adventures: Britons. Season 2;;0 - 20,000;22;0;22;0;0;1
1131060;Dungeon of Eyden;;0 - 20,000;2;2;0;0;0;0
1131110;Orbitblazers;;0 - 20,000;3;0;3;0;0;0
1131140;The MoneyMakers Rallye;;0 - 20,000;72;9;63;0;0;0
1131160;Civil: The Game;;0 - 20,000;8;1;7;0;0;0
1131190;NERTS! Online;;100,000 - 200,000;1222;67;1155;88;122;11
1131230;Dominos!;;20,000 - 50,000;1;0;1;0;0;0
1131240;Dungeons of Edera;;50,000 - 100,000;688;242;446;186;240;6
1131270;Zombie Golf;;0 - 20,000;5;4;1;0;0;0
1131280;叫我铸造师;;0 - 20,000;12;6;6;0;0;0
1131330;CLOSED;;0 - 20,000;42;19;23;0;0;0
1131400;Project RIP;;0 - 20,000;79;41;38;0;0;1
1131410;Sable's Grimoire: Man And Elf;;0 - 20,000;48;0;48;0;0;1
1131420;For a Better Country;;0 - 20,000;0;6;-6;0;0;0
1131430;Parachronism: Order of Chaos;;0 - 20,000;4;1;3;0;0;0
1131450;Above Earth;;0 - 20,000;17;5;12;0;0;0
1131460;明日探险家;;20,000 - 50,000;4;0;4;0;0;0
1131490;Wandering Gem Jockeying;;0 - 20,000;4;1;3;0;0;0
1131520;Trial And Terror;;0 - 20,000;4;0;4;0;0;0
1131530;Dum-Dum;;0 - 20,000;30;4;26;0;0;0
1131540;Light In The Dark;;20,000 - 50,000;44;4;40;0;0;0
1131550;I Walk Among Zombies Vol. 3;;0 - 20,000;187;22;165;5;5;0
1131580;Penguins vs. Bugs;;0 - 20,000;1;1;0;0;0;0
1131590;Aegis Online;;0 - 20,000;7;6;1;0;0;0
1131640;Climatic Survival: Northern Storm;;0 - 20,000;2;4;-2;0;0;0
1131660;The Ai Games;;0 - 20,000;4;4;0;0;0;0
1131670;Justin Wack and the Big Time Hack;;20,000 - 50,000;105;3;102;0;0;1
1131680;PPDD;;0 - 20,000;7;1;6;0;0;0
1131690;Xentripetal Force;;0 - 20,000;1;0;1;0;0;0
1131720;PROP AND SEEK;;200,000 - 500,000;3557;785;2772;150;80;95
1131740;Snowdome;;50,000 - 100,000;217;17;200;0;0;0
1131750;Alien Squatter;;0 - 20,000;60;4;56;0;0;0
1131780;Mustache or Revenge;;0 - 20,000;9;0;9;0;0;0
1131790;Injection π23 'No Name, No Number';;0 - 20,000;7;1;6;0;0;0
1131800;Pixel Puzzle Makeout League;;0 - 20,000;53;2;51;0;0;3
1131810;Gordon Streaman;;0 - 20,000;131;17;114;0;0;0
1131840;Pentaball;;0 - 20,000;5;1;4;0;0;0
1131870;Evergreen Blues;;0 - 20,000;39;2;37;0;0;0
1131880;Henry Mosse and the Wormhole Conspiracy;;0 - 20,000;11;0;11;0;0;0
1131900;3rd eye;;20,000 - 50,000;258;32;226;0;0;0
1131930;BARRICADEZ;;0 - 20,000;110;30;80;0;0;4
1131940;Jailbreak Simulator;;0 - 20,000;6;7;-1;0;0;0
1131960;云聚：失落的魔法 Magic Ganglia;;0 - 20,000;90;37;53;0;0;0
1132030;Trash Sailors: Co-Op Trash Raft Simulator;;20,000 - 50,000;162;56;106;0;0;3
1132050;TheMovingMaze;;0 - 20,000;9;0;9;0;0;0
1132070;5.0;;0 - 20,000;146;23;123;0;0;1
1132090;Silk;;0 - 20,000;20;4;16;0;0;0
1132100;Samurai of Hyuga Book 4;;0 - 20,000;39;10;29;0;0;4
1132110;Heaven's Grave;;;;;0;;;
1132160;Mendel's Garden;;0 - 20,000;7;1;6;0;0;0
1132180;Persephone;;0 - 20,000;18;2;16;0;0;0
1132190;Coloring Game: Little City;;100,000 - 200,000;891;55;836;577;871;10
1132220;Iridion 3D;;0 - 20,000;9;0;9;0;0;0
1132230;Iridion II;;0 - 20,000;13;1;12;0;0;0
1132290;Eldritch University;;0 - 20,000;7;2;5;0;0;0
1132300;Ribbon;;0 - 20,000;0;1;-1;0;0;0
1132410;Cyber OutRun;;0 - 20,000;23;44;-21;0;0;0
1132410;Cyber OutRun;;0 - 20,000;23;44;-21;0;0;0
1132460;Codebreaker;;0 - 20,000;2;1;1;0;0;0
1132490;Phucker in the Woods;;0 - 20,000;134;9;125;0;0;0
1132510;Depixtion: Halloween;;0 - 20,000;8;0;8;0;0;0
1132540;Colonies End;;0 - 20,000;2;4;-2;0;0;0
1132620;Last Knight;;0 - 20,000;4;4;0;0;0;0
1132640;Platforms;;0 - 20,000;2;0;2;0;0;0
1132670;Metal Heads;;0 - 20,000;20;10;10;0;0;0
1132690;Knights of Messiah;;0 - 20,000;68;61;7;0;0;1
1132720;I Walk Among Zombies Vol. 0;;0 - 20,000;82;13;69;0;0;0
1132730;巅峰骑士团;;100,000 - 200,000;1065;104;961;0;0;2
1132730;巅峰骑士团;;100,000 - 200,000;1065;104;961;0;0;2
1132750;Buck Zombies;;0 - 20,000;5;4;1;0;0;0
1132760;Dwerve;;20,000 - 50,000;387;129;258;366;366;5
1132770;World War 2 Craft (二战演义);;0 - 20,000;8;3;5;0;0;0
1132830;Poppy's Nightmare;;0 - 20,000;7;5;2;0;0;0
1132840;RhythmSnake;;0 - 20,000;4;3;1;0;0;0
1132850;Try not to die;;0 - 20,000;2;0;2;0;0;0
1132860;Jera;;0 - 20,000;14;7;7;0;0;0
1132880;The Pilgrim;;20,000 - 50,000;99;4;95;0;0;0
1132910;ITORAH;;0 - 20,000;273;64;209;0;0;8
1132930;Phantom 3D;;0 - 20,000;5;0;5;0;0;0
1132970;Time To Stop Time;;0 - 20,000;93;39;54;314;314;1
1133050;Good Night, Knight;;0 - 20,000;33;4;29;0;0;0
1133060;Anarchy: Wolf's law;;20,000 - 50,000;345;62;283;0;0;4
1133070;Viking Chess: Hnefatafl;;0 - 20,000;43;4;39;0;0;0
1133120;Ecosystem;;20,000 - 50,000;231;50;181;305;305;1
1133120;Ecosystem;;20,000 - 50,000;231;50;181;305;305;1
1133200;Escape Zolstar;;0 - 20,000;8;0;8;0;0;0
1133210;Inner;;0 - 20,000;11;4;7;0;0;0
1133230;Little Awesome Dudes;;0 - 20,000;4;8;-4;0;0;0
1133250;CULT;;;;;0;;;
1133260;Vole Complexity;;0 - 20,000;3;0;3;0;0;0
1133300;Sisters Royale: Five Sisters Under Fire;;0 - 20,000;28;1;27;0;0;0
1133310;LASERVASION;;0 - 20,000;3;3;0;0;0;0
1133320;Westworld Awakening;;20,000 - 50,000;274;57;217;62;62;0
1133330;Helicopter Simulator;;0 - 20,000;97;55;42;0;0;1
1133350;Gravity Control;;0 - 20,000;4;6;-2;0;0;0
1133420;Hero or Villain: Genesis;;0 - 20,000;23;9;14;0;0;1
1133430;Ashes of Creation Apocalypse;;200,000 - 500,000;301;519;-218;0;0;0
1133450;Hexa Trains;;0 - 20,000;10;8;2;0;0;0
1133520;ICONIC;;0 - 20,000;5;0;5;0;0;0
1133530;Mythic Pearls: The Legend of Tirnanog;;0 - 20,000;3;2;1;0;0;1
1133540;Grid Wars;;0 - 20,000;1;0;1;0;0;0
1133570;Shining City;;0 - 20,000;17;9;8;0;0;0
1133580;Snapshot VR;;0 - 20,000;84;12;72;0;0;6
1133590;Stilt Fella;;100,000 - 200,000;735;67;668;199;251;2
1133610;落华居;;0 - 20,000;7;5;2;0;0;0
1133640;Boom 3D Mac;;0 - 20,000;3;2;1;0;0;2
1133730;Second Galaxy;;100,000 - 200,000;572;531;41;0;0;14
1133760;CHRONO CROSS: THE RADICAL DREAMERS EDITION;;100,000 - 200,000;851;627;224;1159;1159;25
1133780;Bandit the game;;20,000 - 50,000;16;2;14;0;0;0
1133790;Armortale;;0 - 20,000;29;3;26;0;0;0
1133800;Ealu - Build Share Play [Early Access];;0 - 20,000;1;0;1;0;0;0
1133890;P1R4T3S;;0 - 20,000;6;5;1;0;0;0
1133910;Caravan Chaos;;0 - 20,000;18;0;18;0;0;0
1133930;Forgotten Hill Disillusion;;20,000 - 50,000;133;13;120;0;0;4
1133950;The Castle;;0 - 20,000;20;1;19;0;0;0
1133970;Battle Dome Redux;;0 - 20,000;2;0;2;0;0;0
1133980;Spirit Arena;;0 - 20,000;13;1;12;0;0;0
1133990;Calm Down, Stalin - VR;;0 - 20,000;58;2;56;25;25;0
1134020;Sons of Ra;;0 - 20,000;45;12;33;0;0;0
1134030;The Paperman;;50,000 - 100,000;214;92;122;0;0;0
1134040;Labyrinths of the World: Fool's Gold Collector's Edition;;0 - 20,000;2;1;1;0;0;0
1134050;Head Over Heels;;0 - 20,000;6;4;2;0;0;0
1134070;Keeper 2119;;0 - 20,000;6;0;6;0;0;0
1134100;Frozenheim;;100,000 - 200,000;1979;775;1204;133;187;23
1134120;Brutal Sports - Football;;0 - 20,000;3;0;3;0;0;0
1134130;Legends;;0 - 20,000;1;2;-1;0;0;0
1134140;Daaang!;;0 - 20,000;1;0;1;0;0;0
1134150;X Wars Deluxe;;0 - 20,000;20;15;5;0;0;0
1134190;tri.Attack();;;;;0;;;
1134200;Chicks and Tricks VR;;0 - 20,000;23;6;17;0;0;0
1134250;Hexadrift;;0 - 20,000;7;2;5;0;0;0
1134260;O Rei;;20,000 - 50,000;10;1;9;0;0;0
1134320;GLADOM - 2D PVP Free & Skill Based;;0 - 20,000;21;6;15;0;0;0
1134370;Baron: Fur Is Gonna Fly;;0 - 20,000;13;0;13;0;0;0
1134390;Voidlifted;;0 - 20,000;5;1;4;0;0;0
1134450;ALLBLACK Phase 1;;50,000 - 100,000;47;19;28;0;0;0
1134470;Sleep Paralysis : mystery of the mountain village;;0 - 20,000;5;4;1;0;0;0
1134480;YORG.io 3;;0 - 20,000;148;75;73;136;136;6
1134500;Follow the White Rabbit VR (화이트래빗);;0 - 20,000;2;3;-1;0;0;0
1134520;Dark Light;;0 - 20,000;380;100;280;14;14;3
1134530;Banana Invaders;;0 - 20,000;3;4;-1;0;0;0
1134570;F1 2021;;1,000,000 - 2,000,000;29809;5028;24781;4034;1852;788
1134600;FOREST OF ELF;;0 - 20,000;1;1;0;0;0;0
1134630;Pear Quest;;0 - 20,000;20;4;16;0;0;0
1134700;Wild Terra 2: New Lands;;20,000 - 50,000;818;561;257;918;918;147
1134710;NIMBY Rails;;100,000 - 200,000;1214;121;1093;169;238;178
1134730;Wetpants;;0 - 20,000;9;0;9;0;0;0
1135030;jut;;0 - 20,000;13;3;10;0;0;0
1135040;Bombini;;0 - 20,000;9;3;6;0;0;0
1135050;Dr. Umgebung's School of Life;;0 - 20,000;8;8;0;0;0;0
1135060;King of the Sandcastle;;0 - 20,000;13;7;6;0;0;0
1135070;Moeras;;0 - 20,000;9;12;-3;0;0;0
1135090;dino game;;0 - 20,000;46;5;41;0;0;0
1135100;driftwood;;0 - 20,000;1;5;-4;0;0;0
1135110;Hoco Poco;;0 - 20,000;11;0;11;0;0;0
1135120;Tomscape;;0 - 20,000;4;9;-5;0;0;0
1135130;kamer;;0 - 20,000;7;3;4;0;0;0
1135140;huts;;0 - 20,000;4;4;0;0;0;0
1135150;Zoo Packs;;0 - 20,000;5;4;1;0;0;0
1135160;Botanik;;0 - 20,000;2;3;-1;0;0;0
1135170;spider ponds;;0 - 20,000;7;2;5;0;0;0
1135180;Llama Villa;;0 - 20,000;36;5;31;0;0;0
1135190;Hoppa;;0 - 20,000;3;4;-1;0;0;0
1135200;soko loco;;0 - 20,000;6;4;2;0;0;0
1135210;Oh Crab!;;0 - 20,000;2;5;-3;0;0;0
1135230;Ember Knights;;100,000 - 200,000;1772;86;1686;1336;1947;283
1135240;Men of War: Assault Squad 2 - Cold War;;200,000 - 500,000;251;768;-517;56;56;10
1135260;The Falconeer;;50,000 - 100,000;245;69;176;89;89;1
1135300;King's Bounty II;;200,000 - 500,000;2825;1632;1193;1862;1862;89
1135320;VR瓦割り / VR roof tile;;0 - 20,000;0;1;-1;0;0;0
1135370;Star Girl Proxima;;0 - 20,000;15;3;12;0;0;0
1135370;Star Girl Proxima;;0 - 20,000;15;3;12;0;0;0
1135380;不可思议佣兵团;;0 - 20,000;6;4;2;0;0;0
1135450;Psy High 2: High Summer;;0 - 20,000;9;1;8;0;0;0
1135480;Protect Your Fool;;0 - 20,000;2;0;2;0;0;0
1135560;The Thing at the Window;;20,000 - 50,000;0;2;-2;0;0;0
1135570;Martian Law;;20,000 - 50,000;134;218;-84;0;0;0
1135690;Unpacking;;200,000 - 500,000;17095;1423;15672;236;258;350
1135710;Peace Restored;;20,000 - 50,000;71;21;50;0;0;0
1135730;Zebra Logic Master;;0 - 20,000;11;0;11;0;0;0
1135740;Utopia;;0 - 20,000;37;10;27;0;0;0
1135750;Return to Earth;;0 - 20,000;6;2;4;0;0;0
1135760;Grab the Mask | 地牢假面;;0 - 20,000;1;1;0;0;0;0
1135800;Tiger Fighter 1931 Sunset;;0 - 20,000;0;3;-3;0;0;0
1135810;Vault of the Void;;50,000 - 100,000;1924;129;1795;603;1058;90
1135830;Brave Alchemist Colette;;20,000 - 50,000;759;76;683;148;148;17
1135860;Corpoct;;20,000 - 50,000;9;1;8;0;0;0
1135910;Hunting Simulator 2;;0 - 20,000;362;205;157;1047;1047;20
1136010;FeArea: Battle Royale;;0 - 20,000;2;1;1;0;0;0
1136020;Cannibal Cuisine;;0 - 20,000;71;19;52;0;0;1
1136040;ReThink 3;;0 - 20,000;19;1;18;0;0;0
1136070;UltraGoodness 2;;0 - 20,000;14;7;7;0;0;0
1136080;8 Eyes;;0 - 20,000;14;2;12;0;0;0
1136090;The Gadget Twins;;0 - 20,000;4;0;4;0;0;0
1136100;Mousegun;;0 - 20,000;9;1;8;0;0;0
1136110;Hidden Objects - The Mystery House;;20,000 - 50,000;3;14;-11;0;0;0
1136160;Internet Cafe Simulator;;200,000 - 500,000;6185;2364;3821;521;182;35
1136210;Ghost Productions: Wraith VR Total Knee Replacement Surgery Simulation;;0 - 20,000;33;0;33;0;0;0
1136240;Crowd Control;;20,000 - 50,000;33;9;24;0;0;0
1136250;Forep Man;;0 - 20,000;0;3;-3;0;0;0
1136370;Bear and Breakfast;;100,000 - 200,000;2939;288;2651;342;454;115
1136380;Ultimate Fishing Simulator 2;;20,000 - 50,000;749;222;527;365;469;51
1136420;Gates of Hell;;0 - 20,000;4;6;-2;0;0;0
1136440;HENTAI ARENA HOLY PUSSY;;0 - 20,000;22;23;-1;0;0;0
1136470;Aspects of change;;0 - 20,000;3;0;3;0;0;0
1136680;Building Killer;;0 - 20,000;1;0;1;0;0;0
1136730;Defect Process;;0 - 20,000;16;0;16;0;0;0
1136770;Maze;;0 - 20,000;2;2;0;0;0;0
1136790;Draconic Route;;0 - 20,000;4;2;2;0;0;0
1136820;Someone Cloned The President;;0 - 20,000;2;2;0;0;0;0
1136870;Nibiru Voyage;;100,000 - 200,000;0;4;-4;0;0;0
1136880;Baby Walking Simulator;;0 - 20,000;78;8;70;0;0;2
1136900;ポエニ戦争　地中海の稲妻;;0 - 20,000;2;0;2;0;0;0
1136910;Lily's Handmaid;;0 - 20,000;18;3;15;0;0;0
1136930;Gekisou! Benza Race -Toilet Shooting Star-;;0 - 20,000;16;5;11;0;0;0
1137030;Shadows of Larth;;0 - 20,000;4;2;2;0;0;0
1137040;CAT & MOUSE;;0 - 20,000;23;2;21;0;0;0
1137050;Treater;;0 - 20,000;8;3;5;0;0;0
1137070;Anime Girls Jigsaw Puzzles;;0 - 20,000;7;3;4;0;0;0
1137100;Twice Reborn: a vampire visual novel;;0 - 20,000;19;1;18;0;0;0
1137110;Ballistic Craft;;0 - 20,000;63;5;58;0;0;0
1137160;百花三国志(Banner of the THREE KINGDOMS);;0 - 20,000;44;12;32;0;0;0
1137170;NEKROTRONIC VR;;0 - 20,000;7;8;-1;0;0;0
1137210;Alien Monopoly;;0 - 20,000;9;0;9;0;0;0
1137220;Elite Soldier: 3D Shooter;;200,000 - 500,000;10;5;5;0;0;0
1137230;Derby: Extreme Racing;;0 - 20,000;4;3;1;0;0;0
1137260;Tower Defense: Defender of the Kingdom;;20,000 - 50,000;9;6;3;0;0;0
1137270;Palladium: Adventure in Greece;;0 - 20,000;13;0;13;0;0;0
1137300;Sherlock Holmes Chapter One;;100,000 - 200,000;1689;412;1277;1088;1482;42
1137320;Screeps: Arena;;20,000 - 50,000;68;10;58;0;0;4
1137330;DREAMO - Puzzle Adventure;;0 - 20,000;47;12;35;0;0;0
1137350;Filament;;50,000 - 100,000;495;62;433;157;157;5
1137360;DOWN MEANS UP;;0 - 20,000;1;0;1;0;0;0
1137400;The War for the West;;0 - 20,000;47;10;37;0;0;0
1137450;ENCODYA;;20,000 - 50,000;260;60;200;0;0;7
1137460;ALTF4;;200,000 - 500,000;7745;1810;5935;137;82;52
1137490;Invasion 2037;;0 - 20,000;88;57;31;0;0;0
1137620;Sexy President;;0 - 20,000;6;3;3;0;0;0
1137630;Quilly;;0 - 20,000;0;1;-1;0;0;0
1137650;Switchblade;;0 - 20,000;4;0;4;0;0;0
1137660;Impossamole;;0 - 20,000;7;1;6;0;0;0
1137670;Power Punch II;;0 - 20,000;2;1;1;0;0;0
1137680;Blender Bros;;0 - 20,000;3;0;3;0;0;0
1137690;Tinhead;;0 - 20,000;2;1;1;0;0;0
1137700;AAW Wrestle Lab;;0 - 20,000;29;10;19;1;1;7
1137750;Farmer's Life;;50,000 - 100,000;823;155;668;216;216;91
1137770;Avalive;;0 - 20,000;9;4;5;0;0;0
1137810;Total Ski Jump;;0 - 20,000;4;1;3;0;0;0
1137820;Gem Collector;;0 - 20,000;3;2;1;0;0;0
1137860;Fowl Magic;;0 - 20,000;11;2;9;0;0;0
1137870;Mosh Pit;;0 - 20,000;4;2;2;0;0;0
1137880;Beyond;;0 - 20,000;15;1;14;0;0;0
1137900;I Am Gooey;;0 - 20,000;10;3;7;0;0;0
1137910;Perdition;;20,000 - 50,000;132;15;117;0;0;0
1137930;Second Dimension RetroPak Vol. 1;;0 - 20,000;2;0;2;0;0;0
1137970;Zombies Ate My Neighbors and Ghoul Patrol;;0 - 20,000;87;69;18;0;0;14
1138010;Aftermoor;;0 - 20,000;16;1;15;0;0;0
1138020;Merge;;0 - 20,000;4;2;2;0;0;0
1138030;Master of LinCard;;0 - 20,000;9;3;6;0;0;0
1138060;Diablo_IslanD 暗黑破坏岛;;0 - 20,000;8;12;-4;0;0;0
1138080;斗地主少女/ Landlord Girls;;100,000 - 200,000;1492;584;908;516;603;5
1138100;Touhou Ibunseki - Ayaria Dawn: ReCreation;;20,000 - 50,000;1227;226;1001;0;0;5
1138130;Shadows and Dust;;0 - 20,000;9;3;6;0;0;0
1138150;Fiery catacombs;;20,000 - 50,000;1;7;-6;0;0;0
1138190;Poker Championship;;200,000 - 500,000;1188;251;937;0;0;175
1138260;Figure Simulator War;;0 - 20,000;78;14;64;10;10;0
1138280;Workhard;;0 - 20,000;13;12;1;0;0;0
1138290;Slime Adventure Legacy;;0 - 20,000;5;5;0;0;0;0
1138300;I LIKE THE FLOWERS;;0 - 20,000;24;10;14;0;0;0
1138310;Morbolbo: Enter the Maze;;0 - 20,000;3;0;3;0;0;0
1138320;AREA 51 - DEFENCE;;0 - 20,000;3;8;-5;0;0;0
1138330;Dark Running;;0 - 20,000;2;0;2;0;0;0
1138360;Next Hand Master;;0 - 20,000;2;4;-2;0;0;0
1138410;Demons Never Lie;;20,000 - 50,000;398;31;367;46;46;0
1138440;Galactic Ruler;;0 - 20,000;47;32;15;0;0;3
1138580;Farmington County: The Ultimate Farming Tycoon Simulator;;0 - 20,000;83;19;64;0;0;1
1138630;Heroes Swipe Right;;0 - 20,000;4;2;2;0;0;0
1138650;Tower Princess;;0 - 20,000;86;28;58;0;0;1
1138660;Black Book;;100,000 - 200,000;4150;289;3861;331;290;98
1138780;RotoBrix;;0 - 20,000;1;0;1;0;0;0
1138810;Super Platformer Gun;;0 - 20,000;6;1;5;0;0;0
1138850;Heavenly Bodies;;100,000 - 200,000;1806;75;1731;54;54;95
1138900;解梦事务所 (Dream Solutions);;20,000 - 50,000;8;2;6;0;0;0
1138910;Escape Mind;;0 - 20,000;104;1;103;0;0;1
1138960;Biomass;;0 - 20,000;82;15;67;0;0;0
1138970;Dandy Dungeon - Legend of Brave Yamada -;;0 - 20,000;56;6;50;0;0;2
1138990;B.i.t.Lock;;0 - 20,000;35;2;33;0;0;1
1139000;幸存者 / The Survivor;;0 - 20,000;22;4;18;0;0;0
1139060;Battle Arena;;0 - 20,000;28;14;14;0;0;0
1139090;Demolition Expert - The Simulation;;0 - 20,000;2;4;-2;0;0;0
1139100;An Egg Can Dream;;20,000 - 50,000;4;0;4;0;0;0
1139130;BioMech;;0 - 20,000;3;3;0;0;0;0
1139160;Divided Reigns;;0 - 20,000;110;11;99;0;0;8
1139200;World left Behind;;0 - 20,000;11;1;10;0;0;0
1139240;HalloweenStory;;0 - 20,000;10;3;7;0;0;0
1139280;The Big Con;;0 - 20,000;376;15;361;0;0;3
1139280;The Big Con;;0 - 20,000;376;15;361;0;0;3
1139310;Ven VR Adventure;;0 - 20,000;64;14;50;0;0;0
1139470;THE ART - Metamorphosis;;0 - 20,000;66;6;60;0;0;0
1139470;THE ART - Metamorphosis;;0 - 20,000;66;6;60;0;0;0
1139480;Mask of Sanity;;0 - 20,000;23;24;-1;0;0;0
1139660;Marburgh;;0 - 20,000;2;0;2;0;0;0
1139670;uniTower;;0 - 20,000;13;0;13;0;0;0
1139680;Pixamal Zoo;;0 - 20,000;10;0;10;0;0;0
1139760;DEDstress;;0 - 20,000;26;2;24;0;0;0
1139780;SereNest;;0 - 20,000;0;1;-1;0;0;0
1139790;Asylum of the Dead;;0 - 20,000;3;3;0;0;0;0
1139800;Chinatris;;50,000 - 100,000;845;113;732;94;94;2
1139830;Recyclomania;;0 - 20,000;14;6;8;0;0;0
1139840;TILTit;;0 - 20,000;4;1;3;0;0;0
1139860;CRUEL WORLD;;0 - 20,000;4;4;0;0;0;0
1139870;The Dark Eye : Book of Heroes;;20,000 - 50,000;76;118;-42;0;0;0
1139880;Chapeau;;0 - 20,000;16;0;16;0;0;0
1139890;Dictators:No Peace Countryballs;;50,000 - 100,000;4795;268;4527;307;307;28
1139900;Ghostrunner;;1,000,000 - 2,000,000;43181;3854;39327;394;338;310
1139920;VR垃圾分类_Refuse classification;;0 - 20,000;2;1;1;0;0;0
1139940;ATOM RPG Trudograd;;100,000 - 200,000;2753;416;2337;2158;3956;92
1139950;Two Weeks in Painland;;0 - 20,000;50;8;42;0;0;0
1139980;Travellers Rest;;200,000 - 500,000;4323;389;3934;506;574;645
1140020;Cetetorius;;0 - 20,000;7;7;0;0;0;0
1140030;AMazing TD;;0 - 20,000;21;16;5;0;0;4
1140060;War Ghost;;0 - 20,000;1;2;-1;0;0;0
1140070;Tractor Cargo Driving Simulator;;0 - 20,000;42;6;36;0;0;0
1140100;The Persistence;;20,000 - 50,000;97;48;49;0;0;0
1140110;141;;0 - 20,000;12;19;-7;0;0;0
1140130;Survival Vacancy;;0 - 20,000;54;30;24;0;0;0
1140140;Summer Meetings;;0 - 20,000;44;4;40;0;0;0
1140150;Touhou: Lost Branch of Legend;;0 - 20,000;303;45;258;283;283;24
1140170;Arietta of Spirits;;0 - 20,000;275;41;234;21;21;1
1140180;MAZEMAN;;0 - 20,000;17;3;14;0;0;1
1140260;Blade Warrior;;0 - 20,000;3;0;3;0;0;0
1140270;Monster Prom 2: Monster Camp;;200,000 - 500,000;4870;111;4759;287;359;141
1140290;Murder by Numbers;;100,000 - 200,000;1069;183;886;92;92;18
1140350;Shuttlecock-H: Covered Rematch;;0 - 20,000;1;1;0;0;0;0
1140360;TextureWorks;;0 - 20,000;10;4;6;0;0;0
1140400;Gericonia 2;;0 - 20,000;3;1;2;0;0;0
1140420;Quantism;;0 - 20,000;2;1;1;0;0;0
1140440;OMON Simulator;;200,000 - 500,000;1893;691;1202;180;247;9
1140460;V1RUZ;;0 - 20,000;38;22;16;0;0;0
1140500;Crimson Hotel;;0 - 20,000;18;30;-12;0;0;0
1140510;Fantasy Gladiators;;0 - 20,000;10;3;7;0;0;0
1140520;Graviton;;0 - 20,000;5;0;5;0;0;0
1140530;Viper;;0 - 20,000;2;1;1;0;0;0
1140540;Lonely Arts;;0 - 20,000;4;0;4;0;0;0
1140570;A Street Cat's Tale;;0 - 20,000;195;11;184;0;0;3
1140620;CosmicBreak Universal;;500,000 - 1,000,000;672;495;177;0;0;216
1140630;Red Wings: Aces of the Sky;;100,000 - 200,000;483;193;290;28;26;1
1140700;GodOrEvil.Beta;;0 - 20,000;2;0;2;0;0;0
1140720;Ship Happens;;0 - 20,000;1;0;1;0;0;0
1140730;Pixel Sentry;;0 - 20,000;10;0;10;0;0;0
1140740;Chroma: Bloom And Blight;;50,000 - 100,000;405;107;298;0;0;1
1140750;Chained;;0 - 20,000;3;1;2;0;0;0
1140760;Rainforest Solitaire;;0 - 20,000;14;9;5;0;0;0
1140790;Kung Fu Jesus;;0 - 20,000;4;1;3;0;0;0
1140880;Only One Burn;;0 - 20,000;24;4;20;0;0;0
1140890;Morbid: The Seven Acolytes;;100,000 - 200,000;632;220;412;0;0;9
1140900;The Chasm - Mines Of Madness;;0 - 20,000;2;1;1;0;0;0
1140930;You are apt;;20,000 - 50,000;4;6;-2;0;0;0
1140950;Boardwalk Carnival Game;;0 - 20,000;2;0;2;0;0;0
1140970;Inside The Park VR;;0 - 20,000;8;11;-3;0;0;0
1141020;Adventure Escape Mysteries;;100,000 - 200,000;318;60;258;0;0;8
1141030;Last Message;;20,000 - 50,000;128;17;111;0;0;0
1141070;UFO : Brawlers from Beyond;;0 - 20,000;8;1;7;0;0;0
1141100;Lilitales;;20,000 - 50,000;445;53;392;0;0;7
1141120;Scarlet Hood and the Wicked Wood;;0 - 20,000;152;21;131;0;0;1
1141130;Serious Scramblers;;0 - 20,000;44;1;43;0;0;0
1141150;The Defender: Farm and Castle 2;;0 - 20,000;8;5;3;0;0;0
1141160;Fractalis;;20,000 - 50,000;5;0;5;0;0;0
1141170;Risnuch;;0 - 20,000;9;5;4;0;0;0
1141220;DemonCrawl;;100,000 - 200,000;852;202;650;918;918;42
1141250;Planet Automata;;0 - 20,000;2;1;1;0;0;0
1141270;Who Stole My Beard?;;0 - 20,000;25;1;24;0;0;0
1141290;Tactical Nexus;;0 - 20,000;72;5;67;0;0;14
1141300;Sloth Quest;;0 - 20,000;12;1;11;0;0;0
1141330;Monster Breakout;;0 - 20,000;6;0;6;0;0;0
1141340;WildIsland;;0 - 20,000;0;5;-5;0;0;0
1141360;Dungeon Dreams (Female Protagonist);;0 - 20,000;36;5;31;0;0;3
1141380;Ladies Orders;;0 - 20,000;2;2;0;0;0;0
1141390;The Blitzkrieg: Weapons of War;;0 - 20,000;4;0;4;0;0;0
1141450;Dodge Rocket;;0 - 20,000;32;12;20;0;0;0
1141530;PlayClaw 7 - Game Overlays, Recording and Streaming;;20,000 - 50,000;93;37;56;543;543;91
1141550;CUCKOLD SIMULATOR: Life as a Beta Male Cuck;;50,000 - 100,000;1459;90;1369;67;116;12
1141570;Sky Cannoneer;;0 - 20,000;25;4;21;0;0;0
1141580;Taiji;;50,000 - 100,000;622;36;586;0;0;10
1141600;Every Day's Different;;0 - 20,000;26;0;26;0;0;0
1141640;Slaveblade;;0 - 20,000;4;13;-9;0;0;0
1141650;Crowd Simulator;;50,000 - 100,000;248;83;165;0;0;0
1141660;夢限ノ夜;;0 - 20,000;1;1;0;0;0;0
1141700;Desert monsters;;0 - 20,000;3;4;-1;0;0;0
1141740;Cures & Curios;;0 - 20,000;15;1;14;0;0;0
1141750;缸中之脑：谎言（Brain in a vat lies）;;0 - 20,000;0;2;-2;0;0;0
1141770;Rage Melee;;0 - 20,000;6;4;2;0;0;0
1141840;Escape the Lab;;0 - 20,000;4;1;3;0;0;0
1141850;Radial;;0 - 20,000;1;1;0;0;0;0
1141860;Trial Of Destiny;;0 - 20,000;5;0;5;0;0;0
1141870;The Longest Love;;0 - 20,000;11;2;9;0;0;0
1141880;Crazy Critters - Combat Cats;;0 - 20,000;19;4;15;0;0;0
1141930;Mondly: Learn Languages in VR;;0 - 20,000;23;21;2;0;0;0
1141990;Elite Escape;;0 - 20,000;11;5;6;0;0;0
1142000;Challenging Dogfights;;0 - 20,000;0;5;-5;0;0;0
1142030;Emperium;;0 - 20,000;5;1;4;0;0;0
1142070;Paladin Slayer;;0 - 20,000;6;7;-1;0;0;0
1142080;Pawnbarian;;20,000 - 50,000;549;57;492;446;641;10
1142090;Playing Both Sides;;0 - 20,000;4;1;3;0;0;0
1142100;WWE 2K BATTLEGROUNDS;;100,000 - 200,000;525;383;142;98;98;3
1142130;They Can't Stop All Of Us;;200,000 - 500,000;1248;416;832;57;36;0
1142180;SE VR World Demo;;0 - 20,000;46;10;36;0;0;1
1142200;Nightmare Cave;;0 - 20,000;2;0;2;0;0;0
1142220;Beat Aim - Rhythm FPS Trainer;;0 - 20,000;147;15;132;0;0;5
1142230;The Secrets of Jesus;;0 - 20,000;11;1;10;0;0;0
1142240;ODA;;0 - 20,000;33;2;31;0;0;0
1142280;Color +;;0 - 20,000;9;1;8;0;0;0
1142280;Color +;;0 - 20,000;9;1;8;0;0;0
1142290;Haunted Legends: The Scars of Lamia Collector's Edition;;0 - 20,000;2;1;1;0;0;1
1142300;Hope;;;;;0;;;
1142320;Little Helper;;0 - 20,000;7;1;6;0;0;0
1142360;Hope for City;;50,000 - 100,000;9;6;3;0;0;0
1142390;Remothered: Broken Porcelain;;20,000 - 50,000;421;299;122;273;409;3
1142410;Kamile: The Fall;;0 - 20,000;17;6;11;0;0;0
1142440;Thanks For Listening;;20,000 - 50,000;1;0;1;0;0;0
1142450;GrapplingHook;;0 - 20,000;6;1;5;0;0;0
1142460;Super Monkey;;20,000 - 50,000;3;0;3;0;0;0
1142500;Fun with Ragdolls: The Game;;200,000 - 500,000;3465;491;2974;288;485;81
1142510;Cucumber Defense VR;;0 - 20,000;10;0;10;0;0;0
1142550;Protein for Muscle;;0 - 20,000;83;10;73;0;0;0
1142560;Princess and Knight;;0 - 20,000;1;0;1;0;0;0
1142710;Total War: WARHAMMER III;;2,000,000 - 5,000,000;46420;16688;29732;7192;2274;30697
1142730;Player Power;;0 - 20,000;1;1;0;0;0;0
1142750;BAFF 3;;0 - 20,000;10;10;0;0;0;0
1142760;Racing angle;;0 - 20,000;18;12;6;0;0;0
1142790;Half-Past Impossible;;0 - 20,000;4;10;-6;0;0;0
1142810;Toasterball;;0 - 20,000;132;4;128;610;610;3
1142830;9-nine-:Episode 3;;20,000 - 50,000;423;37;386;0;0;7
1142850;Darkness Rollercoaster - Ultimate Shooter Edition;;0 - 20,000;6;7;-1;0;0;0
1142860;机甲雄心：巡天者;;0 - 20,000;3;2;1;0;0;0
1142890;Heart in the Dark;;0 - 20,000;1;0;1;0;0;0
1143130;Stratoscape;;0 - 20,000;0;1;-1;0;0;0
1143140;Bierwagen Rush;;0 - 20,000;3;2;1;0;0;0
1143140;Bierwagen Rush;;0 - 20,000;3;2;1;0;0;0
1143170;Auto Factory;;0 - 20,000;5;0;5;0;0;0
1143320;Gred;;0 - 20,000;7;0;7;0;0;0
1143330;Frustrate-a-ball;;0 - 20,000;2;3;-1;0;0;0
1143340;Industriworks;;0 - 20,000;0;1;-1;0;0;0
1143350;FLATLAND Vol.1;;0 - 20,000;50;6;44;0;0;0
1143390;Ichor;;0 - 20,000;3;0;3;0;0;0
1143420;70 Seconds! Adventure;;0 - 20,000;6;7;-1;0;0;0
1143430;Shadow Gangs;;0 - 20,000;36;3;33;0;0;0
1143440;Connor's Desert Adventure;;20,000 - 50,000;26;15;11;0;0;0
1143450;DeltaBlade 2700;;0 - 20,000;18;2;16;0;0;0
1143550;EleMetals: Death Metal Death Match!;;0 - 20,000;5;0;5;0;0;0
1143570;VolticPistol;;0 - 20,000;11;0;11;0;0;0
1143610;Poly Quest;;0 - 20,000;16;9;7;0;0;0
1143680;AVA;;0 - 20,000;23;17;6;0;0;0
1143710;Тёмное отражение (Dark Reflection);;0 - 20,000;54;5;49;0;0;0
1143720;ALTERITY EXPERIENCE;;0 - 20,000;12;7;5;0;0;0
1143750;VRocker;;0 - 20,000;60;5;55;0;0;1
1143770;StressOut;;0 - 20,000;17;4;13;0;0;0
1143780;Graveyard Defender;;0 - 20,000;7;1;6;0;0;0
1143800;Jigsaw Puzzle - Pro Edition;;0 - 20,000;12;1;11;0;0;0
1143810;Black Skylands;;50,000 - 100,000;1222;161;1061;860;1167;16
1143870;YASG;;0 - 20,000;0;1;-1;0;0;0
1143900;Shapeshooter;;0 - 20,000;11;9;2;0;0;0
1144000;Spock in the Dama Kingdom;;0 - 20,000;3;0;3;0;0;0
1144020;GolfTopia;;20,000 - 50,000;411;13;398;25;48;4
1144030;Pesterquest;;100,000 - 200,000;1091;112;979;3327;3327;3
1144060;Ten Days to War;;0 - 20,000;0;1;-1;0;0;0
1144070;NUMB;;0 - 20,000;3;8;-5;0;0;0
1144080;Overboard;;0 - 20,000;23;1;22;0;0;0
1144090;ArtFormer: Ancient Stories;;0 - 20,000;29;7;22;0;0;0
1144100;Linea VR;;0 - 20,000;14;3;11;0;0;0
1144110;Open World Game: the Open World Game;;50,000 - 100,000;2135;167;1968;0;0;0
1144140;Pillars of Dust;;0 - 20,000;26;1;25;0;0;0
1144150;Singled Out;;0 - 20,000;39;1;38;0;0;0
1144170;Warhammer: Chaos And Conquest;;100,000 - 200,000;529;437;92;124;139;288
1144200;Ready or Not;;2,000,000 - 5,000,000;89478;8028;81450;828;502;3281
1144250;WAIFU HELL;;0 - 20,000;275;63;212;133;175;1
1144260;Warships On The Halloween Night;;0 - 20,000;2;4;-2;0;0;0
1144270;救赎抉择Resurrection;;0 - 20,000;13;1;12;0;0;0
1144280;Ain Dodo;;0 - 20,000;137;16;121;0;0;0
1144290;Lucid Nina;;0 - 20,000;7;0;7;0;0;1
1144300;ef - the first tale. (All Ages);;0 - 20,000;75;2;73;0;0;3
1144330;Marisa's Marvelous Magic Shop;;0 - 20,000;50;16;34;0;0;0
1144350;Hunger Tower;;0 - 20,000;2;7;-5;0;0;0
1144370;Levi Chronicles;;0 - 20,000;14;3;11;0;0;0
1144400;Senren＊Banka;;200,000 - 500,000;12508;104;12404;1035;613;371
1144440;UnderParty;;20,000 - 50,000;557;80;477;13;13;2
1144450;Rose Riddle: Fairy Tale Detective;;0 - 20,000;14;1;13;0;0;0
1144460;SOUNDART;;0 - 20,000;54;16;38;0;0;0
1144510;Stratos;;0 - 20,000;16;4;12;0;0;0
1144520;Air;;0 - 20,000;2;3;-1;0;0;0
1144590;Blooding Runner X;;0 - 20,000;12;0;12;0;0;0
1144620;Northern Lights;;20,000 - 50,000;13;3;10;0;0;0
1144630;Beardy the Digger;;0 - 20,000;11;2;9;0;0;0
1144670;Tactikk;;0 - 20,000;0;3;-3;0;0;0
1144690;Project SolarBot;;0 - 20,000;4;0;4;0;0;0
1144760;Vectrix;;20,000 - 50,000;5;5;0;0;0;0
1144770;SLUDGE LIFE;;0 - 20,000;556;28;528;158;158;6
1144800;Drop In - VR F2P;;50,000 - 100,000;453;92;361;0;0;0
1144820;Neighborhood;;0 - 20,000;1;1;0;0;0;0
1144850;MANIC;;0 - 20,000;24;3;21;0;0;0
1144860;Flying Sword;;0 - 20,000;91;10;81;0;0;1
1144900;Pension Day;;20,000 - 50,000;0;1;-1;0;0;0
1144910;Space Gladiators;;0 - 20,000;268;16;252;0;0;25
1144970;Necronator: Dead Wrong;;20,000 - 50,000;331;137;194;173;173;0
1145000;The Rainbow World;;0 - 20,000;5;0;5;0;0;0
1145020;Break Arcade Games Out;;20,000 - 50,000;178;12;166;0;0;0
1145030;ef - the latter tale. (All Ages);;0 - 20,000;64;2;62;0;0;0
1145050;Tonetaker VR;;0 - 20,000;4;0;4;0;0;0
1145100;Singaria - Prologue;;0 - 20,000;0;1;-1;0;0;0
1145120;Last Summer;;0 - 20,000;27;3;24;0;0;0
1145130;卖萌恶霸喵霸霸 Cute Bully Nyanbaba;;0 - 20,000;73;1;72;0;0;0
1145180;uznali ? soglasnbI ?;;0 - 20,000;8;12;-4;0;0;0
1145200;Tomb Typing;;0 - 20,000;2;0;2;0;0;0
1145210;Typing with Sharks;;0 - 20,000;1;1;0;0;0;0
1145220;Xtreme Typing;;0 - 20,000;4;1;3;0;0;0
1145240;Dawn of the Dragons: Ascension;;20,000 - 50,000;14;25;-11;0;0;0
1145270;Misfire;;0 - 20,000;37;30;7;0;0;0
1145280;Blockey: Block Yeah!;;0 - 20,000;1;0;1;0;0;0
1145290;Out There: Oceans of Time;;20,000 - 50,000;102;82;20;60;60;0
1145300;Ziggy;;0 - 20,000;2;0;2;0;0;0
1145330;Skeleton Crew;;20,000 - 50,000;26;9;17;83;83;1
1145340;Rogue State Revolution;;50,000 - 100,000;333;83;250;197;197;3
1145360;Hades;;5,000,000 - 10,000,000;216262;3188;213074;1837;904;5287
1145380;Kakatte Koi Yo!;;0 - 20,000;15;2;13;0;0;0
1145410;Knight Swap;;0 - 20,000;94;12;82;0;0;0
1145430;Agross;;0 - 20,000;5;9;-4;0;0;0
1145450;Mystery Case Files: Moths to a Flame Collector's Edition;;0 - 20,000;20;1;19;0;0;0
1145460;Memories on the Shoreline;;0 - 20,000;5;4;1;0;0;0
1145490;Operation Armstrong;;0 - 20,000;14;5;9;0;0;0
1145520;Wall Force;;0 - 20,000;7;2;5;0;0;0
1145530;One day;;0 - 20,000;51;14;37;0;0;0
1145550;守护传说 Guardian Legend;;0 - 20,000;8;3;5;0;0;0
1145560;Marble Trap;;0 - 20,000;61;4;57;0;0;0
1145570;Ortharion project;;50,000 - 100,000;97;49;48;0;0;0
1145580;Wolves Team;;0 - 20,000;2;2;0;0;0;0
1145590;Kastle Krush;;0 - 20,000;5;4;1;0;0;0
1145660;Drift Of The Hill;;100,000 - 200,000;587;235;352;41;43;2
1145670;The Seven;;0 - 20,000;0;1;-1;0;0;0
1145740;In Search of a Home;;0 - 20,000;5;10;-5;0;0;0
1145770;Cuties Dungeon;;0 - 20,000;28;4;24;0;0;0
1145780;Angry Golf;;0 - 20,000;32;13;19;0;0;0
1145800;Marisa's Inconceivable Journey;;0 - 20,000;1;1;0;0;0;0
1145810;Desert lost;;0 - 20,000;9;6;3;0;0;0
1145820;INFECTIS;;0 - 20,000;10;5;5;0;0;0
1145830;Clarevoyance;;0 - 20,000;6;0;6;0;0;0
1145860;Quantum Multiverse;;0 - 20,000;0;1;-1;0;0;0
1145950;Vector Prospector;;0 - 20,000;13;2;11;0;0;0
1145960;The White Door;;200,000 - 500,000;4419;288;4131;155;177;29
1145970;Forest Home;;0 - 20,000;8;1;7;0;0;0
1146000;Joe Blunt - Up In Smoke;;0 - 20,000;3;0;3;0;0;0
1146010;Art of Boxing;;0 - 20,000;28;42;-14;0;0;0
1146050;Marvelous Designer 9.5 for Steam;;0 - 20,000;19;1;18;0;0;5
1146090;Flint;;0 - 20,000;4;0;4;0;0;0
1146100;The Rising of the Shield Hero : Relive The Animation;;0 - 20,000;180;49;131;73;73;7
1146120;DeepSea;;20,000 - 50,000;3;1;2;0;0;0
1146210;Adam: Robot World;;0 - 20,000;24;5;19;0;0;0
1146230;DungeonTop;;20,000 - 50,000;421;78;343;0;0;4
1146280;Horace:First Trip;;0 - 20,000;1;1;0;0;0;0
1146300;Land of War - The Beginning;;100,000 - 200,000;288;278;10;0;0;6
1146310;Beyond a Steel Sky;;50,000 - 100,000;929;116;813;0;0;5
1146330;Virulent Addiction;;0 - 20,000;3;0;3;0;0;0
1146350;Urban riots;;0 - 20,000;2;2;0;0;0;0
1146360;Grey: An Alien Dream;;0 - 20,000;4;0;4;0;0;0
1146370;Master of Magic Classic;;50,000 - 100,000;533;14;519;21;21;83
1146390;Where Are We Now;;0 - 20,000;5;3;2;0;0;0
1146430;Served!;;0 - 20,000;2;0;2;0;0;0
1146480;DriftWay;;0 - 20,000;4;4;0;0;0;0
1146500;Adventure Slime;;50,000 - 100,000;23;7;16;0;0;0
1146510;Deep Sleep Trilogy;;20,000 - 50,000;277;4;273;55;59;3
1146560;Drawn Down Abyss;;0 - 20,000;12;0;12;0;0;0
1146600;For the People;;20,000 - 50,000;457;139;318;944;944;1
1146600;For the People;;20,000 - 50,000;457;139;318;944;944;1
1146630;Yokai's Secret;;200,000 - 500,000;5934;618;5316;83;75;7
1146660;Solar Cram School/[太阳补习班];;0 - 20,000;17;13;4;0;0;0
1146700;Battle Sorcerers;;0 - 20,000;4;7;-3;0;0;0
1146720;AION - Translator application;;100,000 - 200,000;212;240;-28;0;0;23
1146730;Void of Heroes;;0 - 20,000;9;5;4;0;0;0
1146780;Monster planet;;0 - 20,000;3;1;2;0;0;0
1146810;Phantom Astronaut Lucid VR;;0 - 20,000;1;3;-2;0;0;0
1146880;RRRR3;;0 - 20,000;26;6;20;0;0;0
1146890;MMX;;0 - 20,000;15;3;12;0;0;0
1146910;Atomorf2;;0 - 20,000;16;2;14;0;0;0
1146920;Xenociders;;0 - 20,000;10;11;-1;0;0;0
1146970;My Vow to My Liege;;100,000 - 200,000;3262;191;3071;417;417;14
1147020;Quest for Conquest;;0 - 20,000;2;2;0;0;0;0
1147030;The Terrible Old Man;;100,000 - 200,000;448;57;391;0;0;0
1147090;A Thousand Years;;0 - 20,000;1;0;1;0;0;0
1147110;The Long Gate;;0 - 20,000;34;5;29;0;0;0
1147130;Countryballs: Modern Ballfare;;20,000 - 50,000;145;13;132;0;0;1
1147140;Funny Road Chase Simulator;;0 - 20,000;0;1;-1;0;0;0
1147200;SnL;;20,000 - 50,000;0;3;-3;0;0;0
1147220;Grim Tales: Guest From The Future Collector's Edition;;0 - 20,000;6;0;6;0;0;0
1147240;Rogue Waves;;0 - 20,000;3;1;2;0;0;0
1147280;Column on the Sea;;0 - 20,000;7;1;6;0;0;0
1147370;The Empire's Crisis;;0 - 20,000;1;2;-1;0;0;0
1147390;Punchline!!;;0 - 20,000;31;3;28;0;0;0
1147450;Divine Miko Koyori;;20,000 - 50,000;384;118;266;49;49;5
1147460;Fail to Win;;0 - 20,000;2;0;2;0;0;0
1147490;Frontline: Western Front;;0 - 20,000;35;7;28;0;0;2
1147490;Frontline: Western Front;;0 - 20,000;35;7;28;0;0;2
1147500;A Gay's Life;;0 - 20,000;306;18;288;29;29;1
1147510;Hentai Asmodeus;;50,000 - 100,000;988;224;764;108;144;3
1147520;Super Bora Dragon Eyes;;20,000 - 50,000;0;1;-1;0;0;0
1147550;Not For Broadcast;;1,000,000 - 2,000,000;8465;481;7984;437;245;115
1147560;Skul: The Hero Slayer;;1,000,000 - 2,000,000;37800;2835;34965;1889;693;4089
1147600;Star Police;;0 - 20,000;4;5;-1;0;0;0
1147620;The Lost Dungeon Of Knight;;0 - 20,000;0;3;-3;0;0;0
1147640;Summer Knights;;0 - 20,000;1;0;1;0;0;0
1147660;ArcheAge: Unchained;;200,000 - 500,000;2034;1686;348;5117;399;118
1147690;NGU IDLE;;500,000 - 1,000,000;9277;362;8915;3652;1217;3785
1147750;Fishy;;20,000 - 50,000;1233;77;1156;0;0;2
1147760;The End of an Actress;;0 - 20,000;20;2;18;0;0;0
1147840;Hyper Storm;;0 - 20,000;6;0;6;0;0;0
1147850;Brother Brother;;0 - 20,000;27;0;27;0;0;0
1147890;Bonfire Peaks;;0 - 20,000;176;4;172;0;0;5
1147940;3dSen PC;;20,000 - 50,000;345;30;315;59;102;0
1147950;Shio And Mysterious Forest;;0 - 20,000;46;8;38;0;0;1
1147960;[Chilla's Art] Okaeri | おかえり;;0 - 20,000;357;174;183;0;0;0
1147970;Abode 2;;20,000 - 50,000;120;28;92;5;5;1
1147980;Gene Rain:Wind Tower;;0 - 20,000;23;11;12;0;0;0
1148010;Love Chan;;0 - 20,000;14;8;6;0;0;0
1148030;Esport Test Toolkit (ETT);;0 - 20,000;9;2;7;0;0;0
1148040;polyfuru feat. ASANO RURI / ポリフる feat. 朝ノ瑠璃;;0 - 20,000;5;2;3;0;0;0
1148080;Rainbow Pixel - Color by Number;;0 - 20,000;9;1;8;0;0;0
1148090;Solitaire Game Halloween;;0 - 20,000;7;1;6;0;0;0
1148100;Life on the Hook;;0 - 20,000;40;12;28;0;0;0
1148110;Moysenland;;0 - 20,000;1;0;1;0;0;0
1148120;This Picture;;0 - 20,000;4;1;3;0;0;0
1148120;This Picture;;0 - 20,000;4;1;3;0;0;0
1148200;Fadó: Chapter One;;0 - 20,000;2;0;2;0;0;0
1148270;The Final Battle;;0 - 20,000;3;0;3;0;0;0
1148290;Thy Kingdom Crumble;;0 - 20,000;13;1;12;0;0;0
1148300;War Battle Royale Battlegrounds;;0 - 20,000;1;0;1;0;0;0
1148320;Masteroid;;0 - 20,000;20;6;14;0;0;0
1148330;Legend of the Sword;;0 - 20,000;2;0;2;0;0;0
1148360;Alisa Quest;;0 - 20,000;15;8;7;0;0;0
1148390;Alien Earth;;0 - 20,000;3;0;3;0;0;0
1148400;Blooming Nightshade;;20,000 - 50,000;174;27;147;0;0;0
1148420;Kunoichi Ninja;;0 - 20,000;2;1;1;0;0;0
1148430;Rescue Team 8;;0 - 20,000;16;6;10;0;0;1
1148450;Detective Jackie - Mystic Case;;0 - 20,000;105;4;101;0;0;1
1148460;Inside The Cubes;;0 - 20,000;0;1;-1;0;0;0
1148470;Killjoy Hunter Yuuko;;20,000 - 50,000;28;1;27;0;0;0
1148480;SPACERIFT: Arcanum System;;0 - 20,000;290;70;220;0;0;0
1148490;Second Front;;0 - 20,000;263;66;197;0;0;35
1148490;Second Front;;0 - 20,000;263;66;197;0;0;35
1148500;PuPaiPo Space Deluxe;;0 - 20,000;8;0;8;0;0;0
1148510;Pretty Angel;;100,000 - 200,000;3165;285;2880;41;17;4
1148530;Griddlers Legend Of The Pirates;;0 - 20,000;7;6;1;0;0;0
1148540;Griddlers Victorian Picnic;;0 - 20,000;3;4;-1;0;0;0
1148550;TERROR SQUID;;0 - 20,000;14;3;11;0;0;0
1148560;Buccaneers!;;0 - 20,000;217;40;177;0;0;5
1148570;Blastworld;;0 - 20,000;27;23;4;0;0;0
1148590;DOOM 64;;200,000 - 500,000;5407;341;5066;131;60;38
1148620;Plunder;;0 - 20,000;9;0;9;0;0;0
1148650;The Legend of Bum-Bo;;200,000 - 500,000;4450;1012;3438;858;1360;24
1148670;Annals of Rome;;20,000 - 50,000;7;0;7;0;0;0
1148680;Austerlitz;;0 - 20,000;2;0;2;0;0;0
1148700;Deadtime Defenders;;0 - 20,000;39;11;28;0;0;0
1148710;Miriel Saga;;0 - 20,000;5;1;4;0;0;0
1148730;Errant Kingdom: Prologue - Part Five;;0 - 20,000;65;29;36;0;0;7
1148730;Errant Kingdom: Prologue - Part Five;;0 - 20,000;65;29;36;0;0;7
1148740;Far From Orbit;;0 - 20,000;1;0;1;0;0;0
1148750;Advisors at the End of the Universe;;0 - 20,000;5;0;5;0;0;0
1148750;Advisors at the End of the Universe;;0 - 20,000;5;0;5;0;0;0
1148760;I Was a Teenage Exocolonist;;50,000 - 100,000;1467;35;1432;871;871;114
1148780;Reconstruction;;0 - 20,000;3;5;-2;0;0;0
1148810;Tip of the Spear: Task Force Elite;;0 - 20,000;220;48;172;0;0;3
1148890;Protect the campus;;0 - 20,000;1;3;-2;0;0;0
1148910;ShapeWorks;;0 - 20,000;14;7;7;0;0;0
1148930;Chuusotsu! 1.5th Graduation: The Moving Castle;;0 - 20,000;19;0;19;0;0;0
1148960;Kids Cartoon Maker;;0 - 20,000;7;3;4;0;0;0
1149070;Skyrift;;0 - 20,000;1;0;1;0;0;0
1149080;Swords and Sandals Spartacus;;0 - 20,000;24;10;14;0;0;0
1149080;Swords and Sandals Spartacus;;0 - 20,000;24;10;14;0;0;0
1149090;Hospital 9;;20,000 - 50,000;7;3;4;0;0;0
1149120;Drift 1969;;0 - 20,000;3;1;2;0;0;0
1149180;The Last Promise;;0 - 20,000;1;0;1;0;0;0
1149190;Errant Heart;;0 - 20,000;1;1;0;0;0;0
1149200;Spirit Fighters;;0 - 20,000;0;1;-1;0;0;0
1149210;Turtle Rush;;0 - 20,000;2;1;1;0;0;0
1149220;P.3;;0 - 20,000;3;2;1;0;0;0
1149340;Those crazy crows;;0 - 20,000;1;0;1;0;0;0
1149400;The Yellow King;;20,000 - 50,000;110;103;7;0;0;0
1149430;KiKiMiMi2 / 听能力搜查官2;;0 - 20,000;24;1;23;0;0;0
1149440;Dragon Marked For Death;;50,000 - 100,000;675;193;482;1366;1855;27
1149440;Dragon Marked For Death;;50,000 - 100,000;675;193;482;1366;1855;27
1149460;ICARUS;;500,000 - 1,000,000;19445;9426;10019;2579;1380;2855
1149510;The Leopard Catgirl in Miaoli;;0 - 20,000;168;7;161;0;0;0
1149580;Super Korotama;;0 - 20,000;6;0;6;0;0;0
1149590;Dreamland Solitaire;;0 - 20,000;36;0;36;0;0;3
1149620;Gas Station Simulator;;500,000 - 1,000,000;14659;2313;12346;703;541;343
1149630;Project: Gemini;;0 - 20,000;4;2;2;0;0;0
1149660;Seek Girl Ⅱ;;100,000 - 200,000;1998;449;1549;104;18;3
1149690;Hexogin;;0 - 20,000;19;3;16;0;0;0
1149700;Dark Veer;;0 - 20,000;5;1;4;0;0;0
1149710;Tesla Force;;20,000 - 50,000;151;39;112;0;0;1
1149800;Xenrai;;0 - 20,000;1;0;1;0;0;0
1149830;Josie's Tank;;0 - 20,000;21;0;21;0;0;0
1149860;Arsenal Demon;;0 - 20,000;17;1;16;0;0;0
1149900;Cheer and Track;;0 - 20,000;0;1;-1;0;0;0
1149910;Binky show;;0 - 20,000;2;3;-1;0;0;0
1149930;Tale's Casino Escape;;0 - 20,000;28;5;23;0;0;0
1149940;Lock 'n Load Tactical Digital: Core Game;;20,000 - 50,000;377;53;324;0;0;9
1150040;Go All Out: Free To Play;;0 - 20,000;22;10;12;0;0;0
1150080;Azur Lane Crosswave;;200,000 - 500,000;4849;2150;2699;981;1426;9
1150090;Learning Factory;;0 - 20,000;256;41;215;28;28;5
1150130;吾光笔记Holimas Z Notebook;;20,000 - 50,000;17;4;13;0;0;0
1150140;Just Spin;;0 - 20,000;3;2;1;0;0;0
1150160;KobberParty - Castle Explorer;;0 - 20,000;2;1;1;0;0;0
1150270;NEON SPACE WAR;;0 - 20,000;0;2;-2;0;0;0
1150270;NEON SPACE WAR;;0 - 20,000;0;2;-2;0;0;0
1150310;Let's Go! Skiing VR;;0 - 20,000;8;4;4;0;0;0
1150400;The Ancient Labyrinth;;0 - 20,000;13;3;10;0;0;0
1150460;Summer Paws;;0 - 20,000;320;13;307;0;0;3
1150480;Micro Car Crash Online Le Go!;;0 - 20,000;4;1;3;0;0;0
1150500;Voidspace;;0 - 20,000;11;12;-1;0;0;0
1150540;Offcoast;;0 - 20,000;2;0;2;0;0;0
1150550;Winter Polaris;;0 - 20,000;69;3;66;0;0;0
1150580;History Warriors;;0 - 20,000;1;5;-4;0;0;0
1150590;Samurai Jack: Battle Through Time;;50,000 - 100,000;958;160;798;272;272;5
1150610;City Gangs War in Miami;;0 - 20,000;4;0;4;0;0;0
1150620;Bed Lying Simulator 2020;;0 - 20,000;99;26;73;0;0;1
1150620;Bed Lying Simulator 2020;;0 - 20,000;99;26;73;0;0;1
1150640;Yu-Gi-Oh! Legacy of the Duelist : Link Evolution;;200,000 - 500,000;2815;617;2198;4600;2299;206
1150650;War Theatre: Blood of Winter;;0 - 20,000;6;5;1;0;0;0
1150670;Sorcerer Lord;;0 - 20,000;1;0;1;0;0;0
1150690;OMORI;;1,000,000 - 2,000,000;51645;1054;50591;936;855;1002
1150730;Island SAGA;;0 - 20,000;240;36;204;0;0;3
1150760;Gloomwood;;100,000 - 200,000;3034;191;2843;181;215;13
1150790;GraFi 4;;0 - 20,000;17;10;7;0;0;0
1150800;Breeza Budgie Bill;;0 - 20,000;3;0;3;0;0;0
1150810;Slime Slam;;0 - 20,000;3;0;3;0;0;0
1150820;Delphyq;;100,000 - 200,000;2;3;-1;0;0;0
1150890;The Bunker 69;;0 - 20,000;119;20;99;0;0;0
1150900;EAGLETALON vs. HORDE OF THE FLIES;;0 - 20,000;1;2;-1;0;0;0
1150910;Book of Beasts — The Collectible Card Game CCG;;0 - 20,000;9;12;-3;0;0;0
1150950;Timelie;;100,000 - 200,000;1905;114;1791;219;227;4
1150990;Cemetery Warrior 4;;0 - 20,000;52;22;30;0;0;0
1151050;Golf Gang;;20,000 - 50,000;816;120;696;155;161;37
1151060;Before Arriving at the Terminal;;0 - 20,000;56;6;50;0;0;0
1151060;Before Arriving at the Terminal;;0 - 20,000;56;6;50;0;0;0
1151080;Legend of Keepers: Prologue;;200,000 - 500,000;2175;173;2002;49;77;0
1151090;Easter Egg;;0 - 20,000;1;4;-3;0;0;0
1151120;Arrest of a stone Buddha;;0 - 20,000;165;57;108;0;0;0
1151130;Dark Chess;;0 - 20,000;61;3;58;0;0;1
1151160;Chaos Theory Pirates;;0 - 20,000;3;2;1;0;0;0
1151180;Super Cucho;;0 - 20,000;24;0;24;0;0;0
1151200;Just Drift It !;;0 - 20,000;26;17;9;0;0;0
1151250;Horror Story: Hallowseed;;0 - 20,000;159;58;101;0;0;1
1151310;Blackbeard the Cursed Jungle;;20,000 - 50,000;5;2;3;0;0;0
1151320;Netsoccer;;20,000 - 50,000;101;34;67;0;0;0
1151340;Fallout 76;;2,000,000 - 5,000,000;59374;22782;36592;4292;788;10922
1151370;Night Guardian;;0 - 20,000;1;0;1;0;0;0
1151390;Putin Life;;0 - 20,000;260;35;225;0;0;0
1151400;Furious Goal;;0 - 20,000;6;9;-3;0;0;0
1151430;Magnia;;0 - 20,000;21;3;18;0;0;0
1151440;Utawarerumono: Mask of Truth;;20,000 - 50,000;1046;33;1013;0;0;47
1151450;Utawarerumono: Prelude to the Fallen;;20,000 - 50,000;841;57;784;2404;2404;52
1151460;Obligation;;0 - 20,000;7;1;6;0;0;0
1151500;fight wisdom;;0 - 20,000;4;1;3;0;0;0
1151530;Synthetic Lover;;0 - 20,000;56;8;48;0;0;5
1151570;ED-IT;;0 - 20,000;6;1;5;0;0;0
1151580;1984 Rewired;;0 - 20,000;10;3;7;0;0;0
1151600;Chernobyl: Road of Death;;0 - 20,000;27;2;25;0;0;0
1151610;活下去;;20,000 - 50,000;27;32;-5;0;0;0
1151620;磨难之间 SUFFERING: Reincarnation of Sins;;0 - 20,000;48;10;38;0;0;2
1151630;House of 1000 Doors: Family Secrets;;0 - 20,000;90;7;83;0;0;1
1151640;Horizon Zero Dawn Complete Edition;;1,000,000 - 2,000,000;79435;11660;67775;1538;893;4242
1151650;Shard;;0 - 20,000;3;0;3;0;0;0
1151670;EEP  16 Expert Eisenbahn Aufbau- und Steuerungssimulation;;0 - 20,000;19;7;12;0;0;4
1151720;Scp: Resonance;;0 - 20,000;80;30;50;0;0;1
1151740;Prison Princess;;0 - 20,000;225;34;191;0;0;2
1151750;mmmmm donuts arhhh......;;20,000 - 50,000;35;11;24;0;0;0
1151770;Dragon Slayer;;0 - 20,000;2;4;-2;0;0;0
1151860;Last Chance VR;;0 - 20,000;4;2;2;0;0;0
1151880;Those Chosen By God;;0 - 20,000;6;2;4;0;0;0
1151880;Those Chosen By God;;0 - 20,000;6;2;4;0;0;0
1151930;Buissons;;0 - 20,000;104;1;103;0;0;0
1151940;Super Minesweeper attACK;;0 - 20,000;5;2;3;0;0;0
1152000;Psihanul;;0 - 20,000;1;2;-1;0;0;0
1152020;Return Of The Zombie King;;0 - 20,000;54;19;35;0;0;0
1152040;Dark Romance: The Ethereal Gardens Collector's Edition;;0 - 20,000;6;1;5;0;0;1
1152050;Sword of the Slayer;;0 - 20,000;4;3;1;0;0;0
1152090;Elmarion: Dragon time;;100,000 - 200,000;428;123;305;0;0;0
1152160;Might is Right;;0 - 20,000;110;25;85;0;0;2
1152210;Furry Shakespeare: Dashing Dinosaurs & Sexy Centaurs: Winter's Tale;;20,000 - 50,000;25;4;21;0;0;0
1152230;The Void of Desires;;0 - 20,000;6;2;4;0;0;0
1152250;荒岛求生;;0 - 20,000;9;9;0;0;0;0
1152310;Atelier Escha & Logy: Alchemists of the Dusk Sky DX;;0 - 20,000;181;24;157;0;0;13
1152320;Atelier Shallie: Alchemists of the Dusk Sea DX;;0 - 20,000;136;18;118;0;0;5
1152330;The Adventures of Looppy;;0 - 20,000;64;2;62;0;0;0
1152340;Book of Travels;;100,000 - 200,000;1321;263;1058;232;386;26
1152360;CLIMB OUT!;;0 - 20,000;2;1;1;0;0;0
1152410;Karate Cat;;0 - 20,000;83;5;78;0;0;0
1152410;Karate Cat;;0 - 20,000;83;5;78;0;0;0
1152420;Heraldry Studio;;0 - 20,000;36;5;31;0;0;0
1152440;Party Pumper;;0 - 20,000;26;10;16;0;0;0
1152450;Creeps Creeps? Creeps!;;0 - 20,000;33;3;30;0;0;0
1152480;Death To The Dragon Lord;;0 - 20,000;1;0;1;0;0;0
1152540;Shark Castle;;0 - 20,000;0;1;-1;0;0;0
1152550;Who Is You;;0 - 20,000;4;3;1;0;0;0
1152570;Timmy's adventures : VerbMon;;0 - 20,000;7;0;7;0;0;0
1152580;Ann Achronist: Many Happy Returns;;0 - 20,000;14;0;14;0;0;0
1152620;PixelForces.io;;0 - 20,000;26;13;13;0;0;0
1152640;Snake: The Elder Forest;;0 - 20,000;2;1;1;0;0;0
1152660;Orbital Shipyards;;0 - 20,000;3;0;3;0;0;0
1152670;Operation: Cheek Clapper;;0 - 20,000;9;3;6;0;0;0
1152760;四季 The Four Seasons;;0 - 20,000;13;1;12;0;0;0
1152780;Delivery;;0 - 20,000;0;1;-1;0;0;0
1152800;Buggy Bump;;0 - 20,000;0;1;-1;0;0;0
1152810;Love with Kadyrov;;0 - 20,000;138;17;121;0;0;0
1152820;Everslash;;0 - 20,000;46;2;44;0;0;0
1152820;Everslash;;0 - 20,000;46;2;44;0;0;0
1152840;Gator Parade;;0 - 20,000;6;0;6;0;0;0
1152890;The Delirium Vacation;;0 - 20,000;1;0;1;0;0;0
1152900;KMP;;0 - 20,000;16;3;13;0;0;0
1152910;Bloxicus;;0 - 20,000;1;0;1;0;0;0
1152920;N.a.N Industry VR;;0 - 20,000;15;1;14;0;0;0
1152940;Trails of the Black Sun;;0 - 20,000;4;1;3;0;0;0
1152950;Blackberry;;0 - 20,000;83;48;35;0;0;0
1152990;One Hour Left;;0 - 20,000;1;0;1;0;0;0
1153030;Jigsaw puzzle - Evolution;;0 - 20,000;0;1;-1;0;0;0
1153040;Primate Signal;;0 - 20,000;12;2;10;0;0;0
1153060;Juicy Army: Prologue;;20,000 - 50,000;4;1;3;0;0;0
1153100;Pixels can fight;;0 - 20,000;2;0;2;0;0;0
1153110;Rally Drift Cars;;0 - 20,000;1;4;-3;0;0;0
1153120;ROAD HOMEWARD 4: last step;;0 - 20,000;0;4;-4;0;0;0
1153130;Wurroom;;50,000 - 100,000;530;35;495;0;0;0
1153170;Bomber Bother;;0 - 20,000;43;7;36;0;0;0
1153200;Wormskull;;0 - 20,000;43;2;41;0;0;0
1153210;Bartender Hustle;;0 - 20,000;90;20;70;0;0;5
1153220;Mahjong Dimensions 3D - Fantasy Anime;;0 - 20,000;2;2;0;0;0;0
1153250;VVVVV;;0 - 20,000;28;20;8;0;0;0
1153260;Underponder;;0 - 20,000;15;2;13;0;0;0
1153300;CuBe;;0 - 20,000;1;0;1;0;0;0
1153320;Roy Cluse: Itsy-Bitsy Edition;;;;;0;;;
1153330;Puzzle Patrol;;0 - 20,000;4;0;4;0;0;0
1153330;Puzzle Patrol;;0 - 20,000;4;0;4;0;0;0
1153370;Bumble Butt;;0 - 20,000;4;0;4;0;0;0
1153430;Love wish;;100,000 - 200,000;1259;309;950;61;43;3
1153460;Axegend VR;;0 - 20,000;54;6;48;0;0;0
1153460;Axegend VR;;0 - 20,000;54;6;48;0;0;0
1153470;Empire Live;;0 - 20,000;9;2;7;0;0;0
1153510;Daily OVR Free;;0 - 20,000;19;8;11;0;0;5
1153520;6Souls;;0 - 20,000;17;1;16;0;0;3
1153540;Concept Destruction;;0 - 20,000;116;22;94;0;0;1
1153550;Dark Fairy Fantasy;;0 - 20,000;1;3;-2;0;0;0
1153570;Hyperventila;;0 - 20,000;0;1;-1;0;0;0
1153640;Chorus;;200,000 - 500,000;1930;315;1615;462;855;44
1153700;Eternal Magic;;100,000 - 200,000;472;225;247;35;35;0
1153710;Inspector - 生化战警;;0 - 20,000;2;0;2;0;0;0
1153720;Fart Fiasco Premium;;0 - 20,000;1;3;-2;0;0;0
1153730;SteamCity Chronicles - Rise Of The Rose;;0 - 20,000;7;6;1;0;0;0
1153840;Snow Island;;0 - 20,000;33;1;32;0;0;0
1153850;Super Space Towers;;0 - 20,000;10;0;10;0;0;0
1153860;Instacalm VR;;0 - 20,000;1;2;-1;0;0;0
1153880;Werewolf Voice - Ultimate Werewolf Party;;0 - 20,000;29;16;13;0;0;0
1153930;Easy Shooter;;0 - 20,000;21;19;2;0;0;0
1153950;USAGIRI;;20,000 - 50,000;42;7;35;0;0;0
1153980;Darkness Maze Cube - Hardcore Puzzle Game;;0 - 20,000;34;3;31;0;0;0
1153990;Hacker Evolution - 2019 HD remaster;;0 - 20,000;3;2;1;0;0;0
1154010;Marshmallow Madness;;0 - 20,000;3;2;1;0;0;0
1154040;SpellForce 3: Fallen God;;100,000 - 200,000;1053;121;932;722;1441;11
1154080;Rugby League Team Manager 3;;0 - 20,000;54;15;39;0;0;2
1154150;Evrisia Art;;0 - 20,000;3;4;-1;0;0;0
1154160;CRYPTIC;;0 - 20,000;3;0;3;0;0;0
1154210;Convenience Store;;0 - 20,000;16;7;9;0;0;1
1154290;Rambunny;;0 - 20,000;4;1;3;0;0;0
1154300;The Equinox Hunt;;0 - 20,000;23;1;22;0;0;0
1154300;The Equinox Hunt;;0 - 20,000;23;1;22;0;0;0
1154320;VALHALL Tests;;0 - 20,000;49;15;34;0;0;0
1154340;Night Road;;0 - 20,000;4;0;4;0;0;0
1154350;zzzzz;;0 - 20,000;6;2;4;0;0;0
1154360;For Inco;;0 - 20,000;0;5;-5;0;0;0
1154420;Tech Support 2077;;0 - 20,000;9;0;9;0;0;0
1154430;RPG Character Builder;;20,000 - 50,000;39;9;30;0;0;0
1154470;三国时代2;;0 - 20,000;31;2;29;0;0;1
1154480;Vicious Gambling Agreement;;0 - 20,000;4;6;-2;0;0;0
1154490;Grid Creeps;;0 - 20,000;4;0;4;0;0;0
1154560;Counter Terrorism - Minesweeper;;0 - 20,000;1;1;0;0;0;0
1154570;NAVALNY: A Nightmare of Corrupt;;0 - 20,000;6;5;1;0;0;0
1154640;Safe Climbing;;0 - 20,000;12;2;10;0;0;0
1154680;The Guise;;0 - 20,000;37;12;25;0;0;0
1154730;Panic Diet!!;;0 - 20,000;11;8;3;0;0;0
1154790;XIII;;500,000 - 1,000,000;270;784;-514;423;423;2
1154800;ISLA test;;0 - 20,000;6;1;5;0;0;0
1154810;Going Under;;100,000 - 200,000;2640;236;2404;369;499;29
1154830;Scathe;;20,000 - 50,000;149;73;76;662;662;0
1154840;Shadow Empire;;50,000 - 100,000;824;129;695;152;221;54
1154850;9th Dawn III;;20,000 - 50,000;371;50;321;0;0;4
1154940;Football: The Hardest Job;;0 - 20,000;11;1;10;0;0;0
1154990;War Saber;;0 - 20,000;8;12;-4;0;0;0
1155090;Shadows of time;;0 - 20,000;6;0;6;0;0;0
1155120;The Magician's Research;;20,000 - 50,000;137;94;43;0;0;5
1155130;Block Fall Simulator 2019;;0 - 20,000;4;1;3;0;0;0
1155230;Extend Desktop;;0 - 20,000;2;3;-1;0;0;0
1155290;Cartoon Kreedz: Christmas Season;;0 - 20,000;2;2;0;0;0;0
1155300;Palallel;;20,000 - 50,000;37;2;35;0;0;0
1155340;Rescue Team: Evil Genius;;0 - 20,000;18;1;17;0;0;0
1155390;Code Tracer;;0 - 20,000;2;1;1;0;0;0
1155410;Trials of Harmony ~ A Found Phone Mystery Visual Novel;;0 - 20,000;12;5;7;0;0;0
1155420;Dino Zoo Transport Simulator;;0 - 20,000;57;27;30;0;0;0
1155420;Dino Zoo Transport Simulator;;0 - 20,000;57;27;30;0;0;0
1155440;Tactics & Strategy Master 3:Gemini Strategy;;0 - 20,000;36;13;23;0;0;0
1155460;The Academy: The First Riddle;;0 - 20,000;45;22;23;0;0;1
1155470;Mythic Ocean: Prologue;;0 - 20,000;82;3;79;0;0;0
1155480;Doors of Silence - the prologue;;0 - 20,000;7;5;2;0;0;0
1155490;Dual Blade ~ Battle of The Female Ninja ~;;0 - 20,000;1;3;-2;0;0;0
1155500;Tower Empire Builder;;0 - 20,000;0;2;-2;0;0;0
1155560;Hooks And Shotguns;;0 - 20,000;6;2;4;0;0;0
1155580;Drone Wars;;0 - 20,000;84;19;65;0;0;1
1155590;Warplanes: WW1 Sky Aces;;100,000 - 200,000;432;95;337;0;0;5
1155600;Retro RPG Online 2;;0 - 20,000;1;1;0;0;0;0
1155620;VITAL;;0 - 20,000;9;4;5;0;0;0
1155660;The Deed II;;0 - 20,000;72;13;59;365;365;2
1155670;Living with a Scarecrow;;0 - 20,000;4;1;3;0;0;0
1155680;Through The Dust;;0 - 20,000;8;8;0;0;0;0
1155730;腾起之蛇;;0 - 20,000;4;0;4;0;0;0
1155790;Dreamland Solitaire: Dragon's Fury;;0 - 20,000;27;2;25;0;0;4
1155800;Voyagers;;0 - 20,000;3;3;0;0;0;0
1155810;Santa's Visit;;0 - 20,000;5;4;1;0;0;1
1155830;CHERNOBYL: The Untold Story;;20,000 - 50,000;216;73;143;0;0;0
1155870;WW2: Bunker Simulator;;20,000 - 50,000;198;49;149;0;0;4
1155880;The Bonfire 2: Uncharted Shores;;0 - 20,000;188;91;97;455;455;3
1155900;Treehouse Riddle;;0 - 20,000;12;4;8;0;0;8
1155910;Dice Defenders;;0 - 20,000;2;1;1;0;0;0
1155920;Snow Clearing Driving Simulator;;0 - 20,000;23;15;8;0;0;0
1155950;Treasure Tomb VR;;0 - 20,000;2;4;-2;0;0;0
1155970;Roadwarden;;20,000 - 50,000;1366;47;1319;416;416;38
1156000;Raindancer;;0 - 20,000;271;29;242;0;0;0
1156030;Spectating Simulator The Racing;;0 - 20,000;0;3;-3;0;0;0
1156050;Girl Kill Zombies;;0 - 20,000;17;11;6;0;0;0
1156120;DOOMBRINGER;;0 - 20,000;40;6;34;0;0;0
1156130;Safari Grounds - The Wilpattu Leopard;;0 - 20,000;2;1;1;0;0;0
1156200;VirtuaLiron - Immersive YOGA practice;;0 - 20,000;0;2;-2;0;0;0
1156250;The Exorcist: Legion VR (Deluxe Edition);;0 - 20,000;112;34;78;0;0;2
1156290;HOME: Our Journey;;0 - 20,000;2;1;1;0;0;0
1156320;Concept 20;;0 - 20,000;0;1;-1;0;0;0
1156330;Dead Simple 21;;0 - 20,000;2;0;2;0;0;0
1156360;Peaceful Days;;0 - 20,000;155;23;132;0;0;0
1156380;One Dreamer;;0 - 20,000;233;20;213;259;259;1
1156470;Ghouls Underground;;0 - 20,000;1;3;-2;0;0;0
1156480;My Very Own Light;;0 - 20,000;1;0;1;0;0;0
1156500;Project Apocalypse;;0 - 20,000;10;3;7;0;0;0
1156510;Peachleaf Pirates;;0 - 20,000;38;10;28;0;0;0
1156550;Heroes Of Avranche;;0 - 20,000;9;3;6;0;0;0
1156570;Forest spiders;;0 - 20,000;1;5;-4;0;0;0
1156590;Morels: The Hunt;;0 - 20,000;134;21;113;0;0;1
1156630;A NIGHTMARE'S TRIP;;0 - 20,000;34;1;33;0;0;0
1156640;Cube Attack;;0 - 20,000;12;2;10;0;0;0
1156650;Hero Of The Forest;;0 - 20,000;3;1;2;0;0;0
1156670;Balls!;;0 - 20,000;20;2;18;0;0;1
1156680;Swinger-Man;;0 - 20,000;4;3;1;0;0;0
1156730;Holy Knight Luviria;;20,000 - 50,000;195;46;149;0;0;3
1156730;Holy Knight Luviria;;20,000 - 50,000;195;46;149;0;0;3
1156760;ParaLily;;0 - 20,000;16;0;16;0;0;3
1156770;West-Ward;;0 - 20,000;1;0;1;0;0;0
1156780;Teragard;;0 - 20,000;4;0;4;0;0;0
1156810;Channel Player;;0 - 20,000;0;1;-1;0;0;0
1156850;Dystopian Drift;;;;;0;;;
1156900;Output Pasture;;0 - 20,000;73;7;66;0;0;2
1156910;Galactic Management;;0 - 20,000;1;2;-1;0;0;0
1156970;我们的国;;0 - 20,000;3;2;1;0;0;0
1156980;Nijowari: Where Angels Fall;;0 - 20,000;12;2;10;0;0;0
1156990;Return to Shironagasu Island;;50,000 - 100,000;2192;82;2110;409;485;34
1157010;Him and I;;0 - 20,000;21;6;15;0;0;0
1157020;1001 Hugs;;20,000 - 50,000;60;24;36;0;0;0
1157040;Arkan: The dog adventurer;;0 - 20,000;15;2;13;0;0;0
1157050;Flinger Tactics;;0 - 20,000;32;2;30;0;0;0
1157080;Three Of a Fish;;0 - 20,000;6;3;3;0;0;0
1157100;Starazius;;20,000 - 50,000;1;0;1;0;0;0
1157120;Zombie Season;;0 - 20,000;7;5;2;0;0;0
1157130;Start Button;;0 - 20,000;1;0;1;0;0;0
1157200;Magnesium_173;;0 - 20,000;4;0;4;0;0;1
1157220;Nebuchadnezzar;;100,000 - 200,000;1055;255;800;321;490;81
1157250;Anomaly Zone;;100,000 - 200,000;329;315;14;0;0;49
1157260;GEESE vs CTHULHU;;0 - 20,000;42;8;34;0;0;0
1157300;Last Shark Standing;;0 - 20,000;25;0;25;0;0;0
1157320;Hexagun;;0 - 20,000;3;1;2;0;0;0
1157330;烽火大秦;;0 - 20,000;6;13;-7;0;0;0
1157340;Hentai Killer;;50,000 - 100,000;1105;313;792;90;107;102
1157350;Imaginator;;0 - 20,000;5;4;1;0;0;0
1157360;Life Redemption;;0 - 20,000;2;1;1;0;0;0
1157390;King Arthur: Knight's Tale;;100,000 - 200,000;3874;745;3129;482;691;298
1157560;Arcane Showdown - Battle Arena;;50,000 - 100,000;267;106;161;0;0;0
1157640;Sakura Fox Adventure;;0 - 20,000;155;17;138;61;105;1
1157650;Halloween Pumpkin Smasher VR;;0 - 20,000;7;0;7;0;0;0
1157670;Hepta Beats;;0 - 20,000;25;3;22;0;0;0
1157700;Pro Wrestling Sim;;0 - 20,000;231;13;218;0;0;40
1157750;CATGIRL LOVER 2;;50,000 - 100,000;295;103;192;195;222;0
1157790;I Can't Believe It's Not Gambling 2(K);;0 - 20,000;23;30;-7;0;0;0
1157810;Dark City: Vienna Collector's Edition;;0 - 20,000;12;1;11;0;0;0
1157820;RUNNER HEROES: The curse of night and day;;0 - 20,000;15;4;11;0;0;0
1157830;Final Frontier;;0 - 20,000;1;0;1;0;0;0
1157840;Firezone;;0 - 20,000;1;0;1;0;0;0
1157850;Interphase;;0 - 20,000;2;0;2;0;0;0
1157860;Waterloo;;0 - 20,000;2;0;2;0;0;0
1157870;Savage;;0 - 20,000;1;0;1;0;0;0
1157880;Power Struggle;;0 - 20,000;1;0;1;0;0;0
1157910;Voxel Scavenger;;0 - 20,000;11;1;10;0;0;0
1157920;Beach Body Bros;;0 - 20,000;30;3;27;0;0;0
1157940;Gnomes & Goblins;;0 - 20,000;83;31;52;0;0;1
1157960;Blackout Rugby Manager;;20,000 - 50,000;68;29;39;0;0;6
1157960;Blackout Rugby Manager;;20,000 - 50,000;68;29;39;0;0;6
1157980;Ball Pit Simulator;;0 - 20,000;2;0;2;0;0;0
1158150;Viking Brothers 6;;0 - 20,000;18;2;16;0;0;2
1158160;Coral Island;;200,000 - 500,000;4887;453;4434;1132;1524;641
1158220;Kraken Academy!!;;0 - 20,000;467;33;434;380;380;3
1158230;Hunter's Soul;;0 - 20,000;0;1;-1;0;0;0
1158260;Heroes of Hellas Origins: Part One;;0 - 20,000;44;2;42;0;0;1
1158280;Legion 51;;0 - 20,000;78;17;61;0;0;0
1158280;Legion 51;;0 - 20,000;78;17;61;0;0;0
1158310;Crusader Kings III;;2,000,000 - 5,000,000;80084;6696;73388;6620;2522;15195
1158320;Hentai: Memory leak;;0 - 20,000;44;8;36;0;0;0
1158370;Aragami 2;;100,000 - 200,000;1916;661;1255;439;791;119
1158390;Divan Chronicles;;0 - 20,000;6;11;-5;0;0;0
1158410;Mole Game;;0 - 20,000;29;0;29;0;0;0
1158420;SimCasino;;20,000 - 50,000;473;134;339;62;62;22
1158430;Jane Westlake Adventures - The Mystery Train;;0 - 20,000;4;9;-5;0;0;0
1158450;GALAXIUM;;50,000 - 100,000;58;148;-90;0;0;0
1158460;SULVER'S JOURNEY;;0 - 20,000;1;0;1;0;0;0
1158470;Voxelgram;;20,000 - 50,000;361;6;355;2048;2048;27
1158480;BAFF 4;;0 - 20,000;10;8;2;0;0;0
1158500;Between Two Castles - Digital Edition;;100,000 - 200,000;162;229;-67;18;24;1
1158650;MindLess;;0 - 20,000;0;1;-1;0;0;0
1158690;Uncharted Ocean;;50,000 - 100,000;377;141;236;506;506;4
1158690;Uncharted Ocean;;50,000 - 100,000;377;141;236;506;506;4
1158720;Causality;;100,000 - 200,000;172;14;158;0;0;2
1158750;Tile Conqueror;;0 - 20,000;1;0;1;0;0;0
1158770;1BIT CASTLE;;0 - 20,000;59;18;41;0;0;0
1158820;Mahjong Royal Towers;;0 - 20,000;4;2;2;0;0;1
1158830;1001 Jigsaw Castles And Palaces;;0 - 20,000;11;2;9;0;0;0
1158840;记忆重现/Rememory;;0 - 20,000;59;26;33;0;0;0
1158850;The Great Ace Attorney Chronicles;;100,000 - 200,000;4399;222;4177;4098;5845;280
1158890;White Shadows;;0 - 20,000;253;66;187;0;0;0
1158910;Dream Detective;;0 - 20,000;16;8;8;0;0;0
1158940;Blazing Sails;;100,000 - 200,000;6026;745;5281;612;736;63
1158970;Westmark Manor;;0 - 20,000;46;22;24;0;0;0
1158980;Idle Big Devil;;200,000 - 500,000;3163;635;2528;4559;9102;60
1158990;Alan's Attitude;;0 - 20,000;1;0;1;0;0;0
1159000;我是键盘侠;;0 - 20,000;36;5;31;0;0;0
1159040;KENDO;;0 - 20,000;1;1;0;0;0;0
1159070;A-Vroom!;;0 - 20,000;3;0;3;0;0;0
1159240;Occultus Command;;0 - 20,000;1;0;1;0;0;0
1159260;PANDARA;;0 - 20,000;4;1;3;0;0;0
1159340;March Forward;;0 - 20,000;0;6;-6;0;0;0
1159350;Future Simulation World;;0 - 20,000;14;7;7;0;0;0
1159360;MeiQi Season1;;0 - 20,000;82;38;44;0;0;0
1159430;Systematic Insanity;;0 - 20,000;5;1;4;0;0;21
1159450;Hayfever;;0 - 20,000;45;2;43;0;0;0
1159480;BOW MAN;;0 - 20,000;4;1;3;0;0;0
1159490;LowPoly 3D Art Paint by Number;;0 - 20,000;0;1;-1;0;0;0
1159540;Fear the Dark Unknown;;0 - 20,000;86;31;55;0;0;0
1159550;Supesu 2;;0 - 20,000;5;1;4;0;0;0
1159560;Ziggurat 2;;20,000 - 50,000;1034;78;956;642;642;16
1159590;Lost In Dungeon;;20,000 - 50,000;0;6;-6;0;0;0
1159610;Neighbourhood Loot;;0 - 20,000;3;0;3;0;0;0
1159640;ANIME - World War II;;20,000 - 50,000;643;124;519;189;221;0
1159660;Moe Era;;200,000 - 500,000;4150;561;3589;0;0;4
1159680;Silent Sector;;0 - 20,000;95;19;76;0;0;1
1159700;Knights of Light: The Prologue;;0 - 20,000;6;31;-25;0;0;0
1159770;RaceXXL Space;;0 - 20,000;1;1;0;0;0;0
1159860;Dash Dash World;;0 - 20,000;124;30;94;0;0;2
1159870;SUCCESSOR OF THE KEY;;0 - 20,000;2;0;2;0;0;0
1159880;Quantumleaper;;0 - 20,000;0;1;-1;0;0;0
1159890;Supercar Drift;;0 - 20,000;2;8;-6;0;0;0
1159940;Astrodition;;0 - 20,000;2;1;1;0;0;0
1159940;Astrodition;;0 - 20,000;2;1;1;0;0;0
1159960;Gloam;;0 - 20,000;16;0;16;0;0;0
1160020;AshenForest;;0 - 20,000;161;9;152;0;0;1
1160040;Human Factory;;20,000 - 50,000;8;0;8;0;0;0
1160040;Human Factory;;20,000 - 50,000;8;0;8;0;0;0
1160050;There is a Thief in my House VR;;0 - 20,000;4;4;0;0;0;0
1160190;Player One;;0 - 20,000;2;1;1;0;0;0
1160220;Paradise Killer;;200,000 - 500,000;2725;183;2542;91;117;16
1160330;Fight of Animals;;0 - 20,000;422;23;399;24;24;1
1160360;Miscreation: Evolve Your Creature!;;20,000 - 50,000;118;81;37;0;0;2
1160420;EducationXR;;0 - 20,000;4;1;3;0;0;0
1160440;PARANOIHELL;;0 - 20,000;19;2;17;0;0;0
1160480;Boot : Game Dev Sim;;0 - 20,000;5;12;-7;0;0;0
1160490;Master Of Pottery;;50,000 - 100,000;2404;48;2356;297;455;12
1160500;AstronTycoon2: Ritual;;0 - 20,000;22;8;14;0;0;0
1160560;Galmon Folklore ~Monster Girl Galore!~;;20,000 - 50,000;1;0;1;0;0;0
1160580;Model Melissa;;0 - 20,000;18;9;9;1;1;0
1160670;Shrine to Anubis;;0 - 20,000;6;0;6;0;0;0
1160700;Particle Wars;;0 - 20,000;50;2;48;0;0;0
1160750;Grim Clicker;;100,000 - 200,000;1735;393;1342;0;0;209
1160770;家园VR;;0 - 20,000;2;2;0;0;0;0
1160780;LoliTower;;0 - 20,000;23;6;17;0;0;0
1160790;The Legend of Dark Witch Renovation;;0 - 20,000;20;2;18;0;0;0
1160800;Rainbow Robin;;0 - 20,000;3;2;1;0;0;0
1160820;Bewitched;;0 - 20,000;29;6;23;0;0;0
1160870;Dinosaur Hunting Patrol 3D Multiplayer Online;;0 - 20,000;85;19;66;0;0;0
1160880;Paul's World;;0 - 20,000;21;3;18;0;0;0
1160920;Food Truck Simulator;;20,000 - 50,000;582;267;315;244;332;23
1160920;Food Truck Simulator;;20,000 - 50,000;582;267;315;244;332;23
1160980;Legendary Arcane 2 Universe;;0 - 20,000;1;0;1;0;0;0
1161110;In - Sight;;0 - 20,000;9;0;9;0;0;0
1161110;In - Sight;;0 - 20,000;9;0;9;0;0;0
1161120;A Ghostly Tale;;0 - 20,000;1;0;1;0;0;0
1161140;Speakerman 2;;0 - 20,000;1;0;1;0;0;0
1161160;talesshop puzzle 테일즈샵 퍼즐;;20,000 - 50,000;284;20;264;0;0;0
1161170;The Rewinder;;200,000 - 500,000;5036;149;4887;367;405;14
1161190;Natsu no Iro no Nostalgia;;0 - 20,000;379;34;345;11;11;2
1161200;Foreign;;0 - 20,000;2;0;2;0;0;0
1161210;Ray Versus;;0 - 20,000;1;0;1;0;0;0
1161210;Ray Versus;;0 - 20,000;1;0;1;0;0;0
1161220;Time Squared;;0 - 20,000;3;3;0;0;0;0
1161270;Freud Gate;;20,000 - 50,000;302;84;218;0;0;0
1161300;The Legend of Crystal Valley;;50,000 - 100,000;4;1;3;0;0;2
1161320;东方幻昼梦~ Touhou Fantasy Day;;0 - 20,000;2;6;-4;0;0;0
1161330;Record Life;;0 - 20,000;10;7;3;0;0;0
1161360;Shisensho Solitaire;;0 - 20,000;63;0;63;0;0;4
1161430;Noosphere;;20,000 - 50,000;62;30;32;0;0;0
1161440;World War 2 Winter Gun Range VR Simulator;;0 - 20,000;3;6;-3;0;0;0
1161490;MotoGP20;;100,000 - 200,000;2419;303;2116;671;1067;35
1161510;Lithium Inmate 39 Relapsed Edition;;0 - 20,000;3;1;2;0;0;0
1161550;Dungeon Chest;;0 - 20,000;1;0;1;0;0;0
1161570;Dark Parables: Portrait of the Stained Princess Collector's Edition;;0 - 20,000;24;5;19;0;0;0
1161580;Hardspace: Shipbreaker;;500,000 - 1,000,000;14099;1637;12462;1421;1064;369
1161650;Sakura Gamer 2;;0 - 20,000;119;23;96;162;162;0
1161660;Puzzlection;;0 - 20,000;4;0;4;0;0;0
1161670;CRASH THE GAME;;0 - 20,000;8;6;2;0;0;0
1161680;Bomb Bowling 2;;20,000 - 50,000;8;0;8;0;0;0
1161800;URO2;;0 - 20,000;10;1;9;0;0;0
1161810;SushiParty2;;0 - 20,000;4;2;2;0;0;0
1161820;Survived;;0 - 20,000;0;5;-5;0;0;0
1161840;Funny Archery;;0 - 20,000;23;11;12;0;0;0
1161870;Epiphyllum in Love;;20,000 - 50,000;1730;20;1710;494;513;2
1161880;Vaporum: Lockdown;;0 - 20,000;196;32;164;0;0;2
1161900;Door2:Key;;0 - 20,000;30;10;20;0;0;0
1161910;Exile Squadron;;0 - 20,000;16;3;13;0;0;0
1161930;東方幻夢箋 ~ Touhou Phantasm Dream;;0 - 20,000;70;9;61;308;614;0
1162010;奇幻与砍杀2 Fantasy & Blade Ⅱ;;20,000 - 50,000;91;27;64;7;7;1
1162050;Knockout Party;;0 - 20,000;76;40;36;0;0;0
1162070;Nyakori's Rabbit Doll;;50,000 - 100,000;927;32;895;428;841;2
1162130;Windbound;;50,000 - 100,000;528;384;144;312;312;4
1162180;Warren The Warlock;;20,000 - 50,000;50;14;36;0;0;0
1162280;Eternal Hope;;20,000 - 50,000;192;25;167;0;0;1
1162320;AVA: Dark History;;0 - 20,000;16;4;12;0;0;0
1162330;Earthlings Must Die;;0 - 20,000;0;3;-3;0;0;0
1162350;Drill Down;;0 - 20,000;42;10;32;0;0;0
1162370;Paper - A Game of Folding;;0 - 20,000;6;0;6;0;0;0
1162390;Floody;;0 - 20,000;2;2;0;0;0;0
1162400;The Climate Trail;;0 - 20,000;5;4;1;0;0;0
1162430;Salad Fields;;0 - 20,000;25;0;25;0;0;1
1162440;Explosive Jake;;0 - 20,000;16;7;9;0;0;0
1162440;Explosive Jake;;0 - 20,000;16;7;9;0;0;0
1162470;IIslands of War;;0 - 20,000;103;12;91;0;0;0
1162480;DIMENSION REIGN - ROGUELIKE DECKBUILDER;;0 - 20,000;155;49;106;0;0;0
1162520;Richman10;;500,000 - 1,000,000;6779;6214;565;999;593;943
1162570;The Protagonist: EX-1;;20,000 - 50,000;19;9;10;0;0;1
1162630;Solitaire Call of Honor;;0 - 20,000;7;1;6;0;0;1
1162640;Adventure mosaics. Forest spirits;;0 - 20,000;3;0;3;0;0;2
1162650;Ken ga Kimi;;20,000 - 50,000;800;37;763;0;0;25
1162670;Blocks!: Julius Caesar;;0 - 20,000;33;27;6;0;0;0
1162680;[Chilla's Art] Stigmatized Property | 事故物件;;20,000 - 50,000;704;157;547;0;0;5
1162690;House Number 666;;0 - 20,000;7;5;2;0;0;0
1162700;Midnight Protocol;;20,000 - 50,000;285;38;247;658;658;5
1162730;Deep Ocean Rush;;0 - 20,000;3;9;-6;0;0;0
1162750;Songs of Syx;;100,000 - 200,000;2303;78;2225;211;361;183
1162760;MMY: Otherworld Mystery;;0 - 20,000;15;0;15;0;0;0
1162820;Kings Of Wings;;0 - 20,000;11;0;11;0;0;0
1162880;Pax Ruthenia;;0 - 20,000;7;4;3;0;0;0
1162900;Iron Blood VR;;0 - 20,000;9;5;4;0;0;0
1162920;Time of the Moon;;0 - 20,000;10;0;10;0;0;0
1162930;Split or Steal;;200,000 - 500,000;981;272;709;0;0;1
1162950;>Connect;;0 - 20,000;1;3;-2;0;0;0
1162990;ZOR: Pilgrimage of the Slorfs;;0 - 20,000;31;2;29;0;0;14
1163040;Billion Road;;0 - 20,000;141;33;108;133;133;9
1163070;RaiOhGar: Asuka and the King of Steel;;20,000 - 50,000;212;38;174;0;0;7
1163090;Boot Camp Fitness;;0 - 20,000;50;2;48;0;0;0
1163100;我是院长 - 模拟经营医院游戏;;0 - 20,000;6;2;4;0;0;1
1163140;Shanghai Office Simulator;;20,000 - 50,000;365;99;266;367;367;1
1163150;Unfamiliar;;0 - 20,000;22;9;13;0;0;0
1163170;Music Desktop;;0 - 20,000;7;1;6;0;0;0
1163290;Vortex Attack EX;;0 - 20,000;16;3;13;0;0;0
1163300;visser;;0 - 20,000;7;4;3;0;0;0
1163320;Zombie horde;;0 - 20,000;3;8;-5;0;0;0
1163340;Carrier Battles 4 Guadalcanal - Pacific War Naval Warfare;;0 - 20,000;187;27;160;0;0;4
1163460;Daenerys doesn’t want Hentai;;0 - 20,000;44;33;11;0;0;0
1163470;Give Up The Dupe;;0 - 20,000;5;0;5;0;0;0
1163480;Welcome To... Chichester OVN 2 : Master Tormentor Grendel Jinx !?;;0 - 20,000;16;5;11;0;0;0
1163490;Gangsters 1920;;20,000 - 50,000;2;4;-2;0;0;0
1163500;Warp Drive;;0 - 20,000;23;18;5;0;0;0
1163550;Captain Tsubasa: Rise of New Champions;;100,000 - 200,000;2804;1440;1364;766;1215;93
1163560;SuperEpic: The Entertainment War;;0 - 20,000;53;26;27;0;0;0
1163570;skidlocked;;0 - 20,000;10;2;8;0;0;0
1163590;Bullet Girls Phantasia;;50,000 - 100,000;543;111;432;0;0;11
1163600;Omega Labyrinth Life;;0 - 20,000;175;67;108;447;447;8
1163620;Haunted: Poppy's Nightmare;;0 - 20,000;0;2;-2;0;0;0
1163660;Soul Reaper;;20,000 - 50,000;18;12;6;0;0;0
1163690;Wizards;;20,000 - 50,000;318;52;266;0;0;2
1163730;Motor Assailant;;0 - 20,000;13;1;12;0;0;0
1163830;Sticky Dildo Man;;0 - 20,000;0;2;-2;0;0;0
1163870;Mecha Knights: Nightmare;;50,000 - 100,000;818;72;746;485;485;4
1163910;Brass Brigade;;20,000 - 50,000;421;36;385;0;0;2
1163930;Dragon Forge;;0 - 20,000;57;52;5;0;0;29
1163950;A Dragon's Tale VR;;0 - 20,000;1;1;0;0;0;0
1163960;Paranormal Files: Hook Man's Legend Collector's Edition;;0 - 20,000;4;1;3;0;0;0
1163980;Crazy Shopping;;0 - 20,000;7;0;7;0;0;0
1163990;Starexcess;;0 - 20,000;4;1;3;0;0;0
1164000;六阶谜题 six-step mystery;;0 - 20,000;517;64;453;0;0;1
1164010;Mouse Cursor;;0 - 20,000;129;44;85;1336;1336;4
1164010;Mouse Cursor;;0 - 20,000;129;44;85;1336;1336;4
1164020;Iron Sun;;0 - 20,000;0;1;-1;0;0;0
1164040;Victoriana - Steampunk Text Adventure;;0 - 20,000;3;1;2;0;0;0
1164050;When The Past Was Around;;100,000 - 200,000;2664;116;2548;90;112;7
1164060;The Last Show of Mr. Chardish;;0 - 20,000;91;4;87;0;0;0
1164060;The Last Show of Mr. Chardish;;0 - 20,000;91;4;87;0;0;0
1164100;A Random Maze 某个迷宫;;50,000 - 100,000;357;12;345;0;0;5
1164250;Model Builder;;50,000 - 100,000;846;225;621;57;59;7
1164290;Aluna: Sentinel of the Shards;;0 - 20,000;39;8;31;0;0;0
1164300;1001 Jigsaw. Ice Age;;0 - 20,000;8;2;6;0;0;0
1164310;Fairytale Solitaire. Witch Charms;;0 - 20,000;5;1;4;0;0;1
1164330;Smile To Fly;;0 - 20,000;7;1;6;0;0;0
1164350;Anime Otaku Girl 二次元宅女;;20,000 - 50,000;1;0;1;0;0;0
1164390;Haunted Gas Station;;50,000 - 100,000;861;261;600;0;0;0
1164410;Restless Hero;;0 - 20,000;8;4;4;0;0;0
1164440;Extreme Offroad Monster Simulator;;0 - 20,000;12;13;-1;0;0;0
1164470;[MISC] TIMELINES;;0 - 20,000;8;2;6;0;0;0
1164480;Killer Gin;;0 - 20,000;11;2;9;0;0;0
1164520;The Book Of Yorle: Save The Church;;20,000 - 50,000;1;1;0;0;0;0
1164550;Disc Golf Adventure VR;;0 - 20,000;8;3;5;0;0;0
1164570;Phucker in the Rome;;0 - 20,000;84;11;73;0;0;0
1164660;SHOOTING CHICKEN BRUTAL SUCKERS;;0 - 20,000;4;1;3;0;0;0
1164690;Wigmund;;100,000 - 200,000;230;39;191;0;0;6
1164690;Wigmund;;100,000 - 200,000;230;39;191;0;0;6
1164740;Salting the Earth;;0 - 20,000;69;6;63;0;0;0
1164750;Hospitality VR;;0 - 20,000;78;33;45;0;0;0
1164760;Vugluskr: Zombie Rampage;;20,000 - 50,000;3;2;1;0;0;0
1164850;Sinking Simulator;;500,000 - 1,000,000;2971;500;2471;206;41;27
1164860;Darkour;;0 - 20,000;5;0;5;0;0;0
1164910;Doll;;0 - 20,000;15;1;14;0;0;0
1164920;Axeson's Fury VR;;0 - 20,000;4;0;4;0;0;0
1164970;Dogs of Wallstreet;;0 - 20,000;11;0;11;0;0;0
1164990;Skin Witch;;0 - 20,000;2;6;-4;0;0;0
1165000;Chameleon Gallery;;0 - 20,000;3;2;1;0;0;0
1165010;Lost Home : Battle Of Island;;0 - 20,000;0;1;-1;0;0;0
1165020;Legend of Everything;;0 - 20,000;4;0;4;0;0;0
1165090;Restaurant Solitaire: Pleasant Dinner;;0 - 20,000;6;0;6;0;0;0
1165100;Tasty Jigsaw: Happy Hour  (拼图);;0 - 20,000;5;1;4;0;0;1
1165140;Picross Love;;0 - 20,000;23;27;-4;0;0;0
1165140;Picross Love;;0 - 20,000;23;27;-4;0;0;0
1165170;Morok;;0 - 20,000;65;22;43;0;0;0
1165170;Morok;;0 - 20,000;65;22;43;0;0;0
1165180;Knight Eternal;;0 - 20,000;23;3;20;0;0;0
1165230;Elevenses: The Flask;;0 - 20,000;15;0;15;0;0;0
1165270;Synthesis Universe -Episode 00-;;50,000 - 100,000;27;5;22;0;0;0
1165280;Shuffle World;;0 - 20,000;8;6;2;0;0;0
1165290;Gifted;;0 - 20,000;4;9;-5;0;0;0
1165350;Garbage Classification Simulator 垃圾分类模拟器;;0 - 20,000;2;1;1;0;0;0
1165380;To Be Headed Or Not To Be;;0 - 20,000;97;60;37;0;0;2
1165400;Stellar Commanders;;0 - 20,000;56;28;28;0;0;0
1165420;Detective Solitaire. Butler Story;;0 - 20,000;7;0;7;0;0;0
1165430;1001 Jigsaw. Myths of ancient Greece (拼图);;0 - 20,000;7;3;4;0;0;0
1165450;OCO;;0 - 20,000;66;11;55;0;0;0
1165460;Unlit;;0 - 20,000;1;1;0;0;0;0
1165470;TombStar;;20,000 - 50,000;58;16;42;0;0;2
1165490;New Tricks for Old Gods;;0 - 20,000;2;1;1;0;0;0
1165520;黎明生机:启示录-Survival:Revelation;;0 - 20,000;1;0;1;0;0;0
1165540;MAD Maze;;0 - 20,000;4;0;4;0;0;0
1165570;Tsukai Furushita Kotoba Ya Uta Wo MV;;0 - 20,000;20;4;16;0;0;0
1165590;It Will Find You;;0 - 20,000;6;4;2;0;0;0
1165610;Titeuf: Mega Party;;0 - 20,000;13;12;1;0;0;0
1165610;Titeuf: Mega Party;;0 - 20,000;13;12;1;0;0;0
1165720;Beyond Enemy Lines 2 Online;;0 - 20,000;6;11;-5;0;0;0
1165740;Match Solitaire;;0 - 20,000;3;0;3;0;0;0
1165750;PAGAN: Autogeny;;0 - 20,000;31;7;24;0;0;0
1165780;Masterpiece Studio;;0 - 20,000;5;20;-15;0;0;0
1165820;Super Rebellion;;20,000 - 50,000;12;4;8;0;0;0
1165830;Final Mission VR;;0 - 20,000;1;0;1;0;0;0
1165840;The Strange Story Of Brian Fisher: Chapter 1;;0 - 20,000;37;7;30;0;0;0
1165860;6.0;;0 - 20,000;224;27;197;0;0;0
1165910;Humanity Lost;;0 - 20,000;19;8;11;0;0;0
1165960;Things That Bounce and Explode;;20,000 - 50,000;19;1;18;0;0;0
1166000;Battleships and Carriers - Pacific War;;0 - 20,000;9;2;7;0;0;0
1166000;Battleships and Carriers - Pacific War;;0 - 20,000;9;2;7;0;0;0
1166050;离玥传;;0 - 20,000;9;4;5;0;0;0
1166090;EnviroGolf;;0 - 20,000;17;9;8;0;0;0
1166090;EnviroGolf;;0 - 20,000;17;9;8;0;0;0
1166100;Danger Course VR;;0 - 20,000;0;1;-1;0;0;0
1166110;Gods of Love: An Otome Visual Novel;;0 - 20,000;26;13;13;141;141;0
1166130;Fighting Moore;;0 - 20,000;7;1;6;0;0;0
1166200;CyberLink AudioDirector 10 Ultra;;0 - 20,000;1;0;1;0;0;0
1166230;1812: Napoleon Wars;;0 - 20,000;42;11;31;0;0;0
1166240;Asian Riddles;;0 - 20,000;21;6;15;0;0;0
1166250;Mahjong Gold;;0 - 20,000;4;4;0;0;0;1
1166290;Death and Taxes;;200,000 - 500,000;3276;413;2863;259;300;61
1166310;Tactical Three Kingdoms (3 Kingdoms) - Strategy & War;;0 - 20,000;74;34;40;0;0;0
1166350;Alexis Almighty: Daughter of Hercules;;0 - 20,000;2;3;-1;0;0;0
1166490;Live Desktop;;0 - 20,000;6;12;-6;0;0;0
1166510;Nanoworld;;0 - 20,000;0;7;-7;0;0;0
1166540;Beetle Hunter;;0 - 20,000;14;2;12;0;0;0
1166580;Best Plumber;;0 - 20,000;39;11;28;0;0;0
1166600;The Fog Knows Your Name;;0 - 20,000;54;7;47;0;0;0
1166680;Daraney - Guardian's Rise;;0 - 20,000;0;1;-1;0;0;0
1166710;Find The Treasure;;0 - 20,000;6;0;6;0;0;0
1166730;nothing & nowhere;;0 - 20,000;19;7;12;0;0;0
1166740;Centralia: Homecoming;;50,000 - 100,000;47;21;26;0;0;1
1166760;Jinga Online;;0 - 20,000;4;6;-2;0;0;0
1166780;Interactivity: The Interactive Experience;;0 - 20,000;33;10;23;0;0;0
1166790;Hexterio;;20,000 - 50,000;4;2;2;0;0;0
1166800;Grand Academy II: Attack of the Sequel;;0 - 20,000;6;3;3;0;0;0
1166830;Lost Empire 2977;;0 - 20,000;4;2;2;0;0;0
1166840;Breach: The Archangel Job;;0 - 20,000;68;4;64;0;0;2
1166860;Rival Stars Horse Racing: Desktop Edition;;20,000 - 50,000;2073;199;1874;0;0;351
1166910;Swiss Knife;;0 - 20,000;1;0;1;0;0;0
1166990;Kukoro: Stream chat games;;0 - 20,000;543;14;529;806;806;40
1167090;Desert coachman;;0 - 20,000;1;1;0;0;0;0
1167100;Metal Mind;;0 - 20,000;0;0;0;0;0;1
1167140;Siege Survival: Gloria Victis;;100,000 - 200,000;966;233;733;94;78;25
1167150;Zombies and Keys;;0 - 20,000;38;1;37;0;0;0
1167170;Guilty Parade;;0 - 20,000;205;7;198;0;0;1
1167190;Mr Jorries!;;0 - 20,000;1;0;1;0;0;0
1167270;Tank Impact;;0 - 20,000;1;4;-3;0;0;0
1167300;Battle Axe;;0 - 20,000;34;26;8;0;0;0
1167320;Artificial Extinction;;0 - 20,000;191;56;135;0;0;1
1167350;Skyous;;0 - 20,000;0;2;-2;0;0;0
1167380;Neither Day nor Night;;0 - 20,000;10;7;3;0;0;0
1167430;The Loopholes Chronicles;;0 - 20,000;4;0;4;0;0;0
1167450;DAEMON X MACHINA;;100,000 - 200,000;5047;630;4417;1444;1823;21
1167460;Hero Hours Contract;;0 - 20,000;13;0;13;0;0;0
1167470;Street Jam: The Rise;;0 - 20,000;1;6;-5;0;0;0
1167490;Link Wars;;0 - 20,000;8;2;6;0;0;0
1167530;Ailment;;0 - 20,000;7;2;5;0;0;0
1167540;KiKi's adventure;;0 - 20,000;27;12;15;0;0;0
1167550;VR MEDIA VIEWER;;0 - 20,000;24;2;22;0;0;1
1167590;Dimensionality 3.5;;0 - 20,000;1;0;1;0;0;0
1167630;Teardown;;2,000,000 - 5,000,000;62372;2397;59975;1210;470;4324
1167640;Femida;;0 - 20,000;20;5;15;0;0;0
1167650;Context;;0 - 20,000;1;1;0;0;0;0
1167680;Orbital Bullet – The 360° Rogue-lite;;20,000 - 50,000;389;56;333;0;0;6
1167700;hallucination - 幻觉;;0 - 20,000;163;16;147;0;0;0
1167710;clutchball;;0 - 20,000;8;1;7;3;3;0
1167730;A Time Paradox;;0 - 20,000;5;0;5;0;0;0
1167760;4islands;;0 - 20,000;9;3;6;0;0;0
1167770;More Dark;;0 - 20,000;32;4;28;0;0;0
1167790;绝望监牢 / 絶望プリズン;;100,000 - 200,000;358;115;243;0;0;0
1167800;Exphelius: Arena;;20,000 - 50,000;2;0;2;0;0;0
1167850;Penguin Park 3D;;0 - 20,000;24;1;23;0;0;0
1167900;Friday 星期五部门;;0 - 20,000;31;1;30;0;0;0
1167950;Vampire's Fall: Origins;;50,000 - 100,000;534;131;403;0;0;8
1167970;Will: The Beginning;;0 - 20,000;8;4;4;0;0;0
1168000;High School Otome;;20,000 - 50,000;19;23;-4;0;0;0
1168050;Fairytale Mosaics Beauty and Beast;;0 - 20,000;6;1;5;0;0;0
1168060;Knight Solitaire;;0 - 20,000;11;2;9;0;0;1
1168070;Mystery Solitaire The Arkham Spirits;;0 - 20,000;9;1;8;0;0;0
1168160;Piping Hot;;0 - 20,000;0;1;-1;0;0;0
1168170;WAIFU HORROR: The Eight Pictures;;0 - 20,000;35;30;5;0;0;1
1168250;Shades Of Heroes;;20,000 - 50,000;15;6;9;0;0;0
1168280;"Resident Evil 2 ""R.P.D. Demo""";;200,000 - 500,000;1568;340;1228;32;31;11
1168290;TD Heroes;;0 - 20,000;21;10;11;0;0;0
1168320;Zombie valley;;0 - 20,000;2;5;-3;0;0;0
1168360;Detective Solitaire Inspector Magic;;0 - 20,000;5;0;5;0;0;1
1168420;passenger seat;;0 - 20,000;7;2;5;0;0;0
1168430;Dairy Princess;;0 - 20,000;70;7;63;0;0;1
1168530;登塔者们 Babel Climbers;;0 - 20,000;1;6;-5;0;0;0
1168550;The Hunter's Journals - Blissful Ignorance;;0 - 20,000;3;0;3;0;0;0
1168600;Infinite Sparkles;;0 - 20,000;6;1;5;0;0;0
1168610;Natural Instincts: European Forest;;50,000 - 100,000;130;90;40;16;16;1
1168630;Active Neurons - Puzzle game;;0 - 20,000;48;2;46;0;0;0
1168650;Angry Bunny;;0 - 20,000;25;22;3;0;0;0
1168660;Barro 2020;;100,000 - 200,000;980;191;789;124;95;4
1168690;HELLSEED;;20,000 - 50,000;49;31;18;0;0;3
1168740;Old School Horror Game : Bright Day;;0 - 20,000;5;2;3;0;0;0
1168790;Ground War;;0 - 20,000;1;0;1;0;0;0
1168800;Mulite Sword Man;;0 - 20,000;18;6;12;0;0;0
1168820;Myths of the World: The Heart of Desolation Collector's Edition;;0 - 20,000;7;0;7;0;0;0
1168830;Mystery Case Files: Ravenhearst Unlocked Collector's Edition;;0 - 20,000;18;7;11;0;0;2
1168840;Project Oasis;;20,000 - 50,000;153;7;146;0;0;2
1168870;Mists of Noyah;;0 - 20,000;475;201;274;0;0;8
1168880;MOLEK-SYNTEZ;;100,000 - 200,000;510;60;450;92;144;4
1168940;Crystal core;;0 - 20,000;51;8;43;0;0;0
1168960;Warbrush;;0 - 20,000;3;0;3;0;0;0
1168970;Drunk ride;;0 - 20,000;5;3;2;0;0;0
1168980;Buried Alive: The Annihilation VR;;0 - 20,000;6;15;-9;0;0;0
1168990;Planet destroyer;;20,000 - 50,000;3;8;-5;0;0;0
1169000;TORINTO;;0 - 20,000;3;0;3;0;0;0
1169020;Dark Fall: Ghost Vigil;;0 - 20,000;150;12;138;0;0;2
1169030;Monophobia;;0 - 20,000;4;5;-1;0;0;0
1169040;Necesse;;200,000 - 500,000;4721;250;4471;361;492;557
1169050;Language Worm;;0 - 20,000;1;0;1;0;0;0
1169060;Shield Shock;;0 - 20,000;6;3;3;0;0;0
1169070;RED EVIL;;0 - 20,000;8;9;-1;0;0;0
1169100;Gazillionaire;;0 - 20,000;151;11;140;0;0;7
1169110;Super Bout: Champion's Tour;;0 - 20,000;12;0;12;0;0;0
1169160;ECHORIA: Ancient Echoes;;0 - 20,000;7;1;6;0;0;0
1169200;Space Bear;;20,000 - 50,000;405;5;400;0;0;1
1169200;Space Bear;;20,000 - 50,000;405;5;400;0;0;1
1169230;R.U.B.Y.寻常交织的日常;;0 - 20,000;19;1;18;0;0;0
1169310;The Chronicles of Joseph of Egypt;;0 - 20,000;12;1;11;0;0;0
1169340;Trauma Simulator;;0 - 20,000;4;9;-5;0;0;0
1169420;Monstrüous;;0 - 20,000;18;1;17;0;0;0
1169430;Ransomware Dating Sim;;0 - 20,000;7;2;5;0;0;0
1169460;遠古大陸外傳-古道的盡頭;;0 - 20,000;1;2;-1;0;0;0
1169490;Interactive Horror Stories;;20,000 - 50,000;80;41;39;0;0;0
1169500;The Valley;;0 - 20,000;1;6;-5;0;0;0
1169510;Game Breaker;;0 - 20,000;3;2;1;0;0;0
1169520;Guild of Ascension;;0 - 20,000;36;8;28;0;0;0
1169640;最后的阳光 The Last Sunshine;;0 - 20,000;0;1;-1;0;0;0
1169690;Shadowplay: Metropolis Foe;;0 - 20,000;142;57;85;0;0;0
1169740;Danger Scavenger;;20,000 - 50,000;261;81;180;123;123;11
1169760;Firing Vibes;;20,000 - 50,000;4;18;-14;0;0;0
1169770;Swordrite;;0 - 20,000;1;1;0;0;0;0
1169870;Witch Loraine's Death Game;;0 - 20,000;13;0;13;0;0;0
1169920;SafeHome;;0 - 20,000;8;2;6;0;0;0
1170030;Eye Of Plunder;;0 - 20,000;1;0;1;0;0;0
1170050;Null Drifter;;0 - 20,000;21;1;20;0;0;0
1170060;Boomerang X;;100,000 - 200,000;736;32;704;101;109;2
1170080;Foretales;;50,000 - 100,000;465;48;417;0;0;7
1170110;Puzzle Game: Lee inside TV;;0 - 20,000;6;1;5;0;0;0
1170120;OUTTA GAS;;0 - 20,000;44;1;43;0;0;0
1170130;Restrictr;;0 - 20,000;9;0;9;0;0;10
1170160;Golf98;;0 - 20,000;4;1;3;0;0;0
1170170;Alfonzo's Arctic Adventure;;0 - 20,000;4;0;4;0;0;0
1170180;Beat.School: DJ Simulator;;0 - 20,000;39;18;21;0;0;0
1170190;Bogatyr;;20,000 - 50,000;40;22;18;0;0;0
1170200;Ope;;20,000 - 50,000;81;26;55;0;0;0
1170210;Is the President a Traitor?;;0 - 20,000;10;3;7;0;0;0
1170250;Eutergeläuter;;0 - 20,000;2;0;2;0;0;0
1170290;Lovely Heroines;;0 - 20,000;8;9;-1;0;0;0
1170300;Glitchangels;;0 - 20,000;10;2;8;0;0;0
1170330;toz;;0 - 20,000;17;1;16;0;0;0
1170350;Pirate Popper VR;;0 - 20,000;1;0;1;0;0;0
1170370;Whimsy;;0 - 20,000;80;2;78;0;0;0
1170390;GameBook;;0 - 20,000;1;2;-1;0;0;0
1170400;Labyrinth of the Witch;;0 - 20,000;16;5;11;0;0;0
1170500;Sword and Adventurer;;0 - 20,000;4;2;2;0;0;0
1170610;Sexy Fitness Girl;;0 - 20,000;203;57;146;361;361;0
1170640;When The Past Was Around - Prologue;;50,000 - 100,000;588;31;557;0;0;0
1170720;Pocket Cars;;0 - 20,000;92;10;82;0;0;0
1170750;MOR...E TRAINER (Learning Morse Code);;0 - 20,000;10;1;9;0;0;0
1170760;XIII - Classic;;200,000 - 500,000;1680;180;1500;114;212;10
1170830;ZLM Crafter;;0 - 20,000;9;3;6;0;0;0
1170840;Pamp Quest;;0 - 20,000;6;0;6;0;0;0
1170870;Rain of Fire;;0 - 20,000;2;0;2;0;0;0
1170880;Grimm's Hollow;;500,000 - 1,000,000;10592;149;10443;0;0;12
1170910;SEN: Seven Eight Nine;;0 - 20,000;2;4;-2;0;0;0
1170950;Mortal Online 2;;200,000 - 500,000;5755;3564;2191;4957;5092;1561
1170960;The Eye of Borrack;;0 - 20,000;14;0;14;0;0;0
1170970;Marbles on Stream;;200,000 - 500,000;1304;209;1095;0;0;215
1170980;A Planet of Mine;;0 - 20,000;29;11;18;0;0;0
1171030;Bock Bock;;0 - 20,000;1;1;0;0;0;0
1171040;Eonica Chess Battle;;0 - 20,000;13;10;3;0;0;0
1171070;Medieval - Embers of War;;0 - 20,000;4;4;0;0;0;0
1171080;Diesel Attack;;0 - 20,000;13;2;11;0;0;0
1171110;Kedemara - The Orphan's Ballad (Ch.1 & 2);;20,000 - 50,000;8;1;7;0;0;0
1171130;Scraper: Gauntlet;;0 - 20,000;26;1;25;0;0;0
1171140;Countersnipe;;100,000 - 200,000;233;122;111;3;3;0
1171160;NUVAVULT;;0 - 20,000;8;0;8;0;0;0
1171220;RPG Maker MV Tools - Database ConVerter MV;;0 - 20,000;11;0;11;0;0;0
1171240;Reiko's Fragments;;0 - 20,000;117;43;74;76;76;0
1171240;Reiko's Fragments;;0 - 20,000;117;43;74;76;76;0
1171260;Hollow Head: Director's Cut;;0 - 20,000;32;11;21;0;0;0
1171270;TroubleDays;;20,000 - 50,000;629;62;567;136;136;1
1171310;Valakas Story;;50,000 - 100,000;1155;245;910;95;164;15
1171320;Frog Detective 3: Corruption at Cowboy County;;20,000 - 50,000;978;4;974;102;102;4
1171330;Reviser;;0 - 20,000;4;3;1;0;0;0
1171350;Garden City;;0 - 20,000;5;2;3;0;0;0
1171370;The Supper;;200,000 - 500,000;3124;45;3079;0;0;3
1171410;Ninjapple;;0 - 20,000;2;1;1;0;0;0
1171520;Gravity Chase;;0 - 20,000;6;2;4;0;0;0
1171560;Adventureland XL;;0 - 20,000;5;0;5;0;0;0
1171570;Color Soul: Memories;;0 - 20,000;5;0;5;0;0;0
1171620;Remember, Lights Out;;0 - 20,000;1;1;0;0;0;0
1171660;The Ambassador: Fractured Timelines;;0 - 20,000;145;57;88;0;0;0
1171660;The Ambassador: Fractured Timelines;;0 - 20,000;145;57;88;0;0;0
1171770;Super Novel Collector (Speedrun Edition);;0 - 20,000;1;0;1;0;0;0
1171800;Vertigo;;0 - 20,000;2;0;2;0;0;0
1171820;Creme de la Creme;;0 - 20,000;85;7;78;0;0;0
1171840;Ironheart;;0 - 20,000;33;4;29;0;0;0
1171870;魂之大陆 Soultia;;0 - 20,000;8;0;8;0;0;0
1171880;ALPHA;;0 - 20,000;2;0;2;0;0;0
1171950;Dragon Little Fighters 2;;0 - 20,000;0;1;-1;0;0;0
1171990;Aah, Halloween pie!;;0 - 20,000;2;0;2;0;0;0
1172000;Captain Cook: Word Puzzle;;0 - 20,000;1;2;-1;0;0;0
1172050;COCKHEAD;;50,000 - 100,000;486;267;219;94;94;1
1172060;Rest In Pieces;;0 - 20,000;32;18;14;0;0;0
1172080;Anonymous Player;;0 - 20,000;1;1;0;0;0;0
1172090;In Passing;;20,000 - 50,000;106;28;78;0;0;0
1172120;OCEAN OF BATTLES;;0 - 20,000;6;1;5;0;0;0
1172140;Monster Battles - Portals;;0 - 20,000;32;13;19;0;0;0
1172150;Blue Boy: Bleeding Out;;0 - 20,000;13;0;13;0;0;0
1172170;Krystopia: A Puzzle Journey;;0 - 20,000;53;5;48;0;0;1
1172190;Chinatown Detective Agency;;0 - 20,000;78;28;50;0;0;1
1172220;Space Space;;0 - 20,000;1;0;1;0;0;0
1172290;ControlRoom;;0 - 20,000;9;1;8;0;0;0
1172310;Mona Lisa: Beyond The Glass;;0 - 20,000;71;2;69;11;11;0
1172310;Mona Lisa: Beyond The Glass;;0 - 20,000;71;2;69;11;11;0
1172340;Short Scary Stories - Zombie Defense;;0 - 20,000;0;1;-1;0;0;0
1172380;STAR WARS Jedi: Fallen Order;;2,000,000 - 5,000,000;104204;12044;92160;1187;883;2169
1172390;Anime Tanks Arena;;0 - 20,000;64;25;39;0;0;0
1172390;Anime Tanks Arena;;0 - 20,000;64;25;39;0;0;0
1172400;Battle Mage : Card Caster;;0 - 20,000;0;1;-1;0;0;0
1172410;Rage Among The Stars;;0 - 20,000;10;0;10;0;0;0
1172430;Combat Force;;0 - 20,000;60;51;9;0;0;0
1172470;Apex Legends;;50,000,000 - 100,000,000;498902;99870;399032;6474;859;542342
1172480;Louie;;0 - 20,000;3;0;3;0;0;0
1172500;Hang The Kings;;0 - 20,000;37;10;27;0;0;0
1172510;Unlock The King;;50,000 - 100,000;244;11;233;0;0;0
1172520;Colorgrid;;20,000 - 50,000;107;10;97;0;0;0
1172530;Daylife in Japan - Pixel Art Jigsaw Puzzle;;0 - 20,000;75;10;65;0;0;1
1172620;Sea of Thieves;;5,000,000 - 10,000,000;242337;26105;216232;2981;1165;19356
1172640;Parcel Panic;;0 - 20,000;1;0;1;0;0;0
1172650;INDUSTRIA;;200,000 - 500,000;1202;494;708;285;414;14
1172660;GraFi Halloween;;0 - 20,000;13;4;9;0;0;0
1172680;Heart in the Cell: Rebirth;;0 - 20,000;7;0;7;0;0;0
1172720;Doubles Hard;;0 - 20,000;4;0;4;0;0;0
1172730;The Handler of Dragons;;0 - 20,000;17;8;9;0;0;3
1172760;Twilight's Last Gleaming;;0 - 20,000;2;2;0;0;0;0
1172800;Perfect Tides;;0 - 20,000;145;3;142;0;0;2
1172820;You Only Livez Twice;;0 - 20,000;1;2;-1;0;0;0
1172830;Peasants War;;20,000 - 50,000;91;39;52;0;0;0
1172850;Collector;;0 - 20,000;1;0;1;0;0;0
1172900;FULFILLMENT;;50,000 - 100,000;232;22;210;0;0;0
1172950;Yandere Escape;;20,000 - 50,000;57;34;23;0;0;0
1172980;绮罗四时谭;;20,000 - 50,000;365;13;352;0;0;1
1173010;Flowers Blooming at the End of Summer;;20,000 - 50,000;1225;54;1171;285;285;9
1173070;Explosion Magic Firebolt VR;;0 - 20,000;1;4;-3;0;0;0
1173110;Please adopt me. # AI needs repair.;;0 - 20,000;25;15;10;0;0;0
1173120;Markov Alg;;0 - 20,000;17;1;16;0;0;0
1173150;Goosebumps Dead of Night;;0 - 20,000;30;12;18;0;0;0
1173200;Metal Unit;;100,000 - 200,000;1917;353;1564;515;670;11
1173230;Zapitalism;;0 - 20,000;12;4;8;0;0;0
1173240;Profitania;;0 - 20,000;3;1;2;0;0;0
1173250;DE:VOID;;20,000 - 50,000;26;2;24;0;0;0
1173260;Gangsta Sniper 3: Final Parody;;0 - 20,000;20;13;7;0;0;0
1173310;Lab 7: Cold Nights;;0 - 20,000;25;1;24;0;0;0
1173330;VELVETIST: Prototype;;20,000 - 50,000;125;23;102;0;0;0
1173340;War Trains;;0 - 20,000;2;21;-19;0;0;0
1173350;HENTAI CLIMBER;;0 - 20,000;102;50;52;0;0;0
1173370;Slapshot: Rebound;;500,000 - 1,000,000;5605;964;4641;297;96;428
1173380;NEKO ARENA;;20,000 - 50,000;546;106;440;75;75;0
1173500;Kira's Contract;;0 - 20,000;2;3;-1;0;0;0
1173510;XSOverlay;;100,000 - 200,000;738;79;659;39560;73400;854
1173590;Dominus Galaxia: KS Edition;;0 - 20,000;167;32;135;0;0;5
1173610;MouseWars Party;;0 - 20,000;8;0;8;0;0;0
1173640;Survivor Jones;;0 - 20,000;3;1;2;0;0;0
1173690;Resident Evil 3: Raccoon City Demo;;1,000,000 - 2,000,000;9050;1060;7990;0;0;10
1173700;Kontrol Flow;;0 - 20,000;1;1;0;0;0;0
1173730;Hexia;;0 - 20,000;22;8;14;0;0;0
1173770;FINAL FANTASY;;200,000 - 500,000;4263;253;4010;716;741;101
1173780;FINAL FANTASY II;;200,000 - 500,000;1215;348;867;724;732;72
1173790;FINAL FANTASY III;;100,000 - 200,000;1366;80;1286;1697;1748;58
1173800;FINAL FANTASY IV;;100,000 - 200,000;1381;164;1217;719;733;67
1173810;FINAL FANTASY V;;100,000 - 200,000;1024;160;864;412;348;135
1173820;FINAL FANTASY VI;;200,000 - 500,000;2072;231;1841;515;764;182
1173830;Coloring Game: Pixel;;0 - 20,000;161;5;156;0;0;2
1173850;Zombie Panic In Wonderland DX;;0 - 20,000;16;1;15;0;0;0
1173870;Endless Knight;;0 - 20,000;45;3;42;0;0;0
1173950;Debugger 3.16 // Recoded // Despair of the Developer Edition;;50,000 - 100,000;12;5;7;0;0;0
1174030;Hero Lodge;;0 - 20,000;17;0;17;0;0;1
1174050;Uterine Supremacy;;0 - 20,000;0;2;-2;0;0;0
1174090;Unicorn Tails;;0 - 20,000;71;3;68;0;0;1
1174120;Space Road;;0 - 20,000;3;0;3;0;0;0
1174170;Earthshine;;0 - 20,000;49;6;43;0;0;0
1174180;Red Dead Redemption 2;;5,000,000 - 10,000,000;335263;37664;297599;3744;1873;34681
1174200;Lands of Pharaoh: Episode 1;;0 - 20,000;2;0;2;0;0;0
1174260;The Lost Cave of the Ozarks;;0 - 20,000;3;2;1;0;0;0
1174270;IKO 39;;0 - 20,000;19;3;16;0;0;0
1174300;Shiki;;0 - 20,000;13;1;12;0;0;0
1174320;Travel Mosaics 10: Spooky Halloween;;0 - 20,000;12;0;12;0;0;0
1174390;ANNIE:Last Hope;;20,000 - 50,000;547;45;502;0;0;0
1174420;Libertad o Muerte!;;0 - 20,000;21;6;15;0;0;0
1174430;Space Shapes;;0 - 20,000;2;1;1;0;0;0
1174440;A Zone;;0 - 20,000;5;1;4;0;0;1
1174450;The Bad, The Worse & Djanky;;0 - 20,000;8;1;7;0;0;0
1174460;Poker Club;;0 - 20,000;175;137;38;0;0;10
1174490;Space Carrot;;0 - 20,000;3;0;3;0;0;0
1174500;Yuletide Legends: Who Framed Santa Claus;;0 - 20,000;123;19;104;0;0;2
1174540;Adventure or Normality?;;0 - 20,000;1;0;1;0;0;0
1174550;Bird Simulator;;0 - 20,000;30;19;11;0;0;0
1174640;Arcadia Fallen;;0 - 20,000;184;3;181;0;0;10
1174670;Nordic Warriors;;0 - 20,000;42;8;34;0;0;2
1174680;Ashland Dossier;;0 - 20,000;12;2;10;0;0;3
1174690;love wish 2;;20,000 - 50,000;1015;247;768;89;96;4
1174720;SwarmZ;;50,000 - 100,000;187;98;89;0;0;1
1174780;MONEY LOVES SILENCE;;0 - 20,000;16;12;4;0;0;0
1174810;Curse of the dungeon;;0 - 20,000;1;10;-9;0;0;0
1174820;Tower Of Heresy;;0 - 20,000;7;0;7;0;0;1
1174830;The Magician's Workshop;;0 - 20,000;7;3;4;0;0;0
1174830;The Magician's Workshop;;0 - 20,000;7;3;4;0;0;0
1174850;Way of Boy;;0 - 20,000;7;1;6;0;0;0
1174860;Tacview;;20,000 - 50,000;125;12;113;0;0;16
1174890;No Offence, But;;0 - 20,000;0;2;-2;0;0;0
1174940;Kill or Love;;100,000 - 200,000;1863;215;1648;0;0;2
1174970;Empty Sharp;;0 - 20,000;1;0;1;0;0;0
1174980;Mazetools Mutant;;0 - 20,000;4;0;4;0;0;0
1174990;Sushi Pachi Panic;;0 - 20,000;3;2;1;0;0;0
1175030;Plunkocity;;0 - 20,000;1;0;1;0;0;0
1175050;Queeny Army;;0 - 20,000;12;2;10;0;0;0
1175060;Human Simulator;;0 - 20,000;22;8;14;0;0;0
1175070;Survived;;0 - 20,000;1;0;1;0;0;0
1175080;Easy Bug Manager;;20,000 - 50,000;60;2;58;0;0;1
1175100;单词训练营 | Word Training Camp;;0 - 20,000;20;4;16;0;0;0
1175120;群星战纪: 遗失的星辰 - STARS ERA: LOST STARS;;0 - 20,000;65;9;56;0;0;0
1175140;Vecter;;200,000 - 500,000;2728;93;2635;0;0;8
1175150;Incredible Dracula: Vargosi Returns;;0 - 20,000;8;0;8;0;0;0
1175160;House of 1000 Doors: The Palm of Zoroaster;;0 - 20,000;49;3;46;0;0;2
1175170;Incredible Dracula: The Ice Kingdom;;0 - 20,000;17;0;17;0;0;0
1175180;妈妈，别走;;20,000 - 50,000;0;1;-1;0;0;0
1175190;Natsuki Chronicles;;0 - 20,000;70;6;64;0;0;1
1175200;Forbidden Ingress;;50,000 - 100,000;189;62;127;27;27;1
1175250;Finders Reapers;;50,000 - 100,000;14;0;14;0;0;0
1175320;黑暗之岛;;0 - 20,000;20;6;14;0;0;1
1175360;Doomsday Hunters;;20,000 - 50,000;461;54;407;0;0;3
1175360;Doomsday Hunters;;20,000 - 50,000;461;54;407;0;0;3
1175390;Ultimate Live Wallpaper;;20,000 - 50,000;68;101;-33;0;0;5
1175420;Imbroglio;;0 - 20,000;15;3;12;0;0;0
1175430;Project Starship X;;0 - 20,000;80;2;78;0;0;1
1175460;Revita;;100,000 - 200,000;1331;244;1087;182;182;29
1175470;Shine's Adventures 6 (Go! Girls);;0 - 20,000;27;2;25;0;0;0
1175480;Shadowrain;;0 - 20,000;22;6;16;0;0;0
1175490;Code Zero;;20,000 - 50,000;3;0;3;0;0;0
1175500;Jack In Town;;0 - 20,000;7;2;5;0;0;0
1175510;Cerberus: Orbital watch;;0 - 20,000;2;2;0;0;0;0
1175540;Cyberless: Online;;0 - 20,000;9;1;8;0;0;0
1175550;Merge Towers;;0 - 20,000;0;2;-2;0;0;0
1175570;Vector Light;;20,000 - 50,000;5;1;4;0;0;0
1175590;JAGD LANZER;;0 - 20,000;7;1;6;0;0;0
1175640;Zombie Road Rider;;0 - 20,000;21;17;4;0;0;0
1175650;UpMove;;0 - 20,000;3;0;3;0;0;0
1175690;MyStar;;0 - 20,000;3;1;2;0;0;0
1175720;Gerritory;;50,000 - 100,000;12;1;11;0;0;0
1175800;Command & Control 3;;0 - 20,000;26;15;11;39;39;3
1175830;Legend of Mana;;100,000 - 200,000;716;168;548;414;667;25
1175840;Whateverland;;50,000 - 100,000;91;5;86;0;0;2
1175880;War Room;;0 - 20,000;305;212;93;123;123;4
1175890;P.A.I.N.T.;;100,000 - 200,000;75;33;42;0;0;0
1175900;Antares;;0 - 20,000;21;7;14;0;0;0
1175930;Ray Eager;;0 - 20,000;27;18;9;0;0;0
1175970;Hibiscus Red;;0 - 20,000;17;28;-11;0;0;0
1175980;城市生存计划 / City Survival Project;;0 - 20,000;37;18;19;0;0;0
1176000;Toy Robot;;0 - 20,000;25;5;20;0;0;0
1176020;Rampage Miami;;0 - 20,000;153;21;132;0;0;0
1176040;"I Have Low Stats But My Class Is ""Leader"", So I Recruited Everyone I Know To Fight The Dark Lord";;0 - 20,000;6;2;4;0;0;0
1176050;秘封旅行 ~ Secret Sealing Travel;;0 - 20,000;228;0;228;0;0;22
1176090;Adventure Galaxy;;20,000 - 50,000;0;8;-8;0;0;0
1176110;AudioTheory Guitars;;0 - 20,000;45;6;39;10;10;2
1176140;MixPad;;0 - 20,000;1;0;1;0;0;1
1176160;Space Wars;;0 - 20,000;43;11;32;0;0;0
1176170;GIRLS BATTLEGROUNDS | 性感大逃杀;;0 - 20,000;39;25;14;0;0;0
1176190;Space Candy;;0 - 20,000;28;14;14;0;0;0
1176360;Contract Killers;;0 - 20,000;1;5;-4;0;0;0
1176440;Math The Question;;0 - 20,000;3;1;2;0;0;0
1176460;They Came From a Communist Planet;;50,000 - 100,000;126;14;112;0;0;1
1176470;Terra Invicta;;100,000 - 200,000;3251;653;2598;2029;3245;932
1176480;The City of Time;;0 - 20,000;22;2;20;0;0;0
1176560;The Orphan A Tale of An Errant Ghost - Hidden Object Game;;0 - 20,000;3;18;-15;0;0;0
1176580;Periodic Deliveries;;0 - 20,000;11;6;5;0;0;0
1176590;Seek Hearts;;0 - 20,000;5;1;4;0;0;0
1176640;Frostpoint VR: Proving Grounds;;0 - 20,000;24;24;0;0;0;0
1176710;Space Crew: Legendary Edition;;100,000 - 200,000;1207;337;870;761;985;28
1176780;Nuclear Arms Race;;0 - 20,000;10;8;2;0;0;0
1176800;Useless Box: The Game;;0 - 20,000;5;0;5;0;0;0
1176840;The Airship Designer;;0 - 20,000;0;1;-1;0;0;0
1176850;GOOSE.IO;;0 - 20,000;2;4;-2;0;0;0
1176970;Bolf;;0 - 20,000;4;2;2;0;0;0
1176990;VECTORLORD;;0 - 20,000;11;0;11;0;0;0
1177020;Gigantosaurus The Game;;0 - 20,000;24;6;18;0;0;1
1177030;PONG Quest;;0 - 20,000;35;9;26;0;0;0
1177070;Highway Game;;0 - 20,000;13;7;6;0;0;0
1177080;Geometry Hero;;0 - 20,000;20;1;19;0;0;0
1177100;末法时代;;0 - 20,000;37;32;5;0;0;0
1177110;The Sorrowvirus;;0 - 20,000;41;5;36;0;0;0
1177130;NABOKI;;0 - 20,000;265;18;247;117;117;0
1177170;Pooplers;;0 - 20,000;10;3;7;0;0;0
1177190;Il Sole e la Luna 2;;0 - 20,000;1;0;1;0;0;0
1177270;Imaginarium;;0 - 20,000;1;0;1;0;0;0
1177300;Space zone defender;;20,000 - 50,000;1;3;-2;0;0;0
1177310;Future Pool;;0 - 20,000;1;0;1;0;0;0
1177330;Billion Beat;;0 - 20,000;18;3;15;0;0;0
1177350;Molly: fear of clowns;;0 - 20,000;0;1;-1;0;0;0
1177370;ArachnoSplat;;0 - 20,000;2;0;2;0;0;0
1177390;Future Snooker;;0 - 20,000;3;1;2;0;0;0
1177430;Immanence;;0 - 20,000;61;39;22;0;0;0
1177460;Dangerous Blaster;;0 - 20,000;6;0;6;0;0;0
1177480;月牙楼风云;;0 - 20,000;2;0;2;0;0;0
1177490;Hovershift;;0 - 20,000;1;0;1;0;0;0
1177510;GASH;;0 - 20,000;1;0;1;0;0;0
1177610;Katana Kata;;0 - 20,000;47;19;28;0;0;0
1177640;ROCKETRON;;0 - 20,000;47;7;40;0;0;1
1177660;Escape the Ayuwoki;;0 - 20,000;557;134;423;117;117;9
1177690;The Summoning;;0 - 20,000;52;16;36;0;0;0
1177850;Deadly Night - No Escape;;0 - 20,000;6;1;5;0;0;0
1177890;Cave of Illusions;;0 - 20,000;25;7;18;0;0;0
1177950;Craft Elements;;0 - 20,000;0;1;-1;0;0;0
1177960;Get Me Outta Here - Deluxe/Remastered Edition;;0 - 20,000;5;0;5;0;0;0
1177990;Welcome to Primrose Lake;;0 - 20,000;14;4;10;0;0;0
1178000;Ghost Dimension;;0 - 20,000;29;0;29;0;0;0
1178020;Shot the Body;;0 - 20,000;0;2;-2;0;0;0
1178030;Star Fetchers;;200,000 - 500,000;6120;168;5952;0;0;5
1178050;狐の旅路;;100,000 - 200,000;1430;77;1353;0;0;0
1178060;Spooky Night 2;;0 - 20,000;0;1;-1;0;0;0
1178120;XP Girls;;0 - 20,000;140;37;103;0;0;0
1178120;XP Girls;;0 - 20,000;140;37;103;0;0;0
1178140;Pixel Ripped 1995;;20,000 - 50,000;146;3;143;0;0;0
1178150;MazM: Jekyll and Hyde;;0 - 20,000;87;7;80;0;0;2
1178160;Blackjack Championship;;100,000 - 200,000;481;236;245;0;0;40
1178180;BATYA;;0 - 20,000;17;6;11;0;0;0
1178200;Somewhere inside;;0 - 20,000;44;18;26;0;0;0
1178210;Stirring Abyss;;20,000 - 50,000;291;38;253;0;0;1
1178230;The Wild Case;;50,000 - 100,000;138;20;118;0;0;2
1178280;Ultimate Visualizer;;0 - 20,000;13;33;-20;0;0;0
1178290;Dezatopia;;0 - 20,000;35;0;35;0;0;0
1178310;Picross.io;;0 - 20,000;3;3;0;0;0;1
1178370;Big Bears Bad Advice;;0 - 20,000;2;1;1;0;0;0
1178380;Resurrector;;0 - 20,000;4;7;-3;0;0;0
1178400;Pro Cycling Manager 2020;;50,000 - 100,000;762;116;646;9539;9539;114
1178430;Summer Games Heroes;;20,000 - 50,000;28;18;10;0;0;0
1178460;Desktop Portal;;0 - 20,000;56;10;46;0;0;3
1178480;Space Station Invader VR;;0 - 20,000;3;1;2;0;0;0
1178490;港詭實錄ParanormalHK;;500,000 - 1,000,000;12287;1281;11006;202;194;162
1178500;Crazy Eights 3D Premium;;0 - 20,000;6;1;5;0;0;1
1178510;Gin Rummy 3D Premium;;0 - 20,000;5;5;0;0;0;0
1178570;Dissection Simulator: Feline Edition;;0 - 20,000;0;1;-1;0;0;0
1178680;RetroVamp;;0 - 20,000;14;0;14;0;0;0
1178700;CreateTech;;0 - 20,000;1;0;1;0;0;0
1178710;The Legend of Arcadieu;;0 - 20,000;8;9;-1;0;0;0
1178780;BattleGroupVR;;20,000 - 50,000;685;46;639;38;47;3
1178790;Shiren the Wanderer: The Tower of Fortune and the Dice of Fate;;100,000 - 200,000;493;133;360;1266;1266;268
1178830;Bright Memory: Infinite;;1,000,000 - 2,000,000;31078;2436;28642;267;122;211
1178880;Panzer Dragoon: Remake;;20,000 - 50,000;483;115;368;19;25;1
1179010;Rollers;;20,000 - 50,000;19;6;13;0;0;1
1179060;Wing of Darkness;;0 - 20,000;86;125;-39;0;0;1
1179080;FAITH: The Unholy Trinity;;50,000 - 100,000;2287;81;2206;464;889;149
1179110;Chrono's Arena;;0 - 20,000;23;13;10;0;0;0
1179150;Romguns;;0 - 20,000;1;3;-2;0;0;0
1179170;Super Angling;;0 - 20,000;2;1;1;0;0;0
1179190;Dinodrifters;;0 - 20,000;2;0;2;0;0;0
1179210;Kill It With Fire;;50,000 - 100,000;3005;195;2810;178;220;28
1179220;Gaijin Troubles;;0 - 20,000;36;19;17;0;0;0
1179300;Quicken WillMaker & Trust 2020;;0 - 20,000;3;0;3;0;0;0
1179310;Drift Alone;;0 - 20,000;2;0;2;0;0;0
1179340;Kōmori Fruit Rush;;0 - 20,000;3;0;3;0;0;0
1179350;怪奇幻想夢物語 怪獣綺譚 誘宵地獄;;0 - 20,000;2;0;2;0;0;0
1179390;Victorian Admirals Caroline Crisis 1885;;0 - 20,000;1;3;-2;0;0;0
1179400;Basic Car Repair Garage VR;;0 - 20,000;8;4;4;0;0;0
1179410;Lootcraft;;0 - 20,000;11;2;9;0;0;0
1179420;Brunswick Pro Billiards;;0 - 20,000;7;8;-1;0;0;0
1179430;Laser Z;;0 - 20,000;1;0;1;0;0;0
1179440;Disaster Dragon x Girls from Different Worlds;;0 - 20,000;4;1;3;0;0;0
1179460;HAM-MASTER;;0 - 20,000;15;0;15;0;0;0
1179500;Star Gods;;0 - 20,000;5;0;5;0;0;1
1179530;KAJA：追光者与秘境制造;;0 - 20,000;1;0;1;0;0;0
1179540;Sweet Thomas;;0 - 20,000;12;6;6;0;0;0
1179560;Gachi Heroes 2: Flexboll;;0 - 20,000;217;41;176;0;0;0
1179570;Jazz Lightning : Castle Dungeons;;0 - 20,000;7;0;7;0;0;0
1179620;Journey of the Broken Circle;;0 - 20,000;16;4;12;0;0;0
1179680;Wurm Online;;200,000 - 500,000;998;670;328;0;0;88
1179690;UFO穿越 （UFO Cross）;;0 - 20,000;0;1;-1;0;0;0
1179750;Metrail;;0 - 20,000;5;2;3;0;0;0
1179790;Heroes Of Maidan 3: Crimean Battle;;0 - 20,000;12;8;4;0;0;0
1179840;Origin;;0 - 20,000;2;1;1;0;0;0
1179880;Maverick;;0 - 20,000;2;1;1;0;0;0
1180000;I Will Be Your Eyes;;0 - 20,000;1;0;1;0;0;0
1180020;An Occurrence at Owl Creek Bridge;;0 - 20,000;36;4;32;0;0;0
1180030;Wardwell House;;50,000 - 100,000;585;125;460;0;0;0
1180070;Bangers & Mash;;0 - 20,000;1;0;1;0;0;0
1180110;DeadShotZ;;0 - 20,000;15;0;15;0;0;0
1180130;The Final Earth 2;;0 - 20,000;93;4;89;65;65;3
1180190;Call of VII;;0 - 20,000;15;1;14;0;0;0
1180210;Super Rhythm Duel;;0 - 20,000;5;2;3;0;0;0
1180250;DIVINATION;;100,000 - 200,000;95;14;81;0;0;0
1180270;Forbidden Love With The Ghost Girl;;0 - 20,000;168;21;147;0;0;0
1180360;Two Love;;0 - 20,000;6;1;5;0;0;0
1180370;Wienne;;0 - 20,000;45;4;41;0;0;0
1180380;Stay Out;;2,000,000 - 5,000,000;8508;6890;1618;308;33;1794
1180420;Windmill Kings;;0 - 20,000;16;8;8;0;0;0
1180450;Exitium;;0 - 20,000;4;1;3;0;0;0
1180520;Andromeda One;;0 - 20,000;11;13;-2;0;0;0
1180530;Gates to Terra II;;0 - 20,000;7;1;6;0;0;0
1180540;Puddle Knights;;0 - 20,000;137;1;136;0;0;1
1180560;Abelana's Atom Maker;;0 - 20,000;3;0;3;0;0;0
1180610;Npc Problems: Vertex Coloring;;0 - 20,000;34;2;32;0;0;0
1180620;Bullet Beat: Musical Shoot'em up;;0 - 20,000;16;5;11;0;0;0
1180620;Bullet Beat: Musical Shoot'em up;;0 - 20,000;16;5;11;0;0;0
1180660;Tell Me Why;;500,000 - 1,000,000;7675;1381;6294;283;286;59
1180690;Spaceman;;0 - 20,000;2;2;0;0;0;0
1180700;Shooting Star;;0 - 20,000;6;2;4;0;0;0
1180800;Don't Kill the Cow;;0 - 20,000;61;18;43;0;0;0
1180820;Escape!;;0 - 20,000;0;1;-1;0;0;0
1180840;SoulfulLand;;20,000 - 50,000;1;0;1;0;0;0
1180900;SGS Winter War;;0 - 20,000;44;6;38;0;0;1
1180940;Spellinkers;;0 - 20,000;10;2;8;0;0;0
1180960;Arktrum;;0 - 20,000;2;4;-2;0;0;0
1180970;Phantom Path;;20,000 - 50,000;15;2;13;0;0;0
1181000;UBERMOSH:OMEGA;;0 - 20,000;153;10;143;0;0;0
1181010;PUT IN BAD;;0 - 20,000;5;7;-2;0;0;0
1181020;Squillamorph;;0 - 20,000;9;7;2;0;0;0
1181070;BOX;;0 - 20,000;2;0;2;0;0;0
1181120;Picture toys;;0 - 20,000;17;13;4;0;0;0
1181160;Impossiball - Gamers Challenge;;0 - 20,000;10;0;10;0;0;0
1181220;aMAZE Gears 2;;0 - 20,000;15;6;9;0;0;0
1181270;God of Gym;;0 - 20,000;31;6;25;0;0;0
1181280;EBONY;;20,000 - 50,000;11;15;-4;0;0;0
1181300;Abda Redeemer: Space alien invasion;;0 - 20,000;16;0;16;0;0;0
1181330;D3D INSIDE;;0 - 20,000;52;14;38;0;0;0
1181330;D3D INSIDE;;0 - 20,000;52;14;38;0;0;0
1181390;ID-EGO;;0 - 20,000;13;2;11;0;0;0
1181400;Path of Giants;;20,000 - 50,000;757;22;735;126;126;2
1181440;ToGather:Island;;0 - 20,000;44;9;35;0;0;0
1181470;My Haunted Doll;;0 - 20,000;11;4;7;0;0;0
1181510;OS Omega: Retro Shooter;;0 - 20,000;3;0;3;0;0;0
1181520;Null & Peta -Invasion of the Queen Bug-;;0 - 20,000;64;18;46;0;0;0
1181570;Feria d'Arles;;0 - 20,000;50;2;48;0;0;0
1181600;Jetboard Joust;;0 - 20,000;50;7;43;18;18;0
1181640;Project Exhibited;;20,000 - 50,000;118;22;96;0;0;0
1181650;Have a Blast;;0 - 20,000;5;0;5;0;0;0
1181750;THE VR CANYON;;0 - 20,000;3;4;-1;0;0;0
1181780;Ascendants Rising;;0 - 20,000;9;22;-13;0;0;0
1181790;Circle of Sumo: Online Rumble!;;100,000 - 200,000;877;66;811;0;0;1
1181820;Colossal Saga;;0 - 20,000;0;1;-1;0;0;0
1181830;Urtuk: The Desolation;;50,000 - 100,000;1795;196;1599;51;51;62
1181840;HIVESWAP: ACT 2;;100,000 - 200,000;801;117;684;0;0;6
1181880;Draconic Echoes: The Ardent War;;0 - 20,000;1;0;1;0;0;0
1181900;Cave Confectioner;;0 - 20,000;11;4;7;0;0;0
1181910;Halloween Chronicles: Evil Behind a Mask Collector's Edition;;0 - 20,000;16;0;16;0;0;0
1181940;Cursed Pagoda;;0 - 20,000;1;0;1;0;0;0
1181970;Kamodo Steve: Janitor on Fire!;;0 - 20,000;1;0;1;0;0;0
1182020;WGT Golf;;200,000 - 500,000;1241;762;479;167;97;205
1182040;3 Blind Mice: A Remediation Game for Improper Children;;0 - 20,000;66;24;42;0;0;0
1182060;Heavens Tournament;;0 - 20,000;15;17;-2;0;0;0
1182070;Majula Frontier: The Offense;;0 - 20,000;9;11;-2;0;0;0
1182090;Mr. Pumpkin 2: Kowloon walled city;;0 - 20,000;255;22;233;0;0;3
1182090;Mr. Pumpkin 2: Kowloon walled city;;0 - 20,000;255;22;233;0;0;3
1182110;Weed Shop 3;;100,000 - 200,000;2753;169;2584;1127;1359;213
1182200;Hidden World of Art 2;;0 - 20,000;14;11;3;0;0;0
1182210;Space electrician;;0 - 20,000;0;2;-2;0;0;0
1182260;Kukui 2;;0 - 20,000;4;0;4;0;0;0
1182280;Foodtruck Arena;;0 - 20,000;6;0;6;0;0;0
1182310;The Excavation of Hob's Barrow;;50,000 - 100,000;882;58;824;3067;5804;10
1182370;Mr. Hopp's Playhouse;;100,000 - 200,000;1126;70;1056;0;0;4
1182470;reky;;0 - 20,000;37;5;32;0;0;0
1182530;Shadows on the Vatican: Nightingale;;0 - 20,000;25;3;22;0;0;0
1182590;Hueor;;0 - 20,000;3;0;3;0;0;0
1182620;Impostor Factory;;200,000 - 500,000;8341;322;8019;229;264;11
1182670;Haunted Hotel: Room 18 Collector's Edition;;0 - 20,000;13;4;9;0;0;0
1182690;A Dark World: The Glowing City;;0 - 20,000;0;1;-1;0;0;0
1182720;GO-4-Soldier-1;;0 - 20,000;2;0;2;0;0;0
1182760;Starlight;;20,000 - 50,000;153;95;58;19;19;1
1182770;Caves and Castles: Underworld;;0 - 20,000;14;0;14;0;0;0
1182790;Grudge TV;;0 - 20,000;8;1;7;0;0;0
1182820;Miracle Calamity Homeostasis;;0 - 20,000;21;8;13;0;0;0
1182830;QT;;0 - 20,000;205;8;197;294;294;0
1182900;A Plague Tale: Requiem;;200,000 - 500,000;7443;643;6800;815;1226;163
1182920;Movavi Video Editor Plus 2020 - Video Editing Software;;20,000 - 50,000;745;192;553;3183;4057;86
1182930;Movavi Video Suite 2020 Steam Edition - - Video Making Software - Edit, Convert, Capture Screen, and more;;0 - 20,000;482;131;351;5241;5241;69
1182940;Movavi Video Converter Premium 2020;;0 - 20,000;59;21;38;0;0;3
1183010;Listeria Wars;;0 - 20,000;10;0;10;0;0;1
1183030;Layers of Fear VR;;0 - 20,000;148;54;94;40;74;1
1183080;MMA President;;0 - 20,000;9;6;3;0;0;0
1183140;Planet Lander;;0 - 20,000;7;4;3;0;0;0
1183200;Portal Dogs;;0 - 20,000;14;3;11;0;0;0
1183210;Through The Unknown;;0 - 20,000;3;0;3;0;0;0
1183230;A Pirate's Pleasure;;0 - 20,000;6;2;4;0;0;0
1183240;Image Compressor;;0 - 20,000;17;7;10;0;0;0
1183260;TrymenT ―Ima o Kaetai to Negau Anata e― AlphA;;0 - 20,000;533;43;490;130;140;5
1183260;TrymenT ―Ima o Kaetai to Negau Anata e― AlphA;;0 - 20,000;533;43;490;130;140;5
1183280;Jazz Age;;0 - 20,000;5;4;1;0;0;0
1183300;Dawnfall;;0 - 20,000;5;3;2;0;0;0
1183410;you are pig sitter;;0 - 20,000;2;3;-1;0;0;0
1183420;Monochrome World;;0 - 20,000;13;0;13;0;0;0
1183470;Imperiums: Greek Wars;;20,000 - 50,000;335;61;274;0;0;10
1183480;Bonsai Castles;;0 - 20,000;19;0;19;0;0;0
1183500;Puppy Cross;;0 - 20,000;227;4;223;0;0;1
1183510;Little Town Hero;;0 - 20,000;10;5;5;0;0;0
1183580;Terra Alia: The Language Learning RPG;;0 - 20,000;51;19;32;0;0;0
1183600;King rocket;;0 - 20,000;5;0;5;0;0;0
1183650;PM-1 Inverse Universe;;0 - 20,000;0;1;-1;0;0;0
1183660;Snowman;;0 - 20,000;2;0;2;0;0;0
1183670;Angry Zombies;;0 - 20,000;26;5;21;0;0;0
1183700;Biolum;;0 - 20,000;62;17;45;0;0;0
1183720;Holoswitch;;0 - 20,000;122;30;92;0;0;9
1183750;Liquid Space;;0 - 20,000;3;3;0;0;0;0
1183840;Dungeon of Rikka;;200,000 - 500,000;22;3;19;0;0;0
1183980;Escape from the Lostmoon;;0 - 20,000;2;1;1;0;0;0
1184010;Monsters Mall;;0 - 20,000;26;3;23;0;0;0
1184040;D1896;;0 - 20,000;9;6;3;0;0;0
1184050;Gears Tactics;;100,000 - 200,000;4666;1496;3170;831;971;100
1184070;Overrun;;0 - 20,000;0;2;-2;0;0;0
1184140;KartRider: Drift;;500,000 - 1,000,000;2115;715;1400;64;52;586
1184160;RUSSIAPHOBIA;;100,000 - 200,000;3732;1650;2082;111;90;7
1184190;Knockout Bowling VR;;0 - 20,000;0;2;-2;0;0;0
1184210;Fragile;;0 - 20,000;240;129;111;0;0;0
1184230;Cross Border VR;;0 - 20,000;3;4;-1;0;0;0
1184250;Finnish Army Simulator;;20,000 - 50,000;240;26;214;0;0;27
1184260;Warchasm;;0 - 20,000;7;3;4;0;0;0
1184310;Slippery Sausage;;0 - 20,000;4;0;4;0;0;0
1184320;FIT Food;;50,000 - 100,000;84;28;56;0;0;0
1184360;Heavy load;;0 - 20,000;2;1;1;0;0;0
1184370;Pathfinder: Wrath of the Righteous - Enhanced Edition;;500,000 - 1,000,000;21075;3768;17307;3346;2085;5160
1184420;天降锦鲤 ~ My Lucky Koi;;20,000 - 50,000;288;19;269;0;0;1
1184450;Magic of Autumn;;0 - 20,000;30;2;28;0;0;0
1184470;ASTROPUPPA;;0 - 20,000;2;0;2;0;0;0
1184480;Inertial Drift;;20,000 - 50,000;605;61;544;0;0;9
1184480;Inertial Drift;;20,000 - 50,000;605;61;544;0;0;9
1184530;Aurora - Hidden Colors;;100,000 - 200,000;16;1;15;0;0;0
1184550;TERMINAL VR;;0 - 20,000;11;5;6;0;0;0
1184570;Last Neighbor;;0 - 20,000;100;33;67;0;0;0
1184600;The Sentinel (Old Version);;0 - 20,000;4;4;0;0;0;0
1184640;Hide and Secret: The Lost World;;0 - 20,000;2;0;2;0;0;1
1184700;Whispered Secrets: Dreadful Beauty Collector's Edition;;0 - 20,000;4;0;4;0;0;0
1184720;Later;;0 - 20,000;2;2;0;0;0;0
1184760;Shovel Knight Pocket Dungeon;;50,000 - 100,000;289;32;257;0;0;9
1184770;The Political Process;;20,000 - 50,000;1393;60;1333;882;1610;115
1184780;BOTS;;0 - 20,000;4;1;3;0;0;0
1184810;Mainframe Defenders;;50,000 - 100,000;484;48;436;181;181;3
1184810;Mainframe Defenders;;50,000 - 100,000;484;48;436;181;181;3
1184820;Poker Quest: Swords and Spades;;0 - 20,000;460;49;411;0;0;48
1184840;Chaos Galaxy;;50,000 - 100,000;210;41;169;0;0;4
1184850;Craft The Mapcrafter:Gathering Magic Words;;0 - 20,000;1;0;1;0;0;0
1184890;Fleeting Iris;;20,000 - 50,000;319;141;178;0;0;4
1184900;Unitied;;0 - 20,000;44;0;44;0;0;1
1184960;Aggressors;;0 - 20,000;15;2;13;0;0;0
1185000;Bloody trains;;0 - 20,000;11;7;4;0;0;0
1185190;Climb Challenge;;0 - 20,000;1;1;0;0;0;0
1185270;经典扫雷;;0 - 20,000;2;9;-7;0;0;1
1185280;The Innkeeper;;0 - 20,000;9;1;8;0;0;0
1185290;Cahertis;;0 - 20,000;4;0;4;0;0;0
1185330;Blades of Gory;;0 - 20,000;15;11;4;0;0;0
1185340;Grace;;0 - 20,000;11;0;11;0;0;0
1185360;Alan Sharp;;20,000 - 50,000;50;15;35;0;0;0
1185370;Parked In The Dark;;50,000 - 100,000;15;16;-1;0;0;0
1185390;How to Become a Ninja: Part 1;;0 - 20,000;6;1;5;0;0;0
1185410;Minigame Blast;;0 - 20,000;1;1;0;0;0;0
1185470;Deathbloom: Chapter 2;;0 - 20,000;30;5;25;0;0;0
1185480;Doom of the Clawn;;0 - 20,000;8;8;0;0;0;0
1185490;Dark Quest 3;;0 - 20,000;90;26;64;0;0;2
1185500;Mega Balls;;0 - 20,000;1;0;1;0;0;0
1185520;Love Rhythm;;0 - 20,000;172;55;117;138;138;1
1185530;My Wet Leto Comic;;50,000 - 100,000;4;0;4;0;0;0
1185560;Astellia;;20,000 - 50,000;1091;564;527;498;498;0
1185570;Stickman go;;0 - 20,000;1;4;-3;0;0;0
1185580;Takkyu Tournament Re:Serve;;0 - 20,000;1;0;1;0;0;0
1185600;The Kingdom of God;;0 - 20,000;140;60;80;0;0;5
1185620;NecroLand : Undead Corps;;0 - 20,000;3;5;-2;0;0;0
1185630;CubeParkour;;0 - 20,000;4;0;4;0;0;0
1185680;White Wings ホワイトウィングス;;20,000 - 50,000;59;73;-14;0;0;0
1185700;Arrog;;0 - 20,000;134;16;118;0;0;0
1185740;Mira;;0 - 20,000;38;10;28;0;0;0
1185820;Hollow Island;;0 - 20,000;70;12;58;0;0;0
1185870;Skyland 1976;;0 - 20,000;32;12;20;0;0;0
1185950;Wars of the Roses;;0 - 20,000;11;2;9;0;0;0
1185960;Napoleon in Russia;;0 - 20,000;7;2;5;0;0;2
1186030;Death Park;;0 - 20,000;98;15;83;0;0;0
1186040;Worms Rumble;;100,000 - 200,000;1255;709;546;31;32;0
1186050;Hero's Spirit;;0 - 20,000;41;5;36;0;0;0
1186080;The Adventures of Willow and Ash;;0 - 20,000;1;0;1;0;0;0
1186100;Beast Brigade;;0 - 20,000;6;1;5;0;0;0
1186160;All Day Dying: Redux Edition;;0 - 20,000;43;9;34;0;0;0
1186220;Wire Lips;;0 - 20,000;125;9;116;0;0;0
1186260;Bondage Girl;;0 - 20,000;68;63;5;0;0;1
1186270;Nosferatu Lilinor;;0 - 20,000;26;4;22;0;0;1
1186280;Dodge If you Can!;;0 - 20,000;4;0;4;0;0;0
1186290;Ballance: The Return;;0 - 20,000;20;25;-5;0;0;0
1186320;Catch The Ball 3;;0 - 20,000;2;1;1;0;0;0
1186340;Action Ball 2;;0 - 20,000;28;3;25;0;0;0
1186350;Lethal Tempting Girls;;0 - 20,000;1;3;-2;0;0;0
1186390;BRITANNIA VR: OUT OF YOUR MIND;;0 - 20,000;2;1;1;0;0;0
1186400;West Sweety;;100,000 - 200,000;2642;446;2196;45;43;3
1186460;Songs Of Wuxia;;100,000 - 200,000;473;111;362;3;3;0
1186510;Land of Ngoto;;0 - 20,000;4;2;2;0;0;0
1186530;Business Wars - The Card Game;;0 - 20,000;9;2;7;0;0;0
1186580;New York Mysteries: The Outbreak;;0 - 20,000;48;8;40;0;0;1
1186590;Unnamed Adventure/无名之旅;;0 - 20,000;1;2;-1;0;0;0
1186630;1971 PROJECT HELIOS;;0 - 20,000;23;25;-2;0;0;0
1186640;Pumpkin Jack;;200,000 - 500,000;4322;351;3971;140;179;53
1186650;MADELA;;0 - 20,000;1;8;-7;0;0;0
1186670;Fateless;;100,000 - 200,000;20;6;14;0;0;0
1186680;Maximum Momentum;;0 - 20,000;1;0;1;0;0;0
1186690;Timpu's treasure;;0 - 20,000;7;1;6;0;0;0
1186720;The Cruxis Sword;;0 - 20,000;2;1;1;0;0;1
1186730;Terro Lunkka Adventures;;0 - 20,000;15;4;11;0;0;0
1186740;Kyle is Famous: Complete Edition;;100,000 - 200,000;1160;100;1060;14;18;3
1186760;Robot Boy;;0 - 20,000;0;1;-1;0;0;0
1186770;Disgrâce;;0 - 20,000;0;2;-2;0;0;0
1186860;反现实症候群γ - Counterrealstic Syndrome γ;;0 - 20,000;130;12;118;0;0;0
1186880;OctoFurry;;0 - 20,000;119;15;104;0;0;1
1186940;Underneath;;0 - 20,000;9;3;6;0;0;0
1186960;Cowboys vs Hipsters;;0 - 20,000;4;2;2;0;0;0
1187110;INVESTMENT HERO;;0 - 20,000;2;1;1;0;0;0
1187130;Crimson Colosseum;;0 - 20,000;92;26;66;0;0;0
1187140;Elementary Anatomy: With Story Mode;;0 - 20,000;5;1;4;0;0;0
1187250;Consumed Awakening;;0 - 20,000;3;0;3;0;0;0
1187410;Master Of Dodging;;0 - 20,000;11;0;11;0;0;0
1187420;Hasfax;;0 - 20,000;18;19;-1;0;0;1
1187430;SpaceVibes VR;;0 - 20,000;0;1;-1;0;0;0
1187490;Phoenix Tales;;0 - 20,000;4;1;3;0;0;0
1187510;Rock Simulator;;20,000 - 50,000;905;51;854;6;6;38
1187520;Realms of Darkness;;;;;0;;;
1187560;The Game We All Have To Play;;0 - 20,000;1;2;-1;0;0;0
1187600;Wicked Willow;;0 - 20,000;59;5;54;0;0;1
1187650;Blaze Revolutions;;0 - 20,000;18;1;17;0;0;0
1187670;Holo Views;;20,000 - 50,000;1;0;1;0;0;0
1187740;InfiniteBeat;;0 - 20,000;2;4;-2;0;0;0
1187780;Displace;;0 - 20,000;2;0;2;0;0;0
1187790;FULLCHOKE : Clay Shooting VR;;0 - 20,000;17;4;13;0;0;0
1187830;Incredible Dracula: Witches' Curse;;0 - 20,000;21;0;21;0;0;1
1187840;Vesper: Zero Light Edition;;0 - 20,000;68;10;58;0;0;1
1187870;FORZA POLPO!;;0 - 20,000;14;1;13;0;0;1
1187900;NARWHAR Project Hornwhale;;0 - 20,000;1;1;0;0;0;0
1187910;Third Rule of Universe.;;0 - 20,000;2;1;1;0;0;0
1187940;Is It Wrong to Try to Pick Up Girls in a Dungeon? Infinite Combate;;20,000 - 50,000;134;148;-14;0;0;8
1187950;Gaijin Charenji 1 : Kiss or Kill;;0 - 20,000;10;2;8;0;0;0
1188000;Pulstario;;0 - 20,000;30;1;29;0;0;0
1188070;BreadHead Adventure;;0 - 20,000;1;3;-2;0;0;0
1188080;Cats are Liquid - A Better Place;;0 - 20,000;172;11;161;0;0;3
1188100;Dragon Stone - Legendary Archer;;0 - 20,000;4;0;4;0;0;0
1188130;Among Walls;;0 - 20,000;7;12;-5;0;0;1
1188140;Country Road VR;;0 - 20,000;5;5;0;0;0;0
1188160;Ground Zero Texas - Nuclear Edition;;0 - 20,000;5;6;-1;0;0;3
1188250;GLOWCOMA: chapter 1;;0 - 20,000;171;30;141;0;0;0
1188260;Creature Card Idle;;0 - 20,000;58;25;33;0;0;1
1188270;The Curse of Feldar Vale;;0 - 20,000;36;6;30;0;0;1
1188270;The Curse of Feldar Vale;;0 - 20,000;36;6;30;0;0;1
1188280;Coffee Rush;;0 - 20,000;3;0;3;0;0;2
1188290;Cover Your Eyes;;0 - 20,000;7;1;6;0;0;0
1188310;Mini Island;;0 - 20,000;26;1;25;0;0;0
1188330;Classic Sudoku;;100,000 - 200,000;333;29;304;844;844;19
1188430;Deep, In the  Forest;;0 - 20,000;40;18;22;0;0;0
1188540;Apex Aim Trainer;;0 - 20,000;512;141;371;311;349;27
1188580;Classic Snake Adventures;;0 - 20,000;9;1;8;0;0;0
1188590;云游志 The Clouds Travel Notes;;0 - 20,000;7;1;6;0;0;0
1188630;Twitchoos RUN: Socks & Stream;;0 - 20,000;10;3;7;0;0;0
1188670;Castle Commander;;0 - 20,000;1;2;-1;0;0;0
1188680;The Political Machine 2020;;50,000 - 100,000;602;127;475;1037;1066;7
1188690;Speed Masters ASD;;0 - 20,000;3;1;2;0;0;0
1188710;Bloodholic;;0 - 20,000;28;0;28;0;0;0
1188720;Drunken Wrestlers;;50,000 - 100,000;499;40;459;0;0;1
1188760;JEF;;0 - 20,000;68;6;62;0;0;0
1188800;In the Service of Mrs. Claus;;0 - 20,000;5;2;3;0;0;0
1188900;Fire Tonight;;0 - 20,000;55;10;45;0;0;0
1188920;YUR;;50,000 - 100,000;391;49;342;0;0;21
1188930;Chrono Ark;;200,000 - 500,000;4432;510;3922;2539;3062;246
1188970;Ether Loop;;50,000 - 100,000;221;90;131;1273;1273;1
1188990;WREST;;0 - 20,000;14;9;5;0;0;0
1189020;LOGA: Unexpected Adventure;;0 - 20,000;0;4;-4;0;0;0
1189040;Smart Girl : Christmas;;0 - 20,000;3;3;0;0;0;0
1189050;Hot And Lovely;;0 - 20,000;39;24;15;42;42;0
1189060;The Floor Is Still Really Cheap Lava;;20,000 - 50,000;178;10;168;0;0;0
1189090;Microscope Madness;;0 - 20,000;1;0;1;0;0;0
1189100;Rise Of The White Sun;;0 - 20,000;37;5;32;0;0;2
1189120;Posibility;;0 - 20,000;0;1;-1;0;0;0
1189190;Battle Map Studio;;0 - 20,000;8;0;8;0;0;0
1189200;Moonlight Basket;;0 - 20,000;42;2;40;0;0;0
1189210;Yuna and other troubles;;0 - 20,000;2;1;1;0;0;0
1189230;Door in the Woods;;20,000 - 50,000;181;48;133;0;0;0
1189350;Town Defence;;0 - 20,000;9;4;5;0;0;0
1189380;Beat Or Die The MiniGames;;0 - 20,000;1;1;0;0;0;0
1189430;Interlude (Demo);;0 - 20,000;5;2;3;0;0;0
1189440;VenusBlood FRONTIER International;;100,000 - 200,000;702;46;656;1450;1450;4
1189460;ClickCells: Office Lady;;0 - 20,000;22;5;17;0;0;0
1189470;Fox-Trot Over Run;;0 - 20,000;2;0;2;0;0;0
1189490;觅长生;;500,000 - 1,000,000;16379;1259;15120;1351;995;11181
1189520;Street Hoop;;0 - 20,000;28;5;23;0;0;0
1189590;DEUS EX MACHINA: Stage Zero;;0 - 20,000;3;4;-1;0;0;0
1189600;漫步者 The Walker;;0 - 20,000;3;2;1;0;0;0
1189630;Path Of Wuxia;;500,000 - 1,000,000;23071;6085;16986;1975;1971;404
1189650;Post Scriptum CTG: Collectible Token Game;;0 - 20,000;6;1;5;0;0;1
1189680;Degraman: Act I. Vincent & Cassel;;0 - 20,000;120;14;106;0;0;2
1189730;Tales of Tomorrow: Experiment;;0 - 20,000;15;5;10;0;0;2
1189740;Juken Jigoku | 受験地獄;;;;;0;;;
1189750;WinTweaker;;0 - 20,000;14;8;6;0;0;0
1189780;Wallachia: Reign of Dracula;;0 - 20,000;92;28;64;0;0;0
1189800;Bleeding Edge;;100,000 - 200,000;1062;528;534;0;0;1
1189820;Lightale;;0 - 20,000;3;0;3;0;0;0
1189850;鶴鄉戀旅;;0 - 20,000;165;2;163;0;0;0
1189970;Runoveryou;;0 - 20,000;0;2;-2;0;0;0
1190000;Car Mechanic Simulator 2021;;500,000 - 1,000,000;17245;755;16490;1604;1009;2166
1190060;The Last Deathbound;;0 - 20,000;8;0;8;0;0;0
1190110;H-SNIPER: Middle East;;20,000 - 50,000;414;46;368;140;273;1
1190120;Good doktor;;0 - 20,000;2;6;-4;0;0;1
1190130;Araha : Curse of Yieun Island;;100,000 - 200,000;171;103;68;0;0;3
1190150;Paint Warfare;;50,000 - 100,000;551;95;456;0;0;26
1190160;LIT: Bend the Light;;0 - 20,000;230;13;217;24;24;2
1190160;LIT: Bend the Light;;0 - 20,000;230;13;217;24;24;2
1190170;OlliOlli World;;20,000 - 50,000;980;80;900;236;266;40
1190180;Arrow;;0 - 20,000;4;3;1;0;0;0
1190310;Dancing Arrow : Beat Smash;;0 - 20,000;6;1;5;0;0;0
1190320;FOOD FACTORY VR;;0 - 20,000;1;0;1;0;0;0
1190370;Tank Hurricane;;0 - 20,000;0;3;-3;0;0;0
1190400;The Wonderful 101: Remastered;;50,000 - 100,000;654;93;561;49;81;8
1190410;Crazy city;;0 - 20,000;9;11;-2;0;0;0
1190480;Heebie Jeebies: The Roller Coaster;;0 - 20,000;5;4;1;0;0;0
1190530;Glyph VR;;20,000 - 50,000;42;10;32;0;0;0
1190540;SOONA;;0 - 20,000;2;0;2;0;0;0
1190560;Scriptum VR: The Neighbor's House Escape Room;;0 - 20,000;2;1;1;0;0;0
1190590;Ice Cream Fantasy;;0 - 20,000;6;2;4;0;0;0
1190640;Memory Match Saga;;0 - 20,000;1;1;0;0;0;0
1190690;IOX;;0 - 20,000;3;4;-1;0;0;0
1190750;GameAssistant: The Tool For Every Gamer;;0 - 20,000;8;6;2;0;0;0
1190760;Tales of the Deck;;0 - 20,000;13;5;8;0;0;0
1190780;DooM in the Dark 2;;20,000 - 50,000;4;9;-5;0;0;0
1190810;Ghetto Conspiracy;;0 - 20,000;19;1;18;0;0;0
1190820;Booobjz;;0 - 20,000;17;5;12;0;0;0
1190840;Boomer Remover;;0 - 20,000;14;4;10;0;0;0
1190900;Legend of the 9 Swords: Side Story;;0 - 20,000;7;0;7;0;0;0
1190910;Defend Them !;;0 - 20,000;10;1;9;0;0;0
1190930;ScribbleDude;;0 - 20,000;18;0;18;0;0;0
1190980;Hoarding Simulator;;0 - 20,000;2;5;-3;0;0;0
1190990;Colormeleons;;0 - 20,000;60;6;54;0;0;11
1190990;Colormeleons;;0 - 20,000;60;6;54;0;0;11
1191070;[Chilla's Art] Yuki Onna | 雪女;;0 - 20,000;109;32;77;0;0;0
1191070;[Chilla's Art] Yuki Onna | 雪女;;0 - 20,000;109;32;77;0;0;0
1191080;SANCTION;;0 - 20,000;1;2;-1;0;0;0
1191120;Growing Up;;100,000 - 200,000;1873;244;1629;1872;1872;54
1191190;War Robots: Planet Defender;;0 - 20,000;6;2;4;0;0;0
1191210;Seek Girl Ⅲ;;200,000 - 500,000;2291;441;1850;30;22;0
1191260;Touken Ranbu Warriors;;0 - 20,000;110;13;97;0;0;1
1191270;Arzt Simulator;;0 - 20,000;3;5;-2;0;0;0
1191280;12 Labours of Hercules X: Greed for Speed;;0 - 20,000;16;6;10;0;0;3
1191330;Inferna;;200,000 - 500,000;1225;738;487;0;0;41
1191440;Forgotten Ways;;0 - 20,000;94;7;87;0;0;0
1191450;Plasmoid;;0 - 20,000;6;2;4;0;0;0
1191510;PixHunter;;0 - 20,000;4;2;2;0;0;0
1191540;Streamer Shall Not Pass!;;0 - 20,000;3;7;-4;0;0;0
1191550;Fifo's Night;;0 - 20,000;131;10;121;0;0;0
1191570;Hero Soul: I want to be a Hero!;;0 - 20,000;1;0;1;0;0;0
1191580;Nexomon;;50,000 - 100,000;1113;136;977;40;40;34
1191590;End of War 1945;;0 - 20,000;17;5;12;0;0;0
1191610;Memory;;0 - 20,000;1;0;1;0;0;0
1191620;Spidersaurs;;0 - 20,000;28;5;23;0;0;0
1191630;Shantae and the Seven Sirens;;20,000 - 50,000;1160;133;1027;319;555;5
1191650;Time Travel Trainer;;0 - 20,000;1;0;1;0;0;0
1191680;境界 Dice&Fighter;;0 - 20,000;69;26;43;0;0;1
1191690;Skull Head World;;0 - 20,000;6;0;6;0;0;0
1191700;El Culto: edición completa;;0 - 20,000;0;1;-1;0;0;0
1191700;El Culto: edición completa;;0 - 20,000;0;1;-1;0;0;0
1191730;Hogvalord;;0 - 20,000;9;7;2;0;0;0
1191770;混世萌王喵霸霸 Cute Chaos Demon Nyanbaba;;0 - 20,000;47;0;47;0;0;1
1191820;Spot The Differences 2020 | 大家来找茬 2020;;0 - 20,000;7;12;-5;0;0;1
1191840;Legend Creatures(传奇生物);;100,000 - 200,000;3292;338;2954;1389;1951;58
1191860;Memody: Sindrel Song;;0 - 20,000;17;0;17;0;0;0
1191870;Goblin Times;;0 - 20,000;24;8;16;0;0;0
1191900;Say No! More;;50,000 - 100,000;1087;140;947;110;113;5
1191930;MCAS Simulation;;0 - 20,000;3;2;1;0;0;0
1191940;Deathtrap Dungeon: The Interactive Video Adventure;;0 - 20,000;154;13;141;0;0;0
1192010;Open Country;;20,000 - 50,000;144;237;-93;0;0;1
1192020;Cyber Fight Challenge;;0 - 20,000;18;20;-2;0;0;0
1192050;Iveri: The 1.000 Story;;0 - 20,000;2;3;-1;0;0;0
1192060;Virus L;;0 - 20,000;0;3;-3;0;0;0
1192070;TriangleStorm;;0 - 20,000;10;12;-2;0;0;0
1192160;Section Six;;0 - 20,000;9;1;8;0;0;0
1192260;Labyrinths of the World: The Wild Side Collector's Edition;;0 - 20,000;8;2;6;0;0;0
1192270;Royal Detective: The Last Charm Collector's Edition;;0 - 20,000;1;0;1;0;0;0
1192380;TOTALLY BASEBALL;;0 - 20,000;123;8;115;0;0;2
1192420;Shuttle Commander;;0 - 20,000;14;17;-3;0;0;0
1192440;The Monster Breeder;;0 - 20,000;89;0;89;83;83;8
1192500;GraFi Christmas;;0 - 20,000;11;6;5;0;0;0
1192550;Master of Wills;;0 - 20,000;29;7;22;0;0;0
1192580;Nyanco Dream;;0 - 20,000;41;14;27;0;0;0
1192610;ANIME REDEMPTION;;0 - 20,000;110;41;69;9;9;2
1192630;23UL;;0 - 20,000;1;0;1;0;0;0
1192640;Hentai Mosaique Neko Waifus;;100,000 - 200,000;1703;165;1538;114;142;9
1192700;Void Eclipse;;0 - 20,000;6;7;-1;0;0;0
1192730;ADULT SHERIFF;;0 - 20,000;43;14;29;0;0;0
1192840;The Shenanigans of Cherry and Trix;;0 - 20,000;1;1;0;0;0;0
1192860;Winter Snow | 冬雪;;0 - 20,000;15;7;8;0;0;0
1192880;Nostalgiarian;;0 - 20,000;7;7;0;0;0;0
1192890;Shoot Them;;20,000 - 50,000;110;23;87;0;0;0
1192900;IRON REBELLION;;50,000 - 100,000;189;44;145;0;0;3
1192910;食用系少女：美食內戰 Food Girls：Civil War;;0 - 20,000;87;3;84;0;0;0
1192940;Monkey GO Happy;;20,000 - 50,000;111;4;107;0;0;1
1192950;Qi Qiang;;0 - 20,000;1;1;0;0;0;0
1193040;Eternal Battlefield;;100,000 - 200,000;408;166;242;0;0;0
1193070;Zom Nom;;20,000 - 50,000;122;9;113;0;0;0
1193090;Bus World;;20,000 - 50,000;214;59;155;86;86;6
1193100;Withstand: Survival;;0 - 20,000;225;98;127;0;0;0
1193120;The Battles of Spwak 3;;20,000 - 50,000;8;3;5;0;0;0
1193160;Bomber Fox;;0 - 20,000;3;2;1;0;0;0
1193200;K37-D;;50,000 - 100,000;3;0;3;0;0;0
1193210;Hunt the Muglump;;0 - 20,000;11;2;9;0;0;0
1193280;Reverse Fantasy Legend 2;;0 - 20,000;1;0;1;0;0;0
1193300;Axe Cop;;0 - 20,000;12;1;11;0;0;0
1193330;Together - A Wish No One Remembers;;0 - 20,000;6;0;6;0;0;0
1193340;Zelter;;100,000 - 200,000;968;778;190;1346;1160;13
1193380;The Visitors;;0 - 20,000;0;1;-1;0;0;0
1193420;The Dis-United States Of America;;0 - 20,000;1;0;1;0;0;0
1193430;Vapormaze;;0 - 20,000;24;3;21;0;0;1
1193460;Bunny Sudoku;;0 - 20,000;9;2;7;0;0;0
1193490;A Crooked Heart;;0 - 20,000;9;1;8;0;0;0
1193510;Antarctic Heritage Trust;;20,000 - 50,000;24;4;20;0;0;0
1193520;Space Climber;;0 - 20,000;12;1;11;0;0;0
1193550;Ruthless Conquest;;0 - 20,000;57;13;44;0;0;0
1193560;Roast Party;;0 - 20,000;18;5;13;0;0;0
1193570;Drawkanoid: Review Breaker;;0 - 20,000;17;8;9;0;0;0
1193590;Abomi Nation;;0 - 20,000;87;11;76;0;0;3
1193600;Meandering Fiend;;0 - 20,000;1;1;0;0;0;0
1193630;Edge of Book;;20,000 - 50,000;59;57;2;0;0;0
1193660;Jack-O-Lantern Covers of Darkness;;0 - 20,000;4;0;4;0;0;0
1193680;Alien Invasion 3D part 2;;0 - 20,000;0;1;-1;0;0;0
1193730;Piece Of Mind;;0 - 20,000;0;4;-4;0;0;0
1193760;WarriOrb: Prologue;;20,000 - 50,000;336;42;294;0;0;0
1193780;Tower Climb;;0 - 20,000;5;1;4;0;0;0
1193790;UNHERD;;0 - 20,000;5;2;3;0;0;0
1193830;Jeremiah;;0 - 20,000;3;0;3;0;0;0
1193900;Island Marauder;;0 - 20,000;150;33;117;0;0;0
1193930;Ping Pong Space - Retro Tennis;;0 - 20,000;3;0;3;0;0;0
1193950;Dashbot Ninja;;0 - 20,000;1;0;1;0;0;0
1193990;Trapped;;0 - 20,000;72;10;62;0;0;1
1194050;Orange Cast: Sci-Fi Space Action Game;;20,000 - 50,000;71;59;12;0;0;0
1194100;Musical Aim Trainer;;0 - 20,000;2;2;0;0;0;0
1194110;Substance Painter 2020;;100,000 - 200,000;466;60;406;0;0;78
1194120;Substance Designer 2020;;0 - 20,000;76;4;72;0;0;16
1194140;Blind Justice;;0 - 20,000;31;25;6;61;61;0
1194160;One-Eyed Lee and the Dinner Party;;0 - 20,000;19;1;18;0;0;0
1194170;Foe Frenzy;;0 - 20,000;5;0;5;0;0;0
1194220;Zombie Tag Royale;;0 - 20,000;2;1;1;0;0;0
1194330;Drone Combat;;0 - 20,000;11;2;9;0;0;0
1194380;Volleyball Fever Flat;;0 - 20,000;3;0;3;0;0;0
1194390;The Land of Crows;;0 - 20,000;22;5;17;0;0;0
1194480;Cursed Gem;;0 - 20,000;44;2;42;0;0;0
1194490;Dethcube;;0 - 20,000;7;3;4;1;1;0
1194520;Terra Incognita;;0 - 20,000;1;4;-3;0;0;0
1194560;单身狗的最后机会;;0 - 20,000;43;7;36;0;0;0
1194590;Star Dynasties;;20,000 - 50,000;285;94;191;82;82;7
1194600;Bronze Hoof;;0 - 20,000;7;0;7;0;0;0
1194610;Knights of the Temple: Infernal Crusade;;0 - 20,000;68;6;62;0;0;0
1194620;33 Rounds;;0 - 20,000;12;5;7;0;0;0
1194630;The Dark Pictures Anthology: Little Hope;;200,000 - 500,000;4753;1903;2850;329;317;75
1194650;ReFrame;;0 - 20,000;1;1;0;0;0;0
1194670;Fairyfail;;0 - 20,000;15;1;14;0;0;0
1194690;Creatry — Easy Game Maker & Game Builder App;;0 - 20,000;1;11;-10;0;0;0
1194700;House Flipper VR;;0 - 20,000;136;124;12;30;38;1
1194720;No School No Rules;;20,000 - 50,000;24;11;13;0;0;0
1194740;MetaWare High School (Demo);;20,000 - 50,000;555;17;538;0;0;0
1194750;Neko Ghost, Jump!;;0 - 20,000;32;4;28;0;0;0
1194770;Sanctum Breach;;0 - 20,000;30;11;19;0;0;0
1194790;Kessler Effect;;0 - 20,000;8;7;1;0;0;0
1194830;Master Bladesmith;;20,000 - 50,000;296;58;238;0;0;3
1194840;Frog Fractions: Game of the Decade Edition;;100,000 - 200,000;2050;111;1939;55;71;1
1194870;Winter Worm, Summer Grass;;0 - 20,000;47;4;43;0;0;0
1194890;Star of Lemutia : Reborn;;0 - 20,000;1;1;0;0;0;0
1194910;Celestial;;0 - 20,000;7;0;7;0;0;0
1194930;Blackthorn Arena;;100,000 - 200,000;2526;1127;1399;43;43;34
1194940;Tower of Shades;;0 - 20,000;35;7;28;0;0;0
1195020;Guardians of the Ashes;;50,000 - 100,000;332;105;227;15;15;1
1195070;Ninja JaJaMaru: The Great Yokai Battle + Hell;;0 - 20,000;33;3;30;0;0;3
1195090;Hippoboar Rancher ~かばいの牧場物語~;;0 - 20,000;2;0;2;0;0;0
1195140;URG;;0 - 20,000;5;1;4;0;0;0
1195170;Rebound Ball;;0 - 20,000;3;4;-1;0;0;0
1195220;Gunman And The Witch;;50,000 - 100,000;130;44;86;0;0;1
1195230;Darkness and Flame: Enemy in Reflection Collector's Edition;;0 - 20,000;57;3;54;0;0;2
1195250;Gateball VR;;0 - 20,000;0;1;-1;0;0;0
1195270;iFAction Game Maker;;0 - 20,000;103;27;76;0;0;4
1195290;Moncage;;100,000 - 200,000;3953;240;3713;167;176;24
1195320;Mokoko;;0 - 20,000;155;11;144;2;2;0
1195340;Hermes: Rescue Mission;;0 - 20,000;20;0;20;0;0;0
1195350;Your little story: Winter;;0 - 20,000;14;3;11;0;0;0
1195360;Re:Turn - One Way Trip;;0 - 20,000;100;28;72;0;0;0
1195410;Trial of the Gods: Siralim CCG;;0 - 20,000;42;6;36;0;0;0
1195430;Fight High;;0 - 20,000;5;1;4;0;0;0
1195450;HABITKING RPG;;20,000 - 50,000;2;0;2;0;0;0
1195460;Last Year;;500,000 - 1,000,000;4441;3054;1387;415;202;1
1195530;The Tawashi;;0 - 20,000;16;0;16;0;0;0
1195550;Gamedev simulator;;0 - 20,000;1;5;-4;0;0;0
1195560;Alek - The Lost Kingdom;;0 - 20,000;196;56;140;0;0;3
1195570;Dark Invasion VR;;0 - 20,000;7;3;4;0;0;0
1195610;March Of Soldiers;;0 - 20,000;1;0;1;0;0;0
1195620;Ocean Drive Challenge Remastered;;0 - 20,000;10;3;7;0;0;0
1195710;Monster Viator;;0 - 20,000;14;2;12;0;0;0
1195820;Devil Threats;;0 - 20,000;1;4;-3;0;0;0
1195830;副作用之瞳-Tlicolity Eyes-;;50,000 - 100,000;83;33;50;0;0;1
1195870;零界战线;;0 - 20,000;5;3;2;0;0;0
1195910;Dead Dreams;;100,000 - 200,000;39;9;30;0;0;0
1195920;Solar Panic: Utter Distress;;0 - 20,000;25;4;21;0;0;0
1196030;The Mystic;;0 - 20,000;3;0;3;0;0;0
1196080;Space Simulation Toolkit;;0 - 20,000;67;7;60;66;66;1
1196130;Top Run;;0 - 20,000;26;2;24;0;0;0
1196160;British Gangsters;;0 - 20,000;3;2;1;0;0;0
1196170;Gang District;;0 - 20,000;4;0;4;0;0;0
1196190;KUMO The Little Robot;;0 - 20,000;4;3;1;0;0;0
1196240;WizardPunk;;0 - 20,000;13;0;13;0;0;0
1196260;Draft Day Sports: Pro Basketball 2020;;0 - 20,000;7;7;0;0;0;0
1196280;Pussy Puzzle;;0 - 20,000;11;0;11;0;0;0
1196310;Fantasy Grounds Unity;;20,000 - 50,000;483;81;402;1455;1455;392
1196320;Blood Scrolls;;0 - 20,000;1;1;0;0;0;0
1196350;ATROFIL: THE KEY;;0 - 20,000;4;7;-3;0;0;0
1196380;Automaton;;0 - 20,000;3;4;-1;0;0;0
1196390;Fairy Godmother Stories: Cinderella Collector's Edition;;0 - 20,000;7;1;6;0;0;2
1196400;Mystery Case Files: Black Crown Collector's Edition;;0 - 20,000;33;5;28;0;0;1
1196440;Potion Party;;0 - 20,000;92;3;89;0;0;0
1196440;Potion Party;;0 - 20,000;92;3;89;0;0;0
1196450;Stop Sign VR Tools;;0 - 20,000;45;5;40;0;0;2
1196470;WE ARE FOOTBALL;;100,000 - 200,000;996;299;697;419;419;234
1196500;Party Arena: Board Game Battler;;0 - 20,000;34;10;24;0;0;0
1196520;The Secret of Hutton Grammar School;;0 - 20,000;13;5;8;0;0;0
1196550;Days Gone By;;0 - 20,000;1;1;0;0;0;0
1196570;Suzunaan on Fire;;0 - 20,000;16;3;13;0;0;0
1196580;The Pale City;;0 - 20,000;19;0;19;0;0;0
1196590;Resident Evil Village;;2,000,000 - 5,000,000;84136;3712;80424;1321;930;1082
1196620;佣兵战歌;;0 - 20,000;37;26;11;0;0;0
1196630;Nexomon: Extinction;;100,000 - 200,000;2193;185;2008;350;350;52
1196690;OctaFight;;0 - 20,000;10;2;8;0;0;0
1196800;TaniNani;;0 - 20,000;31;1;30;0;0;0
1196890;Puzzle Tower;;0 - 20,000;12;2;10;0;0;0
1196940;Particulate;;0 - 20,000;9;1;8;0;0;0
1196970;Vile Matter;;0 - 20,000;6;1;5;0;0;0
1197010;TAL: Wizard's Adventures;;0 - 20,000;11;1;10;0;0;0
1197020;Tale of the Gallant Jiraiya;;0 - 20,000;4;0;4;0;0;0
1197030;Mystic Pillars: A Story-Based Puzzle Game;;0 - 20,000;57;8;49;0;0;0
1197060;FUNGI;;100,000 - 200,000;31;18;13;0;0;0
1197100;Red Mercenary;;0 - 20,000;6;5;1;0;0;0
1197150;Em-A-Li;;0 - 20,000;39;8;31;0;0;0
1197160;Code 3: Police Response;;0 - 20,000;20;12;8;0;0;0
1197180;Spider Queen cave;;0 - 20,000;58;75;-17;0;0;2
1197230;Biba`s Adventures — Hardcore Platformer;;0 - 20,000;25;2;23;0;0;0
1197260;The Perfect Tower II;;200,000 - 500,000;1684;236;1448;0;0;903
1197320;A Long Stroll;;0 - 20,000;14;6;8;0;0;0
1197340;Dead territory;;0 - 20,000;2;3;-1;0;0;0
1197350;Santa's Big Sack;;0 - 20,000;25;4;21;0;0;0
1197360;The Santa Challenge;;0 - 20,000;13;0;13;0;0;0
1197370;Suite 776;;0 - 20,000;512;53;459;0;0;2
1197370;Suite 776;;0 - 20,000;512;53;459;0;0;2
1197380;Flashover MegaSector;;0 - 20,000;2;1;1;0;0;0
1197390;Robot Island;;0 - 20,000;27;0;27;0;0;0
1197440;Broken Spell 2;;0 - 20,000;43;75;-32;0;0;0
1197460;InnoEdu;;0 - 20,000;1;3;-2;0;0;0
1197490;Sliding Puzzle Collection;;0 - 20,000;2;0;2;0;0;0
1197500;Groove Runner;;0 - 20,000;2;1;1;0;0;0
1197520;Familia;;50,000 - 100,000;39;0;39;0;0;0
1197530;Planet Modular TD;;0 - 20,000;5;3;2;0;0;2
1197570;Until We Die;;200,000 - 500,000;2735;1146;1589;1126;1614;24
1197580;Nekoview;;20,000 - 50,000;106;6;100;0;0;4
1197620;DragonRideVR;;0 - 20,000;44;5;39;4;4;0
1197670;Robin Hood: Country Heroes;;0 - 20,000;15;5;10;0;0;0
1197700;Hermes: War of the Gods;;0 - 20,000;20;1;19;0;0;1
1197710;Golden Rails: Tales of the Wild West;;0 - 20,000;27;0;27;0;0;1
1197730;DelayedSun;;0 - 20,000;19;16;3;0;0;1
1197820;Craftlands Workshoppe;;0 - 20,000;113;54;59;0;0;1
1197840;The incredible friends;;0 - 20,000;0;7;-7;0;0;0
1197960;Gravity Balls;;0 - 20,000;7;5;2;0;0;0
1197990;Shoot, push, portals;;0 - 20,000;45;4;41;0;0;0
1198020;Braverz;;0 - 20,000;0;1;-1;0;0;0
1198040;Wide Ocean Big Jacket;;0 - 20,000;214;7;207;80;80;0
1198050;War Remains: Dan Carlin Presents an Immersive Memory;;0 - 20,000;79;28;51;0;0;0
1198060;Christmas Stories: Enchanted Express Collector's Edition;;0 - 20,000;19;3;16;0;0;0
1198070;The Christmas Spirit: Grimm Tales Collector's Edition;;0 - 20,000;18;2;16;0;0;1
1198080;Westminster Darkly;;0 - 20,000;6;3;3;0;0;0
1198090;The Legend of Heroes: Trails of Cold Steel IV;;20,000 - 50,000;1634;99;1535;5634;5884;105
1198110;Fantasy Realm TD;;0 - 20,000;2;4;-2;0;0;0
1198210;Dogworld;;0 - 20,000;88;3;85;0;0;1
1198240;Danger City;;0 - 20,000;8;2;6;0;0;0
1198270;The Button Witch;;0 - 20,000;43;0;43;0;0;0
1198290;Space Block Buster;;0 - 20,000;38;3;35;0;0;0
1198310;Mr.King Luo!Don't be kidding;;0 - 20,000;33;12;21;0;0;0
1198320;DOTOKOI / 像素男友;;50,000 - 100,000;935;10;925;0;0;0
1198340;Summoner VR;;0 - 20,000;1;0;1;0;0;0
1198380;COWBOY YAKUZA;;0 - 20,000;4;2;2;0;0;0
1198390;Kawaii Girl;;0 - 20,000;29;4;25;0;0;0
1198400;Rhythm Fighter;;20,000 - 50,000;358;80;278;135;135;0
1198440;The Burning Descent;;0 - 20,000;6;2;4;0;0;0
1198450;The Secret Order 8: Return to the Buried Kingdom;;0 - 20,000;100;20;80;243;243;5
1198510;Paperball;;0 - 20,000;174;7;167;254;254;0
1198550;Moderium;;0 - 20,000;3;0;3;0;0;0
1198590;Stonefly;;20,000 - 50,000;91;11;80;0;0;1
1198600;Pizza Time Explosion;;0 - 20,000;25;1;24;0;0;0
1198700;Chained: A Victorian Nightmare;;0 - 20,000;21;13;8;0;0;0
1198740;Colony Siege;;0 - 20,000;195;17;178;0;0;1
1198760;League of Pixels - 2D MOBA;;20,000 - 50,000;101;20;81;0;0;0
1198810;Wolf and Pigs;;0 - 20,000;17;4;13;0;0;0
1198850;How to Build a Magnificent Kingdom;;0 - 20,000;209;59;150;0;0;4
1198860;Snowballs;;0 - 20,000;115;20;95;0;0;0
1198890;Remuage - MeltySensation;;20,000 - 50,000;1;0;1;0;0;0
1198900;The Underground King;;0 - 20,000;5;0;5;0;0;0
1199010;Tower Of God: One Wish;;0 - 20,000;16;1;15;0;0;0
1199030;Tainted Grail: Conquest;;100,000 - 200,000;5586;510;5076;564;664;72
1199050;CRASH: Autodrive;;0 - 20,000;9;2;7;0;0;0
1199060;Coin Pickers;;0 - 20,000;12;6;6;0;0;0
1199140;Oh Jeez, Oh No, My Rabbits Are Gone!;;0 - 20,000;30;0;30;0;0;0
1199150;Raccoon: The Orc Invasion;;0 - 20,000;3;6;-3;0;0;0
1199170;Gravity Escape From The Maze;;0 - 20,000;14;3;11;0;0;0
1199180;Edge Of Galaxy;;0 - 20,000;22;8;14;0;0;0
1199220;An Odyssey: Echoes of War;;0 - 20,000;6;3;3;0;0;0
1199240;Galactic Asteroids Patrol;;0 - 20,000;1;0;1;0;0;0
1199360;Rat Racer;;0 - 20,000;24;5;19;0;0;0
1199370;Gleamlight;;0 - 20,000;49;62;-13;0;0;1
1199420;Bounce Knight;;0 - 20,000;5;1;4;0;0;0
1199450;Dark Raider;;0 - 20,000;42;24;18;0;0;0
1199540;Spartan Commander Realtime;;0 - 20,000;4;9;-5;0;0;0
1199560;Adrift Arena;;0 - 20,000;8;1;7;0;0;0
1199610;Broken of Darkness;;0 - 20,000;4;7;-3;0;0;0
1199620;Unarmed Area;;0 - 20,000;1;0;1;0;0;0
1199620;Unarmed Area;;0 - 20,000;1;0;1;0;0;0
1199640;Cave to Kingdom;;200,000 - 500,000;172;335;-163;0;0;0
1199650;Cube Smash;;0 - 20,000;1;0;1;0;0;0
1199660;The Answer Is 42;;0 - 20,000;124;10;114;0;0;1
1199740;Piñata Attack;;0 - 20,000;4;0;4;0;0;0
1199760;Light Fairytale Episode 2;;20,000 - 50,000;37;1;36;0;0;0
1199770;TaskForce Gamma-13 : An SCP Tale;;0 - 20,000;7;2;5;0;0;0
1199780;Santa's Holiday;;0 - 20,000;7;0;7;0;0;0
1199790;The Shadow Society;;0 - 20,000;16;8;8;0;0;0
1199800;The Winter's Deal - Frosty Edition;;0 - 20,000;1;0;1;0;0;0
1199900;Hope's Farm;;0 - 20,000;13;4;9;0;0;0
1199910;S.W.A.N.: Chernobyl Unexplored;;0 - 20,000;40;16;24;0;0;0
1199910;S.W.A.N.: Chernobyl Unexplored;;0 - 20,000;40;16;24;0;0;0
1199930;Prens Cavid The Game;;0 - 20,000;1;2;-1;0;0;0
1199940;THE UNIVERSE;;0 - 20,000;1;1;0;0;0;0
1200060;乔乔的铁拳 Joe's Fists;;20,000 - 50,000;1;0;1;0;0;0
1200090;Dimension of Dreams;;0 - 20,000;4;1;3;0;0;0
1200110;メモリーズオフ-Innocent Fille- for Dearest;;0 - 20,000;220;16;204;0;0;2
1200120;Armorgeddon;;0 - 20,000;2;2;0;0;0;0
1200140;4X4 OFF-ROAD CHALLENGE;;0 - 20,000;5;5;0;0;0;0
1200150;Hyperwheel Overdrive;;0 - 20,000;11;0;11;0;0;0
1200160;Pivot;;0 - 20,000;4;0;4;0;0;0
1200180;Fly Fly Tank;;0 - 20,000;4;2;2;0;0;0
1200200;Sin Chess;;0 - 20,000;25;4;21;0;0;0
1200220;Fishing Adventure VR;;0 - 20,000;4;9;-5;0;0;0
1200230;Ludus;;50,000 - 100,000;327;156;171;594;1026;1
1200250;The Time of Awakening;;0 - 20,000;5;1;4;0;0;0
1200280;Alien Terminal;;0 - 20,000;1;2;-1;0;0;0
1200290;FlyManMissile;;20,000 - 50,000;11;2;9;0;0;2
1200300;Comet Golf;;0 - 20,000;2;1;1;0;0;0
1200330;Strategic Mind: Blitzkrieg;;20,000 - 50,000;352;56;296;0;0;33
1200350;Dead Ground Arcade;;0 - 20,000;35;6;29;0;0;4
1200400;Guardians Of Rings;;0 - 20,000;6;10;-4;0;0;0
1200420;Awesome Pea 2;;0 - 20,000;25;3;22;0;0;1
1200430;Sick Way;;0 - 20,000;8;4;4;0;0;0
1200430;Sick Way;;0 - 20,000;8;4;4;0;0;0
1200450;HELLO PLAYER;;0 - 20,000;1;1;0;0;0;0
1200520;Ascent Free-Roaming VR Experience;;0 - 20,000;6;1;5;0;0;0
1200570;AColony;;0 - 20,000;49;5;44;0;0;50
1200580;One Gun Guy;;0 - 20,000;14;4;10;0;0;0
1200590;The Sword;;0 - 20,000;1;0;1;0;0;0
1200600;Nine Circles of Hell;;0 - 20,000;2;0;2;0;0;0
1200610;Jitsumi's Gaming Overlay;;0 - 20,000;6;1;5;0;0;0
1200630;Fright;;0 - 20,000;0;1;-1;0;0;0
1200650;The Disguiser Of Fate;;0 - 20,000;57;6;51;0;0;0
1200660;My Home VR;;0 - 20,000;3;0;3;0;0;0
1200710;BadLads;;0 - 20,000;93;36;57;0;0;0
1200780;Mini Island: Night;;0 - 20,000;20;0;20;0;0;0
1200860;The Good Time Garden;;100,000 - 200,000;2059;85;1974;0;0;4
1200870;History Racers 2;;0 - 20,000;0;1;-1;0;0;0
1200900;Crypto: Against All Odds - Tower Defense;;0 - 20,000;53;8;45;0;0;1
1200910;Pet Chan;;0 - 20,000;39;17;22;0;0;0
1200930;Art of Deception;;0 - 20,000;34;1;33;0;0;0
1200990;love the game;;0 - 20,000;1;0;1;0;0;0
1201000;Reincarnated As A Monster;;0 - 20,000;10;4;6;0;0;0
1201140;2DTo3DModelEditor;;0 - 20,000;1;0;1;0;0;0
1201200;Mouse Mayhem Shooting & Racing;;0 - 20,000;3;3;0;0;0;0
1201220;Afterbern Democralypse;;0 - 20,000;5;4;1;0;0;0
1201230;Immortal Life;;50,000 - 100,000;1654;399;1255;3240;5759;88
1201240;BLEACH Brave Souls;;500,000 - 1,000,000;6717;883;5834;2243;974;2149
1201250;Ninja Run;;0 - 20,000;5;1;4;0;0;0
1201260;Happy Engine;;0 - 20,000;18;15;3;0;0;1
1201280;A Space For The Unbound - Prologue;;20,000 - 50,000;1223;20;1203;32;32;1
1201310;Blocks!: Hammer of the Scots;;0 - 20,000;15;10;5;0;0;0
1201330;I Am Your President: Prologue;;50,000 - 100,000;425;115;310;0;0;0
1201350;Election simulator;;0 - 20,000;4;2;2;0;0;0
1201370;HAMMY;;0 - 20,000;66;19;47;0;0;0
1201380;Puck Buddies;;0 - 20,000;8;1;7;0;0;2
1201400;Not For Broadcast: Prologue;;100,000 - 200,000;693;52;641;25;31;2
1201500;Christmas Cats Revenge;;0 - 20,000;5;5;0;0;0;0
1201520;LRRL or RLLR;;0 - 20,000;0;2;-2;0;0;0
1201540;HELLCARD;;50,000 - 100,000;245;32;213;373;406;3472
1201550;Mad Experiments: Escape Room;;0 - 20,000;182;68;114;165;165;3
1201620;Fast Food Never More;;0 - 20,000;0;2;-2;0;0;0
1201630;Mineirinho Director's Cut;;100,000 - 200,000;993;490;503;40;40;5
1201640;Island Explorer VR;;0 - 20,000;30;13;17;0;0;0
1201650;Mystic Hammer;;0 - 20,000;7;0;7;0;0;0
1201730;PRISON OF SON;;0 - 20,000;10;5;5;0;0;0
1201730;PRISON OF SON;;0 - 20,000;10;5;5;0;0;0
1201750;Taurus VR;;0 - 20,000;6;0;6;0;0;0
1201760;Kari;;20,000 - 50,000;86;25;61;0;0;0
1201770;Colossals;;0 - 20,000;2;1;1;0;0;0
1201770;Colossals;;0 - 20,000;2;1;1;0;0;0
1201790;Long loot the King;;0 - 20,000;5;0;5;0;0;0
1201800;Knight Swap 2;;0 - 20,000;35;3;32;0;0;0
1201810;Unlock The King 2;;20,000 - 50,000;64;25;39;0;0;0
1201830;For The Warp;;0 - 20,000;241;83;158;0;0;13
1201840;MAN STANDING;;0 - 20,000;319;62;257;0;0;0
1201870;Drinks With Abbey;;20,000 - 50,000;310;83;227;0;0;0
1201880;The North Pole;;0 - 20,000;27;4;23;0;0;0
1201910;Cook Dungeon;;0 - 20,000;7;14;-7;0;0;0
1201930;末日临晓/The Dawn;;0 - 20,000;23;3;20;0;0;0
1201940;Project Speed;;0 - 20,000;67;35;32;0;0;0
1202070;Gachi Revenge;;0 - 20,000;264;25;239;0;0;2
1202090;Pieces of Me: Northbound;;0 - 20,000;15;9;6;0;0;0
1202100;Bodyless;;50,000 - 100,000;43;9;34;0;0;0
1202120;Fateful End: True Case Files;;0 - 20,000;4;3;1;0;0;0
1202130;Starship Troopers: Terran Command;;100,000 - 200,000;6257;822;5435;685;565;260
1202140;Portal Dungeon: Goblin Escape;;0 - 20,000;10;3;7;0;0;0
1202150;SpelunKing: The Mine Match;;0 - 20,000;29;13;16;0;0;0
1202160;Choco Pixel;;0 - 20,000;23;4;19;0;0;0
1202170;Barbarous - Tavern Of Emyr;;0 - 20,000;32;2;30;0;0;0
1202220;Egypt Solitaire. Match 2 Cards;;0 - 20,000;6;0;6;0;0;0
1202240;Fighters Wizards;;0 - 20,000;38;8;30;0;0;1
1202250;LUXAR;;0 - 20,000;1;1;0;0;0;0
1202280;Slave Princess Sarah;;0 - 20,000;76;19;57;2;2;0
1202300;Eternal Liiivie - EP1 Liiivie Isolated From the World;;0 - 20,000;23;1;22;0;0;0
1202310;Sakura Succubus;;50,000 - 100,000;447;83;364;127;127;10
1202360;VR Gigapixel Gallery;;0 - 20,000;4;0;4;0;0;0
1202400;Spermula 1;;0 - 20,000;10;0;10;0;0;0
1202410;Midjungard;;0 - 20,000;10;2;8;0;0;0
1202420;Moves;;0 - 20,000;32;4;28;0;0;0
1202480;36 apples;;0 - 20,000;110;9;101;0;0;0
1202510;Escape the Ninja Room;;0 - 20,000;3;1;2;0;0;0
1202540;Marco & The Galaxy Dragon;;50,000 - 100,000;4559;103;4456;407;571;12
1202550;Zombie Busters VR;;0 - 20,000;0;1;-1;0;0;0
1202560;Hero Index;;0 - 20,000;2;1;1;0;0;0
1202570;Aquarius;;0 - 20,000;20;3;17;0;0;0
1202610;StretchBot;;0 - 20,000;11;0;11;0;0;0
1202630;The Walsingham Files - Chapter 2;;0 - 20,000;9;1;8;0;0;0
1202650;Gift Girl;;20,000 - 50,000;387;186;201;17;17;0
1202660;Elizabeth;;0 - 20,000;46;7;39;0;0;1
1202710;Santa's Christmas Solitaire 2;;0 - 20,000;15;0;15;0;0;0
1202730;nStations;;0 - 20,000;7;6;1;0;0;0
1202760;Story in the Dream World -Volcano and Possession-;;0 - 20,000;5;3;2;0;0;0
1202770;kirakira stars idol project AI;;0 - 20,000;59;9;50;0;0;0
1202780;Theme Park Simulator: Rollercoaster Paradise;;0 - 20,000;25;13;12;0;0;1
1202790;Lost Brothers;;0 - 20,000;25;37;-12;0;0;0
1202810;ROAD HOMEWARD: Open world;;0 - 20,000;1;5;-4;0;0;0
1202820;Melbits World;;0 - 20,000;3;0;3;0;0;0
1202830;Cyberception;;0 - 20,000;1;1;0;0;0;0
1202860;Sterio;;0 - 20,000;0;4;-4;0;0;0
1202870;The Heiress of Sorcery;;0 - 20,000;98;15;83;484;484;0
1202900;Assemble with Care;;100,000 - 200,000;3093;277;2816;228;231;24
1202930;Boom Boomerang;;0 - 20,000;7;1;6;0;0;0
1202970;Mad Tracks;;0 - 20,000;126;14;112;46;46;1
1202990;North Of Iraq Part 1;;0 - 20,000;5;2;3;0;0;0
1203030;Tales of Beasteria;;0 - 20,000;0;1;-1;0;0;0
1203050;Nordic Storm Solitaire;;0 - 20,000;14;3;11;0;0;0
1203140;RaidTitans;;0 - 20,000;68;7;61;0;0;1
1203140;RaidTitans;;0 - 20,000;68;7;61;0;0;1
1203160;ArchiTac;;50,000 - 100,000;135;72;63;0;0;0
1203180;Breakwaters;;20,000 - 50,000;530;332;198;0;0;3
1203220;NARAKA: BLADEPOINT;;5,000,000 - 10,000,000;111348;56194;55154;10249;3157;124986
1203240;Remember;;0 - 20,000;11;0;11;0;0;0
1203280;Brawl Hopper;;0 - 20,000;1;0;1;0;0;0
1203310;Tiles Shooter Puzzle Cube;;0 - 20,000;1;0;1;0;0;0
1203360;Core Defense;;20,000 - 50,000;268;63;205;2427;2427;4
1203370;Survival Classic;;0 - 20,000;208;108;100;453;453;2
1203390;Winter Break;;0 - 20,000;2;0;2;0;0;1
1203400;Witchcraft: Pandoras Box;;0 - 20,000;13;4;9;0;0;0
1203420;Miss Neko 2;;50,000 - 100,000;1846;157;1689;55;63;15
1203430;Rescuers2019;;0 - 20,000;0;13;-13;0;0;0
1203460;Koo & Yuu;;0 - 20,000;23;0;23;0;0;0
1203470;Earth Analog;;0 - 20,000;60;33;27;0;0;1
1203490;Planet Colonization;;0 - 20,000;2;1;1;0;0;0
1203500;Dorky Fork;;0 - 20,000;6;2;4;0;0;0
1203560;Everyone Dies;;0 - 20,000;90;30;60;0;0;0
1203570;HexON;;20,000 - 50,000;51;17;34;0;0;0
1203580;Photo Quiz - Animals;;0 - 20,000;11;3;8;0;0;0
1203600;Zombie Slayers;;0 - 20,000;9;2;7;0;0;0
1203630;Record of Lodoss War-Deedlit in Wonder Labyrinth-;;500,000 - 1,000,000;5024;342;4682;281;519;11
1203650;Blood Metal;;0 - 20,000;32;45;-13;0;0;1
1203660;Animal Farm: China;;0 - 20,000;42;13;29;0;0;0
1203680;Guiding Light;;50,000 - 100,000;129;22;107;0;0;0
1203710;UnMetal;;50,000 - 100,000;1634;109;1525;201;30;24
1203740;Kz CTool;;0 - 20,000;1;0;1;0;0;0
1203750;The Girl of Glass: A Summer Bird's Tale;;0 - 20,000;42;15;27;0;0;0
1203760;Builder VR;;0 - 20,000;3;3;0;0;0;0
1203770;A Moustache in the House;;0 - 20,000;5;4;1;0;0;0
1203780;Tiamat's Drink;;0 - 20,000;10;0;10;0;0;0
1203810;Slay The Bigies;;0 - 20,000;4;1;3;0;0;0
1203850;Infection;;0 - 20,000;12;1;11;0;0;0
1203890;Mirage Online Classic;;20,000 - 50,000;37;13;24;0;0;3
1203910;Arabian Treasures: Midnight Match;;0 - 20,000;0;1;-1;0;0;0
1203930;The Last Haven;;50,000 - 100,000;1508;359;1149;78;78;331
1203950;Mystic Ruin: A New Dawn;;0 - 20,000;2;0;2;0;0;0
1203960;Other Realms: Dwarves & more Dwarves;;0 - 20,000;4;6;-2;0;0;0
1203970;The Warmth Between Us;;0 - 20,000;107;4;103;0;0;0
1203990;Shine's Adventures 5(World Of Box);;20,000 - 50,000;34;2;32;0;0;0
1204030;Night Witch: 588;;0 - 20,000;4;0;4;0;0;0
1204050;Pixel Studio for pixel art;;200,000 - 500,000;1873;91;1782;0;0;113
1204080;Nightfall Hacker;;0 - 20,000;18;0;18;0;0;0
1204210;The Big SokoBang;;0 - 20,000;1;1;0;0;0;0
1204220;Mommy;;20,000 - 50,000;90;13;77;0;0;0
1204230;4th Generation Warfare;;0 - 20,000;71;58;13;0;0;6
1204250;C.Y.S.M.A.;;0 - 20,000;1;0;1;0;0;0
1204270;New Year's Eve 2020;;0 - 20,000;58;19;39;0;0;0
1204280;Renegade Grounds: Episode 2;;0 - 20,000;5;0;5;0;0;0
1204330;Fight,to the last;;0 - 20,000;12;2;10;0;0;0
1204360;Blink Cam;;0 - 20,000;15;2;13;0;0;0
1204370;UIFO DEFENSE HD;;0 - 20,000;33;12;21;0;0;0
1204380;CityWarHeroes VR;;0 - 20,000;8;3;5;0;0;0
1204410;Kosmokrats;;20,000 - 50,000;88;9;79;26;26;1
1204440;The God Unit;;0 - 20,000;59;1;58;0;0;0
1204470;Space Elite Force II;;0 - 20,000;81;6;75;0;0;0
1204480;Candera: The Forgotten Realm;;0 - 20,000;2;0;2;0;0;0
1204490;武儒绘卷 - 启示录;;0 - 20,000;8;7;1;0;0;0
1204530;Cold wires;;0 - 20,000;7;1;6;0;0;0
1204540;Pictassembler;;0 - 20,000;3;0;3;0;0;0
1204580;First Contact;;20,000 - 50,000;9;0;9;0;0;0
1204630;Firefight!;;0 - 20,000;8;0;8;0;0;0
1204650;Pirates Treasure II - Steam Edition;;0 - 20,000;2;2;0;0;0;0
1204660;Better Boyfriend;;0 - 20,000;1;2;-1;0;0;0
1204670;Talshard;;0 - 20,000;1;0;1;0;0;0
1204700;Pangea Survival;;0 - 20,000;50;29;21;0;0;0
1204710;Void Breach;;0 - 20,000;26;0;26;0;0;0
1204740;How Stories Die;;0 - 20,000;95;9;86;0;0;0
1204740;How Stories Die;;0 - 20,000;95;9;86;0;0;0
1204760;James Town Courier Frog MD;;0 - 20,000;34;5;29;0;0;0
1204800;Spacebase19;;0 - 20,000;0;1;-1;0;0;0
1204800;Spacebase19;;0 - 20,000;0;1;-1;0;0;0
1204860;REFUGE;;0 - 20,000;1;10;-9;0;0;0
1204870;Schrodinger's cat simulator - PT;;0 - 20,000;15;13;2;0;0;0
1204870;Schrodinger's cat simulator - PT;;0 - 20,000;15;13;2;0;0;0
1204880;Bionic Hunter VR;;0 - 20,000;10;6;4;0;0;0
1204920;Music Visualizer Engine PC Live Wallpaper;;0 - 20,000;68;28;40;20;20;8
1204930;Hop Step Sing! Astral Piece;;0 - 20,000;84;0;84;0;0;0
1204940;Shot in the Dark;;0 - 20,000;30;0;30;0;0;0
1204950;Cecil Run;;0 - 20,000;0;2;-2;0;0;0
1204970;Hell Pub;;0 - 20,000;3;2;1;0;0;0
1204990;Milkcraft;;50,000 - 100,000;106;93;13;0;0;16
1205010;TriangleWingXXXX;;0 - 20,000;2;2;0;0;0;0
1205020;Jack troubles;;0 - 20,000;1;7;-6;0;0;0
1205060;Rock, Paper, Scissors Simulator;;0 - 20,000;14;5;9;0;0;0
1205140;Kika & Daigo: A Curious Tale;;0 - 20,000;56;34;22;0;0;1
1205150;Calamari Clash;;20,000 - 50,000;61;17;44;0;0;0
1205160;Decadent Thinking;;0 - 20,000;8;3;5;0;0;0
1205170;Super Magbot;;0 - 20,000;201;33;168;6;6;3
1205240;Tentacle Girl;;50,000 - 100,000;1049;126;923;20;20;2
1205250;Toy Killer;;0 - 20,000;2;2;0;0;0;0
1205260;Defeated Girl;;0 - 20,000;301;62;239;14;19;1
1205450;Turnip Boy Commits Tax Evasion;;200,000 - 500,000;7622;439;7183;109;128;25
1205480;Monster Jam Steel Titans 2;;0 - 20,000;168;47;121;540;540;12
1205520;Pentiment;;100,000 - 200,000;2367;89;2278;573;573;182
1205540;Shmup Arena;;0 - 20,000;19;0;19;0;0;0
1205590;Palace of sky;;0 - 20,000;16;6;10;0;0;0
1205620;ReversiQuest2;;0 - 20,000;36;12;24;0;0;0
1205630;SPORTCON;;0 - 20,000;29;2;27;0;0;0
1205650;i Have Powers!;;0 - 20,000;5;2;3;0;0;0
1205690;Defending Frontiers;;0 - 20,000;1;3;-2;0;0;0
1205800;Hexon;;20,000 - 50,000;2;1;1;0;0;0
1205900;Alwa's Legacy;;0 - 20,000;278;26;252;4;4;3
1205960;My Cute Fuhrer;;50,000 - 100,000;1021;146;875;178;229;3
1205970;MX vs ATV Legends;;20,000 - 50,000;455;300;155;500;907;23
1206000;VNHL 2022;;0 - 20,000;14;8;6;0;0;0
1206010;DonDon Busters!!;;0 - 20,000;2;0;2;0;0;0
1206040;Rhythm of the Gods;;0 - 20,000;5;1;4;0;0;0
1206050;Sea King;;0 - 20,000;20;3;17;0;0;1
1206060;Happy Game;;50,000 - 100,000;1572;163;1409;113;120;9
1206080;Zombie World Coronavirus Apocalypse VR;;0 - 20,000;6;9;-3;0;0;0
1206090;BORE DOME;;0 - 20,000;33;0;33;0;0;0
1206110;Frontline: The Great Patriotic War;;0 - 20,000;23;3;20;0;0;1
1206140;Frog struggles;;0 - 20,000;1;3;-2;0;0;0
1206180;Position;;0 - 20,000;4;4;0;0;0;0
1206230;Kart kids;;0 - 20,000;10;5;5;0;0;0
1206240;Talvisota - Winter War;;200,000 - 500,000;933;125;808;49;16;0
1206260;Pilfer;;0 - 20,000;9;0;9;0;0;0
1206270;Wrecker;;0 - 20,000;2;1;1;0;0;0
1206280;Thunderflash;;0 - 20,000;22;5;17;0;0;0
1206290;Goblin Summer Camp;;0 - 20,000;151;13;138;0;0;0
1206310;Tranject;;0 - 20,000;1;0;1;0;0;0
1206320;Primitive Survival;;0 - 20,000;0;1;-1;0;0;0
1206350;JORRY;;0 - 20,000;11;0;11;0;0;0
1206430;The Unfinished Swan;;50,000 - 100,000;955;164;791;103;148;1
1206470;Suspicious Slide;;0 - 20,000;3;0;3;0;0;0
1206480;Swordsman VR;;20,000 - 50,000;335;123;212;0;0;2
1206490;Ultimate Disc Golf;;0 - 20,000;19;17;2;0;0;0
1206510;The inside of a drawer;;0 - 20,000;1;0;1;0;0;0
1206550;Kick Of Dungeon;;0 - 20,000;3;1;2;0;0;0
1206560;WorldBox - God Simulator;;500,000 - 1,000,000;18839;1074;17765;865;312;1635
1206570;逆光 Sunwards;;0 - 20,000;22;19;3;0;0;0
1206600;Almighty: Kill Your Gods;;0 - 20,000;234;118;116;0;0;4
1206610;Rubber Bandits;;200,000 - 500,000;2919;410;2509;175;142;86
1206620;Soul Axiom Rebooted;;0 - 20,000;44;9;35;0;0;0
1206660;Monster Capture King;;0 - 20,000;2;1;1;0;0;0
1206710;My Adventure（我的冒险）;;0 - 20,000;1;0;1;0;0;0
1206720;kraken's curse;;0 - 20,000;28;5;23;0;0;1
1206730;Tower of Arcana;;0 - 20,000;2;2;0;0;0;0
1206730;Tower of Arcana;;0 - 20,000;2;2;0;0;0;0
1206740;Omnify Hotspot - The Best Wi-Fi Hotspot & Repeater;;0 - 20,000;25;13;12;0;0;17
1206790;Infinite Dronin;;0 - 20,000;17;2;15;0;0;0
1206810;Wamu Wamu 2;;0 - 20,000;6;2;4;0;0;0
1206840;Lost Roads;;0 - 20,000;2;7;-5;0;0;0
1206870;Pinball universe;;0 - 20,000;2;6;-4;0;0;0
1206900;Physical Glitch;;0 - 20,000;9;2;7;0;0;0
1206910;Bizarre Barber;;0 - 20,000;15;0;15;0;0;0
1206920;FLYING SHOT;;0 - 20,000;4;2;2;0;0;0
1206930;Malediction;;20,000 - 50,000;78;27;51;0;0;0
1206960;Cloudlands 2;;0 - 20,000;10;7;3;0;0;0
1207010;Me and myself;;0 - 20,000;14;5;9;0;0;0
1207020;FLS;;0 - 20,000;17;1;16;0;0;0
1207030;Agent Emerson;;0 - 20,000;11;16;-5;0;0;0
1207050;VUP- VTuber & Animation & motion capture & 3D & Live2D;;100,000 - 200,000;705;104;601;0;0;106
1207130;Many Faces;;0 - 20,000;5;0;5;0;0;0
1207210;The foreigner;;0 - 20,000;24;6;18;0;0;0
1207260;FlickerMAZE;;0 - 20,000;2;0;2;0;0;0
1207310;Gizmos: Steampunk Nonograms;;0 - 20,000;34;3;31;0;0;0
1207320;Gray Zone;;0 - 20,000;39;14;25;0;0;0
1207380;Adventure Boy Jailbreak;;20,000 - 50,000;17;3;14;0;0;0
1207390;Ghosts'n DJs;;0 - 20,000;113;15;98;0;0;0
1207400;Klym;;0 - 20,000;18;9;9;0;0;0
1207420;Chico;;0 - 20,000;9;3;6;0;0;0
1207480;Pupper park;;0 - 20,000;30;4;26;2;2;0
1207500;Coffee Break;;0 - 20,000;6;0;6;0;0;0
1207520;Aigor Escape from Bishop;;0 - 20,000;2;0;2;0;0;0
1207540;Puzzle Frame;;0 - 20,000;11;0;11;0;0;0
1207590;Builders of Egypt: Prologue;;1,000,000 - 2,000,000;2873;1004;1869;0;0;5
1207650;Suzerain;;500,000 - 1,000,000;4339;328;4011;1197;1578;188
1207710;Infinite Beyond The Mind;;0 - 20,000;15;3;12;0;0;0
1207770;Planet Bounce;;0 - 20,000;25;11;14;0;0;0
1207800;Mix-Sign: Girl with 3 Signs;;20,000 - 50,000;11;1;10;0;0;0
1207840;ExtraGalactica;;0 - 20,000;26;1;25;0;0;0
1207850;Project RTD: Random Tower Defense PvP;;20,000 - 50,000;450;453;-3;92;92;1
1207860;Brick Blaster;;0 - 20,000;5;0;5;0;0;1
1207880;Nasty Rogue;;20,000 - 50,000;86;22;64;0;0;0
1208030;Let's Learn Japanese! Vocabulary;;0 - 20,000;33;7;26;0;0;0
1208030;Let's Learn Japanese! Vocabulary;;0 - 20,000;33;7;26;0;0;0
1208050;Shine's Adventures 3 (Sea Fight);;0 - 20,000;14;2;12;0;0;0
1208090;Herbalist Simulator;;0 - 20,000;3;7;-4;0;0;0
1208220;Escape from Life Inc;;0 - 20,000;20;3;17;0;0;0
1208240;Reach Coin;;0 - 20,000;4;0;4;0;0;0
1208260;Hentai Vs Furries;;100,000 - 200,000;2957;389;2568;19;27;14
1208330;Idle Space;;0 - 20,000;15;7;8;0;0;0
1208370;DUMB Infernal;;0 - 20,000;17;8;9;0;0;0
1208380;PhyxBox;;20,000 - 50,000;24;14;10;0;0;0
1208390;Deserted;;0 - 20,000;1;0;1;0;0;0
1208400;Path;;0 - 20,000;1;0;1;0;0;0
1208420;The War Enders Evolution;;0 - 20,000;11;2;9;0;0;0
1208460;Super Crystal Hunter;;0 - 20,000;4;1;3;0;0;0
1208470;Foxfall;;20,000 - 50,000;1;1;0;0;0;0
1208470;Foxfall;;20,000 - 50,000;1;1;0;0;0;0
1208490;TAXIDERMY;;0 - 20,000;11;5;6;0;0;0
1208510;Kingdom Warrior;;0 - 20,000;6;4;2;0;0;0
1208520;The Alchemist's House;;20,000 - 50,000;176;79;97;0;0;0
1208550;DanielX.net Paint Composer;;0 - 20,000;17;1;16;0;0;0
1208580;Red Rush;;0 - 20,000;26;9;17;0;0;0
1208590;Temple Of Snek;;20,000 - 50,000;128;4;124;0;0;6
1208600;Bunny Park;;50,000 - 100,000;532;46;486;0;0;3
1208760;View From Below;;0 - 20,000;31;1;30;0;0;0
1208770;Saber Fight VR;;0 - 20,000;115;52;63;26;26;0
1208770;Saber Fight VR;;0 - 20,000;115;52;63;26;26;0
1208810;Green: An Orc's Life;;0 - 20,000;34;1;33;0;0;1
1208830;Oil Wars;;0 - 20,000;19;8;11;0;0;0
1208840;FireTry;;0 - 20,000;4;2;2;0;0;0
1208860;The Blackbird of Amor;;0 - 20,000;2;0;2;0;0;0
1208870;FLAGFIGHTS;;0 - 20,000;3;1;2;0;0;0
1208900;BomberX;;0 - 20,000;13;2;11;0;0;0
1208910;Real Orchestra;;0 - 20,000;0;2;-2;0;0;0
1208950;Freight Simulator;;0 - 20,000;24;25;-1;0;0;0
1208980;BlazeSky;;0 - 20,000;14;4;10;0;0;0
1208980;BlazeSky;;0 - 20,000;14;4;10;0;0;0
1209000;romantic player;;100,000 - 200,000;319;89;230;0;0;2
1209040;Cyber Hunter;;500,000 - 1,000,000;7591;2801;4790;1180;141;172
1209060;Cowboy;;0 - 20,000;6;13;-7;0;0;0
1209080;Defense and Revenge;;0 - 20,000;9;4;5;0;0;0
1209140;Peace Data;;0 - 20,000;195;21;174;0;0;3
1209160;The Square Game;;0 - 20,000;4;0;4;0;0;0
1209170;匿名信：失心者 / Stayer;;0 - 20,000;6;9;-3;0;0;0
1209190;Steamliner;;0 - 20,000;1;3;-2;0;0;0
1209200;Mompreneur: Pizza Cooking Life Sim;;0 - 20,000;1;2;-1;0;0;0
1209300;loathe the game;;0 - 20,000;1;0;1;0;0;0
1209360;Monster Truck Championship;;0 - 20,000;106;47;59;330;550;3
1209410;King of Seas;;20,000 - 50,000;362;264;98;81;81;3
1209430;Dungeon Cards;;0 - 20,000;58;9;49;0;0;2
1209440;capy hoky;;0 - 20,000;26;3;23;342;342;0
1209450;Potion Commotion;;0 - 20,000;95;14;81;0;0;1
1209490;Exit the Gungeon;;200,000 - 500,000;2290;647;1643;527;546;13
1209520;Smart Moves;;0 - 20,000;10;0;10;0;0;0
1209570;Cosmos - Escape From Freedom;;0 - 20,000;13;0;13;0;0;0
1209610;Virtually Real Life;;0 - 20,000;2;0;2;0;0;0
1209650;The Island Story;;0 - 20,000;21;9;12;0;0;0
1209720;Machina of the Planet Tree -Unity Unions-;;0 - 20,000;24;10;14;0;0;0
1209740;Coloniam;;0 - 20,000;11;15;-4;0;0;0
1209750;FlowState;;50,000 - 100,000;75;15;60;0;0;1
1209760;Aloe and Cal;;0 - 20,000;5;2;3;0;0;0
1209770;子夜之章:历史的终局～MidNights of Desperado～;;20,000 - 50,000;249;5;244;0;0;1
1209860;BDSM: Big Drunk Satanic Massacre Demo;;20,000 - 50,000;139;28;111;0;0;0
1209910;Britannic;;0 - 20,000;78;21;57;17;17;0
1209980;CaveBugBoy;;0 - 20,000;0;1;-1;0;0;0
1209990;烈山海一(BMS1);;0 - 20,000;115;35;80;0;0;0
1210010;sok-stories;;0 - 20,000;27;5;22;0;0;0
1210030;노베나 디아볼로스;;200,000 - 500,000;1342;82;1260;0;0;7
1210060;Submersed;;0 - 20,000;14;9;5;0;0;0
1210150;Ageless;;20,000 - 50,000;169;130;39;143;248;0
1210220;Circle;;0 - 20,000;31;16;15;0;0;0
1210230;Suits: Absolute Power;;20,000 - 50,000;146;10;136;588;588;2
1210250;Island Saver;;200,000 - 500,000;2546;108;2438;327;388;34
1210260;Purgatory Overkill;;50,000 - 100,000;1;1;0;0;0;0
1210320;Potion Craft: Alchemist Simulator;;500,000 - 1,000,000;17659;1449;16210;311;231;630
1210330;Thunder Kid II: Null Mission;;0 - 20,000;10;1;9;0;0;0
1210340;Breakneck City;;0 - 20,000;12;0;12;0;0;0
1210360;War Trigger 3;;50,000 - 100,000;195;141;54;0;0;1
1210380;Bingo VR;;0 - 20,000;17;7;10;0;0;1
1210380;Bingo VR;;0 - 20,000;17;7;10;0;0;1
1210410;Destinata: Pre Red Edition;;0 - 20,000;5;4;1;0;0;0
1210490;YesterMorrow;;0 - 20,000;41;15;26;0;0;0
1210550;Hohokum;;0 - 20,000;42;5;37;0;0;3
1210570;Rocket Ghost Aidan;;0 - 20,000;11;1;10;0;0;0
1210590;Pipeline Of Emperor Yu;;20,000 - 50,000;13;1;12;0;0;0
1210610;Lithium City;;50,000 - 100,000;206;20;186;0;0;1
1210620;lil' Sherman;;0 - 20,000;27;5;22;0;0;0
1210640;XYLITH - Hostile Planet;;0 - 20,000;1;2;-1;0;0;0
1210650;ESCAPE ROOM VR　;;0 - 20,000;10;23;-13;0;0;0
1210660;Daemonic Runner;;0 - 20,000;25;4;21;0;0;0
1210670;Silent World;;0 - 20,000;6;14;-8;0;0;0
1210680;封神纪传奇;;20,000 - 50,000;32;32;0;0;0;0
1210700;Skull Rogue;;0 - 20,000;25;11;14;0;0;0
1210740;Lumin's Path;;0 - 20,000;59;16;43;0;0;0
1210770;Battle Team;;100,000 - 200,000;24;10;14;0;0;0
1210780;Flatspace;;0 - 20,000;13;4;9;0;0;0
1210790;RC Plane VR;;0 - 20,000;2;0;2;0;0;0
1210800;Rum & Gun;;0 - 20,000;136;8;128;134;134;2
1210830;labyrinth;;0 - 20,000;9;1;8;0;0;0
1210850;Super Kickers League;;0 - 20,000;7;2;5;0;0;0
1210880;Dusk Warlocks;;0 - 20,000;7;1;6;0;0;0
1210910;Night Of The Living Dead VR;;20,000 - 50,000;12;1;11;0;0;0
1210960;Matrix Brain Twister;;0 - 20,000;7;0;7;0;0;0
1210970;Carpet Bombing;;0 - 20,000;7;0;7;0;0;0
1211020;Wobbly Life;;500,000 - 1,000,000;10967;338;10629;1298;971;1075
1211050;Once More;;0 - 20,000;5;0;5;0;0;0
1211060;Mission:Amazing;;20,000 - 50,000;1;0;1;0;0;0
1211070;Ephemera;;0 - 20,000;1;0;1;0;0;0
1211100;Universe Quiz;;0 - 20,000;5;1;4;0;0;0
1211110;Petal Crash;;0 - 20,000;249;5;244;0;0;0
1211160;Catch Your Kitty;;0 - 20,000;2;1;1;0;0;0
1211230;Legend of Streets;;0 - 20,000;1;0;1;0;0;0
1211240;Trifox;;0 - 20,000;71;6;65;0;0;1
1211250;Berserk Soccer;;0 - 20,000;6;2;4;0;0;0
1211320;Journey to New Atlantis;;0 - 20,000;0;2;-2;0;0;0
1211350;The Note of Red Evil;;0 - 20,000;20;2;18;0;0;0
1211360;NEOMORPH;;50,000 - 100,000;500;139;361;45;56;1
1211370;Goonya Fighter;;0 - 20,000;3;0;3;0;0;0
1211390;World of Voidia（虚亚世界）;;0 - 20,000;3;1;2;0;0;0
1211420;Find Me: Horror Game;;20,000 - 50,000;30;25;5;0;0;0
1211420;Find Me: Horror Game;;20,000 - 50,000;30;25;5;0;0;0
1211490;Math Path;;0 - 20,000;9;3;6;0;0;0
1211540;bobo robot;;0 - 20,000;45;6;39;43;43;0
1211610;Tune the Tone;;0 - 20,000;3;1;2;0;0;0
1211630;The Jackbox Party Pack 7;;200,000 - 500,000;3650;117;3533;403;205;164
1211640;Dead Motherland: Zombie Co-op;;0 - 20,000;58;55;3;0;0;0
1211640;Dead Motherland: Zombie Co-op;;0 - 20,000;58;55;3;0;0;0
1211650;Cirno's Perfect Summer Vacation;;0 - 20,000;70;11;59;0;0;0
1211650;Cirno's Perfect Summer Vacation;;0 - 20,000;70;11;59;0;0;0
1211700;Trantor: The Last Stormtrooper;;0 - 20,000;1;0;1;0;0;0
1211730;Infferno;;0 - 20,000;1;4;-3;0;0;0
1211740;Guardian of Lore;;0 - 20,000;27;5;22;0;0;0
1211780;Last in Orbit;;0 - 20,000;0;1;-1;0;0;0
1211790;Bad Girl;;0 - 20,000;1;6;-5;0;0;0
1211800;Live checkpoint;;0 - 20,000;1;3;-2;0;0;0
1211830;Explorers of the Abyss;;0 - 20,000;106;58;48;0;0;1
1211930;Ghost on the Shore;;0 - 20,000;99;13;86;0;0;0
1211950;Sheol;;0 - 20,000;7;2;5;0;0;0
1211960;Food Girls - Bubbles' Drink Stand;;0 - 20,000;100;25;75;0;0;1
1211990;The Clockworker;;20,000 - 50,000;38;1;37;0;0;0
1212040;Paws & Effect: My Dogs Are Human!;;0 - 20,000;8;2;6;0;0;0
1212100;fishy;;0 - 20,000;134;24;110;6;6;1
1212110;Knockback: The Awakening;;0 - 20,000;17;1;16;0;0;0
1212170;Sokbots;;0 - 20,000;11;17;-6;2;2;0
1212190;deer hunter II;;0 - 20,000;40;7;33;0;0;0
1212290;Kubble Star;;0 - 20,000;7;1;6;0;0;1
1212300;Reek;;0 - 20,000;17;1;16;0;0;0
1212320;Alien Frontline;;0 - 20,000;2;0;2;0;0;0
1212330;Skin Stealers;;0 - 20,000;4;2;2;0;0;0
1212360;INU;;0 - 20,000;13;1;12;0;0;0
1212370;Boolean;;0 - 20,000;9;1;8;0;0;0
1212400;Heroines of Swords & Spells;;20,000 - 50,000;496;27;469;0;0;3
1212410;Hourglass;;0 - 20,000;222;11;211;0;0;1
1212440;Forest Woodman;;0 - 20,000;11;4;7;0;0;0
1212450;Mineirinho Shooter DC;;50,000 - 100,000;11;8;3;0;0;0
1212470;Fourthy;;0 - 20,000;1;8;-7;0;0;0
1212480;Labirinto 3;;0 - 20,000;2;0;2;0;0;0
1212530;The Blueness of a Wound;;0 - 20,000;2;1;1;0;0;0
1212610;Nijikoi no Houkakou;;0 - 20,000;19;5;14;0;0;0
1212620;Pretty Neko;;100,000 - 200,000;2762;201;2561;36;12;6
1212640;A Lanterns Glow;;0 - 20,000;2;0;2;0;0;0
1212710;Divine Legacy;;0 - 20,000;5;1;4;0;0;0
1212720;Oh Boy More Cheese;;0 - 20,000;0;1;-1;0;0;0
1212730;トトのおもちゃばこ;;0 - 20,000;18;2;16;0;0;0
1212730;トトのおもちゃばこ;;0 - 20,000;18;2;16;0;0;0
1212740;CHAMELEON;;0 - 20,000;3;0;3;0;0;0
1212750;Undead zombies;;0 - 20,000;0;9;-9;0;0;0
1212830;Seek Girl Ⅳ;;100,000 - 200,000;1419;470;949;26;20;2
1212840;パトルの軍事博物館３ 超絶無敵究極兵器;;0 - 20,000;3;1;2;0;0;0
1212850;Monobot;;0 - 20,000;99;7;92;19;19;0
1212860;Flirt Balls;;0 - 20,000;12;2;10;0;0;0
1212930;Doler;;0 - 20,000;6;1;5;0;0;0
1212940;Ayahuasca;;20,000 - 50,000;257;66;191;0;0;0
1212960;Knight Dice;;0 - 20,000;8;4;4;0;0;0
1213000;In Her Eyes;;0 - 20,000;63;10;53;0;0;0
1213050;Ink.;;0 - 20,000;1;0;1;0;0;0
1213070;Pioneerz;;20,000 - 50,000;2;1;1;0;0;0
1213140;This Is Not The End;;0 - 20,000;4;0;4;0;0;0
1213150;Break;;0 - 20,000;5;2;3;0;0;0
1213180;Hero Mini Maker;;0 - 20,000;6;7;-1;0;0;0
1213210;Command & Conquer Remastered Collection;;1,000,000 - 2,000,000;24895;2588;22307;796;256;1633
1213220;IRON GUARD VR;;0 - 20,000;79;3;76;0;0;0
1213230;Rain on Your Parade;;20,000 - 50,000;591;12;579;79;79;4
1213370;Mr. Fast;;0 - 20,000;144;26;118;0;0;2
1213390;Starship Inspector;;0 - 20,000;31;18;13;0;0;0
1213420;Texas Holdem Poker: Solo King;;0 - 20,000;29;20;9;0;0;0
1213450;Craftica;;0 - 20,000;6;1;5;0;0;0
1213460;Deity Driving;;50,000 - 100,000;27;0;27;0;0;0
1213550;Devil's Kiss;;0 - 20,000;32;7;25;0;0;0
1213570;Cave Quest;;20,000 - 50,000;79;4;75;0;0;1
1213600;Peppered;;0 - 20,000;2;1;1;0;0;0
1213650;FEB - Brazilian Elite Force;;0 - 20,000;5;1;4;0;0;0
1213660;Into The Valley;;0 - 20,000;3;1;2;0;0;0
1213670;Solitaire Forever II;;20,000 - 50,000;158;23;135;0;0;51
1213680;Finding the Soul Orb;;0 - 20,000;43;11;32;0;0;1
1213700;Spirit of the North;;50,000 - 100,000;2378;312;2066;145;252;13
1213710;Virtuoso;;0 - 20,000;50;16;34;118;118;1
1213740;She Will Punish Them;;500,000 - 1,000,000;11430;954;10476;372;219;202
1213750;Fight Crab;;20,000 - 50,000;716;56;660;49;63;3
1213760;Path of Zen;;0 - 20,000;1;0;1;0;0;0
1213770;Blastboard;;0 - 20,000;45;2;43;0;0;0
1213780;Basic Warfare;;0 - 20,000;1;1;0;0;0;0
1213810;Strings;;0 - 20,000;1;2;-1;0;0;0
1213860;Cut Smash Wrap;;0 - 20,000;12;1;11;0;0;0
1213870;Kill The Santa;;0 - 20,000;24;3;21;0;0;0
1213890;Frostford;;0 - 20,000;3;2;1;0;0;0
1213910;Puzzle Battler! Mirai;;0 - 20,000;11;1;10;0;0;0
1213980;Cranky Cannon;;0 - 20,000;1;0;1;0;0;0
1214050;SCIENCE SHOW VR : THE ABYSS;;0 - 20,000;0;3;-3;0;0;0
1214060;TRIOS - lofi beats / numbers to chill to;;0 - 20,000;25;1;24;0;0;0
1214130;Jumplord;;0 - 20,000;2;0;2;0;0;0
1214150;ACCEL-X;;0 - 20,000;1;1;0;0;0;0
1214180;Mini Countries;;0 - 20,000;38;15;23;0;0;0
1214200;迷雾空城/The Mist City;;0 - 20,000;21;1;20;0;0;0
1214210;那美克星人;;0 - 20,000;3;9;-6;0;0;0
1214250;TIGER SYMBOLIC LINK KNIFE;;0 - 20,000;0;2;-2;0;0;0
1214280;Walking Simulator;;200,000 - 500,000;7705;1070;6635;0;0;7
1214320;Frog X Log;;50,000 - 100,000;4;1;3;0;0;0
1214330;World Seed Classic;;20,000 - 50,000;100;9;91;0;0;0
1214360;SKYE;;100,000 - 200,000;1106;95;1011;0;0;1
1214380;Zombie Mutant DNA;;0 - 20,000;3;0;3;0;0;0
1214400;A Percent of a Pirate;;20,000 - 50,000;4;3;1;0;0;0
1214410;Zooma VR;;0 - 20,000;216;14;202;3;3;2
1214450;Featherfall;;0 - 20,000;115;22;93;0;0;0
1214460;Tank Ball;;0 - 20,000;9;2;7;0;0;0
1214500;GraFi Lunar;;0 - 20,000;14;13;1;0;0;0
1214520;Pro Gymnast Simulator;;0 - 20,000;86;9;77;0;0;8
1214530;Coin Commander;;0 - 20,000;6;0;6;0;0;0
1214540;SUPER CIRCUIT BREAKERS;;100,000 - 200,000;72;16;56;0;0;0
1214570;DriftOn;;0 - 20,000;45;2;43;0;0;0
1214590;The Puzzle Box Society;;0 - 20,000;2;1;1;0;0;0
1214600;Bandapes;;0 - 20,000;6;5;1;0;0;0
1214630;The Hour of the Rat;;0 - 20,000;8;7;1;0;0;0
1214640;StellarX;;0 - 20,000;10;2;8;0;0;0
1214640;StellarX;;0 - 20,000;10;2;8;0;0;0
1214680;That Lava Escape Game;;0 - 20,000;2;0;2;0;0;0
1214760;Shine's Adventures 4 (Nightmare);;0 - 20,000;6;0;6;0;0;0
1214850;Snaliens;;0 - 20,000;43;2;41;0;0;0
1214920;Slaughter 3: The Rebels;;0 - 20,000;18;2;16;0;0;0
1214980;The Line;;0 - 20,000;27;2;25;0;0;0
1214980;The Line;;0 - 20,000;27;2;25;0;0;0
1214990;New Planets;;0 - 20,000;4;1;3;0;0;0
1215000;STRAYLIGHT;;0 - 20,000;16;1;15;0;0;0
1215060;A.V.I;;0 - 20,000;7;14;-7;0;0;0
1215120;DeeperRed2028-WeAreEscape-;;0 - 20,000;8;0;8;0;0;0
1215180;The Beasts Of 9500;;20,000 - 50,000;353;225;128;71;90;0
1215200;Shining Song Starnova: Idol Empire;;0 - 20,000;73;11;62;0;0;1
1215260;Efflorescence of Lust;;20,000 - 50,000;235;88;147;47;92;0
1215270;Down the Rabbit Hole;;0 - 20,000;353;21;332;0;0;2
1215280;Mask of Mists;;20,000 - 50,000;115;18;97;0;0;1
1215310;DragonScales 3: Eternal Prophecy of Darkness;;0 - 20,000;0;1;-1;0;0;0
1215320;Piczle Cross Adventure;;0 - 20,000;67;4;63;0;0;1
1215340;Danko and the mystery of the jungle;;0 - 20,000;9;3;6;0;0;0
1215350;AudioWizards;;0 - 20,000;3;0;3;0;0;0
1215380;Economica;;0 - 20,000;2;4;-2;0;0;0
1215390;Animal Revolt Battle Simulator;;200,000 - 500,000;3742;171;3571;1351;2391;301
1215410;Sproots;;0 - 20,000;12;12;0;0;0;0
1215430;Make Me LAG;;20,000 - 50,000;202;17;185;0;0;1
1215500;Cattle Admission Challenge;;0 - 20,000;16;0;16;0;0;0
1215520;Aldred Knight;;0 - 20,000;7;3;4;0;0;0
1215540;Data Dream;;0 - 20,000;7;1;6;0;0;0
1215550;Realistic Tower Destruction;;0 - 20,000;18;15;3;0;0;0
1215600;The Legend of Eldridge Scrolls: Woop;;0 - 20,000;6;1;5;0;0;0
1215650;William's Love Prelude;;0 - 20,000;10;2;8;0;0;0
1215660;Clicker Age;;0 - 20,000;9;12;-3;0;0;0
1215690;World War 2 Zombie Attack VR Coronavirus Simulator;;0 - 20,000;1;4;-3;0;0;0
1215700;Haustoria;;0 - 20,000;5;1;4;0;0;0
1215710;The Spirits of Kelley Family;;0 - 20,000;10;11;-1;0;0;0
1215720;Hero's Journey;;20,000 - 50,000;3;0;3;0;0;0
1215740;Casina: The Forgotten Comedy;;0 - 20,000;41;3;38;0;0;0
1215750;Just Arms;;0 - 20,000;24;4;20;0;0;0
1215830;Banana for Scale;;0 - 20,000;1;1;0;0;0;0
1215830;Banana for Scale;;0 - 20,000;1;1;0;0;0;0
1215860;Model Railway Easily;;0 - 20,000;18;7;11;0;0;1
1215870;The Walking Evil;;20,000 - 50,000;56;40;16;0;0;0
1215900;The mysterious Case of Dr. Jekyll and Mr. Hyde;;0 - 20,000;11;9;2;0;0;0
1215930;Ramiwo;;0 - 20,000;13;5;8;0;0;0
1215950;Getaway Mayhem;;0 - 20,000;50;13;37;0;0;0
1215960;P-BOT;;0 - 20,000;7;2;5;0;0;0
1215980;The Final Stand: Breakout;;0 - 20,000;1;0;1;0;0;0
1216030;Wildfire Swap;;0 - 20,000;33;2;31;0;0;0
1216050;Last Week;;0 - 20,000;18;2;16;0;0;0
1216060;DNF Duel;;100,000 - 200,000;2275;1301;974;847;1061;56
1216080;坦率的小红帽和爱说谎的狼;;50,000 - 100,000;898;18;880;0;0;0
1216150;Hell's Pharma;;0 - 20,000;10;0;10;0;0;0
1216200;Coloring Game 2;;200,000 - 500,000;3021;91;2930;432;227;31
1216220;Boiling Steel: Preface;;20,000 - 50,000;85;26;59;0;0;0
1216230;Project Heartbeat;;20,000 - 50,000;226;26;200;4;4;4
1216300;My Diggy Dog 2;;0 - 20,000;38;6;32;0;0;0
1216310;Sweet Holiday Jigsaws: Halloween Night;;0 - 20,000;6;0;6;0;0;0
1216320;Shieldwall;;200,000 - 500,000;4252;512;3740;266;287;60
1216350;Time Hacker;;0 - 20,000;26;6;20;0;0;0
1216470;Zoria: Age of Shattering Prologue;;100,000 - 200,000;351;69;282;0;0;0
1216480;Get the Banana;;0 - 20,000;1;0;1;0;0;0
1216490;Knock Harder;;0 - 20,000;307;11;296;867;867;0
1216540;Fishy2;;0 - 20,000;53;9;44;0;0;0
1216550;Player's Eleven;;0 - 20,000;35;6;29;0;0;1
1216590;Lone Land;;0 - 20,000;48;11;37;0;0;0
1216600;QUICAL;;0 - 20,000;13;4;9;0;0;0
1216700;匿名信：隐匿者 / Anonymous Letter ：Prowler;;0 - 20,000;5;3;2;0;0;0
1216710;Cyber Manhunt;;200,000 - 500,000;11152;646;10506;506;403;133
1216720;Human Delusion;;0 - 20,000;4;9;-5;0;0;0
1216740;Military Base War;;0 - 20,000;1;0;1;0;0;0
1216770;;;0 - 20,000;1;0;1;0;0;0
1216770;;;0 - 20,000;1;0;1;0;0;0
1216780;;;0 - 20,000;1;0;1;0;0;0
1216880;Risen Kingdom;;20,000 - 50,000;231;70;161;236;236;8
1216930;Vikings Wars;;0 - 20,000;2;5;-3;0;0;0
1216980;VasterClaws 3:Dragon slayer of the God world;;0 - 20,000;11;6;5;0;0;0
1217050;Shaolin vs Wutang 2;;0 - 20,000;284;45;239;2;2;2
1217060;Gunfire Reborn;;2,000,000 - 5,000,000;78561;5034;73527;2647;1449;6704
1217070;Der Geisterturm / The Ghost Tower;;0 - 20,000;9;0;9;0;0;0
1217070;Der Geisterturm / The Ghost Tower;;0 - 20,000;9;0;9;0;0;0
1217160;Log 141;;0 - 20,000;3;1;2;0;0;0
1217190;浮世万千之前世今生;;50,000 - 100,000;83;24;59;0;0;0
1217220;Immortal Legacy: The Jade Cipher;;0 - 20,000;46;29;17;0;0;0
1217250;Supermarket Simulator;;0 - 20,000;3;11;-8;0;0;0
1217260;Timeless Paradox VR;;0 - 20,000;35;9;26;0;0;0
1217280;MyBot;;0 - 20,000;3;0;3;0;0;0
1217310;One True Cuddle;;0 - 20,000;12;2;10;0;0;0
1217330;Terminal squad: Swarmites;;20,000 - 50,000;19;8;11;0;0;1
1217340;Anime Studio Tycoon;;0 - 20,000;19;13;6;0;0;0
1217350;Pentasma;;0 - 20,000;17;0;17;0;0;0
1217370;Classic Card Game Spades;;0 - 20,000;1;3;-2;0;0;0
1217380;Encore Classic Puzzle & Board Games;;0 - 20,000;23;8;15;0;0;9
1217390;Some Some Convenience Store;;200,000 - 500,000;2790;107;2683;728;728;10
1217440;Cold Winter Morning;;20,000 - 50,000;5;0;5;0;0;0
1217480;Frontier - TRS;;0 - 20,000;2;2;0;0;0;0
1217510;Terminal Singularity;;0 - 20,000;4;1;3;0;0;0
1217520;Beach Bar VR;;0 - 20,000;2;0;2;0;0;0
1217550;Guardians of Greyrock;;0 - 20,000;8;12;-4;0;0;0
1217560;GORILLA TOWN;;0 - 20,000;3;2;1;0;0;0
1217570;Lessons with Chii-chan;;0 - 20,000;101;21;80;10;10;1
1217580;Green Elephant: Epilogue;;0 - 20,000;34;7;27;0;0;0
1217610;Pro Player Life;;0 - 20,000;84;30;54;0;0;0
1217630;Network E.L.E.;;0 - 20,000;1;2;-1;0;0;0
1217640;God's Challenge;;0 - 20,000;3;2;1;0;0;0
1217660;往け！往け！マグロ - THE SHOOTING MAGURO -;;0 - 20,000;2;1;1;0;0;0
1217720;ILY;;0 - 20,000;48;3;45;0;0;0
1217750;Beyond Enemy Lines - Remastered Edition;;0 - 20,000;2;5;-3;0;0;0
1217830;Khimera: Puzzle Island;;0 - 20,000;158;5;153;0;0;3
1217850;Angry food;;0 - 20,000;1;3;-2;0;0;0
1217860;Royal Rescue SRPG;;20,000 - 50,000;8;6;2;0;0;0
1217870;Box Kid Adventures;;0 - 20,000;8;0;8;0;0;0
1217880;Recluses;;0 - 20,000;5;1;4;0;0;0
1217900;Chronostation;;0 - 20,000;20;3;17;0;0;0
1217930;VR Jetpack Game;;20,000 - 50,000;33;10;23;0;0;1
1218010;HGFaceDD;;0 - 20,000;183;7;176;0;0;9
1218020;Factory Rally Madness;;0 - 20,000;6;0;6;0;0;0
1218030;Operation Deep Magic: Cryptanalysis;;0 - 20,000;2;1;1;0;0;0
1218090;HellScape: Two Brothers;;0 - 20,000;6;4;2;0;0;0
1218110;Restoration X;;0 - 20,000;1;0;1;0;0;0
1218140;Marble Computing;;0 - 20,000;14;0;14;0;0;1
1218170;回门 Way Back Home;;0 - 20,000;277;98;179;0;0;1
1218200;Game Of Puzzles: Space;;0 - 20,000;16;4;12;0;0;0
1218210;Coromon;;100,000 - 200,000;3128;424;2704;646;476;525
1218230;Rhythmic Retro Racer;;0 - 20,000;18;9;9;0;0;0
1218250;We Went Back;;200,000 - 500,000;3606;617;2989;0;0;3
1218260;Sono;;20,000 - 50,000;379;36;343;0;0;0
1218280;Bad Guys at School;;50,000 - 100,000;1182;173;1009;97;130;14
1218300;Gjana's World;;0 - 20,000;1;0;1;0;0;0
1218310;Bombergeddon;;0 - 20,000;3;0;3;0;0;0
1218320;Zack 2: Celestine's Map;;0 - 20,000;2;3;-1;0;0;0
1218360;Luna : The Dimension Watcher;;20,000 - 50,000;25;14;11;0;0;5
1218420;rook;;0 - 20,000;4;3;1;0;0;0
1218440;Tanks 2020;;0 - 20,000;2;3;-1;0;0;0
1218480;SkyPrimal;;0 - 20,000;9;0;9;0;0;0
1218500;Galactic Mining Corp;;100,000 - 200,000;675;103;572;350;350;14
1218530;LastShot;;0 - 20,000;1;3;-2;0;0;0
1218550;Hassle 1977;;0 - 20,000;6;3;3;0;0;0
1218560;Bato: Treasures of Tibet;;0 - 20,000;10;2;8;0;0;0
1218570;The Twins;;0 - 20,000;32;8;24;0;0;0
1218580;Zerograve;;0 - 20,000;18;2;16;0;0;0
1218590;Suppressor;;0 - 20,000;0;1;-1;0;0;0
1218640;Draco Knight;;0 - 20,000;19;2;17;0;0;1
1218670;Super Orbit;;;;;0;;;
1218680;Beatdown Brawler;;0 - 20,000;9;9;0;0;0;0
1218710;Escape from the death castle;;0 - 20,000;6;5;1;0;0;0
1218740;Rakion Chaos Force;;500,000 - 1,000,000;1938;1245;693;0;0;256
1218750;Orum's Death Run;;0 - 20,000;10;0;10;0;0;0
1218760;Moe Moe World War II-3 Deluxe Edition 萌萌２次大戰（略）３豪華限定版;;0 - 20,000;7;1;6;0;0;0
1218770;Classic Card Game Canasta;;0 - 20,000;4;3;1;0;0;1
1218790;Good Goods Incorporated;;20,000 - 50,000;9;20;-11;0;0;0
1218810;Fareo: Shadowlands;;0 - 20,000;95;22;73;0;0;0
1218830;Tropical Air Hockey;;0 - 20,000;18;8;10;0;0;0
1218850;Escape Rebooted;;0 - 20,000;7;2;5;0;0;0
1218890;Ollie & Bollie: Outdoor Estate;;0 - 20,000;132;43;89;312;312;3
1218900;Zup! Z;;200,000 - 500,000;3557;99;3458;84;100;4
1218920;Sunset Kingdom;;0 - 20,000;80;27;53;0;0;0
1218930;Xecute;;0 - 20,000;0;1;-1;0;0;0
1218940;ETERNAL BLOOD;;0 - 20,000;66;19;47;0;0;0
1218950;战神七魄;;0 - 20,000;7;9;-2;0;0;0
1219010;No Game No LIFE;;0 - 20,000;0;1;-1;0;0;0
1219020;Kili's treasure;;0 - 20,000;16;3;13;0;0;0
1219030;InfiniWordSlide;;0 - 20,000;2;0;2;0;0;0
1219060;Missy's Transformation Tournament;;0 - 20,000;15;9;6;0;0;0
1219070;HexiHashi;;0 - 20,000;13;4;9;0;0;0
1219080;Dice Tactics;;0 - 20,000;5;3;2;0;0;0
1219080;Dice Tactics;;0 - 20,000;5;3;2;0;0;0
1219110;Friend Sighting;;;;;0;;;
1219120;RETRO-PIXEL COLOR PALETTE: Color by Number;;0 - 20,000;1;0;1;0;0;0
1219140;2D Vtuber Cutiecats;;0 - 20,000;1;0;1;0;0;0
1219160;Granado Espada Japan;;20,000 - 50,000;25;5;20;0;0;101
1219170;Mayhem Masters;;0 - 20,000;3;0;3;0;0;0
1219180;Skull's Solitude;;0 - 20,000;0;1;-1;0;0;0
1219220;Ghost In The Barn House;;0 - 20,000;5;3;2;0;0;0
1219230;Bingo Hall;;0 - 20,000;19;5;14;0;0;0
1219300;Contract;;0 - 20,000;7;3;4;0;0;0
1219310;欢乐逗病毒TD;;50,000 - 100,000;1;0;1;0;0;0
1219320;Pets Sniper Shooting;;0 - 20,000;27;3;24;0;0;0
1219420;Millions of Minions: An Underground Adventure;;0 - 20,000;11;1;10;0;0;0
1219450;Inglorious Pirate;;0 - 20,000;9;4;5;0;0;0
1219480;Poly Squad;;50,000 - 100,000;160;137;23;0;0;0
1219500;Basketball Madness;;0 - 20,000;11;2;9;0;0;0
1219520;CORVUS;;0 - 20,000;1;5;-4;0;0;0
1219540;Last Slice;;0 - 20,000;57;7;50;0;0;0
1219580;Prison Forever;;0 - 20,000;29;6;23;0;0;0
1219590;HEAT REBORN;;50,000 - 100,000;157;101;56;0;0;4
1219600;PARADOX;;0 - 20,000;0;1;-1;0;0;0
1219610;Courage and Honor;;0 - 20,000;14;16;-2;0;0;0
1219650;K-Point Ski Jumping;;0 - 20,000;85;25;60;0;0;4
1219700;Catlandia: Crisis at Fort Pawprint;;0 - 20,000;10;1;9;0;0;0
1219730;The Manse on Soracca;;0 - 20,000;12;0;12;0;0;0
1219740;Knockout Daddy;;0 - 20,000;17;3;14;0;0;0
1219740;Knockout Daddy;;0 - 20,000;17;3;14;0;0;0
1219820;Pyramid Defense;;0 - 20,000;2;0;2;0;0;0
1219860;Monster Girls You-ki Chan;;0 - 20,000;22;6;16;0;0;0
1219890;The Last Turret;;0 - 20,000;0;1;-1;0;0;0
1219910;Spider Fear;;0 - 20,000;4;5;-1;0;0;0
1219940;US Spy: Mission in Russia;;20,000 - 50,000;150;49;101;0;0;0
1219950;Evil Democracy: 1932;;0 - 20,000;368;113;255;93;171;1
1219980;Bloody Ending;;0 - 20,000;5;0;5;0;0;0
1220010;Home Behind 2;;200,000 - 500,000;5588;798;4790;1748;1650;440
1220040;Jumping Mellow;;0 - 20,000;6;0;6;0;0;0
1220070;Underground Miner;;0 - 20,000;1;2;-1;0;0;0
1220080;Racing Bike Fight (Corona Virus Lockdown Special);;0 - 20,000;15;4;11;0;0;0
1220100;Tentacular;;0 - 20,000;49;3;46;0;0;1
1220120;Dungeon Origins;;0 - 20,000;17;5;12;0;0;0
1220140;Cartel Tycoon;;200,000 - 500,000;2005;565;1440;341;348;118
1220150;Blue Fire;;100,000 - 200,000;1746;385;1361;129;30;6
1220160;Virtual Race Car Engineer 2020;;0 - 20,000;9;4;5;0;0;2
1220170;Eville;;20,000 - 50,000;254;63;191;0;0;16
1220200;PiraCrash!;;0 - 20,000;22;1;21;0;0;0
1220330;Impressions;;0 - 20,000;10;2;8;0;0;0
1220340;Schizophrenia;;0 - 20,000;9;9;0;0;0;0
1220440;Pick, shoot, repeat!;;0 - 20,000;1;0;1;0;0;0
1220460;Naked Little Dude;;0 - 20,000;6;1;5;0;0;0
1220510;Your Quest 2;;0 - 20,000;3;3;0;0;0;0
1220520;Chuhou Joutai;;0 - 20,000;7;0;7;0;0;0
1220540;Maiden and Swordsman;;0 - 20,000;0;2;-2;0;0;0
1220580;Sky Pirates of Actorius;;0 - 20,000;0;1;-1;0;0;0
1220600;Edengrall;;0 - 20,000;15;0;15;0;0;0
1220680;Spooky Spins Remastered - Casino Slot Simulations;;0 - 20,000;2;1;1;0;0;0
1220690;RESPITE 2.0;;0 - 20,000;10;1;9;0;0;0
1220710;Ace In Space;;0 - 20,000;30;4;26;0;0;0
1220830;BATTLE POLYGON;;0 - 20,000;13;2;11;0;0;0
1220840;Retirement Simulator;;100,000 - 200,000;1487;2564;-1077;151;151;3
1220850;Kingdom vs Zombies;;0 - 20,000;5;1;4;0;0;0
1220880;陆大迹神Ⅱ;;0 - 20,000;5;1;4;0;0;0
1220890;Ghone is gone;;0 - 20,000;42;24;18;0;0;0
1220900;Astonia: The Return of Yendor;;20,000 - 50,000;100;19;81;0;0;0
1220910;Dark Zone;;0 - 20,000;1;2;-1;0;0;0
1220930;Metaphobia;;50,000 - 100,000;341;58;283;0;0;0
1220980;Where's Home?;;0 - 20,000;1;2;-1;0;0;0
1220990;Great Utopia;;0 - 20,000;16;11;5;0;0;0
1221050;Ultimate Low Poly Pet;;0 - 20,000;27;12;15;0;0;1
1221070;Alien street battle;;0 - 20,000;7;1;6;0;0;1
1221080;Strip 4: Classmate Study;;0 - 20,000;38;16;22;0;0;1
1221230;Derange;;0 - 20,000;34;11;23;0;0;0
1221240;Tavern Cards;;0 - 20,000;36;20;16;0;0;0
1221250;NORCO;;100,000 - 200,000;1216;82;1134;286;286;18
1221280;Run Dude;;0 - 20,000;42;3;39;0;0;0
1221320;Self-Checkout Unlimited;;0 - 20,000;55;6;49;0;0;0
1221330;One Shot;;20,000 - 50,000;4;0;4;0;0;0
1221390;VOXEL HORIZON;;0 - 20,000;2;0;2;0;0;2
1221400;Trusty Brothers;;0 - 20,000;40;0;40;0;0;0
1221420;零怨 The curse of the dead;;0 - 20,000;22;13;9;0;0;0
1221430;Wat A Life;;0 - 20,000;2;0;2;0;0;0
1221440;Path of Redemption;;0 - 20,000;53;11;42;0;0;0
1221460;Castle Creator;;0 - 20,000;6;12;-6;0;0;0
1221510;IMM Defense 2;;0 - 20,000;3;1;2;0;0;0
1221520;Brimhelm;;0 - 20,000;1;1;0;0;0;0
1221540;KUUKIYOMI: Consider It;;20,000 - 50,000;336;85;251;52;52;2
1221590;Formula Car Racing Simulator;;0 - 20,000;35;12;23;0;0;0
1221600;Raccoon The Miner;;0 - 20,000;12;9;3;0;0;0
1221620;平妖奇谭 Kungfu & Monster;;0 - 20,000;21;27;-6;0;0;0
1221630;Drifting in Space;;0 - 20,000;9;1;8;0;0;0
1221640;Ultra Foodmess;;0 - 20,000;80;4;76;56;56;4
1221650;Boulder Dash Deluxe;;0 - 20,000;13;4;9;0;0;0
1221660;Little Tennis;;0 - 20,000;1;1;0;0;0;0
1221730;Anti-Science Brigade;;0 - 20,000;1;0;1;0;0;0
1221800;Anime Artist 2: Lovely Danya;;0 - 20,000;73;9;64;32;32;0
1221800;Anime Artist 2: Lovely Danya;;0 - 20,000;73;9;64;32;32;0
1221830;Farmer Pug Dash;;0 - 20,000;9;1;8;0;0;0
1221860;The Revenge of Johnny Bonasera: Episode 4;;0 - 20,000;19;1;18;0;0;0
1221880;Frostfire Planet;;0 - 20,000;7;0;7;0;0;0
1221890;SCP: One More Life;;0 - 20,000;14;5;9;0;0;0
1221980;Family Tree Heritage Gold;;0 - 20,000;1;0;1;0;0;0
1221990;Chronicle: Unit Eight;;0 - 20,000;32;7;25;0;0;1
1221990;Chronicle: Unit Eight;;0 - 20,000;32;7;25;0;0;1
1222000;Lights, Camera, Reaction!;;0 - 20,000;5;2;3;0;0;0
1222020;BustaShip;;0 - 20,000;21;0;21;0;0;0
1222040;Offroad Mania;;20,000 - 50,000;417;25;392;50;50;3
1222050;Touhou Mechanical Scrollery | 幻想討幻経;;20,000 - 50,000;145;130;15;0;0;0
1222050;Touhou Mechanical Scrollery | 幻想討幻経;;20,000 - 50,000;145;130;15;0;0;0
1222060;千里の棋譜 ～現代将棋ミステリー～;;0 - 20,000;6;1;5;0;0;0
1222080;Feeling Square?;;0 - 20,000;1;1;0;0;0;0
1222090;Nevaeh;;0 - 20,000;40;11;29;0;0;0
1222120;Valentines Desire - Casino Slot Simulations;;0 - 20,000;2;1;1;0;0;0
1222130;Battlecraft - Tactics Online;;0 - 20,000;13;8;5;0;0;0
1222140;Detroit: Become Human;;1,000,000 - 2,000,000;71568;4613;66955;937;686;1253
1222160;Chinese Brush Simulator;;0 - 20,000;88;8;80;0;0;0
1222170;Cutish;;0 - 20,000;27;8;19;0;0;0
1222180;Retro Drift;;0 - 20,000;25;10;15;0;0;0
1222200;UldreVoid;;0 - 20,000;29;6;23;0;0;0
1222210;Extremely Realistic Siege Warfare Simulator;;0 - 20,000;80;17;63;0;0;4
1222220;7WORLDS: The Dreaming Dale;;0 - 20,000;2;1;1;0;0;0
1222230;Space Ranger VR;;0 - 20,000;1;0;1;0;0;0
1222240;Mineirinho Wildtides DC;;0 - 20,000;24;25;-1;0;0;0
1222240;Mineirinho Wildtides DC;;0 - 20,000;24;25;-1;0;0;0
1222250;La Historia De;;0 - 20,000;11;0;11;0;0;0
1222260;The Lost Brewery;;0 - 20,000;1;2;-1;0;0;0
1222270;Gunbrick: Reloaded;;0 - 20,000;21;1;20;0;0;0
1222300;Into The Flames;;50,000 - 100,000;736;92;644;165;165;70
1222340;Sockventure;;0 - 20,000;68;3;65;0;0;1
1222360;Cybershoes;;0 - 20,000;15;2;13;0;0;1
1222370;Necromunda: Hired Gun;;200,000 - 500,000;3895;1866;2029;190;143;32
1222380;Spookyard;;0 - 20,000;6;0;6;0;0;0
1222390;Shape Arena;;0 - 20,000;5;1;4;0;0;0
1222400;The Soul Stone War;;0 - 20,000;63;23;40;0;0;2
1222480;Slotracers VR;;0 - 20,000;12;3;9;0;0;0
1222540;Gastova: The Witches of Arkana;;0 - 20,000;16;0;16;0;0;2
1222570;Red Ronin;;20,000 - 50,000;122;15;107;0;0;0
1222600;Stocksynd House;;0 - 20,000;43;8;35;5;5;0
1222610;Model Kit Simulator VR;;0 - 20,000;8;5;3;0;0;0
1222670;The Sims 4;;5,000,000 - 10,000,000;76681;11467;65214;1690;283;38573
1222680;Need for Speed Heat;;2,000,000 - 5,000,000;69209;14203;55006;965;379;2193
1222690;Dragon Age Inquisition;;500,000 - 1,000,000;9033;2877;6156;1609;193;1450
1222700;A Way Out;;1,000,000 - 2,000,000;38239;5190;33049;372;359;427
1222720;Journey To Planet Earth;;0 - 20,000;8;10;-2;0;0;0
1222730;STAR WARS: Squadrons;;500,000 - 1,000,000;16172;7508;8664;543;345;111
1222800;VALKYRIE CONNECT;;200,000 - 500,000;683;189;494;0;0;433
1222840;Super Squash;;0 - 20,000;4;1;3;0;0;0
1222870;黄河大合唱 Song of Yellow River;;0 - 20,000;64;17;47;0;0;0
1222940;Cragls;;20,000 - 50,000;17;4;13;0;0;0
1222980;Xenovaders;;0 - 20,000;6;0;6;0;0;0
1223020;Minnano Gensokyo Single;;0 - 20,000;179;9;170;0;0;1
1223090;Emily Archer and the Curse of Tutankhamun;;0 - 20,000;7;9;-2;0;0;0
1223110;BalloonBoyBob;;0 - 20,000;30;1;29;0;0;0
1223160;CyberLink PowerDVD 20 Ultra;;0 - 20,000;0;1;-1;0;0;0
1223200;Cardsweeper;;20,000 - 50,000;1;0;1;0;0;0
1223210;Zombie Towns;;0 - 20,000;5;4;1;0;0;0
1223260;Castle Torgeath Redux;;0 - 20,000;7;0;7;0;0;0
1223270;Dish Life: The Game;;0 - 20,000;5;3;2;0;0;0
1223350;War of the Barrenlands;;0 - 20,000;7;11;-4;0;0;0
1223370;Beardy McStrongarm;;0 - 20,000;7;0;7;0;0;0
1223380;Beyond The Underworld;;0 - 20,000;11;6;5;0;0;0
1223390;A Player's Heart;;0 - 20,000;10;2;8;0;0;0
1223500;Umurangi Generation;;50,000 - 100,000;753;55;698;0;0;1
1223550;Buddy Bash;;0 - 20,000;3;0;3;0;0;0
1223660;The Savana;;0 - 20,000;10;7;3;0;0;0
1223670;Super Rocket Ride;;0 - 20,000;2;0;2;0;0;0
1223680;Mad Ball;;20,000 - 50,000;63;22;41;0;0;0
1223760;Recoil;;0 - 20,000;1;0;1;0;0;0
1223870;Sakura Hime 2;;20,000 - 50,000;648;49;599;20;28;1
1223880;ManaTech;;0 - 20,000;2;0;2;0;0;0
1223910;Tennis World Tour 2;;0 - 20,000;112;143;-31;0;0;6
1224010;KIWAYA;;0 - 20,000;1;0;1;0;0;0
1224020;Creepy Tale;;100,000 - 200,000;1634;251;1383;0;0;3
1224120;Jerking Off In Class Simulator;;0 - 20,000;24;4;20;0;0;0
1224130;DREAMLIVE;;0 - 20,000;19;8;11;0;0;0
1224290;Horizon's Gate;;50,000 - 100,000;689;21;668;0;0;22
1224320;Secret City: Chalk of Fate Collector's Edition;;0 - 20,000;2;0;2;0;0;0
1224380;Somewhere: Sect of Relic;;0 - 20,000;19;11;8;0;0;0
1224420;Smashroom;;0 - 20,000;6;1;5;0;0;0
1224450;My Jigsaw Adventures - Roads of Life;;0 - 20,000;62;2;60;0;0;0
1224480;Fire Escape;;0 - 20,000;24;12;12;22;22;0
1224490;Inner Worlds;;0 - 20,000;6;0;6;0;0;0
1224600;G String;;20,000 - 50,000;600;122;478;303;303;0
1224640;Jump To Die 2 - Bloody Soul;;0 - 20,000;32;13;19;0;0;0
1224650;Super Arcade Boy in Goodbye Greenies;;20,000 - 50,000;1;0;1;0;0;0
1224710;洞穴探险队 Caver;;0 - 20,000;23;1;22;0;0;0
1224720;Kowi Ishto: Battle of Akonoli;;0 - 20,000;1;4;-3;0;0;0
1224840;Frozen Memories;;0 - 20,000;79;3;76;0;0;0
1224900;Halo Beats!;;0 - 20,000;61;4;57;0;0;0
1225040;A Mysterious Gallery;;0 - 20,000;2;0;2;0;0;0
1225060;NAIRI: Rising Tide - Prologue;;0 - 20,000;22;2;20;0;0;0
1225070;Family Mysteries: Poisonous Promises;;0 - 20,000;140;39;101;0;0;9
1225070;Family Mysteries: Poisonous Promises;;0 - 20,000;140;39;101;0;0;9
1225100;SSTR;;0 - 20,000;3;1;2;0;0;0
1225110;Flirt;;0 - 20,000;31;31;0;0;0;0
1225120;Krystopia: Nova´s Journey;;0 - 20,000;24;3;21;0;0;0
1225130;The Adventures of Ten and Till;;0 - 20,000;35;1;34;0;0;0
1225220;Space Avengers;;0 - 20,000;4;7;-3;0;0;0
1225240;Humble Rumble;;0 - 20,000;1;0;1;0;0;0
1225250;ENCYCLE;;0 - 20,000;1;0;1;0;0;0
1225260;Survive In Russia;;0 - 20,000;41;18;23;0;0;0
1225260;Survive In Russia;;0 - 20,000;41;18;23;0;0;0
1225330;NBA 2K21;;2,000,000 - 5,000,000;16302;22872;-6570;5691;3910;904
1225370;Blast Rush Classic;;0 - 20,000;2;1;1;0;0;0
1225380;Into the Infinite;;0 - 20,000;6;3;3;0;0;0
1225550;Draft Day Sports: College Football 2020;;0 - 20,000;12;10;2;0;0;0
1225560;Unravel;;200,000 - 500,000;3250;317;2933;296;368;49
1225570;Unravel Two;;500,000 - 1,000,000;3593;719;2874;207;136;127
1225580;Fe;;50,000 - 100,000;528;134;394;62;62;1
1225590;Sea of Solitude;;100,000 - 200,000;1370;256;1114;129;184;4
1225600;The Amazing Fantastics: Issue 1;;0 - 20,000;22;7;15;0;0;0
1225610;∀kashicverse -Malicious Wake-;;0 - 20,000;35;1;34;0;0;0
1225640;First Day: Home Defender;;0 - 20,000;10;5;5;0;0;1
1225660;Athena Trivia;;0 - 20,000;6;6;0;0;0;0
1225710;Escape The Manor;;0 - 20,000;4;1;3;0;0;0
1225780;他人世界末 On-looker;;100,000 - 200,000;2084;135;1949;0;0;13
1225790;Heat and Run;;0 - 20,000;28;2;26;0;0;2
1225810;FOS;;50,000 - 100,000;269;66;203;0;0;0
1225820;Hermitage: Strange Case Files;;0 - 20,000;23;7;16;0;0;1
1225840;BeatBeat;;20,000 - 50,000;37;1;36;0;0;0
1225850;NonetEnsemble:MagicworkLabyrinth;;0 - 20,000;11;5;6;0;0;0
1225910;Desert of Doitjma;;0 - 20,000;0;1;-1;0;0;0
1225920;Pixelfence;;20,000 - 50,000;4;5;-1;0;0;0
1225930;Pixel Dominance;;0 - 20,000;15;5;10;0;0;0
1225940;I'm Calling The Cops!;;0 - 20,000;3;0;3;0;0;0
1225980;The Big Heap;;0 - 20,000;4;0;4;0;0;0
1226000;Nations At War Digital Core Game;;0 - 20,000;73;19;54;0;0;0
1226010;Storm Chasers: Tornado Islands;;0 - 20,000;21;1;20;0;0;2
1226020;机忆;;0 - 20,000;52;20;32;0;0;0
1226070;Questinarium;;0 - 20,000;14;18;-4;0;0;0
1226100;ROBOTIX: The Escape;;0 - 20,000;10;12;-2;0;0;0
1226170;Forest of MATH;;0 - 20,000;2;0;2;0;0;0
1226180;Bus Parking 3D;;0 - 20,000;0;1;-1;0;0;0
1226210;Fever Cabin;;0 - 20,000;8;7;1;0;0;0
1226230;Escape From The Grim;;0 - 20,000;1;0;1;0;0;0
1226250;Synthesis: Mind, Body, and Soul;;0 - 20,000;21;13;8;0;0;0
1226420;The Tide Intro;;20,000 - 50,000;0;1;-1;0;0;0
1226470;Shadow Arena;;1,000,000 - 2,000,000;3102;2441;661;40;30;0
1226490;Lost In Ferry VR;;0 - 20,000;14;2;12;0;0;0
1226510;Trigon: Space Story;;50,000 - 100,000;739;332;407;110;110;17
1226530;Trap Legend;;0 - 20,000;515;24;491;99;137;1
1226610;Pandora Galaxy;;0 - 20,000;13;4;9;0;0;0
1226690;Great British Railway Journeys;;0 - 20,000;32;15;17;0;0;2
1226760;Bridge Crawler;;0 - 20,000;2;0;2;0;0;0
1226820;Vigil of Glory - Part I;;0 - 20,000;0;1;-1;0;0;0
1226840;Tribloos;;0 - 20,000;11;1;10;0;0;0
1226880;Hard, Fast, & Flashy;;0 - 20,000;8;1;7;0;0;0
1226890;Stellaxy;;0 - 20,000;7;1;6;0;0;0
1226920;Riposte!;;0 - 20,000;6;0;6;0;0;0
1226940;Nonogram Animal Griddlers;;0 - 20,000;2;3;-1;0;0;0
1226960;My Name is Sarah;;0 - 20,000;22;23;-1;0;0;0
1226990;Mechanica;;0 - 20,000;385;107;278;0;0;1
1227000;Black Butterfly;;0 - 20,000;19;18;1;0;0;0
1227010;Die Wolf;;0 - 20,000;12;3;9;0;0;0
1227040;Devastation - Annihilate the Alien Race;;0 - 20,000;1;0;1;0;0;0
1227050;Synonym;;0 - 20,000;1;0;1;0;0;0
1227090;Crapht Box;;0 - 20,000;3;1;2;0;0;0
1227130;space vanguard;;0 - 20,000;13;0;13;0;0;0
1227150;Jump Boy;;0 - 20,000;0;2;-2;0;0;0
1227160;MENTAL;;0 - 20,000;56;24;32;0;0;1
1227190;sotas/时空幽灵;;0 - 20,000;1;1;0;0;0;0
1227250;小镇放置修仙;;0 - 20,000;10;12;-2;0;0;1
1227260;Alder's Blood: Prologue;;50,000 - 100,000;97;29;68;0;0;0
1227280;Despot's Game: Dystopian Battle Simulator;;50,000 - 100,000;2141;352;1789;331;420;48
1227320;Shutter Nyan! Enhanced Edition;;0 - 20,000;25;1;24;0;0;0
1227360;Fighting Clans;;0 - 20,000;30;21;9;0;0;0
1227390;Mazovian Adventure;;0 - 20,000;8;4;4;0;0;0
1227400;Over the Alps;;0 - 20,000;190;16;174;0;0;0
1227530;Partisans 1941;;500,000 - 1,000,000;5262;1072;4190;1132;1321;79
1227570;Lotus Reverie: First Nexus;;0 - 20,000;42;7;35;0;0;1
1227580;Trasta;;20,000 - 50,000;1;9;-8;0;0;0
1227650;Bang-On Balls: Chronicles;;50,000 - 100,000;2186;54;2132;18;18;28
1227680;Berserker;;20,000 - 50,000;8;2;6;0;0;0
1227690;Severed Steel;;100,000 - 200,000;2425;138;2287;133;176;11
1227730;Myridian: The Last Stand;;0 - 20,000;6;2;4;0;0;0
1227740;Draught Kraft;;0 - 20,000;4;1;3;0;0;0
1227750;Puzzle - LINES AND KNOTS;;0 - 20,000;196;29;167;0;0;2
1227760;Zip! Speedster of Valiant City;;0 - 20,000;3;3;0;0;0;0
1227780;Taur;;50,000 - 100,000;1248;293;955;1106;1207;12
1227800;Quantum League - Free Open Beta;;200,000 - 500,000;558;227;331;13;14;0
1227830;Mister Shizz: Don't Let The Shizz Hit The Fan!;;0 - 20,000;0;1;-1;0;0;0
1227860;Plastris;;20,000 - 50,000;30;2;28;0;0;0
1227890;Summer Memories;;200,000 - 500,000;9566;651;8915;393;376;347
1227900;S0;;0 - 20,000;2;0;2;0;0;0
1227910;Roguelite 2;;0 - 20,000;24;6;18;0;0;1
1227930;Travel of Heros;;0 - 20,000;1;0;1;0;0;0
1228320;Dungeon Looter;;0 - 20,000;21;3;18;0;0;0
1228330;The Last One Month;;0 - 20,000;81;14;67;0;0;0
1228410;WATCH / 透视;;0 - 20,000;45;7;38;0;0;0
1228430;Pair-a-Site;;50,000 - 100,000;17;0;17;0;0;0
1228440;Maritime Hegemony： Carrier Travel  海上霸主：航空母舰之旅;;0 - 20,000;9;8;1;0;0;0
1228450;Speed And Survive Ball, 速度与幸存之球;;0 - 20,000;1;0;1;0;0;0
1228470;Ship Surveyor Through the Ages - VR;;0 - 20,000;8;0;8;0;0;0
1228490;Politicking;;0 - 20,000;5;1;4;0;0;0
1228500;1428: Shadows over Silesia;;0 - 20,000;105;7;98;0;0;1
1228510;SOUND FORGE Audio Studio 14 Steam Edition;;0 - 20,000;11;11;0;1;1;0
1228520;[Chilla's Art] The Convenience Store | 夜勤事件;;50,000 - 100,000;1706;303;1403;94;102;10
1228560;Boxman's Struggle;;20,000 - 50,000;204;34;170;366;366;0
1228570;Gamer Shop Simulator;;0 - 20,000;64;89;-25;0;0;2
1228600;Blankspace;;0 - 20,000;67;1;66;0;0;0
1228630;Patched world;;0 - 20,000;3;2;1;0;0;0
1228670;Malvin`s Prehistoric Adventures;;0 - 20,000;8;3;5;0;0;0
1228680;Goblet Cave;;0 - 20,000;17;4;13;0;0;0
1228700;GodOrEvil.1;;0 - 20,000;3;1;2;0;0;0
1228730;Zulup;;0 - 20,000;12;7;5;0;0;0
1228760;Smear FX;;0 - 20,000;11;2;9;0;0;0
1228790;Dark Judgement;;0 - 20,000;19;2;17;0;0;0
1228820;Blind Battle Championship;;0 - 20,000;4;0;4;0;0;0
1228840;Mission Indeed 2.0 FPS;;0 - 20,000;0;1;-1;0;0;0
1228860;The Unseen Fears: Ominous Talent Collector's Edition;;0 - 20,000;5;1;4;0;0;0
1228870;Bartlow's Dread Machine;;0 - 20,000;53;6;47;0;0;0
1228880;Crisp Cube;;0 - 20,000;3;1;2;0;0;0
1228910;Ragdoll Party Online;;0 - 20,000;23;9;14;0;0;0
1228920;Invaden;;0 - 20,000;1;2;-1;0;0;0
1228950;Street Sweeper;;0 - 20,000;9;4;5;0;0;0
1228960;Harolds Harem: The Neckoning;;0 - 20,000;11;0;11;0;0;0
1228970;Elemental Abyss 元素之渊;;0 - 20,000;19;0;19;0;0;0
1229010;Cast VR;;0 - 20,000;5;3;2;0;0;0
1229030;A Hand With Many Fingers;;20,000 - 50,000;196;26;170;0;0;1
1229060;Dungeon and Puzzles;;0 - 20,000;98;0;98;0;0;2
1229190;ArtPulse;;0 - 20,000;3;0;3;0;0;0
1229200;Dreamtopia;;0 - 20,000;2;3;-1;0;0;0
1229240;Chained Echoes;;50,000 - 100,000;2402;208;2194;453;544;750
1229250;Uniseas;;0 - 20,000;8;12;-4;0;0;0
1229260;Monster Girls and the Mysterious Adventure;;0 - 20,000;104;11;93;0;0;7
1229270;Onirike;;0 - 20,000;43;5;38;0;0;2
1229280;Hold 10 Seconds;;0 - 20,000;18;3;15;0;0;0
1229310;Godking: Master of Rituals;;0 - 20,000;33;16;17;0;0;0
1229380;Everhood;;200,000 - 500,000;9400;433;8967;365;375;55
1229390;TOMOMI;;20,000 - 50,000;85;0;85;0;0;0
1229420;Company of Crime;;20,000 - 50,000;93;91;2;0;0;2
1229450;Yuhha: Stolen Treasure;;0 - 20,000;1;0;1;0;0;0
1229460;Dice Legacy;;50,000 - 100,000;594;262;332;377;377;5
1229490;ULTRAKILL;;1,000,000 - 2,000,000;51635;786;50849;1048;621;1079
1229500;Shieldmaiden: Remix Edition;;0 - 20,000;134;18;116;0;0;1
1229570;Imagine Lifetimes;;0 - 20,000;71;37;34;0;0;2
1229580;Disc Room;;0 - 20,000;628;38;590;75;75;12
1229590;Choco Pixel 2;;0 - 20,000;20;1;19;0;0;0
1229640;The search for DEEP loving;;0 - 20,000;0;1;-1;0;0;0
1229650;Shitty Cactus;;0 - 20,000;25;2;23;0;0;1
1229720;Little Big Rabbits;;0 - 20,000;2;1;1;0;0;0
1229730;Achievement Clicker;;0 - 20,000;27;24;3;0;0;1
1229740;LUX SINE;;20,000 - 50,000;20;6;14;0;0;0
1229880;Koumajou Remilia: Scarlet Symphony;;50,000 - 100,000;168;73;95;0;0;2
1229900;ARIA CHRONICLE;;50,000 - 100,000;887;227;660;0;0;7
1229960;Dark Abyss;;0 - 20,000;10;2;8;0;0;0
1230000;Curse of Eternity;;0 - 20,000;15;4;11;0;0;2
1230010;A.R.M.: Absolutely Reliable Machine;;0 - 20,000;16;0;16;0;0;0
1230020;Straight Battler VI;;0 - 20,000;1;0;1;0;0;0
1230100;Fantastic Fishing;;0 - 20,000;5;7;-2;0;0;0
1230140;ATRI -My Dear Moments-;;200,000 - 500,000;10695;125;10570;299;384;103
1230200;Pendula Swing - The Complete Journey;;0 - 20,000;36;8;28;0;0;0
1230210;Groupthink;;0 - 20,000;5;5;0;0;0;0
1230410;Chaos;;200,000 - 500,000;3270;418;2852;0;0;9
1230430;Crocodine: The Buffet;;0 - 20,000;4;1;3;0;0;0
1230510;Beyond Crimson Stars;;0 - 20,000;71;9;62;0;0;0
1230560;Cyber Attack;;20,000 - 50,000;107;36;71;192;192;0
1230570;Shotgun n  Zombies;;200,000 - 500,000;4;4;0;0;0;0
1230650;Proyecto Flamingo X1;;0 - 20,000;17;0;17;0;0;0
1230660;TRF - The Race Factory;;0 - 20,000;13;0;13;0;0;0
1230790;Empty Universe;;0 - 20,000;0;2;-2;0;0;0
1230800;Beach Buggy Racing 2: Island Adventure;;0 - 20,000;357;34;323;178;178;8
1230840;Matcha Warriors;;0 - 20,000;3;0;3;0;0;0
1230860;2MD: VR Football Evolution;;0 - 20,000;59;9;50;0;0;0
1230870;Parameter;;0 - 20,000;1;1;0;0;0;0
1230880;Gladii;;0 - 20,000;2;0;2;0;0;0
1230930;Inside The Computer;;0 - 20,000;17;0;17;0;0;0
1230980;云巅;;0 - 20,000;10;13;-3;0;0;0
1230990;Banzai Escape 2;;0 - 20,000;18;7;11;0;0;0
1231000;Witchsword Remake;;0 - 20,000;0;1;-1;0;0;0
1231040;Blendy 2 Dolls Factory;;0 - 20,000;2;3;-1;0;0;0
1231090;Battle of Brains;;0 - 20,000;3;3;0;0;0;0
1231100;Breath of the Forest;;0 - 20,000;3;1;2;0;0;0
1231120;Staying Together;;0 - 20,000;5;0;5;0;0;0
1231130;Roko-Loko into Ratozinger's Castle;;0 - 20,000;9;2;7;0;0;0
1231180;MEDAL OF LEGENDS;;0 - 20,000;0;3;-3;0;0;0
1231190;The World Of Others;;0 - 20,000;18;7;11;0;0;0
1231270;Dead's Prison Watcher;;0 - 20,000;2;0;2;0;0;0
1231440;驱灵;;0 - 20,000;3;0;3;0;0;0
1231460;Candy Disaster - Tower Defense;;0 - 20,000;211;24;187;1958;1958;1
1231520;Farmtale;;0 - 20,000;174;72;102;756;756;2
1231530;Path of the Sramana;;0 - 20,000;14;10;4;0;0;0
1231540;Test Tube Titans;;0 - 20,000;48;13;35;0;0;0
1231570;Lonecastle;;0 - 20,000;7;0;7;0;0;0
1231590;Isle of Ewe;;100,000 - 200,000;549;79;470;0;0;1
1231640;Galactic Protection Squad | Episode 1;;0 - 20,000;7;0;7;0;0;0
1231670;Chunker;;0 - 20,000;24;10;14;0;0;0
1231710;Super Foosball;;0 - 20,000;8;3;5;0;0;0
1231720;Freedom Isn't Free 资本之乱;;0 - 20,000;1;0;1;0;0;0
1231740;Sorbetta: Gravely in Debt;;0 - 20,000;12;1;11;0;0;0
1231750;Classic Card Game Euchre;;0 - 20,000;3;2;1;0;0;1
1231760;Classic Card Game Gin Rummy;;0 - 20,000;1;3;-2;0;0;0
1231770;Classic Card Game Go Fish;;0 - 20,000;1;0;1;0;0;0
1231780;Classic Card Game Hearts;;0 - 20,000;0;3;-3;0;0;0
1231800;Classic Card Game Pinochle;;0 - 20,000;0;1;-1;0;0;0
1231810;Classic Card Game Mahjong;;0 - 20,000;1;0;1;0;0;0
1231820;Classic Card Game Poker Pack;;0 - 20,000;1;3;-2;0;0;0
1231840;Climber: Sky is the Limit;;0 - 20,000;76;29;47;0;0;3
1231880;Haiku, the Robot;;50,000 - 100,000;1278;106;1172;357;684;20
1231900;Porsche Hall of Legends VR;;20,000 - 50,000;15;10;5;0;0;0
1231920;Convoy Mod Tools;;0 - 20,000;1;0;1;0;0;0
1231940;Cardnarok: Raid with Gods;;0 - 20,000;86;20;66;0;0;0
1231950;The Innsmouth Case;;0 - 20,000;81;33;48;0;0;1
1231950;The Innsmouth Case;;0 - 20,000;81;33;48;0;0;1
1231970;Police Response VR : Disturbance;;0 - 20,000;72;8;64;0;0;1
1232010;Radical Rabbit Stew;;0 - 20,000;113;4;109;0;0;1
1232100;BroodStar;;20,000 - 50,000;65;3;62;0;0;0
1232120;Aether Field;;0 - 20,000;13;5;8;0;0;0
1232130;BEAR, VODKA, STALINGRAD!;;20,000 - 50,000;798;42;756;368;369;0
1232140;Blue Drifter;;0 - 20,000;25;4;21;0;0;0
1232150;A Little Golf Journey;;0 - 20,000;55;4;51;0;0;0
1232180;Sakuya Izayoi Gives You Advice And Dabs;;20,000 - 50,000;1809;36;1773;69;112;8
1232230;Relax Simulator;;0 - 20,000;9;2;7;0;0;0
1232260;Space Mega Force Man;;0 - 20,000;5;1;4;0;0;0
1232290;Oasis Defense;;0 - 20,000;5;0;5;0;0;0
1232310;Bonfire;;0 - 20,000;10;3;7;0;0;1
1232330;Theyest Thou;;0 - 20,000;79;5;74;0;0;0
1232410;孙美琪疑案 第二季;;100,000 - 200,000;8;6;2;0;0;0
1232420;Atlantica Global;;100,000 - 200,000;527;281;246;0;0;151
1232430;Counter Fight 4;;0 - 20,000;14;4;10;0;0;0
1232460;Onee Chanbara ORIGIN;;50,000 - 100,000;705;253;452;381;381;3
1232500;Super Hiking  Simulator 2020;;0 - 20,000;11;3;8;0;0;0
1232510;Teleporter: World of Gamers (Alpha);;0 - 20,000;44;9;35;0;0;0
1232570;Paper Beast;;0 - 20,000;476;21;455;60;60;2
1232580;Knock on the Coffin Lid;;0 - 20,000;498;88;410;1895;1895;17
1232590;DREAMGATE;;0 - 20,000;69;19;50;0;0;1
1232610;Panic Station VR;;0 - 20,000;29;7;22;0;0;0
1232640;Alpaca Ball: Allstars ;;0 - 20,000;72;4;68;0;0;0
1232650;Goblin treasure;;0 - 20,000;0;1;-1;0;0;0
1232670;Mercenaries VR;;0 - 20,000;10;7;3;0;0;0
1232710;Rustler: Prologue;;50,000 - 100,000;310;88;222;0;0;0
1232730;Rune The First Wanderer;;0 - 20,000;21;13;8;0;0;0
1232810;Savage Halloween;;0 - 20,000;82;9;73;0;0;1
1232830;BoyandBox;;0 - 20,000;7;0;7;0;0;0
1232890;DumbBots;;0 - 20,000;5;2;3;0;0;0
1232920;Parliament - Parlement;;20,000 - 50,000;17;0;17;0;0;0
1232940;The Under Presents;;0 - 20,000;78;8;70;475;475;1
1232980;Alien 911 Prologue;;20,000 - 50,000;50;21;29;0;0;0
1233020;Betrayal;;0 - 20,000;2;2;0;0;0;0
1233030;Armorik the Viking: The Eight Conquests;;50,000 - 100,000;2;0;2;0;0;0
1233040;Wardens;;0 - 20,000;3;1;2;0;0;0
1233120;Street Racing 2020;;;;;0;;;
1233170;Utopia Colony;;0 - 20,000;67;28;39;0;0;0
1233170;Utopia Colony;;0 - 20,000;67;28;39;0;0;0
1233200;Wanko of Marriage ~Welcome to The Dog's Tail!~;;0 - 20,000;7;4;3;0;0;0
1233230;You Are A Bird;;0 - 20,000;6;3;3;0;0;0
1233240;墨游记 Inkball adventures;;0 - 20,000;1;0;1;0;0;0
1233250;Abracadabrew;;0 - 20,000;35;3;32;0;0;0
1233250;Abracadabrew;;0 - 20,000;35;3;32;0;0;0
1233260;FAIRY TAIL;;50,000 - 100,000;1026;413;613;1004;1627;7
1233270;OshiRabu: Waifus Over Husbandos;;200,000 - 500,000;3194;458;2736;111;111;9
1233350;Random Heroes: Gold Edition;;0 - 20,000;49;20;29;0;0;0
1233410;MicroWorks;;0 - 20,000;160;11;149;0;0;0
1233420;Wanderlust: Transsiberian;;0 - 20,000;29;10;19;0;0;0
1233460;Star Escape;;50,000 - 100,000;1;1;0;0;0;0
1233510;Juice Mania;;0 - 20,000;4;4;0;0;0;0
1233530;Knights of the Chalice 2;;0 - 20,000;73;19;54;0;0;2
1233540;How Buddy’s parents met - a jigsaw puzzle tale;;0 - 20,000;155;13;142;0;0;0
1233550;Rocket Arena;;100,000 - 200,000;1159;724;435;28;36;1
1233570;Mirror's Edge Catalyst;;500,000 - 1,000,000;8956;1763;7193;345;192;64
1233580;Smile;;0 - 20,000;6;1;5;0;0;0
1233590;Warhammer Age of Sigmar: Storm Ground;;50,000 - 100,000;580;354;226;573;760;3
1233600;Corporated Robots Wars;;0 - 20,000;1;2;-1;0;0;0
1233610;Tactical Warfare Simulator;;0 - 20,000;1;5;-4;0;0;0
1233690;Hypergalactic Psychic Table Tennis 3000;;20,000 - 50,000;113;12;101;0;0;0
1233720;The Parenting Simulator;;0 - 20,000;46;6;40;116;116;1
1233780;Balls Royale;;0 - 20,000;74;24;50;0;0;0
1233790;Ducks' Wrath;;0 - 20,000;14;0;14;0;0;0
1233800;Kandagawa Jet Girls;;0 - 20,000;231;44;187;23;23;1
1233820;A Ton Of Feathers;;20,000 - 50,000;40;6;34;0;0;0
1233850;The Aegis Saga;;0 - 20,000;5;5;0;0;0;0
1233880;Disgaea 4 Complete+;;50,000 - 100,000;592;66;526;874;1673;54
1233950;Wayhaven Chronicles: Book Two;;0 - 20,000;188;3;185;0;0;8
1233950;Wayhaven Chronicles: Book Two;;0 - 20,000;188;3;185;0;0;8
1233990;Tinieblas Jr's Adventures;;0 - 20,000;3;7;-4;0;0;0
1234020;The Epsilon Outcome;;0 - 20,000;8;0;8;0;0;0
1234030;ゴシックマーダー -運命を変えるアドベンチャー-;;0 - 20,000;19;4;15;0;0;0
1234060;HumanBloodSandwich;;0 - 20,000;60;45;15;0;0;0
1234070;Wire Flying Maid;;0 - 20,000;2;0;2;0;0;0
1234110;OH! MOCHI!;;0 - 20,000;6;2;4;0;0;0
1234120;AeternoBlade;;0 - 20,000;17;10;7;0;0;0
1234160;NUMTATE;;0 - 20,000;3;0;3;0;0;0
1234190;ANIME WAR — Modern Campaign;;20,000 - 50,000;371;68;303;3;3;0
1234220;Paper Pirates;;0 - 20,000;85;10;75;0;0;2
1234240;Last Farewell;;0 - 20,000;56;21;35;0;0;0
1234260;Deadly Land;;0 - 20,000;96;25;71;0;0;1
1234290;Paug;;0 - 20,000;13;2;11;0;0;0
1234340;GlowyJump;;0 - 20,000;6;0;6;0;0;0
1234360;CanCan the Game;;0 - 20,000;1;0;1;0;0;0
1234380;Era of Survival;;0 - 20,000;10;12;-2;0;0;0
1234450;EDGE OF DAWN;;0 - 20,000;13;28;-15;0;0;0
1234500;The Expedition;;0 - 20,000;1;3;-2;0;0;0
1234540;Bob Wants to Go Home;;0 - 20,000;2;0;2;0;0;0
1234550;Quest Rooms;;0 - 20,000;79;36;43;0;0;0
1234580;fullybroKEN - A Unique Mix of 4X / Post-Apocalypse / RPG / Roguelike;;0 - 20,000;2;1;1;0;0;0
1234590;Class Kingdom;;0 - 20,000;0;3;-3;0;0;0
1234600;Hollow Remnant;;0 - 20,000;7;4;3;0;0;0
1234620;Tinker Racers;;0 - 20,000;167;38;129;400;400;2
1234630;Enemy Gates Stealth War;;0 - 20,000;1;1;0;0;0;0
1234690;Gotcha;;0 - 20,000;8;0;8;0;0;0
1234700;Hornet Virus: Steel Alcimus II;;0 - 20,000;21;2;19;0;0;0
1234700;Hornet Virus: Steel Alcimus II;;0 - 20,000;21;2;19;0;0;0
1234730;HereSphere VR Video Player;;0 - 20,000;89;9;80;0;0;13
1234750;Penguin's Dogma｜獄門ペンギン;;0 - 20,000;15;3;12;0;0;0
1234810;Unbound: Worlds Apart Prologue;;100,000 - 200,000;846;40;806;0;0;0
1234820;Mistaker;;0 - 20,000;0;4;-4;0;0;0
1234830;Warmth;;0 - 20,000;18;2;16;0;0;0
1234840;Bone Marrow;;0 - 20,000;30;15;15;0;0;0
1234850;Synthetic Blood: Mind Shift;;0 - 20,000;10;3;7;0;0;0
1234890;labyrinth;;0 - 20,000;8;2;6;0;0;0
1234900;Sheptun;;0 - 20,000;17;7;10;0;0;0
1234930;Reach;;0 - 20,000;2;1;1;0;0;0
1234940;Astronarch;;50,000 - 100,000;648;56;592;0;0;13
1234980;Live To Win;;0 - 20,000;3;5;-2;0;0;0
1235110;Rising Star 2;;0 - 20,000;382;18;364;791;791;28
1235120;Meme Run 2;;0 - 20,000;53;8;45;0;0;0
1235130;Roboshark Rampage;;0 - 20,000;5;1;4;0;0;0
1235140;Yakuza: Like a Dragon;;200,000 - 500,000;18966;829;18137;3334;3988;866
1235160;Boom Stick;;0 - 20,000;5;1;4;0;0;0
1235220;There a no Armadillos in this game;;0 - 20,000;2;2;0;0;0;0
1235310;Exhaust;;0 - 20,000;0;4;-4;0;0;0
1235310;Exhaust;;0 - 20,000;0;4;-4;0;0;0
1235350;Weed County;;0 - 20,000;4;3;1;0;0;0
1235360;Epic Conquest 2;;50,000 - 100,000;284;42;242;0;0;0
1235400;CATharsis;;0 - 20,000;7;1;6;0;0;0
1235430;CUBeKA;;0 - 20,000;7;1;6;0;0;0
1235440;长星 Long Star;;0 - 20,000;2;4;-2;0;0;0
1235450;Treasure Drifter: Nian;;0 - 20,000;26;6;20;0;0;0
1235460;Angry Bunny 2: Lost hole;;0 - 20,000;30;15;15;0;0;0
1235480;Abst Clicker Farm;;0 - 20,000;2;13;-11;0;0;0
1235510;晴空：未来的守望;;0 - 20,000;5;2;3;0;0;0
1235570;Indian Army - Mission POK;;0 - 20,000;4;1;3;0;0;0
1235770;Volleyballed;;0 - 20,000;3;0;3;0;0;0
1235790;dancing chair;;0 - 20,000;66;11;55;0;0;0
1235800;Oneiro;;0 - 20,000;42;1;41;0;0;0
1235810;Retro;;0 - 20,000;4;2;2;0;0;0
1235830;Dark Water : Slime Invader;;0 - 20,000;143;7;136;553;553;0
1235920;SwordBall;;20,000 - 50,000;2;3;-1;0;0;0
1235980;Nice Try!;;0 - 20,000;0;2;-2;0;0;0
1236000;Armoured Onslaught;;0 - 20,000;5;2;3;0;0;0
1236040;Mahasona;;0 - 20,000;27;7;20;0;0;0
1236050;Genius!;;0 - 20,000;3;2;1;0;0;0
1236070;Mission Zigloton;;20,000 - 50,000;220;11;209;0;0;0
1236100;Of Evil and Darkness;;0 - 20,000;2;0;2;0;0;0
1236160;The Last Archwing;;0 - 20,000;16;1;15;0;0;0
1236180;Balkadia;;0 - 20,000;1;0;1;0;0;0
1236190;Korpus: Buried over the Black Soil;;0 - 20,000;15;3;12;0;0;0
1236190;Korpus: Buried over the Black Soil;;0 - 20,000;15;3;12;0;0;0
1236240;Zero IDLE;;50,000 - 100,000;216;82;134;0;0;9
1236300;Resident Evil Re:Verse;;200,000 - 500,000;1290;2182;-892;95;119;19
1236320;Phalanx of Resistance;;0 - 20,000;3;7;-4;0;0;0
1236330;Car Tuner 2020;;0 - 20,000;0;2;-2;0;0;0
1236390;Heroes Showdown;;100,000 - 200,000;250;90;160;0;0;0
1236450;Incredible Dracula: Ocean's Call;;0 - 20,000;19;3;16;0;0;2
1236470;VR Summer Sports;;0 - 20,000;2;1;1;0;0;0
1236480;King of Volleyball;;0 - 20,000;6;4;2;0;0;0
1236490;Bamerang;;0 - 20,000;55;3;52;0;0;0
1236530;Starters Orders Classic Horse Racing;;0 - 20,000;14;7;7;0;0;0
1236620;Endurium;;0 - 20,000;9;0;9;0;0;0
1236670;Codename: Terranova;;0 - 20,000;17;7;10;0;0;0
1236720;Spirit Island;;0 - 20,000;592;45;547;0;0;35
1236760;Rule the Rail!;;0 - 20,000;13;7;6;0;0;0
1236780;AKIBA'S TRIP: Hellbound & Debriefed;;0 - 20,000;113;36;77;0;0;3
1236810;Hard2Fly;;0 - 20,000;14;0;14;0;0;0
1236860;Edge of Reality;;0 - 20,000;46;15;31;0;0;0
1236880;Survival Africa;;0 - 20,000;14;14;0;0;0;0
1236900;Verdant Village;;0 - 20,000;48;4;44;0;0;1
1236920;SPACE EXODUS;;0 - 20,000;0;2;-2;0;0;0
1236960;Living Legends: The Crystal Tear Collector's Edition;;0 - 20,000;11;0;11;0;0;0
1236990;Boris and the Dark Survival;;200,000 - 500,000;2442;207;2235;69;69;9
1237050;TheWandererVR;;0 - 20,000;0;1;-1;0;0;0
1237060;Wise Escape From Prison (현명한 감옥 탈출기);;0 - 20,000;16;2;14;0;0;0
1237060;Wise Escape From Prison (현명한 감옥 탈출기);;0 - 20,000;16;2;14;0;0;0
1237070;The Cyclist: Tactics;;0 - 20,000;69;2;67;0;0;5
1237080;Comic Book Tycoon;;0 - 20,000;23;25;-2;0;0;0
1237090;Bounty For Sharks;;0 - 20,000;5;1;4;0;0;0
1237110;Me and (My) Cat's Castle;;0 - 20,000;1;1;0;0;0;0
1237120;Me and (My) Cat's Castle X;;0 - 20,000;1;0;1;0;0;0
1237210;EMPTY;;0 - 20,000;4;0;4;0;0;0
1237240;Crypt Of Shadows;;0 - 20,000;1;0;1;0;0;0
1237260;Evil Cult;;0 - 20,000;17;3;14;0;0;0
1237310;Rocket Shipment;;0 - 20,000;8;0;8;0;0;0
1237320;Sonic Frontiers;;200,000 - 500,000;14688;936;13752;862;1142;470
1237330;GraFi Valentine;;0 - 20,000;8;9;-1;0;0;0
1237410;VE GSIM Crane Simulator;;0 - 20,000;2;4;-2;0;0;0
1237480;Isle Of Spirits;;0 - 20,000;2;5;-3;0;0;0
1237490;Redneck Ed: Astro Monsters Show;;0 - 20,000;35;30;5;0;0;0
1237510;Dr Livingstone, I Presume? Reversed Escape Room;;0 - 20,000;61;10;51;0;0;0
1237540;Ultimate MMA;;0 - 20,000;65;61;4;0;0;1
1237550;Great Alhcemist;;0 - 20,000;5;4;1;0;0;0
1237560;Hot steel;;0 - 20,000;3;6;-3;0;0;0
1237570;Samozbor ID:HEAVEN;;0 - 20,000;47;5;42;0;0;0
1237590;Attack of the alien thingies from lava!;;0 - 20,000;5;2;3;0;0;0
1237610;The Catch: Carp & Coarse Fishing;;0 - 20,000;191;83;108;81;81;4
1237670;Anti Air;;0 - 20,000;2;0;2;0;0;0
1237690;HVOR;;0 - 20,000;31;25;6;0;0;0
1237690;HVOR;;0 - 20,000;31;25;6;0;0;0
1237700;Building the Universe: The Beginning of Time;;0 - 20,000;2;0;2;0;0;0
1237730;Catlateral Damage: Remeowstered;;0 - 20,000;144;1;143;0;0;4
1237760;The Trud;;0 - 20,000;33;16;17;0;0;0
1237780;AREA MAN LIVES;;0 - 20,000;6;6;0;0;0;1
1237800;Fields of Glory;;0 - 20,000;6;3;3;0;0;0
1237820;Tower Blitz;;0 - 20,000;1;6;-5;0;0;0
1237840;Blood Relation Part1.;;0 - 20,000;3;5;-2;0;0;0
1237870;Boss Rush: Mythology;;0 - 20,000;82;22;60;0;0;0
1237880;Red Town;;0 - 20,000;10;6;4;0;0;0
1237900;Legion's Crawl 2;;0 - 20,000;3;1;2;0;0;0
1237950;STAR WARS Battlefront II;;1,000,000 - 2,000,000;40050;5830;34220;1290;572;1882
1237970;Titanfall 2;;2,000,000 - 5,000,000;147037;8120;138917;760;339;3763
1237980;STAR WARS Battlefront;;500,000 - 1,000,000;2927;824;2103;421;111;66
1238000;Mass Effect: Andromeda Deluxe Edition;;500,000 - 1,000,000;8749;2606;6143;1033;446;689
1238020;Mass Effect 3 N7 Digital Deluxe Edition (2012);;200,000 - 500,000;1554;480;1074;5;5;57
1238040;Dragon Age II: Ultimate Edition;;500,000 - 1,000,000;2706;602;2104;968;1181;273
1238060;Dead Space 3;;500,000 - 1,000,000;6839;2119;4720;763;712;256
1238080;Burnout Paradise Remastered;;200,000 - 500,000;3047;1856;1191;411;504;40
1238180;My Universe - School Teacher;;0 - 20,000;6;5;1;0;0;0
1238220;UNNAMED;;0 - 20,000;1;2;-1;0;0;0
1238250;Cave Game;;0 - 20,000;10;2;8;0;0;0
1238280;100 Doors Game - Escape from School;;50,000 - 100,000;468;147;321;0;0;7
1238320;Dead Cubes;;0 - 20,000;18;8;10;0;0;0
1238330;Frontline: Panzer Blitzkrieg!;;0 - 20,000;68;10;58;0;0;2
1238340;Terra Lander II - Rockslide Rescue;;0 - 20,000;3;0;3;0;0;0
1238360;Into A Dream;;0 - 20,000;56;5;51;0;0;0
1238400;Never Date Werewolves;;0 - 20,000;16;4;12;0;0;0
1238450;Interference: Dead Air;;0 - 20,000;34;12;22;0;0;1
1238470;Come on-be with you;;0 - 20,000;2;3;-1;0;0;0
1238480;McSpace Colosseum;;20,000 - 50,000;6;3;3;0;0;0
1238490;MoonRun;;0 - 20,000;5;4;1;0;0;0
1238520;Dandelions in the Sky;;0 - 20,000;191;21;170;0;0;0
1238520;Dandelions in the Sky;;0 - 20,000;191;21;170;0;0;0
1238540;Simple LOTO Simulator;;0 - 20,000;4;1;3;0;0;0
1238620;Peg Solitaire Adventure;;0 - 20,000;1;3;-2;0;0;0
1238630;FatCat with Hat - Reload the Powergun;;0 - 20,000;0;2;-2;0;0;0
1238680;Amairo Chocolate;;0 - 20,000;500;11;489;0;0;6
1238680;Amairo Chocolate;;0 - 20,000;500;11;489;0;0;6
1238710;Wonderland Nights: White Rabbit's Diary;;0 - 20,000;2;0;2;0;0;0
1238720;Wandering Through The Vines;;0 - 20,000;5;1;4;0;0;0
1238730;Flowers -Le volume sur automne-;;0 - 20,000;548;4;544;851;851;0
1238810;Battlefield V;;5,000,000 - 10,000,000;106390;43646;62744;1865;646;23168
1238820;Battlefield 3;;500,000 - 1,000,000;5763;2400;3363;688;282;137
1238840;Battlefield 1;;2,000,000 - 5,000,000;95049;15191;79858;1496;466;12942
1238860;Battlefield 4;;1,000,000 - 2,000,000;44774;6672;38102;1695;516;1953
1238880;Battlefield Hardline;;200,000 - 500,000;1746;767;979;1800;1800;17
1238970;Sudd City Adventures;;0 - 20,000;1;0;1;0;0;0
1238980;Pancake House;;0 - 20,000;1;3;-2;0;0;0
1239000;Relentless;;0 - 20,000;13;1;12;0;0;0
1239020;TOGETHER BnB;;100,000 - 200,000;3908;1825;2083;252;252;85
1239030;Seven Dunes: Curse on the Golden Sand;;0 - 20,000;3;1;2;0;0;0
1239050;Mists of Aiden;;20,000 - 50,000;931;84;847;0;0;2
1239080;Door Kickers 2: Task Force North;;200,000 - 500,000;6103;191;5912;752;253;219
1239120;Pyro the Exterminator;;0 - 20,000;3;0;3;0;0;0
1239140;Cube;;0 - 20,000;1;0;1;0;0;0
1239180;AZ: Oath of Brotherhood Prologue 1;;0 - 20,000;6;3;3;0;0;0
1239260;Barro F;;100,000 - 200,000;990;206;784;101;115;6
1239270;Yoren;;0 - 20,000;2;9;-7;0;0;0
1239300;Gravewood High;;20,000 - 50,000;320;138;182;28;53;12
1239320;Animal Shelter;;50,000 - 100,000;1474;250;1224;93;132;72
1239400;Death courier;;0 - 20,000;1;2;-1;0;0;0
1239430;Population Zero;;100,000 - 200,000;469;735;-266;37;37;0
1239440;Surviving Titan;;0 - 20,000;113;51;62;0;0;0
1239490;LOVE - A Puzzle Box Filled with Stories;;0 - 20,000;45;1;44;0;0;0
1239520;Madden NFL 21;;200,000 - 500,000;2612;2601;11;3457;3898;94
1239590;T.A.R.S;;0 - 20,000;9;15;-6;0;0;0
1239660;Formula Retro Racing;;0 - 20,000;57;22;35;0;0;0
1239690;Retrowave;;200,000 - 500,000;12185;520;11665;91;65;68
1239740;Up on the Rooftop;;0 - 20,000;6;0;6;0;0;0
1239800;Cannon Jump;;20,000 - 50,000;13;2;11;0;0;1
1239870;Memory Player;;0 - 20,000;2;0;2;0;0;0
1239900;Infection Point;;0 - 20,000;0;1;-1;0;0;0
1239920;Xyla and the 'Shrooms of Doom;;0 - 20,000;0;1;-1;0;0;0
1239970;The Yolk Street;;0 - 20,000;23;7;16;0;0;0
1239980;Luciform;;0 - 20,000;16;0;16;0;0;0
1239990;Dantes Bullet Inferno;;0 - 20,000;3;0;3;0;0;0
1240040;SokoBunny;;0 - 20,000;7;0;7;0;0;0
1240050;Pendragon;;0 - 20,000;75;36;39;0;0;2
1240090;Hiragana POW!;;0 - 20,000;5;1;4;0;0;0
1240120;Typical Cliche;;20,000 - 50,000;12;6;6;0;0;0
1240130;Dashing Fire;;0 - 20,000;72;2;70;0;0;0
1240130;Dashing Fire;;0 - 20,000;72;2;70;0;0;0
1240140;Unlord;;0 - 20,000;9;1;8;0;0;0
1240180;Rocket Panda Panic;;0 - 20,000;3;1;2;0;0;0
1240210;There Is No Game: Wrong Dimension;;200,000 - 500,000;18283;376;17907;387;349;82
1240230;Tony Stewart's Sprint Car Racing;;0 - 20,000;175;24;151;0;0;2
1240240;Legendary Knight - 傳奇騎士;;0 - 20,000;70;3;67;0;0;0
1240270;The Botanist;;0 - 20,000;3;0;3;0;0;0
1240290;Infestation: Battle Royale;;100,000 - 200,000;133;150;-17;12;12;5
1240350;Galactic Center VR;;20,000 - 50,000;5;4;1;0;0;0
1240370;Shell Corp;;0 - 20,000;8;1;7;0;0;0
1240440;Halo Infinite;;10,000,000 - 20,000,000;109415;45910;63505;838;155;4674
1240460;TechnoTsunami;;0 - 20,000;52;4;48;0;0;0
1240480;-The Sacrificial Girl of the Fantasy 3 Kingdoms-;;0 - 20,000;164;23;141;0;0;0
1240490;Parallel Catastrophes Chronicles;;0 - 20,000;0;2;-2;0;0;0
1240510;Witch and Spirit;;0 - 20,000;3;0;3;0;0;0
1240530;Dungeon Warriors;;0 - 20,000;9;4;5;0;0;0
1240550;Until the Last Plane;;0 - 20,000;72;29;43;0;0;1
1240590;Sir Whoopass: Immortal Death;;20,000 - 50,000;535;76;459;0;0;21
1240600;Beach anime day;;0 - 20,000;2;8;-6;0;0;0
1240610;Chicken Hero in Wulin;;0 - 20,000;34;2;32;0;0;3
1240620;kosmickop;;0 - 20,000;2;0;2;0;0;0
1240630;Hex of Steel;;0 - 20,000;269;7;262;0;0;33
1240680;Hades Ultimate Fighting Ball;;0 - 20,000;3;1;2;0;0;0
1240690;PIVO;;0 - 20,000;22;3;19;0;0;0
1240730;Dark Room;;0 - 20,000;17;15;2;0;0;0
1240770;Scorched Islands;;0 - 20,000;1;5;-4;0;0;0
1240790;Legacy of Sin the father sacrifice;;0 - 20,000;35;13;22;0;0;0
1240810;잭과 콩나무: 숨겨진 이야기;;20,000 - 50,000;185;103;82;0;0;0
1240840;Shadow Puppets & Beijing opera;;0 - 20,000;32;4;28;0;0;0
1240910;神鬼降世;;0 - 20,000;6;5;1;0;0;0
1241020;Idle Warrior;;0 - 20,000;37;29;8;0;0;0
1241030;Jetpack Stadium;;0 - 20,000;9;5;4;0;0;0
1241040;Deep Despair;;20,000 - 50,000;174;76;98;6;6;0
1241100;POLYGON: Multiplayer Shooter;;500,000 - 1,000,000;13846;5249;8597;0;0;334
1241110;ANARCHY;;500,000 - 1,000,000;12;6;6;0;0;0
1241140;Return to Sender;;0 - 20,000;2;1;1;0;0;0
1241160;TECH DEMO: Pulse Forge VR;;0 - 20,000;7;24;-17;0;0;0
1241180;降神战役 -A Story of the usurpers-;;20,000 - 50,000;1;0;1;0;0;0
1241230;Hack or Die!;;0 - 20,000;11;0;11;0;0;0
1241250;Notera;;0 - 20,000;1;2;-1;0;0;0
1241370;FierceWind Decay;;20,000 - 50,000;7;2;5;0;0;0
1241400;Bomb Fight;;0 - 20,000;2;0;2;0;0;0
1241440;Elfin Clay;;0 - 20,000;7;2;5;0;0;0
1241500;Dirty Harry's Thunder Drive;;20,000 - 50,000;51;13;38;0;0;0
1241510;The Test;;500,000 - 1,000,000;17628;485;17143;31;43;2
1241520;The Horrorscope;;0 - 20,000;995;60;935;0;0;1
1241690;Fatal Wings;;0 - 20,000;1;0;1;0;0;0
1241700;There Is No Game: Jam Edition 2015;;200,000 - 500,000;5340;150;5190;26;24;6
1241710;Energy Island Corp.;;0 - 20,000;22;2;20;0;0;2
1241780;CatDog Puzzle;;0 - 20,000;11;5;6;0;0;0
1241810;Bowmen;;20,000 - 50,000;1;0;1;0;0;0
1241860;Get Good;;0 - 20,000;2;0;2;0;0;0
1241860;Get Good;;0 - 20,000;2;0;2;0;0;0
1241910;Victory and Glory: The American Civil War;;0 - 20,000;44;24;20;0;0;1
1241950;Warzone 2100;;100,000 - 200,000;1038;114;924;0;0;30
1242620;HUNGRY TEA PARTY;;0 - 20,000;55;11;44;0;0;0
1242630;Skid Cities;;0 - 20,000;46;18;28;53;53;0
1242700;Ashland:Explore;;200,000 - 500,000;1356;299;1057;0;0;1
1242710;Simplode Suite;;0 - 20,000;16;10;6;0;0;0
1242730;双子树 TwinTrees;;50,000 - 100,000;2;2;0;0;0;0
1242790;The Crimson Diamond: Chapter 1;;0 - 20,000;33;2;31;0;0;0
1242800;Tower of the Approval;;0 - 20,000;3;4;-1;0;0;0
1242830;Dry Visit - Virtual Underwater Visit - iMARECulture;;0 - 20,000;7;1;6;0;0;0
1242850;Movavi Slideshow Maker;;0 - 20,000;18;3;15;0;0;0
1242910;The House in the Forest;;0 - 20,000;24;18;6;0;0;0
1242980;KeyWe;;20,000 - 50,000;828;80;748;124;148;34
1243010;James Peris: Sin licencia ni control - Edición definitiva;;0 - 20,000;7;2;5;0;0;0
1243030;Send them to the sky;;0 - 20,000;0;3;-3;0;0;0
1243040;Pixel Pileup Party;;0 - 20,000;1;0;1;0;0;0
1243100;Galaxy Warfighter;;0 - 20,000;11;12;-1;0;0;0
1243130;Nimbatus - Drone Creator;;20,000 - 50,000;197;22;175;0;0;3
1243140;Hellpoint: The Thespian Feast;;20,000 - 50,000;501;221;280;164;164;0
1243150;Mr Maker 3D Level Editor;;0 - 20,000;10;2;8;0;0;0
1243160;The Galactic Junkers;;0 - 20,000;10;10;0;0;0;0
1243200;STUFFED: Fun Co-Op FPS;;0 - 20,000;179;45;134;0;0;2
1243220;Picklock;;20,000 - 50,000;298;42;256;132;149;0
1243240;Season Match 4;;0 - 20,000;11;12;-1;0;0;0
1243260;Mossen Seikkailut;;0 - 20,000;10;0;10;0;0;0
1243290;K'nife Fight;;0 - 20,000;3;0;3;0;0;0
1243320;War for Magincia;;0 - 20,000;3;5;-2;0;0;1
1243360;Sigma Draconis;;0 - 20,000;17;6;11;0;0;1
1243370;RUBICON;;0 - 20,000;2;0;2;0;0;0
1243410;The Adventures of Spunk Dodgers and Splat;;0 - 20,000;1;0;1;0;0;0
1243450;Detectives United III: Timeless Voyage Collector's Edition;;0 - 20,000;4;1;3;0;0;0
1243520;KUR;;0 - 20,000;40;21;19;53;53;0
1243530;Tobari 2: Dream Ocean;;0 - 20,000;18;0;18;0;0;0
1243560;Vaporwave World;;0 - 20,000;16;4;12;0;0;0
1243580;Stalker;;0 - 20,000;4;0;4;0;0;0
1243640;Entelechy;;0 - 20,000;6;1;5;0;0;0
1243670;Higurashi When They Cry Hou - Ch.8 Matsuribayashi;;0 - 20,000;359;24;335;0;0;5
1243690;Gods Will Fall;;0 - 20,000;48;35;13;0;0;0
1243700;长安夜明;;0 - 20,000;67;6;61;0;0;0
1243750;Sea Fishing Simulator;;0 - 20,000;5;6;-1;0;0;0
1243790;Heart Star;;0 - 20,000;56;2;54;0;0;2
1243820;NYC Bungee;;0 - 20,000;12;2;10;0;0;0
1243830;Overcooked! All You Can Eat;;100,000 - 200,000;1832;786;1046;277;284;757
1243880;Evil Inside;;0 - 20,000;107;82;25;0;0;0
1243880;Evil Inside;;0 - 20,000;107;82;25;0;0;0
1243890;Sword of the Necromancer;;0 - 20,000;181;65;116;0;0;6
1243900;Climb the Tower;;0 - 20,000;6;0;6;0;0;0
1243930;Clipped;;0 - 20,000;7;1;6;0;0;0
1244040;Crocotile 3D;;0 - 20,000;110;13;97;0;0;4
1244050;Realm Hacker;;0 - 20,000;1;0;1;0;0;0
1244140;Bulk Dominoes VR: Kinetic Rush;;0 - 20,000;12;4;8;0;0;0
1244190;Maze Burrow;;0 - 20,000;9;0;9;0;0;0
1244210;Fragile Box;;0 - 20,000;19;4;15;0;0;0
1244260;The Fairy's Song;;0 - 20,000;114;4;110;0;0;1
1244300;The Astro Parcel Service;;0 - 20,000;4;0;4;0;0;0
1244380;Pirates? Pirates!;;0 - 20,000;51;13;38;209;209;0
1244390;My Little Cloud - Rain and Thunder Sounds;;0 - 20,000;14;1;13;0;0;0
1244460;Jurassic World Evolution 2;;500,000 - 1,000,000;14532;2607;11925;1407;1239;1412
1244470;OneJump;;0 - 20,000;4;1;3;0;0;0
1244520;2D Baseball Duel;;0 - 20,000;13;1;12;0;0;1
1244530;Betelgeuse;;0 - 20,000;35;1;34;0;0;0
1244630;House Builder;;50,000 - 100,000;1119;293;826;363;481;30
1244760;Beautiful Girl Fight School;;0 - 20,000;15;14;1;0;0;0
1244770;LilyDeux - Black Lily Warning;;0 - 20,000;1;1;0;0;0;0
1244800;Terraformers;;500,000 - 1,000,000;793;116;677;63;63;53
1244830;Conflict: Europe;;0 - 20,000;1;0;1;0;0;0
1244850;Witch College 2;;0 - 20,000;9;4;5;0;0;0
1244860;Dawn of Fear;;0 - 20,000;26;12;14;0;0;0
1244890;Sunburnt;;0 - 20,000;1;0;1;0;0;0
1244930;Mask of the Plague Doctor;;0 - 20,000;45;3;42;0;0;2
1244950;Battletoads;;50,000 - 100,000;1213;524;689;155;239;11
1245000;Poly Duels;;0 - 20,000;9;2;7;0;0;0
1245170;F-117A Stealth Fighter (NES edition);;0 - 20,000;3;1;2;0;0;0
1245260;Battle for Iwo Jima;;0 - 20,000;18;7;11;0;0;0
1245280;Skeleton Warrior;;0 - 20,000;2;7;-5;0;0;0
1245350;Race Maniacs;;0 - 20,000;1;3;-2;0;0;0
1245360;Cubic Juice;;0 - 20,000;0;1;-1;0;0;0
1245360;Cubic Juice;;0 - 20,000;0;1;-1;0;0;0
1245370;Puzzle Forge Dungeon;;0 - 20,000;28;5;23;0;0;1
1245430;Golden Light;;0 - 20,000;1931;150;1781;120;215;5
1245470;Ultimate Ski Jumping 2020;;0 - 20,000;48;14;34;87;87;0
1245500;Break the Web;;0 - 20,000;45;14;31;0;0;0
1245540;Touhou Endless Dream;;50,000 - 100,000;1638;79;1559;0;0;4
1245550;Zombie Defense Shelter;;0 - 20,000;0;2;-2;0;0;0
1245570;Circle of Football (Soccer or Whatever);;0 - 20,000;90;33;57;0;0;0
1245600;Obelisk;;0 - 20,000;5;4;1;0;0;0
1245620;ELDEN RING;;20,000,000 - 50,000,000;588405;53749;534656;5571;4398;54950
1245630;Virage Rally;;0 - 20,000;1;4;-3;0;0;0
1245640;The Book of Distance;;0 - 20,000;144;3;141;0;0;1
1245660;Ballavita;;0 - 20,000;3;2;1;0;0;0
1245670;Blackstone Academy for the Magical Arts;;0 - 20,000;15;9;6;0;0;0
1245730;Chuck Meowrris;;0 - 20,000;2;0;2;0;0;0
1245810;BitVault;;0 - 20,000;23;0;23;0;0;0
1245820;Life of a Mercenary;;0 - 20,000;9;2;7;0;0;1
1245900;Comrade-in-Arms;;0 - 20,000;6;4;2;0;0;0
1245920;VectorBall;;0 - 20,000;17;3;14;0;0;0
1245930;Flaming Friday Night;;0 - 20,000;3;3;0;0;0;0
1245950;Ironlights;;0 - 20,000;134;38;96;0;0;2
1245980;Forest monster;;0 - 20,000;3;4;-1;0;0;0
1246020;NOeSIS_诉说谎言记忆物语;;50,000 - 100,000;981;26;955;0;0;5
1246040;KARA Accounting;;0 - 20,000;4;1;3;0;0;0
1246120;NeonFlight;;0 - 20,000;4;1;3;0;0;0
1246140;Cybernetica;;0 - 20,000;1;9;-8;0;0;0
1246170;ZYNET;;0 - 20,000;3;0;3;0;0;0
1246200;Super Toxicboy;;0 - 20,000;1;0;1;0;0;0
1246230;Boom Blaster;;0 - 20,000;26;14;12;0;0;0
1246250;An Airport for Aliens Currently Run by Dogs;;0 - 20,000;153;13;140;0;0;1
1246320;Euler Wars;;0 - 20,000;1;0;1;0;0;0
1246390;Another_World;;0 - 20,000;8;17;-9;0;0;0
1246420;Clown Nightmare, Satan's Joke;;0 - 20,000;8;1;7;0;0;0
1246460;去死吧蝙蝠;;0 - 20,000;5;9;-4;0;0;0
1246490;Domino Simulator;;0 - 20,000;58;10;48;0;0;0
1246540;Alice Sisters;;0 - 20,000;4;0;4;0;0;0
1246600;Feed The Horsebear;;0 - 20,000;3;1;2;0;0;0
1246620;Neon Parasite;;0 - 20,000;4;0;4;0;0;0
1246650;Réel Futur;;20,000 - 50,000;0;1;-1;0;0;0
1246710;Hooplord;;0 - 20,000;18;3;15;0;0;0
1246870;Harvest Moon: One World;;0 - 20,000;46;26;20;0;0;8
1246880;门里;;0 - 20,000;95;8;87;0;0;0
1246930;Encore Classic Card Games;;0 - 20,000;28;4;24;0;0;10
1246940;Encore Classic Casino Games;;0 - 20,000;8;9;-1;0;0;0
1246950;Where in the World is Carmen Sandiego?;;0 - 20,000;53;16;37;21;21;2
1247020;Lovingly Evil;;20,000 - 50,000;87;13;74;0;0;1
1247030;Perpetual Dream;;0 - 20,000;5;2;3;0;0;0
1247040;Void Monsters 2: The Blight;;0 - 20,000;0;4;-4;0;0;0
1247100;SpellMaster: The Saga;;20,000 - 50,000;158;212;-54;3;3;1
1247110;Chasing Light;;20,000 - 50,000;204;36;168;0;0;0
1247110;Chasing Light;;20,000 - 50,000;204;36;168;0;0;0
1247160;WarDogs: Red's Return;;0 - 20,000;36;2;34;0;0;0
1247160;WarDogs: Red's Return;;0 - 20,000;36;2;34;0;0;0
1247170;Alien Cat;;0 - 20,000;314;39;275;0;0;0
1247190;Family Mysteries 2: Echoes of Tomorrow;;0 - 20,000;94;34;60;0;0;3
1247210;INVISIBLE MAN;;0 - 20,000;1;1;0;0;0;0
1247240;Shadowforge;;0 - 20,000;6;0;6;0;0;0
1247250;Quick Trivia;;0 - 20,000;2;4;-2;0;0;0
1247290;GameGuru MAX;;0 - 20,000;122;44;78;0;0;12
1247360;Grand Mountain Adventure: Wonderlands;;0 - 20,000;190;14;176;0;0;3
1247370;Food Chain;;0 - 20,000;46;28;18;0;0;0
1247400;Red Zirion;;0 - 20,000;6;0;6;0;0;0
1247400;Red Zirion;;0 - 20,000;6;0;6;0;0;0
1247460;To the Edge of the Sky;;20,000 - 50,000;34;27;7;0;0;0
1247570;Expedition Zero;;0 - 20,000;92;49;43;157;157;1
1247580;The Dark Heart of Balor;;20,000 - 50,000;10;1;9;0;0;0
1247640;Dwarf Shop;;20,000 - 50,000;63;25;38;0;0;0
1247650;Immortal Love: Stone Beauty Collector's Edition;;0 - 20,000;7;0;7;0;0;1
1247720;Pizza Master VR;;0 - 20,000;55;11;44;27;27;0
1247730;Carrots and Cream;;0 - 20,000;7;2;5;0;0;0
1247740;Your Story;;0 - 20,000;19;4;15;0;0;7
1247830;Drive Forward;;0 - 20,000;10;2;8;0;0;0
1247860;藏梦 Hidden Dream;;0 - 20,000;65;5;60;0;0;1
1247870;Spectrum;;0 - 20,000;3;2;1;0;0;0
1247880;听见我的心 Listen to My Heart;;50,000 - 100,000;38;3;35;0;0;0
1247910;Dragon Banner;;0 - 20,000;7;3;4;0;0;0
1247920;被遺棄的雙子 Gemini of the abandoned;;0 - 20,000;8;2;6;0;0;0
1247940;Greyhat - A Digital Detective Adventure;;0 - 20,000;142;12;130;0;0;0
1247950;zombie variant;;0 - 20,000;0;9;-9;0;0;0
1248030;Thrillgate;;0 - 20,000;7;0;7;0;0;0
1248060;Realpolitiks II;;0 - 20,000;260;274;-14;677;677;10
1248100;Protective Clothing;;20,000 - 50,000;9;0;9;0;0;0
1248120;Higher Critters - 1v4;;0 - 20,000;35;11;24;0;0;0
1248130;Farming Simulator 22;;1,000,000 - 2,000,000;38875;4140;34735;9875;3438;32379
1248140;Trailer Trashers;;0 - 20,000;21;5;16;0;0;0
1248150;Warshmallows;;100,000 - 200,000;35;2;33;0;0;0
1248220;无上道;;0 - 20,000;6;11;-5;0;0;0
1248240;PLUGMAX;;0 - 20,000;3;3;0;0;0;0
1248270;Spellbound Spire;;50,000 - 100,000;175;13;162;0;0;1
1248350;Nyanco Channel;;0 - 20,000;22;2;20;0;0;0
1248360;WalkinVR;;20,000 - 50,000;23;0;23;0;0;8
1248370;Quarter Horse Racing;;0 - 20,000;2;0;2;0;0;0
1248450;Totemlands;;0 - 20,000;36;2;34;0;0;1
1248460;Werewolves 2: Pack Mentality;;0 - 20,000;34;2;32;0;0;1
1248490;Senshi Tank 2: Space Bots;;0 - 20,000;6;0;6;0;0;0
1248510;Performer;;0 - 20,000;3;0;3;0;0;0
1248550;Breaking Gates;;0 - 20,000;37;14;23;0;0;0
1248570;Archaid;;0 - 20,000;1;0;1;0;0;0
1248590;A Squire's Tale;;0 - 20,000;3;6;-3;0;0;0
1248650;Fate Arena (Alpha);;20,000 - 50,000;325;82;243;0;0;1
1248670;Stanga;;0 - 20,000;1;0;1;0;0;0
1248680;Speed Sweeper;;0 - 20,000;9;0;9;0;0;0
1248710;ENEFN;;0 - 20,000;7;8;-1;0;0;0
1248710;ENEFN;;0 - 20,000;7;8;-1;0;0;0
1248730;RATTUS;;0 - 20,000;1;0;1;0;0;0
1248740;Campgrounds IV Collector's Edition;;0 - 20,000;2;0;2;0;0;0
1248800;The Rule of Land: Pioneers;;50,000 - 100,000;216;88;128;0;0;0
1248810;离校日 The School Leaving Day;;50,000 - 100,000;6;0;6;0;0;0
1248820;Lost Memories 3 Side Stories;;50,000 - 100,000;399;52;347;0;0;0
1248840;Sephonie;;0 - 20,000;163;12;151;0;0;1
1248860;Cuyo;;0 - 20,000;12;1;11;0;0;0
1248870;イヌワシ ～うらぶれ探偵とお嬢様刑事の池袋事件ファイル～;;0 - 20,000;6;2;4;0;0;0
1248910;Chronicle of Daneya;;0 - 20,000;6;1;5;0;0;0
1248960;Bigwig Flint;;0 - 20,000;3;0;3;0;0;0
1248990;Mýrdalssandur, Iceland;;100,000 - 200,000;1437;134;1303;7;8;2
1249010;ISOLAND3: Dust of the Universe;;0 - 20,000;165;6;159;0;0;1
1249060;MyCompany996;;20,000 - 50,000;256;89;167;0;0;0
1249070;AeternoBlade II: Director's Rewind;;0 - 20,000;42;10;32;0;0;0
1249080;Lynn , The Girl Drawn On Puzzles;;20,000 - 50,000;66;10;56;0;0;0
1249110;Skully;;0 - 20,000;125;90;35;17;20;1
1249130;Hero of the Kingdom: The Lost Tales 1;;50,000 - 100,000;855;73;782;0;0;4
1249150;Daedaluz;;0 - 20,000;25;1;24;0;0;0
1249170;Mine Dungeon;;0 - 20,000;29;3;26;0;0;0
1249190;The Trivial Dead;;0 - 20,000;7;1;6;0;0;0
1249260;Birth ME Code;;0 - 20,000;68;14;54;0;0;1
1249290;The Curse of Zigoris;;0 - 20,000;4;6;-2;0;0;0
1249390;Tales in the TAXI;;0 - 20,000;3;0;3;0;0;0
1249410;Bloodwych;;0 - 20,000;8;8;0;0;0;0
1249420;Steampunk Genius;;20,000 - 50,000;55;6;49;0;0;0
1249430;Sarawak;;20,000 - 50,000;17;3;14;0;0;0
1249480;Ex-Zodiac;;0 - 20,000;420;11;409;143;143;3
1249480;Ex-Zodiac;;0 - 20,000;420;11;409;143;143;3
1249500;Apprehend;;;;;0;;;
1249510;Hnefatafl;;0 - 20,000;38;0;38;0;0;0
1249620;"Adventures of JQ Jones: ""Isle of the Serpent Empress""";;20,000 - 50,000;0;2;-2;0;0;0
1249680;Ninshi Masuta;;0 - 20,000;13;0;13;0;0;0
1249740;Carnival Games;;0 - 20,000;3;9;-6;0;0;0
1249800;Xuan-Yuan Sword VII;;200,000 - 500,000;5741;3386;2355;1114;1267;21
1249850;King of Vikings;;0 - 20,000;8;3;5;0;0;0
1249880;Tiny Bunny;;100,000 - 200,000;1830;55;1775;0;0;2
1249890;Survival Denied;;0 - 20,000;18;1;17;0;0;0
1249980;愛神餐館MAX;;0 - 20,000;27;4;23;0;0;0
1250030;Ourea;;0 - 20,000;8;3;5;0;0;0
1250040;PASVAN;;0 - 20,000;3;1;2;0;0;0
1250060;法利恩戰記（Furion Chronicles）;;0 - 20,000;87;30;57;9;9;0
1250070;Curtains;;0 - 20,000;15;7;8;0;0;0
1250100;Space Station Manager;;0 - 20,000;38;19;19;0;0;0
1250120;Swamp Castle;;0 - 20,000;2;1;1;0;0;0
1250170;Fire Safety Lab VR;;0 - 20,000;4;0;4;0;0;0
1250210;Cyber Battle 69;;0 - 20,000;5;2;3;0;0;0
1250220;Fallen Region;;0 - 20,000;46;64;-18;0;0;2
1250240;GOBS - Game Of Battle Simulation;;0 - 20,000;2;3;-1;0;0;0
1250250;NAMCO MUSEUM ARCHIVES Vol 1;;0 - 20,000;76;29;47;3;3;0
1250250;NAMCO MUSEUM ARCHIVES Vol 1;;0 - 20,000;76;29;47;3;3;0
1250290;You are next;;0 - 20,000;4;2;2;0;0;0
1250300;Orders of Magnitude;;0 - 20,000;33;1;32;0;0;0
1250350;Rhyme Storm;;0 - 20,000;6;2;4;0;0;0
1250410;Microsoft Flight Simulator 40th Anniversary Edition;;1,000,000 - 2,000,000;34893;9973;24920;6740;3014;8185
1250440;Garlic;;0 - 20,000;278;22;256;0;0;1
1250490;Retro Vaders: Reloaded;;0 - 20,000;19;2;17;0;0;0
1250510;2 Times Circles;;0 - 20,000;4;0;4;0;0;0
1250520;Love Spell: Written In The Stars - a magical romantic-comedy otome;;0 - 20,000;113;9;104;0;0;3
1250520;Love Spell: Written In The Stars - a magical romantic-comedy otome;;0 - 20,000;113;9;104;0;0;3
1250560;Chess Sudoku;;0 - 20,000;155;5;150;0;0;6
1250590;ESCAPE POINT;;0 - 20,000;11;14;-3;0;0;0
1250610;Flash Snooker Game;;20,000 - 50,000;19;15;4;0;0;0
1250640;Apocalypse Age : DESTRUCTION;;0 - 20,000;2;2;0;0;0;0
1250650;AI＊Shoujo/AI＊少女;;100,000 - 200,000;1575;485;1090;327;327;37
1250660;Magic Archers;;0 - 20,000;1;0;1;0;0;0
1250720;Libtard: The Satire Game;;0 - 20,000;9;6;3;0;0;0
1250760;Far Away;;200,000 - 500,000;4727;67;4660;267;413;29
1250770;前進吧！高捷少女Initiating Station PLUS;;0 - 20,000;88;4;84;0;0;0
1250790;Crafting Idle Clicker;;100,000 - 200,000;291;306;-15;0;0;129
1250810;Festoon;;0 - 20,000;1;0;1;0;0;0
1250870;Cyrano Story;;;;;0;;;
1250900;Project Beril / 贝丽尔养成计划;;0 - 20,000;58;4;54;0;0;0
1250940;Demon Blast;;20,000 - 50,000;7;4;3;0;0;0
1250940;Demon Blast;;20,000 - 50,000;7;4;3;0;0;0
1250960;Space Redemption;;0 - 20,000;3;3;0;0;0;0
1250990;Summoners Mist;;0 - 20,000;1;0;1;0;0;0
1251090;Wolfie's Break Out;;0 - 20,000;4;0;4;0;0;0
1251190;Dragon and Weed: Origins - Prologue;;0 - 20,000;6;12;-6;0;0;0
1251200;Glitchy Apocalypse Simulator;;0 - 20,000;10;0;10;0;0;0
1251210;Dungeon No Dungeon;;20,000 - 50,000;296;194;102;222;222;1
1251250;Cock Soccer;;0 - 20,000;8;0;8;0;0;0
1251290;Devil fight;;0 - 20,000;2;6;-4;0;0;0
1251300;Last Floor;;100,000 - 200,000;194;79;115;0;0;1
1251320;JumPlose;;0 - 20,000;1;1;0;0;0;0
1251330;Frak!;;0 - 20,000;10;0;10;0;0;0
1251400;The World Of Xian;;0 - 20,000;9;10;-1;0;0;0
1251410;Golf Ace;;0 - 20,000;38;32;6;0;0;0
1251430;Box: Boxing;;0 - 20,000;8;3;5;0;0;0
1251460;Tanuki Sunset;;0 - 20,000;409;28;381;0;0;1
1251470;Vilundia;;0 - 20,000;1;0;1;0;0;0
1251520;Mystic Escape - Diary of a Prisoner;;0 - 20,000;7;1;6;0;0;0
1251530;Speed0;;0 - 20,000;11;5;6;0;0;0
1251560;Buck Bradley: Comic Adventure;;0 - 20,000;20;2;18;0;0;0
1251560;Buck Bradley: Comic Adventure;;0 - 20,000;20;2;18;0;0;0
1251750;Family Man: Prologue;;0 - 20,000;84;15;69;0;0;0
1251760;Colorful 3D II;;0 - 20,000;1;5;-4;0;0;0
1251770;What The Bear?;;0 - 20,000;5;5;0;0;0;0
1251840;Roman Way;;0 - 20,000;10;5;5;0;0;0
1251850;Inferno - Beyond the 7th Circle;;20,000 - 50,000;44;13;31;0;0;0
1251910;Kill Yourself;;20,000 - 50,000;69;8;61;0;0;0
1251910;Kill Yourself;;20,000 - 50,000;69;8;61;0;0;0
1251930;My Lovely Wife;;50,000 - 100,000;364;106;258;0;0;9
1251950;Escape of Mari: The Polar Ladybug;;0 - 20,000;1;0;1;0;0;0
1251970;Gladiator Manager;;0 - 20,000;80;15;65;0;0;1
1251980;Jessika;;0 - 20,000;131;51;80;1061;1061;2
1252000;GOAL! The Club Manager;;0 - 20,000;114;138;-24;0;0;18
1252010;VEGAS Movie Studio 17 Platinum Steam Edition;;0 - 20,000;124;145;-21;740;740;27
1252020;Ahlman Mansion 2020;;0 - 20,000;12;4;8;0;0;0
1252030;Steel & Bone;;0 - 20,000;23;5;18;0;0;0
1252040;Dreamstate Racing;;20,000 - 50,000;15;15;0;0;0;0
1252050;Elliot and the Musical Journey;;0 - 20,000;18;10;8;0;0;0
1252100;COSMOS;;0 - 20,000;18;1;17;0;0;0
1252120;Go Far Away;;0 - 20,000;2;0;2;0;0;0
1252160;Pejes Vs Zombies;;0 - 20,000;31;6;25;0;0;0
1252170;InfiniteCorp: Cyberpunk Cards;;0 - 20,000;22;4;18;0;0;1
1252190;Sole Iron Tail;;0 - 20,000;13;1;12;0;0;0
1252210;Guile & Glory: Firstborn;;0 - 20,000;18;0;18;0;0;0
1252240;Aeon Drive;;0 - 20,000;73;17;56;0;0;1
1252250;The Celtos;;50,000 - 100,000;107;30;77;0;0;0
1252300;RetroMania Wrestling;;0 - 20,000;213;32;181;0;0;0
1252330;DEATHLOOP;;500,000 - 1,000,000;18832;5727;13105;694;401;256
1252390;CyberHive;;0 - 20,000;31;13;18;0;0;0
1252400;Discord Rich Me! (Custom Rich Presence);;0 - 20,000;117;44;73;0;0;4
1252410;Alien Scumbags;;0 - 20,000;113;3;110;0;0;0
1252450;Skin and Bones;;0 - 20,000;4;0;4;0;0;0
1252480;Plasticalypse - Submarine Adventures;;0 - 20,000;5;4;1;0;0;0
1252510;Mars Plan;;0 - 20,000;2;0;2;0;0;0
1252510;Mars Plan;;0 - 20,000;2;0;2;0;0;0
1252560;Love Breakout;;50,000 - 100,000;543;77;466;120;145;1
1252580;Rising Hell - Prologue;;20,000 - 50,000;88;15;73;12;12;0
1252600;ANOTHER EDEN;;200,000 - 500,000;956;415;541;85;131;217
1252630;Flip Tale;;0 - 20,000;2;0;2;0;0;0
1252650;Mini Golf Club;;0 - 20,000;13;1;12;0;0;0
1252710;Cardaclysm;;20,000 - 50,000;315;150;165;744;744;2
1252730;WWII Partisanen;;0 - 20,000;4;7;-3;0;0;0
1252760;Ancient charm;;0 - 20,000;31;13;18;0;0;0
1252780;Bloons Monkey City;;200,000 - 500,000;4117;355;3762;683;76;382
1252830;A Juggler's Tale;;0 - 20,000;460;28;432;0;0;1
1252850;PRIMAL DUNGEON;;0 - 20,000;40;1;39;0;0;0
1252920;Wire up!;;0 - 20,000;0;2;-2;0;0;0
1253010;Stella Pastoris;;20,000 - 50,000;6;0;6;0;0;0
1253030;Cubecois;;20,000 - 50,000;3;4;-1;0;0;0
1253050;City Breaker;;0 - 20,000;5;0;5;0;0;0
1253160;Virtual Viking;;0 - 20,000;9;0;9;0;0;0
1253180;Dark Disharmony;;20,000 - 50,000;9;7;2;0;0;0
1253190;Warhammer 40,000: Dakka Squadron - Flyboyz Edition;;20,000 - 50,000;282;67;215;212;292;2
1253240;Super Astreus 2;;0 - 20,000;1;0;1;0;0;0
1253270;Scoot Kaboom and the Tomb of Doom;;0 - 20,000;56;2;54;0;0;0
1253320;Seconds in Space;;0 - 20,000;1;0;1;0;0;0
1253390;Yukikoi Melt;;0 - 20,000;55;6;49;0;0;4
1253400;人格面具：陰影面積(Persona：Shadow);;0 - 20,000;2;2;0;0;0;0
1253450;Gnomes & Co: The Art of the Build;;0 - 20,000;2;0;2;0;0;0
1253460;Colouration;;20,000 - 50,000;0;6;-6;0;0;0
1253520;Heidelberg 1693;;20,000 - 50,000;56;9;47;0;0;1
1253550;VEGAS Movie Studio 17 Steam Edition;;0 - 20,000;57;69;-12;408;408;12
1253580;My Dangerous Life;;0 - 20,000;45;9;36;618;618;0
1253610;Knights of Braveland;;0 - 20,000;37;12;25;0;0;72
1253620;VE GSIM Tower Crane Simulator;;0 - 20,000;3;7;-4;0;0;0
1253650;Birds with Feelings;;0 - 20,000;9;0;9;0;0;0
1253680;Super Soccer Blast;;0 - 20,000;90;34;56;540;540;13
1253690;Teke Teke - テケテケ;;0 - 20,000;46;40;6;0;0;0
1253710;Garbage;;50,000 - 100,000;602;235;367;748;748;9
1253720;Blue Fox;;0 - 20,000;5;4;1;0;0;0
1253760;Little Adventures;;0 - 20,000;3;0;3;0;0;0
1253860;Neurodeck : Psychological Deckbuilder;;0 - 20,000;142;74;68;0;0;1
1253920;Rogue Legacy 2;;200,000 - 500,000;11222;1138;10084;784;688;554
1253930;Seeker: My Shadow;;0 - 20,000;10;3;7;0;0;0
1253940;Good Goliath;;0 - 20,000;11;2;9;0;0;0
1253950;Dreamscaper: Prologue;;200,000 - 500,000;1780;204;1576;315;602;0
1254070;Fusion SHIFT;;0 - 20,000;10;0;10;0;0;0
1254110;Quarres;;0 - 20,000;4;3;1;0;0;0
1254120;Bless Unleashed;;2,000,000 - 5,000,000;15365;14241;1124;1787;130;826
1254150;Floppy Heroes 2;;0 - 20,000;17;5;12;0;0;0
1254160;Sleeping Beauty;;0 - 20,000;8;9;-1;0;0;0
1254180;Sliptime Sleuth;;0 - 20,000;12;0;12;0;0;0
1254200;Warp Factor;;0 - 20,000;2;0;2;0;0;0
1254280;Locked;;0 - 20,000;30;7;23;0;0;0
1254320;Surviving the Abyss;;50,000 - 100,000;344;124;220;155;177;89
1254360;街机捕鱼Arcade Fishing;;50,000 - 100,000;255;104;151;0;0;10
1254370;No one lives under the lighthouse Director's cut;;100,000 - 200,000;1145;138;1007;98;149;8
1254390;Toxastra;;0 - 20,000;0;1;-1;0;0;0
1254400;Malus;;20,000 - 50,000;179;105;74;0;0;0
1254410;破阵图(Grids of World);;0 - 20,000;4;3;1;0;0;0
1254430;YATB：You Are The Best - Egypt Chapter;;0 - 20,000;13;6;7;0;0;0
1254480;Beyond This Side;;20,000 - 50,000;31;16;15;0;0;0
1254490;The Prodigal Soul;;0 - 20,000;2;6;-4;0;0;0
1254590;Choco Pixel 3;;0 - 20,000;8;3;5;0;0;0
1254610;Belote - Learn & Play;;0 - 20,000;1;1;0;0;0;0
1254610;Belote - Learn & Play;;0 - 20,000;1;1;0;0;0;0
1254620;NAMCO MUSEUM ARCHIVES Vol 2;;0 - 20,000;70;11;59;35;35;3
1254630;Spacky's Nightshift;;0 - 20,000;25;10;15;0;0;0
1254670;Night Reverie;;0 - 20,000;212;7;205;0;0;1
1254720;The Last Bee;;0 - 20,000;4;6;-2;0;0;0
1254820;Tank Game;;0 - 20,000;3;1;2;0;0;0
1254860;World Championship Boxing Manager;;0 - 20,000;15;7;8;0;0;0
1254870;High Strategy: Urukon;;20,000 - 50,000;79;12;67;0;0;0
1254900;迷雾之夏-The Vigilant Villa;;50,000 - 100,000;776;196;580;0;0;3
1254930;Rain Island;;0 - 20,000;27;6;21;0;0;0
1254950;Hell To Raze;;0 - 20,000;11;4;7;0;0;0
1255010;Bloom: The Forest Burns;;0 - 20,000;9;2;7;0;0;0
1255030;Bunny Quest;;0 - 20,000;9;2;7;0;0;0
1255040;Let's Learn Korean! Hangul;;0 - 20,000;50;1;49;3;3;0
1255050;Craft In Abyss;;0 - 20,000;45;5;40;0;0;0
1255060;THE SKIES: REBORN;;50,000 - 100,000;33;111;-78;0;0;0
1255130;Unlock The King 3;;20,000 - 50,000;45;10;35;0;0;0
1255160;Oh So Lucky, Doctor!;;0 - 20,000;4;1;3;0;0;0
1255170;Captain Pegleg;;0 - 20,000;5;1;4;0;0;0
1255230;Saranity;;0 - 20,000;9;0;9;0;0;0
1255300;Space Sergeants;;20,000 - 50,000;4;4;0;0;0;0
1255380;Roller Riot;;20,000 - 50,000;135;14;121;0;0;0
1255410;Purple Saturn Day;;0 - 20,000;1;0;1;0;0;0
1255420;Murders in Space;;0 - 20,000;1;0;1;0;0;0
1255520;RaidLand;;100,000 - 200,000;619;94;525;0;0;0
1255550;Strange Creatures;;;;;0;;;
1255560;Myst;;20,000 - 50,000;884;108;776;250;446;16
1255630;WWE 2K22;;200,000 - 500,000;6452;2407;4045;1514;1095;2184
1255640;吞噬追踪;;0 - 20,000;11;3;8;0;0;0
1255650;Geometry Arena;;50,000 - 100,000;2103;66;2037;543;642;7
1255660;Mya of the Desert;;20,000 - 50,000;70;40;30;0;0;0
1255680;Hand Cannon Virtuoso;;0 - 20,000;10;0;10;0;0;0
1255730;RUNPUZZLE;;0 - 20,000;5;2;3;0;0;0
1255740;Karma Knight;;0 - 20,000;51;6;45;0;0;0
1255810;幻想小镇危机;;0 - 20,000;7;10;-3;0;0;0
1255870;Jesus Christ RPG: Lucifer;;0 - 20,000;4;0;4;0;0;0
1255880;Whisper;;0 - 20,000;3;0;3;0;0;0
1255910;GANZWORKER;;0 - 20,000;12;1;11;0;0;0
1255920;Graviter;;0 - 20,000;7;0;7;0;0;0
1255970;Kicks Online;;50,000 - 100,000;169;61;108;0;0;2
1255990;We should talk.;;0 - 20,000;76;37;39;0;0;0
1256040;Hyper Treasure - The Legend of Macaron;;0 - 20,000;13;1;12;0;0;0
1256060;Cosmodread;;20,000 - 50,000;316;25;291;0;0;3
1256130;AnShi;;0 - 20,000;24;8;16;0;0;0
1256190;Chickduck & Catduck;;0 - 20,000;15;2;13;0;0;0
1256220;幸存者 星星之火 | Survivor Spark;;20,000 - 50,000;15;0;15;0;0;0
1256230;Hyperbolica;;50,000 - 100,000;828;168;660;142;153;4
1256350;Ultimate Under Water;;0 - 20,000;4;4;0;0;0;0
1256360;Wild West Steam Loco;;0 - 20,000;2;0;2;0;0;0
1256380;FPS Infinite;;20,000 - 50,000;78;13;65;0;0;0
1256430;LAST CHICK - 最後のひよこ;;0 - 20,000;18;2;16;0;0;0
1256440;Bells 'n' Whistles;;0 - 20,000;2;0;2;0;0;0
1256480;A Siren's Call  VR: Legacy ( A VR Short Story);;50,000 - 100,000;0;11;-11;0;0;0
1256490;Othello Let's Go;;0 - 20,000;32;0;32;0;0;0
1256500;Ohayou! Beginner's Japanese;;0 - 20,000;6;3;3;0;0;0
1256510;Dreadtides;;0 - 20,000;21;5;16;0;0;0
1256520;Bone Appetit;;0 - 20,000;55;6;49;0;0;0
1256530;Sentimental K;;0 - 20,000;276;49;227;0;0;0
1256550;Marshmallow Tank;;20,000 - 50,000;1;0;1;0;0;0
1256610;Dream Date;;100,000 - 200,000;1815;295;1520;45;55;5
1256650;Move It Up;;0 - 20,000;3;0;3;0;0;0
1256660;Iwate Mountain Dance;;0 - 20,000;26;1;25;0;0;0
1256670;Library Of Ruina;;500,000 - 1,000,000;16855;1153;15702;4833;4613;1866
1256680;CHICARO DENTISTRY;;0 - 20,000;1;0;1;0;0;0
1256710;Super Arcade Soccer 2021;;0 - 20,000;19;14;5;0;0;1
1256770;Doctor Klyvinski;;0 - 20,000;1;0;1;0;0;0
1256830;Shelter Manager;;20,000 - 50,000;190;94;96;6;6;0
1256850;Audio Drive 2 VR;;20,000 - 50,000;1;8;-7;0;0;0
1256870;Pirate Island Mini Golf VR;;0 - 20,000;0;1;-1;0;0;0
1256920;D3D INSIDE 2: HELL;;0 - 20,000;39;8;31;0;0;0
1256950;Draft Day Sports: College Basketball 2020;;0 - 20,000;39;18;21;0;0;3
1256980;Bubble Bounce;;0 - 20,000;0;1;-1;0;0;0
1257000;A Week In The Cold;;0 - 20,000;4;0;4;0;0;0
1257170;Saint Emiliana;;20,000 - 50,000;199;52;147;0;0;1
1257190;VR Mini Bowling 2;;0 - 20,000;4;1;3;0;0;0
1257200;False Myth;;0 - 20,000;339;41;298;1026;1026;7
1257210;Rabbit Simulator;;0 - 20,000;42;5;37;0;0;1
1257250;Metal Gunner;;20,000 - 50,000;15;5;10;0;0;0
1257270;The Valley of Super Flowers;;0 - 20,000;2;6;-4;0;0;0
1257280;Monuments Flipper;;0 - 20,000;101;30;71;0;0;5
1257290;Atelier Ryza 2: Lost Legends & the Secret Fairy;;100,000 - 200,000;2374;223;2151;1711;2605;264
1257300;King of Cooking;;0 - 20,000;7;1;6;0;0;0
1257310;Mechstermination Force;;0 - 20,000;35;36;-1;0;0;0
1257360;Bloodstained: Curse of the Moon 2;;100,000 - 200,000;1027;142;885;62;62;10
1257360;Bloodstained: Curse of the Moon 2;;100,000 - 200,000;1027;142;885;62;62;10
1257410;Cat in the Box;;20,000 - 50,000;905;55;850;27;27;3
1257520;Zatorski, Ph.D.;;20,000 - 50,000;4;1;3;0;0;0
1257540;Resistance TD;;0 - 20,000;1;3;-2;0;0;0
1257550;Mercenary Skirmish;;100,000 - 200,000;8;5;3;0;0;0
1257560;Make Your Kingdom: Prologue;;50,000 - 100,000;336;93;243;0;0;0
1257590;Spinner Invaders;;0 - 20,000;0;2;-2;0;0;0
1257600;SWORDSHOT;;0 - 20,000;18;2;16;0;0;0
1257620;MagiCarnage;;0 - 20,000;3;0;3;0;0;0
1257660;Time Rift;;0 - 20,000;112;2;110;0;0;1
1257670;Nyanco Space;;0 - 20,000;14;0;14;0;0;0
1257700;Wacky Golf Land;;0 - 20,000;5;1;4;0;0;0
1257720;Help Me Now;;20,000 - 50,000;3;5;-2;0;0;0
1257810;I'm on Observation Duty 2;;0 - 20,000;239;22;217;41;65;14
1257850;SOLAS 128;;0 - 20,000;152;5;147;0;0;0
1257860;Clea 2;;0 - 20,000;87;1;86;21;21;0
1257880;Glover;;0 - 20,000;110;69;41;104;104;0
1257890;The Legacy: Realm of Terror;;0 - 20,000;6;0;6;0;0;0
1257900;Hexplore;;0 - 20,000;25;2;23;0;0;0
1257910;DethKarz;;0 - 20,000;44;2;42;0;0;0
1257920;Canon - Legend of the New Gods;;0 - 20,000;2;1;1;0;0;0
1257930;Zero Tolerance;;0 - 20,000;35;9;26;0;0;1
1257950;Motor Mash;;20,000 - 50,000;3;2;1;0;0;0
1257950;Motor Mash;;20,000 - 50,000;3;2;1;0;0;0
1258000;RADARjAM;;0 - 20,000;4;0;4;0;0;0
1258020;SNIKS;;0 - 20,000;31;0;31;0;0;0
1258040;Super Bernie World;;100,000 - 200,000;2384;647;1737;0;0;2
1258070;The Travelyan Home;;0 - 20,000;3;0;3;0;0;0
1258080;Shop Titans;;1,000,000 - 2,000,000;10485;2882;7603;5732;125;5887
1258090;Duck Duck Goose;;0 - 20,000;12;13;-1;0;0;1
1258140;Secret House | 秘密房间 | 秘密の部屋;;0 - 20,000;6;8;-2;0;0;0
1258200;Forsaken Spire;;0 - 20,000;3;3;0;0;0;0
1258220;Song of Iron;;0 - 20,000;268;99;169;71;71;0
1258290;Fantasy Memory Card Game;;20,000 - 50,000;1;1;0;0;0;0
1258310;Mushroom Cats 2;;0 - 20,000;436;10;426;0;0;1
1258370;DragonScales 6: Love and Redemption;;0 - 20,000;0;1;-1;0;0;0
1258410;Shinobi no Okite/The three female ninjas;;20,000 - 50,000;1;1;0;0;0;0
1258420;Valkyrie's Arrow | 瓦尔基丽的箭;;0 - 20,000;2;0;2;0;0;0
1258440;BLIND QUEST - The Enchanted Castle;;0 - 20,000;2;0;2;0;0;0
1258460;Escape First 3;;20,000 - 50,000;120;70;50;141;141;1
1258480;Aladdin - Hidden Objects Game;;0 - 20,000;39;8;31;0;0;0
1258520;AST-Hero;;20,000 - 50,000;16;0;16;0;0;1
1258560;VR Mummy Girl;;0 - 20,000;5;1;4;0;0;0
1258580;Star Shaman;;20,000 - 50,000;7;2;5;0;0;0
1258590;Locked Up;;50,000 - 100,000;713;180;533;97;114;5
1258620;Little machines world;;0 - 20,000;5;6;-1;0;0;0
1258640;Victorian Admirals Marianas Incident 1887;;0 - 20,000;0;2;-2;0;0;0
1258650;Nyxx;;0 - 20,000;3;0;3;0;0;0
1258710;BEAR, VODKA, FALL OF BERLIN! ;;20,000 - 50,000;370;31;339;0;0;1
1258730;Cyborg Arena 2;;0 - 20,000;10;3;7;0;0;0
1258750;JACK 'N' HAT;;0 - 20,000;10;4;6;0;0;0
1258770;6 PEOPLE;;0 - 20,000;19;24;-5;0;0;0
1258780;B100X - Auto Dungeon RPG;;100,000 - 200,000;619;131;488;0;0;89
1258790;VideoHole: Episode I;;0 - 20,000;47;2;45;0;0;0
1258800;Project Dagger;;0 - 20,000;15;3;12;0;0;3
1258830;Typing Fingers - Enemy;;0 - 20,000;2;1;1;0;0;0
1258840;Stimuli;;0 - 20,000;6;1;5;0;0;0
1258870;Aura Kingdom 2;;20,000 - 50,000;80;169;-89;0;0;0
1258900;Arcade Redemption;;0 - 20,000;12;9;3;0;0;0
1258920;The Maze;;0 - 20,000;1;0;1;0;0;0
1258930;The Sunset that day, あの日見た夕陽;;20,000 - 50,000;2;0;2;0;0;0
1258950;SWISCAPE;;0 - 20,000;2;3;-1;0;0;0
1258960;Alpha Particle;;0 - 20,000;6;1;5;0;0;0
1258970;LunarLux Chapter 1;;0 - 20,000;93;4;89;0;0;0
1258980;SpellPunk VR;;20,000 - 50,000;30;10;20;0;0;0
1258990;Rushberry Mercs;;0 - 20,000;1;0;1;0;0;0
1259000;Damascus;;50,000 - 100,000;190;53;137;0;0;0
1259050;Under Shelter;;0 - 20,000;10;14;-4;0;0;0
1259130;Rover Wars;;0 - 20,000;23;6;17;0;0;0
1259140;Ashina: The Red Witch;;0 - 20,000;84;3;81;0;0;1
1259150;Plan V: Virtual Studio;;0 - 20,000;5;3;2;0;0;0
1259160;Land of Zympaia;;0 - 20,000;0;4;-4;0;0;0
1259180;Ashina: The Red Witch: Prologue;;100,000 - 200,000;151;20;131;0;0;0
1259230;Core Defense: Prelude;;20,000 - 50,000;185;27;158;0;0;0
1259280;ambr;;20,000 - 50,000;8;6;2;0;0;0
1259290;Victorian Admirals Panama Crisis 1885;;0 - 20,000;3;3;0;0;0;0
1259300;Spot Sample Witness Simulator;;0 - 20,000;5;2;3;0;0;0
1259310;KnightRoyale;;0 - 20,000;7;0;7;0;0;0
1259330;Stolen Rage;;0 - 20,000;10;1;9;0;0;0
1259340;Victorian Admirals Samoan Crisis 1889;;0 - 20,000;2;3;-1;0;0;0
1259370;Worm Jazz;;0 - 20,000;13;0;13;0;0;0
1259380;Submarine Titans;;0 - 20,000;215;27;188;58;58;1
1259390;Military Service;;20,000 - 50,000;4;1;3;0;0;0
1259420;Days Gone;;2,000,000 - 5,000,000;50784;3920;46864;1495;960;3916
1259430;First Snow;;50,000 - 100,000;510;30;480;0;0;1
1259470;Casus;;0 - 20,000;2;0;2;0;0;0
1259480;Pteranodon's Flight: The Flying Dinosaur Game;;0 - 20,000;1;0;1;0;0;0
1259510;Venge;;20,000 - 50,000;270;19;251;0;0;0
1259520;Topang;;0 - 20,000;4;2;2;0;0;0
1259560;Britannic: Patroness of the Mediterranean;;50,000 - 100,000;607;69;538;0;0;1
1259570;Around the Fire;;0 - 20,000;2;0;2;0;0;0
1259580;Nonno Lorenzo;;0 - 20,000;16;1;15;0;0;0
1259600;There Was the Moon;;0 - 20,000;27;1;26;0;0;0
1259640;Tiny Room Stories: Town Mystery;;50,000 - 100,000;439;45;394;566;566;3
1259660;NETABOKU -A robot girl changes my life as a bedridden boy-;;0 - 20,000;3;0;3;0;0;1
1259790;Puyo Puyo Tetris 2;;100,000 - 200,000;987;227;760;1156;1529;223
1259800;MXGP 2020 - The Official Motocross Videogame;;0 - 20,000;515;129;386;0;0;26
1259830;Turniej Robotów;;0 - 20,000;7;0;7;0;0;0
1259840;The House of Da Vinci 2;;100,000 - 200,000;1250;99;1151;359;381;30
1259860;GraFi St.Patrick;;0 - 20,000;9;3;6;0;0;0
1259890;Northern Tale 5: Revival;;0 - 20,000;22;1;21;0;0;3
1259960;The Metamorphosis;;0 - 20,000;21;2;19;0;0;0
1259970;eFootball PES 2021 SEASON UPDATE;;1,000,000 - 2,000,000;27931;8730;19201;4431;415;3321
1259980;RIDE 4;;200,000 - 500,000;6532;1558;4974;965;425;740
1259990;Super Dee;;0 - 20,000;17;6;11;0;0;0
1260020;PowerSlave (DOS Classic Edition);;0 - 20,000;36;4;32;0;0;0
1260030;Revel Rousers;;0 - 20,000;4;0;4;0;0;0
1260130;Banana Hell;;100,000 - 200,000;515;214;301;0;0;3
1260160;Down The Hole;;0 - 20,000;6;2;4;0;0;0
1260170;Creator's Chasm;;0 - 20,000;6;2;4;0;0;0
1260230;Scrolor;;0 - 20,000;1;1;0;0;0;0
1260240;30 days of plague;;20,000 - 50,000;1;3;-2;0;0;0
1260250;SECTOR 40: The Soviet Legacy;;0 - 20,000;1;5;-4;0;0;0
1260300;Pity Pit;;0 - 20,000;8;1;7;0;0;0
1260310;ASTRA-256 Assembler;;0 - 20,000;13;2;11;0;0;0
1260340;Naturalist Stories;;0 - 20,000;1;1;0;0;0;0
1260370;Deeproot Manor;;0 - 20,000;6;0;6;0;0;0
1260400;Challenge Speedball;;20,000 - 50,000;60;40;20;0;0;0
1260470;Henchman For Hire;;0 - 20,000;11;5;6;0;0;0
1260490;Astro-g;;0 - 20,000;9;0;9;0;0;0
1260520;Patrick's Parabox;;20,000 - 50,000;1996;13;1983;151;151;57
1260560;Line Simulator;;0 - 20,000;2;5;-3;0;0;0
1260580;ReThink | Evolved 4;;0 - 20,000;19;1;18;0;0;0
1260590;Hadean Tactics;;0 - 20,000;453;40;413;0;0;19
1260590;Hadean Tactics;;0 - 20,000;453;40;413;0;0;19
1260610;Andarigas;;0 - 20,000;3;0;3;0;0;0
1260690;Man Face Spider I;;0 - 20,000;2;1;1;0;0;0
1260710;Lusitania;;0 - 20,000;44;12;32;0;0;0
1260720;Elemental Echoes;;20,000 - 50,000;0;1;-1;0;0;0
1260720;Elemental Echoes;;20,000 - 50,000;0;1;-1;0;0;0
1260770;Radio Station;;0 - 20,000;13;5;8;0;0;0
1260810;Touhou Blooming Chaos 2;;50,000 - 100,000;2167;129;2038;798;1338;25
1260830;Metallic Metronome;;0 - 20,000;68;9;59;0;0;0
1260840;The Casebook of Arkady Smith;;0 - 20,000;4;9;-5;0;0;0
1260860;Ninja Scarf;;0 - 20,000;5;2;3;0;0;0
1260910;Demelia's Isle;;0 - 20,000;6;3;3;0;0;0
1260920;Spirit of Adventure;;200,000 - 500,000;0;2;-2;0;0;0
1260930;Keep the Balance;;0 - 20,000;0;1;-1;0;0;0
1260960;Kairos'Light;;0 - 20,000;80;3;77;0;0;0
1261010;NEAVE;;0 - 20,000;21;7;14;0;0;1
1261020;Edge of Dreams;;0 - 20,000;24;1;23;0;0;0
1261040;Streamer Life Simulator;;200,000 - 500,000;4474;1179;3295;293;265;67
1261060;Cosmic Journey PC Live Wallpaper;;0 - 20,000;37;11;26;0;0;5
1261130;Shoot Them 2;;0 - 20,000;86;16;70;0;0;1
1261160;扶搖直上;;0 - 20,000;18;10;8;0;0;0
1261170;HANGMAN II;;0 - 20,000;15;3;12;0;0;0
1261180;Rebirth Online;;50,000 - 100,000;117;173;-56;0;0;10
1261200;Ace Campus Club;;0 - 20,000;23;15;8;0;0;0
1261220;The Neverland of the Mountain and Sea;;0 - 20,000;157;4;153;0;0;1
1261280;No Exit : Torments of Hell;;0 - 20,000;3;0;3;0;0;0
1261300;Racingmaybe;;0 - 20,000;57;2;55;0;0;0
1261390;Crown of the Empire Around the World;;0 - 20,000;7;1;6;0;0;1
1261430;Kandria;;0 - 20,000;87;2;85;0;0;1
1261490;Cork The Volcano;;0 - 20,000;1;0;1;0;0;0
1261520;Asterix & Obelix XXL: Romastered;;20,000 - 50,000;302;102;200;75;140;6
1261530;Ponpu;;0 - 20,000;44;15;29;0;0;0
1261570;Motion Of The Heart;;0 - 20,000;37;22;15;0;0;0
1261630;Mindframe: The Secret Design Collector's Edition;;0 - 20,000;6;0;6;0;0;0
1261640;Fill all;;0 - 20,000;28;1;27;0;0;0
1261650;Berry mayhem;;0 - 20,000;0;6;-6;0;0;0
1261660;Flatland: Prologue;;0 - 20,000;37;3;34;0;0;0
1261670;Poker Hands;;0 - 20,000;28;8;20;0;0;0
1261700;Knight's Retreat;;0 - 20,000;79;4;75;0;0;0
1261750;Em-A-Zurvival;;100,000 - 200,000;18;1;17;0;0;0
1261760;Democratic Socialism Simulator;;0 - 20,000;67;7;60;0;0;1
1261790;ABSOLUTE;;0 - 20,000;0;3;-3;0;0;0
1261820;Kernmantle;;0 - 20,000;5;0;5;0;0;0
1261880;Education;;0 - 20,000;61;34;27;0;0;0
1261900;Sunrise 7;;0 - 20,000;5;1;4;0;0;0
1261960;STRIKERS 1945;;0 - 20,000;113;7;106;0;0;1
1261970;GUNBIRD;;0 - 20,000;71;2;69;0;0;0
1261980;Samurai Aces;;0 - 20,000;32;3;29;0;0;0
1261990;Horse Racing Rally;;0 - 20,000;23;15;8;0;0;0
1262030;猎魔战纪;;0 - 20,000;3;5;-2;0;0;0
1262040;Super Mombo Quest;;0 - 20,000;254;5;249;0;0;13
1262060;Battle Ram;;100,000 - 200,000;279;38;241;0;0;150
1262070;Arc Defence;;0 - 20,000;4;2;2;0;0;0
1262080;Black blood;;0 - 20,000;14;10;4;0;0;0
1262110;Ultimo Reino 2;;0 - 20,000;14;16;-2;0;0;0
1262120;Evil Heart Fever;;0 - 20,000;14;2;12;0;0;0
1262140;Rangok Skies;;0 - 20,000;18;8;10;0;0;1
1262180;Space Haters;;0 - 20,000;1;0;1;0;0;0
1262190;Without A Voice;;20,000 - 50,000;229;9;220;0;0;0
1262240;Plants vs. Zombies: Battle for Neighborville;;500,000 - 1,000,000;7937;2975;4962;465;573;310
1262260;Maze Slider;;0 - 20,000;4;3;1;0;0;0
1262350;SIGNALIS;;200,000 - 500,000;5744;183;5561;394;460;145
1262380;Hexagon Heroes;;0 - 20,000;3;1;2;0;0;0
1262450;Blaster Squad;;0 - 20,000;3;0;3;0;0;0
1262460;Zompiercer;;20,000 - 50,000;952;154;798;1014;1014;40
1262470;STRAIGHT ON 8;;0 - 20,000;2;6;-4;0;0;0
1262500;Mirastell;;0 - 20,000;2;1;1;0;0;0
1262530;Fire Protection Training Simulator;;0 - 20,000;2;3;-1;0;0;0
1262540;Need for Speed;;500,000 - 1,000,000;10076;4178;5898;686;429;147
1262560;Need for Speed Most Wanted;;500,000 - 1,000,000;10093;2902;7191;848;397;135
1262580;Need for Speed Payback;;1,000,000 - 2,000,000;15699;2562;13137;1433;490;387
1262600;Need for Speed Rivals;;200,000 - 500,000;3824;1302;2522;429;400;47
1262720;Ruin Raiders;;0 - 20,000;29;15;14;0;0;1
1262760;Digitizer;;0 - 20,000;4;2;2;0;0;0
1262770;Snake Core;;0 - 20,000;3;3;0;0;0;0
1262780;Polary;;0 - 20,000;12;5;7;0;0;0
1262790;Crazy Projectile;;0 - 20,000;4;0;4;0;0;0
1262830;Squatch;;0 - 20,000;1;1;0;0;0;0
1262880;Abacus Finch;;0 - 20,000;1;0;1;0;0;0
1262890;Tidal Shock;;0 - 20,000;38;2;36;0;0;0
1262910;Heart's Medicine - Doctor's Oath;;0 - 20,000;105;52;53;0;0;18
1262910;Heart's Medicine - Doctor's Oath;;0 - 20,000;105;52;53;0;0;18
1262920;Horned Knight;;0 - 20,000;5;2;3;0;0;0
1262930;Handball Manager 2021;;0 - 20,000;56;9;47;0;0;3
1263070;Blightbound;;50,000 - 100,000;805;420;385;163;245;19
1263090;Swatch Out!;;0 - 20,000;1;0;1;0;0;0
1263100;Last Kids on Earth and the Staff of Doom;;0 - 20,000;7;3;4;0;0;0
1263110;What Makes Us Special;;20,000 - 50,000;26;7;19;0;0;0
1263120;Hecaton;;0 - 20,000;4;1;3;0;0;0
1263200;Smashing Spirits: Brazil's First Boxer;;0 - 20,000;30;6;24;0;0;0
1263220;Corpse disaster-survivors;;0 - 20,000;16;19;-3;0;0;0
1263230;Cooking Companions;;0 - 20,000;756;37;719;33;33;7
1263230;Cooking Companions;;0 - 20,000;756;37;719;33;33;7
1263350;The Company Man;;0 - 20,000;61;8;53;0;0;0
1263370;Seek Girl:Fog Ⅰ;;100,000 - 200,000;3802;683;3119;116;97;17
1263410;The Tide;;0 - 20,000;5;3;2;0;0;0
1263450;蔚蓝月下;;0 - 20,000;25;4;21;0;0;1
1263490;Sweet Solitaire: School Witch;;0 - 20,000;10;3;7;0;0;2
1263510;Spy Story. The Elusive Evidence;;0 - 20,000;1;1;0;0;0;0
1263520;Dark Solitaire. Mystical Circus;;0 - 20,000;3;0;3;0;0;0
1263530;Dangerous Solitaire. Zombie Fever;;0 - 20,000;2;2;0;0;0;0
1263540;Mystery Solitaire. Dreamcatcher;;0 - 20,000;6;0;6;0;0;1
1263550;Combat Arms: the Classic;;200,000 - 500,000;794;441;353;287;357;104
1263590;Microodyssey;;0 - 20,000;2;0;2;0;0;0
1263610;AftLife -Girl and Cats, and Lost world-;;0 - 20,000;44;9;35;0;0;0
1263620;Yacht Mechanic Simulator;;20,000 - 50,000;28;105;-77;0;0;2
1263680;486;;0 - 20,000;10;6;4;0;0;0
1263700;Nightwalker;;0 - 20,000;20;7;13;0;0;0
1263720;The Long Sky VR;;0 - 20,000;6;1;5;0;0;0
1263800;DockYard;;0 - 20,000;1;1;0;0;0;0
1263820;sok-worlds;;0 - 20,000;52;6;46;0;0;1
1263850;Football Manager 2021;;2,000,000 - 5,000,000;22083;1557;20526;16708;14249;5400
1263860;Football Manager 2021 Touch;;50,000 - 100,000;596;74;522;57;62;132
1263920;Dark Space;;50,000 - 100,000;5;7;-2;0;0;0
1263930;Wreck it! VR;;0 - 20,000;0;1;-1;0;0;0
1263990;Floor 13: Deep State;;0 - 20,000;9;21;-12;0;0;1
1264000;PROXY;;0 - 20,000;3;5;-2;0;0;0
1264010;9 Till Void;;0 - 20,000;9;0;9;0;0;0
1264050;UNBINARY;;0 - 20,000;11;3;8;0;0;0
1264080;Breaking Blocks;;0 - 20,000;2;1;1;0;0;0
1264090;Once Upon an Electric Dream;;20,000 - 50,000;4;0;4;0;0;0
1264140;Kyo's Routine;;0 - 20,000;6;1;5;0;0;0
1264160;からかい上手の高木さんVR 1学期;;0 - 20,000;130;33;97;0;0;0
1264180;Blueplanet VR;;0 - 20,000;43;10;33;0;0;0
1264190;YoloMic;;0 - 20,000;2;1;1;0;0;1
1264220;Card Blitz: WWII;;20,000 - 50,000;45;27;18;0;0;2
1264230;抵抗组织;;0 - 20,000;3;7;-4;0;0;0
1264240;Infinite Way;;0 - 20,000;0;2;-2;0;0;0
1264250;Fishing: North Atlantic - Enhanced Edition;;50,000 - 100,000;1506;487;1019;1928;2047;94
1264280;Slipways;;200,000 - 500,000;1619;122;1497;275;397;32
1264290;What's Inside??;;0 - 20,000;1;0;1;0;0;0
1264310;VIY;;0 - 20,000;23;4;19;0;0;0
1264350;Echoes of Nocturnal Chords 夜弦之音;;0 - 20,000;72;0;72;0;0;0
1264360;GoldFish Brain;;0 - 20,000;14;5;9;0;0;0
1264470;3dRudder Driver for SteamVR;;0 - 20,000;4;2;2;0;0;0
1264510;Get Out...;;0 - 20,000;5;6;-1;0;0;0
1264520;Vibrant Venture;;0 - 20,000;527;14;513;0;0;4
1264550;Personal Space;;0 - 20,000;6;5;1;0;0;0
1264630;茶 CHAR01 VR;;0 - 20,000;0;1;-1;0;0;0
1264640;Wallpaper Master;;0 - 20,000;9;5;4;0;0;0
1264650;Faircroft's Antiques: Treasures of Treffenburg;;0 - 20,000;10;0;10;0;0;1
1264670;The Wind Road;;500,000 - 1,000,000;4444;2065;2379;1542;1653;13
1264730;Total Arcade Racing;;0 - 20,000;21;0;21;0;0;0
1264740;Lucid Dream;;50,000 - 100,000;808;73;735;0;0;0
1264760;Saturn Quest: Shadow of Planetus;;0 - 20,000;5;8;-3;0;0;0
1264770;Coronavirus Evolution;;0 - 20,000;37;4;33;0;0;0
1264790;Destiny of the World;;0 - 20,000;20;4;16;0;0;1
1264800;Radical Solitaire;;0 - 20,000;11;3;8;0;0;0
1264820;Jade Cicada;;0 - 20,000;8;1;7;0;0;0
1264850;Apastron;;0 - 20,000;17;4;13;0;0;0
1264880;Watcher Chronicles;;0 - 20,000;113;15;98;0;0;1
1264900;Simple Farm;;0 - 20,000;4;0;4;0;0;0
1264920;Endgame: Road To Salvation;;50,000 - 100,000;57;1;56;0;0;25
1264930;King of the Streets;;0 - 20,000;5;2;3;0;0;0
1264970;The Conquest of Go;;20,000 - 50,000;371;25;346;0;0;4
1264990;BallClimbing;;0 - 20,000;3;3;0;0;0;0
1265030;Moorhuhn Kart;;0 - 20,000;47;28;19;0;0;2
1265040;The Abnormal Place;;0 - 20,000;4;1;3;0;0;0
1265070;Escape From Violet Institute;;0 - 20,000;2;2;0;0;0;0
1265080;溜冰的猪少;;0 - 20,000;17;3;14;0;0;0
1265110;Chessmates;;0 - 20,000;2;3;-1;0;0;0
1265120;Freddy Spaghetti;;0 - 20,000;45;3;42;0;0;0
1265130;iMemo;;0 - 20,000;1;0;1;0;0;0
1265140;Get Gem;;0 - 20,000;10;2;8;0;0;0
1265200;Escort Alia;;0 - 20,000;5;4;1;0;0;0
1265220;Cauldrons of War - Barbarossa;;0 - 20,000;115;10;105;0;0;1
1265230;Engine Evolution;;50,000 - 100,000;170;81;89;0;0;1
1265240;Uniform Girl;;20,000 - 50,000;263;116;147;6;10;0
1265260;Space Foes;;0 - 20,000;1;0;1;0;0;0
1265270;Madness Fantasy;;0 - 20,000;6;0;6;0;0;0
1265270;Madness Fantasy;;0 - 20,000;6;0;6;0;0;0
1265300;Broll;;20,000 - 50,000;70;15;55;0;0;0
1265380;Natural Habitat;;0 - 20,000;1;0;1;0;0;0
1265390;EllrLand;;0 - 20,000;38;26;12;0;0;0
1265410;Computer Physics Simulator 2020;;;;;0;;;
1265440;Fire Guild;;0 - 20,000;0;2;-2;0;0;0
1265460;Defenders: Survival and Tower Defense;;0 - 20,000;9;0;9;0;0;0
1265510;Machinist;;0 - 20,000;15;10;5;0;0;3
1265520;Forbidden Z;;0 - 20,000;3;15;-12;0;0;0
1265570;DMLC!;;0 - 20,000;18;4;14;0;0;2
1265580;Miden Tower;;0 - 20,000;7;1;6;0;0;0
1265650;The Drained Goddess;;0 - 20,000;11;16;-5;0;0;0
1265660;One More Shot;;0 - 20,000;2;2;0;0;0;0
1265690;Horse Riding Deluxe 2;;0 - 20,000;23;11;12;0;0;0
1265720;RICO: London;;0 - 20,000;9;13;-4;0;0;1
1265730;Welcome To... Chichester OVN 3 : The Mysterious Affair At The Violet Hotel;;0 - 20,000;9;5;4;0;0;0
1265770;TUNNEL BIRD;;0 - 20,000;9;2;7;0;0;0
1265800;Hubris;;0 - 20,000;238;77;161;273;273;15
1265810;Spacen: The Beginning;;0 - 20,000;10;7;3;0;0;0
1265820;Fights in Tight Spaces;;50,000 - 100,000;2035;140;1895;61;61;70
1265850;Chatventures;;0 - 20,000;112;10;102;0;0;7
1265850;Chatventures;;0 - 20,000;112;10;102;0;0;7
1265860;NASCAR Heat 5;;50,000 - 100,000;1716;424;1292;585;568;274
1265870;Cave Digger PC Edition;;20,000 - 50,000;45;14;31;0;0;0
1265920;Life is Strange Remastered;;100,000 - 200,000;1311;447;864;451;611;49
1265930;Life is Strange: Before the Storm Remastered;;50,000 - 100,000;538;307;231;752;900;17
1265960;Kongfusion;;0 - 20,000;25;6;19;0;0;0
1265970;Dark City: Dublin Collector's Edition;;0 - 20,000;8;3;5;0;0;0
1265990;QUIZ PRO! - General Knowledge;;0 - 20,000;0;2;-2;0;0;0
1266050;Pixel Fixer;;0 - 20,000;1;0;1;0;0;0
1266070;Smashing Healthy VR;;0 - 20,000;2;0;2;0;0;0
1266100;Vampire: The Masquerade — Parliament of Knives;;0 - 20,000;201;8;193;0;0;6
1266120;Unoccupied;;0 - 20,000;22;22;0;0;0;1
1266220;Death end re;;;;;0;;;
1266260;Tribble Troubles;;0 - 20,000;2;1;1;0;0;0
1266340;Arcane Waters;;0 - 20,000;102;44;58;0;0;11
1266370;Real Life Plus Ver. Kaname Komatsuzaki;;0 - 20,000;29;4;25;0;0;0
1266380;Super No Crying in Baseball;;0 - 20,000;4;0;4;0;0;0
1266390;HookSharks;;0 - 20,000;1;0;1;0;0;0
1266410;Climb;;0 - 20,000;7;2;5;0;0;0
1266420;Paper Ghost Stories: 7PM;;0 - 20,000;70;7;63;0;0;0
1266430;Lost In Fantaland;;0 - 20,000;246;30;216;0;0;42
1266430;Lost In Fantaland;;0 - 20,000;246;30;216;0;0;42
1266440;Disarmed;;0 - 20,000;14;6;8;0;0;0
1266440;Disarmed;;0 - 20,000;14;6;8;0;0;0
1266480;MiNNaDe Counter Fight;;0 - 20,000;11;6;5;0;0;0
1266560;鋼鉄戦記C21;;100,000 - 200,000;60;36;24;0;0;7
1266600;亦春秋 Power Of Seasons;;0 - 20,000;608;311;297;95;142;0
1266630;懒人修仙传2;;50,000 - 100,000;501;132;369;0;0;312
1266640;SGS Afrika Korps;;0 - 20,000;51;13;38;0;0;2
1266650;Cyber Driver VR;;0 - 20,000;2;4;-2;0;0;0
1266680;Strobophagia | Rave Horror;;500,000 - 1,000,000;52;14;38;0;0;0
1266690;Dark Deception: Monsters & Mortals;;100,000 - 200,000;1857;317;1540;0;0;12
1266690;Dark Deception: Monsters & Mortals;;100,000 - 200,000;1857;317;1540;0;0;12
1266700;Destroy All Humans! 2 - Reprobed;;50,000 - 100,000;1249;372;877;174;194;69
1266800;Adorable Crush;;20,000 - 50,000;423;122;301;74;74;8
1266820;Ultimate ADOM - Caverns of Chaos;;50,000 - 100,000;219;182;37;0;0;4
1266840;The Last Stand: Aftermath;;100,000 - 200,000;3607;835;2772;606;446;133
1266890;Tactical Troops: Anthracite Shift;;0 - 20,000;34;11;23;0;0;1
1266900;Operation DogFight;;0 - 20,000;7;2;5;0;0;1
1266980;Madrun;;20,000 - 50,000;398;29;369;0;0;1
1267040;SUPERHERO-X [Alpha Edition];;0 - 20,000;1;2;-1;0;0;0
1267070;Monorail Stories;;0 - 20,000;24;4;20;0;0;1
1267130;Axe Girl;;0 - 20,000;29;2;27;0;0;0
1267170;Carestia;;20,000 - 50,000;15;1;14;0;0;0
1267230;Labyrinth: The Exit Is Closer;;0 - 20,000;5;2;3;0;0;0
1267240;Chaos Combat Chess;;50,000 - 100,000;178;65;113;0;0;0
1267260;Yumeutsutsu Re:After;;0 - 20,000;66;5;61;0;0;0
1267270;Yumeutsutsu Re:Idol;;0 - 20,000;25;2;23;0;0;0
1267310;[Chilla's Art] Onryo | 怨霊;;0 - 20,000;78;62;16;0;0;0
1267330;Group Project Simulator;;0 - 20,000;6;4;2;0;0;0
1267370;Blind Spot;;0 - 20,000;30;9;21;0;0;0
1267400;Test Of Courage;;0 - 20,000;36;6;30;0;0;0
1267410;Kurogane of the sky;;0 - 20,000;2;0;2;0;0;0
1267470;Warriors of the Nile;;200,000 - 500,000;1958;526;1432;384;384;5
1267530;Weaving Tides: Prologue;;0 - 20,000;6;0;6;0;0;0
1267540;WRC 9 FIA World Rally Championship;;0 - 20,000;310;93;217;1425;1616;29
1267560;In Space;;0 - 20,000;1;0;1;0;0;2
1267670;Heartless reseller is Roguelike;;0 - 20,000;2;1;1;0;0;0
1267770;Linda & Joan Prologue: “Four Months Earlier”;;0 - 20,000;32;5;27;0;0;0
1267810;Gutwhale;;0 - 20,000;123;8;115;0;0;0
1267830;Smartphone Tycoon - Lite;;0 - 20,000;25;26;-1;0;0;0
1267860;Hinterhalt 3;;0 - 20,000;21;9;12;0;0;0
1267870;Xenogunner;;0 - 20,000;24;0;24;0;0;0
1267910;Melvor Idle;;500,000 - 1,000,000;7599;630;6969;10406;7037;5676
1267920;Stealth Master;;0 - 20,000;1;0;1;0;0;0
1267930;Deadly Dozen: Pacific Theater;;0 - 20,000;31;3;28;268;268;1
1267940;Hunting Unlimited 1;;20,000 - 50,000;13;3;10;0;0;0
1267950;Cosmic Flow: A Relaxing VR Experience;;20,000 - 50,000;165;6;159;0;0;1
1267960;FotoMuseo 3D;;0 - 20,000;1;0;1;0;0;0
1268040;Fluid Engine PC Live Wallpaper;;20,000 - 50,000;119;49;70;918;918;22
1268100;War Islands: A Co-op Adventure;;0 - 20,000;19;3;16;0;0;0
1268140;Lair Land Story;;20,000 - 50,000;101;2;99;0;0;2
1268150;Low Poly Forces;;0 - 20,000;28;7;21;0;0;0
1268160;Seven Horns From Tilt;;0 - 20,000;0;1;-1;0;0;0
1268250;GAG;;20,000 - 50,000;40;12;28;0;0;0
1268280;Knockdown the Ball Twice;;0 - 20,000;0;3;-3;0;0;0
1268290;Fantasy World Online Tycoon;;0 - 20,000;42;10;32;0;0;0
1268330;ENHANCE;;0 - 20,000;2;2;0;0;0;0
1268350;A Game of Humans;;0 - 20,000;49;15;34;0;0;0
1268360;Trashed;;0 - 20,000;75;56;19;0;0;0
1268370;holedown;;0 - 20,000;46;5;41;0;0;2
1268370;holedown;;0 - 20,000;46;5;41;0;0;2
1268380;Endless RPG: Random Dungeon Map Generator for D&D 5e;;0 - 20,000;16;4;12;0;0;0
1268400;Pinball Lockdown;;20,000 - 50,000;7;9;-2;0;0;0
1268420;Britannia;;0 - 20,000;38;4;34;0;0;2
1268530;Outside The Grid;;0 - 20,000;139;47;92;0;0;0
1268540;Dungeon Of Dark;;0 - 20,000;7;1;6;0;0;0
1268700;Tuneria;;0 - 20,000;6;0;6;0;0;0
1268710;Skitt;;0 - 20,000;1;2;-1;0;0;0
1268730;Impulse Control;;20,000 - 50,000;0;4;-4;0;0;0
1268810;Doors of Insanity;;0 - 20,000;148;56;92;0;0;1
1268830;Flappy Hypership Out of Control;;0 - 20,000;3;0;3;0;0;0
1268840;Project Toon Tanks;;0 - 20,000;1;0;1;0;0;0
1268860;Raindrops;;0 - 20,000;153;4;149;0;0;2
1268870;Deskmate Girl;;20,000 - 50,000;143;78;65;0;0;0
1268880;方圈 Square Circle;;0 - 20,000;2;0;2;0;0;0
1268900;Nearly Dead;;0 - 20,000;145;99;46;0;0;0
1268960;pureya;;50,000 - 100,000;1922;34;1888;0;0;6
1268990;Amber Time [RPG];;0 - 20,000;1;0;1;0;0;0
1269020;No Plan B;;20,000 - 50,000;244;20;224;724;724;11
1269030;Fred3ric;;0 - 20,000;21;11;10;0;0;0
1269050;告死天使的审判 Death Angel Trial;;50,000 - 100,000;75;15;60;0;0;0
1269080;ALIVE;;0 - 20,000;1;0;1;0;0;0
1269110;勇者的十日人生;;20,000 - 50,000;2;1;1;0;0;0
1269150;Fly Punch Boom: First Impact!;;50,000 - 100,000;478;51;427;0;0;3
1269180;Fatal Evidence: The Missing Collector's Edition;;0 - 20,000;5;2;3;0;0;0
1269190;Arko;;0 - 20,000;4;0;4;0;0;0
1269230;Dodo Adventures;;0 - 20,000;1;0;1;0;0;0
1269240;Damn Dolls;;0 - 20,000;15;6;9;0;0;0
1269260;Artifact Foundry;;0 - 20,000;397;326;71;167;67;8
1269300;This Means Warp;;20,000 - 50,000;233;34;199;514;520;7
1269310;MasterPlan;;0 - 20,000;71;6;65;0;0;4
1269320;Saving Stages;;0 - 20,000;7;3;4;0;0;0
1269370;171;;50,000 - 100,000;1789;517;1272;223;282;41
1269450;Goofy Golf Remastered Steam Edition;;0 - 20,000;1;1;0;0;0;0
1269500;Crowalt: Traces of the Lost Colony;;0 - 20,000;67;10;57;0;0;0
1269510;UNDERZONE;;0 - 20,000;0;1;-1;0;0;0
1269540;Slash Roll;;0 - 20,000;5;2;3;0;0;0
1269550;KillSteel;;50,000 - 100,000;237;47;190;0;0;1
1269560;Square Fast;;0 - 20,000;6;2;4;0;0;0
1269590;Get-A-Grip Chip;;0 - 20,000;38;0;38;0;0;0
1269600;Adventure Field 3 Definitive Edition;;20,000 - 50,000;12;5;7;0;0;0
1269620;Puzzle - STONE BLOCKS;;0 - 20,000;90;13;77;0;0;2
1269640;Beacon Pines;;50,000 - 100,000;1135;19;1116;0;0;10
1269650;Amendium;;0 - 20,000;3;2;1;0;0;0
1269690;Attack on Toys;;20,000 - 50,000;392;29;363;100;100;14
1269710;Kainga: Seeds of Civilization;;20,000 - 50,000;367;92;275;0;0;21
1269710;Kainga: Seeds of Civilization;;20,000 - 50,000;367;92;275;0;0;21
1269720;还我河山HeroRagingFire;;50,000 - 100,000;78;90;-12;0;0;0
1269770;Bullet Art;;0 - 20,000;10;8;2;0;0;1
1269810;The Curse of Kubel;;20,000 - 50,000;313;117;196;377;377;6
1269820;Kozue's Strange Journey;;20,000 - 50,000;166;21;145;20;20;6
1269830;KnotBot;;0 - 20,000;34;12;22;0;0;0
1269890;Virus Popper;;20,000 - 50,000;49;9;40;0;0;0
1269900;snake::reloaded;;0 - 20,000;1;0;1;0;0;0
1269930;Frag Grounds;;20,000 - 50,000;0;3;-3;0;0;0
1269940;Dawn at my Neighbourhood;;0 - 20,000;15;1;14;0;0;0
1269950;Buddy Simulator 1984;;100,000 - 200,000;3017;187;2830;284;404;23
1269960;Inferno Wizards;;0 - 20,000;17;9;8;0;0;0
1269990;Wishy Washy;;0 - 20,000;13;3;10;0;0;0
1270010;Gone: Survival;;0 - 20,000;58;76;-18;19;19;1
1270030;XRacer 2: Evolution;;0 - 20,000;3;0;3;0;0;1
1270070;Gunslingers of the Wasteland vs. The Zombies From Mars;;0 - 20,000;7;0;7;0;0;0
1270080;Magic Twins;;0 - 20,000;39;0;39;0;0;0
1270100;兵法：战国篇;;0 - 20,000;115;20;95;0;0;0
1270280;Pharao Reloaded;;0 - 20,000;4;0;4;0;0;0
1270330;MushrooMonster;;0 - 20,000;6;1;5;0;0;0
1270370;Bat of Dead;;0 - 20,000;7;4;3;0;0;0
1270380;Crystal Raiders VR;;0 - 20,000;26;14;12;0;0;0
1270390;The Golem;;0 - 20,000;30;2;28;0;0;0
1270420;Box Nation [] Lets Go Build and Fight;;20,000 - 50,000;2;8;-6;0;0;0
1270440;MUSCLE POWER;;0 - 20,000;3;0;3;0;0;0
1270500;Snow Apocalypse;;0 - 20,000;1;5;-4;0;0;0
1270520;"""Warehouse Tycoon""";;0 - 20,000;4;14;-10;0;0;0
1270570;All Over;;100,000 - 200,000;23;2;21;0;0;0
1270590;Falcon City;;0 - 20,000;53;3;50;0;0;0
1270620;Project Chemistry;;0 - 20,000;84;11;73;87;87;1
1270650;Defend the village from goblins;;0 - 20,000;4;1;3;0;0;0
1270670;Touhou Double Focus;;0 - 20,000;53;19;34;0;0;0
1270680;WHALIEN - Unexpected Guests;;0 - 20,000;22;0;22;0;0;0
1270720;DreamWorks Spirit Lucky's Big Adventure;;0 - 20,000;18;3;15;0;0;0
1270780;Elemental Defenders TD;;0 - 20,000;1;0;1;0;0;0
1270820;Brothers in Blood: WW2;;0 - 20,000;1;6;-5;0;0;0
1270840;New King;;0 - 20,000;0;5;-5;0;0;0
1270850;Karma City Police;;0 - 20,000;74;4;70;0;0;0
1270870;Gray platformer;;0 - 20,000;19;7;12;0;0;0
1270890;WHONE;;0 - 20,000;6;0;6;0;0;0
1270930;Hentai vs Virus: I Am Waifu;;0 - 20,000;29;2;27;29;32;2
1270970;Burst Planet;;0 - 20,000;5;1;4;0;0;0
1270980;Rise Of Three Kingdoms;;0 - 20,000;61;36;25;0;0;8
1270990;West of Dead Beta;;50,000 - 100,000;769;60;709;20;33;0
1271030;Rainbows, toilets & unicorns!;;0 - 20,000;16;4;12;0;0;0
1271050;Shrine;;20,000 - 50,000;657;50;607;0;0;1
1271070;clickbox;;0 - 20,000;6;4;2;0;0;0
1271080;Car Dealer;;0 - 20,000;120;65;55;0;0;1
1271090;Let's Cook Together;;0 - 20,000;96;4;92;0;0;6
1271100;Deadly Premonition 2: A Blessing in Disguise;;0 - 20,000;179;40;139;0;0;6
1271110;Healing Spree;;0 - 20,000;57;46;11;18;18;1
1271110;Healing Spree;;0 - 20,000;57;46;11;18;18;1
1271170;The Wizard and The Slug;;0 - 20,000;43;0;43;0;0;0
1271190;Queen's Glory;;20,000 - 50,000;431;178;253;34;44;1
1271250;Date Night Bowling;;0 - 20,000;5;2;3;0;0;0
1271260;Land of Screens;;0 - 20,000;52;4;48;0;0;0
1271280;Rift Wizard;;100,000 - 200,000;753;54;699;0;0;18
1271300;Methods: The Detective Competition;;0 - 20,000;315;28;287;0;0;1
1271340;Cat President 2: Purrlitical Revolution;;0 - 20,000;12;0;12;0;0;0
1271380;Street Cleaner: The Video Game;;0 - 20,000;46;2;44;0;0;0
1271400;Adios;;20,000 - 50,000;934;55;879;56;56;0
1271420;Chronicles of Honor;;0 - 20,000;3;5;-2;0;0;0
1271450;Sama Learning;;;;;0;;;
1271500;Legend of Orion: Adventure;;0 - 20,000;1;1;0;0;0;0
1271510;Remnants of the Dawn;;0 - 20,000;3;1;2;0;0;0
1271520;SpeedFighter;;0 - 20,000;2;1;1;0;0;0
1271530;Night Jackal;;0 - 20,000;10;3;7;0;0;0
1271540;1 Screen Platformer: Prologue;;0 - 20,000;119;24;95;0;0;0
1271580;Good Morning World;;20,000 - 50,000;119;55;64;0;0;0
1271600;Panzer Crew VR;;0 - 20,000;4;3;1;0;0;0
1271620;Umihara Kawase BaZooKa!;;0 - 20,000;12;3;9;0;0;0
1271690;Zombie Derby: Pixel Survival;;0 - 20,000;47;9;38;0;0;0
1271700;HOT WHEELS UNLEASHED;;200,000 - 500,000;3793;1121;2672;169;200;109
1271740;Magical Swordmaiden;;0 - 20,000;89;27;62;0;0;1
1271750;Unferat;;0 - 20,000;112;16;96;0;0;2
1271760;Minoes;;0 - 20,000;5;0;5;0;0;0
1271820;Jaw Breakers & The Confection Connection;;0 - 20,000;3;0;3;0;0;0
1271840;Sophie's Cubes;;0 - 20,000;3;0;3;0;0;0
1271850;Grand Casino Tycoon;;20,000 - 50,000;30;20;10;0;0;0
1271870;The Jungle;;0 - 20,000;6;21;-15;0;0;0
1271910;Baby Dino Adventures;;0 - 20,000;37;6;31;0;0;1
1271920;Angels on Tanks;;0 - 20,000;7;5;2;0;0;0
1271930;Zango's Shark Adventure;;0 - 20,000;1;0;1;0;0;0
1271980;Premier Manager 10;;0 - 20,000;10;10;0;0;0;0
1271990;Premier Manager 09;;0 - 20,000;4;1;3;0;0;1
1272000;Premier Manager 08;;0 - 20,000;3;0;3;0;0;0
1272010;Destroyer: The U-Boat Hunter;;0 - 20,000;271;81;190;0;0;6
1272020;Premier Manager 06/07;;20,000 - 50,000;2;0;2;0;0;2
1272030;Premier Manager 05/06;;20,000 - 50,000;1;0;1;0;0;1
1272050;Premier Manager 03/04;;0 - 20,000;0;2;-2;0;0;0
1272060;Premier Manager 02/03;;20,000 - 50,000;8;4;4;0;0;0
1272070;Silicon Dreams  |  cyberpunk interrogation;;50,000 - 100,000;176;8;168;0;0;1
1272110;Close Combat: Wacht am Rhein;;0 - 20,000;45;9;36;0;0;10
1272120;Darkanoid;;0 - 20,000;61;5;56;0;0;0
1272130;Close Combat: The Longest Day;;0 - 20,000;46;15;31;0;0;10
1272150;Sol-Hel;;0 - 20,000;3;0;3;0;0;0
1272160;The Life and Suffering of Sir Brante;;100,000 - 200,000;4441;385;4056;743;656;53
1272200;The Informant Chronicles- Chronicle 1: Riverside Danger Part 1;;0 - 20,000;2;1;1;0;0;1
1272240;Beat The Machine: Rebooted;;0 - 20,000;4;0;4;0;0;0
1272300;Zombusters;;0 - 20,000;2;0;2;0;0;0
1272320;Diplomacy is Not an Option;;100,000 - 200,000;3440;531;2909;1559;1020;197
1272330;Easy puzzle: Bridges;;0 - 20,000;7;1;6;0;0;0
1272340;Escape to Sidious;;0 - 20,000;22;9;13;0;0;0
1272360;VRDJ;;0 - 20,000;7;3;4;0;0;0
1272390;The Last Day of Adolf;;0 - 20,000;1;4;-3;0;0;0
1272450;Mahjong Deluxe;;0 - 20,000;18;3;15;0;0;15
1272460;人狼の仔;;0 - 20,000;0;1;-1;0;0;0
1272470;Alien:Chip;;50,000 - 100,000;1;1;0;0;0;0
1272500;Paraiso Island;;0 - 20,000;5;6;-1;0;0;0
1272500;Paraiso Island;;0 - 20,000;5;6;-1;0;0;0
1272520;PuzzleKid;;0 - 20,000;2;0;2;0;0;0
1272530;Looking Glass;;0 - 20,000;4;0;4;0;0;0
1272580;Nine Witches: Family Disruption;;0 - 20,000;186;17;169;0;0;0
1272660;Gan's Matchstick Men：Deadly Rhythm;;0 - 20,000;0;1;-1;0;0;0
1272680;Umihara Kawase Fresh!;;0 - 20,000;12;8;4;0;0;0
1272690;Car Crush Racing Simulator;;0 - 20,000;18;6;12;0;0;0
1272820;Super Worm 3D;;0 - 20,000;4;1;3;0;0;0
1272860;Absolute Alchemical Potion;;0 - 20,000;62;7;55;0;0;1
1272900;【救世计划】红衣/SalvationPlan:SpiritEvil;;0 - 20,000;5;5;0;0;0;0
1272920;Easy puzzle: Streets;;0 - 20,000;9;0;9;0;0;0
1272970;Nyanco Card;;0 - 20,000;45;7;38;0;0;0
1273010;ASTRALODE Freeminers;;20,000 - 50,000;9;2;7;0;0;0
1273020;Dark Side;;0 - 20,000;1;3;-2;0;0;0
1273060;Aliens Love Beefs;;0 - 20,000;1;0;1;0;0;0
1273070;Infinite Abyss;;0 - 20,000;3;0;3;0;0;0
1273080;Raptor Boyfriend: A High School Romance;;0 - 20,000;84;0;84;0;0;0
1273120;Eira: Echoes of Adventure;;0 - 20,000;23;2;21;0;0;0
1273120;Eira: Echoes of Adventure;;0 - 20,000;23;2;21;0;0;0
1273150;Dry Grass;;0 - 20,000;4;2;2;0;0;0
1273160;Fall Of The Mafia;;0 - 20,000;5;2;3;0;0;0
1273180;Glory Horse Racing;;0 - 20,000;10;7;3;0;0;0
1273220;Sphere - Flying Cities;;20,000 - 50,000;97;73;24;0;0;2
1273250;Breakpoint;;50,000 - 100,000;186;4;182;0;0;2
1273260;Corpse Party (2021);;20,000 - 50,000;538;27;511;0;0;12
1273270;Dingleberries;;0 - 20,000;6;0;6;0;0;0
1273290;Blind Blade II;;0 - 20,000;8;1;7;0;0;0
1273380;Weapons Genius VR;;0 - 20,000;0;3;-3;0;0;0
1273390;Baby Shark VR Dancing;;50,000 - 100,000;23;11;12;0;0;0
1273400;Construction Simulator;;200,000 - 500,000;4204;961;3243;1923;1550;512
1273430;iota;;0 - 20,000;13;2;11;0;0;0
1273440;OverDrift Festival;;0 - 20,000;518;120;398;0;0;19
1273450;Selfless Heroes;;0 - 20,000;31;7;24;0;0;0
1273520;The Last Day Defense VR;;0 - 20,000;32;7;25;0;0;0
1273530;Endless Savagery;;0 - 20,000;1;0;1;0;0;0
1273540;Mail Mole + 'Xpress Deliveries;;0 - 20,000;159;7;152;0;0;0
1273570;Four Rendezvous;;0 - 20,000;34;4;30;0;0;0
1273580;TEMPER MY BLADE;;0 - 20,000;40;16;24;0;0;0
1273590;Jumping Joe! - Friends Edition;;20,000 - 50,000;35;2;33;0;0;0
1273600;SPACE TOW TRUCK - ISAAC NEWTON's Favorite Puzzle Game;;20,000 - 50,000;11;1;10;0;0;1
1273600;SPACE TOW TRUCK - ISAAC NEWTON's Favorite Puzzle Game;;20,000 - 50,000;11;1;10;0;0;1
1273620;Dialogue Designer;;0 - 20,000;18;12;6;0;0;2
1273700;Day and Night;;0 - 20,000;1;2;-1;0;0;0
1273710;King of Crabs;;200,000 - 500,000;6182;1620;4562;0;0;53
1273720;SBX 5K;;0 - 20,000;6;6;0;0;0;0
1273740;As Aventuras do Cueca Listrada;;0 - 20,000;4;0;4;0;0;0
1273750;Button City;;0 - 20,000;107;4;103;0;0;0
1273780;Peekaboo Collection - 3 Tales of Horror;;0 - 20,000;27;9;18;0;0;0
1273790;Empires and Tribes;;20,000 - 50,000;192;72;120;0;0;16
1273800;Vaccine;;0 - 20,000;15;2;13;0;0;0
1273800;Vaccine;;0 - 20,000;15;2;13;0;0;0
1273890;Bastard Little Zombie;;0 - 20,000;5;0;5;0;0;0
1273920;Dark Romance: Ashville Collector's Edition;;0 - 20,000;13;0;13;0;0;0
1273930;Hard Rock Pinball;;0 - 20,000;9;2;7;0;0;0
1273940;Fight with love - deckbuilder datingsim;;0 - 20,000;4;6;-2;0;0;0
1274020;Castle Fight;;0 - 20,000;10;3;7;0;0;0
1274060;The Ball Adventure;;0 - 20,000;0;4;-4;0;0;0
1274090;Hotfix;;0 - 20,000;43;13;30;0;0;1
1274110;Light: A Maze Game;;0 - 20,000;1;0;1;0;0;0
1274140;One Dreamer: Prologue;;100,000 - 200,000;761;30;731;0;0;1
1274150;Shoot Covid-19 | 消灭新冠肺炎;;0 - 20,000;3;5;-2;0;0;0
1274160;The Enclosure;;0 - 20,000;1;0;1;0;0;0
1274190;Southern cross Battle force;;20,000 - 50,000;2;0;2;0;0;0
1274200;Enamored Risks;;20,000 - 50,000;131;16;115;0;0;0
1274230;Legend of Kendor;;0 - 20,000;18;3;15;0;0;3
1274250;Fire for Effect;;0 - 20,000;1;1;0;0;0;0
1274280;Blue Flame;;0 - 20,000;8;0;8;0;0;0
1274290;Kidnapped Girl;;200,000 - 500,000;4933;775;4158;0;0;3
1274300;Cyber Agent;;50,000 - 100,000;342;126;216;46;46;0
1274310;东方鬼神玉 ~ I wanna be the Yin-Yang orb;;0 - 20,000;14;8;6;0;0;0
1274340;ColorsInvasion;;20,000 - 50,000;3;0;3;0;0;0
1274360;幽灵高校(Ghost College);;50,000 - 100,000;301;77;224;0;0;2
1274380;Etheldia Pepper;;0 - 20,000;3;0;3;0;0;0
1274390;Bud Masters;;0 - 20,000;1;0;1;0;0;0
1274430;Human Origin;;0 - 20,000;22;5;17;0;0;0
1274440;Jack Walker: Ethereal;;0 - 20,000;11;2;9;0;0;0
1274470;Heim;;0 - 20,000;1;0;1;0;0;0
1274490;Green Project;;100,000 - 200,000;942;177;765;122;122;27
1274540;Tomatenquark;;0 - 20,000;30;9;21;0;0;0
1274550;Dragon Storm;;0 - 20,000;4;16;-12;0;0;0
1274560;Matergari: Below Valesia;;0 - 20,000;3;1;2;0;0;0
1274570;DEVOUR;;2,000,000 - 5,000,000;51845;4597;47248;350;241;1154
1274610;LesLove.Club: Emily and Sarah;;0 - 20,000;30;11;19;0;0;0
1274630;So May It Be: A Witch Dating Simulator;;0 - 20,000;23;2;21;0;0;0
1274640;Nightvision: Drive Forever;;0 - 20,000;12;4;8;0;0;0
1274690;Sayonara Electric;;0 - 20,000;4;0;4;0;0;0
1274710;Lullaby Days;;0 - 20,000;73;10;63;0;0;2
1274720;SOULBOUND;;0 - 20,000;3;2;1;0;0;0
1274800;Pancake Sailor;;50,000 - 100,000;143;23;120;0;0;1
1274820;Street Hero;;20,000 - 50,000;32;13;19;0;0;0
1274840;Escape from GULAG;;0 - 20,000;51;8;43;0;0;0
1274850;The Sickle Upon Sekigahara;;20,000 - 50,000;0;1;-1;0;0;0
1274850;The Sickle Upon Sekigahara;;20,000 - 50,000;0;1;-1;0;0;0
1274910;Active Neurons 2;;0 - 20,000;14;1;13;0;0;0
1274930;Planet 2000;;0 - 20,000;1;4;-3;0;0;0
1274960;Game Overlay Pro;;0 - 20,000;0;4;-4;0;0;0
1274970;ZEROED;;0 - 20,000;13;0;13;0;0;0
1274980;Rogue Party 2;;0 - 20,000;36;2;34;0;0;0
1274990;Living Art;;0 - 20,000;1;0;1;0;0;0
1275060;Farm Builder;;0 - 20,000;7;4;3;0;0;0
1275150;Aquadine;;20,000 - 50,000;27;2;25;0;0;0
1275190;Inside The Mirror;;0 - 20,000;13;0;13;0;0;0
1275210;Cross Soul;;0 - 20,000;18;12;6;0;0;0
1275230;Strato'S Sylph Asterism;;0 - 20,000;6;1;5;0;0;0
1275240;Pandoria;;0 - 20,000;1;1;0;0;0;0
1275250;Trump and Virus;;0 - 20,000;11;4;7;0;0;0
1275290;Dream Catcher;;0 - 20,000;50;37;13;0;0;1
1275320;Be Coronavirus;;0 - 20,000;1;0;1;0;0;0
1275330;Viking Heroes;;0 - 20,000;24;0;24;0;0;0
1275350;Ninja Kiwi Archive;;500,000 - 1,000,000;3831;256;3575;124;46;354
1275370;Sharded World;;0 - 20,000;13;6;7;0;0;2
1275380;Notruf 112 - Die Feuerwehr Simulation 2: Showroom;;20,000 - 50,000;75;18;57;69;69;0
1275390;City Destructor;;0 - 20,000;15;7;8;0;0;0
1275410;Only One Rectangle;;0 - 20,000;13;1;12;0;0;0
1275450;A letter to you!;;0 - 20,000;8;13;-5;0;0;0
1275490;Martial Arts Brutality Premium;;0 - 20,000;8;0;8;0;0;0
1275520;Choco Pixel 4;;0 - 20,000;4;4;0;0;0;0
1275540;Go Kart Run!;;50,000 - 100,000;59;41;18;0;0;0
1275590;Dieselpunk Wars Prologue;;50,000 - 100,000;117;37;80;0;0;1
1275590;Dieselpunk Wars Prologue;;50,000 - 100,000;117;37;80;0;0;1
1275600;Kevin's Path to Wizdom;;20,000 - 50,000;25;0;25;0;0;0
1275630;Drug Dealer Simulator: Free Sample;;200,000 - 500,000;2322;274;2048;51;38;4
1275640;Coloring Game 3;;100,000 - 200,000;1287;53;1234;1395;1970;18
1275660;Sanity of Morris;;0 - 20,000;40;16;24;0;0;0
1275660;Sanity of Morris;;0 - 20,000;40;16;24;0;0;0
1275670;Outcore: Desktop Adventure;;100,000 - 200,000;4068;106;3962;0;0;59
1275760;Street Power Football;;0 - 20,000;31;40;-9;0;0;0
1275770;The Narrator is a DICK : Longer, Harder, and Uncut;;0 - 20,000;36;7;29;0;0;0
1275790;Space Otter Charlie;;0 - 20,000;66;1;65;0;0;0
1275810;Stan Lee's Verticus;;20,000 - 50,000;48;6;42;0;0;0
1275850;Frog Space;;0 - 20,000;6;5;1;0;0;0
1275860;Kick the VIRUS;;0 - 20,000;12;3;9;0;0;0
1275880;Happy Birthday, Adolf!;;0 - 20,000;5;5;0;0;0;0
1275890;Baldi's Basics Plus;;100,000 - 200,000;2248;82;2166;0;0;21
1275970;Digital Dungeon Tiles;;0 - 20,000;3;6;-3;0;0;0
1275980;Probe;;0 - 20,000;17;1;16;0;0;0
1276060;Fingertips  mountain  sea;;0 - 20,000;0;2;-2;0;0;0
1276070;Manufactoria 2022;;0 - 20,000;51;1;50;0;0;4
1276090;Creator Adventure Legend;;20,000 - 50,000;0;3;-3;0;0;0
1276100;Clay Game;;0 - 20,000;97;14;83;0;0;0
1276140;NuclearRifle;;0 - 20,000;7;7;0;0;0;0
1276170;Pandemic Panic!;;20,000 - 50,000;2;0;2;0;0;0
1276180;Inside Explorer;;0 - 20,000;5;0;5;0;0;0
1276290;PST VR (Primary Surgical Treatment);;0 - 20,000;11;10;1;0;0;0
1276290;PST VR (Primary Surgical Treatment);;0 - 20,000;11;10;1;0;0;0
1276300;Zerowood;;0 - 20,000;0;2;-2;0;0;0
1276320;Naught;;0 - 20,000;9;1;8;0;0;0
1276320;Naught;;0 - 20,000;9;1;8;0;0;0
1276330;Flying Soldiers;;0 - 20,000;5;0;5;0;0;0
1276350;evolution for beginners;;0 - 20,000;1;1;0;0;0;0
1276370;Elva the Eco Dragon;;0 - 20,000;1;2;-1;0;0;0
1276430;MEGALAN 11;;0 - 20,000;15;5;10;0;0;0
1276450;Modest Hero;;0 - 20,000;7;6;1;0;0;0
1276470;Arctic Anxiety;;20,000 - 50,000;165;99;66;0;0;0
1276490;Cascading Failure;;0 - 20,000;9;10;-1;0;0;0
1276490;Cascading Failure;;0 - 20,000;9;10;-1;0;0;0
1276530;An Interesting Journey of Monsieur PAF;;0 - 20,000;26;3;23;0;0;0
1276540;Persian Nights 2: The Moonlight Veil;;0 - 20,000;75;13;62;0;0;1
1276550;Faefever;;50,000 - 100,000;340;51;289;0;0;0
1276590;Oddest Sea;;0 - 20,000;0;2;-2;0;0;0
1276600;The Chronicles of Robin Hood - The King of Thieves;;0 - 20,000;13;0;13;0;0;0
1276660;Tinkertown;;50,000 - 100,000;652;220;432;104;143;11
1276720;Witching Tower: Heroes;;0 - 20,000;6;10;-4;0;0;0
1276730;Undungeon Arena;;20,000 - 50,000;55;10;45;5;5;0
1276760;DRAGON BALL: THE BREAKERS;;100,000 - 200,000;2053;1438;615;516;630;713
1276790;Ruined King: A League of Legends Story;;200,000 - 500,000;8315;979;7336;894;641;151
1276820;Space War Machine;;0 - 20,000;1;0;1;0;0;0
1276850;Kane's Shadow;;50,000 - 100,000;3;2;1;0;0;0
1276890;The Lilliputian Runner;;0 - 20,000;1;0;1;0;0;0
1277090;Toilet Paper Crisis Simulator 2020;;0 - 20,000;4;2;2;0;0;0
1277100;Dungeon & Derision;;0 - 20,000;4;1;3;0;0;0
1277140;Underwater Wars;;0 - 20,000;7;2;5;0;0;0
1277160;Aquarium Life;;0 - 20,000;0;2;-2;0;0;0
1277190;How To Make A Killing;;;;;0;;;
1277210;Beautiful Feet Cabin;;0 - 20,000;86;59;27;0;0;0
1277290;C-TAS: A Virtual Chinese Learning Game;;20,000 - 50,000;1;1;0;0;0;0
1277300;Cryptic Rooms;;0 - 20,000;0;1;-1;0;0;0
1277310;Saving You From Yourself;;0 - 20,000;35;32;3;0;0;0
1277320;FirstQueen1 NEXT;;0 - 20,000;26;15;11;0;0;1
1277340;Sunset fighter;;0 - 20,000;2;0;2;0;0;0
1277360;异界大陆;;0 - 20,000;0;1;-1;0;0;0
1277390;Death World;;0 - 20,000;21;25;-4;0;0;0
1277400;Monster Hunter Stories 2: Wings of Ruin;;1,000,000 - 2,000,000;11489;2493;8996;2509;1937;329
1277480;The Shepherd;;0 - 20,000;5;1;4;0;0;0
1277500;Skeletal Avenger;;0 - 20,000;156;32;124;89;89;0
1277510;Re:ZERO -Starting Life in Another World- The Prophecy of the Throne;;0 - 20,000;415;54;361;0;0;8
1277520;Traffic Storm;;0 - 20,000;1;0;1;0;0;0
1277650;Deadsigns;;0 - 20,000;4;0;4;0;0;0
1277710;RoboDo;;0 - 20,000;12;2;10;0;0;0
1277840;Dustoff Z;;0 - 20,000;30;2;28;0;0;0
1277870;SUPER UFO FIGHTER;;0 - 20,000;16;0;16;0;0;1
1277900;Archer VR;;0 - 20,000;4;1;3;0;0;0
1277930;Riddle Joker;;50,000 - 100,000;3299;34;3265;1173;1227;62
1277940;Kinkoi: Golden Loveriche;;20,000 - 50,000;1229;31;1198;9;9;18
1277950;Heart's Medicine - Season One;;0 - 20,000;47;14;33;0;0;2
1278000;HistoryMaker VR;;50,000 - 100,000;5;0;5;0;0;0
1278040;Storynth;;0 - 20,000;2;0;2;0;0;0
1278060;Orqa FPV.SkyDive;;100,000 - 200,000;556;131;425;0;0;44
1278090;Collection Quest;;0 - 20,000;5;1;4;0;0;0
1278100;Stabby Cats;;0 - 20,000;18;9;9;0;0;0
1278110;Death Taxi 3000;;0 - 20,000;5;1;4;0;0;0
1278140;Delirium;;0 - 20,000;2;0;2;0;0;0
1278150;Nayati River;;20,000 - 50,000;52;24;28;0;0;2
1278170;Big Rumble Boxing: Creed Champions;;0 - 20,000;58;34;24;0;0;5
1278190;Jumpala;;0 - 20,000;35;8;27;0;0;0
1278200;Spacer: Legacies;;0 - 20,000;14;7;7;0;0;0
1278210;Space Raiders in Space;;0 - 20,000;107;4;103;0;0;1
1278230;DENIAL;;0 - 20,000;9;8;1;0;0;0
1278270;Fire Rescue Simulator;;0 - 20,000;13;12;1;0;0;0
1278270;Fire Rescue Simulator;;0 - 20,000;13;12;1;0;0;0
1278290;xDasher;;20,000 - 50,000;20;0;20;0;0;0
1278350;Jelly Brawl;;0 - 20,000;19;9;10;0;0;0
1278360;Clam Man 2: Open Mic;;50,000 - 100,000;359;10;349;0;0;0
1278370;Lost Circus VR - The Prologue;;0 - 20,000;59;13;46;0;0;0
1278390;Succumate;;20,000 - 50,000;606;119;487;428;428;10
1278430;Warehouse attack;;0 - 20,000;3;3;0;0;0;0
1278480;Smart Game Booster;;200,000 - 500,000;942;290;652;1323;1841;243
1278500;Tower! 3D;;0 - 20,000;38;25;13;0;0;1
1278500;Tower! 3D;;0 - 20,000;38;25;13;0;0;1
1278520;Sky Seeker;;0 - 20,000;7;2;5;0;0;0
1278670;Mindframe Arena;;0 - 20,000;4;2;2;0;0;0
1278690;Firefighters - Airport Heroes;;0 - 20,000;5;9;-4;0;0;0
1278710;FPS Robot Attack Minigame;;20,000 - 50,000;7;0;7;0;0;0
1278750;Lost At Sea;;0 - 20,000;27;7;20;0;0;1
1278760;TinyShot;;0 - 20,000;21;4;17;0;0;0
1278860;Di[c]E;;0 - 20,000;2;2;0;0;0;0
1278880;DeLight: The Journey Home;;20,000 - 50,000;20;6;14;0;0;0
1278930;Math Puzzle Alpha Challenge;;20,000 - 50,000;3;2;1;0;0;0
1278930;Math Puzzle Alpha Challenge;;20,000 - 50,000;3;2;1;0;0;0
1278960;Super Forklift 3000;;0 - 20,000;31;0;31;0;0;0
1278960;Super Forklift 3000;;0 - 20,000;31;0;31;0;0;0
1279000;Glare fall;;0 - 20,000;36;4;32;0;0;0
1279020;I Can't Believe It's Not Music!;;0 - 20,000;8;0;8;0;0;0
1279220;Net King's Call;;0 - 20,000;2;0;2;0;0;0
1279240;Police Shootout;;50,000 - 100,000;145;88;57;220;220;3
1279260;Lelie Navigation!;;0 - 20,000;218;21;197;0;0;3
1279270;7 Girls War;;0 - 20,000;67;59;8;0;0;0
1279280;Welcome to the Adventurer Inn!;;0 - 20,000;60;37;23;0;0;0
1279280;Welcome to the Adventurer Inn!;;0 - 20,000;60;37;23;0;0;0
1279310;RESEARCH and DESTROY;;0 - 20,000;17;1;16;0;0;0
1279320;湛蓝星球-迷失·赛博之城;;50,000 - 100,000;26;5;21;0;0;0
1279330;Under Lock;;0 - 20,000;54;21;33;0;0;0
1279370;TENGAI;;0 - 20,000;68;8;60;0;0;0
1279380;STRIKERS 1945 II;;0 - 20,000;72;2;70;0;0;1
1279400;STRIKERS 1945 III;;0 - 20,000;47;9;38;0;0;0
1279400;STRIKERS 1945 III;;0 - 20,000;47;9;38;0;0;0
1279410;GUNBIRD 2;;0 - 20,000;43;1;42;0;0;0
1279420;Dragon Blaze;;0 - 20,000;39;1;38;0;0;0
1279450;SOL DIVIDE -SWORD OF DARKNESS-;;20,000 - 50,000;16;3;13;0;0;0
1279480;Thomas Scott;;0 - 20,000;18;2;16;0;0;0
1279540;MAVR3D 八般武艺;;0 - 20,000;11;8;3;0;0;0
1279580;Fortress V2;;0 - 20,000;309;189;120;1;1;1
1279580;Fortress V2;;0 - 20,000;309;189;120;1;1;1
1279590;Fritz Chess 17 Steam Edition;;0 - 20,000;47;26;21;0;0;7
1279610;PrprLive;;200,000 - 500,000;901;102;799;4910;641;406
1279620;Gem Master;;0 - 20,000;13;2;11;0;0;0
1279630;Vampire: The Masquerade - Shadows of New York;;50,000 - 100,000;838;252;586;259;259;6
1279700;Midnight Scenes: The Highway (Special Edition);;20,000 - 50,000;146;18;128;0;0;0
1279770;Tower of God;;0 - 20,000;4;2;2;0;0;0
1279800;Legend of Towercraft;;20,000 - 50,000;55;22;33;0;0;0
1279810;Zeph;;0 - 20,000;8;0;8;0;0;0
1279910;NERF Legends;;0 - 20,000;15;28;-13;0;0;1
1279920;Cobra Kai: The Karate Kid Saga Continues;;20,000 - 50,000;371;70;301;0;0;2
1279970;Swoosh;;0 - 20,000;3;0;3;0;0;0
1280060;Hoverflow;;0 - 20,000;9;0;9;0;0;0
1280070;Ballad of The Masked Bandits;;0 - 20,000;34;14;20;0;0;0
1280090;Discreet;;0 - 20,000;1;1;0;0;0;0
1280100;Element Battle Royale;;0 - 20,000;49;35;14;0;0;0
1280180;Get Over Here!;;0 - 20,000;15;2;13;0;0;0
1280180;Get Over Here!;;0 - 20,000;15;2;13;0;0;0
1280210;Void Arena;;0 - 20,000;10;1;9;0;0;1
1280270;匠人物语Craftsman story;;0 - 20,000;1;3;-2;0;0;0
1280290;Ash of Legends;;0 - 20,000;3;1;2;0;0;1
1280300;Steel Assault;;0 - 20,000;218;54;164;66;122;0
1280300;Steel Assault;;0 - 20,000;218;54;164;66;122;0
1280310;Axizon Labs: Zombies;;0 - 20,000;1;4;-3;0;0;0
1280370;Heavenworld;;0 - 20,000;142;92;50;168;168;0
1280380;Moolii's Dreamland;;0 - 20,000;58;6;52;0;0;0
1280420;Mannequin;;0 - 20,000;67;7;60;0;0;0
1280490;Color Crush;;0 - 20,000;2;4;-2;0;0;0
1280500;Terracosmic;;0 - 20,000;11;13;-2;0;0;0
1280550;Defense high;;0 - 20,000;14;11;3;0;0;0
1280590;Race Project;;0 - 20,000;2;1;1;0;0;0
1280670;Covid Quest 2077;;0 - 20,000;1;0;1;0;0;0
1280700;Drekirokr - Dusk of the Dragon;;50,000 - 100,000;17;3;14;0;0;0
1280730;Lovely Goddess;;0 - 20,000;14;1;13;0;0;0
1280750;Aquamarine: Explorer's Edition;;20,000 - 50,000;45;21;24;0;0;0
1280910;80S escape;;0 - 20,000;1;9;-8;0;0;0
1280930;Astral Ascent;;20,000 - 50,000;831;73;758;28;28;66
1280940;Hard Vacuum;;0 - 20,000;10;1;9;0;0;0
1280950;Interstate Drifter 2000;;0 - 20,000;47;1;46;0;0;1
1280970;Pay Me In Colors;;0 - 20,000;14;1;13;0;0;0
1280980;Polarities;;0 - 20,000;1;0;1;0;0;0
1281080;Train Station Renovation - First Job;;200,000 - 500,000;713;106;607;108;183;0
1281100;Murk;;0 - 20,000;0;4;-4;0;0;0
1281130;Thrice in a row;;0 - 20,000;0;2;-2;0;0;0
1281140;My Sweet Confession;;0 - 20,000;12;2;10;0;0;0
1281150;Modiverse;;50,000 - 100,000;32;24;8;0;0;0
1281170;Pro Strategy Football 2021;;20,000 - 50,000;92;15;77;0;0;2
1281180;Jigsaw Puzzles for Kids and Adults - Europe;;0 - 20,000;3;0;3;0;0;0
1281190;The Shadow Government Simulator;;0 - 20,000;28;5;23;0;0;4
1281270;Fatum Betula;;0 - 20,000;332;16;316;0;0;1
1281270;Fatum Betula;;0 - 20,000;332;16;316;0;0;1
1281280;Therapy Sheep VR;;0 - 20,000;5;3;2;0;0;0
1281310;Explorer Studio;;0 - 20,000;15;28;-13;0;0;0
1281350;Pandemic Crisis;;0 - 20,000;9;0;9;0;0;0
1281360;New Yankee 8: Journey of Odysseus;;0 - 20,000;16;2;14;0;0;2
1281370;PLOID SAGA;;0 - 20,000;4;2;2;0;0;0
1281380;INVASION;;0 - 20,000;3;5;-2;0;0;0
1281390;Wasted World;;0 - 20,000;52;22;30;0;0;0
1281400;Good Knight;;20,000 - 50,000;84;3;81;0;0;1
1281420;DOM RUSALOK;;20,000 - 50,000;134;35;99;0;0;1
1281470;Chessсakе;;0 - 20,000;5;3;2;0;0;0
1281480;EPICA;;0 - 20,000;2;4;-2;0;0;0
1281510;Kirakira stars idol project Nagisa;;0 - 20,000;32;1;31;0;0;0
1281530;Bird Missions;;0 - 20,000;47;7;40;0;0;0
1281580;Oh Frog;;0 - 20,000;12;0;12;0;0;0
1281590;The Dark Pictures Anthology: House of Ashes;;200,000 - 500,000;5185;710;4475;395;440;82
1281600;Zen Universe;;0 - 20,000;7;6;1;0;0;0
1281610;HEX Hacking Simulator;;0 - 20,000;18;6;12;0;0;0
1281630;Anno 1404 - History Edition;;200,000 - 500,000;1486;317;1169;486;807;429
1281690;Woody Chopper;;0 - 20,000;4;0;4;0;0;0
1281700;House of Fear;;0 - 20,000;11;2;9;0;0;0
1281790;SHEEPO;;0 - 20,000;220;2;218;0;0;1
1281800;Samsara Room;;200,000 - 500,000;7025;186;6839;170;62;35
1281810;Reflections of Life: Utopia Collector's Edition;;0 - 20,000;7;0;7;0;0;1
1281890;Defective Holiday;;0 - 20,000;22;7;15;0;0;0
1281920;Iron Reckoning;;0 - 20,000;3;0;3;0;0;0
1281980;Catovania;;0 - 20,000;1;2;-1;0;0;0
1281990;CoronaFighter;;20,000 - 50,000;8;1;7;0;0;0
1282040;Apocalypse Survivor;;0 - 20,000;2;0;2;0;0;0
1282050;Tabletop Playground Beta;;0 - 20,000;26;3;23;0;0;0
1282060;Rust Raiders;;0 - 20,000;1;0;1;0;0;0
1282080;Chang'an: The capital of Tang Dynasty;;0 - 20,000;38;15;23;0;0;0
1282090;Tree Simulator 2021;;0 - 20,000;100;5;95;0;0;0
1282110;Escape Initiative;;0 - 20,000;13;1;12;0;0;0
1282120;A Rabbit and the Mystic Fog;;0 - 20,000;1;2;-1;0;0;0
1282140;Fires At Midnight;;0 - 20,000;28;1;27;0;0;0
1282150;SpongeBob SquarePants: The Cosmic Shake;;20,000 - 50,000;981;68;913;1242;1242;180
1282180;Drawing Machine;;0 - 20,000;0;1;-1;0;0;0
1282200;The Test: Hypothesis Rising;;100,000 - 200,000;5260;105;5155;44;62;1
1282210;DEEMO -Reborn-;;200,000 - 500,000;2629;376;2253;109;153;10
1282240;泡泡三国;;20,000 - 50,000;3;7;-4;0;0;0
1282320;Stilstand;;0 - 20,000;48;2;46;0;0;0
1282330;Abracadabrew : Prologue;;20,000 - 50,000;4;0;4;0;0;0
1282370;GraFi Easter;;0 - 20,000;11;1;10;0;0;0
1282410;Hard West 2;;100,000 - 200,000;1474;403;1071;0;0;313
1282500;Prisme 7;;0 - 20,000;11;5;6;0;0;0
1282510;Cards & Crystals;;0 - 20,000;14;0;14;0;0;0
1282540;Tales of Kongfu;;0 - 20,000;1;1;0;0;0;0
1282580;Hunter of the Disowned;;0 - 20,000;1;0;1;0;0;0
1282590;Train Sim World 2;;500,000 - 1,000,000;6239;1412;4827;1050;870;176
1282600;Mayhem in Single Valley: Confessions;;50,000 - 100,000;79;12;67;0;0;0
1282610;BitBattle;;0 - 20,000;27;3;24;0;0;2
1282650;180 Files: The Aegis Project;;0 - 20,000;32;1;31;0;0;0
1282690;Crysis 3;;500,000 - 1,000,000;4364;711;3653;320;373;33
1282700;Woodsalt;;0 - 20,000;3;1;2;0;0;0
1282710;Sakura Stars;;20,000 - 50,000;6;1;5;0;0;0
1282730;Loop Hero;;1,000,000 - 2,000,000;28492;2003;26489;1264;896;419
1282740;CNDL;;20,000 - 50,000;3;3;0;0;0;0
1282740;CNDL;;20,000 - 50,000;3;3;0;0;0;0
1282760;Mad Streets;;0 - 20,000;152;19;133;0;0;3
1282770;Virtual Presenter Pro;;0 - 20,000;0;2;-2;0;0;0
1282880;PUZZL;;0 - 20,000;6;1;5;0;0;0
1282890;Space Mouse 2;;0 - 20,000;15;0;15;0;0;0
1282930;Volta-X;;0 - 20,000;26;10;16;0;0;3
1283000;Hi-Score Boi;;0 - 20,000;32;1;31;0;0;0
1283070;3D Jigsaw Puzzle Simulator;;0 - 20,000;10;0;10;0;0;0
1283110;Start! Heart Thief | 出发吧！偷心盗贼 | 出撃! ルビー | 出擊！偷心盜賊;;0 - 20,000;9;5;4;0;0;0
1283130;Micro Platformer;;50,000 - 100,000;1352;43;1309;0;0;3
1283140;Burn Me Twice;;50,000 - 100,000;198;39;159;0;0;0
1283180;ROBALL;;0 - 20,000;3;4;-1;0;0;0
1283190;Neighbours back From Hell;;100,000 - 200,000;2925;198;2727;149;167;20
1283210;渡劫 x 魔女 ~ Team up with A Magician！;;;;;0;;;
1283220;Devolverland Expo;;500,000 - 1,000,000;5081;602;4479;38;42;1
1283240;Center2048;;0 - 20,000;1;0;1;0;0;0
1283250;Audio Party Pack;;20,000 - 50,000;4;2;2;0;0;0
1283260;Coof Attack;;0 - 20,000;8;2;6;0;0;0
1283270;胆小鬼 Coward;;0 - 20,000;3;0;3;0;0;0
1283270;胆小鬼 Coward;;0 - 20,000;3;0;3;0;0;0
1283330;My Sail And My Sea;;0 - 20,000;10;1;9;0;0;0
1283350;我是熊孩子;;0 - 20,000;5;1;4;0;0;0
1283370;A Painter's Tale: Curon, 1950;;0 - 20,000;23;4;19;0;0;0
1283380;SpinZap;;0 - 20,000;1;0;1;0;0;0
1283400;Steelrising;;200,000 - 500,000;1902;609;1293;149;185;40
1283410;Tails of Iron;;200,000 - 500,000;5092;554;4538;484;788;29
1283430;Fighting Fiends;;0 - 20,000;46;1;45;0;0;0
1283440;VBOX Sim;;0 - 20,000;7;3;4;0;0;1
1283450;soundStrider;;0 - 20,000;5;0;5;0;0;0
1283500;Euphoria: Supreme Mechanics;;0 - 20,000;67;11;56;0;0;0
1283520;The Odd Neon Void;;0 - 20,000;4;2;2;0;0;0
1283520;The Odd Neon Void;;0 - 20,000;4;2;2;0;0;0
1283550;Rotatex 3;;0 - 20,000;13;1;12;0;0;0
1283580;Minimalist Space War;;20,000 - 50,000;21;0;21;0;0;0
1283590;Azure;;0 - 20,000;53;4;49;0;0;0
1283610;Protoball Beta;;20,000 - 50,000;10;1;9;0;0;0
1283620;Run!!!;;20,000 - 50,000;3;4;-1;0;0;0
1283630;Frog Bath;;50,000 - 100,000;186;30;156;0;0;0
1283660;Game-Kun: Input Challenge;;0 - 20,000;10;0;10;0;0;0
1283680;Captive;;0 - 20,000;3;5;-2;0;0;0
1283720;Cube Miners;;20,000 - 50,000;3;1;2;0;0;0
1283740;Dangerous Lands 2 - Evil Ascension;;0 - 20,000;1;1;0;0;0;0
1283760;COVID-19 (CORONA VIRUS);;0 - 20,000;0;3;-3;0;0;0
1283770;Grey Skies: A War of the Worlds Story;;20,000 - 50,000;38;67;-29;0;0;1
1283790;The Employee;;0 - 20,000;4;2;2;0;0;0
1283800;The Legend of Cesar;;0 - 20,000;3;0;3;0;0;0
1283810;Solenars Edge II: Aurora of The Seventh Dawn;;0 - 20,000;5;0;5;0;0;0
1283820;Epic Dumpster Bear 2: He Who Bears Wins;;20,000 - 50,000;11;0;11;0;0;0
1283830;IMPACT;;0 - 20,000;19;1;18;0;0;0
1283850;MaryPark St.;;0 - 20,000;8;0;8;0;0;0
1283860;Super Bounce Ball;;0 - 20,000;3;3;0;0;0;0
1283880;pilapa BOOM;;0 - 20,000;0;1;-1;0;0;0
1283890;Suspicious Spaceroads;;0 - 20,000;5;0;5;0;0;0
1283920;Advanced creator of labyrinths;;0 - 20,000;1;0;1;0;0;0
1283970;YoloMouse;;200,000 - 500,000;1107;76;1031;12794;25217;5056
1283990;Awaken The Time;;0 - 20,000;8;3;5;0;0;0
1284050;Dissection;;0 - 20,000;15;8;7;0;0;0
1284080;Legion Gold;;0 - 20,000;67;10;57;0;0;2
1284090;Chariots of War;;0 - 20,000;1;1;0;0;0;4
1284140;Dangerous Plane;;0 - 20,000;1;4;-3;0;0;0
1284150;Danger Zombies;;0 - 20,000;14;9;5;0;0;0
1284190;The Planet Crafter;;500,000 - 1,000,000;17548;660;16888;628;577;1297
1284200;Puzzle Dungeon;;0 - 20,000;1;0;1;0;0;0
1284210;Guild Wars 2;;1,000,000 - 2,000,000;6790;834;5956;868;180;5025
1284240;Black Book: Prologue;;50,000 - 100,000;1203;76;1127;43;43;1
1284260;Apprentice Knight-Iona;;0 - 20,000;15;4;11;0;0;0
1284290;Ball of Doom;;0 - 20,000;3;0;3;0;0;0
1284300;King of Spies;;0 - 20,000;5;4;1;0;0;0
1284350;漏气宝大冒险 Balloon Man Adventure;;0 - 20,000;1;0;1;0;0;0
1284360;Alien Harvest Leader;;0 - 20,000;1;0;1;0;0;0
1284410;GWENT: The Witcher Card Game;;1,000,000 - 2,000,000;21365;4785;16580;1367;71;1322
1284430;Nazi Labs;;20,000 - 50,000;6;2;4;0;0;0
1284480;Beatitas;;20,000 - 50,000;4;0;4;0;0;0
1284510;In a search of a new home;;0 - 20,000;27;19;8;0;0;0
1284630;送小鸡回家 sendchickenhome;;0 - 20,000;3;0;3;0;0;0
1284660;ロストカラーズ／再装版 / LOSTCOLORS;;0 - 20,000;3;0;3;0;0;0
1284820;Desktop Kanojo;;100,000 - 200,000;1356;209;1147;2156;1578;20
1284850;Batu Ta Batu;;0 - 20,000;1;1;0;0;0;0
1284870;Ultreïa;;0 - 20,000;50;2;48;0;0;0
1284950;Witcheye;;0 - 20,000;127;12;115;0;0;0
1285000;Stayhome Simulator;;20,000 - 50,000;116;32;84;0;0;0
1285010;Cyber Protocol;;0 - 20,000;22;0;22;0;0;0
1285020;Flipon;;0 - 20,000;80;3;77;0;0;2
1285040;D-Corp;;0 - 20,000;51;9;42;0;0;2
1285060;Winter Falling: Battle Tactics;;0 - 20,000;140;10;130;0;0;2
1285070;Bad Run - Turbo Edition;;0 - 20,000;6;0;6;0;0;0
1285080;Gordian Rooms 1: A curious heritage;;20,000 - 50,000;324;43;281;0;0;3
1285130;Milk and Cookies;;0 - 20,000;4;0;4;0;0;0
1285160;Depanneur Nocturne;;20,000 - 50,000;189;7;182;40;40;0
1285180;Maneuver Warfare;;0 - 20,000;13;0;13;0;0;0
1285210;CasinoLife Poker - #1 Free Texas Holdem 3D;;20,000 - 50,000;75;40;35;0;0;16
1285230;Ultimate Racing 2D 2;;0 - 20,000;136;6;130;0;0;29
1285310;OLD SKOOL RACER;;0 - 20,000;1;4;-3;0;0;0
1285350;Easy puzzle: Landscape;;0 - 20,000;11;2;9;0;0;0
1285390;I-Exist: Consciousness VR;;0 - 20,000;3;1;2;0;0;0
1285490;Way of Boy: Another Way;;0 - 20,000;6;0;6;0;0;0
1285500;血潭江湖百里荣;;0 - 20,000;6;4;2;0;0;0
1285530;Eagles Expedition;;0 - 20,000;7;7;0;0;0;0
1285540;Aldroy - Chapter 1;;0 - 20,000;1;2;-1;0;0;0
1285580;Queens Garden: Sakura Season;;0 - 20,000;13;2;11;0;0;0
1285600;Daiichi Dash;;0 - 20,000;6;0;6;0;0;0
1285610;Awe;;0 - 20,000;4;3;1;0;0;0
1285620;Alone Journey;;0 - 20,000;2;5;-3;0;0;0
1285630;One Try, One Kill;;0 - 20,000;46;9;37;0;0;0
1285660;Watch&Run;;0 - 20,000;7;0;7;0;0;0
1285670;Post Void;;500,000 - 1,000,000;7534;201;7333;89;70;10
1285700;Mobocratic;;0 - 20,000;2;4;-2;0;0;0
1285740;The World's Most Impossible Game;;0 - 20,000;1;0;1;0;0;0
1285750;World of FUNDO;;;;;0;;;
1285800;The Spoon Of Doom;;0 - 20,000;2;1;1;0;0;0
1285820;Virus Kombat;;0 - 20,000;3;2;1;0;0;0
1285870;Little Bunny;;0 - 20,000;22;13;9;0;0;0
1285920;VR Skater;;0 - 20,000;174;23;151;17;17;1
1285930;TYPICAL RUSSIAN QUARANTINE;;0 - 20,000;2;9;-7;0;0;0
1285940;Briefcase Inc.;;0 - 20,000;17;1;16;0;0;0
1285960;The Ancient Art of Staying Alive;;0 - 20,000;4;0;4;0;0;0
1285970;Dwarf Slayer;;0 - 20,000;1;0;1;0;0;0
1286010;Godless Tactics;;0 - 20,000;96;4;92;0;0;0
1286140;Dingletopia: Nation Under Siege (by Orcs);;20,000 - 50,000;144;13;131;0;0;0
1286150;Operation of North Kingdom;;0 - 20,000;3;0;3;0;0;0
1286160;Mosquitoes and zombies;;0 - 20,000;11;1;10;0;0;0
1286170;The Broston Saga;;0 - 20,000;4;2;2;0;0;0
1286210;The Battle of Angels;;0 - 20,000;14;4;10;0;0;0
1286280;Pronty;;0 - 20,000;574;24;550;0;0;4
1286340;Daily Wife;;20,000 - 50,000;561;140;421;45;73;2
1286350;BPM: BULLETS PER MINUTE;;200,000 - 500,000;8556;798;7758;261;262;49
1286360;Let's Learn Korean! Vocabulary;;0 - 20,000;9;3;6;2;2;0
1286370;Project RTD: Random Tower Defense VR;;0 - 20,000;43;8;35;0;0;0
1286470;Just Like Golf;;0 - 20,000;3;1;2;0;0;0
1286490;Awoken: Chapter One of Reverie;;0 - 20,000;1;4;-3;0;0;0
1286530;Black Skylands: Origins;;200,000 - 500,000;485;79;406;1;1;0
1286560;BROTHER!!! Save him! - Hardcore Platformer;;0 - 20,000;5;4;1;0;0;0
1286570;Ultimate Fluid;;0 - 20,000;10;17;-7;0;0;2
1286580;Ship of Fools;;50,000 - 100,000;1448;333;1115;695;757;157
1286590;CodeWalker;;0 - 20,000;2;1;1;0;0;0
1286640;Suli Fallen Harmony;;0 - 20,000;4;0;4;0;0;0
1286650;Face on Fire;;0 - 20,000;3;0;3;0;0;0
1286670;Spooky Chase;;0 - 20,000;33;2;31;0;0;0
1286680;Tiny Tina's Wonderlands;;1,000,000 - 2,000,000;7031;2010;5021;1685;1205;2489
1286710;Hylics 2;;100,000 - 200,000;1780;53;1727;423;423;15
1286730;Epicinium;;20,000 - 50,000;252;33;219;0;0;1
1286770;Internet Court;;0 - 20,000;21;7;14;0;0;1
1286810;Mission Biotech;;100,000 - 200,000;8;2;6;0;0;0
1286830;STAR WARS: The Old Republic;;5,000,000 - 10,000,000;44401;4957;39444;3621;321;6139
1286870;Nevertales: Hearthbridge Cabinet Collector's Edition;;0 - 20,000;4;3;1;0;0;0
1286880;Ship Graveyard Simulator;;50,000 - 100,000;740;298;442;94;94;28
1286880;Ship Graveyard Simulator;;50,000 - 100,000;740;298;442;94;94;28
1286930;Business Shark;;0 - 20,000;1;0;1;0;0;0
1286950;Box Voyage;;0 - 20,000;3;1;2;0;0;0
1286980;String Tyrant;;0 - 20,000;17;0;17;0;0;0
1287000;COVID: The Outbreak;;0 - 20,000;65;27;38;5199;5199;0
1287030;Bubble Bobble 4 Friends: The Baron's Workshop;;0 - 20,000;45;27;18;0;0;0
1287090;qubo;;0 - 20,000;1;0;1;0;0;0
1287100;Ready? Set. Haiya!;;0 - 20,000;11;2;9;0;0;0
1287140;Sonia and the Hypnotic City;;0 - 20,000;41;27;14;0;0;0
1287140;Sonia and the Hypnotic City;;0 - 20,000;41;27;14;0;0;0
1287150;Pulseball;;50,000 - 100,000;27;7;20;0;0;0
1287180;Squares;;20,000 - 50,000;1;0;1;0;0;0
1287220;Doomsday Hero;;0 - 20,000;3;2;1;0;0;0
1287230;Dreaming Atlas;;0 - 20,000;13;5;8;0;0;0
1287240;Siebenstreich's Nerdventure;;0 - 20,000;12;0;12;0;0;0
1287250;! Wild Russia !;;0 - 20,000;42;32;10;0;0;0
1287260;BarnFinders: The Pilot;;100,000 - 200,000;455;41;414;117;143;0
1287310;Juiced!;;0 - 20,000;122;8;114;0;0;1
1287420;PiLKO;;0 - 20,000;8;4;4;0;0;0
1287450;Ultimate Chess;;0 - 20,000;4;2;2;0;0;0
1287530;Lords and Villeins;;20,000 - 50,000;389;102;287;473;473;31
1287540;Dino Hazard: Chronos Blackout;;0 - 20,000;56;3;53;0;0;0
1287590;Tour de France 2020;;0 - 20,000;160;43;117;31;31;11
1287710;Rary;;0 - 20,000;6;6;0;0;0;0
1287750;RC Flight Simulator 2020 VR;;0 - 20,000;15;17;-2;0;0;0
1287790;PhaseWorm;;0 - 20,000;1;0;1;0;0;0
1287800;Schwarzerblitz;;20,000 - 50,000;135;3;132;0;0;0
1287810;Shattered Hourglass;;0 - 20,000;16;1;15;0;0;0
1287830;Forbidden Pleasure;;0 - 20,000;6;12;-6;0;0;0
1287840;Disciples: Liberation;;100,000 - 200,000;2105;707;1398;1155;1161;127
1287850;Guilded;;0 - 20,000;6;7;-1;0;0;0
1287860;The Harrowed;;20,000 - 50,000;15;0;15;0;0;0
1287880;In The Search For: Revenge;;0 - 20,000;0;2;-2;0;0;0
1287920;Brass: Birmingham;;20,000 - 50,000;219;133;86;0;0;26
1287940;Blaze;;0 - 20,000;2;2;0;0;0;0
1287970;Centauri Dominion;;0 - 20,000;1;0;1;0;0;0
1287980;Eternal Vortex - Beta;;0 - 20,000;1;1;0;0;0;0
1288020;Eternal Starshine Beta;;0 - 20,000;0;1;-1;0;0;0
1288030;BoxxyQuest: The Gathering Storm;;20,000 - 50,000;4;1;3;0;0;0
1288040;Helicopter Simulator 2020;;0 - 20,000;0;6;-6;0;0;0
1288070;LightBall;;0 - 20,000;18;0;18;0;0;0
1288090;Wire;;0 - 20,000;3;0;3;0;0;0
1288110;Super Robin;;0 - 20,000;0;4;-4;0;0;0
1288130;TP Royale;;0 - 20,000;8;0;8;0;0;0
1288170;Red Planet Farming;;100,000 - 200,000;642;27;615;0;0;3
1288300;AdaptaTank;;0 - 20,000;3;0;3;0;0;0
1288310;Firework;;500,000 - 1,000,000;30388;604;29784;173;219;234
1288320;Way of the Hunter;;100,000 - 200,000;3490;1293;2197;1501;1587;506
1288330;XpCade;;50,000 - 100,000;4;0;4;0;0;0
1288370;Desert attack;;0 - 20,000;3;2;1;0;0;0
1288380;Two Bit Hero;;0 - 20,000;2;3;-1;0;0;0
1288410;Outshine;;0 - 20,000;28;0;28;0;0;1
1288420;The Secret of Retropolis;;50,000 - 100,000;111;6;105;0;0;0
1288430;TinShift;;0 - 20,000;101;36;65;0;0;0
1288550;Extreme Social Distancing;;0 - 20,000;1;0;1;0;0;0
1288560;My Dear Prince;;0 - 20,000;23;3;20;0;0;0
1288600;TWELVE CONTAINERS;;0 - 20,000;12;7;5;0;0;0
1288610;Wildcat Gun Machine;;0 - 20,000;61;28;33;0;0;0
1288630;City Defender;;0 - 20,000;2;0;2;0;0;0
1288650;Pon Para and the Unconquerable Scorpion;;0 - 20,000;8;1;7;0;0;0
1288670;Antidote;;0 - 20,000;12;5;7;0;0;0
1288760;Dude, Where Is My Beer?;;0 - 20,000;95;12;83;0;0;0
1288790;BeachHead;;50,000 - 100,000;37;24;13;5;5;0
1288900;Title_Pending;;0 - 20,000;175;9;166;0;0;1
1288930;Hargrave;;20,000 - 50,000;211;18;193;0;0;1
1288940;ARCHiTECTUS;;0 - 20,000;6;0;6;0;0;0
1288960;SwordBoy;;0 - 20,000;2;1;1;0;0;0
1289010;Haypi Monster 3;;0 - 20,000;25;14;11;0;0;1
1289120;A.I-Mnemosyne 記憶女神;;0 - 20,000;7;2;5;0;0;0
1289170;Defenders of the West;;0 - 20,000;7;0;7;0;0;0
1289240;The Ancient Lands;;0 - 20,000;1;0;1;0;0;0
1289260;就这消消乐;;0 - 20,000;2;0;2;0;0;0
1289300;Bubble With Djealy;;0 - 20,000;1;3;-2;0;0;0
1289310;Helltaker;;2,000,000 - 5,000,000;107953;2286;105667;115;70;93
1289330;Angry Bunny 3: Virus;;20,000 - 50,000;27;4;23;0;0;0
1289340;TasteMaker;;50,000 - 100,000;883;129;754;132;141;5
1289380;Sheltered 2;;100,000 - 200,000;818;856;-38;0;0;50
1289470;Break Robots VR;;0 - 20,000;2;1;1;0;0;0
1289480;The Hero with a Thousand Arms / 千手英雄;;0 - 20,000;7;0;7;0;0;0
1289490;Dungeon Solver;;0 - 20,000;32;10;22;0;0;0
1289500;BattleParty;;0 - 20,000;11;7;4;0;0;0
1289510;Shuffled Nightmares;;0 - 20,000;0;1;-1;0;0;0
1289520;SHMUP Creator;;0 - 20,000;45;5;40;0;0;4
1289550;Synth War Tactics;;0 - 20,000;2;0;2;0;0;0
1289610;Traumatic Syndrome - Investigative Horror Visual Novel;;0 - 20,000;4;1;3;0;0;0
1289640;The Confession;;0 - 20,000;907;37;870;0;0;0
1289690;Midsummer Night;;0 - 20,000;32;1;31;0;0;0
1289750;Operation Zeta;;0 - 20,000;16;1;15;0;0;0
1289770;Robot Builder War;;0 - 20,000;1;0;1;0;0;0
1289780;Not Our Home: Platinum Edition;;0 - 20,000;5;2;3;0;0;0
1289800;Prophecy;;50,000 - 100,000;357;56;301;0;0;0
1289810;Siralim Ultimate;;100,000 - 200,000;1376;82;1294;11723;23428;52
1289830;迅风的米斯特汀 Windy Mystletainn;;50,000 - 100,000;19;1;18;0;0;0
1289850;Astrozombies;;0 - 20,000;3;0;3;0;0;0
1289890;VR Long March ;;0 - 20,000;2;1;1;0;0;0
1289900;NoWaitHero;;0 - 20,000;9;3;6;0;0;0
1289960;Core Awaken ~Jilelen and LittleSnow~;;0 - 20,000;32;0;32;0;0;0
1289990;Alan's Automaton Workshop;;50,000 - 100,000;133;28;105;0;0;4
1290000;PowerWash Simulator;;500,000 - 1,000,000;32163;768;31395;1760;1177;2661
1290010;Spacefighter Rukia;;0 - 20,000;13;0;13;0;0;0
1290010;Spacefighter Rukia;;0 - 20,000;13;0;13;0;0;0
1290040;Intemporel;;0 - 20,000;6;0;6;0;0;0
1290070;Hot And Lovely 3;;0 - 20,000;168;47;121;88;64;2
1290090;The Wicked Days;;0 - 20,000;27;4;23;0;0;0
1290100;Draginsanity;;0 - 20,000;2;0;2;0;0;0
1290110;Ginseng Hero;;0 - 20,000;21;9;12;0;0;0
1290160;DOUDY;;0 - 20,000;10;11;-1;0;0;0
1290170;Titan Chaser;;20,000 - 50,000;463;97;366;63;63;3
1290200;Beautycopter;;0 - 20,000;25;0;25;0;0;0
1290220;Elasto Mania Remastered;;0 - 20,000;199;0;199;141;210;1
1290220;Elasto Mania Remastered;;0 - 20,000;199;0;199;141;210;1
1290270;Vampire: The Masquerade — Night Road;;20,000 - 50,000;464;49;415;0;0;12
1290350;Vampire: The Masquerade — Out for Blood;;0 - 20,000;98;38;60;0;0;0
1290390;PT+;;20,000 - 50,000;6;1;5;0;0;0
1290460;Light Years Apart;;0 - 20,000;6;2;4;0;0;0
1290480;KaveXplorer;;0 - 20,000;5;0;5;0;0;0
1290510;Your Human is Sick;;0 - 20,000;8;3;5;0;0;0
1290620;'Member the Alamo? VR EDITION;;0 - 20,000;2;1;1;0;0;0
1290670;Freedom! Do or Die;;0 - 20,000;4;0;4;0;0;0
1290680;SnowFighters;;0 - 20,000;5;0;5;0;0;1
1290710;Shiro;;20,000 - 50,000;242;35;207;0;0;0
1290750;Crawl Tactics;;0 - 20,000;43;9;34;0;0;6
1290770;Mushroom Savior;;0 - 20,000;12;0;12;0;0;0
1290780;Residual;;0 - 20,000;21;6;15;0;0;1
1290790;Yardlings;;0 - 20,000;32;3;29;606;606;0
1290820;Project Océara;;0 - 20,000;4;1;3;0;0;0
1290830;逃出图书馆(Escape from Library);;50,000 - 100,000;7;2;5;0;0;0
1290850;Kingdom of Corrupts;;0 - 20,000;11;17;-6;0;0;0
1290920;Roll Control;;20,000 - 50,000;5;0;5;0;0;0
1290960;Strange Aeons;;20,000 - 50,000;5;0;5;0;0;0
1290960;Strange Aeons;;20,000 - 50,000;5;0;5;0;0;0
1291010;Warpips;;100,000 - 200,000;2964;360;2604;320;380;45
1291020;Replicated;;0 - 20,000;5;0;5;0;0;0
1291050;Pilots Of Darsalon;;0 - 20,000;27;3;24;0;0;0
1291060;Epicure;;0 - 20,000;15;0;15;0;0;0
1291090;Stozle - Solve the Mystery;;0 - 20,000;9;0;9;0;0;0
1291100;Night Spasm;;0 - 20,000;3;3;0;0;0;0
1291110;Poly Party;;0 - 20,000;1;1;0;0;0;0
1291140;重生 Rebirth;;0 - 20,000;3;0;3;0;0;0
1291170;Terrordrome - Reign of the Legends;;100,000 - 200,000;78;18;60;0;0;1
1291210;Justice.exe;;20,000 - 50,000;69;15;54;0;0;0
1291220;Crash The Core;;0 - 20,000;35;13;22;0;0;2
1291230;Heaven vs Hell;;0 - 20,000;19;3;16;0;0;0
1291240;Zamboni Simulator 2019;;20,000 - 50,000;212;24;188;0;0;0
1291250;故鄉戰爭 HOMETOWN WAR;;0 - 20,000;20;5;15;0;0;1
1291280;PXL-SHIP;;0 - 20,000;2;0;2;0;0;0
1291330;Wakamarina Valley, New Zealand;;0 - 20,000;74;16;58;0;0;1
1291340;Townscaper;;500,000 - 1,000,000;17459;673;16786;172;66;85
1291370;Lotion samurai;;0 - 20,000;74;0;74;0;0;0
1291470;Robot Paradise VR;;20,000 - 50,000;0;1;-1;0;0;0
1291500;Kill It With Fire: Ignition;;50,000 - 100,000;1479;137;1342;21;17;3
1291530;Arena;;20,000 - 50,000;186;18;168;0;0;0
1291540;Cartridge Defense;;0 - 20,000;72;5;67;0;0;4
1291640;Stress explosion;;0 - 20,000;20;3;17;0;0;0
1291660;Deeply Dark;;0 - 20,000;2;2;0;0;0;0
1291670;Hentai Girls 2;;0 - 20,000;7;0;7;0;0;0
1291680;Apocalypse: 2.0 Edition;;0 - 20,000;16;19;-3;0;0;0
1291720;Neon Beat Rider;;0 - 20,000;1;0;1;0;0;0
1291740;Vertical Runner;;0 - 20,000;3;2;1;0;0;0
1291830;Outlaws: Corwin's Treasure;;0 - 20,000;17;17;0;0;0;1
1291970;Mythic Dungeons;;0 - 20,000;11;23;-12;0;0;2
1291990;Magic Forms;;0 - 20,000;0;4;-4;0;0;0
1292010;Missile Command: Recharged;;0 - 20,000;160;19;141;0;0;0
1292010;Missile Command: Recharged;;0 - 20,000;160;19;141;0;0;0
1292020;Armoured Commander II;;0 - 20,000;376;7;369;879;879;11
1292020;Armoured Commander II;;0 - 20,000;376;7;369;879;879;11
1292040;STRIDE;;200,000 - 500,000;1731;309;1422;87;146;7
1292050;Pure Soul: The Journey of the Witch Emily;;50,000 - 100,000;12;0;12;0;0;0
1292070;SubDivide;;0 - 20,000;3;1;2;0;0;0
1292100;TraptionBakery;;20,000 - 50,000;8;0;8;0;0;0
1292100;TraptionBakery;;20,000 - 50,000;8;0;8;0;0;0
1292140;Grim Tales: The Generous Gift Collector's Edition;;0 - 20,000;7;2;5;0;0;0
1292170;Krush Kill 'N Destroy Xtreme;;0 - 20,000;100;33;67;0;0;2
1292180;Krush Kill ‘N Destroy 2: Krossfire;;0 - 20,000;157;60;97;0;0;8
1292220;Apoc Runner;;0 - 20,000;16;4;12;0;0;0
1292240;The Chess Variants Club;;0 - 20,000;39;7;32;0;0;1
1292250;Blackjack Hands;;0 - 20,000;17;4;13;0;0;0
1292270;Late Stage Inferno;;0 - 20,000;1;1;0;0;0;0
1292280;Hentai beautiful girls 3;;0 - 20,000;14;6;8;0;0;0
1292410;Golden Fall 2;;20,000 - 50,000;10;1;9;0;0;0
1292520;Crimson Spires;;0 - 20,000;57;6;51;0;0;0
1292540;Escape: The Brother's Saloon;;0 - 20,000;76;20;56;0;0;0
1292550;Lockdown;;0 - 20,000;19;11;8;0;0;0
1292560;Bikini Alert;;0 - 20,000;1;1;0;0;0;0
1292630;3on3 FreeStyle: Rebound;;500,000 - 1,000,000;1324;807;517;169;206;173
1292700;Kings Of Streets;;0 - 20,000;87;61;26;0;0;0
1292750;Hunting Moon - Depression & Succubus;;0 - 20,000;62;29;33;0;0;0
1292770;Grisaia Phantom Trigger Vol.7;;20,000 - 50,000;92;13;79;0;0;1
1292880;Hit Zero: Chronos;;100,000 - 200,000;40;13;27;0;0;1
1292910;Accident: The Pilot;;100,000 - 200,000;473;210;263;245;479;5
1292920;Fatec's Out: School Rage;;0 - 20,000;24;6;18;0;0;0
1292920;Fatec's Out: School Rage;;0 - 20,000;24;6;18;0;0;0
1292940;Cube Escape Collection;;100,000 - 200,000;4327;66;4261;381;666;79
1292960;The Magic Storm;;0 - 20,000;18;7;11;0;0;0
1292980;Professor Lupo: Ocean;;20,000 - 50,000;11;2;9;0;0;0
1293000;Hyzer Sky;;0 - 20,000;17;1;16;0;0;0
1293040;candle flame in the wind;;20,000 - 50,000;192;19;173;0;0;0
1293120;Silmaris: Dice Kingdom;;0 - 20,000;60;25;35;0;0;0
1293160;The Medium;;200,000 - 500,000;6197;790;5407;409;461;8
1293180;SuchArt: Genius Artist Simulator;;50,000 - 100,000;3282;65;3217;651;710;38
1293190;Hunt Planet Bug;;0 - 20,000;3;0;3;0;0;0
1293230;House of Detention;;200,000 - 500,000;7930;697;7233;154;119;19
1293370;WC;;0 - 20,000;0;2;-2;0;0;0
1293400;Software House Simulator;;0 - 20,000;6;8;-2;0;0;0
1293420;Roller Drama;;0 - 20,000;10;0;10;0;0;0
1293430;Space Junk;;20,000 - 50,000;3;1;2;0;0;0
1293510;Anicon - Animal Complex - Rabbit's Path;;0 - 20,000;1;0;1;0;0;0
1293520;Flatland Vol.2;;0 - 20,000;34;4;30;0;0;0
1293530;Disc Ninja;;0 - 20,000;7;5;2;0;0;0
1293540;Outerverse;;0 - 20,000;63;40;23;0;0;1
1293610;Escape Planet 17;;0 - 20,000;2;0;2;0;0;0
1293650;b 2;;;;;0;;;
1293730;Broken Pieces;;20,000 - 50,000;191;50;141;0;0;3
1293780;Fear the Dark Unknown: Chloe;;0 - 20,000;12;2;10;0;0;0
1293820;YOU and ME and HER: A Love Story;;50,000 - 100,000;2270;82;2188;435;435;24
1293830;Forza Horizon 4;;2,000,000 - 5,000,000;151873;18758;133115;2657;1067;7198
1293850;The Magic Elevator;;0 - 20,000;4;3;1;0;0;0
1293860;The Riftbreaker: Prologue;;200,000 - 500,000;3906;175;3731;266;120;2
1293880;Boo's Balloons;;0 - 20,000;6;1;5;0;0;0
1293900;NOMAD;;0 - 20,000;29;0;29;0;0;0
1293940;M.U.S.T. Repeat;;0 - 20,000;4;0;4;0;0;0
1293950;Masquerade of Miasma;;50,000 - 100,000;1;0;1;0;0;0
1293970;Sound Science;;0 - 20,000;1;0;1;0;0;0
1293980;Rozalin and the Palace of Flowers;;0 - 20,000;3;2;1;0;0;0
1293990;Nullum;;0 - 20,000;35;2;33;0;0;0
1294000;Krim: The War in the Crimea 1941-42;;0 - 20,000;2;1;1;0;0;0
1294020;Space Mercenary Shooter : Episode 2;;0 - 20,000;3;0;3;0;0;0
1294040;Best Friend;;0 - 20,000;15;11;4;0;0;0
1294060;铁道少女:梦想轨迹 2.0 Railway To Dream;;0 - 20,000;152;2;150;285;285;0
1294120;Bragger's Run;;0 - 20,000;11;0;11;0;0;0
1294160;DJIGULI;;0 - 20,000;3;6;-3;0;0;0
1294170;TCSTRIKERS3;;0 - 20,000;1;2;-1;0;0;0
1294220;Learn Game Development, Unity Code Monkey;;50,000 - 100,000;98;17;81;0;0;0
1294230;Interrogation Files: Port Landsend;;0 - 20,000;60;6;54;0;0;0
1294280;Game Of Puzzles: Dinosaurs;;0 - 20,000;25;1;24;0;0;1
1294300;Sockventure: Prologue;;0 - 20,000;65;12;53;0;0;0
1294310;Unforgotten;;0 - 20,000;39;11;28;0;0;0
1294310;Unforgotten;;0 - 20,000;39;11;28;0;0;0
1294340;Wonhon: A Vengeful Spirit;;200,000 - 500,000;0;0;0;4;4;0
1294420;Rollerdrome;;50,000 - 100,000;1057;66;991;115;144;8
1294450;Little Witch Academia: VR Broom Racing;;0 - 20,000;22;2;20;0;0;0
1294630;Shape Storm;;0 - 20,000;2;1;1;0;0;0
1294650;The Mansion;;0 - 20,000;82;23;59;0;0;2
1294660;Divine Knockout (DKO);;100,000 - 200,000;3334;1611;1723;122;89;299
1294680;Café Rouge;;0 - 20,000;20;26;-6;0;0;0
1294720;Balloon Blast;;0 - 20,000;16;2;14;0;0;0
1294750;Dr. Atominus;;0 - 20,000;12;3;9;0;0;0
1294760;HARD BULLET;;100,000 - 200,000;2524;393;2131;419;669;75
1294770;Atlas Engine;;0 - 20,000;18;5;13;0;0;0
1294780;Pathfinders: Memories;;20,000 - 50,000;43;6;37;0;0;0
1294880;Blind Fate: Edo no Yami;;0 - 20,000;84;29;55;10;10;0
1294920;Another FPS Game;;0 - 20,000;5;2;3;0;0;0
1294970;Undead Darlings ~no cure for love~;;0 - 20,000;15;1;14;0;0;0
1295000;The Last Shot;;0 - 20,000;17;3;14;0;0;3
1295030;Zagan Must Be Rescued;;0 - 20,000;6;2;4;0;0;0
1295210;Snack clearing;;0 - 20,000;1;4;-3;0;0;0
1295230;三国志猛将传;;0 - 20,000;60;48;12;0;0;1
1295250;Future Fragments - Command Z;;0 - 20,000;4;2;2;0;0;0
1295250;Future Fragments - Command Z;;0 - 20,000;4;2;2;0;0;0
1295260;Clockwork Calamity in Mushroom World: What would you do if the time stopped ticking?;;;;;0;;;
1295270;SaGa Frontier Remastered;;50,000 - 100,000;434;40;394;331;331;13
1295420;Chaos Party;;0 - 20,000;4;0;4;0;0;0
1295440;Boom slayer;;0 - 20,000;2;7;-5;0;0;0
1295490;Beyond DAWN;;0 - 20,000;12;1;11;0;0;0
1295500;Warhammer 40,000: Battlesector;;100,000 - 200,000;3134;347;2787;542;580;103
1295510;DRAGON QUEST XI S: Echoes of an Elusive Age - Definitive Edition;;200,000 - 500,000;6140;369;5771;2665;3850;417
1295570;Amends VR;;0 - 20,000;17;3;14;0;0;0
1295670;My Strong Horse;;50,000 - 100,000;20;5;15;0;0;1
1295700;Nitroverse;;20,000 - 50,000;7;1;6;0;0;0
1295740;Mine Dungeon2 ~Rurumu's trip~;;0 - 20,000;18;3;15;0;0;0
1295750;Jack Hayes: The Lazarus Sign;;0 - 20,000;3;1;2;0;0;0
1295760;Moonfall;;0 - 20,000;15;1;14;0;0;0
1295790;The Longest Road on Earth;;0 - 20,000;272;56;216;0;0;0
1295810;A Little Shop in Squirrel Town;;0 - 20,000;42;12;30;0;0;1
1295900;Draconia;;0 - 20,000;336;141;195;0;0;13
1295900;Draconia;;0 - 20,000;336;141;195;0;0;13
1295910;The Ninth Way;;0 - 20,000;2;0;2;0;0;0
1295920;The Mortuary Assistant;;100,000 - 200,000;3533;319;3214;275;301;90
1295990;Adriatic Pizza;;0 - 20,000;4;0;4;0;0;0
1296010;Stay in the Light;;0 - 20,000;25;16;9;0;0;0
1296180;Risky Floors;;0 - 20,000;1;5;-4;0;0;0
1296190;What a Cluster Fight;;0 - 20,000;1;1;0;0;0;0
1296200;Astonishing Baseball Manager 20;;0 - 20,000;3;1;2;0;0;0
1296260;Sakura Knight 2;;0 - 20,000;54;14;40;0;0;0
1296280;Car Trader Simulator - Welcome to the Business;;50,000 - 100,000;279;163;116;21;27;0
1296290;What Happened;;0 - 20,000;61;37;24;0;0;0
1296360;Archvale;;100,000 - 200,000;1480;171;1309;224;224;12
1296370;ThinkFast;;0 - 20,000;0;1;-1;0;0;0
1296410;Underdog Arena;;0 - 20,000;1;0;1;0;0;0
1296450;Dust & Neon;;0 - 20,000;69;25;44;0;0;82
1296480;Surviving Isolation;;0 - 20,000;2;2;0;0;0;0
1296510;Dread X Collection;;0 - 20,000;349;73;276;250;250;2
1296540;Flatworld;;20,000 - 50,000;723;20;703;319;319;0
1296550;Altidudes;;0 - 20,000;3;0;3;0;0;0
1296560;Vectromirror 0;;100,000 - 200,000;371;63;308;0;0;0
1296580;Finger Guessing King;;0 - 20,000;0;1;-1;0;0;0
1296610;Peglin;;200,000 - 500,000;5895;1340;4555;908;667;465
1296650;The Chronicles of Confucius's Journey;;0 - 20,000;9;2;7;0;0;0
1296680;Cute Triplets;;0 - 20,000;0;1;-1;0;0;0
1296700;Headbangers in Holiday Hell;;0 - 20,000;44;6;38;0;0;0
1296720;欢乐消消乐;;50,000 - 100,000;4;7;-3;0;0;0
1296810;Naturalealia: Forest Determination;;0 - 20,000;1;0;1;0;0;0
1296830;暖雪 Warm Snow;;500,000 - 1,000,000;23665;1906;21759;2143;1287;2351
1296840;The Spike;;100,000 - 200,000;1355;91;1264;71;104;98
1296860;Enter Digiton;;0 - 20,000;24;7;17;0;0;0
1296880;Sausage Hunter;;0 - 20,000;18;3;15;0;0;0
1296970;Zombieland VR: Headshot Fever;;0 - 20,000;52;7;45;0;0;0
1296980;Forgotten Fields;;0 - 20,000;67;7;60;0;0;0
1297010;Rinlo;;0 - 20,000;25;6;19;0;0;0
1297030;Sycamore;;0 - 20,000;3;0;3;0;0;0
1297090;Stack Up! (or dive trying);;0 - 20,000;22;2;20;0;0;0
1297160;a new life.;;50,000 - 100,000;1688;57;1631;0;0;1
1297180;Plato Shoot 柏拉图激射;;0 - 20,000;1;0;1;0;0;0
1297200;Fantasy Lands;;20,000 - 50,000;8;0;8;0;0;0
1297210;Tandis;;0 - 20,000;110;2;108;0;0;0
1297230;My Jigsaw Adventures - A Lost Story;;0 - 20,000;33;3;30;0;0;0
1297270;Programmer Dungeon Knightress;;0 - 20,000;9;1;8;0;0;1
1297300;The Shore;;50,000 - 100,000;919;313;606;111;111;5
1297320;ACT;;0 - 20,000;29;20;9;0;0;0
1297330;Olija;;20,000 - 50,000;515;45;470;295;295;1
1297340;Ryclaw: Hope;;0 - 20,000;5;0;5;0;0;0
1297370;Zombies Don't Drive;;0 - 20,000;4;10;-6;0;0;0
1297390;Inexistence Rebirth;;0 - 20,000;67;26;41;0;0;1
1297430;Deadly Dozen Reloaded;;20,000 - 50,000;17;11;6;0;0;1
1297470;Inconsistencies;;0 - 20,000;10;7;3;0;0;0
1297480;Isorropia;;0 - 20,000;1;1;0;0;0;0
1297490;Superior;;0 - 20,000;46;13;33;0;0;0
1297530;Liar Trick -Psychological Crime Mystery-;;0 - 20,000;17;7;10;0;0;1
1297540;Blobkin Blaster;;0 - 20,000;6;1;5;0;0;0
1297550;TKO;;0 - 20,000;1;0;1;0;0;0
1297560;Timequest;;0 - 20,000;1;0;1;0;0;1
1297650;About Gretel;;0 - 20,000;25;19;6;0;0;0
1297660;Fragment's Moonrise;;0 - 20,000;24;9;15;0;0;0
1297720;Starstruck: Prologue;;20,000 - 50,000;180;11;169;0;0;1
1297790;Sunday Rivals;;0 - 20,000;201;15;186;0;0;3
1297800;ChronoBreach Ultra;;0 - 20,000;28;4;24;0;0;1
1297890;Rocky Ride;;0 - 20,000;13;9;4;0;0;0
1298000;Hidden;;0 - 20,000;2;4;-2;0;0;0
1298010;Tactical Combat Department;;20,000 - 50,000;60;29;31;0;0;0
1298020;Syzygy;;0 - 20,000;27;0;27;0;0;0
1298040;SpellCaster;;0 - 20,000;6;1;5;0;0;0
1298050;Boinihi: The Ki Codex;;0 - 20,000;17;2;15;0;0;0
1298080;Almost My Floor;;0 - 20,000;133;16;117;0;0;0
1298100;The Old West Savior;;0 - 20,000;7;6;1;0;0;0
1298130;Mark One;;0 - 20,000;4;0;4;0;0;0
1298140;Fobia - St. Dinfna Hotel;;0 - 20,000;831;99;732;226;226;44
1298180;Pair Matching Puzzle Connect;;0 - 20,000;3;2;1;0;0;1
1298280;Captain Disaster in: Death Has A Million Stomping Boots;;0 - 20,000;19;0;19;0;0;0
1298310;Rhythm Race;;0 - 20,000;15;2;13;0;0;0
1298320;Galaxy Cat;;0 - 20,000;3;0;3;0;0;0
1298340;Bad Meme;;0 - 20,000;8;2;6;0;0;0
1298360;MIBT;;0 - 20,000;7;0;7;0;0;0
1298380;宇宙探索;;0 - 20,000;0;1;-1;0;0;0
1298390;Rubble Bubble;;20,000 - 50,000;0;3;-3;0;0;0
1298480;Kardboard Kings: Card Shop Simulator;;0 - 20,000;261;78;183;0;0;0
1298500;Fantasy Mosaics 33: Inventor's Workshop;;0 - 20,000;2;0;2;0;0;0
1298510;GeoLogic;;0 - 20,000;2;1;1;0;0;0
1298520;Zac Zac adventure;;0 - 20,000;0;1;-1;0;0;0
1298600;Dam Busters;;0 - 20,000;1;0;1;0;0;0
1298620;GAMECINE VR;;0 - 20,000;10;6;4;0;0;0
1298640;Buck Bradley Comic Adventure 2;;0 - 20,000;1;0;1;0;0;0
1298670;I, AI;;0 - 20,000;36;15;21;0;0;0
1298690;Nigel's Journey : A Working Day;;0 - 20,000;0;1;-1;0;0;0
1298700;patter warrior;;0 - 20,000;0;4;-4;0;0;0
1298740;Hopebringers;;0 - 20,000;28;4;24;0;0;0
1298750;Lost Knight;;0 - 20,000;1;0;1;0;0;0
1298820;Ad Agency Tycoon;;0 - 20,000;43;13;30;0;0;0
1298830;Don't Fall;;0 - 20,000;61;10;51;0;0;0
1298850;Lihue;;0 - 20,000;13;2;11;0;0;0
1298880;Barrel Blast;;0 - 20,000;2;0;2;0;0;0
1298890;Whispers from Within: Moving On;;0 - 20,000;9;0;9;0;0;0
1299000;Toasted!;;0 - 20,000;0;2;-2;0;0;0
1299010;Overseer;;0 - 20,000;3;0;3;0;0;0
1299120;Mosaique Neko Waifus 2;;100,000 - 200,000;2302;107;2195;208;164;7
1299130;The Apocalypse;;20,000 - 50,000;9;13;-4;0;0;0
1299220;Rockytown;;0 - 20,000;6;1;5;0;0;0
1299220;Rockytown;;0 - 20,000;6;1;5;0;0;0
1299260;Isolation Story;;0 - 20,000;1;0;1;0;0;0
1299330;Victory At Sea Ironclad;;0 - 20,000;9;3;6;0;0;0
1299330;Victory At Sea Ironclad;;0 - 20,000;9;3;6;0;0;0
1299360;Mighty Goose;;50,000 - 100,000;560;94;466;295;295;0
1299400;Understand;;20,000 - 50,000;464;38;426;0;0;15
1299420;Touhou : Shooting Star | 東方流星譚;;0 - 20,000;42;2;40;0;0;0
1299430;Extortion;;0 - 20,000;9;0;9;0;0;0
1299480;The Fabled Woods;;0 - 20,000;80;46;34;0;0;0
1299580;Agent-00;;20,000 - 50,000;40;14;26;0;0;0
1299600;Tinseltown Tycoon;;0 - 20,000;16;7;9;0;0;1
1299620;Fabled Lands;;50,000 - 100,000;273;59;214;58;58;59
1299660;WiP;;20,000 - 50,000;2;0;2;0;0;0
1299680;NicoNotes The Whoo!;;0 - 20,000;1;0;1;0;0;0
1299710;Return of the Phantom;;20,000 - 50,000;12;1;11;0;0;0
1299720;Les Manley in: Search for the King;;100,000 - 200,000;2;0;2;0;0;0
1299730;Les Manley in: Lost in L.A.;;0 - 20,000;1;0;1;0;0;0
1299750;Wizodd;;0 - 20,000;27;5;22;0;0;0
1299790;Be Hero;;0 - 20,000;84;6;78;0;0;0
1299810;Kovox Pitch;;0 - 20,000;50;3;47;0;0;0
1299820;Not Their Will;;0 - 20,000;8;0;8;0;0;1
1299880;Deep Abyss;;0 - 20,000;3;0;3;0;0;0
1299890;Zombie Slayer;;0 - 20,000;10;2;8;0;0;0
1299900;Everland (Stress Test);;100,000 - 200,000;264;16;248;0;0;0
1299930;Vilset;;0 - 20,000;27;33;-6;0;0;0
1299980;CursorFX;;0 - 20,000;18;8;10;0;0;0
1299990;Whateverland: Prologue;;20,000 - 50,000;136;21;115;0;0;0
1300000;Mystery Tales: Til Death Collector's Edition;;0 - 20,000;5;4;1;0;0;0
1300050;A Story In Space;;0 - 20,000;7;5;2;0;0;0
1300060;SMIB: Mission Cure;;20,000 - 50,000;19;2;17;0;0;0
1300100;Spectacular Sparky;;0 - 20,000;87;8;79;0;0;0
1300110;THE Z LAND : FPS SURVIVAL;;0 - 20,000;2;4;-2;0;0;0
1300140;HereticOS MR Lab;;20,000 - 50,000;0;1;-1;0;0;0
1300160;异世界的无厘头生活;;0 - 20,000;137;67;70;0;0;0
1300190;Crystal Story: The Hero and the Evil Witch;;0 - 20,000;17;7;10;0;0;0
1300200;Express Thru;;0 - 20,000;10;0;10;0;0;0
1300310;Move Code Lines;;0 - 20,000;40;5;35;11;11;0
1300330;Farmageddon: A Cattle Royale;;0 - 20,000;27;1;26;0;0;0
1300330;Farmageddon: A Cattle Royale;;0 - 20,000;27;1;26;0;0;0
1300360;Neglected;;20,000 - 50,000;314;28;286;0;0;0
1300390;Sunset Shapes;;0 - 20,000;20;2;18;0;0;0
1300430;Whiskey.Mafia. Leo's Family;;0 - 20,000;204;104;100;0;0;0
1300490;Shooty Skies Overdrive;;0 - 20,000;15;2;13;0;0;0
1300560;Mars Power Industries: First Job;;0 - 20,000;47;4;43;0;0;0
1300570;Apollo Lunar Mission;;0 - 20,000;2;3;-1;0;0;0
1300580;Battle Baseball;;0 - 20,000;4;12;-8;0;0;0
1300590;Taiga;;0 - 20,000;3;1;2;0;0;0
1300600;Blind Drive;;0 - 20,000;191;7;184;0;0;0
1300610;Taxer Inc;;0 - 20,000;30;26;4;0;0;0
1300630;Meditation 2 ~ Wisdom and Christian Art;;0 - 20,000;3;0;3;0;0;0
1300650;Rodent and Plank: Secret Origin;;0 - 20,000;2;0;2;0;0;0
1300670;ヤドカリサバイブ;;0 - 20,000;12;0;12;0;0;0
1300680;Goblin Jargon;;0 - 20,000;40;23;17;0;0;0
1300700;Kingdom Wars 4;;0 - 20,000;116;50;66;41;41;5
1300790;Dayscream;;0 - 20,000;0;3;-3;0;0;0
1300860;Strawberry Chocolate: Miner 8AD 4SS;;0 - 20,000;2;1;1;0;0;0
1300890;Tap-A-Zombie;;0 - 20,000;1;1;0;0;0;0
1300920;Ghost of Dragon;;20,000 - 50,000;360;279;81;0;0;49
1300940;CoronaWhomp!;;0 - 20,000;4;3;1;0;0;0
1300950;Tiki Tiki: The Tropical Memory Game;;0 - 20,000;6;0;6;0;0;0
1300960;ASTROVITY;;0 - 20,000;7;0;7;0;0;0
1301000;MYSTERY of the Missing Brigantine;;0 - 20,000;1;0;1;0;0;0
1301010;World Racing 2 - Champion Edition;;0 - 20,000;121;8;113;41;41;1
1301100;Forking Hell;;0 - 20,000;11;0;11;0;0;0
1301210;Knockout City;;1,000,000 - 2,000,000;6737;1172;5565;476;132;145
1301220;Dear Devere;;0 - 20,000;193;9;184;0;0;1
1301230;Astrodogs;;0 - 20,000;26;6;20;0;0;0
1301250;Biscuitts;;0 - 20,000;6;3;3;0;0;0
1301260;My Personal World;;0 - 20,000;1;0;1;0;0;0
1301310;Gems of Fate: the Charmed King;;0 - 20,000;0;3;-3;0;0;0
1301310;Gems of Fate: the Charmed King;;0 - 20,000;0;3;-3;0;0;0
1301370;Pyro Fighters;;0 - 20,000;6;0;6;0;0;0
1301380;Rogue Planet;;0 - 20,000;4;1;3;0;0;0
1301390;No Umbrellas Allowed;;200,000 - 500,000;873;223;650;1197;1559;23
1301410;Solar Rogue;;0 - 20,000;5;0;5;0;0;0
1301430;Dragon Extinction VR;;0 - 20,000;15;9;6;0;0;2
1301470;Bishoujo Battle Hanafuda Koi-Koi;;0 - 20,000;22;10;12;0;0;1
1301480;Bishoujo Battle Mahjong Solitaire;;0 - 20,000;24;13;11;0;0;0
1301500;Quarry Simulator 2021;;0 - 20,000;0;2;-2;0;0;0
1301520;Wrestledunk Sports;;0 - 20,000;20;1;19;0;0;0
1301560;Space Roaming;;0 - 20,000;6;2;4;0;0;0
1301580;Qube Qross;;0 - 20,000;12;3;9;0;0;0
1301590;Beyond Mankind: The Awakening;;0 - 20,000;47;50;-3;0;0;2
1301620;Cross Princess;;20,000 - 50,000;733;28;705;111;178;0
1301650;Knight's Destiny;;0 - 20,000;1;0;1;0;0;0
1301720;Escape Room - Der kranke Kollege;;500,000 - 1,000,000;7610;1018;6592;101;83;142
1301730;Raid on the Zone;;0 - 20,000;4;0;4;0;0;0
1301770;Machizzle;;0 - 20,000;31;1;30;0;0;0
1301830;Shatris: Infinite Puzzles;;0 - 20,000;18;0;18;0;0;0
1301840;Maggie the Magnet;;0 - 20,000;8;0;8;0;0;0
1301850;Meditation VR;;20,000 - 50,000;54;17;37;0;0;1
1301860;Farlight Commanders;;0 - 20,000;13;2;11;0;0;0
1301930;Traffic Jams;;0 - 20,000;56;15;41;84;84;2
1301950;Time Loader;;0 - 20,000;233;38;195;254;254;0
1301990;Electro Ride Prologue;;20,000 - 50,000;120;54;66;0;0;0
1302000;Infectious;;0 - 20,000;20;14;6;0;0;0
1302050;Milky Way Prince – The Vampire Star;;0 - 20,000;243;53;190;38;38;2
1302090;The Zone;;0 - 20,000;6;3;3;0;0;0
1302110;Inertial Drift: Sunset Prologue;;100,000 - 200,000;388;71;317;11;15;2
1302160;Ultimate Wall Defense Force;;0 - 20,000;6;2;4;0;0;0
1302180;Racing Juke;;0 - 20,000;21;8;13;0;0;0
1302220;The prisoner of the Night;;0 - 20,000;21;1;20;0;0;0
1302230;Dead Containment;;0 - 20,000;20;2;18;0;0;2
1302240;Labyrinthine;;500,000 - 1,000,000;7751;1111;6640;334;255;262
1302270;F29 Retaliator;;0 - 20,000;8;0;8;0;0;0
1302290;Elkabo: Selina's Dark Spirit;;0 - 20,000;1;2;-1;0;0;0
1302290;Elkabo: Selina's Dark Spirit;;0 - 20,000;1;2;-1;0;0;0
1302400;Breakout Planet;;0 - 20,000;1;0;1;0;0;0
1302430;Close Encounter VR;;0 - 20,000;16;12;4;0;0;0
1302440;RogueJack: Roguelike Blackjack;;0 - 20,000;35;8;27;0;0;1
1302470;Saiku's Endless Labyrinth;;0 - 20,000;1;0;1;0;0;0
1302480;Slurkum;;0 - 20,000;1;4;-3;0;0;0
1302510;Vaporwave Road VR;;0 - 20,000;1;2;-1;0;0;0
1302550;Tanklike;;0 - 20,000;10;1;9;0;0;0
1302570;Vampirem;;0 - 20,000;63;8;55;0;0;0
1302590;Swords and Sandals Crusader Redux;;0 - 20,000;76;29;47;45;45;1
1302700;Realm of the hero;;0 - 20,000;0;1;-1;0;0;0
1302730;Nebula Within;;0 - 20,000;29;1;28;0;0;0
1302750;大明王朝1789 | Ming dynasty 1789;;0 - 20,000;245;263;-18;0;0;2
1302780;Zombo Buster Advance;;0 - 20,000;139;23;116;437;437;0
1302800;Chair F*cking Simulator;;0 - 20,000;553;33;520;0;0;2
1302840;Kooring VR Coding Adventure;;0 - 20,000;7;0;7;0;0;0
1302860;Assembly Planter;;0 - 20,000;152;18;134;0;0;4
1302930;Cricket Captain 2020;;0 - 20,000;63;32;31;0;0;6
1302990;MARDEK;;0 - 20,000;206;2;204;0;0;9
1303000;Proxy Air Force;;0 - 20,000;1;7;-6;0;0;0
1303010;Vincemus - Air Combat;;0 - 20,000;33;7;26;0;0;1
1303050;Ruggnar;;0 - 20,000;9;2;7;0;0;1
1303140;Escape Game Fort Boyard;;0 - 20,000;15;1;14;0;0;0
1303140;Escape Game Fort Boyard;;0 - 20,000;15;1;14;0;0;0
1303160;Dig Bombers;;20,000 - 50,000;3;2;1;0;0;0
1303170;MelDEV Power Boat Racing;;0 - 20,000;2;1;1;0;0;0
1303210;Small Ball;;50,000 - 100,000;1;0;1;0;0;0
1303260;Drift Racing Rally;;0 - 20,000;10;5;5;0;0;0
1303270;Ungeon;;50,000 - 100,000;1;0;1;0;0;0
1303280;Dirt Bike Motocross Stunts;;0 - 20,000;19;3;16;0;0;0
1303350;Rocky Mayhem;;0 - 20,000;6;2;4;0;0;0
1303370;A Lot of Universes;;0 - 20,000;6;1;5;0;0;0
1303420;CAMEO: CCTV Detective;;0 - 20,000;3;0;3;0;0;0
1303440;Noise Hunters;;20,000 - 50,000;73;25;48;0;0;0
1303480;Radio Viscera;;0 - 20,000;20;5;15;0;0;0
1303590;Dura Vita Online;;0 - 20,000;20;11;9;0;0;0
1303630;Rachael Savage;;0 - 20,000;1;0;1;0;0;0
1303640;Parabolus Two;;0 - 20,000;1;1;0;0;0;0
1303660;Geometric Sniper;;50,000 - 100,000;284;63;221;0;0;0
1303670;World of Art - learn with Jigsaw Puzzles;;0 - 20,000;49;2;47;0;0;1
1303680;Alien Egg: Ascent;;0 - 20,000;3;1;2;0;0;0
1303740;Love n Dream;;20,000 - 50,000;260;70;190;73;98;1
1303760;Knife Quest;;0 - 20,000;2;2;0;0;0;0
1303790;Beware of the Blob;;0 - 20,000;2;0;2;0;0;0
1303820;Aim Master H;;0 - 20,000;9;11;-2;0;0;0
1303870;Mischance;;0 - 20,000;10;3;7;0;0;0
1303930;SkunkHunter 101;;0 - 20,000;2;0;2;0;0;0
1303950;Toodee and Topdee;;0 - 20,000;497;23;474;6;6;7
1303990;Mini Motor Racing X;;0 - 20,000;221;34;187;24;24;2
1304070;Extra Terrestrial Nation;;0 - 20,000;2;3;-1;0;0;0
1304090;Cannibal Crossing;;0 - 20,000;147;71;76;0;0;2
1304100;The Adventures of Fatman: Intergalactic Indigestion;;20,000 - 50,000;1;8;-7;0;0;0
1304120;Color Game;;0 - 20,000;2;0;2;0;0;0
1304130;ReRoad;;0 - 20,000;85;18;67;0;0;0
1304160;Spellbearers;;0 - 20,000;5;1;4;0;0;1
1304170;Drifter King Online;;0 - 20,000;20;1;19;0;0;0
1304220;The End of Labyronia: Nerubis;;0 - 20,000;4;1;3;0;0;0
1304290;Call of Corona: Micro Warfare;;0 - 20,000;14;0;14;0;0;0
1304300;Fantasy Mosaics 34: Zen Garden;;0 - 20,000;1;1;0;0;0;0
1304310;Ace of Space;;0 - 20,000;3;0;3;0;0;0
1304320;重装无限·Metal Infinite;;0 - 20,000;30;9;21;0;0;1
1304340;Monster Energy Supercross - The Official Videogame 4;;20,000 - 50,000;366;207;159;1818;1818;23
1304350;Urge;;0 - 20,000;42;5;37;0;0;5
1304360;Dumb Roguelike-like RPG;;0 - 20,000;2;0;2;0;0;0
1304390;Covid Tale: Ignorance;;0 - 20,000;117;18;99;0;0;0
1304400;The End of Dyeus;;500,000 - 1,000,000;84;6;78;0;0;0
1304420;Super Cable Boy;;0 - 20,000;80;1;79;0;0;0
1304450;Die Again;;100,000 - 200,000;120;19;101;0;0;0
1304470;降妖神兵;;0 - 20,000;45;17;28;0;0;0
1304520;Phogbound;;0 - 20,000;4;1;3;0;0;0
1304550;Progressbar95;;20,000 - 50,000;1412;67;1345;96;149;25
1304620;The Insider – interactive movie;;0 - 20,000;18;29;-11;0;0;0
1304640;Related;;0 - 20,000;126;16;110;0;0;0
1304660;Vagrus - The Riven Realms: Prologue;;20,000 - 50,000;111;44;67;0;0;0
1304680;Voidigo;;50,000 - 100,000;1736;44;1692;183;269;18
1304690;Push Your Family;;0 - 20,000;10;6;4;0;0;0
1304780;Nongunz: Doppelganger Edition;;0 - 20,000;75;32;43;0;0;1
1304790;罗马之链;;50,000 - 100,000;3;1;2;0;0;0
1304800;FOREST OF THE DEAD;;0 - 20,000;2;2;0;0;0;0
1304810;HANI;;0 - 20,000;19;2;17;0;0;1
1304870;Motel Murder;;0 - 20,000;2;2;0;0;0;0
1304910;My Hidden Things;;0 - 20,000;43;7;36;0;0;0
1305000;Kingdom Karnage;;0 - 20,000;20;9;11;0;0;2
1305050;Lightless;;50,000 - 100,000;128;27;101;0;0;0
1305060;Virus Blast;;0 - 20,000;18;1;17;0;0;0
1305120;The Lost Legends of Redwall: The Scout Act 2;;0 - 20,000;13;0;13;0;0;0
1305130;The Lost Legends of Redwall: The Scout Act 3;;50,000 - 100,000;12;0;12;0;0;4
1305190;Aria: Dragon Eater;;0 - 20,000;1;0;1;0;0;0
1305220;Zomcade;;0 - 20,000;4;3;1;0;0;0
1305250;Grand Theft Rome;;0 - 20,000;2;0;2;0;0;0
1305300;Love Love School Days;;20,000 - 50,000;192;8;184;0;0;66
1305310;Drox Operative 2;;0 - 20,000;193;23;170;0;0;7
1305310;Drox Operative 2;;0 - 20,000;193;23;170;0;0;7
1305320;Belongings;;0 - 20,000;3;1;2;0;0;0
1305350;C-4;;0 - 20,000;44;3;41;0;0;0
1305370;Pandemia: Virus Outbreak;;0 - 20,000;5;1;4;0;0;0
1305380;VR Fitness Gym (Cycling, Marathon, Football, etc);;0 - 20,000;11;6;5;0;0;0
1305390;Gel-Tank;;0 - 20,000;15;2;13;0;0;0
1305420;Agrou;;200,000 - 500,000;2106;242;1864;237;327;41
1305440;Death Tales;;0 - 20,000;37;11;26;0;0;0
1305450;16bit vs Reality;;0 - 20,000;18;2;16;0;0;0
1305490;Up until the end - Otome/Visual Novel;;0 - 20,000;15;0;15;0;0;0
1305500;Captain Disaster in: The Dark Side of the Moon;;100,000 - 200,000;9;2;7;0;0;0
1305540;Rusty Gun;;0 - 20,000;27;8;19;0;0;0
1305570;BRAVE PINBALL;;0 - 20,000;11;9;2;0;0;0
1305570;BRAVE PINBALL;;0 - 20,000;11;9;2;0;0;0
1305590;Wibbly Witches;;0 - 20,000;19;0;19;0;0;0
1305610;Cosmodome;;20,000 - 50,000;3;0;3;0;0;0
1305640;Beyond Hope;;0 - 20,000;5;0;5;0;0;0
1305660;Remedy;;0 - 20,000;7;1;6;0;0;0
1305690;アルティメットダンジョン「紅」;;0 - 20,000;13;2;11;0;0;0
1305720;Delores: A Thimbleweed Park Mini-Adventure;;50,000 - 100,000;479;63;416;1;1;3
1305730;Way To Yaatra;;20,000 - 50,000;128;8;120;0;0;0
1305820;Lunar Axe;;0 - 20,000;78;8;70;0;0;6
1305940;Ambush: Convoy Strike;;0 - 20,000;10;2;8;0;0;0
1305960;武林桃源乡 The Arcadia Of Wulin;;0 - 20,000;12;9;3;0;0;0
1305970;不二臣The Only  Master;;0 - 20,000;3;3;0;0;0;0
1306020;The Hostage;;0 - 20,000;2;2;0;0;0;0
1306100;Ezaron Defense Alpha;;20,000 - 50,000;68;37;31;0;0;0
1306110;Angkor: Celebrations - Match 3 Puzzle;;0 - 20,000;2;4;-2;0;0;2
1306160;Get Over Blood;;0 - 20,000;1;15;-14;0;0;0
1306180;Retrocycles;;0 - 20,000;115;7;108;0;0;0
1306210;Boston AInamics;;0 - 20,000;5;8;-3;0;0;0
1306240;Freelance Trucker: Insurance Fraud Edition;;0 - 20,000;1;0;1;0;0;0
1306570;Fadeout: Underground;;100,000 - 200,000;156;29;127;0;0;2
1306580;Left on Read;;200,000 - 500,000;4075;963;3112;0;0;4
1306620;[Chilla's Art] Missing Children | 行方不明;;20,000 - 50,000;302;47;255;0;0;3
1306630;Lost Ruins;;100,000 - 200,000;3329;385;2944;544;544;27
1306720;Mayhem Brawler;;0 - 20,000;351;40;311;0;0;1
1306750;黑色花与红山羊 / Black Datura & Red Goat;;20,000 - 50,000;409;17;392;0;0;4
1306760;Time Agent;;0 - 20,000;11;3;8;0;0;0
1306840;Ancient World War;;20,000 - 50,000;10;8;2;0;0;0
1306860;Cemetery War;;0 - 20,000;6;11;-5;0;0;0
1306900;BadBee;;0 - 20,000;12;1;11;0;0;0
1306910;DICHOTOMY;;0 - 20,000;1;0;1;0;0;0
1306990;Wanderlust: Bangkok Prelude;;0 - 20,000;18;0;18;0;0;0
1307070;Vetrix;;0 - 20,000;41;0;41;0;0;0
1307090;Barro Racing;;50,000 - 100,000;369;80;289;121;192;1
1307200;Sue's Story;;0 - 20,000;10;4;6;0;0;0
1307220;DodgeBall VR;;0 - 20,000;0;1;-1;0;0;0
1307240;Call of Coronga;;0 - 20,000;35;13;22;0;0;0
1307250;BorderCollie Game;;0 - 20,000;15;6;9;0;0;0
1307270;Demon Keeper 2+;;0 - 20,000;28;4;24;0;0;1
1307310;ArrowBall;;0 - 20,000;3;0;3;0;0;0
1307370;Rain City;;50,000 - 100,000;53;30;23;0;0;2
1307380;ISOLAND: The Amusement Park;;20,000 - 50,000;41;2;39;0;0;0
1307390;飞仙决;;0 - 20,000;0;6;-6;0;0;0
1307450;THE KNIGHT OF QUEEN;;0 - 20,000;13;1;12;0;0;0
1307460;Indoor Sniper Shooting Alpha Strike in Corona Virus Lockdown;;0 - 20,000;8;4;4;0;0;0
1307480;Street Sniper;;0 - 20,000;14;14;0;0;0;0
1307490;Not My President - Level 1;;0 - 20,000;5;2;3;0;0;0
1307530;Infection Maze / 感染メイズ;;0 - 20,000;24;4;20;0;0;0
1307550;Craftopia;;500,000 - 1,000,000;13220;3184;10036;951;368;559
1307580;TOEM;;50,000 - 100,000;3100;22;3078;372;376;28
1307640;Choco Pixel 5;;0 - 20,000;6;2;4;0;0;0
1307670;The Unexpected Quest;;0 - 20,000;126;29;97;0;0;4
1307690;The Darkest Tales;;0 - 20,000;234;97;137;0;0;8
1307710;GRID Legends;;0 - 20,000;1075;388;687;331;331;131
1307730;Rogue Robots;;0 - 20,000;5;2;3;0;0;0
1307760;Fisherman Classic;;0 - 20,000;9;6;3;0;0;0
1307780;Kinda Heroes: The cutest RPG ever!;;0 - 20,000;51;23;28;0;0;0
1307810;Cybxus Heart;;0 - 20,000;2;1;1;0;0;0
1307850;Simple Machines;;0 - 20,000;20;1;19;0;0;0
1307860;Queerskins: a love story;;0 - 20,000;0;2;-2;0;0;0
1307870;Sensorium;;0 - 20,000;129;9;120;0;0;1
1307880;Hanoi Puzzles: Solid Match;;0 - 20,000;44;0;44;0;0;0
1307890;Kingdoms Reborn;;200,000 - 500,000;4657;473;4184;804;800;592
1307900;Dark Sales;;0 - 20,000;11;3;8;0;0;0
1307920;Rift Runner;;0 - 20,000;12;4;8;0;0;0
1308040;Agence;;0 - 20,000;13;9;4;0;0;0
1308060;Craft city;;0 - 20,000;4;10;-6;0;0;0
1308140;Drive & Drift;;0 - 20,000;3;5;-2;0;0;0
1308150;Orb Overload;;0 - 20,000;4;0;4;0;0;0
1308170;Possession 1881;;0 - 20,000;13;3;10;0;0;0
1308220;Orbals;;0 - 20,000;0;1;-1;0;0;0
1308240;Out of Shapes;;0 - 20,000;15;2;13;0;0;0
1308250;Knight Bewitched 2;;0 - 20,000;20;0;20;0;0;0
1308270;In-Home Streaming;;0 - 20,000;1;2;-1;0;0;0
1308280;Empire of the Wicked;;0 - 20,000;5;2;3;0;0;0
1308350;Deer Hunter xTreme Focal Plane;;0 - 20,000;6;6;0;0;0;0
1308410;Rolling Cube;;0 - 20,000;7;0;7;0;0;0
1308450;Halloween Horrors Deluxe Steam Edition;;0 - 20,000;0;1;-1;0;0;0
1308470;Journey to the Centre of the Cell;;0 - 20,000;8;3;5;0;0;0
1308470;Journey to the Centre of the Cell;;0 - 20,000;8;3;5;0;0;0
1308500;Soul Elegy;;0 - 20,000;156;85;71;0;0;1
1308510;Kalidazkoph;;0 - 20,000;4;3;1;0;0;0
1308550;Speedrun;;0 - 20,000;28;12;16;0;0;0
1308550;Speedrun;;0 - 20,000;28;12;16;0;0;0
1308560;The Legend of HyperStar;;0 - 20,000;12;22;-10;0;0;0
1308570;Costa's Classic Cosmic Pizzas;;0 - 20,000;5;0;5;0;0;0
1308650;Axegend：Episode I;;0 - 20,000;13;3;10;0;0;0
1308660;Gun Master;;20,000 - 50,000;5;9;-4;0;0;0
1308700;Wizardry: The Five Ordeals;;50,000 - 100,000;266;46;220;0;0;24
1308760;Mesmer;;0 - 20,000;20;8;12;0;0;0
1308770;West Legends;;0 - 20,000;5;3;2;0;0;0
1308780;The Medic;;0 - 20,000;2;1;1;0;0;0
1308790;鲸走：前篇 Whale Left Part 1;;0 - 20,000;7;1;6;0;0;0
1308800;时间卡牌  TimelineCard;;0 - 20,000;2;1;1;0;0;0
1308840;Consternation II;;0 - 20,000;54;7;47;0;0;1
1308870;Cyber Ops Prologue;;0 - 20,000;27;12;15;1;1;0
1308880;FORECLOSED;;20,000 - 50,000;52;31;21;0;0;0
1308920;Nightmare Simulator 2 Rebirth;;0 - 20,000;1;2;-1;0;0;0
1308950;Bhop PRO;;0 - 20,000;34;143;-109;0;0;0
1308980;Dungeon Throne;;0 - 20,000;8;1;7;0;0;0
1309090;Barold;;0 - 20,000;25;0;25;0;0;0
1309130;Lucky and a life worth living - a jigsaw puzzle tale;;0 - 20,000;76;5;71;0;0;1
1309140;Space Battle;;0 - 20,000;7;6;1;0;0;0
1309170;Way of Heroes;;0 - 20,000;1;0;1;0;0;0
1309200;3D Math - Ultra;;0 - 20,000;144;11;133;0;0;0
1309280;Corners;;0 - 20,000;12;1;11;0;0;0
1309290;Shadow of Valhalla;;0 - 20,000;28;7;21;0;0;0
1309350;The Hilltop Mansion;;0 - 20,000;6;3;3;0;0;0
1309430;Dungeon of Trials;;0 - 20,000;9;2;7;0;0;0
1309440;Sweet House Love;;0 - 20,000;12;12;0;0;0;0
1309490;团长别生气;;0 - 20,000;73;32;41;0;0;0
1309500;Road To Death;;0 - 20,000;1;3;-2;0;0;0
1309550;Far Eastern Federal University Virtual Expo;;20,000 - 50,000;6;1;5;0;0;0
1309610;Line War;;20,000 - 50,000;430;106;324;0;0;27
1309700;Devil's dream;;0 - 20,000;5;6;-1;0;0;0
1309730;Infinity Imperium;;0 - 20,000;0;1;-1;0;0;0
1309780;MODERN NAVAL COMBAT;;0 - 20,000;42;16;26;0;0;0
1309820;Remains;;50,000 - 100,000;178;44;134;287;287;10
1309830;City Eye: Prologue;;0 - 20,000;40;28;12;0;0;0
1309850;Into the TIMEVERSE;;20,000 - 50,000;7;1;6;0;0;0
1309860;Family Mysteries 3: Criminal Mindset;;0 - 20,000;74;21;53;0;0;0
1309870;Decently Bad Tower Defense;;20,000 - 50,000;92;31;61;0;0;0
1309890;logiCally;;0 - 20,000;5;6;-1;0;0;0
1309910;Vacation Adventures: Park Ranger 10;;0 - 20,000;3;0;3;0;0;1
1309940;Lorera;;0 - 20,000;19;4;15;0;0;0
1309980;Space Probes;;0 - 20,000;12;1;11;0;0;0
1310050;Video Editor Tycoon;;0 - 20,000;13;3;10;0;0;0
1310080;Finding Fido: The Journey;;0 - 20,000;5;5;0;0;0;0
1310120;Elliot;;0 - 20,000;34;1;33;0;0;0
1310150;Uranus;;0 - 20,000;0;5;-5;0;0;0
1310210;OMICRON: Coronavirus Battlegrounds;;0 - 20,000;44;11;33;0;0;0
1310230;Cyber Seraph;;0 - 20,000;9;1;8;0;0;0
1310270;Chromalition;;0 - 20,000;12;3;9;0;0;0
1310470;Tankfight;;0 - 20,000;4;7;-3;0;0;0
1310480;Jumperbird;;0 - 20,000;4;24;-20;0;0;0
1310510;Handy Harry's Haunted House Services;;20,000 - 50,000;515;65;450;80;103;0
1310520;Occupy Mars: Prologue;;100,000 - 200,000;1121;286;835;0;0;14
1310590;Tank Battle;;20,000 - 50,000;94;34;60;0;0;3
1310620;The Sight in a mirror;;0 - 20,000;1;0;1;0;0;0
1310650;Hedera;;0 - 20,000;12;2;10;0;0;0
1310690;disc party;;0 - 20,000;15;1;14;0;0;0
1310770;Valiantia;;20,000 - 50,000;1;1;0;0;0;0
1310770;Valiantia;;20,000 - 50,000;1;1;0;0;0;0
1310790;The Adventures of Eggbert;;0 - 20,000;16;4;12;0;0;0
1310840;动绘（Drawing）;;0 - 20,000;1;0;1;0;0;0
1310860;Image To Normal Map;;0 - 20,000;0;2;-2;0;0;0
1310950;DRazor;;0 - 20,000;2;1;1;0;0;0
1310970;RussianPunk 2007;;0 - 20,000;124;30;94;0;0;0
1310990;Bishojo Mangekyo Kotowari to Meikyu no Shojo;;500,000 - 1,000,000;2356;92;2264;4;4;17
1311070;Greak: Memories of Azur;;50,000 - 100,000;730;192;538;755;1347;6
1311140;Slime Climb;;0 - 20,000;3;1;2;0;0;0
1311150;Long Car Journey - A road trip game;;0 - 20,000;7;13;-6;0;0;0
1311160;Apollon 88;;0 - 20,000;47;9;38;0;0;0
1311210;Virus Madness - Dungeons of your Body;;0 - 20,000;1;1;0;0;0;0
1311220;Johann Weiss;;0 - 20,000;14;8;6;0;0;0
1311220;Johann Weiss;;0 - 20,000;14;8;6;0;0;0
1311250;Don't Be Afraid - The First Toy;;100,000 - 200,000;677;66;611;0;0;2
1311320;Their Radiance;;20,000 - 50,000;17;5;12;0;0;0
1311330;Pro Basketball Manager 2021;;0 - 20,000;60;62;-2;0;0;2
1311330;Pro Basketball Manager 2021;;0 - 20,000;60;62;-2;0;0;2
1311400;Arena Experiment;;0 - 20,000;1;0;1;0;0;0
1311440;看白海豚的好日子 A Perfect Day for White Dolphin;;0 - 20,000;11;1;10;0;0;0
1311460;Lost Alone;;0 - 20,000;4;3;1;0;0;0
1311510;Embracelet;;0 - 20,000;82;4;78;0;0;0
1311540;The Wake: Mourning Father, Mourning Mother;;0 - 20,000;150;27;123;137;137;0
1311570;Desecrators;;0 - 20,000;29;0;29;0;0;3
1311610;The Hunter's Journals - Red Ripper;;0 - 20,000;3;0;3;0;0;0
1311640;Swarm;;20,000 - 50,000;223;16;207;0;0;0
1311650;Helwyr;;0 - 20,000;3;2;1;0;0;0
1311660;Friendly Fire;;100,000 - 200,000;907;52;855;0;0;1
1311670;The Forsaken Ruins;;0 - 20,000;4;0;4;0;0;0
1311690;Bubble Tea : game for thinking and imagination;;0 - 20,000;11;6;5;0;0;0
1311700;汉武大帝传;;0 - 20,000;76;35;41;0;0;4
1311710;Somber;;0 - 20,000;11;1;10;0;0;0
1311710;Somber;;0 - 20,000;11;1;10;0;0;0
1311740;Boreal Tenebrae Act I: “I Stand Before You,  A Form Undone”;;0 - 20,000;35;7;28;0;0;0
1311770;Zoo World VR;;0 - 20,000;4;6;-2;0;0;0
1311830;Music Ball;;0 - 20,000;3;3;0;0;0;0
1311930;Robot Invasion;;0 - 20,000;0;11;-11;0;0;0
1311960;Couple in Trouble;;0 - 20,000;12;0;12;0;0;0
1311990;Little Terror;;0 - 20,000;10;9;1;0;0;0
1312000;Wrap It!;;0 - 20,000;4;0;4;0;0;0
1312050;Return to Sector 9;;0 - 20,000;13;6;7;0;0;0
1312060;Zero-G Gunfight;;0 - 20,000;1;0;1;0;0;0
1312070;Pink Island;;0 - 20,000;13;3;10;0;0;0
1312150;Charlie | The Legend;;0 - 20,000;43;55;-12;0;0;1
1312160;Astro Dash;;50,000 - 100,000;3;0;3;0;0;0
1312190;Cruel Galaxy: Discordia;;0 - 20,000;5;2;3;0;0;0
1312240;Rubikingdom;;0 - 20,000;1;0;1;0;0;0
1312250;ODIA;;0 - 20,000;26;14;12;0;0;0
1312310;Golden Moon;;0 - 20,000;17;6;11;0;0;0
1312310;Golden Moon;;0 - 20,000;17;6;11;0;0;0
1312420;The United SPACE of America;;0 - 20,000;2;0;2;0;0;0
1312470;Hyde and Zeke;;0 - 20,000;2;0;2;0;0;0
1312510;Spooky Spins Deluxe Steam Edition;;0 - 20,000;0;2;-2;0;0;0
1312540;OMG: One Million Guns;;20,000 - 50,000;7;2;5;0;0;0
1312570;ハンターハーツ Hunter Hearts;;0 - 20,000;4;2;2;0;0;0
1312740;Schlag den Star - Das 2. Spiel;;0 - 20,000;1;9;-8;0;0;1
1312760;Dreams Keeper Solitaire;;0 - 20,000;3;2;1;0;0;1
1312960;Epic Chef;;0 - 20,000;386;99;287;48;48;12
1312960;Epic Chef;;0 - 20,000;386;99;287;48;48;12
1313050;Cute Lady;;0 - 20,000;76;10;66;0;0;0
1313120;Cannonship;;0 - 20,000;7;1;6;0;0;0
1313140;Cult of the Lamb;;1,000,000 - 2,000,000;42345;2746;39599;948;888;982
1313150;Enchantress;;0 - 20,000;1;3;-2;0;0;0
1313200;Explode On Contact;;0 - 20,000;2;0;2;0;0;0
1313310;Election Year Knockout;;0 - 20,000;54;9;45;0;0;0
1313330;HEDE Game Engine;;0 - 20,000;0;7;-7;0;0;1
1313340;Epocria;;0 - 20,000;11;3;8;0;0;0
1313350;Living Legends Remastered: Ice Rose Collector's Edition;;0 - 20,000;6;1;5;0;0;1
1313360;Underfire;;0 - 20,000;10;17;-7;0;0;0
1313400;Einsteins Riddle;;0 - 20,000;2;2;0;0;0;1
1313470;Really Trash Game;;0 - 20,000;22;6;16;0;0;0
1313490;Slimes;;0 - 20,000;28;1;27;0;0;0
1313530;FM;;0 - 20,000;42;16;26;0;0;0
1313560;Design girl team;;0 - 20,000;26;15;11;0;0;0
1313580;CryptoClickers: Crypto Idle Game;;20,000 - 50,000;111;60;51;0;0;4
1313640;The Lost Marble;;0 - 20,000;11;0;11;0;0;0
1313700;COVID Kawaii!;;0 - 20,000;24;2;22;0;0;0
1313810;Her Lie I Tried To Believe - Extended Edition;;0 - 20,000;40;0;40;0;0;0
1313860;EA SPORTS FIFA 21;;1,000,000 - 2,000,000;43559;13621;29938;12846;8525;1032
1313870;Orc's Civil War;;0 - 20,000;3;1;2;0;0;0
1313880;Test Tube Titans: Taster Trial;;0 - 20,000;6;5;1;0;0;0
1313940;My Holiday 2;;0 - 20,000;93;4;89;0;0;0
1313970;PlanetariumVR;;0 - 20,000;4;2;2;0;0;0
1314000;Achilles: Legends Untold;;0 - 20,000;312;120;192;0;0;5
1314010;深入敵境 Behind Enemy Line;;0 - 20,000;0;1;-1;0;0;0
1314090;City Sniper;;0 - 20,000;2;3;-1;0;0;0
1314140;TramSim Vienna - The Tram Simulator;;50,000 - 100,000;1265;329;936;152;152;39
1314160;Rover Mechanic Simulator: Training Day;;20,000 - 50,000;63;23;40;0;0;0
1314170;dungeon & heros;;0 - 20,000;35;13;22;0;0;0
1314270;Adventure mosaics. Small Islanders;;0 - 20,000;3;0;3;0;0;2
1314300;Flying Hero VR;;0 - 20,000;64;12;52;0;0;0
1314410;Rugby Union Team Manager 3;;0 - 20,000;43;19;24;0;0;4
1314460;Flicker of Hope;;50,000 - 100,000;788;52;736;0;0;1
1314480;Don Flatus: Poop Hunter;;0 - 20,000;64;10;54;0;0;0
1314500;Improbable Soccer;;0 - 20,000;4;0;4;0;0;0
1314540;Feylin;;0 - 20,000;3;7;-4;0;0;0
1314590;X-Fitness;;0 - 20,000;79;16;63;0;0;1
1314600;The Rogue Cavern;;0 - 20,000;1;1;0;0;0;0
1314620;Coronavirus Quarantine Simulator;;0 - 20,000;22;7;15;0;0;0
1314680;Defensive Attacks;;0 - 20,000;7;2;5;0;0;1
1314730;Addle Earth;;0 - 20,000;5;2;3;0;0;0
1314770;Three Kingdom: The Journey;;0 - 20,000;41;9;32;0;0;3
1314820;RealFlight Trainer Edition;;0 - 20,000;78;18;60;0;0;21
1314830;Finding Kathy;;0 - 20,000;5;2;3;0;0;0
1314840;encrypt.;;0 - 20,000;21;1;20;0;0;0
1314870;KITT.IO;;0 - 20,000;20;2;18;0;0;0
1314880;Shoo, Box!;;0 - 20,000;20;2;18;0;0;0
1314930;Speed Swing;;0 - 20,000;38;10;28;0;0;0
1314980;Mealmates;;0 - 20,000;18;1;17;0;0;0
1315040;My UnReal Pet;;0 - 20,000;1;0;1;0;0;0
1315070;Vaccine19;;50,000 - 100,000;50;14;36;0;0;0
1315100;Jumping Jax;;20,000 - 50,000;30;2;28;0;0;0
1315120;Field Hospital: Dr. Taylor's Story;;0 - 20,000;39;8;31;0;0;0
1315160;鸢之歌-Singing Iris;;20,000 - 50,000;388;46;342;2;2;2
1315200;Kingdom Under Fire: Heroes;;20,000 - 50,000;267;77;190;0;0;9
1315210;Ikai;;20,000 - 50,000;157;37;120;0;0;0
1315220;Memory Illusions;;0 - 20,000;3;1;2;0;0;0
1315250;Escape from the Cosmic Abyss;;50,000 - 100,000;8;1;7;0;0;0
1315270;PEE WAR！;;0 - 20,000;66;4;62;0;0;1
1315360;Crazy Jump;;0 - 20,000;16;3;13;0;0;0
1315370;Way Far Home;;0 - 20,000;1;2;-1;0;0;0
1315390;Verse Surf;;0 - 20,000;37;13;24;0;0;0
1315410;Mini Maker: Make A Thing;;0 - 20,000;30;2;28;0;0;1
1315610;Source of Madness;;0 - 20,000;505;119;386;0;0;12
1315620;EndlessShinyBlues;;0 - 20,000;11;4;7;0;0;0
1315630;RUN OR FIGHT;;0 - 20,000;20;3;17;0;0;1
1315640;Actor Tycoon 2;;0 - 20,000;5;9;-4;0;0;0
1315650;Auto Kitchen;;0 - 20,000;12;6;6;0;0;0
1315660;Sausage Fest;;0 - 20,000;18;3;15;0;0;0
1315670;Asteroids 44 (For Four);;20,000 - 50,000;10;1;9;0;0;0
1315710;Move 'n' Bloom;;0 - 20,000;15;0;15;0;0;0
1315810;UNITED COMMAND ;;20,000 - 50,000;5;3;2;0;0;0
1315810;UNITED COMMAND ;;20,000 - 50,000;5;3;2;0;0;0
1315890;Big City Rigs: Garbage Truck Driver;;0 - 20,000;2;2;0;0;0;0
1315900;3d Maze In Space;;20,000 - 50,000;3;1;2;0;0;0
1315910;Bop'N Wrestle;;0 - 20,000;2;0;2;0;0;0
1315920;The Train: Escape to Normandy;;0 - 20,000;1;0;1;0;0;0
1315980;Tin Can;;20,000 - 50,000;647;83;564;28;28;4
1316000;Honor and Duty: D-Day;;0 - 20,000;7;7;0;0;0;0
1316050;Rainy City: Pandemic;;0 - 20,000;21;4;17;0;0;0
1316050;Rainy City: Pandemic;;0 - 20,000;21;4;17;0;0;0
1316060;Smelted Kin;;0 - 20,000;3;4;-1;0;0;0
1316130;The Village Story;;0 - 20,000;3;1;2;0;0;0
1316160;M.E.A.T. RPG;;0 - 20,000;147;34;113;817;817;0
1316200;House Sitter;;0 - 20,000;32;1;31;0;0;0
1316230;Force of Nature 2: Ghost Keeper;;100,000 - 200,000;1339;277;1062;705;1210;71
1316280;Tekling 2: Overdrive;;0 - 20,000;6;0;6;0;0;0
1316290;We Die;;0 - 20,000;8;0;8;0;0;0
1316310;WAVE RIDER;;0 - 20,000;16;1;15;0;0;0
1316390;Thermo Sudoku;;0 - 20,000;135;5;130;0;0;6
1316460;Bounty;;0 - 20,000;7;0;7;0;0;0
1316520;Flain - Tao force & Cubes;;0 - 20,000;5;3;2;0;0;0
1316530;Buster's Tower Defense;;20,000 - 50,000;31;0;31;0;0;0
1316560;Otaku's Rage: Waifu Strikes Back;;0 - 20,000;133;38;95;64;64;1
1316570;Operation Covid-19;;20,000 - 50,000;21;9;12;0;0;0
1316610;Covid-19 - Corona Clicker;;0 - 20,000;2;22;-20;0;0;0
1316640;Ironsmith Medieval Simulator: Prologue;;20,000 - 50,000;75;21;54;0;0;0
1316700;Escape from Kyoto House;;0 - 20,000;136;10;126;0;0;0
1316740;Extreme Escape;;0 - 20,000;56;7;49;0;0;1
1316770;Sol 705;;0 - 20,000;18;5;13;0;0;0
1316770;Sol 705;;0 - 20,000;18;5;13;0;0;0
1316800;Destropolis;;0 - 20,000;139;19;120;27;27;2
1316830;Simply Puzzles: Codewords;;0 - 20,000;15;3;12;0;0;0
1316870;Primordials: Battle of Gods;;0 - 20,000;32;40;-8;0;0;0
1316910;Super Monkey Ball Banana Mania;;50,000 - 100,000;978;143;835;621;621;11
1316950;VE FPSO TOUR in VR;;0 - 20,000;4;3;1;0;0;0
1317070;Shape Shooter;;0 - 20,000;4;0;4;0;0;0
1317120;Yuri Ogibalov's Bizarre Adventure;;20,000 - 50,000;8;0;8;0;0;0
1317310;The Machine's Garden;;0 - 20,000;13;1;12;0;0;0
1317500;Lucidscape;;0 - 20,000;24;11;13;0;0;1
1317800;Big City Rigs: Bus Driver;;0 - 20,000;2;2;0;0;0;0
1317850;Martian Potato;;0 - 20,000;5;3;2;0;0;0
1317950;Eternal Dreamers;;100,000 - 200,000;67;10;57;0;0;0
1318000;HTD;;0 - 20,000;6;0;6;0;0;0
1318030;Fractal Alchemist;;0 - 20,000;23;3;20;0;0;1
1318110;Party Mashup;;0 - 20,000;5;1;4;0;0;0
1318130;Robin Hood: Winds of Freedom;;0 - 20,000;17;2;15;0;0;0
1318170;PhotoStage;;0 - 20,000;1;0;1;0;0;0
1318210;Dancing Angel;;0 - 20,000;11;7;4;0;0;0
1318240;Shields of Loyalty;;0 - 20,000;43;3;40;0;0;3
1318280;OverShoot Battle Race;;0 - 20,000;19;1;18;0;0;0
1318420;Summer in Mara Prologue;;50,000 - 100,000;919;135;784;0;0;2
1318520;Dört Model Müzesi;;20,000 - 50,000;5;2;3;0;0;0
1318530;My Mud Game;;0 - 20,000;6;0;6;0;0;0
1318550;Ardein.Fall;;0 - 20,000;17;3;14;0;0;0
1318560;Husbandry;;0 - 20,000;89;21;68;0;0;1
1318690;shapez;;200,000 - 500,000;8803;286;8517;443;275;313
1318730;Axiom Alternative;;0 - 20,000;4;3;1;0;0;0
1318740;Farlanders;;20,000 - 50,000;264;15;249;52;52;39
1318750;18 Wheels of Steel: Hard Truck;;0 - 20,000;23;2;21;0;0;1
1318790;BROK the InvestiGator - Prologue;;50,000 - 100,000;271;7;264;0;0;0
1318800;ESC;;0 - 20,000;72;2;70;0;0;1
1318840;Outlast : Journey of a Gladiator;;0 - 20,000;1;0;1;0;0;0
1318870;Turkey Hunting Unlimited;;0 - 20,000;5;1;4;0;0;1
1318940;Forkdrift;;100,000 - 200,000;521;104;417;0;0;0
1318970;This Way Madness Lies;;0 - 20,000;83;2;81;0;0;2
1318980;Virtual Exhibition;;0 - 20,000;73;4;69;0;0;2
1319060;Deadly Maze;;0 - 20,000;5;0;5;0;0;0
1319100;Orbit Outlaws;;0 - 20,000;5;2;3;0;0;0
1319210;Little Chick;;0 - 20,000;2;1;1;0;0;0
1319220;Don't Fall Asleep;;0 - 20,000;2;1;1;0;0;0
1319260;Knight's maze;;100,000 - 200,000;9;4;5;0;0;0
1319270;Our Beautiful Earth;;20,000 - 50,000;4;0;4;0;0;0
1319290;Damn, what was yesterday?;;0 - 20,000;20;7;13;0;0;0
1319320;Pangman;;0 - 20,000;7;3;4;0;0;0
1319400;The Sunny Life;;0 - 20,000;19;1;18;0;0;0
1319420;Chasing Static;;0 - 20,000;294;41;253;0;0;1
1319420;Chasing Static;;0 - 20,000;294;41;253;0;0;1
1319430;VERGJORN;;0 - 20,000;15;9;6;0;0;0
1319460;Fashion Police Squad;;0 - 20,000;482;32;450;0;0;7
1319550;Power of Ten;;0 - 20,000;101;23;78;12;12;2
1319570;LIMINALPHOBIA;;0 - 20,000;8;5;3;0;0;0
1319690;Freediving Hunter Spearfishing the World;;0 - 20,000;6;1;5;0;0;0
1319690;Freediving Hunter Spearfishing the World;;0 - 20,000;6;1;5;0;0;0
1319720;Obsolete Souls;;0 - 20,000;5;0;5;0;0;0
1319790;Yogurt Commercial 3;;0 - 20,000;55;0;55;0;0;0
1319850;ValiDate: Struggling Singles in your Area;;0 - 20,000;51;14;37;0;0;6
1319880;Cupcake: an Apartment Adventure;;0 - 20,000;2;0;2;0;0;0
1320030;Oneteam Soccer;;0 - 20,000;42;4;38;0;0;0
1320100;Wanted Raccoon;;0 - 20,000;331;77;254;0;0;4
1320110;The Adventurer - Episode 2: New Dreams;;50,000 - 100,000;1;1;0;0;0;0
1320230;Curved Space;;0 - 20,000;22;3;19;0;0;0
1320240;zoku sonohigurashi vs touhou universe 2;;0 - 20,000;9;1;8;0;0;0
1320400;Phaser;;0 - 20,000;4;0;4;0;0;0
1320440;World of Towers;;0 - 20,000;3;3;0;0;0;0
1320470;Meditation 3 ~ Sophia Code;;0 - 20,000;3;0;3;0;0;0
1320490;Princess Farmer;;0 - 20,000;110;4;106;0;0;2
1320500;Lauras Tierklinik;;0 - 20,000;1;1;0;0;0;0
1320510;Rider's World: I Want To Ride!;;0 - 20,000;2;2;0;0;0;0
1320520;Grand horse attraction;;0 - 20,000;3;8;-5;0;0;0
1320550;The Call of Karen;;100,000 - 200,000;855;230;625;0;0;3
1320710;Glitch Escape;;100,000 - 200,000;11;10;1;0;0;0
1320830;Электричка;;0 - 20,000;33;7;26;0;0;0
1320940;The Disappearance of the Mitchells;;0 - 20,000;6;6;0;0;0;0
1320950;The Swine;;50,000 - 100,000;202;40;162;0;0;0
1320990;Horror Adventure VR;;0 - 20,000;9;8;1;0;0;0
1321010;Labyrinth Legend;;0 - 20,000;31;4;27;0;0;2
1321030;No one lives in heaven;;0 - 20,000;57;8;49;0;0;0
1321040;Memory Note;;0 - 20,000;55;1;54;0;0;0
1321070;Death Come True;;50,000 - 100,000;588;166;422;0;0;2
1321080;Slams City. Hitler's Escape.;;0 - 20,000;2;3;-1;0;0;0
1321110;MonsterTerritory;;20,000 - 50,000;1;0;1;0;0;0
1321120;末路调色板;;0 - 20,000;77;1;76;0;0;1
1321220;Real Farm – Gold Edition;;0 - 20,000;4;11;-7;0;0;0
1321230;Angels of Death Episode.Eddie;;0 - 20,000;290;31;259;0;0;1
1321270;Duck Life: Adventure;;0 - 20,000;250;27;223;0;0;6
1321350;LV99: Final Fortress;;20,000 - 50,000;5;0;5;0;0;0
1321400;Diesel Punch;;0 - 20,000;26;9;17;0;0;0
1321450;American Theft 80s;;20,000 - 50,000;459;129;330;171;266;11
1321590;Dark Tales: Edgar Allan Poe's The Bells Collector's Edition;;0 - 20,000;8;0;8;0;0;1
1321650;Rocket Ghost Aidan 2;;0 - 20,000;14;0;14;0;0;0
1321680;Hello Neighbor 2;;50,000 - 100,000;896;385;511;0;0;83
1321760;Corona Find Us;;0 - 20,000;3;4;-1;0;0;0
1321840;Sword and Spirit;;0 - 20,000;6;2;4;0;0;0
1321890;Gravitators;;0 - 20,000;28;0;28;0;0;0
1322010;Automata Break;;0 - 20,000;13;0;13;0;0;0
1322010;Automata Break;;0 - 20,000;13;0;13;0;0;0
1322080;Marshall Mellow;;0 - 20,000;2;0;2;0;0;0
1322090;Taken Away;;0 - 20,000;8;2;6;0;0;0
1322100;Battle Bands: Rock & Roll Deckbuilder;;0 - 20,000;118;16;102;3503;3503;1
1322170;Pluviophile;;0 - 20,000;229;16;213;0;0;0
1322180;DriftZ;;0 - 20,000;29;11;18;0;0;0
1322260;Santa Monica Paradise;;0 - 20,000;11;5;6;0;0;0
1322270;HARTS ISLAND;;0 - 20,000;25;13;12;0;0;0
1322280;Time Of Special Team(T.O.S.T);;0 - 20,000;1;2;-1;0;0;0
1322290;The Case Book of Arne;;0 - 20,000;239;23;216;0;0;3
1322290;The Case Book of Arne;;0 - 20,000;239;23;216;0;0;3
1322300;Tsugunohi;;20,000 - 50,000;317;130;187;80;80;10
1322330;Salvage;;0 - 20,000;9;1;8;0;0;0
1322370;Uphold The Realm;;0 - 20,000;16;2;14;0;0;0
1322520;The Door Of Redemption;;0 - 20,000;5;1;4;0;0;0
1322540;The lost Labyrinth;;0 - 20,000;17;2;15;0;0;0
1322550;Fear the Dark Unknown: James;;0 - 20,000;0;3;-3;0;0;0
1322600;Pizza Bike Rider;;0 - 20,000;40;6;34;0;0;0
1322650;RITE;;0 - 20,000;234;32;202;0;0;1
1322700;Brain Boom;;0 - 20,000;14;3;11;0;0;0
1322730;Endless Battle: Return of Hero +1;;0 - 20,000;17;8;9;0;0;3
1322740;VR-NISSAGE 3 - John Wentz Art Exhibition;;0 - 20,000;5;1;4;0;0;0
1323000;Space Court;;0 - 20,000;132;3;129;0;0;0
1323190;Sbeve;;50,000 - 100,000;3;4;-1;0;0;0
1323200;Hurry Up!;;0 - 20,000;9;1;8;0;0;0
1323220;Hoops Madness;;0 - 20,000;6;0;6;0;0;0
1323350;Corona Simulator;;0 - 20,000;3;0;3;0;0;0
1323410;Quest 4 Papa: Reloaded;;20,000 - 50,000;80;8;72;0;0;0
1323420;H-SNIPER: World War II;;100,000 - 200,000;805;112;693;15;24;0
1323470;GetsuFumaDen: Undying Moon;;20,000 - 50,000;664;178;486;878;878;9
1323480;No One Can Ever Know;;0 - 20,000;10;3;7;0;0;0
1323480;No One Can Ever Know;;0 - 20,000;10;3;7;0;0;0
1323540;Aerial_Knight's Never Yield;;0 - 20,000;79;14;65;0;0;0
1323540;Aerial_Knight's Never Yield;;0 - 20,000;79;14;65;0;0;0
1323580;Buddy's Creative Quest!;;20,000 - 50,000;0;1;-1;0;0;0
1323610;Grit Paintball;;0 - 20,000;15;2;13;0;0;0
1323770;Roll The World;;0 - 20,000;7;0;7;0;0;0
1323860;Crowded Blue Dot;;0 - 20,000;31;19;12;0;0;0
1323870;Touch The Floor;;0 - 20,000;2;0;2;0;0;0
1323900;Scrapnaut;;20,000 - 50,000;415;156;259;14;14;3
1323910;Wall Ninja;;0 - 20,000;3;0;3;0;0;0
1323950;Dungeons & Bombs;;0 - 20,000;13;0;13;0;0;0
1323950;Dungeons & Bombs;;0 - 20,000;13;0;13;0;0;0
1324010;Disease -Hidden Object-;;0 - 20,000;23;13;10;0;0;0
1324030;Alien Cat 2;;0 - 20,000;100;8;92;0;0;0
1324040;Bluevolution;;0 - 20,000;3;0;3;0;0;0
1324070;Monolight;;50,000 - 100,000;293;39;254;0;0;0
1324130;Stranded: Alien Dawn;;100,000 - 200,000;2272;317;1955;2460;2460;658
1324150;Micetopia;;0 - 20,000;4;11;-7;0;0;0
1324270;Space Station Tycoon;;20,000 - 50,000;97;34;63;0;0;0
1324320;Dark Heart Mansion;;0 - 20,000;1;0;1;0;0;0
1324340;Made in Abyss: Binary Star Falling into Darkness;;20,000 - 50,000;727;249;478;389;389;143
1324350;Turbo Golf Racing;;20,000 - 50,000;360;48;312;0;0;14
1324360;Brain Please Don't;;0 - 20,000;10;4;6;0;0;0
1324410;Car Parking Simulator VR;;0 - 20,000;32;10;22;0;0;0
1324420;Fox Spirit: A Two-Tailed Adventure;;0 - 20,000;25;3;22;0;0;1
1324530;Warhammer 40,000: Shootas, Blood & Teef;;100,000 - 200,000;1325;161;1164;823;823;22
1324560;Krum - Battle Arena;;0 - 20,000;15;9;6;0;0;0
1324560;Krum - Battle Arena;;0 - 20,000;15;9;6;0;0;0
1324630;Drive-By Cop;;0 - 20,000;1;1;0;0;0;0
1324630;Drive-By Cop;;0 - 20,000;1;1;0;0;0;0
1324710;Twin Stick Heroes;;0 - 20,000;3;0;3;0;0;0
1324730;Steam revolution VR;;20,000 - 50,000;3;1;2;0;0;0
1324780;Easy Red 2;;100,000 - 200,000;2226;275;1951;278;423;77
1324860;Heretic's Lot: Prologue;;20,000 - 50,000;8;1;7;0;0;0
1324870;Ur Game: The Game of Ancient Gods;;0 - 20,000;26;2;24;0;0;0
1325000;Roller Stars;;0 - 20,000;3;9;-6;0;0;0
1325030;Fright Chasers: Thrills, Chills and Kills Collector's Edition;;0 - 20,000;0;2;-2;0;0;0
1325080;CyberBorn;;0 - 20,000;3;1;2;0;0;0
1325200;Nioh 2 – The Complete Edition;;500,000 - 1,000,000;30555;4019;26536;3936;1811;4933
1325220;Chess of Chains;;0 - 20,000;1;0;1;0;0;0
1325270;Escapeworld Dilemma;;0 - 20,000;44;13;31;0;0;0
1325290;Ever Forward Prologue;;50,000 - 100,000;367;53;314;28;28;0
1325310;Endless Voyage / 无尽航线;;50,000 - 100,000;470;157;313;557;557;2
1325340;Brain Sanguo;;0 - 20,000;0;3;-3;0;0;0
1325370;Pandemic Isolation;;0 - 20,000;23;9;14;0;0;0
1325380;Live Empire;;20,000 - 50,000;116;132;-16;106;123;0
1325400;VEGAS Pro 18 Edit Steam Edition;;200,000 - 500,000;415;1835;-1420;0;0;44
1325420;Kooring VR Wonderland : Heart Castle Crush;;0 - 20,000;5;0;5;0;0;0
1325430;KooringVR Wonderland:Red Queen's Black Magic;;0 - 20,000;2;0;2;0;0;0
1325470;Pianistic;;0 - 20,000;212;28;184;0;0;0
1325470;Pianistic;;0 - 20,000;212;28;184;0;0;0
1325520;Mezmeratu;;0 - 20,000;9;3;6;0;0;0
1325610;Anthology of Fear: Prologue;;20,000 - 50,000;64;35;29;0;0;0
1325730;Keysight;;0 - 20,000;35;2;33;0;0;9
1325800;Viticulture Essential Edition;;20,000 - 50,000;104;54;50;0;0;13
1325860;VTube Studio;;500,000 - 1,000,000;2502;211;2291;166;13;8200
1325870;Kotel Ne Gori: A Friend of Lena Boots;;20,000 - 50,000;74;4;70;0;0;0
1325870;Kotel Ne Gori: A Friend of Lena Boots;;20,000 - 50,000;74;4;70;0;0;0
1325880;Eternal Hope: Prologue;;50,000 - 100,000;261;17;244;0;0;0
1325890;SILT;;50,000 - 100,000;245;80;165;0;0;1
1325900;Demon Turf;;0 - 20,000;299;44;255;332;332;3
1325960;Pandemic: The Virus Outbreak;;0 - 20,000;4;8;-4;0;0;0
1325970;Ghost of Tomorrow: Chapter 1;;0 - 20,000;47;13;34;0;0;1
1326000;Sakura Succubus 2;;20,000 - 50,000;235;23;212;34;34;3
1326110;Killer Ricky;;0 - 20,000;13;7;6;0;0;0
1326170;Immortal Hero;;0 - 20,000;13;5;8;0;0;0
1326220;Dynarog;;0 - 20,000;1;1;0;0;0;0
1326270;Festival Tycoon;;0 - 20,000;134;26;108;234;234;4
1326290;BALROG;;0 - 20,000;4;1;3;0;0;0
1326330;Data mining 8;;0 - 20,000;5;3;2;0;0;0
1326700;CHRONOSHOT;;200,000 - 500,000;365;49;316;0;0;0
1326710;TIGER GAME ASSETS;;0 - 20,000;2;1;1;0;0;0
1326760;Grand Attrition;;0 - 20,000;4;2;2;0;0;0
1326870;Energysaber Masta VR;;0 - 20,000;4;0;4;0;0;0
1326920;AstroWings: Space War;;0 - 20,000;7;2;5;0;0;0
1326920;AstroWings: Space War;;0 - 20,000;7;2;5;0;0;0
1327020;亭上满月映西枝~The Forever Moon;;0 - 20,000;122;3;119;0;0;0
1327100;Squaxel;;0 - 20,000;4;0;4;0;0;0
1327260;KOJOUJI;;0 - 20,000;6;6;0;0;0;0
1327370;Frag;;0 - 20,000;7;2;5;0;0;0
1327390;Sogo Vego;;0 - 20,000;16;14;2;0;0;0
1327430;Pinku Kult Hex Mortis;;50,000 - 100,000;29;1;28;0;0;0
1327440;Flewfie's Adventure;;0 - 20,000;55;0;55;0;0;0
1327450;ValiVictorian;;0 - 20,000;0;2;-2;0;0;0
1327540;Cross the Moon;;0 - 20,000;4;0;4;0;0;0
1327600;Logic - Electrons Connect;;0 - 20,000;2;0;2;0;0;0
1327720;Earth: 9000;;0 - 20,000;5;0;5;0;0;0
1327810;Moon Raider;;0 - 20,000;31;5;26;0;0;0
1327820;The Lost Art of Innkeeping;;0 - 20,000;80;0;80;0;0;0
1327920;Maestro VR;;0 - 20,000;43;10;33;0;0;0
1328050;Tornado Driver;;0 - 20,000;19;1;18;0;0;0
1328190;BATTLESHIP APOLLO;;100,000 - 200,000;98;111;-13;0;0;0
1328350;Turbo Overkill;;100,000 - 200,000;1597;67;1530;24;24;29
1328410;Newton's Cradle Puzzle Game;;0 - 20,000;17;3;14;0;0;0
1328430;Lost Ed;;0 - 20,000;1;0;1;0;0;0
1328460;The Host;;0 - 20,000;2;0;2;0;0;0
1328470;Covid-Racing;;0 - 20,000;10;3;7;0;0;0
1328490;Rico-Jump;;20,000 - 50,000;67;14;53;0;0;0
1328500;The Adventures of Crackhead Jack: Overdose Edition;;50,000 - 100,000;20;0;20;0;0;0
1328530;Quantum Protocol;;20,000 - 50,000;406;42;364;0;0;4
1328560;Tofu Topple;;0 - 20,000;5;0;5;0;0;0
1328570;Lighton;;0 - 20,000;52;4;48;0;0;0
1328620;Desolate Roads;;0 - 20,000;3;7;-4;0;0;0
1328660;Need for Speed Hot Pursuit Remastered;;500,000 - 1,000,000;4929;1193;3736;569;539;142
1328670;Mass Effect Legendary Edition;;500,000 - 1,000,000;31437;2506;28931;3013;1120;3750
1328710;Capsule Hotel Simulator;;0 - 20,000;10;6;4;0;0;0
1328750;BRDG;;0 - 20,000;13;1;12;0;0;0
1328760;妙语连珠;;0 - 20,000;18;2;16;0;0;1
1328780;Cell Defender;;0 - 20,000;1;3;-2;0;0;0
1328810;Shoot. Push. Repeat.;;0 - 20,000;43;5;38;0;0;0
1328830;Jumper Starman;;0 - 20,000;11;2;9;0;0;0
1328840;Lost in Play;;50,000 - 100,000;2168;37;2131;230;230;14
1328850;Trazz;;0 - 20,000;1;0;1;0;0;0
1328890;Succubus Affection;;20,000 - 50,000;861;70;791;436;436;12
1328900;Explorer of Yggdrasil;;20,000 - 50,000;201;29;172;0;0;3
1328910;Otome the Exorcist;;0 - 20,000;74;22;52;0;0;2
1328920;Mira and the Mysteries of Alchemy;;0 - 20,000;92;25;67;0;0;1
1328930;Power Of Language;;0 - 20,000;1;2;-1;0;0;0
1329080;BORIS THE ROCKET;;0 - 20,000;89;2;87;0;0;0
1329110;2ECONDS TO STΔRLIVHT: Forever My Diamond;;0 - 20,000;60;11;49;0;0;0
1329130;枪炮派对;;0 - 20,000;2;1;1;0;0;0
1329190;Fear Of The Dark;;0 - 20,000;3;2;1;0;0;0
1329250;Refrigerant Recovery Simulation;;0 - 20,000;10;0;10;0;0;0
1329270;Raider Bots;;0 - 20,000;4;0;4;0;0;0
1329320;Seven Doors;;0 - 20,000;55;24;31;0;0;0
1329350;蛊婆 Lady in Tomb;;0 - 20,000;372;24;348;0;0;1
1329400;Space Dogfight;;0 - 20,000;3;2;1;0;0;0
1329420;Solitaire Beach Season Sounds of Waves;;0 - 20,000;3;0;3;0;0;1
1329430;Holiday Mosaics Christmas Puzzles;;0 - 20,000;5;1;4;0;0;0
1329440;Detective Solitaire Inspector Magic and the Man Without Face;;0 - 20,000;7;1;6;0;0;1
1329450;Elly's Cake Cafe;;0 - 20,000;9;4;5;0;0;0
1329460;Strike Solitaire 2;;0 - 20,000;4;2;2;0;0;0
1329470;Christmas Patchwork Frozen;;0 - 20,000;11;4;7;0;0;0
1329480;Olympus Griddlers;;0 - 20,000;3;3;0;0;0;0
1329500;SpiderHeck;;200,000 - 500,000;2450;248;2202;904;970;109
1329510;Big Farm Story;;0 - 20,000;840;229;611;467;876;40
1329540;CROSSBOW: Bloodnight;;20,000 - 50,000;286;59;227;0;0;0
1329560;LURE;;0 - 20,000;27;35;-8;0;0;0
1329600;Karting;;50,000 - 100,000;457;70;387;112;197;7
1329630;Chickamauga Battles;;0 - 20,000;3;0;3;0;0;0
1329720;AshEdit;;0 - 20,000;3;2;1;0;0;0
1329790;Override 2: Super Mech League;;0 - 20,000;72;37;35;0;0;1
1329800;We Surround You;;0 - 20,000;14;1;13;0;0;0
1329800;We Surround You;;0 - 20,000;14;1;13;0;0;0
1329810;Nexagon: Deathmatch;;0 - 20,000;3;0;3;212;212;0
1329830;Ms. Holmes: Five Orange Pips Collector's Edition;;0 - 20,000;7;1;6;0;0;0
1329850;The Battle of Visby;;0 - 20,000;6;7;-1;0;0;0
1329880;Wild West Dynasty;;50,000 - 100,000;238;632;-394;0;0;418
1329990;My Silly Life;;0 - 20,000;29;5;24;0;0;0
1330000;Stolen Realm;;200,000 - 500,000;1178;121;1057;1558;2048;1313
1330010;RetroBound;;0 - 20,000;3;1;2;0;0;0
1330080;The Fantastic Adventure of Monsieur Grape;;20,000 - 50,000;5;1;4;0;0;0
1330100;The Wishing Stone;;0 - 20,000;11;0;11;0;0;0
1330120;Pitcher and the Whale;;0 - 20,000;48;1;47;0;0;0
1330140;The Maze;;0 - 20,000;1;1;0;0;0;0
1330160;Maze;;0 - 20,000;4;0;4;0;0;0
1330170;Bishoujo Battle Cyber Panic!;;0 - 20,000;20;3;17;0;0;0
1330180;Evil Manor;;0 - 20,000;3;11;-8;0;0;0
1330250;Taimanin Collection: Battle Arena;;50,000 - 100,000;505;188;317;147;88;74
1330260;Welcome to Elk: The First Stories;;0 - 20,000;33;1;32;0;0;0
1330290;READY AIM FIRE;;50,000 - 100,000;7;10;-3;0;0;0
1330300;Roopit and Boopit;;0 - 20,000;1;0;1;0;0;0
1330330;Let's Journey;;0 - 20,000;27;3;24;0;0;0
1330370;One Shell Straight to Hell;;0 - 20,000;12;12;0;0;0;0
1330460;Becastled;;200,000 - 500,000;3379;673;2706;370;377;60
1330470;F.I.S.T.: Forged In Shadow Torch;;200,000 - 500,000;4634;544;4090;758;1017;10
1330500;Libe;;0 - 20,000;3;0;3;0;0;0
1330550;Magic Lessons in Wand Valley - a jigsaw puzzle tale;;0 - 20,000;49;6;43;0;0;2
1330570;RUN! GRANDPA! RUN!;;0 - 20,000;44;7;37;0;0;0
1330610;The Last Farm;;0 - 20,000;4;1;3;0;0;0
1330630;Marcella Moon: Secret on the Hill;;20,000 - 50,000;17;1;16;0;0;0
1330660;Train Life: A Railway Simulator;;20,000 - 50,000;861;291;570;374;384;45
1330690;Time Patrol;;0 - 20,000;6;0;6;0;0;0
1330760;Mind Mirror;;0 - 20,000;7;3;4;0;0;0
1330770;Gogoo;;0 - 20,000;0;1;-1;0;0;0
1330800;Nowhere New;;0 - 20,000;1;1;0;0;0;0
1330820;Hunting Unlimited 3;;0 - 20,000;20;0;20;0;0;0
1330830;Cannabis Farmer Strain Master;;0 - 20,000;7;8;-1;0;0;0
1330890;Crystal Caves HD;;20,000 - 50,000;238;2;236;102;102;7
1330920;Captain Clive: Danger From Dione;;20,000 - 50,000;7;0;7;0;0;0
1330930;Star Seeker in: the Secret of the Sorcerous Standoff;;20,000 - 50,000;42;0;42;0;0;0
1330940;Sword Slinger;;0 - 20,000;8;0;8;0;0;0
1330960;The Commission 1920: Organized Crime Grand Strategy;;0 - 20,000;23;8;15;0;0;0
1331030;VR King of Battle Cards;;0 - 20,000;5;0;5;0;0;0
1331040;Card Apocalypse;;0 - 20,000;10;4;6;0;0;0
1331070;No Honor;;0 - 20,000;7;4;3;0;0;0
1331080;Refreshing Sideways Puzzle Ghost Hammer;;0 - 20,000;0;1;-1;0;0;0
1331090;GoblinAttack / 进击的哥布林;;0 - 20,000;39;2;37;0;0;0
1331120;Kármán line: the edge of war;;50,000 - 100,000;8;2;6;0;0;0
1331180;Destructive Contraptions;;0 - 20,000;2;0;2;0;0;0
1331210;Wolfstride;;50,000 - 100,000;506;48;458;0;0;7
1331240;摇摆地牢 Swing Dungeon;;0 - 20,000;5;0;5;0;0;0
1331310;Card escape: Plane crash;;0 - 20,000;2;0;2;0;0;0
1331330;CurryKitten FPV Simulator;;0 - 20,000;29;7;22;0;0;0
1331370;Untitled Video Game;;0 - 20,000;2;1;1;0;0;0
1331390;sfäre;;0 - 20,000;13;0;13;0;0;3
1331400;The Oort Cloud 2020;;0 - 20,000;1;1;0;0;0;0
1331410;Rogue Bots;;20,000 - 50,000;0;1;-1;0;0;0
1331420;Rogue Arrows;;0 - 20,000;31;8;23;0;0;0
1331440;FUSER;;20,000 - 50,000;1173;187;986;337;489;10
1331470;Sport Shooter;;0 - 20,000;2;0;2;0;0;0
1331530;Paws and Soul: First Step;;0 - 20,000;39;28;11;0;0;0
1331540;ノンビリア(Nonvilia);;0 - 20,000;1;3;-2;0;0;0
1331610;Super Neo Tanks;;20,000 - 50,000;6;1;5;0;0;0
1331620;The Last Survey;;0 - 20,000;16;1;15;0;0;0
1331670;International Space Banana;;0 - 20,000;71;2;69;0;0;0
1331860;Trident;;0 - 20,000;1;0;1;0;0;0
1331910;Morkredd;;20,000 - 50,000;293;64;229;102;106;2
1332010;Stray;;2,000,000 - 5,000,000;109715;2883;106832;538;355;796
1332040;Damn Endless Orcs;;0 - 20,000;3;2;1;0;0;0
1332090;Void Tyrant;;0 - 20,000;41;10;31;0;0;0
1332120;VR Aim Trainer;;0 - 20,000;8;3;5;0;0;0
1332150;Zorya: The Celestial Sisters;;0 - 20,000;34;11;23;408;408;0
1332210;Signs of the Sojourner: Prologue;;0 - 20,000;13;3;10;0;0;0
1332210;Signs of the Sojourner: Prologue;;0 - 20,000;13;3;10;0;0;0
1332220;Mightyy's FPS Aim Trainer;;0 - 20,000;15;2;13;0;0;0
1332250;Wire Flying Maid 2;;0 - 20,000;2;0;2;0;0;0
1332370;The Shadow You;;0 - 20,000;34;3;31;0;0;1
1332440;Futbolín Revolution;;0 - 20,000;0;2;-2;0;0;0
1332450;Open The Gates!;;0 - 20,000;48;8;40;0;0;1
1332470;Gladiator Guild Manager: Prologue;;200,000 - 500,000;1403;90;1313;87;124;2
1332490;Chroma;;0 - 20,000;29;6;23;0;0;0
1332540;Order from Caos;;0 - 20,000;11;0;11;0;0;0
1332570;The Floating City;;0 - 20,000;3;2;1;0;0;0
1332630;Zombeer: Delivery Mission;;0 - 20,000;5;2;3;0;0;0
1332660;Super Punch Patrol;;20,000 - 50,000;5;3;2;0;0;0
1332690;Kill The Humans;;0 - 20,000;1;0;1;0;0;0
1332760;Nienix: Cosmic Warfare;;0 - 20,000;89;8;81;0;0;2
1332800;Snake;;0 - 20,000;8;0;8;0;0;0
1332840;Rise and Fall;;0 - 20,000;4;4;0;0;0;1
1332860;STAYHOMER;;0 - 20,000;47;4;43;0;0;0
1332890;HopBound;;0 - 20,000;30;4;26;0;0;1
1332940;Dungeons of Clay;;0 - 20,000;13;4;9;0;0;0
1332970;Dab on Darkness!;;0 - 20,000;71;2;69;0;0;1
1332990;The Hayseed Knight;;0 - 20,000;99;3;96;0;0;2
1333020;Roundabout 3;;0 - 20,000;21;1;20;0;0;0
1333030;Block Motion;;0 - 20,000;9;0;9;0;0;0
1333050;Born to Kill;;0 - 20,000;3;2;1;0;0;0
1333090;Gravity;;50,000 - 100,000;53;7;46;0;0;0
1333190;Rescue Team: Danger from Outer Space!;;0 - 20,000;28;0;28;0;0;3
1333270;Crazy Derby Racing;;0 - 20,000;10;6;4;0;0;0
1333280;Klomanager - Regurgitated;;0 - 20,000;6;1;5;0;0;0
1333350;Angel Legion;;200,000 - 500,000;3645;412;3233;3;3;586
1333380;HUNTERS All Star Battle;;0 - 20,000;5;0;5;0;0;0
1333410;Stream Racer;;50,000 - 100,000;205;39;166;0;0;5
1333420;Silenthead: Ducks hunt;;0 - 20,000;3;3;0;0;0;0
1333430;Foxy's Adventure;;0 - 20,000;1;0;1;0;0;0
1333460;Nino Maze LOFI;;0 - 20,000;77;8;69;0;0;0
1333470;Alex Kidd in Miracle World DX;;0 - 20,000;413;72;341;59;59;4
1333490;Dead Event;;0 - 20,000;115;22;93;0;0;0
1333500;Combat Mech VR;;0 - 20,000;1;0;1;0;0;0
1333530;Acolyte: Prologue;;50,000 - 100,000;58;17;41;0;0;0
1333540;Tactical Suppression;;0 - 20,000;0;1;-1;0;0;0
1333590;Carnival VR Orientation;;0 - 20,000;1;0;1;0;0;0
1333650;Kingdoms In Chaos;;0 - 20,000;25;18;7;0;0;0
1333700;Real Heroes: Firefighter HD;;0 - 20,000;68;5;63;0;0;4
1333700;Real Heroes: Firefighter HD;;0 - 20,000;68;5;63;0;0;4
1333750;Right Way;;0 - 20,000;13;5;8;0;0;2
1333800;Villa's Blinds;;0 - 20,000;162;36;126;0;0;0
1333810;Space Mining;;0 - 20,000;2;1;1;0;0;0
1333840;Overshadow;;0 - 20,000;2;2;0;0;0;0
1333860;Wild West Survival;;0 - 20,000;9;5;4;0;0;0
1333870;Widgets and Gidgets;;0 - 20,000;2;0;2;0;0;0
1333890;Crappy Climber;;0 - 20,000;30;4;26;0;0;1
1333900;Maidens of the Ocean Solitaire;;0 - 20,000;9;2;7;0;0;0
1333910;Sizeable;;20,000 - 50,000;786;10;776;0;0;2
1333920;A Place, Forbidden;;50,000 - 100,000;261;33;228;0;0;1
1333940;Magirune;;0 - 20,000;20;3;17;0;0;0
1333950;Viral Execution;;50,000 - 100,000;5;0;5;0;0;0
1333980;Flyist;;0 - 20,000;10;3;7;0;0;0
1333990;Saving Animals;;0 - 20,000;6;6;0;0;0;0
1334000;Wordle;;100,000 - 200,000;521;93;428;124;138;4
1334010;Last Room;;200,000 - 500,000;264;114;150;241;214;4
1334020;Aeon on Mosaic: Anemone 时间碎片：奇迹;;0 - 20,000;65;3;62;0;0;0
1334040;Paper Dolls 2 纸人贰;;200,000 - 500,000;1837;330;1507;385;586;37
1334050;Kwarn Armada Tactics;;0 - 20,000;1;0;1;0;0;0
1334070;Sleep;;20,000 - 50,000;14;17;-3;0;0;0
1334110;FREAKOUT;;0 - 20,000;19;24;-5;0;0;1
1334120;Goblin Rush;;50,000 - 100,000;3;7;-4;0;0;0
1334200;Mülltrennungssimulator 2021;;0 - 20,000;7;1;6;0;0;0
1334240;Sunset 20 Drone Racer;;0 - 20,000;2;2;0;0;0;0
1334300;Charge Kid;;0 - 20,000;21;0;21;0;0;0
1334330;Rolling Arcade;;0 - 20,000;9;1;8;0;0;0
1334420;Maze Banquet;;0 - 20,000;4;2;2;0;0;0
1334470;Mythic Archive;;0 - 20,000;7;2;5;0;0;0
1334510;Jane Skriff;;0 - 20,000;3;0;3;0;0;0
1334530;I AM FLY;;0 - 20,000;9;3;6;0;0;0
1334580;October Night Games;;20,000 - 50,000;51;15;36;0;0;0
1334590;Furry Love;;200,000 - 500,000;0;0;0;227;293;11
1334610;Takelshin;;0 - 20,000;9;0;9;0;0;0
1334620;KANAPOCALYPSE;;0 - 20,000;3;1;2;0;0;0
1334630;Deja Vu Collector's Edition;;0 - 20,000;4;2;2;0;0;0
1334650;Hell Shuffle;;0 - 20,000;32;2;30;0;0;1
1334700;tomorrow won't come for those without ██████;;20,000 - 50,000;573;26;547;11;11;2
1334730;Dread Templar;;100,000 - 200,000;794;92;702;147;147;20
1334760;CRASH: Autodrive - Prologue;;0 - 20,000;1;0;1;0;0;0
1334780;Onsen Master;;0 - 20,000;10;8;2;0;0;1
1334800;Everything Explosive;;0 - 20,000;7;3;4;0;0;0
1334840;GOHOME;;20,000 - 50,000;181;40;141;10;10;0
1334900;Murder Hornets;;0 - 20,000;3;7;-4;0;0;0
1334910;Space Slurpies;;0 - 20,000;72;1;71;0;0;0
1334970;The Neon Mate;;0 - 20,000;13;0;13;0;0;0
1334980;The Perplexing Orb 2;;0 - 20,000;2;0;2;0;0;0
1335020;Mind Over Melee Radio;;0 - 20,000;1;0;1;0;0;0
1335030;Ginkgo;;50,000 - 100,000;242;21;221;0;0;1
1335050;Cosmic Zephyr DX;;0 - 20,000;2;3;-1;0;0;0
1335200;Action Taimanin;;1,000,000 - 2,000,000;12438;2413;10025;538;57;986
1335210;Stream Smash;;0 - 20,000;4;0;4;0;0;0
1335210;Stream Smash;;0 - 20,000;4;0;4;0;0;0
1335230;Sumire;;0 - 20,000;377;14;363;0;0;0
1335240;放置勇者：远征/Idle Heroes:Odyssey;;50,000 - 100,000;279;254;25;7067;14128;30
1335290;Dennkind Dock;;0 - 20,000;60;13;47;0;0;5
1335300;The Warlin of Heroes;;0 - 20,000;16;7;9;0;0;0
1335340;Painted Legend 2;;0 - 20,000;5;0;5;0;0;0
1335350;Kaapelipeli: The Cable Game;;0 - 20,000;2;0;2;0;0;0
1335360;Chef Chen;;0 - 20,000;11;4;7;0;0;0
1335370;DVR Simulator;;0 - 20,000;3;3;0;0;0;0
1335400;Rangers;;0 - 20,000;5;1;4;0;0;0
1335410;50 Level Survival;;0 - 20,000;0;3;-3;0;0;0
1335440;Tyrgard Archer VR;;0 - 20,000;13;5;8;0;0;0
1335500;Hell's High Harmonizers;;0 - 20,000;11;1;10;0;0;0
1335510;The Escape from Bungalow;;0 - 20,000;12;7;5;0;0;0
1335530;Alisa;;0 - 20,000;614;54;560;246;246;4
1335560;UNREAL LIFE;;20,000 - 50,000;782;26;756;0;0;5
1335630;IMHA;;0 - 20,000;2;0;2;0;0;0
1335680;The Kind Camomille;;0 - 20,000;18;12;6;0;0;0
1335700;Marbleous Blocks;;0 - 20,000;5;2;3;0;0;0
1335790;Operation: Tango;;200,000 - 500,000;4514;549;3965;322;359;108
1335800;Don't Forget Me;;20,000 - 50,000;67;32;35;0;0;0
1335810;Bunny's Maze;;0 - 20,000;33;3;30;0;0;0
1335810;Bunny's Maze;;0 - 20,000;33;3;30;0;0;0
1335820;100 vacas;;0 - 20,000;21;1;20;0;0;0
1335830;Len's Island;;50,000 - 100,000;2131;296;1835;560;624;95
1335880;Duo Defenders - Tower Defense;;0 - 20,000;5;0;5;0;0;0
1335890;Fractured Voyage;;0 - 20,000;0;1;-1;0;0;0
1335910;Droid Guier;;0 - 20,000;6;0;6;0;0;0
1335970;Greedy Maze;;0 - 20,000;6;1;5;0;0;0
1336020;Mayor of Defense;;0 - 20,000;3;1;2;0;0;0
1336040;Easter Pairs;;0 - 20,000;4;8;-4;0;0;0
1336060;TAISHO x ALICE episode 2;;20,000 - 50,000;324;37;287;0;0;5
1336070;Ynglet: Prologue;;50,000 - 100,000;28;6;22;0;0;0
1336100;Arcadium;;0 - 20,000;5;4;1;0;0;0
1336120;Bridge Constructor: The Walking Dead;;20,000 - 50,000;144;33;111;464;464;0
1336130;Inside the Box;;0 - 20,000;14;7;7;0;0;0
1336150;Whispers of the Ancients;;0 - 20,000;5;2;3;0;0;0
1336160;Chupa Chupa VR;;0 - 20,000;88;11;77;0;0;0
1336170;The Cabin;;0 - 20,000;4;2;2;0;0;0
1336180;Floodland;;0 - 20,000;299;203;96;1834;1834;15
1336180;Floodland;;0 - 20,000;299;203;96;1834;1834;15
1336210;The ER: Patient Typhon;;0 - 20,000;51;5;46;0;0;0
1336230;AVRACH RESURRECTION;;50,000 - 100,000;5;0;5;0;0;0
1336290;ARTHA;;0 - 20,000;5;21;-16;0;0;0
1336340;-SPROUT-;;0 - 20,000;81;3;78;0;0;0
1336420;Breaking Lockdown;;0 - 20,000;27;8;19;0;0;0
1336430;Waves of Rotting Flesh;;0 - 20,000;48;7;41;0;0;0
1336440;Enchanted Kingdom: The Secret of the Golden Lamp Collector's Edition;;0 - 20,000;3;1;2;0;0;1
1336450;Poco In;;20,000 - 50,000;21;6;15;0;0;0
1336460;Moirs;;0 - 20,000;19;0;19;0;0;0
1336490;Against the Storm;;200,000 - 500,000;7161;309;6852;1654;1749;2779
1336560;Hashiriya Drifter-Online Drift Racing Multiplayer (DRIFT/DRAG/RACING);;20,000 - 50,000;932;388;544;135;236;4
1336600;Cabin Fever;;0 - 20,000;324;14;310;0;0;1
1336620;Shutter 2;;0 - 20,000;8;3;5;0;0;0
1336690;ZOMBIE MATHters;;0 - 20,000;5;0;5;0;0;0
1336790;Mini Words: Top Games;;0 - 20,000;54;11;43;0;0;0
1336800;Cybershow;;0 - 20,000;1;1;0;0;0;0
1336830;Touhou MONEY STOCKS SHOPS;;0 - 20,000;13;2;11;0;0;0
1336840;Naudrion: Fall of The Empire;;0 - 20,000;76;31;45;0;0;0
1336950;VoxFox;;0 - 20,000;19;4;15;0;0;0
1336960;Keyboard Piano-ist;;0 - 20,000;3;4;-1;0;0;0
1336970;Ashley: The Emptiness Inside;;20,000 - 50,000;7;1;6;0;0;0
1337000;Bugvasion TD;;0 - 20,000;19;1;18;0;0;0
1337010;Alba: A Wildlife Adventure;;50,000 - 100,000;3667;81;3586;176;211;10
1337020;The Last Surface;;0 - 20,000;5;0;5;0;0;0
1337030;En-Train;;0 - 20,000;9;2;7;0;0;0
1337060;LabTrainingVR: Biosafety Cabinet Edition;;0 - 20,000;9;0;9;0;0;0
1337070;Matrix Blocks;;0 - 20,000;1;0;1;0;0;0
1337080;Blockicker;;0 - 20,000;27;5;22;0;0;0
1337100;Warhammer Age of Sigmar: Tempestfall;;0 - 20,000;127;57;70;46;46;0
1337170;Lords of the Shattered Kingdom;;20,000 - 50,000;2;0;2;0;0;0
1337170;Lords of the Shattered Kingdom;;20,000 - 50,000;2;0;2;0;0;0
1337200;Da! Russian Quiz;;0 - 20,000;6;0;6;0;0;0
1337210;I Wanna Build a Robot;;0 - 20,000;4;2;2;0;0;0
1337240;Gripper: Prologue;;50,000 - 100,000;52;21;31;0;0;0
1337270;Pirates Girls;;0 - 20,000;81;13;68;0;0;0
1337330;Woden GP;;20,000 - 50,000;22;4;18;0;0;0
1337340;Hop Skip Jump;;0 - 20,000;1;0;1;0;0;0
1337430;Personality Dating Sim;;0 - 20,000;21;11;10;0;0;0
1337530;Maskmaker;;100,000 - 200,000;191;11;180;533;533;5
1337600;Wetware;;50,000 - 100,000;4;4;0;0;0;0
1337640;Towers Inc.;;0 - 20,000;3;4;-1;0;0;0
1337650;Flak;;0 - 20,000;41;11;30;0;0;0
1337660;Shikari Rising;;0 - 20,000;4;0;4;0;0;0
1337710;Sanae Toumaden X;;0 - 20,000;24;5;19;0;0;0
1337760;Potion Permit;;100,000 - 200,000;2178;554;1624;428;428;261
1337780;卡牌游戏;;20,000 - 50,000;6;3;3;0;0;0
1337810;Finger Fortress;;20,000 - 50,000;34;17;17;0;0;0
1337820;Emergence;;20,000 - 50,000;72;14;58;0;0;0
1337840;Klondike Solitaire Collection;;0 - 20,000;5;0;5;0;0;2
1337870;Argy Bargy Legends;;0 - 20,000;1;1;0;0;0;0
1337880;Foxen Island;;0 - 20,000;21;3;18;0;0;0
1337890;Choice of Life: Middle Ages;;20,000 - 50,000;590;81;509;0;0;4
1337920;Serial Cleaners;;20,000 - 50,000;149;27;122;10;10;1
1337970;CatTuber;;20,000 - 50,000;430;14;416;4553;4553;227
1338020;Super Glitter Rush;;0 - 20,000;69;2;67;0;0;2
1338090;The Zombie's Horror;;100,000 - 200,000;9;1;8;0;0;0
1338100;Teratopia;;0 - 20,000;23;2;21;0;0;0
1338100;Teratopia;;0 - 20,000;23;2;21;0;0;0
1338130;Popo's Tower;;0 - 20,000;20;12;8;0;0;1
1338140;Meditation Journey: VR Zen Garden;;0 - 20,000;3;1;2;0;0;0
1338160;Monster Tower;;0 - 20,000;0;1;-1;0;0;0
1338180;Dungeon Scale;;0 - 20,000;1;0;1;0;0;0
1338220;Forsaken Portals;;0 - 20,000;21;5;16;0;0;1
1338250;Nohra;;20,000 - 50,000;277;9;268;0;0;0
1338320;Do Animals Dream?;;0 - 20,000;55;24;31;0;0;0
1338330;Lemon Cake;;20,000 - 50,000;1165;126;1039;137;137;20
1338360;Color Security;;0 - 20,000;5;0;5;0;0;0
1338390;Tyrannis;;0 - 20,000;16;1;15;0;0;0
1338410;Para Bellum;;0 - 20,000;3;0;3;0;0;0
1338420;A Night In Berlin;;100,000 - 200,000;345;72;273;0;0;2
1338460;Jiangshi x Daoshi;;50,000 - 100,000;146;11;135;32;32;0
1338520;Bouncy Cat;;0 - 20,000;24;0;24;0;0;0
1338520;Bouncy Cat;;0 - 20,000;24;0;24;0;0;0
1338560;Kingdom of Bees;;0 - 20,000;2;2;0;0;0;0
1338570;Sheng Tian (升天) - Episode 1;;0 - 20,000;6;0;6;0;0;0
1338580;McPixel 3;;0 - 20,000;321;8;313;0;0;1
1338620;Troupe;;0 - 20,000;18;0;18;0;0;0
1338640;A day in East Europe;;0 - 20,000;201;5;196;0;0;0
1338650;Alice | 愛莉澄【Demo】;;20,000 - 50,000;40;26;14;0;0;0
1338770;Sniper Ghost Warrior Contracts 2;;200,000 - 500,000;6344;1121;5223;709;460;453
1338780;Nekopter;;0 - 20,000;6;1;5;0;0;0
1338780;Nekopter;;0 - 20,000;6;1;5;0;0;0
1338790;Good Mourning;;0 - 20,000;18;2;16;0;0;0
1338830;最后的大法师 光明之旅(Last Archmage Journey of Light);;20,000 - 50,000;32;3;29;0;0;0
1338840;Death in the Water 2;;50,000 - 100,000;444;97;347;196;196;29
1338910;VRandish;;0 - 20,000;2;1;1;0;0;0
1338920;Space Fat: To the Core;;0 - 20,000;1;1;0;0;0;0
1338930;Invaliens;;0 - 20,000;0;1;-1;0;0;0
1338940;Head AS Code;;0 - 20,000;40;0;40;0;0;0
1338980;Chess Knights: Viking Lands;;50,000 - 100,000;56;6;50;0;0;0
1339000;Aquarium Designer;;20,000 - 50,000;659;87;572;364;497;5
1339030;Final Hope: The Plot;;0 - 20,000;2;1;1;0;0;0
1339080;Neon Fusion;;0 - 20,000;2;1;1;0;0;0
1339110;The Maze: Humanity;;0 - 20,000;28;1;27;0;0;2
1339140;BATTLE OF REBELS;;200,000 - 500,000;6;1;5;0;0;0
1339170;Mean-While;;20,000 - 50,000;9;1;8;0;0;0
1339180;Xoo: Xeno Xafari;;0 - 20,000;21;0;21;0;0;0
1339220;Matt's Project Zombies: Open World;;100,000 - 200,000;9;8;1;0;0;0
1339260;末代侠客;;0 - 20,000;166;21;145;0;0;0
1339290;ZONEX;;0 - 20,000;2;0;2;0;0;0
1339310;Solitaire 3D;;0 - 20,000;11;0;11;0;0;0
1339330;Samurai Cooking;;20,000 - 50,000;41;9;32;0;0;0
1339360;Soulace;;0 - 20,000;7;3;4;0;0;0
1339370;MV Mazes;;0 - 20,000;1;1;0;0;0;0
1339410;雾之本境S Conspiracy Field: Fog Shadow;;50,000 - 100,000;272;75;197;0;0;0
1339450;Choco Pixel 6;;0 - 20,000;3;2;1;0;0;0
1339460;Dinosaur Fossil Hunter: Prologue;;50,000 - 100,000;514;128;386;0;0;2
1339500;Gym Tycoon;;0 - 20,000;65;17;48;0;0;1
1339550;Alien Cat 3;;0 - 20,000;22;4;18;0;0;0
1339580;Fox! Hen! Bag!;;20,000 - 50,000;157;9;148;0;0;0
1339620;Action SuperCross;;0 - 20,000;18;2;16;0;0;0
1339640;The Ice Caves;;0 - 20,000;135;21;114;0;0;0
1339650;CHV: VR Trunk Escape;;0 - 20,000;1;2;-1;0;0;0
1339670;Treasure of Cutuma 3rd;;0 - 20,000;7;2;5;0;0;0
1339750;Home: A Quarantine Story;;20,000 - 50,000;7;1;6;0;0;0
1339790;Battleground;;100,000 - 200,000;12;11;1;0;0;0
1339800;Seeker 2;;0 - 20,000;18;2;16;0;0;0
1339810;Slimey Champions;;50,000 - 100,000;0;1;-1;0;0;0
1339820;Flowers Garden Solitaire;;0 - 20,000;8;4;4;0;0;0
1339850;Karting Grand Prix Minigame;;0 - 20,000;20;1;19;0;0;0
1339860;Lumione;;0 - 20,000;380;102;278;11;11;0
1339870;The Last Saviour;;0 - 20,000;15;5;10;0;0;0
1339880;Kenbo;;0 - 20,000;4;3;1;0;0;0
1339900;BOT.vinnik Chess: Combination Lessons;;0 - 20,000;93;8;85;0;0;1
1339920;Freedom: How I Escaped;;0 - 20,000;27;6;21;0;0;0
1340020;Aster Fpv Drone Simulator;;200,000 - 500,000;9;4;5;0;0;0
1340080;Bunny Memory;;0 - 20,000;6;0;6;0;0;0
1340120;IxSHE Tell;;0 - 20,000;120;8;112;0;0;1
1340120;IxSHE Tell;;0 - 20,000;120;8;112;0;0;1
1340130;Aokana - Four Rhythms Across the Blue - EXTRA1;;20,000 - 50,000;955;13;942;270;270;6
1340180;Sherwood Extreme;;20,000 - 50,000;236;70;166;0;0;9
1340240;MORTE;;0 - 20,000;3;4;-1;0;0;0
1340260;Labyrinth of the Chaka King;;0 - 20,000;12;0;12;0;0;0
1340300;Crazy Kung Fu;;0 - 20,000;52;4;48;0;0;2
1340310;Nine Lives;;0 - 20,000;4;0;4;0;0;0
1340330;牝静的开端;;0 - 20,000;3;0;3;0;0;0
1340400;Solitaire. Elemental Wizards;;0 - 20,000;5;1;4;0;0;1
1340410;Carnage;;0 - 20,000;4;4;0;0;0;0
1340420;Slime Up;;0 - 20,000;5;2;3;0;0;0
1340440;Lost;;0 - 20,000;1;6;-5;0;0;0
1340470;Wait! Life is Beautiful! Prologue;;20,000 - 50,000;393;48;345;0;0;0
1340530;Mr. Prepper: Prologue;;200,000 - 500,000;1998;392;1606;39;41;3
1340540;Chimeras: Cherished Serpent Collector's Edition;;0 - 20,000;3;0;3;0;0;0
1340570;Golf On Mars;;0 - 20,000;29;1;28;0;0;0
1340640;HORROR TALES: The Wine;;0 - 20,000;290;63;227;0;0;0
1340730;Oath;;50,000 - 100,000;3;2;1;0;0;0
1340740;Kawaii Memory;;0 - 20,000;2;0;2;0;0;0
1340770;Artifacts;;0 - 20,000;4;2;2;0;0;0
1340810;The Night Fisherman;;100,000 - 200,000;660;126;534;0;0;0
1340820;Wreck the Insects;;0 - 20,000;1;0;1;0;0;0
1340850;韦弗利山 - Waverly Hills;;50,000 - 100,000;7;3;4;0;0;0
1340870;Limiter!;;0 - 20,000;5;0;5;0;0;0
1340910;From The Grave;;20,000 - 50,000;10;11;-1;0;0;0
1340950;Do Noob Corporate-slave Dream of Boss's Ass?;;0 - 20,000;3;0;3;0;0;0
1340980;Pop-It! Or Don't..;;0 - 20,000;8;0;8;0;0;0
1341050;BALAN WONDERWORLD;;20,000 - 50,000;204;139;65;0;0;1
1341080;Marie Antoinette's Solitaire;;0 - 20,000;5;3;2;0;0;0
1341090;Space Castle;;0 - 20,000;1;2;-1;0;0;0
1341100;Demonic Blade;;0 - 20,000;18;0;18;0;0;0
1341160;Infinite Tournament Paintball;;0 - 20,000;48;12;36;0;0;3
1341170;Strategic Mind: Spectre of Communism;;0 - 20,000;147;27;120;0;0;6
1341200;DYNASTY WARRIORS 9 Empires;;50,000 - 100,000;698;718;-20;1384;1925;102
1341210;Afterinfection;;0 - 20,000;248;118;130;0;0;0
1341220;BlackJack Math;;0 - 20,000;72;10;62;0;0;0
1341230;Super Buckyball Tournament Preseason;;200,000 - 500,000;1102;177;925;97;103;0
1341240;The Great Adventures of Hemeko & CH0_CH0;;0 - 20,000;2;0;2;0;0;0
1341250;Reiterland - Meine Rennpferde;;0 - 20,000;2;0;2;0;0;0
1341270;Die drei Freunde von der Reitschule;;0 - 20,000;4;0;4;0;0;0
1341280;Notre-Dame de Paris: Journey Back in Time;;20,000 - 50,000;47;15;32;1;1;0
1341290;We Were Here Forever;;200,000 - 500,000;7951;757;7194;683;656;300
1341300;Cocaine Dealer;;0 - 20,000;73;12;61;0;0;3
1341310;Space Pioneer;;0 - 20,000;5;0;5;0;0;0
1341330;Gatewalkers (Alpha);;20,000 - 50,000;672;124;548;0;0;0
1341400;Oniria Crimes;;200,000 - 500,000;37;1;36;0;0;0
1341440;World Process;;0 - 20,000;14;18;-4;0;0;1
1341450;Yolo Space Hacker;;0 - 20,000;174;6;168;0;0;7
1341460;Touhou DollDraft;;0 - 20,000;30;8;22;0;0;0
1341500;The Haunted Exmone Theatre;;0 - 20,000;3;1;2;0;0;0
1341620;ANCIENT EVIL;;0 - 20,000;12;6;6;0;0;0
1341630;Go, Go Cowboy;;0 - 20,000;16;4;12;0;0;0
1341640;Hard Driver;;0 - 20,000;15;7;8;0;0;0
1341650;Hard Driver 2;;20,000 - 50,000;12;10;2;0;0;0
1341650;Hard Driver 2;;20,000 - 50,000;12;10;2;0;0;0
1341660;ClickMonster;;20,000 - 50,000;17;18;-1;0;0;0
1341710;Nightmare Zone;;0 - 20,000;10;5;5;0;0;0
1341720;Alt254;;0 - 20,000;20;1;19;0;0;0
1341780;Super Huey III;;0 - 20,000;2;4;-2;0;0;1
1341820;As Dusk Falls;;50,000 - 100,000;1353;137;1216;410;410;28
1341830;Steel Thunder;;20,000 - 50,000;1;0;1;0;0;0
1341890;Corridor 7: Alien Invasion;;100,000 - 200,000;19;0;19;0;0;0
1341900;Castle on the Coast;;0 - 20,000;60;1;59;0;0;0
1341960;Fuhrer in LA - Special Edition;;100,000 - 200,000;65;8;57;0;0;0
1341980;Coronavirus - Nano Force;;20,000 - 50,000;4;4;0;0;0;0
1342040;Sylphy and the Sleepless Island;;0 - 20,000;130;13;117;348;348;6
1342050;Lisa and the Grimoire;;20,000 - 50,000;66;33;33;0;0;2
1342060;The Dead End;;0 - 20,000;105;50;55;0;0;3
1342070;The Triumphant Return of Diabolos;;0 - 20,000;40;12;28;0;0;2
1342080;The Maiden, the Butler, and the Witch;;0 - 20,000;28;5;23;0;0;58
1342090;PRIMITIVE HEARTS;;0 - 20,000;16;10;6;0;0;97
1342100;Evening Starter;;0 - 20,000;95;21;74;0;0;1
1342120;Castaway of the Ardusta Sea;;0 - 20,000;53;18;35;0;0;2
1342130;Riders 2491;;0 - 20,000;10;6;4;0;0;0
1342180;Bugz!;;20,000 - 50,000;1;0;1;0;0;0
1342220;Jurassic Fantasy;;20,000 - 50,000;8;1;7;0;0;0
1342240;GUNBARICH;;0 - 20,000;11;5;6;0;0;0
1342250;ZERO GUNNER 2-;;50,000 - 100,000;36;14;22;0;0;0
1342270;Nofrills Solitaire;;0 - 20,000;10;0;10;0;0;0
1342280;Story in the Dream World 2 –Water Gods and Spirits–;;20,000 - 50,000;2;2;0;0;0;0
1342330;Mad Games Tycoon 2;;200,000 - 500,000;3779;257;3522;1398;2312;220
1342340;MadGuns;;100,000 - 200,000;262;185;77;18;18;4
1342360;Everlasting Guilt;;0 - 20,000;16;1;15;0;0;0
1342410;[TDA02] Muv-Luv Unlimited: THE DAY AFTER - Episode 02 REMASTERED;;0 - 20,000;31;6;25;0;0;0
1342480;Hard Night VR;;0 - 20,000;17;10;7;0;0;0
1342500;Bananas Academy's Psyber;;0 - 20,000;3;1;2;0;0;0
1342520;Bad Apples;;0 - 20,000;0;1;-1;0;0;0
1342540;Orb and the Stars;;0 - 20,000;1;0;1;0;0;0
1342620;Werewolf: The Apocalypse — Heart of the Forest;;50,000 - 100,000;656;124;532;487;540;3
1342640;Relic Guardians: Complete;;20,000 - 50,000;3;0;3;0;0;0
1342660;Cobots;;0 - 20,000;23;0;23;0;0;0
1342730;Truzzle;;0 - 20,000;10;1;9;0;0;0
1342740;Moose Life;;0 - 20,000;83;2;81;0;0;1
1342750;Forsaken Barn;;0 - 20,000;1;2;-1;0;0;0
1342790;GangV | VR & PC Battle Royale;;20,000 - 50,000;319;170;149;62;62;0
1342810;United Assault - Normandy '44;;0 - 20,000;32;29;3;0;0;0
1342850;Bright Days in Quarantine;;0 - 20,000;24;5;19;0;0;0
1342890;Who Needs a Hero?;;50,000 - 100,000;1036;74;962;284;284;6
1342900;Basketing;;50,000 - 100,000;6;1;5;0;0;0
1342910;Winter's Trumpet;;0 - 20,000;4;0;4;0;0;0
1343040;Blocky Ball;;20,000 - 50,000;63;13;50;0;0;0
1343050;Duality of Doodles;;0 - 20,000;1;0;1;0;0;0
1343100;Life of Food;;0 - 20,000;1;0;1;0;0;0
1343110;Realms of Eternity;;20,000 - 50,000;3;4;-1;0;0;0
1343130;The Last Bug;;0 - 20,000;33;1;32;0;0;0
1343140;Choices That Matter: And The Sun Went Out;;20,000 - 50,000;12;5;7;0;0;0
1343150;Florida Simulator 1986;;0 - 20,000;24;3;21;0;0;0
1343240;Thymesia;;100,000 - 200,000;4148;661;3487;351;385;51
1343260;I dream of you and ice cream;;0 - 20,000;39;2;37;0;0;0
1343310;Space Wave Race;;0 - 20,000;1;0;1;0;0;0
1343330;Xendless;;20,000 - 50,000;0;1;-1;0;0;0
1343370;Old School RuneScape;;1,000,000 - 2,000,000;11676;1196;10480;576;27;1761
1343390;Detective Boiled-Hard / Case File - Death of the Space Dino Hunter;;0 - 20,000;4;1;3;0;0;0
1343400;RuneScape ;;1,000,000 - 2,000,000;17526;2534;14992;3711;49;5704
1343450;Whiskers & Tail;;0 - 20,000;2;0;2;0;0;0
1343510;Karakia Shooter;;20,000 - 50,000;1;0;1;0;0;0
1343520;Survival: Lost Way;;0 - 20,000;75;110;-35;59;59;1
1343550;Conflict Area;;0 - 20,000;41;7;34;0;0;0
1343580;Scary Hospital Horror Game;;0 - 20,000;13;11;2;0;0;0
1343620;Nemesis: Distress;;50,000 - 100,000;175;82;93;0;0;4
1343660;True Detective Solitaire;;0 - 20,000;7;1;6;0;0;1
1343670;Dealer's Life 2;;100,000 - 200,000;2526;464;2062;641;610;132
1343680;1001 Jigsaw: Earth Chronicles 2;;0 - 20,000;8;3;5;0;0;1
1343690;Santa's Toy Factory Nonograms;;0 - 20,000;3;2;1;0;0;0
1343700;Break Space: Out of Bounds;;100,000 - 200,000;11;1;10;0;0;0
1343750;Z-Race;;0 - 20,000;68;15;53;0;0;1
1343810;Fallen Hero: Retribution;;0 - 20,000;196;3;193;0;0;49
1343850;DR MILOS REVENGE;;0 - 20,000;8;2;6;0;0;0
1343920;Mighty Fling;;0 - 20,000;49;11;38;0;0;0
1343970;The Running Man;;0 - 20,000;61;28;33;0;0;0
1343990;Dooria;;0 - 20,000;9;2;7;0;0;0
1344070;Trollhunters: Defenders of Arcadia;;0 - 20,000;41;9;32;0;0;1
1344120;Bistro Days;;0 - 20,000;19;0;19;0;0;0
1344140;Viking Chronicles: Tale of the lost Queen;;0 - 20,000;10;2;8;0;0;0
1344170;Sudden Way;;0 - 20,000;3;0;3;0;0;0
1344210;Mysteries Of Darkness;;0 - 20,000;11;1;10;0;0;1
1344340;GALSAD - Galactic Salvage and Disposal;;50,000 - 100,000;2;0;2;0;0;0
1344350;SUCCUBUS: Prologue;;200,000 - 500,000;4304;905;3399;35;36;38
1344430;Kosta Projekt;;0 - 20,000;15;0;15;0;0;0
1344440;Spaceflux;;0 - 20,000;26;8;18;0;0;0
1344450;Black Smith2;;0 - 20,000;15;0;15;0;0;0
1344520;Apprentice Arriving;;100,000 - 200,000;5;1;4;0;0;0
1344530;vrkshop;;0 - 20,000;129;27;102;0;0;2
1344570;300k - The Game;;0 - 20,000;3;0;3;0;0;0
1344580;My Mind Ghost;;0 - 20,000;2;4;-2;0;0;0
1344630;Retrowave Hexon;;0 - 20,000;4;1;3;0;0;0
1344690;Crypt of the Gods;;0 - 20,000;2;0;2;0;0;0
1344740;FOOTSIES Rollback Edition;;20,000 - 50,000;360;7;353;86;86;5
1344760;Night Rogue;;50,000 - 100,000;1;0;1;0;0;0
1344780;Throwing Stone;;0 - 20,000;2;0;2;0;0;0
1344790;Unsung Kingdom;;50,000 - 100,000;59;7;52;0;0;1
1344800;Twin-Turbo Supercharged Nitro-Fueled Papamobile;;100,000 - 200,000;37;9;28;0;0;0
1344810;Homeland: Lay to Rest;;20,000 - 50,000;27;5;22;0;0;0
1344820;Stargaze;;20,000 - 50,000;20;6;14;0;0;0
1344830;Open The Chest 2;;0 - 20,000;5;0;5;0;0;0
1344840;AKER FERN;;20,000 - 50,000;69;18;51;0;0;0
1344860;Thrust Legend;;0 - 20,000;4;1;3;0;0;0
1344870;Zombie School Survival;;0 - 20,000;1;2;-1;0;0;0
1344890;GOD GAME;;0 - 20,000;4;4;0;0;0;0
1344900;OMG - One More Goal!;;0 - 20,000;1;0;1;0;0;0
1344930;MagVigor;;0 - 20,000;2;0;2;0;0;0
1344950;Lone King;;20,000 - 50,000;8;1;7;0;0;0
1344980;GUNPIG: Firepower For Hire;;0 - 20,000;1;3;-2;0;0;0
1345030;Bomber Games;;0 - 20,000;5;1;4;0;0;0
1345040;Girabox;;0 - 20,000;23;1;22;0;0;0
1345080;12 Hours to Die;;20,000 - 50,000;127;47;80;0;0;0
1345120;CreepWars TD;;0 - 20,000;24;3;21;0;0;0
1345140;Claw Crane Company;;0 - 20,000;8;1;7;0;0;1
1345150;Mushroom Challenge;;0 - 20,000;21;26;-5;0;0;0
1345180;NO MAN IS AN ISLAND;;0 - 20,000;4;2;2;0;0;0
1345190;Super Psy Penguin;;0 - 20,000;13;0;13;0;0;0
1345200;Pokie The Stickfigure;;0 - 20,000;2;1;1;0;0;0
1345220;LiveOnIdol;;0 - 20,000;6;8;-2;0;0;0
1345240;Shuffs;;0 - 20,000;1;0;1;0;0;0
1345280;Slide - Animal Race;;0 - 20,000;14;0;14;0;0;0
1345320;Deep Space Gardening;;0 - 20,000;17;4;13;0;0;1
1345350;Simply Puzzles: Junctions;;0 - 20,000;19;1;18;0;0;0
1345370;Promesa;;0 - 20,000;117;21;96;0;0;0
1345380;BiteVille;;0 - 20,000;29;20;9;0;0;0
1345390;Batallas Galacticas;;0 - 20,000;2;0;2;0;0;0
1345400;群鹰之岛;;0 - 20,000;17;3;14;0;0;0
1345440;Toy Tanks;;0 - 20,000;47;2;45;0;0;0
1345470;Lockheart Indigo;;50,000 - 100,000;90;1;89;0;0;0
1345520;Quiet Town;;0 - 20,000;1;2;-1;0;0;0
1345610;Sakura TTS;;0 - 20,000;10;6;4;0;0;0
1345730;江湖侠客令;;0 - 20,000;2;3;-1;0;0;0
1345740;恋爱绮谭~不存在的夏天~;;50,000 - 100,000;2219;89;2130;629;721;11
1345750;映夢 Dream;;0 - 20,000;37;7;30;0;0;0
1345760;Matchpoint - Tennis Championships;;0 - 20,000;97;45;52;0;0;4
1345770;Adventure Farm VR;;0 - 20,000;2;4;-2;0;0;0
1345810;mojica;;0 - 20,000;0;1;-1;0;0;0
1345820;Ragnarock;;50,000 - 100,000;2346;124;2222;189;177;26
1345830;迷宫：消灭机器人;;50,000 - 100,000;1;1;0;0;0;0
1345860;Grapple Dog;;0 - 20,000;288;28;260;0;0;1
1345860;Grapple Dog;;0 - 20,000;288;28;260;0;0;1
1345870;Franchise Hockey Manager 7;;0 - 20,000;193;58;135;0;0;21
1345890;Deliver Us Mars;;100,000 - 200,000;592;187;405;0;0;108
1345900;Space Defense Grid;;20,000 - 50,000;3;3;0;0;0;0
1345940;Anagrams;;0 - 20,000;10;3;7;0;0;0
1345950;HEPTAGON;;0 - 20,000;14;2;12;0;0;0
1345980;Survive.com;;100,000 - 200,000;4;4;0;0;0;0
1346010;RiMS Racing;;20,000 - 50,000;620;444;176;855;855;8
1346070;Sign of Silence;;200,000 - 500,000;1116;999;117;99;134;14
1346110;Rock Paper SHIFT;;0 - 20,000;7;0;7;0;0;0
1346120;My Lil Horror;;0 - 20,000;16;20;-4;0;0;0
1346130;ZOMBEEZ: A Killer Queen Remix;;0 - 20,000;12;4;8;0;0;0
1346170;PuppetShow: Fatal Mistake Collector's Edition;;0 - 20,000;4;1;3;0;0;0
1346210;Regrowth;;0 - 20,000;33;2;31;0;0;0
1346240;Sporadic Spire;;0 - 20,000;54;7;47;0;0;0
1346250;Slide Stories: Neko's Journey;;0 - 20,000;56;0;56;0;0;0
1346260;Another road;;0 - 20,000;14;11;3;0;0;0
1346300;RealFit (VR fitness);;0 - 20,000;7;0;7;0;0;0
1346310;Project Senko;;100,000 - 200,000;5;5;0;0;0;0
1346320;Metal Swarm Infinity;;0 - 20,000;3;0;3;0;0;0
1346320;Metal Swarm Infinity;;0 - 20,000;3;0;3;0;0;0
1346330;Flea!;;0 - 20,000;7;2;5;0;0;1
1346390;ASTRO AQUA KITTY;;0 - 20,000;52;5;47;0;0;1
1346400;Battle Engine Aquila;;50,000 - 100,000;68;6;62;0;0;0
1346420;Transpire;;0 - 20,000;17;0;17;0;0;0
1346460;Dungeoneers;;0 - 20,000;41;9;32;0;0;2
1346600;Elli;;20,000 - 50,000;21;3;18;0;0;0
1346630;Astronomia;;0 - 20,000;8;0;8;0;0;0
1346680;VR Astronomy and Geography Lab (Universe Spacecraft, Solar System, Earth, Moon, Relativity, Flying over the World, etc);;0 - 20,000;8;4;4;0;0;0
1346700;Soccer Adventures;;0 - 20,000;8;0;8;0;0;0
1346740;荧火微光;;0 - 20,000;54;15;39;296;296;0
1346770;YAKIMOCHI STREAM;;0 - 20,000;103;8;95;721;721;1
1346790;Fly Fish;;0 - 20,000;3;3;0;0;0;0
1346800;PERFECT MATTER;;50,000 - 100,000;12;0;12;0;0;0
1346830;I Saw Black Clouds;;20,000 - 50,000;272;161;111;924;924;3
1346850;VRWorkout;;20,000 - 50,000;17;2;15;0;0;0
1346860;Spirit of dungeon;;0 - 20,000;2;3;-1;0;0;0
1346890;Motoride Rollercoaster VR;;0 - 20,000;47;16;31;0;0;1
1346960;The Divine Invasion;;20,000 - 50,000;173;41;132;0;0;0
1346980;Lawnmower Game: Next Generation;;0 - 20,000;135;13;122;0;0;0
1347010;Dim Glow;;20,000 - 50,000;7;3;4;0;0;0
1347030;THE CORRIDOR;;100,000 - 200,000;1559;93;1466;24;24;7
1347130;Kinetic Edge;;0 - 20,000;20;5;15;0;0;0
1347140;NEAR DEADline;;50,000 - 100,000;63;7;56;0;0;0
1347170;Analog Party Sim;;0 - 20,000;2;0;2;0;0;0
1347240;Suez Canal Simulator;;0 - 20,000;2;2;0;0;0;0
1347350;Killing Sun / 抗日大刀队：日军总部;;0 - 20,000;9;3;6;0;0;0
1347360;Midnight Renegade;;0 - 20,000;13;2;11;0;0;0
1347390;Beaver Fun River Run - Steam Edition;;0 - 20,000;1;0;1;0;0;0
1347430;Cute Honey;;200,000 - 500,000;4380;440;3940;236;49;10
1347450;日日夜夜;;0 - 20,000;265;23;242;0;0;1
1347460;Dark Cards;;0 - 20,000;16;6;10;0;0;0
1347490;箱庭小相撲;;0 - 20,000;1;2;-1;0;0;1
1347540;Sky Fleet;;0 - 20,000;22;20;2;0;0;0
1347550;Tiny Combat Arena;;20,000 - 50,000;933;107;826;44;44;9
1347580;シルヴァリオ トリニティ-Beyond the Horizon-;;0 - 20,000;8;0;8;0;0;0
1347590;シルヴァリオ ヴェンデッタ-Verse of Orpheus-;;0 - 20,000;11;0;11;0;0;0
1347600;Dad's Monster House;;0 - 20,000;123;5;118;0;0;1
1347690;Groove Balls;;0 - 20,000;2;0;2;0;0;0
1347700;Spherical alliance;;0 - 20,000;2;0;2;0;0;0
1347710;Sink;;20,000 - 50,000;1;1;0;0;0;0
1347760;Clash II;;0 - 20,000;24;8;16;0;0;0
1347780;Freedom Fighters;;100,000 - 200,000;1142;55;1087;18;18;13
1347880;Beholder's Lair;;0 - 20,000;14;2;12;0;0;0
1347960;Enga Extreme Battle Race;;0 - 20,000;5;0;5;0;0;0
1347970;Patch Quest;;20,000 - 50,000;498;10;488;0;0;14
1348030;Planta;;0 - 20,000;13;14;-1;0;0;0
1348160;Turn on the light;;0 - 20,000;134;5;129;0;0;0
1348180;From Frontier;;20,000 - 50,000;242;2;240;1052;1052;3
1348220;Colorize;;0 - 20,000;5;2;3;0;0;0
1348240;Snow Trail;;0 - 20,000;4;0;4;0;0;0
1348250;Tank Quest;;20,000 - 50,000;11;0;11;0;0;0
1348260;This Throne Is Mine - The Card Game;;0 - 20,000;4;0;4;0;0;0
1348270;Fingers: Mini Games;;0 - 20,000;29;1;28;0;0;0
1348300;大千世界;;200,000 - 500,000;2004;291;1713;5450;5450;42
1348380;God Hates Us;;0 - 20,000;7;4;3;0;0;0
1348400;Red Dust;;0 - 20,000;10;1;9;0;0;0
1348430;Chicken Bomb;;0 - 20,000;68;2;66;0;0;0
1348480;Viking Butcher;;20,000 - 50,000;28;4;24;0;0;0
1348510;问道仙途;;0 - 20,000;25;12;13;0;0;0
1348520;Saving Mr. Sparkles;;0 - 20,000;3;2;1;0;0;0
1348680;Meow Pow;;20,000 - 50,000;44;6;38;0;0;0
1348690;Oaken;;0 - 20,000;130;24;106;198;198;5
1348700;Spice&Wolf VR2;;20,000 - 50,000;446;12;434;35;35;2
1348750;Hearts of the Dungeon List;;0 - 20,000;16;1;15;0;0;0
1348760;KARM;;0 - 20,000;19;2;17;0;0;0
1348770;Captain MAYO;;0 - 20,000;2;1;1;0;0;0
1348800;PROJECTIONS;;0 - 20,000;56;1;55;0;0;0
1348810;Down the River;;0 - 20,000;1;0;1;0;0;0
1348880;Restricted Area;;0 - 20,000;2;21;-19;0;0;0
1348920;Wind Peaks;;20,000 - 50,000;227;46;181;0;0;2
1348930;Rockjack;;0 - 20,000;5;0;5;0;0;0
1348960;Tetron;;0 - 20,000;3;0;3;0;0;0
1348970;Ego In A Coma (自我、状態、昏睡。);;100,000 - 200,000;270;59;211;0;0;0
1348980;The Surreal Imaginarium;;0 - 20,000;9;4;5;0;0;0
1348990;Button Lock;;0 - 20,000;4;1;3;0;0;0
1349000;Jigsaw Puzzle - Animals;;0 - 20,000;32;2;30;0;0;0
1349060;It Steals;;50,000 - 100,000;779;6;773;59;59;3
1349070;Rollfall: Quest of Acceleration;;0 - 20,000;0;1;-1;0;0;0
1349070;Rollfall: Quest of Acceleration;;0 - 20,000;0;1;-1;0;0;0
1349100;GALAXY CRISIS;;0 - 20,000;4;3;1;0;0;0
1349120;球球少女/Pinball Girls;;20,000 - 50,000;718;152;566;128;159;1
1349130;Fear of The Unknown;;20,000 - 50,000;11;4;7;0;0;0
1349170;Furries & Scalies & Bears OH MY! 2: Return to Kale Bay;;0 - 20,000;3;0;3;0;0;0
1349230;5D Chess With Multiverse Time Travel;;500,000 - 1,000,000;5508;169;5339;133;147;54
1349290;BAFF F;;0 - 20,000;3;0;3;0;0;0
1349340;Alias;;0 - 20,000;0;2;-2;0;0;0
1349390;Sweet Love;;0 - 20,000;8;1;7;0;0;0
1349540;DPS IDLE;;100,000 - 200,000;339;211;128;554;685;101
1349620;Humans V Zombies;;0 - 20,000;7;15;-8;0;0;0
1349640;Alien Function;;20,000 - 50,000;8;1;7;0;0;0
1349720;Carom Billiards;;0 - 20,000;1;7;-6;0;0;0
1349740;First Floor;;0 - 20,000;1;5;-4;0;0;0
1349790;CORGIX;;0 - 20,000;1;1;0;0;0;0
1349830;RONIN: Two Souls CHAPTER 1;;50,000 - 100,000;227;40;187;0;0;0
1349890;The last earth man;;0 - 20,000;6;0;6;0;0;0
1349920;Caterpillarnoid;;20,000 - 50,000;87;13;74;0;0;1
1349940;Hardbass Clicker;;0 - 20,000;13;2;11;0;0;0
1349960;[Chilla's Art] The Ghost Train | 幽霊列車;;0 - 20,000;309;71;238;146;146;3
1350010;Dinosaur Hunting Patrol 3D Jurassic VR;;0 - 20,000;0;1;-1;0;0;0
1350030;Wizards Of The West;;0 - 20,000;2;0;2;0;0;0
1350060;Eternal Pain: Epiphany;;0 - 20,000;7;3;4;0;0;0
1350080;ABC: Audioreactive Beat Circle;;0 - 20,000;25;9;16;0;0;0
1350100;RUNOUT;;0 - 20,000;20;1;19;0;0;0
1350120;Story;;20,000 - 50,000;7;6;1;0;0;0
1350170;EscapeVr;;0 - 20,000;4;5;-1;0;0;0
1350200;IMMORTALITY;;100,000 - 200,000;749;140;609;0;0;25
1350210;Alien's Armageddon;;0 - 20,000;1;3;-2;0;0;0
1350240;Critters for Sale: SNAKE;;0 - 20,000;59;4;55;0;0;0
1350280;Jonas Willy Online;;0 - 20,000;9;0;9;0;0;0
1350300;PURRfection!  The cat tossing game!!;;0 - 20,000;2;0;2;0;0;0
1350340;Simp Simulator;;20,000 - 50,000;211;39;172;0;0;0
1350350;Touhou Gensokyo Visitor;;0 - 20,000;188;6;182;0;0;0
1350390;Brain Test;;0 - 20,000;9;5;4;0;0;0
1350430;Ravensword: Undaunted;;0 - 20,000;38;19;19;0;0;0
1350440;Cardful Planning;;0 - 20,000;10;0;10;0;0;0
1350470;Impossible Target;;20,000 - 50,000;1;0;1;0;0;0
1350500;Last Memory;;0 - 20,000;9;4;5;0;0;0
1350540;Rebel Reenactment: Battle of the Wilderness;;20,000 - 50,000;10;2;8;0;0;0
1350560;Catch It;;0 - 20,000;3;4;-1;0;0;1
1350570;Missile Tank;;0 - 20,000;13;2;11;0;0;0
1350580;Poly Race;;0 - 20,000;3;1;2;0;0;0
1350590;Default Unreal Physics and Assets AKA DUPA Project;;0 - 20,000;1;0;1;0;0;0
1350630;American Isekai Prologue;;20,000 - 50,000;7;3;4;0;0;0
1350690;흡혈귀의 연애방법;;0 - 20,000;3;2;1;0;0;0
1350780;Orbital Strike VR;;0 - 20,000;6;0;6;0;0;0
1350810;Total Rendition;;0 - 20,000;1;1;0;0;0;0
1350820;コモラ・リアルワールドエスケープ;;0 - 20,000;11;2;9;0;0;0
1350850;Dreamland Solitaire: Dark Prophecy;;0 - 20,000;24;5;19;0;0;1
1350860;归途;;0 - 20,000;3;0;3;0;0;0
1350920;Liege Dragon;;100,000 - 200,000;4;0;4;0;0;0
1351070;Pest Control;;0 - 20,000;13;5;8;0;0;0
1351080;Pharaoh: A New Era;;100,000 - 200,000;762;345;417;301;328;4986
1351120;Le Voyage de Toki;;0 - 20,000;2;0;2;0;0;0
1351140;KAPIA;;0 - 20,000;65;2;63;0;0;1
1351170;東方催狐譚 ～ Servants of Harvest Wish;;50,000 - 100,000;312;9;303;0;0;4
1351180;Voyager;;0 - 20,000;4;0;4;0;0;0
1351200;Museum of War;;0 - 20,000;3;0;3;0;0;0
1351220;Escape Room VR: Inner Voices;;0 - 20,000;4;5;-1;0;0;0
1351250;Secrets of Magic 3: Happy Halloween;;0 - 20,000;11;0;11;0;0;0
1351250;Secrets of Magic 3: Happy Halloween;;0 - 20,000;11;0;11;0;0;0
1351290;AccidentHouse;;0 - 20,000;60;19;41;0;0;0
1351300;Аlien cat 4;;0 - 20,000;11;0;11;0;0;0
1351310;Hungry Boy;;0 - 20,000;4;1;3;0;0;0
1351350;Specimen 13;;0 - 20,000;11;1;10;0;0;0
1351360;DevLife;;0 - 20,000;45;15;30;0;0;0
1351370;Sakura Knight 3;;0 - 20,000;47;13;34;0;0;3
1351400;Canvas Hockey;;0 - 20,000;33;2;31;0;0;0
1351450;Steel Fury Kharkov 1942;;0 - 20,000;92;45;47;0;0;2
1351470;Chroma Chronicles;;0 - 20,000;30;1;29;0;0;0
1351500;SimPocalypse;;0 - 20,000;69;30;39;0;0;1
1351510;Kindred Fates: Combat Arena Alpha;;0 - 20,000;15;3;12;0;0;0
1351550;Haunted Hotel: Lost Time Collector's Edition;;0 - 20,000;13;3;10;0;0;0
1351560;Maze: Sinister Play Collector's Edition;;0 - 20,000;13;1;12;0;0;0
1351580;Hillmain Hotel;;0 - 20,000;0;2;-2;0;0;0
1351630;Ys IX: Monstrum Nox;;20,000 - 50,000;1225;66;1159;2231;2242;22
1351650;No Cure;;0 - 20,000;4;0;4;0;0;0
1351720;Sharks of Mars: Prologue;;0 - 20,000;3;3;0;0;0;0
1351840;Onmyoudou - Arcade Edition;;0 - 20,000;4;0;4;0;0;0
1351870;PICK ME UP! - Rescue Rangers -;;0 - 20,000;2;0;2;0;0;0
1351880;F.U.B.A.R;;0 - 20,000;12;12;0;0;0;0
1351900;Dungeon Core;;0 - 20,000;33;3;30;0;0;0
1351950;Projectile Dysfunction;;0 - 20,000;37;10;27;0;0;0
1351960;Pumpkin Farmer;;0 - 20,000;11;0;11;0;0;0
1351980;2945VR;;0 - 20,000;3;1;2;0;0;0
1352000;World Puzzle;;0 - 20,000;3;16;-13;0;0;0
1352010;Cursed Mummies;;0 - 20,000;8;9;-1;0;0;0
1352020;Yupitergrad;;0 - 20,000;49;3;46;0;0;0
1352040;Fury Captain;;0 - 20,000;4;14;-10;0;0;0
1352040;Fury Captain;;0 - 20,000;4;14;-10;0;0;0
1352070;Truck Crash;;0 - 20,000;4;8;-4;0;0;0
1352130;Nonsense Soccer;;0 - 20,000;8;0;8;0;0;0
1352180;Rugida;;0 - 20,000;9;2;7;0;0;0
1352200;Detective From The Crypt;;0 - 20,000;100;5;95;0;0;4
1352230;1917 : The Prologue;;0 - 20,000;19;12;7;0;0;0
1352300;Jubeez;;20,000 - 50,000;4;2;2;0;0;1
1352330;Zoo 2: Animal Park;;50,000 - 100,000;738;194;544;141;141;123
1352340;Rolling Hamster;;0 - 20,000;32;1;31;0;0;0
1352380;Guts 'N Goals: Preseason;;20,000 - 50,000;26;9;17;0;0;0
1352440;Brick Building;;100,000 - 200,000;29;16;13;0;0;1
1352450;Caterva;;0 - 20,000;1;1;0;0;0;0
1352470;Carrot Heart;;0 - 20,000;9;2;7;0;0;0
1352480;Spell Karts;;0 - 20,000;0;1;-1;0;0;0
1352520;Soldier Warfare;;0 - 20,000;22;16;6;0;0;0
1352530;Ronald's Run;;0 - 20,000;3;4;-1;0;0;0
1352540;Sentience;;0 - 20,000;74;23;51;0;0;0
1352560;Cartridge Monsters;;20,000 - 50,000;12;2;10;0;0;0
1352590;Requiem Aeternam Eden;;20,000 - 50,000;2;0;2;0;0;0
1352650;Bomber;;0 - 20,000;0;1;-1;0;0;0
1352660;PUFIWEHO;;50,000 - 100,000;9;1;8;0;0;0
1352680;Winter War 1939;;0 - 20,000;91;13;78;0;0;0
1352730;Twin Horizons;;0 - 20,000;2;1;1;0;0;0
1352740;DF-41 Simulator;;0 - 20,000;90;81;9;0;0;1
1352750;Comic&Picture Shelf;;0 - 20,000;31;5;26;0;0;0
1352850;Citystate II;;20,000 - 50,000;551;190;361;1903;3065;26
1352870;Stoirs VR;;0 - 20,000;2;0;2;0;0;0
1352910;春と修羅｜Haru to Shura;;0 - 20,000;56;6;50;0;0;0
1352930;HAAK;;50,000 - 100,000;1549;166;1383;803;1550;46
1353040;The first titans;;0 - 20,000;1;0;1;0;0;0
1353050;My Isekai After Life is an RPG!?;;20,000 - 50,000;5;8;-3;0;0;0
1353050;My Isekai After Life is an RPG!?;;20,000 - 50,000;5;8;-3;0;0;0
1353100;SCP: The Foundation;;50,000 - 100,000;162;163;-1;0;0;1
1353120;ココロクローバー パート１/Kokoro Clover Part1;;0 - 20,000;71;7;64;0;0;0
1353130;Hoplichess;;50,000 - 100,000;0;1;-1;0;0;0
1353160;The Night of Joe;;0 - 20,000;4;1;3;0;0;0
1353180;AIDA: The Beginning of the Story;;0 - 20,000;5;3;2;0;0;0
1353250;Infected zone 感染之地;;0 - 20,000;18;11;7;0;0;0
1353270;Five Dates;;100,000 - 200,000;1691;221;1470;218;242;54
1353300;Idle Slayer;;200,000 - 500,000;3281;555;2726;3752;860;1155
1353310;Monster Blast;;0 - 20,000;2;0;2;0;0;0
1353330;Super CosmoJet;;20,000 - 50,000;5;0;5;0;0;0
1353370;The Peresmeshnik;;20,000 - 50,000;81;3;78;0;0;0
1353470;Super Indie Square - Fight Against Time;;0 - 20,000;12;0;12;0;0;0
1353550;Balacera Brothers;;0 - 20,000;17;1;16;0;0;0
1353670;Throw It;;0 - 20,000;5;8;-3;0;0;0
1353680;三国吕布传说(Legend of Lv Bu of the Three Kingdoms);;0 - 20,000;55;16;39;0;0;0
1353690;Mini Army Tactics Medieval;;0 - 20,000;1;0;1;0;0;0
1353710;BitFlipClock-桌面翻页时钟;;0 - 20,000;18;4;14;0;0;4
1353730;送外卖模拟器 Delivery Simulator;;0 - 20,000;6;4;2;0;0;0
1353790;Neko Ghost, Jump! Prologue;;0 - 20,000;19;0;19;0;0;0
1353830;Horrors of Space;;0 - 20,000;23;13;10;0;0;0
1353850;Monster Shooter;;0 - 20,000;1;11;-10;0;0;0
1353870;WestLand Adventure;;0 - 20,000;11;12;-1;0;0;0
1353880;Unicorn Dream;;0 - 20,000;11;10;1;0;0;0
1353920;High School Odyssey;;20,000 - 50,000;358;23;335;0;0;4
1353950;Ring of Fire: Prologue;;1,000,000 - 2,000,000;10;2;8;0;0;0
1354000;Abyss of Death;;0 - 20,000;3;5;-2;0;0;0
1354070;Bloodway Infinity;;0 - 20,000;3;0;3;0;0;0
1354080;The Horrors at Castle Wülhein;;50,000 - 100,000;1;2;-1;0;0;0
1354100;A Lozenge;;0 - 20,000;36;1;35;0;0;0
1354230;Love Tavern;;20,000 - 50,000;449;171;278;239;239;4
1354240;Hunting Moon vol.2;;0 - 20,000;39;12;27;0;0;0
1354270;Match Match Mania!;;50,000 - 100,000;2;0;2;0;0;0
1354300;Club Soccer Director 2021;;20,000 - 50,000;78;57;21;0;0;1
1354370;Bound Forest Alpha;;50,000 - 100,000;31;9;22;0;0;0
1354420;The protectors of Deya;;20,000 - 50,000;2;0;2;0;0;0
1354460;miniStrike;;0 - 20,000;3;1;2;0;0;0
1354510;Traphouse Druglord;;0 - 20,000;10;1;9;0;0;0
1354520;Wild Honesty: A party game for deeper conversations;;0 - 20,000;17;4;13;0;0;0
1354530;Ultikill;;50,000 - 100,000;7;1;6;0;0;0
1354540;Arcaxer;;50,000 - 100,000;17;2;15;0;0;0
1354580;Urban Survival;;0 - 20,000;8;0;8;0;0;0
1354690;Girls' civilization 2;;0 - 20,000;17;11;6;0;0;0
1354750;A-Star Theft;;0 - 20,000;10;0;10;0;0;0
1354800;Really Bad Flying Machine;;0 - 20,000;1;0;1;0;0;0
1354830;Cat Cafe Manager;;50,000 - 100,000;1093;169;924;0;0;62
1354840;Parking Attendant;;0 - 20,000;3;8;-5;0;0;0
1354910;Tiny Lands;;20,000 - 50,000;687;47;640;89;89;6
1354940;Outsider: After Life;;0 - 20,000;16;3;13;0;0;0
1354970;DNA Farm;;0 - 20,000;1;0;1;0;0;0
1354990;Dungeons of Voidria;;0 - 20,000;28;2;26;0;0;5
1355010;Girls Memory Card;;0 - 20,000;10;5;5;0;0;0
1355020;Human Or Virus;;0 - 20,000;6;11;-5;0;0;0
1355050;Traurig Secrets: Prologue;;20,000 - 50,000;16;2;14;0;0;0
1355070;Aenaon;;0 - 20,000;1;0;1;0;0;0
1355140;Police Chase;;0 - 20,000;27;9;18;0;0;0
1355240;Being Centered;;0 - 20,000;2;2;0;0;0;0
1355290;회사 키우기;;0 - 20,000;1;2;-1;0;0;0
1355300;Swallow The Blue;;20,000 - 50,000;3;1;2;0;0;0
1355310;Nightmare Puppeteer;;0 - 20,000;44;5;39;0;0;0
1355390;Obreno: Chapter One;;50,000 - 100,000;5;4;1;0;0;0
1355400;The Line;;0 - 20,000;5;3;2;0;0;0
1355410;Five Steps From Hell;;0 - 20,000;6;0;6;0;0;0
1355420;Pixboy;;0 - 20,000;9;1;8;0;0;0
1355430;The Outcast Lovers;;0 - 20,000;46;20;26;0;0;0
1355430;The Outcast Lovers;;0 - 20,000;46;20;26;0;0;0
1355440;开局一把剑;;0 - 20,000;25;10;15;0;0;21
1355450;Dungeon Island;;0 - 20,000;1;4;-3;0;0;0
1355470;The importance of choosing: second chance;;0 - 20,000;0;3;-3;0;0;0
1355510;Rogue Summoner;;0 - 20,000;21;4;17;0;0;0
1355560;Aloof;;0 - 20,000;28;0;28;0;0;0
1355570;Dungeons & Guns;;0 - 20,000;17;1;16;0;0;0
1355590;War Machine;;0 - 20,000;0;1;-1;0;0;0
1355610;I_Darkness;;0 - 20,000;2;1;1;0;0;0
1355620;Mage Rage;;0 - 20,000;17;3;14;0;0;0
1355630;Connect-X;;0 - 20,000;2;0;2;0;0;0
1355640;SYNTHSPACE;;0 - 20,000;28;3;25;0;0;0
1355650;Filcher;;0 - 20,000;116;4;112;0;0;2
1355720;Henosis;;0 - 20,000;4;0;4;0;0;0
1355760;投资模拟器：打工人;;50,000 - 100,000;594;355;239;231;365;3
1355770;BATTLECASTER;;0 - 20,000;0;1;-1;0;0;0
1355780;Crushed;;0 - 20,000;80;69;11;0;0;1
1355820;大话江湖;;20,000 - 50,000;5;4;1;0;0;0
1355830;Return to Earth 2130;;0 - 20,000;0;4;-4;0;0;0
1355880;SpermDash精疲力尽;;0 - 20,000;75;6;69;0;0;0
1355910;Wolf Territory;;0 - 20,000;4;9;-5;0;0;0
1355930;Escape the Clinic;;50,000 - 100,000;284;111;173;0;0;0
1355980;Minimal Maze;;0 - 20,000;22;2;20;0;0;0
1356040;Ampersat;;50,000 - 100,000;38;5;33;0;0;2
1356070;模拟练枪;;0 - 20,000;2;7;-5;0;0;0
1356080;Hot-air VR Balloon trip over Russian Primorye;;20,000 - 50,000;11;9;2;0;0;0
1356110;EaseUS Todo Backup Home;;0 - 20,000;10;1;9;0;0;0
1356160;Andromeda One Zombies;;50,000 - 100,000;23;31;-8;0;0;0
1356180;Mahjong Nagomi;;20,000 - 50,000;166;35;131;0;0;8
1356190;Warehouse Simulator;;0 - 20,000;11;29;-18;0;0;0
1356240;Who Wants To Be A Millionaire;;0 - 20,000;104;107;-3;0;0;2
1356260;Snack Tick;;0 - 20,000;7;2;5;0;0;0
1356280;Kitaria Fables;;50,000 - 100,000;786;255;531;128;179;41
1356300;Butterfly 3. Funny Twins.;;0 - 20,000;6;1;5;0;0;0
1356360;Exploaris: Vermis story;;0 - 20,000;3;1;2;0;0;0
1356380;Pendelum;;20,000 - 50,000;3;1;2;0;0;0
1356440;Kidnapped! A Royal Birthday;;20,000 - 50,000;11;11;0;0;0;0
1356460;Commander '85 Prologue;;50,000 - 100,000;10;6;4;23;23;0
1356470;The Rooster's Chess;;20,000 - 50,000;3;4;-1;0;0;0
1356480;helionaut;;0 - 20,000;80;4;76;150;150;0
1356530;Mystery Hotel - Hidden Object Detective Game;;0 - 20,000;41;11;30;0;0;2
1356580;Guild of Darksteel;;0 - 20,000;20;9;11;0;0;1
1356610;Hidden Expedition: The Price of Paradise Collector's Edition;;0 - 20,000;6;1;5;0;0;1
1356640;Magical Cat Cafe and Heroes;;0 - 20,000;0;3;-3;0;0;0
1356670;Sakuna: Of Rice and Ruin;;100,000 - 200,000;3921;295;3626;757;1087;95
1356750;Doctor Lee;;0 - 20,000;1;0;1;0;0;0
1356760;The Spectre Files: Deathstalker;;0 - 20,000;18;0;18;0;0;0
1356790;Exp Parasite;;0 - 20,000;1;0;1;0;0;0
1356800;Keepers of the Trees;;0 - 20,000;44;26;18;0;0;3
1356830;Stone it!;;0 - 20,000;2;0;2;0;0;0
1356860;Project Boost;;20,000 - 50,000;11;1;10;0;0;2
1356860;Project Boost;;20,000 - 50,000;11;1;10;0;0;2
1356880;Factory of Sweets;;0 - 20,000;5;6;-1;0;0;0
1356890;Dangerous Zone;;0 - 20,000;2;9;-7;0;0;0
1356970;Escape from Poalet;;20,000 - 50,000;6;0;6;0;0;0
1357000;Above the Stars;;0 - 20,000;12;2;10;0;0;0
1357020;完美电路 Electric Circuit;;0 - 20,000;2;1;1;0;0;0
1357090;Button Soccer League;;0 - 20,000;12;0;12;0;0;0
1357150;Gassy Man;;0 - 20,000;3;2;1;0;0;0
1357190;Conjurer Andy's Repeatable Dungeon;;0 - 20,000;0;2;-2;0;0;0
1357200;Zeko;;0 - 20,000;2;0;2;0;0;0
1357220;PogoChamp;;0 - 20,000;31;1;30;0;0;3
1357230;Color Buster!;;0 - 20,000;0;1;-1;0;0;0
1357270;Proto Cuckoo 64;;0 - 20,000;3;2;1;0;0;0
1357280;Sheep Island;;0 - 20,000;2;0;2;0;0;0
1357390;Finding 21;;0 - 20,000;0;1;-1;0;0;0
1357400;Skydom;;20,000 - 50,000;6;2;4;0;0;0
1357410;Road Z : The Last Drive;;0 - 20,000;28;25;3;0;0;0
1357430;Rocket Rumble;;0 - 20,000;25;2;23;0;0;4
1357490;Gunboat;;50,000 - 100,000;3;0;3;0;0;0
1357540;Altered Destiny;;50,000 - 100,000;3;0;3;0;0;0
1357550;Psi 5 Trading Company;;0 - 20,000;2;0;2;0;0;1
1357580;XF5700 Mantis Experimental Fighter;;50,000 - 100,000;2;0;2;0;0;0
1357610;Desktop Farm;;50,000 - 100,000;475;166;309;1;1;8
1357640;Olympic Boxing;;0 - 20,000;0;2;-2;0;0;0
1357650;Free Fluid Engine PC Live Wallpaper;;0 - 20,000;6;1;5;0;0;1
1357710;Excalibots;;0 - 20,000;22;13;9;0;0;0
1357750;Box Factory;;0 - 20,000;13;3;10;0;0;0
1357870;Metel - Horror Escape;;20,000 - 50,000;558;31;527;0;0;7
1357890;Son of Aral;;0 - 20,000;9;1;8;0;0;0
1357930;Whirlibird;;0 - 20,000;6;0;6;0;0;0
1357960;The Dragon Sword;;0 - 20,000;3;7;-4;0;0;0
1357990;Unfolded : Camellia Tales;;0 - 20,000;12;3;9;0;0;0
1358000;_OUR_:_Defense 2021;;0 - 20,000;0;1;-1;0;0;0
1358020;41 Hours;;0 - 20,000;15;10;5;0;0;0
1358030;Shooting Arena VR;;0 - 20,000;27;1;26;0;0;0
1358050;Sanatorium «Anthropocene Retreat»;;100,000 - 200,000;2;2;0;0;0;0
1358100;Directional Isolation VR;;20,000 - 50,000;2;2;0;0;0;0
1358140;Cooking Simulator VR;;50,000 - 100,000;921;184;737;113;110;17
1358180;Gerrymander Madness;;0 - 20,000;6;0;6;0;0;0
1358260;Conqueror 940 AD;;0 - 20,000;28;8;20;0;0;5
1358320;Corg of the Dead;;0 - 20,000;5;0;5;0;0;0
1358430;War War;;20,000 - 50,000;1;0;1;0;0;0
1358490;Ash & Rust;;50,000 - 100,000;20;4;16;0;0;0
1358510;Snake In The Cube;;0 - 20,000;1;2;-1;0;0;0
1358530;Saint Kotar;;20,000 - 50,000;104;27;77;14969;14969;1
1358540;Pink Gum;;0 - 20,000;33;2;31;0;0;0
1358570;Fort Golf;;0 - 20,000;6;0;6;0;0;0
1358590;Gravity SQUARE -グラビティ スクエア-;;0 - 20,000;1;0;1;0;0;0
1358610;Make the Burger;;0 - 20,000;54;17;37;0;0;0
1358630;Ski Doom VR;;0 - 20,000;12;5;7;0;0;0
1358640;Penny's Path;;0 - 20,000;8;4;4;0;0;0
1358650;Queen's Conquest;;0 - 20,000;3;2;1;0;0;0
1358710;Battle Cry of Freedom;;20,000 - 50,000;1259;355;904;1001;1001;45
1358730;Over'n Over;;0 - 20,000;3;2;1;0;0;0
1358760;Portability;;0 - 20,000;5;0;5;0;0;0
1358770;The falling tower;;0 - 20,000;4;6;-2;0;0;0
1358800;projectM Music Visualizer;;0 - 20,000;180;10;170;0;0;19
1358830;Operator;;0 - 20,000;20;3;17;0;0;0
1358840;Flat Eye;;50,000 - 100,000;72;17;55;0;0;9
1358860;Groove Fit Kingdom!;;0 - 20,000;14;5;9;0;0;0
1358880;Liberated: Free Trial;;200,000 - 500,000;11;2;9;0;0;0
1358940;Stormblades;;0 - 20,000;3;4;-1;0;0;0
1358990;Space Shooter;;0 - 20,000;4;1;3;0;0;0
1359000;GUN DOG ROCK RAPID;;0 - 20,000;5;0;5;0;0;0
1359020;Vermitron;;0 - 20,000;13;4;9;0;0;0
1359080;Dragon Drop: Tabletop Multi-tool;;0 - 20,000;12;3;9;0;0;0
1359090;Zero Hour;;500,000 - 1,000,000;19817;4849;14968;478;312;236
1359120;The Dungeon Beneath;;20,000 - 50,000;457;65;392;0;0;32
1359160;Rocket Bots;;0 - 20,000;38;10;28;0;0;0
1359170;Killer Dog;;0 - 20,000;9;3;6;0;0;0
1359300;Knights and Dungeons;;50,000 - 100,000;88;26;62;0;0;0
1359310;Trenchlore;;0 - 20,000;13;1;12;0;0;0
1359340;Fairy Bubble;;0 - 20,000;1;0;1;0;0;0
1359440;The Game of The Playful;;0 - 20,000;4;5;-1;0;0;0
1359450;Choco Pixel 7;;0 - 20,000;4;0;4;0;0;0
1359470;Kawaii Girl 2;;0 - 20,000;163;94;69;34;34;0
1359520;ENCODE;;50,000 - 100,000;21;21;0;0;0;0
1359650;The Last of Waifus;;100,000 - 200,000;1144;257;887;108;108;0
1359720;Turbo Machines Mini Racing;;0 - 20,000;0;1;-1;0;0;0
1359740;CyberLink PowerDirector 19 Ultimate;;0 - 20,000;7;2;5;0;0;4
1359750;CyberLink PowerDirector 19 Ultra;;0 - 20,000;8;0;8;0;0;2
1359760;Hadr;;0 - 20,000;45;6;39;0;0;1
1359770;CyberLink PhotoDirector 12 Ultra;;0 - 20,000;2;5;-3;0;0;0
1359800;The Soldiers Factory;;20,000 - 50,000;4;0;4;0;0;0
1359820;The Place I Called Home;;0 - 20,000;3;2;1;0;0;0
1359840;Lockdown Hero;;0 - 20,000;14;4;10;0;0;0
1359850;Zombies Must Die;;20,000 - 50,000;10;1;9;0;0;0
1359870;VEGTERIA - Vegetable Shop Simulator;;0 - 20,000;10;28;-18;0;0;0
1359890;Beach Love Shop;;0 - 20,000;11;6;5;0;0;0
1359900;Gone Golfing;;50,000 - 100,000;80;17;63;0;0;0
1359910;Mad Mosh;;0 - 20,000;1;1;0;0;0;0
1359920;Last Days of Lazarus;;0 - 20,000;86;11;75;0;0;0
1359970;Citadale - The Awakened Spirit;;0 - 20,000;4;3;1;0;0;0
1359980;POSTAL: Brain Damaged;;100,000 - 200,000;4461;155;4306;89;89;22
1360000;The Infected;;200,000 - 500,000;4355;645;3710;1372;385;220
1360010;One Tile Man;;0 - 20,000;10;2;8;0;0;0
1360040;uVolley;;20,000 - 50,000;26;23;3;0;0;0
1360080;Space Battle Arena;;50,000 - 100,000;4;1;3;0;0;0
1360130;Power of the Ancients;;20,000 - 50,000;0;1;-1;0;0;0
1360130;Power of the Ancients;;20,000 - 50,000;0;1;-1;0;0;0
1360140;Bird Boxing;;0 - 20,000;2;1;1;0;0;0
1360150;At The Downstairs;;0 - 20,000;3;1;2;0;0;0
1360190;曙光之诗;;20,000 - 50,000;11;1;10;0;0;0
1360250;Zombie Frenzy;;0 - 20,000;1;2;-1;0;0;0
1360260;Strange Lands;;0 - 20,000;1;0;1;0;0;0
1360270;Gem Wizards Tactics;;200,000 - 500,000;49;7;42;0;0;1
1360280;CATMAN-GIMMICK ACTION GAME-;;100,000 - 200,000;2;0;2;0;0;0
1360360;The Moon Relax;;0 - 20,000;1;12;-11;0;0;0
1360380;WORDDING;;0 - 20,000;0;3;-3;0;0;0
1360390;Cats and the Other Lives;;0 - 20,000;581;32;549;42;42;6
1360430;Lapso: NIMBO;;20,000 - 50,000;108;12;96;0;0;0
1360450;Runeverse: The Card Game;;20,000 - 50,000;482;103;379;0;0;0
1360480;推箱子(Push Box);;0 - 20,000;1;0;1;0;0;0
1360490;PECO;;0 - 20,000;5;0;5;0;0;0
1360500;Warrecs 2;;0 - 20,000;4;2;2;0;0;0
1360510;Lunar Rover;;200,000 - 500,000;6;1;5;0;0;0
1360550;Summertime Madness;;20,000 - 50,000;60;16;44;0;0;0
1360560;Pac vs Ghosts;;0 - 20,000;1;2;-1;0;0;0
1360580;The Fire;;0 - 20,000;9;1;8;0;0;0
1360600;Strike Team Gladius;;0 - 20,000;21;5;16;0;0;0
1360620;20,000 Miles Under the Sea;;50,000 - 100,000;36;64;-28;0;0;0
1360660;Neon Blight;;0 - 20,000;28;28;0;0;0;1
1360670;MiniMap Kingdom;;0 - 20,000;69;9;60;0;0;0
1360700;DREAM TIME;;0 - 20,000;23;0;23;0;0;0
1360720;Aethernaut;;0 - 20,000;14;4;10;0;0;3
1360780;Roll Ball Adventures;;0 - 20,000;1;1;0;0;0;0
1360790;Slip 'n Dip;;0 - 20,000;7;3;4;0;0;0
1360820;The Chase;;0 - 20,000;3;1;2;0;0;0
1360850;Isles of Yore;;0 - 20,000;77;28;49;0;0;2
1360870;Gude! Jump n Run;;0 - 20,000;1;1;0;0;0;0
1360890;JUST A GAME;;50,000 - 100,000;1;0;1;0;0;0
1361000;In Silence;;500,000 - 1,000,000;8485;2326;6159;185;150;18
1361010;Vampires Dawn 3 - The Crimson Realm;;50,000 - 100,000;547;83;464;0;0;6
1361020;Living the Nightmare;;20,000 - 50,000;14;0;14;0;0;0
1361050;DeRailed;;20,000 - 50,000;3;0;3;0;0;0
1361100;两体;;20,000 - 50,000;0;2;-2;0;0;0
1361110;Karen: An Outrage Simulator;;0 - 20,000;184;11;173;0;0;1
1361120;Element X;;20,000 - 50,000;6;0;6;0;0;0
1361150;Day Island;;50,000 - 100,000;9;0;9;0;0;0
1361180;Gemini Strategy Origin;;20,000 - 50,000;82;46;36;43;43;0
1361190;Brain Marmelade;;0 - 20,000;5;1;4;0;0;0
1361200;Forsaken Flesh;;0 - 20,000;5;1;4;0;0;0
1361210;Warhammer 40,000: Darktide;;1,000,000 - 2,000,000;34084;29938;4146;3032;1327;4055
1361230;Cleo - a pirate's tale;;20,000 - 50,000;468;4;464;0;0;2
1361240;Teenage Blob: Paperperson - The First Single;;0 - 20,000;47;1;46;0;0;0
1361260;Tequila Sunrise;;0 - 20,000;9;3;6;0;0;0
1361270;Flying Slime;;0 - 20,000;20;0;20;0;0;0
1361290;Splash King's Tournament;;0 - 20,000;1;0;1;0;0;0
1361320;The Room 4: Old Sins;;200,000 - 500,000;11329;140;11189;257;305;65
1361390;Mafia Gangster City;;0 - 20,000;5;3;2;0;0;0
1361400;Moonglow Bay;;20,000 - 50,000;235;99;136;9;9;3
1361430;Magical Stock Princess;;20,000 - 50,000;2;0;2;0;0;0
1361440;DuelVox;;20,000 - 50,000;23;6;17;0;0;0
1361450;Hadrian's Villa Reborn: South Theater;;0 - 20,000;1;1;0;0;0;0
1361470;illuminati Simulator VR;;0 - 20,000;3;4;-1;0;0;0
1361480;Robots, Death & Venice;;;;;0;;;
1361490;All Hail The Cook-o-tron;;0 - 20,000;12;5;7;0;0;0
1361510;Teenage Mutant Ninja Turtles: Shredder's Revenge;;200,000 - 500,000;10261;625;9636;416;250;86
1361520;Dondar;;0 - 20,000;16;3;13;0;0;0
1361530;Election 2020: Battle for the Throne;;0 - 20,000;6;0;6;0;0;0
1361580;Armoured Commander;;20,000 - 50,000;27;5;22;0;0;1
1361660;Alas Astra;;20,000 - 50,000;14;6;8;0;0;0
1361670;Skate City;;0 - 20,000;94;15;79;0;0;1
1361680;cyberpunkdreams;;100,000 - 200,000;497;159;338;0;0;43
1361700;Half-Life: Alyx - Final Hours;;50,000 - 100,000;767;39;728;117;117;2
1361720;Space Fuel;;0 - 20,000;2;0;2;0;0;0
1361750;The Rebellion;;0 - 20,000;20;8;12;0;0;0
1361760;Cartomante – Fortune Teller;;0 - 20,000;77;6;71;0;0;0
1361790;HYPERBOLIC Arcade Trading;;20,000 - 50,000;16;5;11;0;0;0
1361810;be you 2;;0 - 20,000;72;15;57;0;0;0
1361840;Tunnel of Doom;;0 - 20,000;34;17;17;0;0;2
1361860;Toilet Management Simulator;;20,000 - 50,000;217;72;145;48;48;1
1361950;Input Out;;0 - 20,000;1;0;1;0;0;0
1362040;Dungeon Swappers;;0 - 20,000;11;8;3;0;0;0
1362120;PIGROMANCE;;0 - 20,000;4;1;3;0;0;0
1362130;Hidden Valley Tower Defense;;0 - 20,000;9;2;7;0;0;0
1362190;Endless Escape;;0 - 20,000;61;15;46;0;0;0
1362260;经天纪;;20,000 - 50,000;8;8;0;0;0;0
1362260;经天纪;;20,000 - 50,000;8;8;0;0;0;0
1362270;ALPHA CENTAURI SPACE FORCE;;0 - 20,000;1;0;1;0;0;0
1362310;Zombie Simulator;;0 - 20,000;84;20;64;0;0;0
1362340;Freelancer Life Simulator;;0 - 20,000;8;20;-12;0;0;0
1362390;Ties;;20,000 - 50,000;84;17;67;0;0;0
1362400;Critical Zone;;50,000 - 100,000;16;0;16;0;0;0
1362420;Siege Survival: Gloria Victis Prologue;;200,000 - 500,000;810;111;699;51;54;3
1362430;Lairchitect;;0 - 20,000;31;20;11;0;0;1
1362440;Lost in Dungeon / 地牢迷失者;;20,000 - 50,000;47;19;28;74;74;0
1362460;EMBERZONE;;0 - 20,000;20;20;0;0;0;0
1362480;战地细胞（Battlefield Cell）;;0 - 20,000;5;0;5;0;0;0
1362520;The Luminous Underground;;0 - 20,000;6;3;3;0;0;1
1362560;Fire Commander;;0 - 20,000;161;74;87;892;892;2
1362580;Retro War;;0 - 20,000;14;2;12;0;0;0
1362580;Retro War;;0 - 20,000;14;2;12;0;0;0
1362650;Rolling Adventure;;0 - 20,000;19;0;19;0;0;0
1362670;KHIO;;0 - 20,000;3;1;2;0;0;0
1362700;Demetria Spirit;;0 - 20,000;2;6;-4;0;0;0
1362720;PillPop - Match 3;;0 - 20,000;5;0;5;0;0;0
1362750;Ziggy The Chaser;;0 - 20,000;2;0;2;0;0;0
1362780;Guildmaster: Gratuitous Subtitle;;0 - 20,000;24;4;20;0;0;0
1362830;Bomber Dudes;;20,000 - 50,000;41;14;27;0;0;0
1362860;Before Nightfall: Summertime;;0 - 20,000;19;7;12;0;0;0
1362890;Mega Roller Ball;;0 - 20,000;2;0;2;0;0;0
1362910;Waterpark Simulator;;0 - 20,000;10;11;-1;0;0;0
1362940;Seasons of the Samurai;;0 - 20,000;2;0;2;0;0;0
1362980;Hanapon Princess;;0 - 20,000;7;11;-4;0;0;0
1363020;100-Level Dungeon;;20,000 - 50,000;3;1;2;0;0;1
1363090;群星战纪: 最终防卫线 - STARS ERA: THE FINAL DEFENCE;;0 - 20,000;13;1;12;0;0;0
1363140;Altwaldheim: Town in Turmoil;;20,000 - 50,000;14;3;11;0;0;0
1363170;Lareissa Everbright;;0 - 20,000;2;0;2;0;0;0
1363200;Wings Of Legends;;0 - 20,000;3;0;3;0;0;0
1363210;Live by the Sword: Tactics;;0 - 20,000;38;10;28;0;0;0
1363250;MAGIX Video deluxe 2021 Plus Steam Edition;;0 - 20,000;5;10;-5;66;66;0
1363290;SIGNAL;;0 - 20,000;4;5;-1;0;0;0
1363350;Monster Harvest;;20,000 - 50,000;224;193;31;0;0;2
1363350;Monster Harvest;;20,000 - 50,000;224;193;31;0;0;2
1363360;Noch;;100,000 - 200,000;100;39;61;0;0;0
1363390;The Darkest Island;;0 - 20,000;22;6;16;0;0;0
1363430;Propagation VR;;200,000 - 500,000;4286;237;4049;48;33;60
1363470;ARISEN: Prologue;;20,000 - 50,000;69;13;56;0;0;0
1363490;Dragon Spirits : Prologue;;20,000 - 50,000;113;1;112;0;0;0
1363560;Shattered Worlds;;0 - 20,000;7;0;7;0;0;0
1363600;MOMO.EXE VR;;0 - 20,000;16;6;10;0;0;0
1363650;Dungeon Display;;20,000 - 50,000;2;1;1;0;0;0
1363660;Emerald Lake;;0 - 20,000;11;18;-7;0;0;0
1363680;FALLING OUT;;0 - 20,000;26;0;26;0;0;0
1363690;Fantastic Contraption Classic 1 & 2;;0 - 20,000;49;1;48;0;0;5
1363740;The Troop;;0 - 20,000;253;23;230;0;0;16
1363770;Escape Quest;;50,000 - 100,000;174;56;118;0;0;0
1363790;Deadly Way;;0 - 20,000;17;0;17;0;0;0
1363810;Astra;;50,000 - 100,000;26;19;7;0;0;0
1363840;Saviors of Sapphire Wings / Stranger of Sword City Revisited;;0 - 20,000;90;53;37;0;0;4
1363850;THE IMPOSSIBLE;;200,000 - 500,000;241;32;209;0;0;0
1363960;Sweetest Thing;;0 - 20,000;4;1;3;0;0;0
1363980;时之痕 Trace Of Time;;0 - 20,000;36;9;27;0;0;0
1364000;Hanefield Asylum;;0 - 20,000;6;1;5;0;0;0
1364010;The Librarian (Special Edition);;20,000 - 50,000;70;9;61;0;0;0
1364100;Lacuna – A Sci-Fi Noir Adventure;;200,000 - 500,000;1346;88;1258;462;889;17
1364130;Chaotic Airport Construction Manager;;20,000 - 50,000;199;22;177;80;80;0
1364150;Hide and Shoot;;50,000 - 100,000;3;3;0;0;0;0
1364180;Counter Operation Online;;0 - 20,000;1;1;0;0;0;0
1364210;City Bus Manager;;20,000 - 50,000;610;85;525;0;0;164
1364240;FarRock Dodgeball;;0 - 20,000;1;0;1;0;0;0
1364280;The Kalalau Trail;;0 - 20,000;2;1;1;0;0;0
1364290;Animalia Survival;;50,000 - 100,000;1063;568;495;37;37;170
1364330;Hellbreachers;;0 - 20,000;2;2;0;0;0;0
1364340;OPERATION SERPENS;;0 - 20,000;87;10;77;0;0;0
1364360;Last Space Mission;;20,000 - 50,000;3;0;3;0;0;0
1364380;RULES OF GRAVITY;;0 - 20,000;2;3;-1;0;0;0
1364390;Animaze by FaceRig;;200,000 - 500,000;1405;812;593;132;33;793
1364400;The Holy City;;0 - 20,000;4;1;3;0;0;0
1364430;Gryphon Knight Epic: Definitive Edition;;0 - 20,000;6;3;3;0;0;0
1364460;Keizudo;;20,000 - 50,000;4;1;3;0;0;0
1364470;SmartwatchVR;;0 - 20,000;4;2;2;0;0;0
1364500;Drive or Die;;0 - 20,000;3;2;1;0;0;0
1364510;'Member the Alamo?;;0 - 20,000;4;4;0;0;0;0
1364570;Starshot;;0 - 20,000;2;0;2;0;0;0
1364580;Nyanroo The Supercat;;0 - 20,000;10;0;10;0;0;0
1364610;Take Me Home;;0 - 20,000;0;1;-1;0;0;0
1364710;Skycadia;;0 - 20,000;13;2;11;0;0;0
1364750;pop and well;;0 - 20,000;1;0;1;0;0;0
1364760;COTTOn Rock'n'Roll -SUPERLATIVE NIGHT DREAMS-;;0 - 20,000;21;1;20;0;0;4
1364800;The Emperor's Own: Alpha Teaser;;100,000 - 200,000;405;111;294;0;0;1
1364830;TinyPoker;;0 - 20,000;4;2;2;0;0;0
1364890;Increase World;;0 - 20,000;9;7;2;0;0;0
1364950;Work Trip;;0 - 20,000;36;8;28;0;0;0
1364960;Hello Neighbor 2 Alpha 1.5;;500,000 - 1,000,000;4555;745;3810;128;64;26
1364980;project BLARI;;20,000 - 50,000;142;16;126;0;0;0
1365010;Lost Potato;;0 - 20,000;103;4;99;0;0;5
1365030;Cybershock: Future Parkour;;20,000 - 50,000;87;4;83;0;0;0
1365140;EX LIFE;;0 - 20,000;3;3;0;0;0;0
1365380;Atria Valkyrie;;0 - 20,000;1;0;1;0;0;0
1365390;Facility 47;;0 - 20,000;45;7;38;0;0;0
1365390;Facility 47;;0 - 20,000;45;7;38;0;0;0
1365400;My Universe - Pet Clinic Cats & Dogs;;0 - 20,000;7;4;3;0;0;0
1365410;My Universe - Fashion Boutique;;0 - 20,000;13;10;3;0;0;0
1365420;Magic Fluids;;0 - 20,000;12;4;8;0;0;0
1365490;Stellaren II;;0 - 20,000;11;0;11;0;0;0
1365500;Vapor Music Tour;;0 - 20,000;4;0;4;0;0;0
1365520;Dwarven Forge;;0 - 20,000;1;1;0;0;0;0
1365540;Hot Tiles;;0 - 20,000;1;0;1;0;0;0
1365550;The Grand Lord;;20,000 - 50,000;8;0;8;0;0;0
1365560;The Laundry;;0 - 20,000;58;32;26;0;0;0
1365590;Timewalk Tower Defense;;50,000 - 100,000;8;2;6;0;0;0
1365600;REPTRAILS;;0 - 20,000;21;6;15;0;0;4
1365630;BAL Solid;;50,000 - 100,000;6;0;6;0;0;0
1365680;Insulated at the bottom;;20,000 - 50,000;0;1;-1;0;0;0
1365700;Fleeting World;;0 - 20,000;0;2;-2;0;0;0
1365710;Simple Tools;;0 - 20,000;4;1;3;0;0;0
1365750;东方栖霞园 ~ Blue devil in the Belvedere.;;20,000 - 50,000;307;25;282;401;401;3
1365760;Defold;;50,000 - 100,000;92;18;74;0;0;7
1365900;Mystika 4 : Dark Omens;;20,000 - 50,000;12;1;11;0;0;0
1365900;Mystika 4 : Dark Omens;;20,000 - 50,000;12;1;11;0;0;0
1365920;神王之王者之心;;0 - 20,000;0;3;-3;0;0;0
1365920;神王之王者之心;;0 - 20,000;0;3;-3;0;0;0
1365930;Shadow Walls;;100,000 - 200,000;48;3;45;0;0;0
1365940;Eye of the Temple: First Steps;;50,000 - 100,000;259;17;242;0;0;0
1365950;VR Hentai room;;0 - 20,000;13;5;8;0;0;0
1366000;Dream Of Salmon;;20,000 - 50,000;2;0;2;0;0;0
1366010;Bromeliad;;0 - 20,000;16;10;6;0;0;0
1366060;Refraction;;0 - 20,000;5;0;5;0;0;0
1366070;Push Blox;;0 - 20,000;5;0;5;0;0;0
1366100;Azalea;;0 - 20,000;30;0;30;0;0;0
1366150;Greedy Dungeon;;0 - 20,000;26;5;21;0;0;0
1366160;Top Billiards;;20,000 - 50,000;2;8;-6;0;0;0
1366270;Primal Carnage: Extinction - Workshop Tool;;50,000 - 100,000;2;0;2;0;0;0
1366290;Kill It With Fire: HEATWAVE;;50,000 - 100,000;1819;166;1653;54;66;12
1366310;Try to Survive!;;0 - 20,000;2;0;2;0;0;0
1366320;Shine's Adventures 0 (Zombies Reload);;0 - 20,000;21;4;17;0;0;1
1366390;LuPR: Lunar Post Recruit;;0 - 20,000;9;0;9;0;0;0
1366420;Cellular Harvest;;0 - 20,000;24;1;23;0;0;0
1366510;炼器师;;0 - 20,000;23;16;7;0;0;0
1366520;Dungeon Limbus;;0 - 20,000;11;7;4;0;0;0
1366540;Dyson Sphere Program;;2,000,000 - 5,000,000;67316;1527;65789;2538;1258;5742
1366550;Explore Girl · Rope Sprite;;0 - 20,000;10;16;-6;0;0;0
1366570;RESONARK X;;0 - 20,000;20;4;16;0;0;0
1366610;Fox Simulator;;0 - 20,000;22;4;18;0;0;0
1366680;San Diablos;;100,000 - 200,000;6;6;0;0;0;0
1366700;Quintus and the Absent Truth;;0 - 20,000;59;15;44;0;0;0
1366710;Memory Battle;;0 - 20,000;4;1;3;0;0;0
1366720;Vidiot Game;;50,000 - 100,000;160;18;142;0;0;0
1366750;Alien Cat 5;;0 - 20,000;18;12;6;0;0;1
1366760;The Last Wulin;;0 - 20,000;6;6;0;0;0;0
1366770;Pecaminosa - A Pixel Noir Game;;0 - 20,000;35;7;28;0;0;0
1366800;Crosshair X;;200,000 - 500,000;5828;590;5238;11560;5631;4235
1366810;AccrO;;0 - 20,000;38;12;26;27;27;0
1366830;Quiz Pro - Guess Pictures;;0 - 20,000;1;1;0;0;0;0
1366930;Rainbow Laser Disco Dungeon;;0 - 20,000;11;1;10;0;0;0
1366940;Time Gap Puppies;;0 - 20,000;3;1;2;0;0;0
1366950;Driver4VR;;0 - 20,000;472;238;234;104;115;25
1367090;I'm Oh, So Busy...: A Week with Yoshimi;;0 - 20,000;4;2;2;0;0;0
1367110;Child of Abyss;;0 - 20,000;2;3;-1;0;0;0
1367130;FoxVoltex;;0 - 20,000;7;2;5;0;0;0
1367160;Wetlands;;20,000 - 50,000;1;3;-2;0;0;0
1367170;Planet's Edge;;20,000 - 50,000;3;1;2;0;0;0
1367220;Wild Gun;;0 - 20,000;11;1;10;0;0;0
1367230;Neon Cyborg Cat Club;;0 - 20,000;23;0;23;0;0;0
1367250;Arabel;;0 - 20,000;18;0;18;0;0;0
1367270;BATTLESCAR: Punk Was Invented By Girls;;0 - 20,000;13;12;1;0;0;0
1367270;BATTLESCAR: Punk Was Invented By Girls;;0 - 20,000;13;12;1;0;0;0
1367300;Blade Assault;;50,000 - 100,000;1399;334;1065;1181;1661;18
1367320;Close Combat: Cross of Iron;;0 - 20,000;76;14;62;0;0;10
1367320;Close Combat: Cross of Iron;;0 - 20,000;76;14;62;0;0;10
1367330;Close Combat: Modern Tactics;;0 - 20,000;5;11;-6;0;0;0
1367340;POLYGON: Life;;0 - 20,000;7;4;3;0;0;0
1367350;Destructive Behavior;;0 - 20,000;2;0;2;0;0;0
1367420;One Line Coloring;;0 - 20,000;26;3;23;0;0;0
1367430;Furry Woof and Nya;;0 - 20,000;40;8;32;0;0;0
1367520;Fake Illusions;;0 - 20,000;15;0;15;0;0;0
1367530;Rekt: Crash Test;;100,000 - 200,000;467;85;382;0;0;5
1367550;Kingdom Rush Vengeance - Tower Defense;;200,000 - 500,000;6004;304;5700;1002;1078;311
1367580;GiseiHero;;0 - 20,000;16;0;16;0;0;0
1367580;GiseiHero;;0 - 20,000;16;0;16;0;0;0
1367590;Tormented Souls;;200,000 - 500,000;3708;261;3447;593;593;19
1367620;Domestic Defense;;0 - 20,000;4;1;3;0;0;0
1367680;Charge!;;0 - 20,000;5;0;5;0;0;0
1367690;Tony Stewart's All-American Racing;;0 - 20,000;121;26;95;7123;7123;10
1367720;General War Memories;;0 - 20,000;12;15;-3;0;0;7
1367750;Target Runner;;0 - 20,000;20;8;12;0;0;0
1367760;AOD: Art Of Defense;;50,000 - 100,000;205;56;149;0;0;27
1367770;Flying propeller;;0 - 20,000;4;2;2;0;0;0
1367780;Baby Coyote;;0 - 20,000;17;6;11;0;0;0
1367860;Damned Hand;;20,000 - 50,000;9;9;0;0;0;0
1367880;Critterland;;0 - 20,000;6;4;2;0;0;0
1367950;Aeloren Tactics;;0 - 20,000;4;2;2;0;0;0
1367960;百詰怪軼與金魚;;0 - 20,000;24;2;22;0;0;0
1367970;Motionless;;20,000 - 50,000;24;7;17;0;0;0
1367980;Battle Jacked;;0 - 20,000;13;0;13;0;0;0
1368000;Secret Agent Allan Martin in ... Phoenix Erupting;;50,000 - 100,000;1;0;1;0;0;0
1368030;ANNO: Mutationem;;200,000 - 500,000;3110;870;2240;755;720;23
1368060;dead run;;20,000 - 50,000;5;12;-7;0;0;0
1368120;Messy Room Simulator;;0 - 20,000;24;16;8;0;0;0
1368240;Isle of the Crown;;0 - 20,000;1;0;1;0;0;0
1368260;Dark Farm;;0 - 20,000;1;1;0;0;0;0
1368330;VR Marco Polo's Travelling in Medieval Asia (The Far East, Chinese, Japanese, Shogun, Khitan...revisit A.D. 1290);;0 - 20,000;3;0;3;0;0;0
1368340;Beneath a Steel Sky;;100,000 - 200,000;312;29;283;3;3;0
1368350;Instability;;20,000 - 50,000;22;9;13;0;0;0
1368400;Pombero - The Lord of the Night;;0 - 20,000;29;17;12;0;0;0
1368410;PSYCRON;;0 - 20,000;82;2;80;0;0;0
1368420;Sokodice;;0 - 20,000;3;1;2;0;0;0
1368560;Rogue Randy;;20,000 - 50,000;1;0;1;0;0;0
1368620;Healing Movement;;200,000 - 500,000;4;1;3;0;0;0
1368630;CustomCross;;0 - 20,000;6;2;4;0;0;2
1368750;Jigsaw Puzzles: Master Artists of Old;;0 - 20,000;5;0;5;0;0;1
1368770;The Line;;0 - 20,000;20;10;10;0;0;0
1368780;The Mikado Birdgirl in Taichung;;0 - 20,000;60;2;58;0;0;0
1368810;FACTORY RUNNER;;0 - 20,000;49;46;3;0;0;0
1368820;RollerCoaster Tycoon 3: Complete Edition;;50,000 - 100,000;1129;206;923;42;66;236
1368830;回纹战棋;;50,000 - 100,000;2;0;2;0;0;0
1368840;Battle of Hunters : Beast Zone;;0 - 20,000;51;20;31;0;0;0
1368850;Cursed Treasure 2 Ultimate Edition - Tower Defense;;0 - 20,000;86;31;55;0;0;9
1368860;像素女友;;100,000 - 200,000;1207;17;1190;0;0;1
1368870;Field of Glory II: Medieval;;0 - 20,000;307;42;265;0;0;49
1368880;Corona Kombat;;0 - 20,000;2;2;0;0;0;0
1368960;Fishing Sim World: Bass Pro Shops Edition;;0 - 20,000;17;6;11;0;0;0
1368970;Rover Mechanic Challenge - ERC Competition;;20,000 - 50,000;3;2;1;0;0;0
1369090;Chibi Wars Kinetic Novel;;0 - 20,000;1;1;0;0;0;0
1369320;Virtual Cottage;;;;;0;;;
1369340;Cats Organized Neatly;;50,000 - 100,000;2663;43;2620;76;109;32
1369350;Speechless;;0 - 20,000;1;3;-2;0;0;0
1369370;Combat Mission Shock Force 2;;20,000 - 50,000;530;97;433;1681;1681;44
1369390;Tome Rush;;0 - 20,000;0;1;-1;0;0;0
1369400;Croppy Boy;;20,000 - 50,000;76;47;29;0;0;1
1369410;Dream Stone 2;;20,000 - 50,000;2;1;1;0;0;0
1369470;Pincremental;;50,000 - 100,000;365;98;267;0;0;63
1369520;Strangeland;;50,000 - 100,000;590;35;555;0;0;2
1369560;Obsolete;;0 - 20,000;30;2;28;0;0;0
1369570;Spirit Messages;;100,000 - 200,000;0;2;-2;0;0;0
1369580;Being Mindful;;20,000 - 50,000;7;1;6;0;0;0
1369630;ENDER LILIES: Quietus of the Knights;;500,000 - 1,000,000;21435;1137;20298;467;362;263
1369670;Motor Town: Behind The Wheel;;100,000 - 200,000;2384;122;2262;969;1046;265
1369730;Citizens Unite!: Earth x Space;;0 - 20,000;6;1;5;0;0;0
1369740;Dragon Lapis;;0 - 20,000;9;1;8;0;0;0
1369760;[NINJA GAIDEN: Master Collection] NINJA GAIDEN 3: Razor's Edge;;50,000 - 100,000;666;280;386;346;395;10
1369770;MannaRites;;20,000 - 50,000;235;26;209;0;0;0
1369780;Opus Ludum;;0 - 20,000;4;0;4;0;0;0
1369800;Spaceslingers;;50,000 - 100,000;4;0;4;0;0;0
1369830;Kaiju Krashers;;20,000 - 50,000;1;2;-1;0;0;0
1369950;亡命尸潮惊魂夜 Escape Zombies At Night;;0 - 20,000;5;4;1;0;0;0
1369980;Abyss The Forgotten Past;;0 - 20,000;9;5;4;0;0;0
1370000;Max and the Book of Chaos;;0 - 20,000;5;1;4;0;0;0
1370040;Underlings;;0 - 20,000;18;6;12;0;0;0
1370050;Trek to Yomi;;100,000 - 200,000;1003;402;601;209;209;4
1370060;Cirno'sBattleofFaith;;0 - 20,000;14;1;13;0;0;0
1370140;Kao the Kangaroo;;0 - 20,000;462;85;377;464;464;1
1370170;Diorama Builder;;0 - 20,000;259;18;241;0;0;4
1370180;Alien Cat 6;;0 - 20,000;5;2;3;0;0;1
1370220;BAO;;0 - 20,000;4;1;3;0;0;0
1370250;Super Nate Adventure;;0 - 20,000;16;2;14;0;0;0
1370300;Ultragun Dreamland;;0 - 20,000;4;0;4;0;0;0
1370310;Jewel of Kuru;;0 - 20,000;3;0;3;0;0;0
1370370;Lands of Sorcery;;0 - 20,000;24;9;15;0;0;0
1370390;Offroad Horizons: Arcade Rock Crawling;;0 - 20,000;20;11;9;0;0;0
1370410;Progress Game;;100,000 - 200,000;283;23;260;0;0;2
1370430;Police Chase;;0 - 20,000;19;10;9;0;0;0
1370470;Paralax Vr Aim Trainer;;0 - 20,000;3;11;-8;0;0;0
1370550;Circles of Hell;;0 - 20,000;2;0;2;0;0;0
1370560;Brash Monster Simulator;;20,000 - 50,000;2;2;0;0;0;0
1370570;First Person Shooter Kit Showcase;;20,000 - 50,000;47;9;38;0;0;0
1370580;Toilet Paper Unleashed;;0 - 20,000;7;3;4;0;0;0
1370610;Mushroom Picker Simulator;;0 - 20,000;16;23;-7;0;0;2
1370620;Zodiac Girls;;0 - 20,000;51;9;42;0;0;1
1370640;Rewrite - DYH;;0 - 20,000;6;0;6;0;0;0
1370650;Bit - Animation Editor;;0 - 20,000;6;5;1;0;0;0
1370660;PlayZ;;20,000 - 50,000;15;4;11;0;0;0
1370690;How I learned to Skate;;0 - 20,000;24;2;22;0;0;1
1370710;7n7;;20,000 - 50,000;5;1;4;0;0;0
1370710;7n7;;20,000 - 50,000;5;1;4;0;0;0
1370720;Starship Intruder;;20,000 - 50,000;5;1;4;0;0;0
1370770;Let It Go - How to realize your dreams;;0 - 20,000;27;0;27;0;0;0
1370780;AudioTheory Grids;;0 - 20,000;6;1;5;0;0;1
1370800;Baalbek Reborn: Temples;;20,000 - 50,000;35;8;27;0;0;0
1370820;Welcome to the Polyverse;;0 - 20,000;3;1;2;0;0;0
1370850;Elasto Mania II;;0 - 20,000;6;2;4;0;0;1
1370940;NovaMundi;;0 - 20,000;5;2;3;0;0;0
1370950;Out of Oblivion;;50,000 - 100,000;10;6;4;0;0;0
1370970;Gamitate - Meditate, Relax, Feel Better;;0 - 20,000;5;1;4;0;0;0
1371000;AnotherOne;;0 - 20,000;1;0;1;0;0;0
1371040;Corridors of their memories;;0 - 20,000;31;7;24;0;0;0
1371050;Illness in the East;;50,000 - 100,000;15;1;14;0;0;0
1371090;Illegal Race Tuning;;0 - 20,000;10;8;2;0;0;0
1371110;labyrinth 2;;0 - 20,000;5;0;5;0;0;0
1371120;The Maze Escaper;;0 - 20,000;1;0;1;0;0;0
1371160;InMaze;;50,000 - 100,000;4;2;2;0;0;0
1371170;3 min per day! Improve your aged eyes(Presbyopia);;0 - 20,000;20;5;15;0;0;0
1371180;Star Rover;;0 - 20,000;1;0;1;0;0;0
1371220;Death: The Ascension;;0 - 20,000;6;3;3;0;0;0
1371280;Anetona;;0 - 20,000;2;2;0;0;0;0
1371300;Cuba2077;;0 - 20,000;11;7;4;0;0;0
1371300;Cuba2077;;0 - 20,000;11;7;4;0;0;0
1371320;Beat Flip;;0 - 20,000;2;0;2;0;0;0
1371350;Solenars Edge II: Champions;;20,000 - 50,000;3;7;-4;0;0;0
1371380;Space Soldier;;0 - 20,000;1;1;0;0;0;0
1371460;Alien Cat 7;;0 - 20,000;2;1;1;0;0;0
1371470;Ant Force;;0 - 20,000;1;1;0;0;0;0
1371480;Iron Conflict;;50,000 - 100,000;1364;589;775;50;84;28
1371500;Cargo Company;;0 - 20,000;36;23;13;0;0;0
1371510;This Game Might Improve Your Memory;;0 - 20,000;0;1;-1;0;0;0
1371540;Spartoi Meadow;;20,000 - 50,000;6;0;6;0;0;0
1371560;DarKnot;;0 - 20,000;34;15;19;0;0;0
1371600;Star Puzzle;;0 - 20,000;7;7;0;0;0;0
1371610;Apple Hopper;;0 - 20,000;10;7;3;0;0;0
1371620;Clash Memory Game;;20,000 - 50,000;8;6;2;0;0;0
1371630;Incremental Adventures;;100,000 - 200,000;511;125;386;2643;1833;73
1371690;GRAVEN;;100,000 - 200,000;471;196;275;401;401;2
1371700;Divinest Light;;20,000 - 50,000;4;6;-2;0;0;0
1371710;Rogue Aces Deluxe;;20,000 - 50,000;16;0;16;0;0;0
1371720;Card Shark;;100,000 - 200,000;1621;136;1485;353;353;10
1371720;Card Shark;;100,000 - 200,000;1621;136;1485;353;353;10
1371730;A Little Bird;;0 - 20,000;4;1;3;0;0;0
1371750;T-Minus 30;;0 - 20,000;148;11;137;0;0;0
1371760;Birthright;;0 - 20,000;8;3;5;0;0;0
1371770;Dust to Dusk;;0 - 20,000;22;0;22;0;0;0
1371780;Dungeons & Cocks;;0 - 20,000;20;3;17;0;0;0
1371790;The Evil in the Forest;;0 - 20,000;8;4;4;0;0;0
1371800;My Nuclear Octopus;;0 - 20,000;8;0;8;0;0;0
1371810;Bamerang: Warm-Up Duel;;50,000 - 100,000;41;3;38;0;0;0
1371860;Space Cube Racers;;0 - 20,000;0;1;-1;0;0;0
1371880;Solar Echoes: The Star Legation;;20,000 - 50,000;13;0;13;0;0;1
1371910;Worlds Align: Deadly Dream Collector's Edition;;0 - 20,000;3;0;3;0;0;0
1371930;Family Quiz;;0 - 20,000;2;3;-1;0;0;0
1371940;Milo's Quest;;0 - 20,000;12;1;11;0;0;0
1372010;Cube Shifter;;0 - 20,000;6;2;4;0;0;0
1372110;JoJo's Bizarre Adventure: All-Star Battle R;;50,000 - 100,000;5111;793;4318;332;406;202
1372120;VR Time Machine Travelling in history: Medieval Castle, Fort, and Village Life in 1071-1453 Europe;;0 - 20,000;1;0;1;0;0;0
1372180;The Call Of Paper Plane;;0 - 20,000;25;4;21;0;0;0
1372210;Dap;;0 - 20,000;90;4;86;36;36;1
1372220;Medievalien;;20,000 - 50,000;59;12;47;0;0;0
1372260;Watch Your Helmet;;50,000 - 100,000;0;1;-1;0;0;0
1372270;Boxfight;;0 - 20,000;3;0;3;0;0;0
1372280;MELTY BLOOD: TYPE LUMINA;;200,000 - 500,000;5939;900;5039;2001;1068;253
1372300;Iwaihime;;20,000 - 50,000;403;78;325;0;0;4
1372310;Love Mystery Club;;20,000 - 50,000;84;19;65;0;0;0
1372320;Cloud Gardens;;50,000 - 100,000;1748;78;1670;619;969;14
1372350;SkyLife: VoxelSurvival;;0 - 20,000;6;9;-3;0;0;0
1372370;Last of Ass;;0 - 20,000;31;8;23;0;0;0
1372380;CYNOROID GAIDEN;;0 - 20,000;7;1;6;0;0;0
1372390;Cosmic Disco;;0 - 20,000;6;3;3;0;0;0
1372430;Spells and Fellas;;0 - 20,000;8;5;3;0;0;2
1372530;Fly Corp;;50,000 - 100,000;1193;187;1006;2226;2288;81
1372560;Olympic Basketball;;0 - 20,000;3;0;3;0;0;0
1372570;Domino House;;0 - 20,000;25;3;22;0;0;0
1372580;Planet Zeta;;100,000 - 200,000;3;3;0;0;0;0
1372630;Whizz Ball;;0 - 20,000;3;0;3;0;0;0
1372640;Candle In Darkness;;500,000 - 1,000,000;6;1;5;0;0;0
1372670;86;;20,000 - 50,000;1;0;1;0;0;0
1372680;Castle Grimholt;;0 - 20,000;6;6;0;0;0;0
1372700;Off The Chains Disc Golf;;0 - 20,000;21;12;9;0;0;1
1372730;Phaseshift;;0 - 20,000;20;0;20;0;0;0
1372800;Gloom and Doom;;0 - 20,000;29;0;29;0;0;0
1372810;Teamfight Manager;;200,000 - 500,000;4067;624;3443;684;806;108
1372840;Curling On Line;;0 - 20,000;4;6;-2;0;0;0
1372910;Project Crimson;;0 - 20,000;30;4;26;0;0;0
1372940;Behind Closed Doors: A Developer's Tale;;0 - 20,000;1;2;-1;0;0;0
1373020;Fox's Holiday / 狐の假期;;0 - 20,000;11;14;-3;0;0;0
1373080;Twin Breaker: A Sacred Symbols Adventure;;0 - 20,000;8;2;6;0;0;0
1373110;Reflect Horizons;;0 - 20,000;21;7;14;0;0;0
1373120;Air Wars;;0 - 20,000;14;25;-11;0;0;0
1373120;Air Wars;;0 - 20,000;14;25;-11;0;0;0
1373170;Slimesphere;;50,000 - 100,000;9;0;9;0;0;0
1373180;The Sea Hotel☆Umineko Tei;;20,000 - 50,000;48;8;40;0;0;6
1373180;The Sea Hotel☆Umineko Tei;;20,000 - 50,000;48;8;40;0;0;6
1373220;Live the Life;;0 - 20,000;238;138;100;66;66;2
1373230;Portals World;;0 - 20,000;1;4;-3;0;0;0
1373240;Cube Raiders;;20,000 - 50,000;8;4;4;0;0;0
1373250;Lonely Birds;;0 - 20,000;9;0;9;0;0;0
1373260;Obsidian Prince;;50,000 - 100,000;105;23;82;0;0;2
1373270;Sakura Dimensions;;0 - 20,000;8;3;5;0;0;0
1373290;TENS!;;0 - 20,000;6;5;1;0;0;0
1373310;OUBEY VR - Samurai;;50,000 - 100,000;5;2;3;0;0;0
1373320;I'a I'a Cofflhu Fhtagnyaa;;50,000 - 100,000;238;39;199;4;4;0
1373350;Phobos;;100,000 - 200,000;114;52;62;0;0;7
1373380;Building 847;;0 - 20,000;4;2;2;0;0;0
1373410;Data mining X;;0 - 20,000;2;3;-1;0;0;0
1373430;Leisure Suit Larry - Wet Dreams Dry Twice;;20,000 - 50,000;579;79;500;1063;1361;29
1373440;Picross for a Cause;;0 - 20,000;32;0;32;0;0;4
1373450;Misplaced;;0 - 20,000;4;0;4;0;0;0
1373500;Mist of the Undead;;200,000 - 500,000;11;14;-3;0;0;0
1373510;BloodRayne: Terminal Cut;;50,000 - 100,000;932;99;833;257;327;6
1373550;BloodRayne 2: Terminal Cut;;20,000 - 50,000;571;129;442;275;275;4
1373560;Super Chopper;;0 - 20,000;1;3;-2;0;0;0
1373580;Bor;;0 - 20,000;6;2;4;0;0;0
1373600;Day of the Dead: Solitaire Collection;;0 - 20,000;10;1;9;0;0;0
1373630;Ragnar's Chinese Memory Game;;0 - 20,000;13;0;13;0;0;0
1373680;Small Iron;;0 - 20,000;1;0;1;0;0;0
1373700;Barry the Bunny;;0 - 20,000;18;0;18;0;0;0
1373710;Mina & Michi;;0 - 20,000;4;2;2;0;0;0
1373740;Prehistoric Dude;;0 - 20,000;11;2;9;0;0;0
1373760;Super Wiloo Demake;;0 - 20,000;3;1;2;0;0;0
1373770;Sea Legends;;50,000 - 100,000;9;0;9;0;0;0
1373780;Bakery Magnate: Beginning;;50,000 - 100,000;726;125;601;0;0;4
1373810;Orlando Theme Park VR - Roller Coaster and Rides;;100,000 - 200,000;5;33;-28;0;0;0
1373820;MindWorks;;0 - 20,000;6;1;5;0;0;0
1373830;SPL: Skilled Pilots Live;;0 - 20,000;11;1;10;0;0;0
1373880;Hello Neighbor 2 Alpha 1;;100,000 - 200,000;393;63;330;36;36;8
1373890;Fight N' Fall;;0 - 20,000;1;0;1;0;0;0
1373920;Sword Rogue;;20,000 - 50,000;391;16;375;0;0;0
1373930;Dino Nest;;0 - 20,000;189;11;178;0;0;0
1373990;The Majesti;;0 - 20,000;4;0;4;0;0;0
1373990;The Majesti;;0 - 20,000;4;0;4;0;0;0
1374010;Grand Prix Racing On Line;;0 - 20,000;1;1;0;0;0;0
1374040;ヨガって！奥様;;0 - 20,000;4;0;4;0;0;0
1374050;KIRO;;0 - 20,000;12;0;12;0;0;0
1374170;Camp Canyonwood;;100,000 - 200,000;23;7;16;0;0;1
1374200;Lockdown VR: Kidnapped;;0 - 20,000;12;2;10;0;0;0
1374220;GamerZ CastlE Rush!;;0 - 20,000;2;1;1;0;0;0
1374280;Kor;;20,000 - 50,000;53;1;52;0;0;0
1374330;VR Time Travelling in Medieval Towns and Islands: Magellan's Life in ancient Europe, the Great Exploration Age, and A.D.1500 Time Machine;;0 - 20,000;2;1;1;0;0;0
1374400;Where Is My Parking Spot;;0 - 20,000;11;1;10;0;0;0
1374410;TCSTRIKERS2;;20,000 - 50,000;1;1;0;0;0;0
1374430;三国模拟器 Three Kingdoms Simulator;;0 - 20,000;6;2;4;0;0;0
1374580;Dirge;;0 - 20,000;50;5;45;0;0;0
1374590;Monsterwolf;;20,000 - 50,000;0;1;-1;0;0;0
1374600;RunDrill;;0 - 20,000;2;0;2;0;0;0
1374630;Uploaded;;0 - 20,000;4;0;4;0;0;0
1374640;Hive Mind;;0 - 20,000;5;0;5;0;0;0
1374700;BIG-Bobby-Car – The Big Race;;0 - 20,000;4;0;4;0;0;0
1374740;Isolated Life;;0 - 20,000;0;10;-10;0;0;0
1374820;MBHL20;;0 - 20,000;4;5;-1;0;0;0
1374840;Dark Deity;;100,000 - 200,000;1501;519;982;1863;1863;43
1374850;Eldrador Creatures;;0 - 20,000;9;1;8;0;0;0
1374890;Crossword City Chronicles;;0 - 20,000;7;10;-3;0;0;0
1374890;Crossword City Chronicles;;0 - 20,000;7;10;-3;0;0;0
1374900;Dental Madness: Cavity Mania;;0 - 20,000;6;0;6;0;0;0
1374910;Distant Transmission;;0 - 20,000;1;0;1;0;0;0
1374930;Black Geyser: Couriers of Darkness;;100,000 - 200,000;490;189;301;0;0;22
1374940;Bulldozer;;0 - 20,000;19;3;16;0;0;0
1374970;Moonscars;;0 - 20,000;446;111;335;1103;1103;8
1374990;PAW Patrol Mighty Pups Save Adventure Bay;;0 - 20,000;89;41;48;0;0;9
1375000;Valletine against Darkne;;20,000 - 50,000;5;2;3;0;0;0
1375000;Valletine against Darkne;;20,000 - 50,000;5;2;3;0;0;0
1375070;FurBall;;20,000 - 50,000;35;13;22;0;0;0
1375110;History of Korea - VR;;0 - 20,000;6;0;6;0;0;0
1375260;Strike Force 2 - Terrorist Hunt;;0 - 20,000;1;4;-3;0;0;0
1375270;Shape;;0 - 20,000;10;0;10;0;0;0
1375280;CosmoDrive:Infinity;;0 - 20,000;6;1;5;0;0;0
1375300;POLAR;;0 - 20,000;0;1;-1;0;0;0
1375400;Ghosts 'n Goblins Resurrection;;20,000 - 50,000;545;106;439;41;41;5
1375420;Messier111;;0 - 20,000;2;0;2;0;0;0
1375430;MotoRun;;0 - 20,000;1;7;-6;0;0;0
1375440;Avoidvania;;0 - 20,000;6;0;6;0;0;0
1375450;7 Roses - A Darkness Rises;;20,000 - 50,000;23;18;5;0;0;0
1375460;Six Paths;;0 - 20,000;4;2;2;0;0;0
1375480;Bunny's Flowers;;0 - 20,000;60;0;60;0;0;0
1375510;Otti: house keeper;;0 - 20,000;7;0;7;0;0;0
1375520;BlueBete;;0 - 20,000;0;2;-2;0;0;0
1375540;Omno: Prologue;;20,000 - 50,000;270;5;265;0;0;1
1375560;Stonebot Adventures;;0 - 20,000;3;0;3;0;0;0
1375640;Lost Keys;;0 - 20,000;11;1;10;0;0;0
1375650;Crystal Chasers League;;0 - 20,000;19;1;18;0;0;0
1375690;Arcanion: Tale of Magi;;0 - 20,000;3;0;3;0;0;0
1375740;Surviv.io - 2D Battle Royale;;100,000 - 200,000;1813;672;1141;141;178;51
1375760;Tropicalia;;0 - 20,000;49;5;44;0;0;0
1375780;The Scam;;0 - 20,000;2;0;2;0;0;0
1375810;Legends of Solitaire: Diamond Relic;;0 - 20,000;10;2;8;0;0;0
1375870;川建国同志想要连任/Comrade Trump's Re-election;;100,000 - 200,000;1030;135;895;75;83;0
1375880;Rave Heart;;20,000 - 50,000;12;0;12;0;0;0
1375920;Ghost Beat;;0 - 20,000;5;1;4;0;0;0
1375930;Minesweeper: Collector;;0 - 20,000;61;7;54;0;0;6
1375940;PULSAR;;0 - 20,000;2;0;2;0;0;0
1375970;Korean Adventures in Russia;;0 - 20,000;4;9;-5;0;0;0
1376010;YRek Lost In Portals;;0 - 20,000;6;0;6;0;0;0
1376010;YRek Lost In Portals;;0 - 20,000;6;0;6;0;0;0
1376020;BattleMaster;;50,000 - 100,000;1;1;0;0;0;0
1376030;DEV Bloodline;;50,000 - 100,000;2;0;2;0;0;0
1376060;Masked Vale;;0 - 20,000;5;0;5;0;0;0
1376070;Rushdown Revolt - Alpha Testing;;200,000 - 500,000;1165;203;962;0;0;1
1376090;Darkness Eternal;;0 - 20,000;4;2;2;0;0;0
1376140;CounterBlocks;;20,000 - 50,000;1;0;1;0;0;0
1376220;Sperm Runner;;0 - 20,000;25;9;16;0;0;0
1376260;HTML5 Javascript Game Engine;;0 - 20,000;2;3;-1;0;0;0
1376270;小小愿景;;0 - 20,000;15;4;11;0;0;0
1376290;Jet Set Corps;;0 - 20,000;7;0;7;0;0;0
1376300;Our Past;;0 - 20,000;12;5;7;0;0;0
1376340;This is My Dungeon;;0 - 20,000;6;2;4;0;0;0
1376350;Poly Pirates;;0 - 20,000;1;0;1;0;0;0
1376360;AVANTI - The Joy of Driving;;0 - 20,000;7;2;5;0;0;0
1376420;StopGate;;50,000 - 100,000;523;47;476;0;0;0
1376470;Hunted;;50,000 - 100,000;1;2;-1;0;0;0
1376520;Stick Knight Takes Over the Universe;;0 - 20,000;7;0;7;0;0;0
1376590;Sphere Game;;20,000 - 50,000;15;2;13;0;0;0
1376640;Divine Favor;;0 - 20,000;16;3;13;0;0;0
1376690;蜀山幻剑录 Sword of Shushan;;0 - 20,000;55;50;5;0;0;2
1376690;蜀山幻剑录 Sword of Shushan;;0 - 20,000;55;50;5;0;0;2
1376730;Vacation: dayOFF;;0 - 20,000;15;5;10;0;0;0
1376730;Vacation: dayOFF;;0 - 20,000;15;5;10;0;0;0
1376820;The Kingdom of Gardenia;;0 - 20,000;5;1;4;0;0;0
1376840;Lurkers;;0 - 20,000;14;1;13;0;0;0
1376870;Realm of Alters;;20,000 - 50,000;30;21;9;0;0;0
1376890;Drill Deal: Borehole (Alpha);;100,000 - 200,000;317;48;269;18;25;0
1376940;Monster Killer;;0 - 20,000;9;1;8;0;0;0
1376940;Monster Killer;;0 - 20,000;9;1;8;0;0;0
1376950;Fantasy Friends;;0 - 20,000;9;3;6;0;0;0
1377010;Sanctuary Island;;0 - 20,000;10;5;5;0;0;0
1377030;Gunnhildr;;0 - 20,000;18;3;15;0;0;0
1377060;nightmAR Protocol;;50,000 - 100,000;14;3;11;0;0;0
1377120;Your Music Puzzle;;0 - 20,000;7;1;6;0;0;0
1377140;Don't Look;;0 - 20,000;10;19;-9;0;0;0
1377150;Operation: Tango - Demo;;100,000 - 200,000;1222;172;1050;249;258;15
1377160;Enlightened Sentinel;;50,000 - 100,000;2;0;2;0;0;0
1377200;Zero Wrath Vendetta;;0 - 20,000;1;0;1;0;0;0
1377240;Five-Finger Gunslinger;;20,000 - 50,000;8;4;4;0;0;0
1377280;Electioneering;;0 - 20,000;3;4;-1;0;0;0
1377350;Spinodrum;;0 - 20,000;11;3;8;0;0;0
1377360;Vampires' Melody;;100,000 - 200,000;3301;70;3231;150;135;6
1377370;Fantasy Gladiators;;20,000 - 50,000;13;6;7;0;0;0
1377380;Night of the Dead;;200,000 - 500,000;6592;1707;4885;1533;1178;829
1377420;Baking Bustle;;0 - 20,000;13;6;7;0;0;0
1377430;Sword Reverie;;0 - 20,000;79;36;43;0;0;1
1377450;圣歌德嘉的晚钟;;100,000 - 200,000;963;63;900;0;0;11
1377540;The Viking Way;;20,000 - 50,000;148;180;-32;0;0;1
1377550;~Be a maid in the Demon World~ The Secret Café of the Demon Angel Hero.;;20,000 - 50,000;249;56;193;77;135;2
1377550;~Be a maid in the Demon World~ The Secret Café of the Demon Angel Hero.;;20,000 - 50,000;249;56;193;77;135;2
1377580;Soulworker;;1,000,000 - 2,000,000;6853;2457;4396;804;90;748
1377590;The Island;;0 - 20,000;39;46;-7;0;0;0
1377600;"""draw a card"" -Simulator";;0 - 20,000;15;3;12;0;0;0
1377680;CROSSFIRE II (2002);;50,000 - 100,000;8;0;8;0;0;0
1377800;FyreXR Festival;;0 - 20,000;0;1;-1;0;0;0
1377850;Server is Down;;0 - 20,000;6;11;-5;0;0;0
1377890;Professor Rubik’s Brain Fitness;;0 - 20,000;8;1;7;0;0;1
1377900;Train Train Train;;0 - 20,000;11;0;11;0;0;0
1377920;Big Mutha Truckers 2;;0 - 20,000;51;11;40;0;0;2
1377930;Project:Pong;;0 - 20,000;42;3;39;0;0;1
1377970;Tales From Evenfall;;0 - 20,000;2;0;2;0;0;0
1377980;RX Racing 2020 Pro;;0 - 20,000;0;1;-1;0;0;0
1378010;Eyes of The Mirror;;0 - 20,000;5;0;5;0;0;0
1378020;Beasts of Maravilla Island;;0 - 20,000;258;25;233;86;103;1
1378020;Beasts of Maravilla Island;;0 - 20,000;258;25;233;86;103;1
1378040;Tear and the Library of Labyrinths;;20,000 - 50,000;252;24;228;0;0;1
1378060;Hidden Lands - Spot the differences;;20,000 - 50,000;249;15;234;0;0;1
1378070;Drawn to Life: Two Realms;;20,000 - 50,000;103;119;-16;0;0;0
1378070;Drawn to Life: Two Realms;;20,000 - 50,000;103;119;-16;0;0;0
1378100;Treasures of the Roman Empire;;0 - 20,000;1;0;1;0;0;0
1378120;Fairy Godmother Stories: Dark Deal Collector's Edition;;0 - 20,000;7;2;5;0;0;0
1378180;《Curse of disaster spirit : Anecdotes of mansion》;;0 - 20,000;2;2;0;0;0;0
1378200;Rooftop Renegade;;0 - 20,000;1;0;1;0;0;1
1378250;Px Art;;0 - 20,000;2;0;2;0;0;0
1378260;Voodoo Kid;;0 - 20,000;8;2;6;0;0;0
1378290;The Citadel;;50,000 - 100,000;642;40;602;69;69;3
1378320;Killstreak;;0 - 20,000;0;2;-2;0;0;0
1378330;Speedgunner Ultra;;20,000 - 50,000;19;0;19;0;0;0
1378350;《Drifting : Weight of Feathers》;;20,000 - 50,000;32;10;22;0;0;0
1378360;White Hell;;100,000 - 200,000;150;4;146;0;0;1
1378370;Fallen Knight;;0 - 20,000;28;16;12;0;0;0
1378390;Endurance - space action;;20,000 - 50,000;3;3;0;0;0;0
1378470;Now There Be Goblins;;0 - 20,000;37;4;33;0;0;1
1378580;Ninjas Busters: Whack A Ninja;;0 - 20,000;2;0;2;0;0;0
1378660;NYAF;;0 - 20,000;6;0;6;0;0;0
1378670;Adapted Adventures: Crystal Cave;;0 - 20,000;6;2;4;0;0;0
1378700;CRYPTEX;;0 - 20,000;12;12;0;0;0;0
1378710;Placebo Love;;0 - 20,000;20;1;19;0;0;1
1378730;ドトコイ;;0 - 20,000;10;0;10;0;0;1
1378800;Squad 51 vs. the Flying Saucers;;20,000 - 50,000;117;3;114;0;0;1
1378810;The Haunted Dolls;;0 - 20,000;5;4;1;0;0;0
1378820;Escaping Hell;;20,000 - 50,000;2;0;2;0;0;0
1378840;Learn Spanish VR;;0 - 20,000;3;0;3;0;0;0
1378850;Escape From Monsterland;;0 - 20,000;2;3;-1;0;0;0
1378860;Cubic Currency;;20,000 - 50,000;31;4;27;0;0;0
1378870;In the House of Silence;;0 - 20,000;7;3;4;0;0;0
1378890;Indoorlands;;0 - 20,000;139;23;116;200;200;8
1378940;Verdungo;;0 - 20,000;31;3;28;0;0;1
1378990;Crash Bandicoot 4: It’s About Time;;20,000 - 50,000;867;98;769;246;335;206
1379020;The Horrorscope: Fatal Awakening;;50,000 - 100,000;359;25;334;0;0;0
1379040;Pixel Ninja;;0 - 20,000;3;0;3;0;0;0
1379050;Mystical Mayhem;;0 - 20,000;7;2;5;0;0;0
1379070;Rise of SamuraizerzZz;;0 - 20,000;23;4;19;0;0;0
1379110;Anime Feet;;20,000 - 50,000;124;24;100;8;8;2
1379120;MechNest;;20,000 - 50,000;7;5;2;0;0;2
1379130;League of Angels-Heaven's Fury;;50,000 - 100,000;355;267;88;0;0;95
1379150;Kebab House;;0 - 20,000;5;10;-5;0;0;0
1379200;Escape from Skull Dungeon;;0 - 20,000;53;22;31;0;0;0
1379270;Wild Dose: First Session;;100,000 - 200,000;61;11;50;0;0;0
1379320;Anime Play Life: Unlimited;;20,000 - 50,000;0;6;-6;0;0;0
1379320;Anime Play Life: Unlimited;;20,000 - 50,000;0;6;-6;0;0;0
1379350;Frogworld;;0 - 20,000;6;0;6;0;0;0
1379370;4 Civilizations;;0 - 20,000;11;2;9;0;0;0
1379380;Burger Joint;;20,000 - 50,000;51;0;51;0;0;0
1379450;Turtle vs. Portal;;0 - 20,000;3;0;3;0;0;0
1379470;Commissar Catlov;;0 - 20,000;3;2;1;0;0;0
1379510;Algebra Ridge;;0 - 20,000;16;3;13;0;0;0
1379550;The USB Stick Found in the Grass;;50,000 - 100,000;56;89;-33;0;0;1
1379560;Steven Universe: Unleash the Light;;50,000 - 100,000;478;18;460;0;0;9
1379570;PROJECT : KNIGHT;;0 - 20,000;5;0;5;0;0;0
1379580;Arosia;;20,000 - 50,000;6;4;2;0;0;0
1379590;Adventures in Morality: An Interactive Case Study;;20,000 - 50,000;3;3;0;0;0;0
1379590;Adventures in Morality: An Interactive Case Study;;20,000 - 50,000;3;3;0;0;0;0
1379610;First Hero - Epic of Gilgamesh;;0 - 20,000;2;0;2;0;0;0
1379640;aMAZEd;;0 - 20,000;2;0;2;0;0;0
1379660;The Developer;;0 - 20,000;17;5;12;0;0;0
1379670;Crash'em Derby;;0 - 20,000;8;3;5;0;0;0
1379830;Cyber Crush 2069;;50,000 - 100,000;585;176;409;58;60;5
1379840;Run Dummy Run;;0 - 20,000;11;4;7;0;0;0
1379870;Tribal Hunter;;20,000 - 50,000;1011;30;981;1244;1244;13
1379900;Shikokushi ~food and sightseeing and beauties~;;0 - 20,000;52;11;41;36;36;0
1379920;Total Dark;;0 - 20,000;10;14;-4;0;0;0
1379930;Power & Revolution 2020 Edition;;20,000 - 50,000;524;292;232;123;123;20
1379960;Grid Force - Mask Of The Goddess;;0 - 20,000;26;5;21;0;0;1
1379970;Solar System VR;;20,000 - 50,000;177;61;116;0;0;2
1379980;Unscripted;;20,000 - 50,000;2;0;2;0;0;0
1380010;Waiting For The Raven;;20,000 - 50,000;54;13;41;0;0;0
1380060;Urban Trial Tricky Deluxe Edition;;0 - 20,000;17;9;8;0;0;0
1380110;Sprite Basic 2 Game Engine;;0 - 20,000;0;3;-3;0;0;0
1380120;Fate of the Storm Gods;;20,000 - 50,000;7;5;2;0;0;0
1380150;Sword Game;;0 - 20,000;17;4;13;0;0;0
1380160;Inner Light;;0 - 20,000;1;0;1;0;0;0
1380170;Blood War;;0 - 20,000;8;6;2;0;0;0
1380210;Lucky Burst;;0 - 20,000;0;1;-1;0;0;0
1380220;Starsand;;50,000 - 100,000;563;213;350;414;414;41
1380250;Timber Jump VR;;0 - 20,000;0;1;-1;0;0;0
1380260;Space Empires: Starfury;;20,000 - 50,000;7;2;5;0;0;1
1380290;New Witch in Town;;0 - 20,000;2;9;-7;0;0;0
1380310;Lost Remnant: The End Tides;;20,000 - 50,000;31;1;30;0;0;0
1380320;City 13;;0 - 20,000;7;0;7;0;0;0
1380360;Battle Sweeper;;0 - 20,000;5;3;2;0;0;0
1380390;Dread X Collection 2;;20,000 - 50,000;350;13;337;249;249;3
1380400;Saving Grace;;1,000,000 - 2,000,000;25;2;23;0;0;0
1380420;Grow: Song of the Evertree;;50,000 - 100,000;1397;233;1164;366;601;95
1380430;Pummel Paladins;;50,000 - 100,000;40;2;38;0;0;4
1380470;Water Rain;;0 - 20,000;8;4;4;0;0;0
1380480;Blobert;;0 - 20,000;7;0;7;0;0;0
1380490;Winter Wastelands;;0 - 20,000;10;2;8;0;0;0
1380500;President's Sniper Shooting;;0 - 20,000;3;1;2;0;0;0
1380510;Shark Attack;;0 - 20,000;1;5;-4;0;0;0
1380520;Racing Outlaws;;0 - 20,000;18;2;16;0;0;3
1380630;The Adventures of Wolf and Hood - A Jigsaw Tale;;0 - 20,000;16;0;16;0;0;0
1380650;Draft of Darkness;;0 - 20,000;115;6;109;0;0;3
1380660;Soulpath: the final journey;;0 - 20,000;1;5;-4;0;0;0
1380690;MP5;;0 - 20,000;6;1;5;0;0;0
1380720;Tales of Esferia: Araxis;;0 - 20,000;4;0;4;0;0;0
1380760;Color Crush 2;;0 - 20,000;5;5;0;0;0;1
1380780;Battle Village;;0 - 20,000;17;10;7;0;0;0
1380780;Battle Village;;0 - 20,000;17;10;7;0;0;0
1380820;Helixian;;0 - 20,000;4;0;4;0;0;0
1380830;Space Kettle;;0 - 20,000;26;7;19;0;0;0
1380840;August of August;;0 - 20,000;14;1;13;0;0;0
1380850;Virtual Vacations;;0 - 20,000;1;4;-3;0;0;0
1380890;Block Sumo;;0 - 20,000;8;0;8;0;0;0
1380910;Stardeus;;20,000 - 50,000;680;72;608;848;909;105
1381150;Desirable;;0 - 20,000;9;11;-2;0;0;0
1381270;休止符 StopSign;;0 - 20,000;5;1;4;0;0;0
1381280;Cheat or Die;;0 - 20,000;8;1;7;0;0;0
1381290;Viking Fight;;0 - 20,000;18;8;10;0;0;0
1381360;Lair Hockey;;0 - 20,000;2;0;2;0;0;0
1381370;Lloyd the Monkey 2;;0 - 20,000;4;2;2;0;0;0
1381440;80's OVERDRIVE;;0 - 20,000;346;122;224;57;71;6
1381450;Dreadful Shadows;;20,000 - 50,000;3;0;3;0;0;0
1381460;Path of the Martyrs;;0 - 20,000;4;1;3;0;0;0
1381500;Mimicry;;0 - 20,000;8;0;8;0;0;0
1381530;Mess Adventures;;0 - 20,000;371;91;280;3;3;2
1381590;Tokyo Re:Connect Prologue;;0 - 20,000;24;3;21;0;0;0
1381610;AEON BLOOD;;0 - 20,000;5;9;-4;0;0;0
1381630;Pumpkin Dog Xtreme;;0 - 20,000;8;0;8;0;0;0
1381640;Captain Frogger;;0 - 20,000;9;0;9;0;0;0
1381650;ACTION SANDBOX;;20,000 - 50,000;574;140;434;42;42;15
1381690;Sainthum 圣颂;;0 - 20,000;0;1;-1;0;0;0
1381690;Sainthum 圣颂;;0 - 20,000;0;1;-1;0;0;0
1381720;OUBEY VR – Reise der Monaden;;20,000 - 50,000;5;0;5;0;0;0
1381770;フォーチュンサモナーズ -アルチェの精霊石-;;50,000 - 100,000;28;9;19;0;0;0
1381780;Stealthy ninja;;0 - 20,000;7;8;-1;0;0;0
1381850;Strategic Mind: Fight for Freedom;;20,000 - 50,000;103;11;92;0;0;11
1381880;The Square Key;;0 - 20,000;17;1;16;0;0;0
1381880;The Square Key;;0 - 20,000;17;1;16;0;0;0
1381980;MOTHER;;20,000 - 50,000;256;35;221;179;179;1
1382020;The Struggles Of Stefan;;0 - 20,000;1;0;1;0;0;0
1382160;Monolithic;;0 - 20,000;10;4;6;0;0;0
1382180;Escape Knox Manor;;0 - 20,000;3;0;3;0;0;0
1382190;Killer in the cabin;;0 - 20,000;74;25;49;0;0;2
1382290;Betrayer: Curse of the Spine;;0 - 20,000;8;1;7;0;0;0
1382310;Splinter;;0 - 20,000;1;0;1;0;0;0
1382330;Persona 5 Strikers;;200,000 - 500,000;10466;917;9549;1442;1792;466
1382350;The Beast of Stormy Forest;;50,000 - 100,000;3;6;-3;0;0;0
1382370;ProjectTeo;;0 - 20,000;14;4;10;0;0;0
1382380;Aurora;;0 - 20,000;5;0;5;0;0;0
1382450;My First Date RPG (Presented by: ProjectSummerIce.com);;0 - 20,000;0;4;-4;0;0;0
1382630;Fruit Clicker;;0 - 20,000;3;0;3;0;0;0
1382670;FIRE  TRUMP - Air Combat VR;;50,000 - 100,000;2;1;1;0;0;0
1382710;OUBEY VR – Cosmic Voyage;;0 - 20,000;3;2;1;0;0;0
1382730;Midnight Scenes Episode 2 (Special Edition);;20,000 - 50,000;85;3;82;0;0;2
1382770;Knightczech: The beginning;;0 - 20,000;5;2;3;0;0;0
1382790;Demons of Asteborg;;0 - 20,000;31;2;29;0;0;0
1382800;A Winding Path;;0 - 20,000;15;0;15;0;0;0
1382840;Space Bar at the End of the Galaxy;;0 - 20,000;10;6;4;0;0;0
1382860;Heroes of Dungeon;;0 - 20,000;2;7;-5;0;0;0
1382870;World War Academy: COMMANDER 1;;20,000 - 50,000;1;0;1;0;0;0
1382890;Mystic Midway: Rest in Pieces;;200,000 - 500,000;5;0;5;0;0;0
1382910;Hell Architect: Prologue;;100,000 - 200,000;684;149;535;0;0;0
1382920;Caravan Trade Tycoon;;20,000 - 50,000;20;5;15;0;0;0
1382980;Fech The Ferret;;0 - 20,000;9;2;7;0;0;0
1383010;Balconing Simulator 2020;;0 - 20,000;7;0;7;0;0;0
1383020;Germany at War - Soviet Dawn;;0 - 20,000;3;1;2;0;0;1
1383040;Delivery Company Clicker;;0 - 20,000;7;4;3;0;0;0
1383050;Chess Knights: Shinobi;;20,000 - 50,000;53;10;43;0;0;0
1383060;eyeDASH;;0 - 20,000;2;0;2;0;0;0
1383060;eyeDASH;;0 - 20,000;2;0;2;0;0;0
1383120;LouveSystems' TrackMasters;;0 - 20,000;3;0;3;0;0;0
1383160;Endless Firepower;;0 - 20,000;16;3;13;0;0;0
1383170;100 RUB: Operation Global Denomination;;0 - 20,000;33;8;25;0;0;0
1383200;Clouds of Rain;;20,000 - 50,000;7;2;5;0;0;0
1383220;Space Crisis;;0 - 20,000;1;0;1;0;0;0
1383250;Please Fix The Road;;0 - 20,000;105;11;94;65;65;2
1383270;Pre-Shave;;0 - 20,000;36;5;31;0;0;0
1383280;Josh Journey: Darkness Totems;;0 - 20,000;17;1;16;0;0;0
1383290;Kidgilantes;;20,000 - 50,000;4;1;3;0;0;0
1383340;HEXONEX;;0 - 20,000;2;1;1;0;0;0
1383400;Crystal Ortha;;20,000 - 50,000;5;2;3;0;0;0
1383400;Crystal Ortha;;20,000 - 50,000;5;2;3;0;0;0
1383410;Gravitaze: One;;0 - 20,000;7;0;7;0;0;0
1383440;INSIDE LIGHT;;0 - 20,000;8;7;1;0;0;0
1383450;心境 VR / Mind VR Exploration;;0 - 20,000;49;12;37;0;0;0
1383490;Run For Your Life;;;;;0;;;
1383500;客栈江湖-Vagabond Inn;;0 - 20,000;39;24;15;0;0;0
1383500;客栈江湖-Vagabond Inn;;0 - 20,000;39;24;15;0;0;0
1383510;Dark Stone: The Lightseeker;;0 - 20,000;44;3;41;0;0;0
1383550;Soul Dossier ;;100,000 - 200,000;813;587;226;14;13;0
1383570;Ballex²: The Hanging Gardens;;0 - 20,000;44;3;41;0;0;6
1383580;Mechone;;0 - 20,000;0;1;-1;0;0;0
1383630;Antarctica 88;;20,000 - 50,000;124;15;109;0;0;0
1383640;Attack at Dawn: North Africa;;0 - 20,000;41;3;38;0;0;1
1383650;Drone VR;;0 - 20,000;12;1;11;0;0;0
1383670;KING GOD DOMAIN;;0 - 20,000;22;14;8;0;0;0
1383680;Isekai Succubus ~My Genderbent Saga in Another World~;;20,000 - 50,000;110;13;97;0;0;2
1383690;A Wake Inn;;0 - 20,000;27;16;11;0;0;0
1383700;Jet Kave Adventure;;0 - 20,000;48;4;44;0;0;0
1383720;Cyber-doge 2077: Meme runner;;0 - 20,000;172;7;165;0;0;0
1383730;Absolutely Goode Championship;;0 - 20,000;3;0;3;0;0;0
1383740;My Cute Commissar;;20,000 - 50,000;290;37;253;0;0;1
1383740;My Cute Commissar;;20,000 - 50,000;290;37;253;0;0;1
1383760;Fortification: tower defence;;0 - 20,000;15;7;8;0;0;0
1383770;Interstate Drifter 1999;;50,000 - 100,000;260;11;249;0;0;0
1383830;Breadbox Game Pack;;0 - 20,000;7;0;7;0;0;0
1383850;Gurobu;;20,000 - 50,000;20;0;20;0;0;0
1383930;Swordian Hero;;0 - 20,000;2;2;0;0;0;0
1383960;Nickelodeon Kart Racers 2: Grand Prix;;0 - 20,000;427;108;319;4;4;13
1383970;Captain Sabertooth and the Magic Diamond;;0 - 20,000;27;4;23;0;0;2
1383990;Our Way;;0 - 20,000;5;8;-3;0;0;0
1384020;Ovrlay - VR Discord Notifications;;0 - 20,000;27;13;14;0;0;2
1384030;Boppio;;0 - 20,000;47;38;9;0;0;1
1384090;AutoLand;;0 - 20,000;9;2;7;0;0;0
1384110;Cascade Cafe;;0 - 20,000;15;0;15;0;0;0
1384160;GUILTY GEAR -STRIVE-;;500,000 - 1,000,000;32761;2863;29898;2849;1241;2439
1384170;天虹书店 Tian Hong Bookstore;;0 - 20,000;12;3;9;0;0;1
1384290;Dinoscape;;20,000 - 50,000;182;41;141;0;0;1
1384320;Grapple Tournament;;0 - 20,000;234;19;215;0;0;0
1384350;Bricks Frenzy;;0 - 20,000;11;2;9;0;0;0
1384380;KUUKIYOMI 2: Consider It More! - New Era;;0 - 20,000;72;15;57;0;0;1
1384390;Photo Studio;;0 - 20,000;5;8;-3;0;0;0
1384440;The Call Centre;;0 - 20,000;1;2;-1;0;0;0
1384450;Jungles of Maxtheria;;0 - 20,000;1;0;1;0;0;0
1384460;Puzzle Angry Cat;;0 - 20,000;3;8;-5;0;0;0
1384480;Pathfinder Puzzle;;0 - 20,000;2;0;2;0;0;0
1384490;I hope she's ok;;0 - 20,000;35;6;29;0;0;0
1384500;The Owl Quest;;0 - 20,000;5;1;4;0;0;0
1384510;Floating life in Other-world;;0 - 20,000;1;3;-2;0;0;0
1384530;Lion Quest Infinity;;0 - 20,000;11;2;9;0;0;0
1384540;OPEC IDLE;;0 - 20,000;12;7;5;0;0;0
1384550;School of Magic Prologue;;20,000 - 50,000;24;2;22;0;0;0
1384570;Kanały '44;;0 - 20,000;0;1;-1;0;0;0
1384620;Ninja Hanrei;;20,000 - 50,000;178;37;141;0;0;1
1384670;Dark Tales: Edgar Allan Poe's The Devil in the Belfry Collector's Edition;;0 - 20,000;8;0;8;0;0;1
1384680;Todd's Spider Dream;;0 - 20,000;3;0;3;0;0;0
1384700;A Gay Love Story About Gay Love;;20,000 - 50,000;394;63;331;0;0;3
1384740;SkeleToon:forgotten memories;;0 - 20,000;1;0;1;0;0;0
1384760;IN THE DARK;;0 - 20,000;4;1;3;0;0;0
1384770;Scrutinized;;50,000 - 100,000;771;90;681;46;46;5
1384790;D100 Dungeon Computer Companion;;0 - 20,000;15;7;8;0;0;0
1384820;Psychocat: The Door;;0 - 20,000;14;3;11;0;0;0
1384840;XOL;;50,000 - 100,000;1;1;0;0;0;0
1384870;Drifters Loot the Galaxy - Beta;;0 - 20,000;19;9;10;0;0;0
1384880;Frontier Quest;;0 - 20,000;9;1;8;0;0;0
1384890;Flag Collection;;0 - 20,000;60;24;36;0;0;0
1384940;Egression;;0 - 20,000;57;1;56;0;0;0
1384960;Unit 404;;0 - 20,000;39;4;35;0;0;0
1384990;魔法考核冒险;;20,000 - 50,000;2;0;2;0;0;0
1385050;This Game is Trash;;0 - 20,000;2;0;2;0;0;0
1385090;Grand Father ISLAND;;0 - 20,000;1;2;-1;0;0;0
1385100;Insurmountable;;20,000 - 50,000;505;99;406;207;370;4
1385180;Kings0;;20,000 - 50,000;3;1;2;0;0;0
1385190;After The War;;50,000 - 100,000;6;20;-14;0;0;0
1385210;Impulse, From Here!;;20,000 - 50,000;120;20;100;0;0;0
1385210;Impulse, From Here!;;20,000 - 50,000;120;20;100;0;0;0
1385260;If It Please the Court;;0 - 20,000;19;0;19;0;0;0
1385320;Pipe Mania;;0 - 20,000;8;1;7;0;0;0
1385350;Clowns;;0 - 20,000;9;1;8;0;0;0
1385380;Across the Obelisk;;200,000 - 500,000;6123;504;5619;5033;4008;1167
1385460;Drifters Loot the Galaxy;;20,000 - 50,000;80;56;24;0;0;0
1385480;Gangster Empire: Vendetta;;0 - 20,000;4;4;0;0;0;0
1385500;WTC : Relentless Protagonist [SxS];;0 - 20,000;9;1;8;0;0;0
1385540;Beat Me If You Can;;0 - 20,000;9;2;7;0;0;0
1385570;Fateholder Quest;;20,000 - 50,000;2;0;2;0;0;0
1385590;Spark The Battle Dog;;0 - 20,000;9;0;9;0;0;0
1385620;Model Sisters;;0 - 20,000;2;1;1;0;0;0
1385650;Hot Pot For One;;0 - 20,000;104;42;62;0;0;1
1385670;The Mutineer;;0 - 20,000;17;1;16;0;0;0
1385680;Corpse Box Racers;;0 - 20,000;17;0;17;0;0;0
1385690;Battletronics;;100,000 - 200,000;4;1;3;0;0;0
1385700;True Hate;;0 - 20,000;35;11;24;0;0;0
1385730;Mosaique Neko Waifus 3;;50,000 - 100,000;1653;90;1563;89;133;4
1385740;SuperNatural Duels;;0 - 20,000;5;13;-8;0;0;0
1385750;Waste X;;0 - 20,000;1;0;1;0;0;0
1385760;Super Marble Brothers;;0 - 20,000;3;3;0;0;0;0
1385780;My Village Life;;0 - 20,000;164;18;146;0;0;0
1385820;Ninja Kunoichi;;0 - 20,000;1;0;1;0;0;0
1385830;MagicalGirl Mimi;;0 - 20,000;1;0;1;0;0;0
1385840;Cube Worlds Survival;;0 - 20,000;9;11;-2;0;0;0
1385880;五五午时书;;20,000 - 50,000;271;21;250;0;0;0
1385920;Impossible Pixels;;0 - 20,000;8;1;7;0;0;0
1385940;Panty&Demons;;0 - 20,000;29;4;25;0;0;1
1385950;Guilt Free;;20,000 - 50,000;188;28;160;0;0;2
1385960;Bird path;;0 - 20,000;32;5;27;0;0;0
1385970;Robowork;;0 - 20,000;7;3;4;0;0;0
1385990;The Light at the End of the Ocean;;0 - 20,000;3;0;3;0;0;0
1386000;I'm Russia;;0 - 20,000;2;1;1;0;0;0
1386020;Lost Remnant: Roaches to Riches;;0 - 20,000;17;1;16;0;0;0
1386040;Jelly Brawl: Classic;;20,000 - 50,000;262;107;155;0;0;2
1386090;Ants;;0 - 20,000;1;1;0;0;0;0
1386110;Xentron Attack;;50,000 - 100,000;3;0;3;0;0;0
1386160;Pier Pressure;;0 - 20,000;19;3;16;0;0;0
1386180;Bitty Engine;;0 - 20,000;26;2;24;0;0;0
1386190;Fishhead: Blueprint;;0 - 20,000;4;0;4;0;0;0
1386210;Queen's Garden 2;;20,000 - 50,000;9;8;1;0;0;0
1386280;The Game is ON;;0 - 20,000;6;0;6;0;0;0
1386310;Airplane Racer 2021;;0 - 20,000;3;1;2;0;0;0
1386320;Table Top Turrets;;0 - 20,000;3;1;2;0;0;0
1386330;Funanigans: Party Games;;0 - 20,000;1;3;-2;0;0;0
1386340;Monads II;;0 - 20,000;3;1;2;0;0;0
1386360;A Dark Ice Saga: The Rescue;;;;;0;;;
1386440;B67;;0 - 20,000;35;6;29;0;0;0
1386460;Zodiakalik;;100,000 - 200,000;4;0;4;0;0;0
1386500;cyan;;0 - 20,000;39;34;5;0;0;1
1386510;How to Win: Season One;;0 - 20,000;12;3;9;0;0;0
1386520;Attic;;0 - 20,000;1;1;0;0;0;0
1386530;VR Travelling in the Roman Empire (VR Rome Time machine travel in history);;0 - 20,000;4;3;1;0;0;0
1386560;Fancy Skiing Ⅲ Pro;;0 - 20,000;0;3;-3;0;0;0
1386620;Anuchard;;0 - 20,000;64;10;54;0;0;1
1386650;ZCREW;;20,000 - 50,000;175;136;39;0;0;2
1386660;Dead Body Killer;;0 - 20,000;4;3;1;0;0;0
1386680;Rain Leak Life -  雨漏り人生;;0 - 20,000;1;0;1;0;0;0
1386700;Venkazoid Blast;;0 - 20,000;2;0;2;0;0;0
1386710;The HeartBeat;;20,000 - 50,000;92;2;90;0;0;1
1386730;Wordle 2;;20,000 - 50,000;114;25;89;130;130;5
1386770;Particubes;;0 - 20,000;50;10;40;0;0;2
1386780;City of Gangsters;;50,000 - 100,000;793;262;531;106;106;51
1386790;Gordian Rooms: A curious heritage Prologue;;0 - 20,000;90;10;80;0;0;0
1386810;Man in gravity;;0 - 20,000;16;7;9;0;0;0
1386810;Man in gravity;;0 - 20,000;16;7;9;0;0;0
1386840;An Evil Existence;;0 - 20,000;16;7;9;0;0;0
1386870;Wraith: The Oblivion - Afterlife;;0 - 20,000;37;29;8;0;0;0
1386890;Hyper Dash;;50,000 - 100,000;159;21;138;48;48;17
1386900;Observer: System Redux;;200,000 - 500,000;1342;185;1157;64;64;3
1386910;サチ江 -死道-/Sachie -Death Road-;;0 - 20,000;9;5;4;0;0;0
1386910;サチ江 -死道-/Sachie -Death Road-;;0 - 20,000;9;5;4;0;0;0
1386940;UEBERNATURAL: The Video Game - Prologue;;0 - 20,000;50;4;46;0;0;0
1386980;PANIC STATION;;0 - 20,000;25;26;-1;0;0;0
1386990;Vectromirror;;0 - 20,000;20;7;13;0;0;0
1386990;Vectromirror;;0 - 20,000;20;7;13;0;0;0
1387000;Island of the Lost;;0 - 20,000;20;4;16;0;0;0
1387010;Kings Town;;0 - 20,000;14;9;5;0;0;0
1387030;Sly Slime;;0 - 20,000;40;4;36;0;0;0
1387060;Tale of an Apocalypse;;0 - 20,000;3;4;-1;0;0;0
1387120;E.X.P.L.O.R.: A New World;;0 - 20,000;7;1;6;0;0;0
1387150;A Case of the Crabs: Rehash;;20,000 - 50,000;49;1;48;0;0;0
1387170;Similo: The Card Game;;0 - 20,000;25;9;16;0;0;1
1387200;Covert Commando;;0 - 20,000;5;1;4;0;0;0
1387250;Discovery Yard Investigation;;0 - 20,000;2;4;-2;0;0;0
1387300;Joy the Pug;;0 - 20,000;2;0;2;0;0;0
1387320;Left Dex;;0 - 20,000;2;0;2;0;0;0
1387350;Ken ga Kimi: Momoyo Tsuzuri;;0 - 20,000;124;15;109;0;0;1
1387400;a Story of Merchant;;0 - 20,000;0;1;-1;0;0;0
1387410;Invaders;;0 - 20,000;5;3;2;0;0;0
1387450;Ninja Castle Escape;;0 - 20,000;4;1;3;0;0;0
1387460;Melancholy Love;;0 - 20,000;57;2;55;0;0;0
1387480;Farmer And Tree;;0 - 20,000;73;10;63;0;0;2
1387510;Last Mortem;;20,000 - 50,000;48;26;22;0;0;0
1387560;Educational Games for Kids;;0 - 20,000;22;5;17;0;0;2
1387580;AbsentedAge: Squarebound;;50,000 - 100,000;57;8;49;0;0;1
1387590;列传：革新战争;;20,000 - 50,000;164;45;119;0;0;2
1387610;Cowboys n' Stuff;;0 - 20,000;5;1;4;0;0;0
1387620;Save Aisha;;0 - 20,000;5;0;5;0;0;0
1387830;Hate Wave;;0 - 20,000;1;2;-1;0;0;0
1387870;Alien Cat 8;;0 - 20,000;4;2;2;0;0;0
1387910;BOOM Bound;;0 - 20,000;2;0;2;0;0;0
1387950;Crossroads of Helmia;;20,000 - 50,000;1;0;1;0;0;0
1387970;Hello Teacher;;0 - 20,000;25;15;10;0;0;0
1387980;Rock'n Cow;;0 - 20,000;9;0;9;0;0;0
1388010;Easy puzzle: Animals 2;;20,000 - 50,000;10;0;10;0;0;0
1388030;Bocce VR Simulator;;50,000 - 100,000;5;4;1;0;0;0
1388090;Line Dots;;0 - 20,000;21;2;19;0;0;1
1388130;Religion inc God Simulator;;0 - 20,000;70;18;52;67;134;1
1388140;Arwinia;;0 - 20,000;2;2;0;0;0;0
1388150;Dispersion;;0 - 20,000;6;3;3;0;0;0
1388160;Rad Rocket;;0 - 20,000;19;0;19;0;0;0
1388230;DANMAKAI: Red Forbidden Fruit;;0 - 20,000;81;5;76;0;0;1
1388260;P.I.D.;;0 - 20,000;2;0;2;0;0;0
1388280;Country Discoverer;;0 - 20,000;15;0;15;0;0;0
1388310;Tumbled;;50,000 - 100,000;2;1;1;0;0;0
1388320;老板，游戏凉了！- Game Company Simulator: back to 2000;;0 - 20,000;151;78;73;0;0;0
1388330;Hermes: Sibyls' Prophecy;;0 - 20,000;19;0;19;0;0;0
1388350;Parallel;;0 - 20,000;18;1;17;0;0;2
1388370;Heroic Armored Company;;20,000 - 50,000;102;65;37;0;0;0
1388380;SituationCovid;;0 - 20,000;0;2;-2;0;0;0
1388390;Impossible Maze;;0 - 20,000;4;0;4;0;0;0
1388400;CuberPunk 2090;;0 - 20,000;6;2;4;0;0;0
1388420;Buildmark;;0 - 20,000;2;0;2;0;0;0
1388430;История бомжа;;0 - 20,000;46;21;25;0;0;0
1388490;Capital Simulator;;0 - 20,000;30;20;10;0;0;1
1388510;トラウマーメイド;;0 - 20,000;8;0;8;0;0;0
1388570;Seduction;;0 - 20,000;28;26;2;0;0;0
1388590;Yakuza 6: The Song of Life;;200,000 - 500,000;3770;268;3502;1556;2021;160
1388650;League Of Enthusiastic Losers;;0 - 20,000;137;23;114;0;0;0
1388670;Modern Puzzle;;20,000 - 50,000;3;0;3;0;0;0
1388690;Taivas;;0 - 20,000;0;2;-2;0;0;0
1388720;Japanese Romaji Adventure;;20,000 - 50,000;9;2;7;0;0;0
1388740;Thief Girls Quartet;;0 - 20,000;4;0;4;0;0;0
1388770;Cruelty Squad;;500,000 - 1,000,000;9577;296;9281;303;430;53
1388790;Colorpick - PRO;;0 - 20,000;4;3;1;0;0;0
1388860;Unmemory;;;;;0;;;
1388870;Arcade Paradise;;20,000 - 50,000;620;80;540;576;576;44
1388870;Arcade Paradise;;20,000 - 50,000;620;80;540;576;576;44
1388880;Doki Doki Literature Club Plus!;;500,000 - 1,000,000;18130;609;17521;410;364;101
1388900;The Banana Saved The World;;0 - 20,000;2;1;1;0;0;0
1388910;Deadly Forest;;50,000 - 100,000;7;11;-4;0;0;0
1389000;Boom Dojo;;0 - 20,000;1;3;-2;0;0;0
1389010;Deathroids;;50,000 - 100,000;17;1;16;0;0;0
1389020;The Cleaner;;0 - 20,000;58;32;26;0;0;1
1389030;End Reach;;0 - 20,000;5;0;5;0;0;0
1389040;Drift Racer;;0 - 20,000;1;0;1;0;0;0
1389070;HOLY QURAN VR EXPERİENCE;;0 - 20,000;24;5;19;0;0;0
1389090;Robot Female Hero 3;;20,000 - 50,000;0;1;-1;0;0;0
1389130;Folkloric Excursion;;0 - 20,000;2;1;1;0;0;0
1389180;The Perfect Shape;;0 - 20,000;7;0;7;0;0;0
1389190;Rear of Business;;50,000 - 100,000;4;4;0;0;0;0
1389260;Isles of Limbo;;100,000 - 200,000;187;73;114;0;0;0
1389270;Don't Crash - The Political Game;;0 - 20,000;113;6;107;0;0;0
1389300;Soulcaster;;20,000 - 50,000;55;4;51;0;0;0
1389360;Mech Armada;;20,000 - 50,000;330;61;269;30;30;3
1389380;故乡的记忆：味缘篇;;0 - 20,000;8;2;6;0;0;0
1389410;Record of Battle 3D Maiden Wars;;20,000 - 50,000;3;1;2;0;0;0
1389420;Luise and Secret Basement Rooms;;50,000 - 100,000;0;1;-1;0;0;0
1389430;Trash Can Dungeon - Battle Against The ZOO;;20,000 - 50,000;1;1;0;0;0;0
1389450;The Spirit;;0 - 20,000;13;9;4;0;0;0
1389510;Souls Lore;;50,000 - 100,000;5;1;4;0;0;0
1389530;Happy Marriage Project - Starting from 9 years old -;;20,000 - 50,000;12;0;12;0;0;0
1389540;Wesprau Senki;;50,000 - 100,000;1;1;0;0;0;1
1389550;Mind Scanners;;50,000 - 100,000;646;166;480;250;295;13
1389560;Paint Girl;;20,000 - 50,000;607;97;510;51;70;0
1389610;Hell Road VR;;0 - 20,000;58;9;49;0;0;0
1389630;High Entropy: Challenges;;100,000 - 200,000;915;43;872;0;0;4
1389650;Escape Hospital-脫出 失憶病棟;;0 - 20,000;24;0;24;0;0;8
1389730;Abiko The Miko;;0 - 20,000;4;0;4;0;0;0
1389740;Accel Magician Mimi;;50,000 - 100,000;2;0;2;0;0;0
1389750;RoboPhobik;;20,000 - 50,000;14;0;14;0;0;0
1389780;Running Challenge;;0 - 20,000;4;0;4;0;0;0
1389830;Electronic World Z;;0 - 20,000;0;2;-2;0;0;0
1389850;Digital Janitors;;0 - 20,000;19;0;19;0;0;1
1389880;Space Monster;;0 - 20,000;5;5;0;0;0;0
1389890;10mg: You are such a Soft and Round Kitten.;;20,000 - 50,000;66;1;65;0;0;0
1389990;Oblivity - Find your perfect Sensitivity;;200,000 - 500,000;768;166;602;205;205;64
1390000;Antadin DX;;20,000 - 50,000;13;2;11;0;0;0
1390010;pyramida;;20,000 - 50,000;465;70;395;51;51;8
1390020;活体三国;;0 - 20,000;0;1;-1;0;0;0
1390080;Tank Rampage;;0 - 20,000;0;1;-1;0;0;0
1390120;Nodes;;0 - 20,000;28;16;12;0;0;3
1390190;APICO;;50,000 - 100,000;687;46;641;9;9;30
1390190;APICO;;50,000 - 100,000;687;46;641;9;9;30
1390300;Stream Arenas;;0 - 20,000;37;3;34;0;0;0
1390350;Webbed;;200,000 - 500,000;9338;205;9133;231;269;53
1390370;Winds Rhapsody;;50,000 - 100,000;42;7;35;0;0;0
1390380;Wolf's Gang;;50,000 - 100,000;115;10;105;0;0;0
1390390;Shu's Misfortune;;20,000 - 50,000;13;7;6;0;0;0
1390410;Midnight Fight Express;;50,000 - 100,000;1038;110;928;11;11;18
1390480;Never BreakUp Beta;;50,000 - 100,000;130;54;76;19;25;0
1390490;Kohate;;0 - 20,000;47;5;42;0;0;0
1390520;cameleon;;0 - 20,000;1;1;0;0;0;0
1390560;Jumping Platform Minigame;;0 - 20,000;4;0;4;0;0;0
1390560;Jumping Platform Minigame;;0 - 20,000;4;0;4;0;0;0
1390580;Curse Lsland;;0 - 20,000;12;17;-5;0;0;0
1390600;Shachibato! President, It's Time for Battle! Maju Wars;;0 - 20,000;57;35;22;0;0;0
1390600;Shachibato! President, It's Time for Battle! Maju Wars;;0 - 20,000;57;35;22;0;0;0
1390650;SimpleProject;;0 - 20,000;2;11;-9;0;0;0
1390670;Escape from Naraka;;0 - 20,000;88;11;77;0;0;0
1390680;Music Maker (64 Bit) Steam Edition;;50,000 - 100,000;87;110;-23;34;36;22
1390690;MachineryWorld;;0 - 20,000;4;3;1;0;0;1
1390700;The Crackpet Show;;0 - 20,000;432;50;382;735;735;25
1390830;Flower Challenge;;0 - 20,000;6;18;-12;0;0;0
1390880;Castle Wonders - A Castle Tale;;0 - 20,000;9;6;3;0;0;0
1390920;Marbles: Razor's Wrath;;0 - 20,000;1;0;1;0;0;0
1390970;Abstractanks;;0 - 20,000;4;0;4;0;0;0
1391000;Junkyard Simulator: Prologue;;50,000 - 100,000;210;241;-31;0;0;0
1391000;Junkyard Simulator: Prologue;;50,000 - 100,000;210;241;-31;0;0;0
1391020;Tomes and Quests: a Word RPG;;0 - 20,000;20;11;9;0;0;1
1391050;Kraken Smash: Volleyball;;0 - 20,000;18;0;18;0;0;0
1391090;BUGWORLD:ONLINE PRESENTS MITCH MAKER;;0 - 20,000;28;5;23;0;0;0
1391130;Asteroad;;0 - 20,000;1;0;1;0;0;0
1391160;EPEJSODION Dodgeball Attack;;0 - 20,000;2;1;1;0;0;0
1391220;Scrapnaut: Prologue;;100,000 - 200,000;648;90;558;80;80;1
1391250;WKSP Rumble;;0 - 20,000;90;17;73;0;0;0
1391350;Happy Summer Holiday;;0 - 20,000;2;0;2;0;0;0
1391400;Halloween World;;0 - 20,000;2;3;-1;0;0;0
1391430;The Outbreak Guardian;;0 - 20,000;2;2;0;0;0;0
1391450;Case 00: The Cannibal Boy;;0 - 20,000;92;21;71;0;0;0
1391530;Mud and Blood;;0 - 20,000;346;39;307;3788;3788;41
1391540;Uberlaufer;;0 - 20,000;54;6;48;0;0;2
1391550;Amusemos;;0 - 20,000;0;1;-1;0;0;0
1391570;Two by One;;0 - 20,000;1;0;1;0;0;0
1391600;Anime Jigsaw Puzzles;;0 - 20,000;5;1;4;0;0;0
1391610;Drifters Don't Brake;;0 - 20,000;6;0;6;0;0;0
1391620;Astero;;0 - 20,000;1;0;1;0;0;0
1391690;War Identity;;50,000 - 100,000;68;59;9;0;0;1
1391720;HANG IN ! MONKEY BARS ROBOT;;0 - 20,000;1;1;0;0;0;0
1391740;S H R i M P;;0 - 20,000;25;4;21;0;0;0
1391770;Sushi Slammers;;0 - 20,000;1;0;1;0;0;0
1391940;DogFight;;50,000 - 100,000;2;0;2;0;0;0
1391960;Star Island;;0 - 20,000;41;0;41;0;0;0
1391990;Berries Challenge;;0 - 20,000;7;16;-9;0;0;0
1392000;Corona Sector;;0 - 20,000;1;0;1;0;0;0
1392030;Draft Day Sports: Pro Football 2021;;0 - 20,000;31;17;14;0;0;18
1392040;グランドインテンション・アジャストメント;;0 - 20,000;12;3;9;0;0;0
1392060;Erzurum;;50,000 - 100,000;1454;2255;-801;319;429;13
1392070;B.D.K;;0 - 20,000;4;1;3;0;0;0
1392080;Dimetrosaur 2;;0 - 20,000;7;0;7;0;0;0
1392130;Game Of Puzzles: Slavic Mythology;;0 - 20,000;21;0;21;0;0;0
1392140;Project Gravity;;0 - 20,000;3;0;3;0;0;0
1392150;Hover Attack;;0 - 20,000;13;0;13;0;0;1
1392170;Schastye;;20,000 - 50,000;137;59;78;0;0;0
1392190;Rock Paper Sock;;20,000 - 50,000;5;6;-1;0;0;0
1392230;Road Home;;0 - 20,000;1;0;1;0;0;0
1392340;Shop Tycoon: Prepare your wallet;;0 - 20,000;115;31;84;29;29;16
1392410;Seeking Revenge;;0 - 20,000;1;0;1;0;0;0
1392490;Forklift Load;;20,000 - 50,000;88;14;74;0;0;0
1392510;The logic inside;;0 - 20,000;2;3;-1;0;0;0
1392540;缄默星空 Silent Space;;20,000 - 50,000;18;1;17;0;0;0
1392560;Serious Fun Football;;0 - 20,000;23;13;10;0;0;0
1392570;Dream Knights;;0 - 20,000;2;1;1;0;0;0
1392590;VIETNAM WAR PLATOON 越战排 (AI WAR Game);;0 - 20,000;1;1;0;0;0;0
1392600;Kazakh Drive;;0 - 20,000;169;39;130;0;0;0
1392650;BLASTRONAUT;;0 - 20,000;100;22;78;512;512;1
1392660;Ice star Chapter 2;;0 - 20,000;1;0;1;0;0;0
1392670;Unbeliever;;0 - 20,000;13;5;8;0;0;0
1392690;Gravitational;;0 - 20,000;2;3;-1;0;0;0
1392700;AGOS - A Game Of Space;;0 - 20,000;56;35;21;54;54;0
1392750;Lost Patrol;;100,000 - 200,000;1;5;-4;0;0;0
1392770;Practical Shooting Simulator;;0 - 20,000;6;0;6;0;0;0
1392780;The Companion;;0 - 20,000;53;14;39;0;0;0
1392790;Asteroids... But Roguelite;;0 - 20,000;15;2;13;0;0;0
1392790;Asteroids... But Roguelite;;0 - 20,000;15;2;13;0;0;0
1392820;Milk inside a bag of milk inside a bag of milk;;200,000 - 500,000;15498;452;15046;196;47;19
1392960;STORY OF SEASONS: Pioneers of Olive Town;;20,000 - 50,000;799;135;664;92;92;74
1393080;Labyrinths of the World: Hearts of the Planet Collector's Edition;;0 - 20,000;5;2;3;0;0;0
1393100;Block Arena;;0 - 20,000;26;7;19;0;0;0
1393120;Get Out! Snakes!;;0 - 20,000;18;2;16;0;0;0
1393210;Dashie's Puh-ranormal Activity;;0 - 20,000;49;1;48;0;0;0
1393220;Electrify;;50,000 - 100,000;1;4;-3;0;0;0
1393270;12 bananas;;20,000 - 50,000;136;38;98;0;0;0
1393310;Space Hole 2020;;0 - 20,000;12;1;11;0;0;0
1393320;Keyword: A Spider's Thread;;0 - 20,000;179;22;157;15;15;0
1393340;Battle Hunters;;0 - 20,000;8;2;6;0;0;0
1393350;Swaying Girl;;200,000 - 500,000;3861;437;3424;57;33;9
1393360;Onder;;0 - 20,000;0;2;-2;0;0;0
1393370;Actraiser Renaissance;;20,000 - 50,000;393;116;277;0;0;9
1393380;Reverse Defenders;;0 - 20,000;20;9;11;0;0;2
1393410;Seek Girl V;;50,000 - 100,000;644;254;390;22;30;1
1393420;TOKOYO: The Tower of Perpetuity;;0 - 20,000;379;38;341;100;139;3
1393460;Mythicard;;0 - 20,000;40;7;33;0;0;0
1393480;Union;;0 - 20,000;9;0;9;0;0;0
1393490;CheeseCube;;0 - 20,000;23;0;23;0;0;0
1393500;Time Break Chronicles;;50,000 - 100,000;135;10;125;0;0;3
1393560;Self gunsbase;;0 - 20,000;3;0;3;0;0;0
1393570;Superbugs: Awaken;;0 - 20,000;156;10;146;0;0;2
1393580;The Amulet of AmunRun;;0 - 20,000;10;13;-3;0;0;2
1393580;The Amulet of AmunRun;;0 - 20,000;10;13;-3;0;0;2
1393610;CLASSIC TANKS 2020;;20,000 - 50,000;8;6;2;0;0;0
1393640;Home Designer - Living Room;;0 - 20,000;8;6;2;0;0;0
1393650;BlockBustersVR;;0 - 20,000;1;0;1;0;0;0
1393660;Rising Constellation;;0 - 20,000;44;6;38;0;0;0
1393690;WAVER: A Typing Adventure;;0 - 20,000;3;1;2;0;0;0
1393740;Vincula;;0 - 20,000;7;1;6;0;0;0
1393750;Ocean's Heart;;100,000 - 200,000;770;165;605;0;0;5
1393770;Fury Knight;;0 - 20,000;1;4;-3;0;0;0
1393780;OVR Locomotion Effect : Anti-VR Sickness;;0 - 20,000;20;0;20;0;0;0
1393810;Surabaya Inferno;;0 - 20,000;0;1;-1;0;0;0
1393820;Prodigal;;0 - 20,000;167;6;161;0;0;6
1393830;INFLUXIS;;0 - 20,000;81;29;52;0;0;0
1393850;Outer Frontier;;0 - 20,000;0;1;-1;0;0;0
1393890;Sweet Dungeon;;0 - 20,000;15;12;3;0;0;0
1393910;Jolly Good: Cakes and Ale;;0 - 20,000;38;1;37;0;0;1
1393930;Speedway Challenge 20;;0 - 20,000;32;4;28;0;0;0
1393960;Battle Command;;0 - 20,000;2;0;2;0;0;0
1393970;My Jigsaw Adventures - The Source of Power;;50,000 - 100,000;17;0;17;0;0;0
1394030;CESSPOOL;;0 - 20,000;11;1;10;0;0;0
1394060;Viking Idle;;0 - 20,000;3;5;-2;0;0;0
1394090;Power of Ten - Demo;;0 - 20,000;46;1;45;0;0;1
1394130;Breach Wanderers;;0 - 20,000;115;8;107;0;0;4
1394140;You Can Pet The Dog VR;;0 - 20,000;10;2;8;0;0;0
1394160;Directive Nine;;20,000 - 50,000;15;7;8;0;0;0
1394210;Strike VR;;20,000 - 50,000;5;0;5;0;0;0
1394240;VirtuaCreature;;50,000 - 100,000;17;12;5;0;0;0
1394270;SCP: Escape Together;;200,000 - 500,000;2126;1132;994;0;0;19
1394320;Magic Trick;;0 - 20,000;14;1;13;0;0;0
1394340;DreamDasher;;0 - 20,000;80;13;67;0;0;0
1394350;沉默沼泽;;0 - 20,000;6;1;5;0;0;0
1394400;Gump;;0 - 20,000;1;4;-3;0;0;0
1394420;Dallen Clicker Ultimate;;0 - 20,000;27;6;21;0;0;0
1394460;RXC - Rally Cross Challenge;;0 - 20,000;46;1;45;0;0;4
1394480;Rocco's Island: Ring to End the Pain;;20,000 - 50,000;92;3;89;0;0;1
1394500;Frontline: World War II;;0 - 20,000;40;5;35;0;0;1
1394510;Emurinoo;;0 - 20,000;3;0;3;0;0;0
1394520;Path to Prosperity;;0 - 20,000;23;2;21;0;0;0
1394540;Niko and the Cubic Curse;;0 - 20,000;4;1;3;0;0;0
1394550;Tales From The Under-Realm: Hazel;;0 - 20,000;19;2;17;0;0;1
1394570;Pass to Hell;;20,000 - 50,000;0;1;-1;0;0;0
1394570;Pass to Hell;;20,000 - 50,000;0;1;-1;0;0;0
1394600;Invasion Resistance 2;;0 - 20,000;5;0;5;0;0;0
1394640;Dark Room VR;;0 - 20,000;7;1;6;0;0;0
1394680;Soul Catcher;;50,000 - 100,000;8;2;6;0;0;0
1394690;KAKU: Ancient Seal (Alpha);;0 - 20,000;52;26;26;0;0;0
1394700;Takorita Meets Fries;;20,000 - 50,000;25;3;22;0;0;0
1394720;Block Dungeon;;20,000 - 50,000;29;10;19;0;0;0
1394750;Mahjong World Contest 2;;0 - 20,000;10;2;8;0;0;0
1394760;Mahjong Carnaval;;0 - 20,000;6;0;6;0;0;1
1394800;Rebirth:Mr Wang;;50,000 - 100,000;1536;395;1141;83;83;6
1394830;LOCIS;;0 - 20,000;17;4;13;0;0;0
1394830;LOCIS;;0 - 20,000;17;4;13;0;0;0
1394880;Wild Baffo;;0 - 20,000;6;1;5;0;0;0
1394930;MAMIYA;;0 - 20,000;91;1;90;0;0;1
1394940;Nak Sim: Fallen Warriors;;0 - 20,000;0;1;-1;0;0;0
1395000;Egypt Picross Pharaohs Riddles;;0 - 20,000;5;1;4;0;0;0
1395010;Magic Griddlers;;0 - 20,000;10;3;7;0;0;0
1395020;Picross Beach Paradise;;0 - 20,000;2;4;-2;0;0;0
1395030;Kathy Rain: Director's Cut;;0 - 20,000;404;24;380;0;0;6
1395080;The Disaster;;0 - 20,000;10;4;6;0;0;0
1395080;The Disaster;;0 - 20,000;10;4;6;0;0;0
1395120;At Eve's Wake;;20,000 - 50,000;21;2;19;0;0;0
1395170;Stones of the Revenant;;0 - 20,000;3;1;2;0;0;0
1395180;Raid!;;20,000 - 50,000;10;2;8;0;0;0
1395190;BLASK 2;;0 - 20,000;6;0;6;0;0;0
1395230;Almost My Floor: Prologue;;20,000 - 50,000;108;13;95;0;0;0
1395270;Haiki;;0 - 20,000;34;0;34;0;0;0
1395280;Infanticide | インファンティサイド;;0 - 20,000;15;14;1;0;0;0
1395310;World of Soccer RELOADED;;20,000 - 50,000;76;33;43;0;0;0
1395330;Venture Valley;;20,000 - 50,000;23;18;5;0;0;5
1395400;The Corruption Within;;0 - 20,000;112;6;106;0;0;0
1395410;Jetscout: Mystery of the Valunians;;0 - 20,000;16;0;16;0;0;0
1395420;Human Diaspora;;0 - 20,000;3;4;-1;0;0;0
1395450;Shell Shuffle;;20,000 - 50,000;6;1;5;0;0;0
1395470;Glory;;0 - 20,000;1;0;1;0;0;0
1395480;A Midnight Village Story;;0 - 20,000;2;1;1;0;0;0
1395510;Solar Scion;;0 - 20,000;1;0;1;0;0;0
1395540;BOT.vinnik Chess: Winning Patterns;;0 - 20,000;60;6;54;0;0;0
1395560;Kandidatos;;200,000 - 500,000;2881;297;2584;80;77;19
1395600;Party Parkade;;0 - 20,000;3;4;-1;0;0;0
1395630;Cute dragon Yongyong;;0 - 20,000;5;0;5;0;0;0
1395660;Sphere Invasion;;0 - 20,000;0;2;-2;0;0;0
1395750;Dasher;;0 - 20,000;1;0;1;0;0;0
1395760;Reshaping Mars;;50,000 - 100,000;440;67;373;535;672;88
1395760;Reshaping Mars;;50,000 - 100,000;440;67;373;535;672;88
1395780;Punchout: Music;;0 - 20,000;2;0;2;0;0;0
1395830;Hoplegs;;0 - 20,000;68;5;63;0;0;0
1395850;Home and Dungeon;;50,000 - 100,000;228;29;199;107;107;3
1395890;Super Dango;;0 - 20,000;7;1;6;0;0;0
1395900;Bouncer Story;;0 - 20,000;5;3;2;0;0;0
1395920;GrappleWell;;0 - 20,000;6;0;6;0;0;0
1396010;Asian Riddles 2;;0 - 20,000;7;3;4;0;0;2
1396020;Fill and Cross Royal Riddles;;0 - 20,000;1;3;-2;0;0;0
1396140;Hexagroove: Tactical DJ;;0 - 20,000;6;0;6;0;0;0
1396150;Sutekina kanojo no tsukurikata;;20,000 - 50,000;368;533;-165;41;41;0
1396240;Contraband Police: Prologue;;200,000 - 500,000;4514;519;3995;0;0;40
1396260;FALAFEL Restaurant Simulator;;0 - 20,000;81;40;41;0;0;1
1396290;Chess Mega Bundle;;0 - 20,000;2;2;0;0;0;0
1396350;Anamnesis;;0 - 20,000;4;0;4;0;0;0
1396390;Jump Hero: Beginning;;0 - 20,000;0;1;-1;0;0;0
1396450;最末行程：胜利路19号;;0 - 20,000;26;6;20;0;0;0
1396480;MonsterSoft;;0 - 20,000;2;2;0;0;0;0
1396500;Thyra Adventure;;0 - 20,000;2;0;2;0;0;0
1396580;Hey ma i'm a Dragon Now;;20,000 - 50,000;7;1;6;0;0;0
1396580;Hey ma i'm a Dragon Now;;20,000 - 50,000;7;1;6;0;0;0
1396610;Do It With Hay;;0 - 20,000;10;2;8;0;0;0
1396630;Hollow Mind: The Lost Puppy;;0 - 20,000;23;9;14;0;0;0
1396890;Boss of this gym;;50,000 - 100,000;579;33;546;0;0;0
1396950;The mouse and the cheese;;0 - 20,000;1;0;1;0;0;0
1396980;The Sealed Ampoule;;0 - 20,000;43;10;33;0;0;1
1397000;Zodiac DX;;0 - 20,000;12;0;12;0;0;0
1397010;1980;;50,000 - 100,000;532;66;466;0;0;1
1397030;Survive or Thrive;;0 - 20,000;216;4;212;0;0;0
1397040;Sanguine Melancholia;;20,000 - 50,000;6;2;4;0;0;0
1397050;Square vs Triangles;;0 - 20,000;1;0;1;0;0;0
1397060;Little Brother's Turn;;0 - 20,000;9;1;8;0;0;0
1397070;重返现场;;0 - 20,000;13;10;3;0;0;0
1397110;Harthorn;;20,000 - 50,000;124;19;105;0;0;0
1397140;The Last Show of Mr. Chardish: Act I;;0 - 20,000;32;4;28;0;0;0
1397160;Pulut Adventure RPG;;0 - 20,000;10;1;9;0;0;0
1397170;Anime Wave Simulator;;100,000 - 200,000;39;30;9;0;0;0
1397220;Patricia;;20,000 - 50,000;34;23;11;0;0;0
1397230;VR Time Machine Travelling in history: Visit ancient Egypt, Babylon and Greece in B.C. 400;;0 - 20,000;2;2;0;0;0;0
1397240;MEGAJUMP;;0 - 20,000;84;14;70;0;0;3
1397270;Knight Arena;;0 - 20,000;0;5;-5;0;0;0
1397280;Slime Pandemic TD;;0 - 20,000;16;0;16;0;0;0
1397290;Comet 64;;0 - 20,000;109;33;76;0;0;0
1397300;Kyma Maker's Island;;0 - 20,000;3;0;3;0;0;0
1397350;好久不见 - Long Time No See;;50,000 - 100,000;174;57;117;189;189;1
1397470;Tsuro - The Game of The Path;;0 - 20,000;101;5;96;16;16;3
1397530;Monochro;;0 - 20,000;2;0;2;0;0;0
1397540;On Pixels: A lights out game;;0 - 20,000;15;0;15;0;0;0
1397620;Flat Earth Simulator;;0 - 20,000;53;27;26;0;0;0
1397650;Jetborne Racing;;20,000 - 50,000;380;40;340;40;40;0
1397690;Riot At World;;50,000 - 100,000;0;2;-2;0;0;0
1397710;Operation TP;;20,000 - 50,000;4;2;2;0;0;0
1397720;Red Sector;;0 - 20,000;2;0;2;0;0;0
1397760;Pulse Jumper;;0 - 20,000;13;3;10;0;0;0
1397790;Samurai Gunn 2;;50,000 - 100,000;509;24;485;163;289;2
1397800;Please Wake Up;;0 - 20,000;20;4;16;0;0;0
1397810;Ducktopia;;0 - 20,000;4;0;4;0;0;0
1397820;Sky Mirror · Strolling;;20,000 - 50,000;5;2;3;0;0;0
1397850;Circle Tank;;0 - 20,000;3;3;0;0;0;0
1397920;Mr.Mine;;500,000 - 1,000,000;11725;987;10738;3888;220;883
1397940;Prototype ONE DAY I AM ;;0 - 20,000;15;16;-1;0;0;0
1397960;One Night on Halloween;;0 - 20,000;1;0;1;0;0;0
1397980;THE NORMAL THING;;50,000 - 100,000;405;17;388;0;0;3
1398010;Battle Ready;;0 - 20,000;4;5;-1;0;0;0
1398080;Seaside Cafe Story;;0 - 20,000;12;2;10;0;0;0
1398100;Orwell's Animal Farm;;50,000 - 100,000;106;27;79;0;0;1
1398110;Space Pirate King;;0 - 20,000;5;2;3;0;0;0
1398120;The Hardest Thing Ever;;0 - 20,000;0;1;-1;0;0;0
1398130;Head Bumper: Editcraft;;20,000 - 50,000;14;1;13;0;0;0
1398180;Porcini;;0 - 20,000;20;4;16;0;0;0
1398210;Selene ~Apoptosis~;;50,000 - 100,000;102;13;89;0;0;87
1398220;IMPAVIDVM;;0 - 20,000;2;0;2;0;0;0
1398270;Furgal's Jetpack;;20,000 - 50,000;14;4;10;0;0;0
1398280;Great Lakes Simulator;;0 - 20,000;6;13;-7;0;0;1
1398290;Crônicas de Landulph;;0 - 20,000;1;0;1;0;0;0
1398300;Suspicious Shuffle;;0 - 20,000;2;0;2;0;0;0
1398320;Remalmok;;0 - 20,000;15;13;2;0;0;0
1398400;Florida Man: Hurricane Hijinks;;0 - 20,000;0;1;-1;0;0;0
1398400;Florida Man: Hurricane Hijinks;;0 - 20,000;0;1;-1;0;0;0
1398410;Reginald's Death Arena;;0 - 20,000;4;1;3;0;0;0
1398420;One Last Dungeon;;0 - 20,000;8;1;7;0;0;0
1398500;MECHBLAZE;;0 - 20,000;48;3;45;74;74;1
1398510;Galaxy in Peril: Time Trouble;;0 - 20,000;1;2;-1;0;0;0
1398570;Last Escape;;0 - 20,000;20;13;7;0;0;0
1398590;1001 Jigsaw World Tour Asia;;0 - 20,000;4;3;1;0;0;1
1398600;Fill and Cross World Contest;;0 - 20,000;3;3;0;0;0;2
1398620;Sweet Tooth;;0 - 20,000;0;3;-3;0;0;0
1398630;无限次元;;50,000 - 100,000;14;3;11;0;0;0
1398630;无限次元;;50,000 - 100,000;14;3;11;0;0;0
1398740;The Chrono Jotter;;50,000 - 100,000;1311;46;1265;0;0;1
1398750;Sunset Mall;;20,000 - 50,000;23;3;20;0;0;0
1398820;Compost;;0 - 20,000;2;0;2;0;0;0
1398860;Rocket Squad;;0 - 20,000;2;1;1;0;0;0
1398900;Lost: Into Dolor;;0 - 20,000;1;0;1;0;0;0
1398950;Savage Tower Defense;;0 - 20,000;0;1;-1;0;0;0
1398990;ANCIENT SOULS: Starship Renata;;0 - 20,000;1;3;-2;0;0;0
1399030;Wacky Wizarding Dungeon;;0 - 20,000;1;0;1;0;0;0
1399040;This Is Not Chess;;20,000 - 50,000;1;0;1;0;0;0
1399080;The DioField Chronicle;;20,000 - 50,000;302;333;-31;0;0;3
1399090;Life Simulator;;0 - 20,000;124;102;22;148;148;0
1399140;Boxing Coach;;0 - 20,000;15;6;9;0;0;0
1399150;VR Time Machine Travelling in ancient civilizations: Mayan Kingdom, Inca Empire, Indians, and Aztecs before conquest A.D.1000;;20,000 - 50,000;2;0;2;0;0;0
1399160;御剑飞行射击训练空间;;50,000 - 100,000;1;0;1;0;0;0
1399170;Nimbus INFINITY;;0 - 20,000;46;21;25;0;0;0
1399180;Lone Wolf: World War 2;;0 - 20,000;3;0;3;0;0;0
1399210;Lumiland;;0 - 20,000;5;0;5;0;0;0
1399240;Yotsume God -Reunion-;;0 - 20,000;212;4;208;0;0;4
1399250;Red Cap Zombie Hunter;;0 - 20,000;2;3;-1;0;0;0
1399260;The Girl of Glass: A Summer Bird's Tale - The Journey Begins;;20,000 - 50,000;9;1;8;0;0;0
1399270;The Arena Guy;;0 - 20,000;4;4;0;0;0;0
1399280;The Lost Cube;;0 - 20,000;3;0;3;0;0;0
1399300;SOK PRO;;0 - 20,000;48;4;44;0;0;0
1399370;Cute Honey 2;;100,000 - 200,000;1103;332;771;25;29;5
1399380;NUI;;0 - 20,000;9;0;9;0;0;0
1399400;VR historical journey to the Buddhist civilizations: VR ancient India and Asia;;20,000 - 50,000;3;1;2;0;0;0
1399440;Pets VR;;0 - 20,000;2;2;0;0;0;0
1399460;Museum Of Extravagance;;20,000 - 50,000;2;2;0;0;0;0
1399480;California Games;;50,000 - 100,000;7;2;5;0;0;0
1399540;A Forgetful Loop;;0 - 20,000;7;0;7;0;0;0
1399590;Strike Buster Prototype;;100,000 - 200,000;566;83;483;27;27;0
1399600;District 99;;0 - 20,000;3;0;3;0;0;0
1399620;The Caretaker;;0 - 20,000;4;1;3;0;0;0
1399630;Lactea Volleyball;;0 - 20,000;2;0;2;0;0;0
1399650;EPEJSODION Dodgeball Defense;;0 - 20,000;1;2;-1;0;0;0
1399660;My Little Prince - a jigsaw puzzle tale;;0 - 20,000;57;5;52;0;0;0
1399670;Instant Farmer - Logic Puzzle;;0 - 20,000;143;15;128;0;0;3
1399680;Web Buttons Designer;;0 - 20,000;0;1;-1;0;0;0
1399690;Reverie Knights Tactics;;20,000 - 50,000;44;31;13;0;0;1
1399700;Kapital: Sparks of Revolution;;0 - 20,000;119;65;54;13;13;4
1399740;Zball;;0 - 20,000;10;7;3;0;0;0
1399750;Beholgar;;0 - 20,000;119;32;87;0;0;4
1399760;Randomlands;;200,000 - 500,000;4;4;0;0;0;0
1399780;Spellbreak;;1,000,000 - 2,000,000;11767;1919;9848;233;82;3
1399840;Neptunia Virtual Stars;;20,000 - 50,000;219;170;49;0;0;4
1399850;Squares Rage;;0 - 20,000;9;3;6;0;0;0
1399910;Crisis Arcana;;0 - 20,000;3;0;3;0;0;0
1399990;Don't Die! Douche!;;0 - 20,000;5;0;5;0;0;0
1400000;Mint Works;;0 - 20,000;4;4;0;0;0;0
1400070;Don't Cheat On Me;;20,000 - 50,000;134;161;-27;101;114;0
1400080;Pre-Strike;;0 - 20,000;30;24;6;0;0;0
1400100;The Old House;;20,000 - 50,000;68;40;28;0;0;0
1400110;Sightbringer;;0 - 20,000;12;9;3;0;0;0
1400140;Way in the stars;;0 - 20,000;7;0;7;0;0;0
1400150;Pandemic Bunny;;0 - 20,000;4;2;2;0;0;0
1400170;TinyCrack;;0 - 20,000;5;0;5;0;0;0
1400190;Human-Like;;0 - 20,000;6;0;6;0;0;0
1400190;Human-Like;;0 - 20,000;6;0;6;0;0;0
1400200;Mystery Case Files: The Harbinger Collector's Edition;;0 - 20,000;9;4;5;0;0;0
1400210;Death Drives A Bus;;0 - 20,000;11;0;11;0;0;0
1400260;Legendary Journeys;;20,000 - 50,000;20;1;19;0;0;1
1400270;Fox face kills!;;0 - 20,000;2;2;0;0;0;0
1400290;[Chilla's Art] Hanako | 花子さん;;20,000 - 50,000;128;43;85;0;0;0
1400320;그 어느 여름날의 이야기;;0 - 20,000;46;5;41;0;0;0
1400350;Rescue Rina;;0 - 20,000;2;1;1;0;0;0
1400360;LemWars;;0 - 20,000;1;5;-4;0;0;0
1400380;Sweet Tooth 2;;0 - 20,000;0;2;-2;0;0;0
1400390;The First Confrontation;;50,000 - 100,000;4;6;-2;0;0;0
1400440;Mini Warriors: Brawler Army;;0 - 20,000;5;13;-8;0;0;0
1400450;Dino Eruption;;20,000 - 50,000;4;6;-2;0;0;0
1400480;Lost Gems;;0 - 20,000;5;0;5;0;0;0
1400510;Castle Rock Beach, West Australia;;20,000 - 50,000;320;45;275;3;3;0
1400520;Nomads of Driftland;;20,000 - 50,000;90;30;60;11;11;0
1400610;One Drunken Knight;;0 - 20,000;4;0;4;0;0;0
1400620;Ballsy! World Cup 2020;;0 - 20,000;24;1;23;0;0;0
1400630;Afterthought;;0 - 20,000;17;0;17;0;0;1
1400650;Cruel TD;;0 - 20,000;6;5;1;0;0;0
1400680;Impossible Mission II;;100,000 - 200,000;3;1;2;0;0;0
1400700;Confessions;;;;;0;;;
1400760;My Universe - My Baby;;0 - 20,000;14;6;8;0;0;0
1400870;When The Night Comes;;0 - 20,000;204;12;192;0;0;6
1400910;Soundodger 2;;20,000 - 50,000;98;0;98;0;0;9
1400920;Flood Fill;;0 - 20,000;3;0;3;0;0;0
1400930;Save the Date;;0 - 20,000;4;1;3;0;0;0
1400940;Revolution Diabolique;;0 - 20,000;3;9;-6;0;0;0
1400980;My Neighborhood Arcade;;0 - 20,000;5;2;3;0;0;0
1401070;Quest for Runia;;0 - 20,000;18;0;18;0;0;0
1401080;Starmind;;20,000 - 50,000;4;0;4;0;0;0
1401080;Starmind;;20,000 - 50,000;4;0;4;0;0;0
1401150;Black Hole Simulator;;20,000 - 50,000;80;21;59;0;0;0
1401150;Black Hole Simulator;;20,000 - 50,000;80;21;59;0;0;0
1401220;冷血症骰子;;20,000 - 50,000;199;17;182;0;0;1
1401320;破镜恐惧;;0 - 20,000;45;13;32;0;0;0
1401340;Tea Garden Simulator;;0 - 20,000;29;12;17;0;0;0
1401360;Friendly Find;;20,000 - 50,000;2;0;2;0;0;0
1401400;Lovecraft's Untold Stories 2;;0 - 20,000;38;64;-26;0;0;0
1401520;Sweet Tooth 3;;0 - 20,000;5;6;-1;0;0;0
1401530;Project Existence - Multiplayer Sandbox;;0 - 20,000;22;24;-2;0;0;0
1401560;Kilta;;0 - 20,000;50;15;35;0;0;1
1401590;Disney Dreamlight Valley;;200,000 - 500,000;9996;453;9543;1014;1238;5354
1401610;Leons Identität;;50,000 - 100,000;73;40;33;0;0;0
1401620;Chesstle;;0 - 20,000;3;2;1;0;0;0
1401670;Handy Machines VR;;0 - 20,000;2;0;2;0;0;0
1401750;Mission Z;;500,000 - 1,000,000;14;7;7;0;0;0
1401840;Silk Roads: Caravan Kings;;0 - 20,000;20;8;12;0;0;0
1401870;Dark Dealings;;0 - 20,000;1;0;1;0;0;0
1401880;Midnight Bike;;0 - 20,000;24;2;22;0;0;0
1401890;Glorious Tournius;;0 - 20,000;3;1;2;0;0;0
1401920;Chinatown Detective Agency: Day One;;50,000 - 100,000;154;24;130;0;0;0
1401990;Missing Features: 2D;;0 - 20,000;13;1;12;0;0;0
1402010;Table Soccer Club;;0 - 20,000;2;0;2;0;0;0
1402020;SCP: Labrat;;200,000 - 500,000;1804;301;1503;0;0;171
1402030;Strings Theory;;0 - 20,000;36;1;35;0;0;0
1402060;Dung Beetle Strike;;0 - 20,000;1;0;1;0;0;0
1402090;Crisis Wing;;0 - 20,000;55;9;46;0;0;2
1402130;Archery Arena;;0 - 20,000;1;0;1;0;0;0
1402290;Monochrome RPG Episode 1: The Maniacal Morning;;0 - 20,000;1;1;0;0;0;0
1402320;Medal of Honor: Above and Beyond;;50,000 - 100,000;1312;819;493;150;150;7
1402350;12 Labours of Hercules XI: Painted Adventure;;0 - 20,000;6;5;1;0;0;4
1402380;Hogogeist;;0 - 20,000;1;0;1;0;0;0
1402390;Oddity Girls: Virtual World;;0 - 20,000;0;2;-2;0;0;0
1402400;Arcanbreak;;20,000 - 50,000;21;0;21;0;0;0
1402420;Demon Strikes Back;;0 - 20,000;35;17;18;0;0;0
1402460;BattleStick 2;;20,000 - 50,000;11;8;3;0;0;0
1402480;NARAKA: BLADEPOINT / 永劫無間 - Test Server;;20,000 - 50,000;148;58;90;96;96;0
1402580;No Place for the Dissident;;0 - 20,000;13;10;3;0;0;1
1402700;Red Falcon;;20,000 - 50,000;1;0;1;0;0;0
1402740;The Prabbits: Happy Dogfights !;;0 - 20,000;1;0;1;0;0;0
1402780;Forever Night;;0 - 20,000;2;3;-1;0;0;0
1402790;Shopping Empire Tycoon;;0 - 20,000;63;2;61;0;0;1
1402900;Twilight Memoria;;50,000 - 100,000;23;1;22;0;0;0
1403020;SCP Strategy;;20,000 - 50,000;401;42;359;0;0;3
1403040;Physics Sandbox VR;;0 - 20,000;2;2;0;0;0;0
1403080;Radioactive Dwarfs: Evil From The Sewers;;100,000 - 200,000;54;0;54;0;0;0
1403110;Isles of Pangaea;;0 - 20,000;29;19;10;0;0;0
1403130;Pixel Art - Mash-Up;;0 - 20,000;2;0;2;0;0;0
1403190;Throne of Fate;;0 - 20,000;18;4;14;0;0;0
1403230;Penny RPG: Shadows of the Lost - A Blood City Tale;;20,000 - 50,000;2;0;2;0;0;0
1403280;Struggle Offensive;;0 - 20,000;107;58;49;0;0;0
1403310;Garden Simulator;;0 - 20,000;162;19;143;0;0;6
1403350;Supfly Delivery Simulator;;20,000 - 50,000;26;4;22;0;0;0
1403370;Zenith: The Last City;;200,000 - 500,000;2973;643;2330;674;1124;68
1403400;Sky Squadron;;0 - 20,000;15;0;15;0;0;1
1403460;Flavortown;;20,000 - 50,000;19;4;15;0;0;0
1403520;Forest Farm;;0 - 20,000;10;7;3;0;0;0
1403550;Planet Blood;;0 - 20,000;1;0;1;0;0;0
1403570;The Message;;0 - 20,000;2;1;1;0;0;0
1403590;Kingdom Of Force;;0 - 20,000;4;3;1;0;0;0
1403680;Bob Mazzolini Racing;;0 - 20,000;0;3;-3;0;0;0
1403710;Platzkart Simulator;;0 - 20,000;63;54;9;0;0;0
1403720;Medulla;;0 - 20,000;15;0;15;0;0;0
1403740;Space Architect;;0 - 20,000;16;2;14;0;0;0
1403750;街机金蟾捕鱼2;;0 - 20,000;21;34;-13;0;0;9
1403800;Movavi Picverse - Photo Editing Software;;0 - 20,000;29;10;19;0;0;1
1403830;Paper Beast - Folded Edition;;0 - 20,000;89;13;76;0;0;0
1403840;Gecata by Movavi 6 – Streaming and Game Recording Software;;0 - 20,000;29;26;3;0;0;3
1403890;SmFly: Gravity Adventure;;0 - 20,000;18;2;16;0;0;0
1403990;Paths & Danger;;0 - 20,000;24;15;9;0;0;1
1404010;A Knight Never Yields;;0 - 20,000;6;1;5;0;0;0
1404030;Fighting for Justice Episode 1;;0 - 20,000;7;2;5;0;0;0
1404050;10mg: Stroke;;0 - 20,000;12;0;12;0;0;0
1404070;Save The Astronaut;;20,000 - 50,000;15;0;15;0;0;0
1404080;Rotund Takeoff;;0 - 20,000;16;0;16;0;0;0
1404090;Trivia Tricks;;0 - 20,000;120;10;110;0;0;4
1404090;Trivia Tricks;;0 - 20,000;120;10;110;0;0;4
1404130;Gothic Murder: Adventure That Changes Destiny;;0 - 20,000;39;1;38;0;0;0
1404150;Escape the City;;20,000 - 50,000;30;14;16;0;0;0
1404180;6th Dimension;;0 - 20,000;13;17;-4;0;0;0
1404190;Chess Brain;;20,000 - 50,000;100;10;90;0;0;0
1404210;Red Dead Online;;1,000,000 - 2,000,000;44601;8244;36357;2315;891;2476
1404360;A Shopping Trip to Eklan Tor;;50,000 - 100,000;182;2;180;0;0;0
1404500;Dungeon Royale;;0 - 20,000;84;15;69;0;0;0
1404530;RoboSkate;;0 - 20,000;80;11;69;113;207;0
1404550;Legend of Xion: Royal Story 赛恩传说：皇家物语;;0 - 20,000;0;2;-2;0;0;0
1404560;Yerba Mate Tycoon;;20,000 - 50,000;77;10;67;0;0;0
1404630;All Hit All Her;;0 - 20,000;7;1;6;0;0;0
1404660;Psych;;0 - 20,000;192;39;153;0;0;1
1404750;Mind Muscle VR;;0 - 20,000;3;2;1;0;0;0
1404770;Cube;;0 - 20,000;2;0;2;0;0;0
1404800;Juicy Army;;0 - 20,000;2;0;2;0;0;0
1404840;Liberation Special Forces;;0 - 20,000;0;1;-1;0;0;0
1404850;Luck be a Landlord;;200,000 - 500,000;6429;445;5984;1115;851;646
1404870;Couplinked;;0 - 20,000;9;1;8;0;0;0
1404930;Snowman Saves Christmas;;0 - 20,000;4;1;3;0;0;0
1404960;The Last Sunshine: Rekindled;;0 - 20,000;12;3;9;0;0;3
1404970;Sponsor-A-Planet;;0 - 20,000;5;1;4;0;0;0
1404980;NENA;;0 - 20,000;22;2;20;0;0;0
1405040;GoVenture Entrepreneur;;0 - 20,000;2;1;1;0;0;0
1405090;Star Maidens Chronicle: Definitive Edition;;0 - 20,000;4;2;2;0;0;0
1405170;VR historical journey to the age of Crusaders: Medieval Jerusalem, Saracen Cities, Arabic Culture, East Land;;20,000 - 50,000;4;1;3;0;0;0
1405180;Wilderness;;0 - 20,000;24;57;-33;0;0;0
1405260;Rebellion;;0 - 20,000;45;14;31;0;0;0
1405270;Inseparable;;0 - 20,000;9;1;8;0;0;0
1405320;The Adventures Of Maximus;;0 - 20,000;0;2;-2;0;0;0
1405360;Brutal Dinosaur;;0 - 20,000;3;2;1;0;0;0
1405440;The Horror Of Salazar House;;0 - 20,000;224;7;217;0;0;0
1405470;Scars of Summer;;50,000 - 100,000;781;256;525;647;647;25
1405480;Swing Lord;;0 - 20,000;10;0;10;0;0;0
1405670;The Forgotten Island - v1.0;;20,000 - 50,000;6;4;2;0;0;0
1405720;Zball II;;0 - 20,000;3;7;-4;0;0;0
1405730;Alchemy Emporium;;0 - 20,000;15;11;4;0;0;0
1405740;P0;;20,000 - 50,000;6;10;-4;0;0;0
1405780;Interactive Empathy;;0 - 20,000;3;7;-4;0;0;0
1405790;John Wick Hex;;50,000 - 100,000;308;186;122;31;34;1
1405810;Wedding Designer Prologue;;0 - 20,000;113;59;54;0;0;1
1405950;pear potion;;0 - 20,000;21;0;21;0;0;0
1405970;Once upon a time in the Gold Rush VR: shoot and ride;;0 - 20,000;2;0;2;0;0;0
1405980;Astronomy Lab on PC: Relativity, Lunar Landing, Space Flight, and Interstellar Travelling;;20,000 - 50,000;3;2;1;0;0;0
1406000;BigChick;;0 - 20,000;26;0;26;0;0;0
1406020;Sakura Succubus 3;;50,000 - 100,000;168;21;147;0;0;7
1406040;Scarlet Hollow;;100,000 - 200,000;588;14;574;0;0;5
1406080;Arc Wizards;;0 - 20,000;2;3;-1;0;0;0
1406090;Control:Override;;0 - 20,000;8;1;7;0;0;0
1406110;Nova Odessa;;0 - 20,000;13;3;10;0;0;0
1406140;Wiggly Boy;;20,000 - 50,000;45;1;44;0;0;0
1406150;Delta Light;;0 - 20,000;14;0;14;0;0;0
1406200;In My Shadow;;0 - 20,000;48;9;39;0;0;0
1406240;Memories of Fireflies;;0 - 20,000;5;1;4;0;0;0
1406240;Memories of Fireflies;;0 - 20,000;5;1;4;0;0;0
1406250;Tanuki Justice;;0 - 20,000;25;4;21;0;0;1
1406260;Bram The Toymaker;;0 - 20,000;14;6;8;0;0;1
1406340;Black Maou & Rainbow Kingdom;;0 - 20,000;4;1;3;0;0;0
1406350;Guns N Stuff;;50,000 - 100,000;5;1;4;0;0;0
1406490;Quester;;0 - 20,000;5;0;5;0;0;0
1406570;Sokoban (Boxman) Classic;;0 - 20,000;4;1;3;0;0;0
1406610;Fatal Evidence: Art of Murder Collector's Edition;;0 - 20,000;4;11;-7;0;0;0
1406630;Star Mine;;0 - 20,000;2;0;2;0;0;0
1406690;Kasi;;0 - 20,000;146;5;141;0;0;3
1406700;M1 Tank Platoon II;;0 - 20,000;22;5;17;0;0;0
1406710;Smoop Can't Sleep!;;0 - 20,000;1;0;1;0;0;0
1406740;DumbBots: Hello World;;0 - 20,000;4;1;3;0;0;1
1406750;Virtual Ricochet;;0 - 20,000;3;0;3;0;0;0
1406770;Evil Icebox;;0 - 20,000;5;1;4;0;0;0
1406780;Viscerafest;;20,000 - 50,000;408;40;368;25;25;3
1406850;The Legend of Tianding;;50,000 - 100,000;2230;92;2138;0;0;4
1406900;のっぺらぼう;;50,000 - 100,000;5;3;2;0;0;0
1406930;Space Travel Jigsaw Puzzles;;0 - 20,000;15;1;14;0;0;1
1406930;Space Travel Jigsaw Puzzles;;0 - 20,000;15;1;14;0;0;1
1406980;Road Tripper;;0 - 20,000;1;1;0;0;0;0
1406990;NEKOPARA Vol. 4;;200,000 - 500,000;7592;197;7395;2299;160;34
1407000;Deios I // Directors Cut;;0 - 20,000;3;0;3;0;0;0
1407050;Batterneers;;0 - 20,000;8;1;7;0;0;0
1407060;Crimson Ranch;;20,000 - 50,000;21;4;17;0;0;0
1407080;Fisti-Fluffs;;0 - 20,000;20;10;10;0;0;0
1407090;[TDA01] Muv-Luv Unlimited: THE DAY AFTER - Episode 01 REMASTERED;;0 - 20,000;38;6;32;0;0;0
1407090;[TDA01] Muv-Luv Unlimited: THE DAY AFTER - Episode 01 REMASTERED;;0 - 20,000;38;6;32;0;0;0
1407100;[TDA00] Muv-Luv Unlimited: THE DAY AFTER - Episode 00 REMASTERED;;0 - 20,000;64;20;44;0;0;2
1407190;My Universe - Cooking Star Restaurant;;0 - 20,000;14;8;6;0;0;0
1407200;World of Tanks;;5,000,000 - 10,000,000;46909;8301;38608;382;69;5409
1407240;Landing;;0 - 20,000;8;4;4;0;0;0
1407250;Fugitive Criminal;;0 - 20,000;3;2;1;0;0;0
1407300;Hirilun;;20,000 - 50,000;13;2;11;0;0;0
1407420;Milo and the Magpies;;50,000 - 100,000;2019;31;1988;67;74;4
1407450;大江湖之苍龙与白鸟;;100,000 - 200,000;1679;1104;575;2421;3131;34
1407520;Television Trivia;;0 - 20,000;0;1;-1;0;0;0
1407530;Warrior Beneath Heaven;;500,000 - 1,000,000;5;2;3;0;0;0
1407570;Interactive Fluid Wallpaper;;0 - 20,000;0;5;-5;0;0;0
1407620;Last Hope on Earth;;0 - 20,000;24;21;3;0;0;0
1407790;Earth Attack;;0 - 20,000;24;1;23;0;0;0
1407800;Ball Fall;;0 - 20,000;2;0;2;0;0;0
1407850;HOLIDAYS;;0 - 20,000;2;0;2;0;0;0
1407860;Space Travel Idle;;50,000 - 100,000;316;161;155;0;0;57
1407870;Infinity Coloring Pixel;;0 - 20,000;7;1;6;0;0;1
1407890;hexurb;;0 - 20,000;47;14;33;0;0;0
1407920;Bloat;;0 - 20,000;16;0;16;0;0;0
1407950;Sir War-A-Lot;;0 - 20,000;4;1;3;0;0;0
1408000;Shot of Rhythm;;0 - 20,000;0;1;-1;0;0;0
1408050;Our Hero! Two;;50,000 - 100,000;8;1;7;0;0;0
1408060;Idle Armada;;0 - 20,000;33;4;29;0;0;4
1408070;Midnight Manor;;0 - 20,000;13;0;13;0;0;0
1408100;Penimorta;;;;;0;;;
1408110;The Grounding;;20,000 - 50,000;625;77;548;0;0;0
1408160;Sweet Pea;;0 - 20,000;9;2;7;0;0;0
1408200;The Seven Keys: Escape Room;;0 - 20,000;11;6;5;0;0;0
1408220;破坏效应;;50,000 - 100,000;32;10;22;0;0;0
1408230;Walkabout Mini Golf VR;;100,000 - 200,000;2036;34;2002;377;535;78
1408310;Monster Legend;;0 - 20,000;4;4;0;0;0;0
1408350;Hex Slayer;;0 - 20,000;4;1;3;0;0;0
1408370;人类VS怪物(Human vs Monster);;0 - 20,000;0;1;-1;0;0;0
1408380;RGB Simulator;;0 - 20,000;2;1;1;0;0;0
1408400;Adventures of Megara: Demeter's Cat-astrophe;;0 - 20,000;0;2;-2;0;0;0
1408410;Eyeb;;0 - 20,000;7;1;6;0;0;0
1408420;Ancient Worlds: Egypt;;20,000 - 50,000;3;2;1;0;0;0
1408430;Ekstase;;0 - 20,000;18;0;18;0;0;0
1408450;1x! Space Adventure;;0 - 20,000;5;0;5;0;0;0
1408480;Sneaky Kitten;;0 - 20,000;7;2;5;0;0;0
1408490;Historical Games: Chariot Racing;;0 - 20,000;2;0;2;0;0;0
1408530;Sudoku Starry Sky;;0 - 20,000;16;6;10;0;0;2
1408540;仙境之夜：白兔奇幻记;;0 - 20,000;17;2;15;0;0;0
1408570;Stand 'em Up;;0 - 20,000;32;3;29;0;0;1
1408590;ROGUERIA: Roguelikes X Tactics;;0 - 20,000;7;2;5;0;0;0
1408610;Call of the Wild: The Angler;;100,000 - 200,000;2249;1957;292;1283;1671;496
1408630;Hungry Horace Revisited;;0 - 20,000;4;1;3;0;0;0
1408680;Nine to Five;;500,000 - 1,000,000;1562;1808;-246;0;0;2
1408700;Osman Gazi;;0 - 20,000;67;18;49;0;0;0
1408710;Regain Earth: First Strike;;0 - 20,000;62;9;53;0;0;0
1408720;Krunker;;1,000,000 - 2,000,000;17161;4103;13058;0;0;492
1408760;Star Tank;;0 - 20,000;15;3;12;0;0;0
1408780;Mad Taxi;;0 - 20,000;3;2;1;0;0;0
1408810;Manalith;;0 - 20,000;4;0;4;0;0;0
1408860;Silence Channel;;20,000 - 50,000;79;19;60;0;0;0
1408930;Greedy Corgi;;0 - 20,000;5;0;5;0;0;0
1409000;Walking Girl: Dead Parking;;0 - 20,000;23;20;3;0;0;0
1409020;Mana Maker;;20,000 - 50,000;13;30;-17;0;0;0
1409020;Mana Maker;;20,000 - 50,000;13;30;-17;0;0;0
1409180;Of Mice and Moggies;;0 - 20,000;31;0;31;0;0;0
1409250;Harmless Demons;;200,000 - 500,000;2;1;1;0;0;0
1409260;Project Entertainment System;;0 - 20,000;6;1;5;0;0;0
1409310;The Spiral Labyrinth;;0 - 20,000;6;0;6;0;0;0
1409320;VR Travelling towards World War III Scenario: Post Nuclear War Earth Fantasy;;0 - 20,000;2;0;2;0;0;0
1409330;VR Travelling back to our childhoods: VR 1980s;;0 - 20,000;2;1;1;0;0;0
1409350;Brushlings Pale Moon;;0 - 20,000;0;2;-2;0;0;0
1409370;Psych;;20,000 - 50,000;9;6;3;0;0;0
1409470;Encounter the Light / 邂逅光明;;0 - 20,000;1;0;1;0;0;0
1409510;Survival Simulator 生存模拟器;;0 - 20,000;15;8;7;0;0;0
1409510;Survival Simulator 生存模拟器;;0 - 20,000;15;8;7;0;0;0
1409520;The Worst Game Ever;;20,000 - 50,000;5;1;4;0;0;0
1409530;Neophyte;;20,000 - 50,000;355;29;326;0;0;2
1409540;Summoner VR : The ruined village;;0 - 20,000;7;4;3;0;0;0
1409560;Wasting Away;;0 - 20,000;4;1;3;0;0;0
1409560;Wasting Away;;0 - 20,000;4;1;3;0;0;0
1409570;Goblin Takes No Argument[s];;0 - 20,000;2;0;2;0;0;0
1409570;Goblin Takes No Argument[s];;0 - 20,000;2;0;2;0;0;0
1409610;Without Romance;;20,000 - 50,000;88;25;63;0;0;0
1409630;Halloween Rhythm;;0 - 20,000;0;1;-1;0;0;0
1409640;Tomato Way 3;;0 - 20,000;52;9;43;0;0;0
1409670;Bright Memory: Infinite Ray Tracing Benchmark;;200,000 - 500,000;47;2;45;0;0;2
1409710;Escape from Tatris;;100,000 - 200,000;273;27;246;0;0;0
1409730;Hero of Not Our Time;;0 - 20,000;104;41;63;0;0;0
1409740;Cybernetic Fault;;20,000 - 50,000;82;27;55;0;0;0
1409760;Gardens Of Celestial Globes;;0 - 20,000;1;0;1;0;0;0
1409780;My city and army;;0 - 20,000;4;9;-5;0;0;0
1409810;月之泪 ～ Tears of Luna;;20,000 - 50,000;1;1;0;0;0;0
1409930;Memory Card Monsters;;0 - 20,000;0;1;-1;0;0;0
1410000;SkydiveSim - Skydiving Simulator;;0 - 20,000;0;8;-8;0;0;0
1410050;Angry Rock;;0 - 20,000;0;1;-1;0;0;0
1410070;Bunny Hop;;0 - 20,000;20;0;20;0;0;0
1410100;Saving Punyville;;0 - 20,000;18;5;13;0;0;0
1410110;RENEGADE: ARENA SHOOTER;;0 - 20,000;0;2;-2;0;0;0
1410140;Load Roll Die;;0 - 20,000;7;1;6;0;0;0
1410200;Uranus;;0 - 20,000;20;0;20;0;0;0
1410210;The Bible - Exodus;;0 - 20,000;16;5;11;0;0;0
1410260;The Last King's Archer;;0 - 20,000;33;1;32;0;0;0
1410300;Space Debris;;0 - 20,000;1;0;1;0;0;0
1410370;非常魔王(Beelzebub);;50,000 - 100,000;64;6;58;0;0;1
1410380;星尘战区 Stardust Theater;;0 - 20,000;2;0;2;0;0;0
1410440;Sophstar;;0 - 20,000;68;0;68;0;0;1
1410500;Legacy - Witch Island;;0 - 20,000;16;7;9;0;0;0
1410560;Control Over;;0 - 20,000;21;15;6;0;0;0
1410580;Wave of Time;;0 - 20,000;21;2;19;0;0;0
1410600;MIRAY;;0 - 20,000;48;3;45;0;0;0
1410620;Minimum Wage: Influence The Election;;0 - 20,000;16;0;16;0;0;0
1410640;Syberia: The World Before;;100,000 - 200,000;2077;174;1903;81;81;66
1410680;Biscuitts 2;;0 - 20,000;1;1;0;0;0;0
1410700;UpWakeNing;;0 - 20,000;23;0;23;0;0;0
1410710;Democracy 4;;200,000 - 500,000;3555;690;2865;2598;2598;74
1410740;IDIOT;;0 - 20,000;19;8;11;0;0;0
1410790;LIFESPAWN;;0 - 20,000;6;1;5;0;0;0
1410830;Curse That Magic Cat!;;0 - 20,000;238;18;220;0;0;0
1410840;Crystal Call;;20,000 - 50,000;140;8;132;0;0;1
1410850;Space Smack!;;0 - 20,000;7;0;7;0;0;0
1410860;Puzzle Box Palace;;20,000 - 50,000;57;9;48;0;0;0
1410870;Trikaya;;20,000 - 50,000;230;40;190;0;0;1
1410980;Serafina and the Key to the Egg;;0 - 20,000;75;18;57;0;0;4
1411000;Bean Climb;;0 - 20,000;7;2;5;0;0;0
1411040;ThrustLander;;0 - 20,000;6;0;6;0;0;0
1411170;Boston Nursing Home;;0 - 20,000;6;10;-4;0;0;0
1411180;Touhou Block Fall ~ Yukari;;0 - 20,000;34;3;31;0;0;0
1411200;Critter Clicker;;20,000 - 50,000;53;38;15;0;0;0
1411330;谁说奶妈不能拯救世界！;;20,000 - 50,000;46;3;43;0;0;1
1411360;SpaceCrash;;0 - 20,000;2;1;1;0;0;0
1411380;The Story of The Flood;;20,000 - 50,000;52;18;34;0;0;0
1411410;Paddle Combat;;50,000 - 100,000;2;0;2;0;0;0
1411420;Ordeal;;0 - 20,000;11;2;9;0;0;0
1411460;Z Arena;;0 - 20,000;8;1;7;0;0;0
1411490;Lost In Time;;0 - 20,000;1;3;-2;0;0;0
1411550;Divilixa;;0 - 20,000;3;2;1;0;0;0
1411660;BITROOM;;0 - 20,000;11;2;9;0;0;0
1411670;Whiteboyz Wit Attitude: The Pursuit of Money;;50,000 - 100,000;427;21;406;0;0;0
1411700;Doko Roko;;0 - 20,000;8;18;-10;0;0;0
1411710;Forklift & Box;;20,000 - 50,000;1;2;-1;0;0;0
1411740;Urbek City Builder;;50,000 - 100,000;828;66;762;1632;2542;29
1411770;Redd's Runaway;;0 - 20,000;8;1;7;0;0;0
1411800;Goodnight, Lily;;0 - 20,000;68;20;48;0;0;0
1411840;Who Are You?;;20,000 - 50,000;6;4;2;0;0;0
1411860;Invasion: Lost in Time;;0 - 20,000;19;15;4;0;0;1
1411870;Zball III;;20,000 - 50,000;7;4;3;0;0;0
1411880;travelsolar;;0 - 20,000;1;3;-2;0;0;0
1411920;Get Ogre It;;50,000 - 100,000;24;4;20;0;0;0
1411940;Silence in the Dark;;20,000 - 50,000;1;2;-1;0;0;0
1412000;Agoraphobia;;0 - 20,000;14;16;-2;0;0;0
1412040;Gangsta Magic;;20,000 - 50,000;28;10;18;0;0;0
1412070;Siege the Day;;0 - 20,000;16;7;9;0;0;0
1412120;Shiny Summer;;0 - 20,000;18;7;11;0;0;0
1412170;Janosik;;100,000 - 200,000;463;29;434;0;0;1
1412180;The Last Act;;0 - 20,000;12;0;12;0;0;0
1412190;BEACHED;;200,000 - 500,000;1613;573;1040;0;0;52
1412240;Lombardi's World;;0 - 20,000;70;7;63;0;0;0
1412250;Path Maker;;0 - 20,000;7;1;6;0;0;0
1412250;Path Maker;;0 - 20,000;7;1;6;0;0;0
1412260;Kombo King;;0 - 20,000;6;0;6;0;0;0
1412370;东方修仙传;;0 - 20,000;3;4;-1;0;0;0
1412470;GranAge;;50,000 - 100,000;342;121;221;0;0;18
1412510;仙剑奇侠传九野;;200,000 - 500,000;1156;418;738;89;89;36
1412540;Zball IV;;0 - 20,000;2;6;-4;0;0;0
1412560;Death Rattle - Hell Unleashed;;0 - 20,000;15;6;9;0;0;0
1412560;Death Rattle - Hell Unleashed;;0 - 20,000;15;6;9;0;0;0
1412580;Sword of Destiny;;20,000 - 50,000;124;18;106;0;0;1
1412610;Couch Installation Service;;0 - 20,000;13;0;13;0;0;0
1412620;Sweet Time;;0 - 20,000;1;2;-1;0;0;0
1412630;Kristallijn;;0 - 20,000;12;1;11;0;0;0
1412640;Ribby Rocket;;0 - 20,000;1;1;0;0;0;0
1412650;Conspiracy!;;0 - 20,000;14;2;12;0;0;0
1412650;Conspiracy!;;0 - 20,000;14;2;12;0;0;0
1412660;Rivals;;0 - 20,000;35;0;35;0;0;0
1412680;THE ORIGIN: Blind Maid;;0 - 20,000;24;21;3;0;0;0
1412750;Gummy Bear Mafia;;0 - 20,000;1;0;1;0;0;0
1412780;Axis Football 2020;;0 - 20,000;120;56;64;0;0;1
1412820;Grimace Run;;0 - 20,000;37;14;23;0;0;0
1412840;ChessLocke;;0 - 20,000;19;3;16;0;0;0
1412850;Spacelines from the Far Out;;0 - 20,000;215;54;161;0;0;14
1412880;Village businessman;;0 - 20,000;1;1;0;0;0;0
1412890;Frail Hearts: Versicorae Domlion;;0 - 20,000;45;1;44;0;0;0
1412950;Dark Romance: Vampire Origins Collector's Edition;;0 - 20,000;12;0;12;0;0;2
1412980;Ironseed 25th Anniversary Edition;;0 - 20,000;11;0;11;0;0;0
1413000;Jurisdiction;;0 - 20,000;15;5;10;0;0;0
1413010;Cube Gothic;;20,000 - 50,000;20;10;10;0;0;0
1413020;Superfly;;0 - 20,000;399;52;347;303;303;8
1413090;Yoli;;0 - 20,000;26;0;26;0;0;0
1413170;DroneGlitch;;0 - 20,000;3;0;3;0;0;0
1413260;Traveler of Artcaster;;0 - 20,000;1;2;-1;0;0;0
1413290;Plummet;;0 - 20,000;4;1;3;0;0;0
1413300;Dezinsector;;20,000 - 50,000;16;3;13;0;0;0
1413350;Flipper Volcano;;0 - 20,000;22;13;9;0;0;4
1413370;Power to the People;;20,000 - 50,000;273;52;221;119;119;8
1413440;Run Die Jump;;0 - 20,000;1;0;1;0;0;0
1413480;Shin Megami Tensei III Nocturne HD Remaster;;100,000 - 200,000;2374;333;2041;1566;2183;98
1413490;Tower of Mice;;0 - 20,000;0;1;-1;0;0;0
1413500;Infectra;;0 - 20,000;9;1;8;0;0;0
1413540;Amarok Dreams Demo;;20,000 - 50,000;42;27;15;0;0;1
1413550;赛博侦探：艾尔塔特;;0 - 20,000;6;2;4;0;0;0
1413560;Mages and Treasures;;0 - 20,000;14;1;13;0;0;0
1413580;The Dragoness: Command of the Flame;;100,000 - 200,000;81;30;51;0;0;0
1413590;LA FORET DE PAGO : LA VENGEANCE DU DRAGON;;20,000 - 50,000;37;3;34;0;0;0
1413630;Woodland Saga;;0 - 20,000;3;8;-5;0;0;0
1413650;The Civil War;;20,000 - 50,000;4;3;1;0;0;0
1413660;Elderand;;20,000 - 50,000;55;13;42;0;0;108
1413670;U27RA R3Z0NANC3;;0 - 20,000;9;0;9;0;0;0
1413680;DANGER! Escape Lab;;0 - 20,000;31;20;11;0;0;0
1413780;TECHPACK;;0 - 20,000;1;0;1;0;0;0
1413790;10mg: HANDMADEDEATHLABYRINTH issue 0;;0 - 20,000;24;2;22;0;0;0
1413820;Balloon Saga;;0 - 20,000;4;11;-7;0;0;0
1413870;Shadow Man Remastered;;100,000 - 200,000;917;48;869;744;1052;14
1413890;Nice to NO you;;0 - 20,000;2;2;0;0;0;0
1413960;Chevalier Historie;;0 - 20,000;250;46;204;0;0;6
1413970;Fox Girls Never Play Dirty;;0 - 20,000;143;23;120;0;0;5
1413980;The Demon Lord is New in Town!;;0 - 20,000;82;28;54;0;0;1
1413990;The Heart of Darkness;;0 - 20,000;191;30;161;0;0;7
1414000;Obscurite Magie: The City of Sin;;0 - 20,000;54;18;36;0;0;0
1414020;Mixolumia;;0 - 20,000;185;2;183;69;69;1
1414020;Mixolumia;;0 - 20,000;185;2;183;69;69;1
1414060;Lone Archer;;0 - 20,000;1;0;1;0;0;0
1414070;Sokoban: Bunny Tales;;0 - 20,000;2;0;2;0;0;0
1414090;Buddi Bot:  Your Machine Learning AI Helper With Advanced Neural Networking!;;20,000 - 50,000;10;3;7;0;0;0
1414180;Motesolo : No Girlfriend Since Birth;;50,000 - 100,000;757;121;636;165;165;9
1414210;Rainy;;100,000 - 200,000;9;6;3;0;0;0
1414220;POPPIN' DONUTS;;20,000 - 50,000;5;0;5;0;0;0
1414240;Evolution of a Mini World: Physics Wonderland;;0 - 20,000;14;2;12;0;0;0
1414240;Evolution of a Mini World: Physics Wonderland;;0 - 20,000;14;2;12;0;0;0
1414250;CORPSE FACTORY;;0 - 20,000;318;54;264;0;0;1
1414270;Hexdoku;;0 - 20,000;5;0;5;0;0;0
1414280;Fishing Together;;0 - 20,000;11;0;11;0;0;0
1414290;VR Maze;;0 - 20,000;1;2;-1;0;0;0
1414300;BeetleQuest;;0 - 20,000;4;1;3;0;0;0
1414320;여우불;;0 - 20,000;12;8;4;0;0;0
1414380;Monty Kong;;0 - 20,000;3;0;3;0;0;0
1414400;Unnatural Disaster;;0 - 20,000;9;3;6;0;0;1
1414430;Project Morpheus: Prologue;;50,000 - 100,000;397;90;307;136;136;0
1414470;Yeomna : The Legend of Dongbaek;;0 - 20,000;31;24;7;0;0;0
1414480;Zof;;0 - 20,000;39;4;35;0;0;1
1414490;Kasmo;;100,000 - 200,000;8;2;6;0;0;0
1414500;Voyeur;;50,000 - 100,000;5;1;4;0;0;0
1414530;Kavel;;0 - 20,000;16;0;16;0;0;0
1414550;Tunnel Blast;;0 - 20,000;5;0;5;0;0;0
1414570;Expiration;;0 - 20,000;3;0;3;0;0;0
1414600;Buzzle;;0 - 20,000;1;1;0;0;0;0
1414640;Early Quest;;0 - 20,000;0;1;-1;0;0;0
1414640;Early Quest;;0 - 20,000;0;1;-1;0;0;0
1414650;EDENGATE: The Edge of Life;;0 - 20,000;54;21;33;0;0;1
1414680;Geometry Rocket;;0 - 20,000;2;3;-1;0;0;0
1414680;Geometry Rocket;;0 - 20,000;2;3;-1;0;0;0
1414700;The Imagined Leviathan: Prologue;;20,000 - 50,000;123;32;91;0;0;0
1414710;Arc Wizards 2;;20,000 - 50,000;4;0;4;0;0;0
1414720;Desktop Man;;0 - 20,000;11;5;6;0;0;0
1414770;Quinterra;;0 - 20,000;37;9;28;0;0;0
1414800;Wet steps;;20,000 - 50,000;220;18;202;0;0;0
1414840;Zombie Rush - Heroes;;0 - 20,000;12;5;7;0;0;0
1414850;Nickelodeon All-Star Brawl;;200,000 - 500,000;3921;1355;2566;258;211;15
1414900;Rage Jump;;0 - 20,000;4;1;3;0;0;0
1414920;Knightmare;;20,000 - 50,000;1;0;1;0;0;0
1414930;Tenami;;20,000 - 50,000;19;4;15;0;0;0
1414990;Quarantine simulator;;0 - 20,000;9;1;8;0;0;0
1415010;Lynium;;0 - 20,000;7;9;-2;0;0;1
1415020;Bloody Service;;20,000 - 50,000;29;0;29;0;0;0
1415110;Second Chance;;20,000 - 50,000;3;0;3;0;0;0
1415120;Finger Breaker;;0 - 20,000;7;0;7;0;0;0
1415140;Kandidatos Kart;;0 - 20,000;517;68;449;0;0;3
1415200;Pitched Battle;;50,000 - 100,000;6;2;4;0;0;0
1415250;RE: Get To Schol On Time;;0 - 20,000;17;3;14;0;0;0
1415300;Escaping maze;;0 - 20,000;0;5;-5;0;0;0
1415320;PalmRide;;0 - 20,000;99;18;81;0;0;0
1415370;Grandmother;;0 - 20,000;17;10;7;0;0;0
1415380;Overlay Studio;;0 - 20,000;12;0;12;0;0;0
1415410;Farm Manager 2021: Prologue;;200,000 - 500,000;710;211;499;26;26;9
1415470;Team-Z;;0 - 20,000;9;8;1;0;0;0
1415480;10mg: Locked In;;0 - 20,000;5;3;2;0;0;0
1415500;SUDOKU TIME;;0 - 20,000;11;9;2;0;0;0
1415520;High Speed Cataclysm;;0 - 20,000;17;2;15;0;0;0
1415540;ElementalsFight;;0 - 20,000;4;5;-1;0;0;0
1415580;Heart World;;0 - 20,000;1;2;-1;0;0;0
1415620;Sudoku Forever;;0 - 20,000;5;1;4;0;0;0
1415630;River Attack;;0 - 20,000;15;1;14;0;0;0
1415660;TRADER LIFE SIMULATOR;;100,000 - 200,000;1497;426;1071;196;219;17
1415670;High School of Memories;;0 - 20,000;1;1;0;0;0;0
1415750;Gravity_Kid;;0 - 20,000;19;8;11;0;0;0
1415830;NECROSIS : RECONFIGURATED;;0 - 20,000;50;12;38;0;0;0
1415870;Knight`s Pride;;0 - 20,000;5;2;3;0;0;0
1415920;PBA Pro Bowling 2021;;0 - 20,000;57;21;36;0;0;5
1416000;The Dark: Survival RPG;;0 - 20,000;15;6;9;0;0;0
1416050;Shovel Knight Dig;;0 - 20,000;419;155;264;1670;1670;7
1416130;Perfect Vermin;;100,000 - 200,000;2608;149;2459;0;0;4
1416140;Gododo;;0 - 20,000;3;3;0;0;0;0
1416150;Drilly Willis;;0 - 20,000;6;0;6;0;0;0
1416160;安堂的心理咨询室：杯中之心〈ANDOU：Pulse of cup〉;;20,000 - 50,000;62;18;44;0;0;0
1416180;DECO:BLOCK SIMULATOR;;0 - 20,000;2;0;2;0;0;0
1416190;Fatiao发条：自动化工具;;0 - 20,000;4;0;4;0;0;3
1416210;Pantyhose Test Girl;;0 - 20,000;19;17;2;0;0;0
1416210;Pantyhose Test Girl;;0 - 20,000;19;17;2;0;0;0
1416230;Panzer Knights;;20,000 - 50,000;1040;225;815;173;247;6
1416240;夜永 Eternal Love;;50,000 - 100,000;734;33;701;351;351;2
1416260;SpellForce 3: Versus Edition;;100,000 - 200,000;876;265;611;762;300;234
1416290;Ghost Run 3D;;0 - 20,000;13;1;12;0;0;0
1416340;Impostor Inside Us;;0 - 20,000;53;24;29;0;0;0
1416430;New Yankee 9: The Evil Spellbook;;0 - 20,000;14;1;13;0;0;0
1416460;Horror Globes;;20,000 - 50,000;68;6;62;0;0;0
1416460;Horror Globes;;20,000 - 50,000;68;6;62;0;0;0
1416520;Drive 21;;0 - 20,000;188;153;35;0;0;2
1416520;Drive 21;;0 - 20,000;188;153;35;0;0;2
1416600;Evil Ritual - Horror Escape;;0 - 20,000;5;11;-6;0;0;0
1416600;Evil Ritual - Horror Escape;;0 - 20,000;5;11;-6;0;0;0
1416690;4X4 Masters;;0 - 20,000;6;0;6;0;0;0
1416720;Brain Games;;0 - 20,000;25;6;19;0;0;0
1416730;Ball at Work: The Ultimate Speedrun Platformer!;;50,000 - 100,000;352;58;294;0;0;0
1416760;B.ARK;;0 - 20,000;33;4;29;0;0;0
1416770;Modulo;;0 - 20,000;3;0;3;0;0;0
1416820;Brutal Wizardry;;0 - 20,000;2;4;-2;0;0;0
1416930;Infected Prison;;0 - 20,000;5;8;-3;0;0;0
1416980;Reimu's Weird little adventure;;0 - 20,000;24;1;23;0;0;0
1417000;Golf Party;;0 - 20,000;25;9;16;0;0;8
1417010;Shrine II;;50,000 - 100,000;612;49;563;0;0;4
1417090;NEON STRUCT: Carrion Carrier;;100,000 - 200,000;26;3;23;0;0;0
1417130;Planet LEV;;20,000 - 50,000;4;0;4;0;0;0
1417150;World of Pets: Match 3 and Decorate;;0 - 20,000;6;2;4;0;0;0
1417170;Don't Miss The King;;0 - 20,000;1;0;1;0;0;0
1417190;Gravity Mummy;;0 - 20,000;25;12;13;0;0;1
1417190;Gravity Mummy;;0 - 20,000;25;12;13;0;0;1
1417230;Toupei55;;0 - 20,000;2;1;1;0;0;0
1417250;Three Kingdoms 21;;0 - 20,000;0;1;-1;0;0;0
1417310;Dead TD;;0 - 20,000;3;0;3;0;0;0
1417310;Dead TD;;0 - 20,000;3;0;3;0;0;0
1417320;Inheritors2078;;20,000 - 50,000;16;4;12;0;0;0
1417340;Werewolves Online;;0 - 20,000;12;9;3;0;0;0
1417400;Escape Dinosaur Island;;20,000 - 50,000;3;2;1;0;0;0
1417420;Endless Furry Killer 2020;;0 - 20,000;198;23;175;0;0;0
1417450;Grilled;;0 - 20,000;1;0;1;0;0;0
1417490;Fractal Fury;;50,000 - 100,000;96;41;55;0;0;0
1417500;Planet Station;;0 - 20,000;33;19;14;0;0;0
1417530;Fashion Show Makeover Mega Pack;;20,000 - 50,000;8;3;5;0;0;0
1417540;Gravity Block;;0 - 20,000;33;2;31;0;0;0
1417590;The Legends of Tynedale;;0 - 20,000;5;0;5;0;0;0
1417610;After You;;0 - 20,000;64;15;49;0;0;1
1417640;Stella Voyager;;0 - 20,000;5;0;5;0;0;0
1417670;Zombie camping;;0 - 20,000;15;3;12;0;0;0
1417670;Zombie camping;;0 - 20,000;15;3;12;0;0;0
1417680;Damien;;20,000 - 50,000;3;5;-2;0;0;0
1417690;12 MiniBattles;;0 - 20,000;8;1;7;0;0;0
1417720;Gemini;;0 - 20,000;119;12;107;0;0;1
1417730;Coffin Mall;;20,000 - 50,000;40;10;30;0;0;0
1417740;Reality End;;0 - 20,000;0;4;-4;0;0;0
1417750;Moondrop;;0 - 20,000;18;0;18;0;0;0
1417840;跳跃练习生/Jump Man;;0 - 20,000;5;0;5;0;0;0
1417880;Winter Ember;;100,000 - 200,000;53;31;22;0;0;3
1417890;Catie in MeowmeowLand;;0 - 20,000;69;3;66;0;0;1
1417940;捕鱼炸翻天;;20,000 - 50,000;19;31;-12;0;0;1
1417950;Simon the Sorcerer 3D;;0 - 20,000;8;5;3;0;0;1
1417960;Timeline Traveler;;0 - 20,000;2;1;1;0;0;0
1417970;Surprise Party!;;20,000 - 50,000;4;2;2;0;0;0
1417970;Surprise Party!;;20,000 - 50,000;4;2;2;0;0;0
1418010;Black Chapter;;20,000 - 50,000;48;4;44;0;0;0
1418020;Tavern of Gods;;50,000 - 100,000;595;157;438;433;433;4
1418090;Cafe Deux Femmes;;0 - 20,000;14;6;8;0;0;0
1418100;Swords of Legends Online;;1,000,000 - 2,000,000;3857;1815;2042;3046;685;202
1418140;Invasion 2: Doomed;;0 - 20,000;9;6;3;0;0;0
1418160;Happy Quest;;50,000 - 100,000;650;133;517;135;138;2
1418310;BreakBlast;;0 - 20,000;17;3;14;0;0;0
1418320;Puerto Viejo;;0 - 20,000;14;5;9;0;0;0
1418330;Sweet Halloween;;0 - 20,000;12;8;4;0;0;0
1418350;California Games II;;0 - 20,000;2;0;2;0;0;0
1418360;Lonesome Village;;0 - 20,000;83;19;64;0;0;3
1418430;Horror Bar VR;;0 - 20,000;54;6;48;59;59;0
1418440;Beyond Polaris Guardian;;0 - 20,000;2;2;0;0;0;0
1418460;Mygnar;;0 - 20,000;11;1;10;0;0;0
1418470;Franky the Bumwalker: REBORN;;0 - 20,000;3;2;1;0;0;0
1418490;The Storm;;0 - 20,000;1;0;1;0;0;0
1418520;109 Remastered;;0 - 20,000;1;0;1;0;0;0
1418540;SEARCH PARTY: Director's Cut;;0 - 20,000;79;4;75;0;0;0
1418570;Zen Trails;;0 - 20,000;83;0;83;0;0;0
1418610;FEVER: FIGHT THE FEVER;;0 - 20,000;4;1;3;0;0;0
1418610;FEVER: FIGHT THE FEVER;;0 - 20,000;4;1;3;0;0;0
1418630;Dread Hunger;;1,000,000 - 2,000,000;26000;16324;9676;9363;3312;9523
1418670;Fire survival;;0 - 20,000;3;3;0;0;0;0
1418680;Pretty Girls Mahjong Solitaire [BLUE];;0 - 20,000;24;7;17;0;0;0
1418790;Movavi Video Converter Premium 2022;;0 - 20,000;37;18;19;0;0;7
1418800;Movavi Video Editor Plus 2021 - Video Editing Software;;0 - 20,000;319;68;251;244;244;63
1418830;Sayonara Golden Days;;0 - 20,000;79;1;78;0;0;0
1418970;Movavi Video Suite 2021 Steam Edition -- Video Making Software - Video Editor, Screen Recorder and Video Converter;;0 - 20,000;121;62;59;3183;3183;22
1418990;Unicorns on Unicycles;;0 - 20,000;6;0;6;0;0;0
1419040;Road Maintenance Simulator;;0 - 20,000;61;56;5;0;0;3
1419070;Mython Island;;0 - 20,000;28;10;18;0;0;1
1419090;"MVorpheus ""Content Organizer""";;0 - 20,000;0;2;-2;0;0;0
1419100;The Unexpected Quest Prologue;;0 - 20,000;72;17;55;0;0;2
1419130;Airstrife: Assault of the Aviators;;20,000 - 50,000;14;2;12;0;0;0
1419140;Little Big Monsters;;0 - 20,000;1;0;1;0;0;0
1419150;Woodland Empire;;0 - 20,000;11;0;11;0;0;7
1419160;Souldiers;;50,000 - 100,000;1043;570;473;0;0;30
1419180;Mystica;;50,000 - 100,000;6;0;6;0;0;1
1419190;Way Walkers: University;;0 - 20,000;5;3;2;0;0;0
1419200;Way Walkers: University 2;;20,000 - 50,000;1;3;-2;0;0;0
1419290;Out of Line;;0 - 20,000;159;16;143;145;145;0
1419330;Horizon Odyssey;;0 - 20,000;2;0;2;0;0;0
1419350;Outbreak: Endless Nightmares;;0 - 20,000;16;13;3;0;0;1
1419360;Hyper Psychic Gauntlets;;0 - 20,000;4;0;4;0;0;0
1419370;Cooking Companions: Appetizer Edition;;20,000 - 50,000;316;33;283;0;0;1
1419380;Invisible Wings;;20,000 - 50,000;16;5;11;0;0;0
1419430;Magic Ocean - Multiplayer Roguelike;;20,000 - 50,000;8;6;2;0;0;0
1419440;Truck Truck;;20,000 - 50,000;1;6;-5;0;0;0
1419480;Love's Sweet Garnish 2;;0 - 20,000;105;5;100;0;0;0
1419580;ToVer Defense;;0 - 20,000;3;0;3;0;0;0
1419670;REALITY;;0 - 20,000;12;1;11;0;0;0
1419680;Ursa;;0 - 20,000;6;1;5;0;0;0
1419730;Seek Girl Ⅵ;;50,000 - 100,000;904;239;665;31;34;3
1419740;The Witch in the Forest;;0 - 20,000;64;11;53;0;0;1
1419750;Apostle: Rebellion;;0 - 20,000;198;39;159;0;0;16
1419760;Zombie's Cool;;0 - 20,000;1;1;0;0;0;0
1419770;JumpJumpBall;;0 - 20,000;1;0;1;0;0;0
1419860;Tukoni;;100,000 - 200,000;2987;80;2907;0;0;4
1419870;The Book of Shadows;;0 - 20,000;10;1;9;0;0;0
1419880;The Summoner;;0 - 20,000;1;1;0;0;0;0
1420050;Loot Grind Simulator;;20,000 - 50,000;261;68;193;0;0;1
1420060;Helix Slider;;0 - 20,000;84;7;77;0;0;1
1420080;Wonder Boy: Asha in Monster World;;0 - 20,000;93;22;71;0;0;0
1420100;Skate Forever;;0 - 20,000;0;5;-5;0;0;0
1420160;Paranormal Stories;;0 - 20,000;4;6;-2;0;0;0
1420290;No More Heroes;;50,000 - 100,000;764;243;521;0;0;1
1420300;No More Heroes 2: Desperate Struggle;;20,000 - 50,000;294;122;172;108;108;1
1420320;Let's Learn Japanese! Kanji Sudoku;;0 - 20,000;10;3;7;0;0;0
1420330;Business Simulator;;0 - 20,000;11;6;5;0;0;0
1420350;Fraymakers;;50,000 - 100,000;556;181;375;130;130;49
1420400;Heterodox;;0 - 20,000;4;1;3;0;0;0
1420510;Usurper: Soulbound;;0 - 20,000;34;12;22;0;0;0
1420540;CATch the Stars;;0 - 20,000;310;10;300;0;0;0
1420580;Daikaiju Daikessen: Versus;;20,000 - 50,000;76;39;37;0;0;0
1420640;Boundary: Benchmark;;0 - 20,000;56;6;50;0;0;2
1420650;Touhou Bunkachou ～ Shoot the Bullet.;;20,000 - 50,000;36;0;36;0;0;0
1420680;Shards of Feyra;;20,000 - 50,000;7;3;4;0;0;0
1420690;Project Ultra;;0 - 20,000;3;0;3;0;0;0
1420720;无名录;;20,000 - 50,000;15;2;13;0;0;0
1420730;Save the Planet;;0 - 20,000;2;1;1;0;0;0
1420740;Your amazing T-Gotchi!;;50,000 - 100,000;268;126;142;0;0;5
1420770;Winter Resort Simulator 2;;50,000 - 100,000;817;194;623;3549;3844;128
1420780;校长模拟器;;0 - 20,000;11;60;-49;0;0;1
1420780;校长模拟器;;0 - 20,000;11;60;-49;0;0;1
1420810;Touhou Kaeizuka ～ Phantasmagoria of Flower View.;;20,000 - 50,000;152;1;151;0;0;4
1420830;Happy Numbers;;20,000 - 50,000;303;36;267;27;37;0
1420850;CyberTaxi;;20,000 - 50,000;96;37;59;0;0;0
1420860;Deception;;0 - 20,000;2;0;2;0;0;0
1420890;VA Framework - Build Your AI;;0 - 20,000;2;5;-3;0;0;0
1420930;Movavi Slideshow Maker 8;;0 - 20,000;5;2;3;0;0;2
1420950;Spinning_Kid;;0 - 20,000;23;5;18;0;0;0
1420970;Fantasy Heroes 2;;0 - 20,000;3;0;3;0;0;0
1420980;Epidemic;;0 - 20,000;14;8;6;0;0;0
1421020;Simple FPS Aim Trainer;;0 - 20,000;46;5;41;0;0;1
1421100;Binaural Odyssey;;20,000 - 50,000;23;3;20;0;0;0
1421120;Montezuma's Revenge;;20,000 - 50,000;52;5;47;0;0;0
1421230;Syberia: The World Before - Prologue;;100,000 - 200,000;1035;357;678;56;64;0
1421250;Tiny Bunny;;200,000 - 500,000;10330;160;10170;274;310;40
1421310;Secret of Harrow Manor 2;;0 - 20,000;1;4;-3;0;0;0
1421390;Tichu;;0 - 20,000;8;0;8;0;0;2
1421410;Nectar of the Gods;;20,000 - 50,000;17;4;13;0;0;0
1421410;Nectar of the Gods;;20,000 - 50,000;17;4;13;0;0;0
1421600;Safari Zone;;0 - 20,000;2;0;2;0;0;0
1421610;DEUS EX MACHINA: Episode 1;;50,000 - 100,000;1;1;0;0;0;0
1421690;Panmorphia;;0 - 20,000;22;3;19;0;0;0
1421700;BegieAde ~a lyric of lie and retribution~;;0 - 20,000;39;18;21;21;21;1
1421710;Epic Palace : Knossos;;0 - 20,000;16;2;14;0;0;0
1421760;What Comes After;;50,000 - 100,000;662;64;598;1;1;0
1421790;Labyrinth City: Pierre the Maze Detective;;50,000 - 100,000;1672;58;1614;97;123;12
1421930;BLIND QUEST - The Frost Demon;;0 - 20,000;1;0;1;0;0;0
1421960;HordeCore: Training Ground;;0 - 20,000;82;15;67;42;42;0
1421970;Time Loader: First Memories;;20,000 - 50,000;83;6;77;51;51;0
1422050;UOS Prototype;;20,000 - 50,000;108;0;108;0;0;0
1422080;Oraiah;;0 - 20,000;2;2;0;0;0;0
1422090;Sink Again;;20,000 - 50,000;83;38;45;0;0;0
1422130;SimRail - The Railway Simulator;;20,000 - 50,000;928;81;847;1287;1287;663
1422150;PP Puncher;;20,000 - 50,000;24;2;22;0;0;1
1422180;Galactic Crew II;;50,000 - 100,000;13;16;-3;0;0;1
1422190;Fuzz Force: Spook Squad;;0 - 20,000;50;3;47;0;0;1
1422200;Rev;;0 - 20,000;35;5;30;0;0;1
1422210;Throw Me in the River;;0 - 20,000;21;2;19;0;0;0
1422220;Cardinal Chains;;0 - 20,000;15;0;15;0;0;0
1422260;The Last Element: Looking For Tomorrow;;20,000 - 50,000;97;43;54;0;0;0
1422270;Rank: Warmaster;;0 - 20,000;3;0;3;0;0;0
1422280;Torqued Up Legends;;0 - 20,000;20;11;9;0;0;0
1422290;Jardinains!;;0 - 20,000;11;1;10;0;0;0
1422300;IWOCon 2021;;20,000 - 50,000;85;32;53;0;0;0
1422300;IWOCon 2021;;20,000 - 50,000;85;32;53;0;0;0
1422380;Witches x Warlocks;;20,000 - 50,000;446;37;409;0;0;3
1422410;Into the Pit;;0 - 20,000;101;39;62;133;133;0
1422420;Dodgeball Academia;;20,000 - 50,000;332;19;313;0;0;8
1422430;Next Space Rebels;;0 - 20,000;205;36;169;0;0;4
1422520;Divide and Conquer: The Board Game;;0 - 20,000;1;2;-1;0;0;0
1422540;云端之约;;20,000 - 50,000;439;28;411;0;0;1
1422570;EchoBlade;;0 - 20,000;20;1;19;0;0;0
1422610;Aurora;;50,000 - 100,000;404;95;309;16;26;1
1422630;Active Neurons 3 - Wonders Of The World;;20,000 - 50,000;103;5;98;0;0;1
1422670;Son Savaşçı;;0 - 20,000;10;9;1;0;0;0
1422680;Battle Sad Boy;;0 - 20,000;3;0;3;0;0;0
1422730;Hijacker Jack : ARCADE FMV;;0 - 20,000;34;20;14;0;0;0
1422740;DIERY HEAVEN;;0 - 20,000;4;2;2;0;0;0
1422750;Aery - Sky Castle;;0 - 20,000;40;14;26;0;0;0
1422780;Gizmos: Spooky Adventures;;0 - 20,000;11;0;11;0;0;0
1422790;门 The Door;;0 - 20,000;0;3;-3;0;0;0
1422810;Adventure Minesweeper;;0 - 20,000;3;2;1;0;0;0
1422820;Hidden Shelter;;0 - 20,000;30;24;6;0;0;0
1422880;Frisbee For Fun;;0 - 20,000;18;2;16;0;0;0
1422910;Agent Klutz;;20,000 - 50,000;22;3;19;0;0;0
1422930;Aripi;;0 - 20,000;18;6;12;0;0;0
1422940;Glider Sim;;0 - 20,000;70;13;57;0;0;0
1422950;Worm Adventure 4: Into the Wormhole;;0 - 20,000;18;0;18;0;0;0
1422980;Structura;;20,000 - 50,000;0;1;-1;0;0;0
1423010;Zephyr;;0 - 20,000;1;0;1;0;0;0
1423030;Evolution;;0 - 20,000;25;27;-2;0;0;1
1423060;wonShot;;20,000 - 50,000;27;2;25;0;0;0
1423090;Monster Collector;;0 - 20,000;15;8;7;0;0;1
1423140;Assimilate! (A Party Game);;0 - 20,000;13;2;11;0;0;0
1423200;Legacy - Witch Island 2;;0 - 20,000;26;12;14;0;0;0
1423270;Ghost Stories 2;;0 - 20,000;36;13;23;0;0;0
1423280;Synthwave Hop;;0 - 20,000;12;1;11;0;0;0
1423340;IronSurvival;;0 - 20,000;5;7;-2;0;0;0
1423360;Swire Future;;0 - 20,000;3;1;2;0;0;0
1423370;NOeSIS_羽化;;20,000 - 50,000;379;2;377;0;0;2
1423410;Zone of Death;;200,000 - 500,000;2;3;-1;0;0;0
1423420;Sublunar;;50,000 - 100,000;2;1;1;0;0;0
1423500;Darklands:Awakening;;0 - 20,000;2;13;-11;0;0;0
1423540;Air Gun Fighter;;0 - 20,000;2;3;-1;0;0;0
1423590;Wardroid;;0 - 20,000;2;0;2;0;0;0
1423600;BLUE REFLECTION: Second Light;;20,000 - 50,000;625;151;474;252;452;36
1423610;Tales from Zilmurik;;0 - 20,000;4;2;2;0;0;0
1423680;DOGFIGHTER -WW2-;;0 - 20,000;3;1;2;0;0;0
1423720;Antiprism;;0 - 20,000;22;9;13;0;0;0
1423780;Plague M.D.;;0 - 20,000;100;33;67;0;0;0
1423830;Cave Crawl;;0 - 20,000;3;0;3;0;0;0
1423880;Grid Fight - Mask of the Goddess - First Boot;;0 - 20,000;4;1;3;0;0;0
1423970;Hunt the Lights;;0 - 20,000;1;0;1;0;0;0
1423980;Streatham Hill Stories;;0 - 20,000;13;10;3;0;0;0
1424010;Slaves of Magic prelude;;50,000 - 100,000;4;2;2;0;0;0
1424020;Wrath Of The Violent Vicar - Interactive Film;;0 - 20,000;10;6;4;0;0;0
1424050;Chess'Extra;;0 - 20,000;134;13;121;0;0;4
1424070;Blocks Stacking;;0 - 20,000;17;1;16;0;0;0
1424080;Roads of Rome: New Generation 3 Collector's Edition;;0 - 20,000;19;1;18;0;0;9
1424120;Synth Swinger;;20,000 - 50,000;1;0;1;0;0;0
1424140;Forest Problems;;0 - 20,000;1;5;-4;0;0;0
1424250;Puzzzle;;20,000 - 50,000;23;13;10;0;0;0
1424270;Brew & Brawl - Gnomes vs. Dwarves;;0 - 20,000;3;0;3;0;0;0
1424290;Project Colonies: MARS 2120;;0 - 20,000;8;0;8;0;0;0
1424310;Living in the Ending World;;0 - 20,000;7;13;-6;0;0;0
1424330;Wobbledogs;;100,000 - 200,000;6065;113;5952;344;351;148
1424350;Bunny Hill;;0 - 20,000;55;5;50;0;0;0
1424360;Pillow Simulator;;0 - 20,000;13;4;9;0;0;0
1424380;Bunker Down;;0 - 20,000;2;0;2;0;0;0
1424500;Secret of The Lost Keys - Episode I: The Attack on Disred;;0 - 20,000;7;0;7;0;0;0
1424570;Delta0;;0 - 20,000;11;0;11;0;0;0
1424610;自西徂东;;0 - 20,000;4;0;4;0;0;0
1424630;CosmoDreamer;;0 - 20,000;87;0;87;0;0;2
1424640;余烬;;20,000 - 50,000;5;7;-2;0;0;0
1424650;Flicker;;0 - 20,000;1;0;1;0;0;0
1424660;9-nine-:Episode 4;;0 - 20,000;654;12;642;0;0;5
1424690;Hatchwell;;0 - 20,000;29;3;26;0;0;0
1424700;The secret of the stone;;0 - 20,000;6;12;-6;0;0;0
1424710;Geneforge 1 - Mutagen;;100,000 - 200,000;303;16;287;0;0;13
1424720;墨心：波云诡船;;100,000 - 200,000;1225;133;1092;299;299;2
1424770;Aery - Little Bird Adventure;;0 - 20,000;32;21;11;0;0;0
1424780;My Little Dog Adventure;;0 - 20,000;17;12;5;0;0;0
1424790;Aery - Broken Memories;;0 - 20,000;30;6;24;0;0;0
1424870;Cross Maid;;0 - 20,000;176;9;167;0;0;0
1424870;Cross Maid;;0 - 20,000;176;9;167;0;0;0
1424890;天仙变;;20,000 - 50,000;5;3;2;0;0;0
1424900;Air Attack;;20,000 - 50,000;66;8;58;0;0;1
1424930;Connect Chat;;20,000 - 50,000;14;13;1;0;0;0
1424960;Random(platformer);;0 - 20,000;1;0;1;0;0;0
1424980;The Solitaire Conspiracy;;100,000 - 200,000;611;63;548;344;344;2
1425030;Cyberwinter;;0 - 20,000;2;1;1;0;0;0
1425050;Erazer - Devise & Destroy;;0 - 20,000;8;1;7;0;0;0
1425070;Golden Force;;0 - 20,000;13;10;3;0;0;0
1425090;EXOTIUM - Episode 1;;0 - 20,000;0;1;-1;0;0;0
1425110;Space Empires I;;20,000 - 50,000;4;4;0;0;0;0
1425120;Clutter Evolution: Beyond Xtreme;;0 - 20,000;13;0;13;0;0;0
1425130;Forgotten Hill First Steps;;0 - 20,000;79;3;76;0;0;1
1425140;Until Last Breath;;0 - 20,000;8;2;6;0;0;0
1425170;Car Jump;;0 - 20,000;1;0;1;0;0;0
1425190;Abducted: The Night Hunters;;0 - 20,000;18;0;18;0;0;0
1425240;Match It!;;20,000 - 50,000;5;1;4;0;0;0
1425250;Gravity Field;;50,000 - 100,000;107;38;69;148;148;21
1425260;Chibi Horror: The School;;;;;0;;;
1425270;PAGO FOREST: TOWER DEFENSE;;0 - 20,000;73;6;67;0;0;0
1425270;PAGO FOREST: TOWER DEFENSE;;0 - 20,000;73;6;67;0;0;0
1425280;Tantal;;0 - 20,000;14;2;12;0;0;0
1425300;Factorization;;0 - 20,000;2;4;-2;0;0;0
1425330;Eye of the Beholder;;20,000 - 50,000;7;2;5;0;0;0
1425370;Razenroth 2;;0 - 20,000;19;3;16;0;0;0
1425380;10mg :);;0 - 20,000;59;1;58;0;0;0
1425390;Eat or DIE!;;0 - 20,000;16;4;12;0;0;0
1425410;Castlehold;;0 - 20,000;57;23;34;0;0;0
1425510;Clown In a House;;0 - 20,000;47;6;41;0;0;0
1425550;Who is the Liar?;;0 - 20,000;30;13;17;0;0;0
1425580;Last Soul - Prologue;;20,000 - 50,000;37;5;32;0;0;0
1425620;赤蛮奇的头头大冒险 ~ Sekibanki Head Adventure;;0 - 20,000;1;1;0;0;0;0
1425630;Space Crusaders;;0 - 20,000;19;4;15;0;0;0
1425640;Minestrife;;0 - 20,000;2;0;2;0;0;0
1425720;Human Constructor VR;;0 - 20,000;1;1;0;0;0;0
1425730;Gal*Gun Returns;;20,000 - 50,000;177;32;145;0;0;7
1425760;Pulling No Punches;;0 - 20,000;383;7;376;0;0;9
1425760;Pulling No Punches;;0 - 20,000;383;7;376;0;0;9
1425770;再苟一步 One More Step;;0 - 20,000;46;7;39;0;0;0
1425790;刺沙;;20,000 - 50,000;3;9;-6;0;0;0
1425830;Halley's Dream;;0 - 20,000;6;2;4;0;0;0
1425840;Alchemania;;0 - 20,000;30;24;6;0;0;0
1425920;Crazy Engineer;;0 - 20,000;0;1;-1;0;0;0
1426050;Fractured Online;;50,000 - 100,000;184;263;-79;0;0;0
1426110;Love n Dream: Virtual Happiness;;20,000 - 50,000;190;68;122;88;150;1
1426110;Love n Dream: Virtual Happiness;;20,000 - 50,000;190;68;122;88;150;1
1426120;Re:DESTINY;;20,000 - 50,000;214;83;131;80;80;1
1426130;MAYOR MADNESS;;0 - 20,000;1;0;1;0;0;0
1426160;The Den of Worms;;20,000 - 50,000;4;0;4;0;0;0
1426210;It Takes Two;;5,000,000 - 10,000,000;114098;5156;108942;921;848;7760
1426230;It's Not About The End;;0 - 20,000;32;4;28;0;0;0
1426280;Hello Puppets! VR;;0 - 20,000;188;38;150;107;107;0
1426310;Dee-6: Dice Defenders;;0 - 20,000;31;11;20;0;0;1
1426330;Mega Veg Man;;0 - 20,000;2;0;2;0;0;0
1426400;Beat 'Em Up;;0 - 20,000;3;3;0;0;0;0
1426450;Age of Darkness: Final Stand;;200,000 - 500,000;4270;792;3478;309;365;207
1426480;Fate of Kai;;0 - 20,000;170;10;160;0;0;0
1426490;LOST EPIC;;20,000 - 50,000;699;263;436;431;431;27
1426500;Reboot;;0 - 20,000;80;24;56;9;9;0
1426530;Sid Classic;;20,000 - 50,000;92;24;68;0;0;13
1426540;Angry Cat;;0 - 20,000;0;0;0;0;0;4
1426560;Ghost Opera House 剧院魅影;;0 - 20,000;6;2;4;0;0;0
1426570;Space Station 51;;20,000 - 50,000;4;1;3;0;0;0
1426730;The Immortal Mayor;;100,000 - 200,000;1724;851;873;2474;2625;48
1426790;Vicewave 1984;;20,000 - 50,000;115;79;36;41;41;0
1426890;Jewel Match Solitaire Collector's Edition;;0 - 20,000;14;2;12;0;0;0
1426900;Dread Nautical;;0 - 20,000;22;7;15;0;0;0
1426970;Boom!VR;;0 - 20,000;3;1;2;0;0;0
1426980;Hidden Memory - Nature;;0 - 20,000;70;12;58;0;0;0
1426990;Anime - Space Sniper;;0 - 20,000;26;9;17;0;0;0
1427020;Sasel RPG;;0 - 20,000;37;6;31;0;0;0
1427030;Inukari - Chase of Deception;;0 - 20,000;19;3;16;0;0;0
1427100;Eat fish 3D;;0 - 20,000;3;1;2;0;0;0
1427120;Consequence;;0 - 20,000;5;1;4;0;0;0
1427130;Elusive World;;0 - 20,000;0;1;-1;0;0;1
1427140;Among School Girls;;0 - 20,000;19;13;6;0;0;0
1427150;The Episodic;;200,000 - 500,000;2;7;-5;0;0;0
1427210;From the Shadows;;20,000 - 50,000;194;35;159;0;0;0
1427290;Jiguland;;0 - 20,000;2;1;1;0;0;0
1427300;Detours;;0 - 20,000;6;0;6;0;0;0
1427320;Decamped;;0 - 20,000;5;4;1;0;0;0
1427340;Witchy Life Story;;0 - 20,000;279;40;239;475;475;13
1427400;Sky Journey - Jigsaw Landscapes;;0 - 20,000;21;3;18;0;0;0
1427420;Bloodland;;0 - 20,000;4;2;2;0;0;0
1427480;Miner Ultra Rag Smash;;0 - 20,000;27;6;21;0;0;0
1427510;Overdose WW2;;20,000 - 50,000;4;2;2;0;0;0
1427540;Attack from Planet Smiley;;20,000 - 50,000;1;0;1;0;0;0
1427620;Caapora Adventure - Ojibe's Revenge;;0 - 20,000;22;4;18;0;0;0
1427640;All-Time Battle;;50,000 - 100,000;8;19;-11;0;0;2
1427680;Magia X;;0 - 20,000;192;115;77;0;0;0
1427700;Realm Engine | Virtual Tabletop;;0 - 20,000;26;12;14;0;0;0
1427710;EmptyBottle;;0 - 20,000;16;1;15;0;0;0
1427760;RoboSquare;;0 - 20,000;166;37;129;0;0;1
1427770;Rhythm 'n Bullets;;0 - 20,000;1;0;1;0;0;0
1427800;Mutant Ops;;0 - 20,000;434;130;304;0;0;0
1427890;Blaston;;20,000 - 50,000;452;34;418;60;86;3
1427900;1001 Jigsaw World Tour Africa;;0 - 20,000;9;2;7;0;0;0
1427910;Gem Legends;;0 - 20,000;5;1;4;0;0;1
1427920;Griddlers TED and PET;;0 - 20,000;7;0;7;0;0;0
1427930;Fairytale Mosaics Cinderella;;0 - 20,000;6;0;6;0;0;0
1427940;Pirate Jigsaw;;0 - 20,000;2;1;1;0;0;1
1427950;Solitaire Halloween Story;;0 - 20,000;4;1;3;0;0;1
1427960;Jigsaw Boom;;0 - 20,000;3;1;2;0;0;0
1427970;Asian Riddles 3;;0 - 20,000;5;1;4;0;0;2
1427980;Strike Solitaire 3;;0 - 20,000;2;0;2;0;0;0
1427990;Jigsaw Tour;;0 - 20,000;1;2;-1;0;0;0
1428030;Prince Of Wallachia;;0 - 20,000;5;3;2;0;0;0
1428040;Gizmos: Spirit Of The Christmas;;0 - 20,000;7;0;7;0;0;1
1428100;Instruments of Destruction;;20,000 - 50,000;677;29;648;0;0;44
1428130;DARK MAGIC;;0 - 20,000;5;6;-1;0;0;0
1428140;Riding Seas;;0 - 20,000;30;0;30;0;0;4
1428160;Nosferatu's Butler;;0 - 20,000;1;1;0;0;0;0
1428270;Good puzzle: Animals;;0 - 20,000;8;0;8;0;0;0
1428290;Anime - Match The Memory;;0 - 20,000;1;0;1;0;0;0
1428310;The Test: Final Revelation;;100,000 - 200,000;4739;85;4654;345;345;2
1428320;Achievement Killer;;0 - 20,000;11;21;-10;0;0;0
1428360;Too Much Water;;0 - 20,000;3;0;3;0;0;0
1428370;times infinity;;0 - 20,000;44;1;43;0;0;0
1428420;Nucleares;;0 - 20,000;13;2;11;0;0;0
1428460;BISQUE DOLL;;0 - 20,000;41;7;34;0;0;0
1428470;Stowaway;;0 - 20,000;431;132;299;20;24;0
1428520;Mech Engineer;;0 - 20,000;78;34;44;0;0;6
1428570;Godland : The Fire Quest;;50,000 - 100,000;1;0;1;0;0;0
1428580;Quiet Valley;;0 - 20,000;7;2;5;0;0;0
1428610;Animal Rescuer: Prologue;;0 - 20,000;80;35;45;0;0;0
1428630;Diamond hunt;;20,000 - 50,000;2;0;2;0;0;0
1428680;Abiko The Miko 2;;0 - 20,000;1;1;0;0;0;0
1428710;The Tarnishing of Juxtia;;0 - 20,000;247;110;137;453;453;1
1428770;Kingdom Gun;;0 - 20,000;48;30;18;0;0;0
1428780;Animal Rescuer;;0 - 20,000;44;15;29;0;0;0
1428790;MADHACK;;0 - 20,000;1;0;1;0;0;0
1428820;Wordle 3;;20,000 - 50,000;156;38;118;131;131;30
1428840;10mg: SNAAAK;;0 - 20,000;16;0;16;0;0;0
1428900;Tadpole Tales;;100,000 - 200,000;703;71;632;0;0;1
1428970;Where the Snow Settles;;0 - 20,000;15;1;14;0;0;0
1428980;The Count of Monte Carlo;;0 - 20,000;9;0;9;0;0;0
1429040;Kaputte Kranz Chap1;;0 - 20,000;8;3;5;0;0;0
1429100;Siren Head: The Siren's Forest;;50,000 - 100,000;202;192;10;0;0;1
1429130;Disquiet Fields;;0 - 20,000;11;0;11;0;0;0
1429160;Prairie survival;;0 - 20,000;1;8;-7;0;0;0
1429210;Gelldonia;;0 - 20,000;7;5;2;0;0;0
1429300;The Fishery;;0 - 20,000;4;3;1;0;0;0
1429350;MH-Zombie;;0 - 20,000;48;6;42;0;0;0
1429400;Mousebound;;0 - 20,000;5;2;3;0;0;0
1429500;Frontier Hunter: Erza’s Wheel of Fortune;;0 - 20,000;440;58;382;0;0;36
1429510;The Birthday;;0 - 20,000;1;0;1;0;0;0
1429530;Azlan: Rise of the Burlpups;;0 - 20,000;5;4;1;0;0;0
1429610;~府城少女~ 以妳為名的府城情書;;0 - 20,000;25;5;20;0;0;0
1429630;The King of Warriors : Battle in the Three Kingdoms;;0 - 20,000;2;1;1;0;0;0
1429640;HINGE VR;;0 - 20,000;137;51;86;0;0;0
1429670;Dungeon Lord;;20,000 - 50,000;78;67;11;0;0;1
1429680;Space Plane;;0 - 20,000;1;0;1;0;0;0
1429700;ARCADEON VR;;50,000 - 100,000;2;0;2;0;0;0
1429730;Project Mirror;;0 - 20,000;1;0;1;0;0;0
1429740;Raji: Prologue;;100,000 - 200,000;487;62;425;35;45;1
1429800;Chandrayaan VR;;0 - 20,000;1;0;1;0;0;0
1429820;Neko Nyaa~;;0 - 20,000;6;0;6;0;0;0
1429870;Vectro Blast;;0 - 20,000;7;0;7;0;0;0
1429890;Singularity;;0 - 20,000;4;5;-1;0;0;0
1429950;Apotheker;;0 - 20,000;38;1;37;0;0;0
1430010;迷途;;0 - 20,000;19;9;10;0;0;0
1430030;THE MONSTER OF MEMORY:DESTINY;;0 - 20,000;140;16;124;0;0;2
1430040;Jump Again!;;0 - 20,000;1;2;-1;0;0;0
1430070;Too Different;;20,000 - 50,000;1;2;-1;0;0;0
1430120;Moving Letters;;0 - 20,000;20;6;14;0;0;1
1430140;Space Empires II;;100,000 - 200,000;4;4;0;0;0;0
1430180;Musical Balls;;0 - 20,000;1;1;0;0;0;0
1430200;Space Empires III;;20,000 - 50,000;20;4;16;0;0;4
1430240;The Space in Between;;20,000 - 50,000;93;23;70;0;0;0
1430310;NetGunner;;0 - 20,000;9;4;5;0;0;0
1430340;Vocal Space Shooter;;0 - 20,000;2;0;2;0;0;0
1430420;CBT With Yuuka Kazami;;20,000 - 50,000;800;21;779;0;0;5
1430640;Into The Haze;;0 - 20,000;73;52;21;0;0;0
1430690;Stay Safe 2020;;0 - 20,000;7;0;7;0;0;0
1430720;Clash of Warlords;;0 - 20,000;7;8;-1;0;0;0
1430740;Mine Crazy: The Korean Grinder;;0 - 20,000;10;3;7;0;0;0
1430750;Blacksmith Legends;;0 - 20,000;68;58;10;0;0;2
1430760;Aquarist;;0 - 20,000;333;57;276;480;556;14
1430810;World of Wonder;;0 - 20,000;2;5;-3;0;0;0
1430820;Monstermonger;;0 - 20,000;5;0;5;0;0;0
1430970;Astatos;;0 - 20,000;151;35;116;0;0;3
1430980;Space Love Delta;;0 - 20,000;5;13;-8;0;0;0
1431020;Blurple Food Wars;;0 - 20,000;9;0;9;0;0;0
1431040;Golazo! Soccer League;;0 - 20,000;149;36;113;27;27;1
1431100;RollerBaller;;0 - 20,000;29;5;24;0;0;0
1431150;LongPath;;0 - 20,000;11;2;9;0;0;0
1431170;Pepo;;0 - 20,000;3;4;-1;0;0;0
1431180;DON'T WAKE THE NIGHT;;0 - 20,000;1;1;0;0;0;0
1431190;Bunny's Trail;;0 - 20,000;19;0;19;0;0;0
1431210;MahJong - Medieval Fantasy;;0 - 20,000;3;3;0;0;0;0
1431220;10mg: SLASHER, Interrupted;;0 - 20,000;21;1;20;0;0;0
1431230;Gods of Sand;;20,000 - 50,000;410;25;385;0;0;8
1431240;Coloring Book for Adults;;20,000 - 50,000;193;43;150;0;0;0
1431270;Arcana Sands of Destiny;;0 - 20,000;12;5;7;0;0;0
1431290;Sam & Max: This Time It's Virtual!;;0 - 20,000;31;51;-20;0;0;1
1431340;SOL Cycling;;0 - 20,000;2;2;0;0;0;0
1431350;Santa Claus in Trouble (HD);;0 - 20,000;130;6;124;38;38;1
1431370;ThrustWorks;;0 - 20,000;0;1;-1;0;0;0
1431380;Mage World - The Wizard's Stone;;0 - 20,000;5;3;2;0;0;0
1431380;Mage World - The Wizard's Stone;;0 - 20,000;5;3;2;0;0;0
1431420;10mg: Cover Me In Leaves;;0 - 20,000;28;2;26;0;0;0
1431430;Tiny Island;;0 - 20,000;23;2;21;0;0;0
1431450;Do I smell Pizza?;;0 - 20,000;15;1;14;0;0;0
1431470;Mythos Ever After: A Cthulhu Dating Sim;;20,000 - 50,000;1;0;1;0;0;0
1431550;Secure the Skies;;0 - 20,000;4;0;4;0;0;0
1431610;Prison Simulator: Prologue;;200,000 - 500,000;2511;290;2221;54;53;22
1431620;Cybercube battle;;0 - 20,000;2;5;-3;0;0;0
1431630;Gallic Wars: Battle Simulator Prologue;;0 - 20,000;10;6;4;0;0;0
1431690;Mr. Hibbl;;0 - 20,000;4;0;4;0;0;0
1431720;Evergate: Ki's Awakening;;0 - 20,000;21;8;13;0;0;0
1431730;TRY TO WIN 2;;0 - 20,000;4;2;2;0;0;0
1431770;JungleKnight;;0 - 20,000;6;7;-1;0;0;0
1431780;The Black Heart;;0 - 20,000;228;7;221;190;190;0
1431790;剑与羁绊;;0 - 20,000;4;3;1;0;0;0
1431840;Murder by Moonlight - Call of the Wolf;;0 - 20,000;12;2;10;0;0;0
1431890;Starfighter Renegade;;0 - 20,000;2;1;1;0;0;0
1431950;Decks & Daggers;;0 - 20,000;44;13;31;0;0;0
1432000;Timeline Traveler II: Dream;;0 - 20,000;1;0;1;0;0;0
1432020;Jay Schilling's Edge of Chaos;;0 - 20,000;3;0;3;0;0;0
1432050;Nobody Saves the World;;200,000 - 500,000;3626;343;3283;448;424;126
1432110;Puzzle Bowling;;0 - 20,000;1;2;-1;0;0;0
1432200;Not Another Weekend;;0 - 20,000;72;1;71;0;0;0
1432220;G.I. Joe: Operation Blackout;;20,000 - 50,000;48;36;12;0;0;0
1432290;Spot The Dot;;0 - 20,000;2;0;2;0;0;0
1432310;Look and Find - Curiosity;;0 - 20,000;4;1;3;0;0;0
1432320;Liftoff: Micro Drones;;0 - 20,000;145;23;122;0;0;17
1432390;Sonority;;0 - 20,000;83;8;75;0;0;0
1432400;Ozone Guardian;;0 - 20,000;5;2;3;0;0;0
1432400;Ozone Guardian;;0 - 20,000;5;2;3;0;0;0
1432480;Luminous Plume;;0 - 20,000;11;0;11;0;0;0
1432500;The Sekimeiya: Spun Glass;;0 - 20,000;133;9;124;0;0;6
1432610;Royale Archer VR;;0 - 20,000;6;4;2;0;0;0
1432620;Aimi;;20,000 - 50,000;77;16;61;0;0;0
1432630;Space Defense;;0 - 20,000;0;1;-1;0;0;0
1432670;Pretty Girls Mahjong Solitaire [GREEN];;0 - 20,000;19;5;14;0;0;1
1432680;Mechanic 8230: Escape from Ilgrot;;0 - 20,000;51;7;44;0;0;0
1432710;新魔剑（New Magic Sword）;;20,000 - 50,000;26;36;-10;0;0;0
1432730;911 Emergency Manager;;20,000 - 50,000;2;1;1;0;0;0
1432750;Chionophile;;0 - 20,000;135;14;121;0;0;1
1432760;A Comfortable Burden;;0 - 20,000;23;3;20;0;0;0
1432810;Poster Sticker;;0 - 20,000;1;0;1;0;0;0
1432840;Resthedex;;0 - 20,000;3;2;1;0;0;0
1432860;Sun Haven;;200,000 - 500,000;3246;325;2921;1059;1165;505
1432880;4Line;;0 - 20,000;3;1;2;0;0;0
1432910;Godlike Burger;;20,000 - 50,000;344;109;235;69;69;3
1432930;Cybernetica: fallen city;;0 - 20,000;0;10;-10;0;0;0
1432960;Eight;;20,000 - 50,000;30;21;9;0;0;0
1432970;ASSAULT SHELL;;0 - 20,000;15;0;15;0;0;0
1432970;ASSAULT SHELL;;0 - 20,000;15;0;15;0;0;0
1432980;MOAI 6: Unexpected Guests Collector's Edition;;0 - 20,000;9;2;7;0;0;0
1433010;Tennis Manager 2021;;0 - 20,000;165;51;114;2996;2996;16
1433030;MOAI 7: Mystery Coast;;0 - 20,000;15;1;14;0;0;1
1433030;MOAI 7: Mystery Coast;;0 - 20,000;15;1;14;0;0;1
1433040;Dragon Fury VR;;20,000 - 50,000;1;2;-1;0;0;0
1433070;Into the Pyramid;;0 - 20,000;3;3;0;0;0;0
1433090;The Schizophrenic Dynasty of Müller;;0 - 20,000;18;3;15;0;0;0
1433100;Alchemist Adventure Prologue;;0 - 20,000;27;11;16;0;0;0
1433110;Disturbed R.I.P.;;0 - 20,000;3;0;3;0;0;0
1433190;Welcome to Emba;;20,000 - 50,000;30;6;24;0;0;0
1433210;Notebook Artillery;;0 - 20,000;10;0;10;0;0;0
1433240;Whiskey Island;;0 - 20,000;1;1;0;0;0;0
1433320;Mortal Decay;;0 - 20,000;61;2;59;0;0;0
1433320;Mortal Decay;;0 - 20,000;61;2;59;0;0;0
1433330;Happy's Humble Burger Farm Alpha;;0 - 20,000;524;53;471;250;250;0
1433340;Happy's Humble Burger Farm;;0 - 20,000;992;74;918;305;331;9
1433390;To My Best Friend;;0 - 20,000;4;0;4;0;0;0
1433410;Tetracosm;;0 - 20,000;9;1;8;0;0;1
1433420;Hero by Chance;;100,000 - 200,000;826;212;614;90;128;9
1433430;Level 20;;0 - 20,000;14;0;14;0;0;0
1433440;Requiescat;;20,000 - 50,000;10;4;6;0;0;0
1433460;决奕Duel;;0 - 20,000;3;2;1;0;0;0
1433470;Outpost Engineer;;0 - 20,000;5;5;0;0;0;0
1433480;Poop On 2020 Simulator;;0 - 20,000;41;2;39;0;0;0
1433490;Pristiq: Tash's Trilogy;;0 - 20,000;5;0;5;0;0;0
1433500;Hotel Transylvania: Scary-Tale Adventures;;0 - 20,000;6;0;6;0;0;1
1433540;Death Circus;;0 - 20,000;12;11;1;0;0;0
1433550;Space Gladiators: The Hole;;20,000 - 50,000;69;6;63;0;0;5
1433570;Car Detailing Simulator;;0 - 20,000;433;113;320;388;388;8
1433830;Peg Adventure - Solo Noble;;0 - 20,000;10;0;10;0;0;0
1433860;The Amazing American Circus;;100,000 - 200,000;162;123;39;352;352;4
1433870;Bricky to Me;;0 - 20,000;13;0;13;0;0;1
1433890;Lawnmower Game: Racing;;0 - 20,000;75;22;53;0;0;0
1433900;Narrow Escape;;0 - 20,000;13;9;4;0;0;1
1433910;Dragu's Puzzle Adventure;;20,000 - 50,000;1;0;1;0;0;0
1433930;Strong towers;;0 - 20,000;11;4;7;0;0;0
1433930;Strong towers;;0 - 20,000;11;4;7;0;0;0
1433940;Adventure of Bears;;0 - 20,000;26;8;18;0;0;0
1433950;Duck Life: Retro Pack;;0 - 20,000;126;17;109;0;0;0
1433960;Fast Food Simulator;;0 - 20,000;2;2;0;0;0;0
1433970;Cake Shop Simulator;;0 - 20,000;5;13;-8;0;0;0
1433970;Cake Shop Simulator;;0 - 20,000;5;13;-8;0;0;0
1433980;Farm & Puzzle;;0 - 20,000;5;4;1;0;0;0
1433990;NGU INDUSTRIES;;200,000 - 500,000;1190;291;899;14733;22070;91
1434000;BO020880;;20,000 - 50,000;11;0;11;0;0;0
1434040;Slide Stars;;0 - 20,000;3;0;3;0;0;0
1434160;My Empire;;50,000 - 100,000;0;1;-1;0;0;0
1434220;Sunshine Manor Prologue;;0 - 20,000;3;1;2;0;0;0
1434260;Painting Werther;;0 - 20,000;14;0;14;0;0;2
1434270;ANTE;;0 - 20,000;0;1;-1;0;0;0
1434300;Block Wizard;;0 - 20,000;4;0;4;0;0;0
1434310;PAW Patrol The Movie: Adventure City Calls;;0 - 20,000;26;28;-2;0;0;19
1434320;Fast & Furious: Spy Racers Rise of SH1FT3R;;0 - 20,000;11;11;0;0;0;1
1434330;Blaze and the Monster Machines: Axle City Racers;;0 - 20,000;10;2;8;0;0;0
1434340;Insect Adventure Demo;;0 - 20,000;4;1;3;0;0;0
1434350;Celestial Hearts;;0 - 20,000;27;3;24;0;0;0
1434440;The Missing Link;;0 - 20,000;2;0;2;0;0;0
1434470;RagDoll MadDoll;;50,000 - 100,000;0;1;-1;0;0;0
1434480;Maitetsu:Last Run!!;;50,000 - 100,000;2725;34;2691;273;305;76
1434490;Farm Day 2021;;0 - 20,000;28;16;12;0;0;0
1434500;MiniFarm 2020;;0 - 20,000;0;24;-24;0;0;0
1434510;Park The Car;;0 - 20,000;3;6;-3;0;0;1
1434550;Zeltrus;;0 - 20,000;1;0;1;0;0;0
1434610;Darkzone: Idle RPG;;50,000 - 100,000;82;49;33;0;0;0
1434620;Emberlight;;0 - 20,000;4;2;2;0;0;0
1434720;Mystical Lights;;0 - 20,000;15;12;3;0;0;0
1434750;TRIPILL;;0 - 20,000;1;0;1;0;0;0
1434760;Heroine for Hire;;0 - 20,000;11;1;10;0;0;0
1434780;Tech Madness;;20,000 - 50,000;1;4;-3;0;0;0
1434850;Lumpy;;0 - 20,000;8;0;8;0;0;0
1434870;1 For Yes, 0 For No;;0 - 20,000;12;1;11;0;0;0
1434880;ROBO OH;;0 - 20,000;42;0;42;0;0;0
1434890;Portable Farm;;0 - 20,000;28;1;27;0;0;1
1434910;Last Visit;;0 - 20,000;19;2;17;0;0;0
1434940;GravKitten;;0 - 20,000;15;0;15;0;0;0
1434950;HighFleet;;200,000 - 500,000;4308;567;3741;432;544;84
1434970;Social Distancing;;0 - 20,000;8;0;8;0;0;0
1435010;Succubus★Connect!;;0 - 20,000;269;87;182;5;9;1
1435020;PhotoWorld;;0 - 20,000;13;5;8;0;0;0
1435090;Bloody Rally Show: Prologue;;0 - 20,000;60;4;56;0;0;1
1435090;Bloody Rally Show: Prologue;;0 - 20,000;60;4;56;0;0;1
1435160;NYANCO MINE;;0 - 20,000;22;0;22;0;0;0
1435210;Highlaundry;;0 - 20,000;4;2;2;0;0;0
1435310;Shotgun Witch;;20,000 - 50,000;818;23;795;0;0;0
1435330;Costume Kingdom;;0 - 20,000;2;1;1;0;0;0
1435420;Godslayer|one;;0 - 20,000;4;1;3;0;0;0
1435440;Dark Dragonkin;;20,000 - 50,000;2;2;0;0;0;0
1435470;Space Bandit;;0 - 20,000;60;2;58;0;0;0
1435480;10mg: Sealed Estate;;0 - 20,000;12;3;9;0;0;0
1435540;Yachu Dice;;0 - 20,000;3;0;3;0;0;0
1435590;Candy Bear 2;;0 - 20,000;2;0;2;0;0;0
1435610;Master of Miracles;;0 - 20,000;5;5;0;0;0;0
1435630;Project : SKYSCAPE;;20,000 - 50,000;11;13;-2;0;0;0
1435660;Orbital Invaders;;20,000 - 50,000;8;1;7;0;0;0
1435670;Song of Farca;;20,000 - 50,000;626;117;509;543;543;5
1435680;Poultry Parade;;0 - 20,000;4;0;4;0;0;0
1435700;Roald Amundsen's House;;0 - 20,000;27;2;25;0;0;0
1435780;Farm Frenzy: Refreshed;;0 - 20,000;88;11;77;0;0;5
1435790;Escape Simulator;;500,000 - 1,000,000;9642;651;8991;416;294;685
1435840;DIG THE GROUND;;20,000 - 50,000;5;9;-4;0;0;0
1435960;Potato Party: Hash It Out;;0 - 20,000;17;1;16;0;0;0
1435970;Anomalous;;0 - 20,000;64;9;55;0;0;0
1435980;Sloth Tales;;0 - 20,000;5;1;4;0;0;0
1436040;Guns Boy;;0 - 20,000;13;15;-2;0;0;0
1436190;Wark & Wimble;;0 - 20,000;6;0;6;0;0;0
1436190;Wark & Wimble;;0 - 20,000;6;0;6;0;0;0
1436220;XIBALBA;;20,000 - 50,000;5;5;0;0;0;0
1436240;Krakatoa;;50,000 - 100,000;20;19;1;0;0;0
1436280;Plan Z;;20,000 - 50,000;3;1;2;0;0;0
1436390;TEXT: Russia;;0 - 20,000;7;2;5;0;0;0
1436410;ReThink 4;;0 - 20,000;15;0;15;0;0;0
1436440;Sleeper Cell;;100,000 - 200,000;2;4;-2;0;0;0
1436490;Stacker Puzzle;;0 - 20,000;12;0;12;0;0;0
1436570;The Enthralling Realms: The Blacksmith's Revenge;;0 - 20,000;7;2;5;0;0;0
1436590;Phoenotopia: Awakening;;200,000 - 500,000;1379;210;1169;411;411;24
1436600;Holiday Time;;0 - 20,000;120;38;82;0;0;0
1436650;Battle Star;;20,000 - 50,000;131;39;92;0;0;8
1436680;Gachi run: Running of the slaves;;0 - 20,000;226;11;215;0;0;0
1436800;Elon's Dream;;20,000 - 50,000;5;2;3;0;0;0
1436810;The Door in the Basement;;0 - 20,000;105;11;94;0;0;0
1436830;CatMafia;;0 - 20,000;18;5;13;0;0;0
1436870;The Tool;;0 - 20,000;6;1;5;0;0;0
1436910;Troy: The Malware Fight;;0 - 20,000;1;0;1;0;0;0
1436920;Tandem: A Tale of Shadows;;0 - 20,000;159;13;146;0;0;1
1436930;Temple of Apshai Trilogy;;500,000 - 1,000,000;4;2;2;0;0;0
1436980;最后的夜晚 Babel;;0 - 20,000;25;15;10;0;0;0
1436990;Feign;;200,000 - 500,000;2124;253;1871;192;258;122
1437010;The Last Spell: Prologue;;100,000 - 200,000;248;9;239;52;52;0
1437020;Monster Seek Ep.1;;20,000 - 50,000;2;2;0;0;0;0
1437030;Silent Mansion : Part2;;0 - 20,000;22;8;14;0;0;0
1437040;Starshot: Space Circus Fever;;0 - 20,000;6;4;2;0;0;0
1437050;EBOLA 2;;0 - 20,000;154;61;93;0;0;1
1437050;EBOLA 2;;0 - 20,000;154;61;93;0;0;1
1437100;Blue fencer Resurrection;;0 - 20,000;2;0;2;0;0;0
1437120;Gizmos: Interstellar Voyage;;20,000 - 50,000;11;0;11;0;0;2
1437160;Awesome Mix Tape;;0 - 20,000;2;0;2;0;0;0
1437170;Stranded 2;;0 - 20,000;2;1;1;0;0;0
1437210;Bring Back The Sun by Daniel da Silva;;20,000 - 50,000;3;3;0;0;0;0
1437270;Pleiades - A Subversion Saga Game;;50,000 - 100,000;8;1;7;0;0;0
1437280;Project Terminus VR;;0 - 20,000;27;10;17;0;0;0
1437370;The Ultimate Game;;0 - 20,000;6;0;6;0;0;0
1437410;CrossKrush;;0 - 20,000;9;0;9;0;0;0
1437420;Two Parsecs From Earth;;0 - 20,000;25;2;23;0;0;0
1437430;Mixx Island;;0 - 20,000;9;1;8;0;0;0
1437480;Cultus;;0 - 20,000;3;0;3;0;0;0
1437500;Dread X Collection 3;;;;;0;;;
1437520;Marcella Moon: Saboteurs on the River;;0 - 20,000;6;0;6;0;0;0
1437550;The Debug;;20,000 - 50,000;49;14;35;0;0;0
1437580;Solicitude Wake-up;;0 - 20,000;2;4;-2;0;0;0
1437600;Biscuitts 3;;0 - 20,000;2;0;2;0;0;0
1437680;Ambient Channels;;0 - 20,000;4;6;-2;0;0;0
1437710;Cave Explorers;;0 - 20,000;2;1;1;0;0;0
1437750;Stellar Monarch 2;;0 - 20,000;46;5;41;0;0;3
1437770;RevolVR 3;;20,000 - 50,000;113;41;72;0;0;0
1437820;Heroes of the Three Kingdoms;;200,000 - 500,000;955;75;880;436;679;129
1437830;Heroes of the Three Kingdoms 2;;200,000 - 500,000;1182;58;1124;197;244;571
1437840;Heroes of the Three Kingdoms 3;;100,000 - 200,000;473;66;407;1822;3177;107
1437850;Heroes of the Three Kingdoms 4;;20,000 - 50,000;117;33;84;18;32;21
1437860;Heroes of the Three Kingdoms 5;;20,000 - 50,000;133;16;117;1199;1855;99
1437880;Heroes of the Three Kingdoms 7;;200,000 - 500,000;1830;390;1440;1273;1048;730
1437890;Mexican Train Dominoes Gold;;0 - 20,000;4;1;3;0;0;3
1438090;Hobo Cat Adventures;;0 - 20,000;57;3;54;0;0;0
1438100;Qbio;;0 - 20,000;24;10;14;0;0;0
1438110;Angel Tears;;0 - 20,000;10;6;4;0;0;0
1438190;SHUT IN;;0 - 20,000;71;8;63;0;0;0
1438260;GOLF MONSTER;;0 - 20,000;24;6;18;0;0;0
1438270;Rogue Wars;;0 - 20,000;8;2;6;0;0;0
1438280;Super Match! The Ultimate Matching Game;;0 - 20,000;1;3;-2;0;0;0
1438430;Ralf's Adventure: Aztec Mystery;;0 - 20,000;1;1;0;0;0;0
1438440;Aurora: A Child's Journey;;50,000 - 100,000;782;59;723;0;0;0
1438680;Techno Tower Defense;;0 - 20,000;4;0;4;0;0;0
1438700;Silicon Valley Investor;;20,000 - 50,000;13;1;12;0;0;0
1438710;Modern Arena;;50,000 - 100,000;1;1;0;0;0;0
1438750;Halloween Decoration Sandbox;;0 - 20,000;0;1;-1;0;0;0
1438760;Recruit One;;0 - 20,000;24;2;22;0;0;0
1438830;Dark Asteroids;;0 - 20,000;2;0;2;0;0;0
1438940;Game Localization;;0 - 20,000;4;16;-12;0;0;0
1438950;Half Blood RPG;;0 - 20,000;3;0;3;0;0;0
1439010;Phantom Typist;;0 - 20,000;3;0;3;0;0;0
1439030;Brain off;;0 - 20,000;16;7;9;0;0;0
1439040;Squingle;;0 - 20,000;17;0;17;0;0;0
1439070;Stranded B;;0 - 20,000;9;6;3;0;0;0
1439100;Space Force Squadron;;0 - 20,000;3;0;3;0;0;0
1439130;ABH;;0 - 20,000;1;8;-7;0;0;0
1439170;Smart Thief;;0 - 20,000;31;9;22;0;0;0
1439180;Elite Commander;;0 - 20,000;16;16;0;0;0;0
1439180;Elite Commander;;0 - 20,000;16;16;0;0;0;0
1439190;Archeologist Simulator;;0 - 20,000;0;11;-11;0;0;0
1439220;Conquest: Medieval Kingdoms;;0 - 20,000;7;5;2;0;0;2
1439300;NASCAR 21: Ignition;;20,000 - 50,000;163;533;-370;0;0;15
1439310;If Fusion Were That Easy;;0 - 20,000;6;0;6;0;0;0
1439320;OverTime;;0 - 20,000;11;0;11;0;0;0
1439340;Kittens of Fear;;0 - 20,000;1;2;-1;0;0;0
1439400;Bananarun;;0 - 20,000;8;0;8;0;0;0
1439420;Ayoub Episode 0;;0 - 20,000;7;0;7;0;0;0
1439440;Gravels of Endless War;;0 - 20,000;2;1;1;0;0;0
1439440;Gravels of Endless War;;0 - 20,000;2;1;1;0;0;0
1439460;Hellcraze;;0 - 20,000;13;0;13;0;0;0
1439550;Vagrant Sword;;100,000 - 200,000;3;1;2;0;0;0
1439630;Mad Devils;;0 - 20,000;3;5;-2;0;0;0
1439700;Alchemy Absorption: Melody;;0 - 20,000;7;1;6;0;0;0
1439710;Theo's World;;0 - 20,000;5;3;2;0;0;0
1439790;Keep Wall;;0 - 20,000;1;0;1;0;0;0
1439800;ASMR Journey - Animated Jigsaw Puzzle;;0 - 20,000;29;3;26;0;0;0
1439930;BROTHER WAKE UP;;20,000 - 50,000;7;4;3;0;0;0
1439970;Broken Sky;;100,000 - 200,000;9;1;8;0;0;1
1440010;Die After Sunset;;20,000 - 50,000;55;20;35;0;0;1
1440020;Artifact Hunter;;0 - 20,000;10;3;7;0;0;0
1440020;Artifact Hunter;;0 - 20,000;10;3;7;0;0;0
1440050;Объемная История;;50,000 - 100,000;8;6;2;0;0;0
1440090;Viewergames Arcade;;0 - 20,000;25;1;24;0;0;4
1440130;Escape2088;;20,000 - 50,000;20;17;3;0;0;0
1440220;Train Ride Simulator;;0 - 20,000;0;2;-2;0;0;0
1440240;SOUND FORGE Audio Studio 15 Steam Edition;;0 - 20,000;2;5;-3;0;0;1
1440280;Killer Inside Us;;0 - 20,000;35;4;31;0;0;0
1440290;Psycho;;0 - 20,000;44;37;7;0;0;0
1440330;In It Together;;20,000 - 50,000;4;0;4;0;0;0
1440350;Staff Only;;0 - 20,000;19;1;18;0;0;0
1440360;Tanks in Labyrinth;;0 - 20,000;11;0;11;0;0;0
1440370;Before Dark;;0 - 20,000;2;0;2;0;0;0
1440440;Sam & Max Save the World;;200,000 - 500,000;1129;103;1026;478;516;9
1440450;Metagroove;;0 - 20,000;31;9;22;0;0;0
1440470;Synthetic Hazard;;0 - 20,000;17;13;4;0;0;0
1440470;Synthetic Hazard;;0 - 20,000;17;13;4;0;0;0
1440500;東方剛欲異聞　～ 水没した沈愁地獄;;50,000 - 100,000;561;121;440;209;209;4
1440510;Tombo Survivor;;0 - 20,000;47;3;44;0;0;0
1440530;Good puzzle;;0 - 20,000;13;2;11;0;0;0
1440670;Zeepkist;;50,000 - 100,000;822;20;802;276;276;85
1440680;SIDE;;0 - 20,000;0;2;-2;0;0;0
1440750;Splash;;20,000 - 50,000;5;3;2;0;0;0
1440780;Nerm the Worm;;0 - 20,000;9;2;7;0;0;0
1440790;Fled fierce city;;0 - 20,000;2;0;2;0;0;0
1440810;Enthrean Radiance : Prologue;;20,000 - 50,000;6;3;3;0;0;0
1440840;Breathing Fear;;20,000 - 50,000;9;0;9;0;0;0
1440850;LP;;0 - 20,000;20;4;16;0;0;0
1440870;Corrupted Hospital : Part1;;50,000 - 100,000;44;26;18;0;0;0
1440890;Fear Protocol: Codename Omega Starring Agent Jack Banger;;20,000 - 50,000;26;12;14;0;0;0
1440910;Gogte;;0 - 20,000;2;2;0;0;0;0
1440940;Spooky Speakeasy;;0 - 20,000;42;5;37;0;0;1
1441010;The Pacifist's Great and Final Nightmare;;0 - 20,000;0;1;-1;0;0;0
1441090;Metal Strike;;0 - 20,000;4;9;-5;0;0;0
1441180;Dofamine;;0 - 20,000;82;19;63;0;0;0
1441210;Beat the Nightmare – Evil Dreams Simulator VR;;0 - 20,000;1;3;-2;0;0;0
1441230;Tanto Cuore;;0 - 20,000;151;12;139;0;0;2
1441300;Huuma Mina: The Secret of Immortality (Censored);;0 - 20,000;15;3;12;0;0;0
1441340;Sunflower Code;;0 - 20,000;2;3;-1;0;0;0
1441400;Mason: Building Bricks;;0 - 20,000;22;3;19;0;0;0
1441430;Wordeous;;0 - 20,000;20;1;19;0;0;2
1441480;Adventures of Megara: Antigone and the Living Toys;;0 - 20,000;2;1;1;0;0;1
1441500;Traceur's Dreamlab VR;;0 - 20,000;7;1;6;0;0;0
1441500;Traceur's Dreamlab VR;;0 - 20,000;7;1;6;0;0;0
1441530;PrePaladin Wars;;0 - 20,000;1;0;1;0;0;0
1441550;Regular Human Workshop;;0 - 20,000;282;34;248;0;0;51
1441570;Cubiscape 2;;50,000 - 100,000;100;12;88;0;0;1
1441630;Мистер Вселенная;;0 - 20,000;2;0;2;0;0;0
1441670;SJ-19 Learns To Love!;;0 - 20,000;0;0;0;0;0;0
1441680;Tree Trunk Brook;;0 - 20,000;72;13;59;0;0;0
1441690;ZendoVR;;0 - 20,000;1;1;0;0;0;0
1441740;Frick Frack;;0 - 20,000;19;28;-9;0;0;0
1441760;My Business;;20,000 - 50,000;6;1;5;0;0;0
1441790;Miner: Dig Deep;;0 - 20,000;162;17;145;0;0;1
1441830;The Wizard Game;;0 - 20,000;3;0;3;0;0;0
1441840;FALL IN LABYRINTH;;50,000 - 100,000;659;38;621;0;0;7
1441850;The strangest game in the world;;0 - 20,000;2;3;-1;0;0;0
1442040;我反对这门亲事-I'm against this marriage;;0 - 20,000;42;5;37;0;0;0
1442070;Claire's Cruisin' Cafe;;0 - 20,000;26;4;22;0;0;2
1442080;CONET｜コネット;;0 - 20,000;3;0;3;0;0;0
1442150;Raidfield 2;;20,000 - 50,000;34;42;-8;0;0;0
1442160;ABYSS OF THE SACRIFICE;;0 - 20,000;175;22;153;2444;2444;1
1442170;KILLRUN;;50,000 - 100,000;104;45;59;26;26;2
1442190;Rise of Zombies;;0 - 20,000;2;1;1;0;0;0
1442240;Save the Pirate: Sea Story;;0 - 20,000;42;9;33;0;0;0
1442300;Rags to Dishes;;0 - 20,000;119;4;115;2;2;0
1442350;Space Runner - Anime;;0 - 20,000;8;6;2;0;0;0
1442380;Book of Shadows;;0 - 20,000;30;13;17;0;0;0
1442390;Grey Scout;;0 - 20,000;17;2;15;0;0;0
1442390;Grey Scout;;0 - 20,000;17;2;15;0;0;0
1442410;Pingers;;20,000 - 50,000;15;0;15;0;0;0
1442480;Prank Call;;0 - 20,000;17;10;7;0;0;0
1442590;Letter Vetter;;0 - 20,000;11;5;6;0;0;0
1442650;White Day VR: The Courage Test;;0 - 20,000;45;16;29;0;0;0
1442750;Invasion Vill;;0 - 20,000;9;0;9;0;0;0
1442770;Friend Fighters;;0 - 20,000;3;0;3;0;0;0
1442820;R-Type Final 2;;50,000 - 100,000;506;155;351;0;0;5
1442840;The Mole Men;;0 - 20,000;30;1;29;0;0;1
1443100;RogueSlide;;0 - 20,000;26;2;24;0;0;0
1443160;StrateZ;;0 - 20,000;6;0;6;0;0;0
1443170;Rhythm Stars Climbing;;0 - 20,000;4;4;0;0;0;0
1443190;Knights of Grumthorr;;0 - 20,000;0;2;-2;0;0;0
1443200;Class of '09;;0 - 20,000;130;17;113;0;0;1
1443250;Training Grounds;;0 - 20,000;2;0;2;0;0;0
1443260;Endless;;0 - 20,000;8;3;5;0;0;0
1443300;Martha;;50,000 - 100,000;24;8;16;0;0;0
1443310;Mr. Walker's Basement;;0 - 20,000;5;0;5;0;0;0
1443330;Speedy Golf;;0 - 20,000;18;1;17;0;0;0
1443360;Arcante;;0 - 20,000;10;5;5;0;0;0
1443370;The Skylia Prophecy;;0 - 20,000;4;6;-2;0;0;0
1443400;Coronarun;;0 - 20,000;2;0;2;0;0;0
1443430;Rogue;;100,000 - 200,000;315;13;302;18;32;1
1443450;NEO: Commanders;;0 - 20,000;2;7;-5;0;0;0
1443490;Siren Head: Awakening;;50,000 - 100,000;512;186;326;0;0;2
1443500;Frog's Princess;;50,000 - 100,000;2;0;2;0;0;0
1443600;Amazething;;0 - 20,000;3;0;3;0;0;0
1443630;Turbo Sloths;;50,000 - 100,000;34;0;34;0;0;0
1443640;Horace Goes Skiing Revisited;;0 - 20,000;3;1;2;0;0;0
1443650;Dubbing Time;;0 - 20,000;1;0;1;0;0;0
1443680;Coloree;;0 - 20,000;17;0;17;0;0;0
1443690;WirtschaftsWoche Virtual Reality;;0 - 20,000;2;1;1;0;0;0
1443810;Round 99;;20,000 - 50,000;3;1;2;0;0;0
1443850;Social Services of the Doomed;;0 - 20,000;9;1;8;0;0;3
1443900;Volmatic;;0 - 20,000;28;4;24;0;0;0
1443950;Last Hope;;0 - 20,000;7;4;3;0;0;0
1443990;Strange Midnight;;0 - 20,000;5;3;2;0;0;0
1444020;Reactor Tech²;;50,000 - 100,000;213;93;120;366;366;0
1444090;Colorful Colore;;0 - 20,000;138;3;135;0;0;0
1444110;Summerland;;100,000 - 200,000;1427;137;1290;0;0;3
1444150;BLINK: The Last Night;;20,000 - 50,000;63;15;48;0;0;1
1444170;DOGMAN;;50,000 - 100,000;13;4;9;0;0;0
1444190;Death Becomes You - Mystery Visual Novel;;0 - 20,000;20;2;18;0;0;1
1444190;Death Becomes You - Mystery Visual Novel;;0 - 20,000;20;2;18;0;0;1
1444300;Teacup;;0 - 20,000;375;8;367;0;0;1
1444300;Teacup;;0 - 20,000;375;8;367;0;0;1
1444320;Cat Saves Halloween;;0 - 20,000;32;2;30;0;0;0
1444350;House;;50,000 - 100,000;1348;37;1311;34;34;7
1444360;Aisling and the Tavern of Elves;;0 - 20,000;17;7;10;0;0;0
1444370;Escape The Tank;;0 - 20,000;2;0;2;0;0;0
1444390;Ladder Box;;0 - 20,000;1;1;0;0;0;0
1444410;Yuoni;;0 - 20,000;15;11;4;0;0;0
1444420;WOMG Lite version;;;;;0;;;
1444480;Turing Complete;;100,000 - 200,000;1189;61;1128;730;1192;47
1444490;Why pizza?;;0 - 20,000;5;0;5;0;0;0
1444510;Task Men;;0 - 20,000;3;1;2;0;0;0
1444550;Waronoi;;0 - 20,000;23;0;23;0;0;0
1444570;Fantasy Royal VR;;0 - 20,000;9;10;-1;0;0;0
1444570;Fantasy Royal VR;;0 - 20,000;9;10;-1;0;0;0
1444580;EVIL BELOW;;0 - 20,000;1;0;1;0;0;1
1444610;Knuckers Test Fight;;0 - 20,000;0;1;-1;0;0;0
1444650;Haydee 2;;50,000 - 100,000;1041;96;945;3;3;17
1444670;Greed Knights;;20,000 - 50,000;90;24;66;0;0;0
1444670;Greed Knights;;20,000 - 50,000;90;24;66;0;0;0
1444700;Zen! Slider;;20,000 - 50,000;2;1;1;0;0;0
1444710;FireJumpers Inferno;;0 - 20,000;28;15;13;0;0;6
1444730;My Sweet Washing Machine!;;0 - 20,000;60;14;46;0;0;0
1444740;Maniac Path;;500,000 - 1,000,000;5;3;2;0;0;0
1444750;DreamWatcher;;0 - 20,000;46;11;35;0;0;0
1444770;ASTRO ACE;;0 - 20,000;38;4;34;0;0;0
1444870;Ostatni Dzien w Pracy;;0 - 20,000;2;1;1;0;0;0
1444890;Crazy Mafioso;;0 - 20,000;13;2;11;0;0;0
1444920;Doctor Who: The Edge of Reality;;0 - 20,000;149;93;56;0;0;0
1444950;Demon Purge Saga;;0 - 20,000;5;1;4;0;0;0
1445010;Rocket Explorer;;50,000 - 100,000;15;11;4;0;0;0
1445040;Space Choice: Data Analyzer;;20,000 - 50,000;130;8;122;0;0;0
1445050;Keywords of A Life;;20,000 - 50,000;2;2;0;0;0;0
1445110;The Legend of Arcadieu 2;;0 - 20,000;2;4;-2;0;0;0
1445120;Fast Typing Master;;0 - 20,000;8;12;-4;0;0;0
1445260;Hoards of Glory;;20,000 - 50,000;18;0;18;0;0;0
1445310;JWildfire;;0 - 20,000;58;2;56;0;0;16
1445360;MUZEGATE;;0 - 20,000;1;1;0;0;0;0
1445370;Imposters: Countdown;;0 - 20,000;7;0;7;0;0;0
1445400;Eternal Dungeon;;0 - 20,000;16;0;16;0;0;0
1445430;Ruinverse;;0 - 20,000;7;1;6;0;0;0
1445440;Blacksmith of the Sand Kingdom;;20,000 - 50,000;101;29;72;0;0;4
1445500;CITY - 909;;0 - 20,000;3;0;3;0;0;0
1445540;The Chronicles of Moses and the Exodus;;20,000 - 50,000;6;0;6;0;0;0
1445580;Good puzzle: Music;;0 - 20,000;9;0;9;0;0;0
1445630;Retrowave Drift;;0 - 20,000;27;12;15;0;0;0
1445650;Vylan;;0 - 20,000;4;1;3;0;0;0
1445670;依澪 Zero Plan;;0 - 20,000;1;0;1;0;0;0
1445720;Life of Fly;;0 - 20,000;30;2;28;0;0;0
1445810;Draft Day Sports: Pro Basketball 2021;;0 - 20,000;27;16;11;0;0;14
1445870;Terra Bomber;;0 - 20,000;1;1;0;0;0;0
1445890;Lithoi - Trials of Memory;;50,000 - 100,000;2;0;2;0;0;0
1445980;Tiny Traffic;;0 - 20,000;30;0;30;0;0;0
1446000;Fishy 3D;;0 - 20,000;27;0;27;0;0;0
1446090;PAGO FOREST: DRAGON'S REVENGE;;50,000 - 100,000;14;0;14;0;0;0
1446100;Pole of Cold;;0 - 20,000;15;3;12;0;0;0
1446130;The Trap: Remastered;;0 - 20,000;1;1;0;0;0;0
1446180;Leak Elite;;50,000 - 100,000;2;0;2;0;0;0
1446280;Alice in Wonderland - a jigsaw puzzle tale;;0 - 20,000;60;8;52;0;0;4
1446320;Harvest Island: Beginnings;;0 - 20,000;96;25;71;0;0;0
1446370;Super Marxist Twins;;0 - 20,000;6;0;6;0;0;0
1446410;Slime with a Sword;;0 - 20,000;2;0;2;0;0;0
1446420;Otherside;;0 - 20,000;8;2;6;0;0;0
1446450;Pretty Girls Klondike Solitaire;;0 - 20,000;17;12;5;0;0;1
1446470;Dome Discover;;0 - 20,000;22;8;14;0;0;0
1446510;Hyforge;;0 - 20,000;4;4;0;0;0;0
1446540;Fillit;;0 - 20,000;6;0;6;0;0;0
1446560;Grub Gauntlet;;0 - 20,000;4;0;4;0;0;0
1446640;Rifle Dodger;;0 - 20,000;1;4;-3;0;0;0
1446650;BRAVELY DEFAULT II;;20,000 - 50,000;1099;213;886;547;547;56
1446660;Ayu - The Dream Soul -;;0 - 20,000;1;1;0;0;0;0
1446670;Tin Tandem;;0 - 20,000;4;1;3;0;0;0
1446690;Super Ultimatum Quiz;;0 - 20,000;7;6;1;0;0;0
1446720;Is It Wrong to Try to Shoot 'em Up Girls in a Dungeon?;;20,000 - 50,000;185;19;166;0;0;0
1446750;Healing Animal;;0 - 20,000;4;1;3;0;0;0
1446780;MONSTER HUNTER RISE;;2,000,000 - 5,000,000;58138;9053;49085;5047;3000;29080
1446830;ガリア戦記　雄篇アンナーレス;;0 - 20,000;2;1;1;0;0;0
1446840;Broken Memories;;0 - 20,000;0;3;-3;0;0;0
1446880;Space Revenge;;0 - 20,000;1;1;0;0;0;0
1446930;Merge & Blade;;20,000 - 50,000;88;22;66;0;0;1
1446950;Frontline Grunt;;0 - 20,000;0;1;-1;0;0;0
1446980;Quick Square;;0 - 20,000;15;2;13;0;0;0
1447000;MotoGP21;;50,000 - 100,000;1323;310;1013;291;344;40
1447020;Vortex Escape;;20,000 - 50,000;1;2;-1;0;0;0
1447050;Enoki;;20,000 - 50,000;12;2;10;0;0;0
1447060;Jad;;0 - 20,000;26;2;24;0;0;0
1447070;Spinning_Kid_2;;0 - 20,000;19;4;15;0;0;0
1447080;SMFly: Ice Age;;0 - 20,000;12;3;9;0;0;0
1447090;Tarek;;0 - 20,000;15;5;10;0;0;0
1447140;Lost & Round;;20,000 - 50,000;1;0;1;0;0;0
1447160;Difficult Platformer Game;;20,000 - 50,000;3;1;2;0;0;0
1447190;Vladimir 2021;;0 - 20,000;1;5;-4;0;0;0
1447210;Obey The Law;;0 - 20,000;2;2;0;0;0;0
1447290;Tactical Operations Force;;0 - 20,000;3;4;-1;0;0;0
1447330;Born Race;;0 - 20,000;40;0;40;0;0;0
1447410;Mandew vs the Colorless Curse;;;;;0;;;
1447420;Burg Battle;;0 - 20,000;12;3;9;0;0;0
1447420;Burg Battle;;0 - 20,000;12;3;9;0;0;0
1447470;全战天下;;20,000 - 50,000;44;14;30;0;0;3
1447540;Enypnion;;0 - 20,000;19;3;16;0;0;0
1447570;Monkey King vs Transformers;;0 - 20,000;8;1;7;0;0;0
1447580;ココロクローバー パート2/Kokoro Clover Part2;;0 - 20,000;16;2;14;0;0;0
1447600;Pandemos;;0 - 20,000;15;0;15;0;0;0
1447640;Deadly Cosmic;;20,000 - 50,000;19;1;18;0;0;0
1447710;Death By FrostByte;;0 - 20,000;0;1;-1;0;0;0
1447730;Town Fall Zombie;;0 - 20,000;10;3;7;0;0;0
1447800;Christmas Rampage;;0 - 20,000;0;2;-2;0;0;0
1447830;battleMETAL;;20,000 - 50,000;3;2;1;0;0;0
1447870;鬼王~Oni;;0 - 20,000;36;24;12;0;0;0
1447900;Gold Dust;;0 - 20,000;14;10;4;0;0;0
1447900;Gold Dust;;0 - 20,000;14;10;4;0;0;0
1447920;Video World;;0 - 20,000;86;15;71;0;0;0
1448030;Press Any Button;;100,000 - 200,000;2102;176;1926;0;0;1
1448070;KosmoSquad;;50,000 - 100,000;2;0;2;0;0;0
1448090;Retention: A Love Story;;0 - 20,000;2;0;2;0;0;0
1448140;Beat Bolt City;;0 - 20,000;1;0;1;0;0;0
1448190;Fighties 2;;0 - 20,000;4;2;2;0;0;0
1448200;Laser Skirmish;;0 - 20,000;1;2;-1;0;0;0
1448200;Laser Skirmish;;0 - 20,000;1;2;-1;0;0;0
1448220;KONSAIRI;;0 - 20,000;15;6;9;0;0;0
1448230;Avalom: Ancestral Heroes;;0 - 20,000;59;29;30;0;0;0
1448260;下一站江湖Ⅰ;;20,000 - 50,000;387;150;237;0;0;6
1448320;Boat Warfare;;0 - 20,000;1;1;0;0;0;0
1448330;ELIOS VR;;0 - 20,000;6;26;-20;0;0;0
1448400;蓝实战队;;0 - 20,000;2;5;-3;0;0;0
1448460;Diodius ~PREMONITION~;;0 - 20,000;9;1;8;0;0;0
1448460;Diodius ~PREMONITION~;;0 - 20,000;9;1;8;0;0;0
1448520;Magicians' Legacy: Prologue;;50,000 - 100,000;27;4;23;0;0;0
1448530;Soccer Manager 2021;;500,000 - 1,000,000;1486;521;965;0;0;97
1448610;NERO;;0 - 20,000;125;39;86;0;0;3
1448650;Close Contact;;20,000 - 50,000;15;3;12;0;0;0
1448760;The Plane Effect;;0 - 20,000;42;22;20;0;0;0
1448780;Jewel Match Origins - Palais Imperial Collector's Edition;;0 - 20,000;27;0;27;0;0;1
1448800;BioCrisis;;0 - 20,000;40;1;39;0;0;0
1448820;Hydrofoil Generation;;0 - 20,000;17;1;16;0;0;13
1448840;Very Very Valet;;0 - 20,000;22;0;22;0;0;2
1448900;StreamUsers;;0 - 20,000;7;1;6;0;0;1
1448940;Warlock Bentspine - Toilet Edition;;0 - 20,000;33;1;32;0;0;0
1448950;Glitch Assassin;;0 - 20,000;3;2;1;0;0;0
1448970;CIPHER 61;;0 - 20,000;16;0;16;0;0;0
1449000;CALL OF LDPR;;0 - 20,000;163;53;110;0;0;0
1449060;RUNDOM;;0 - 20,000;2;2;0;0;0;0
1449070;Journey to the West;;0 - 20,000;665;124;541;0;0;48
1449100;Kore;;50,000 - 100,000;112;24;88;0;0;1
1449140;Foglight;;20,000 - 50,000;7;1;6;0;0;0
1449200;AI: THE SOMNIUM FILES - nirvanA Initiative;;100,000 - 200,000;1594;182;1412;1381;1381;312
1449230;Glitchhikers: The Spaces Between;;0 - 20,000;73;10;63;0;0;1
1449280;Ghostbusters: The Video Game Remastered;;100,000 - 200,000;1067;96;971;36;46;19
1449300;莉莉娜的奇幻之旅;;0 - 20,000;64;11;53;1;1;0
1449300;莉莉娜的奇幻之旅;;0 - 20,000;64;11;53;1;1;0
1449320;Alfred Hitchcock - Vertigo;;20,000 - 50,000;230;60;170;0;0;5
1449330;DRINK BAR MAID -REGRESSION-;;0 - 20,000;46;17;29;0;0;2
1449370;The Benza RPG;;20,000 - 50,000;14;2;12;0;0;0
1449380;Colored Shapes;;0 - 20,000;11;9;2;0;0;0
1449400;The Games: Winter Edition;;0 - 20,000;3;1;2;0;0;0
1449430;Jendo: Origins;;50,000 - 100,000;242;63;179;0;0;1
1449480;Impossible Mission Revisited;;20,000 - 50,000;10;11;-1;0;0;0
1449500;Bassmaster Fishing;;20,000 - 50,000;118;65;53;0;0;5
1449510;Henchman Story;;0 - 20,000;181;4;177;0;0;0
1449540;Atlas Rogues;;20,000 - 50,000;114;118;-4;0;0;0
1449580;The Gurion Mountains;;20,000 - 50,000;4;0;4;0;0;0
1449630;Crash Dive 2;;0 - 20,000;147;12;135;0;0;7
1449640;Revenge on the Streets 2;;0 - 20,000;6;0;6;0;0;0
1449650;Casual Challenge Players Club- Anime Bilhar game;;20,000 - 50,000;17;6;11;0;0;0
1449670;Relics of the Lost Age;;0 - 20,000;15;3;12;0;0;0
1449690;The Walking Dead: The Telltale Definitive Series;;200,000 - 500,000;9264;385;8879;1136;793;514
1449720;Cats and Food 4: New Year;;0 - 20,000;3;1;2;0;0;0
1449750;Space Commander: War and Trade;;100,000 - 200,000;336;160;176;0;0;16
1449760;Project Summit;;0 - 20,000;5;0;5;0;0;0
1449920;GRUNND;;50,000 - 100,000;22;3;19;0;0;0
1449960;Crazy Rabbit AntiLogic;;0 - 20,000;1;0;1;0;0;0
1450000;Safe Squares;;0 - 20,000;1;1;0;0;0;0
1450020;Ellie's Travel Diary;;0 - 20,000;3;1;2;0;0;0
1450060;Down and Out;;0 - 20,000;9;7;2;0;0;2
1450070;Dark Blocks;;0 - 20,000;1;0;1;0;0;0
1450080;The Legend of Heroes: Sen no Kiseki III;;0 - 20,000;268;44;224;0;0;89
1450090;The Legend of Heroes: Sen no Kiseki II KAI -The Erebonian Civil War-;;0 - 20,000;191;26;165;336;336;60
1450090;The Legend of Heroes: Sen no Kiseki II KAI -The Erebonian Civil War-;;0 - 20,000;191;26;165;336;336;60
1450100;LUNA;;50,000 - 100,000;205;40;165;0;0;0
1450120;The Legend of Heroes: Sen no Kiseki I KAI -Thors Military Academy 1204-;;20,000 - 50,000;344;70;274;3607;3607;63
1450150;Durka Simulator;;200,000 - 500,000;1558;74;1484;0;0;0
1450170;My Ten-day Girlfriend;;0 - 20,000;51;20;31;0;0;0
1450180;Haunt Chaser;;100,000 - 200,000;455;174;281;102;158;3
1450190;SUPER WHIPLASH;;0 - 20,000;2;1;1;0;0;0
1450200;Space Squadron;;0 - 20,000;2;0;2;0;0;0
1450210;The Game of Squids: Ultimate Parody Game;;0 - 20,000;10;0;10;0;0;0
1450240;Summoner Apprentice;;0 - 20,000;6;1;5;0;0;0
1450270;Kill Fish;;0 - 20,000;11;0;11;0;0;0
1450290;Metal Tales: Overkill;;0 - 20,000;3;1;2;0;0;0
1450300;Battleships: Command of the Sea;;0 - 20,000;15;7;8;0;0;0
1450310;Hidden Shapes Animals - Jigsaw Puzzle Game;;0 - 20,000;36;2;34;0;0;0
1450330;Concordia: Digital Edition;;0 - 20,000;81;9;72;0;0;6
1450410;Scrap Games;;20,000 - 50,000;3;1;2;0;0;0
1450530;Allotropy;;0 - 20,000;2;6;-4;0;0;0
1450610;Punch the Potus;;0 - 20,000;0;1;-1;0;0;0
1450620;Alien Duel Elements;;0 - 20,000;4;0;4;0;0;0
1450640;Plague Doctor: Contagion 430 BCE–2020 AD;;0 - 20,000;6;0;6;0;0;0
1450650;Osteoblasts;;0 - 20,000;92;12;80;0;0;2
1450650;Osteoblasts;;0 - 20,000;92;12;80;0;0;2
1450660;Brick Breaker Premium 2;;0 - 20,000;1;1;0;0;0;0
1450720;Street Massacre;;0 - 20,000;2;3;-1;0;0;0
1450750;Deva｜The Haunted Game;;20,000 - 50,000;0;5;-5;0;0;0
1450780;Gael's Quest;;0 - 20,000;5;2;3;0;0;0
1450790;Crazy Wheels;;20,000 - 50,000;3;2;1;0;0;0
1450800;Lilith Odyssey;;0 - 20,000;43;7;36;0;0;3
1450830;At Dead Of Night;;100,000 - 200,000;1731;114;1617;144;165;24
1450860;Typing Fingers;;0 - 20,000;1;3;-2;0;0;0
1450880;Wound of the West;;0 - 20,000;5;0;5;0;0;0
1451010;Pop Bowling VR;;0 - 20,000;0;2;-2;0;0;0
1451030;Star Hunter DX;;0 - 20,000;15;3;12;0;0;0
1451080;DUNGEON ENCOUNTERS;;20,000 - 50,000;297;146;151;0;0;3
1451090;Tactics Ogre: Reborn;;50,000 - 100,000;1790;543;1247;2062;2160;774
1451110;Lawyer Guy: Defender of Justice;;0 - 20,000;98;27;71;0;0;0
1451120;Sunlight;;0 - 20,000;167;31;136;0;0;0
1451150;Gestaltor;;0 - 20,000;1;1;0;0;0;0
1451160;Bakumatsu Renka SHINSENGUMI;;0 - 20,000;14;8;6;0;0;0
1451190;Undisputed;;200,000 - 500,000;3855;925;2930;207;207;1873
1451200;召唤与合体;;0 - 20,000;26;47;-21;0;0;0
1451230;Blood of Titans;;0 - 20,000;32;29;3;0;0;18
1451300;GridMath;;0 - 20,000;3;3;0;0;0;1
1451410;Watch Your Ride - Bicycle Game;;0 - 20,000;34;7;27;0;0;0
1451420;Construction Playground;;0 - 20,000;1;2;-1;0;0;0
1451440;Void Encounter;;0 - 20,000;1;0;1;0;0;0
1451480;The Greatest Penguin Heist of All Time;;50,000 - 100,000;1235;172;1063;71;102;32
1451490;Guns And Waifus;;0 - 20,000;9;3;6;0;0;0
1451560;BasCatball Mars: Basketball & Cat;;0 - 20,000;31;0;31;0;0;0
1451570;Cosmic Magus;;0 - 20,000;5;1;4;0;0;0
1451580;Hypercide;;0 - 20,000;4;1;3;0;0;0
1451650;Demon Turf: Trials;;0 - 20,000;102;9;93;0;0;0
1451720;Minesweeper Classy;;0 - 20,000;97;5;92;0;0;1
1451740;Children of Silentown: Prologue;;100,000 - 200,000;1011;34;977;27;32;0
1451760;TITANKIN: Prologue;;0 - 20,000;13;1;12;0;0;0
1451800;Super vs. World;;0 - 20,000;2;0;2;0;0;0
1451860;Cyber Badminton 2020;;20,000 - 50,000;3;2;1;0;0;0
1451860;Cyber Badminton 2020;;20,000 - 50,000;3;2;1;0;0;0
1451870;Sunset Drive 1986;;0 - 20,000;136;20;116;0;0;0
1451880;Color Breakers;;0 - 20,000;24;0;24;0;0;0
1451890;Unknown Planet;;0 - 20,000;17;1;16;0;0;0
1451920;逃离地球;;0 - 20,000;5;1;4;0;0;0
1451940;NEEDY STREAMER OVERLOAD;;200,000 - 500,000;19816;942;18874;263;224;169
1451950;Street Outlaws 2: Winner Takes All;;0 - 20,000;26;10;16;439;439;1
1451970;SATORI;;0 - 20,000;26;5;21;0;0;0
1451980;Taiwan Richman;;0 - 20,000;1;0;1;0;0;0
1452000;It's Six Random Characters and a Single Floor Dungeon, That's the Whole Game;;0 - 20,000;8;3;5;0;0;0
1452070;LONE RUIN;;0 - 20,000;90;38;52;0;0;4
1452080;Simply Parkour;;0 - 20,000;4;5;-1;0;0;0
1452110;Dominium Mundi;;0 - 20,000;2;5;-3;0;0;0
1452130;My Jigsaw Adventures - Forgotten Destiny;;0 - 20,000;18;0;18;0;0;0
1452180;Still Light;;50,000 - 100,000;19;34;-15;0;0;0
1452210;INPUT6;;20,000 - 50,000;81;3;78;0;0;4
1452220;Freddy Spaghetti 2.0;;0 - 20,000;18;4;14;0;0;0
1452260;8 Bit Space;;0 - 20,000;19;0;19;0;0;0
1452280;Devastator;;0 - 20,000;11;3;8;0;0;2
1452300;Snakenpon;;0 - 20,000;1;1;0;0;0;0
1452320;Hell Invades Heaven;;0 - 20,000;1;3;-2;0;0;0
1452360;The Tides of Time;;0 - 20,000;8;2;6;0;0;0
1452410;Case Kovacs - Agent 228;;0 - 20,000;26;18;8;0;0;0
1452500;The Good Life;;0 - 20,000;175;45;130;0;0;1
1452540;Frincess&Cnight;;0 - 20,000;107;5;102;0;0;0
1452630;Toast Defense;;20,000 - 50,000;156;29;127;0;0;1
1452650;Monstrum 2 Beta;;200,000 - 500,000;83;77;6;0;0;0
1452700;宥蘿的奇幻冒險 YURO'S FANTASY ADVENTURE;;0 - 20,000;22;1;21;0;0;0
1452770;Super Neat Cat;;0 - 20,000;22;2;20;0;0;0
1452790;IZBOT 2;;0 - 20,000;21;0;21;0;0;0
1452830;Disc Space;;50,000 - 100,000;437;81;356;0;0;0
1452860;Orlando the Fireman;;0 - 20,000;1;2;-1;0;0;0
1452870;Roads of Time 2: Odyssey;;0 - 20,000;7;1;6;0;0;2
1452900;Xeno Shooter;;50,000 - 100,000;15;0;15;0;0;0
1452910;Soul Shifter;;0 - 20,000;4;2;2;0;0;0
1452950;Seditionis: Tower Defense;;50,000 - 100,000;8;6;2;0;0;0
1452990;Hero Allstars: Void Invasion;;20,000 - 50,000;67;7;60;0;0;2
1453000;ADRPAN;;0 - 20,000;4;0;4;0;0;0
1453010;BATTLE ARENA: Robot Apocalypse;;0 - 20,000;14;0;14;0;0;0
1453080;DruMidia;;0 - 20,000;3;2;1;0;0;0
1453130;Lightsmith;;0 - 20,000;7;0;7;0;0;0
1453140;Abyss The Forgotten Past: Prologue;;20,000 - 50,000;70;46;24;0;0;0
1453200;Metu Caligine;;0 - 20,000;6;2;4;0;0;0
1453200;Metu Caligine;;0 - 20,000;6;2;4;0;0;0
1453220;Be a Pirate;;0 - 20,000;14;11;3;0;0;0
1453230;HIIS;;0 - 20,000;8;3;5;0;0;0
1453250;Cinema Simulator;;0 - 20,000;26;2;24;0;0;0
1453280;MEIRIN IN FISTS OF FIRE;;0 - 20,000;9;0;9;0;0;0
1453350;Veiled Basilisk;;0 - 20,000;2;0;2;0;0;0
1453400;TowerMancer;;0 - 20,000;16;11;5;0;0;0
1453430;Behind the Horizon;;0 - 20,000;13;0;13;0;0;0
1453450;Myth Bearer;;0 - 20,000;17;1;16;0;0;0
1453460;Trials of Argolis;;0 - 20,000;14;1;13;0;0;0
1453480;Dimensions;;0 - 20,000;1;0;1;0;0;0
1453600;Night Reverie: Prologue;;50,000 - 100,000;254;23;231;0;0;0
1453640;Valthirian Arc: Hero School Story 2;;0 - 20,000;27;15;12;0;0;2
1453660;Mana Gloom;;0 - 20,000;4;0;4;0;0;0
1453670;In Search of Fon Vitae;;0 - 20,000;16;0;16;0;0;0
1453710;Castle Formers;;0 - 20,000;35;1;34;0;0;0
1453730;Liminal;;0 - 20,000;22;11;11;0;0;0
1453740;DUNGEON OF NAZARICK;;0 - 20,000;6;1;5;0;0;0
1453790;The Serpent Rogue;;50,000 - 100,000;98;63;35;38;43;13
1453820;Shariiing VR;;0 - 20,000;0;1;-1;0;0;0
1453840;Killer: Infected One of Us;;0 - 20,000;105;110;-5;14;14;0
1453850;Pro Cycling Manager 2021;;20,000 - 50,000;447;127;320;3046;3046;151
1453870;Flow;;0 - 20,000;4;4;0;0;0;0
1453870;Flow;;0 - 20,000;4;4;0;0;0;0
1453920;Heroes of Three Kingdoms;;100,000 - 200,000;101;77;24;0;0;3
1453940;Deep Space;;0 - 20,000;87;61;26;0;0;0
1453950;Blaze3D;;0 - 20,000;2;0;2;0;0;0
1454010;Diary of Lucie;;0 - 20,000;106;8;98;0;0;0
1454030;Lotharus - Bacon, Ale & Repeat;;20,000 - 50,000;6;0;6;0;0;0
1454050;Tour de France 2021;;0 - 20,000;73;20;53;2723;2723;7
1454060;Shooty;;0 - 20,000;7;5;2;0;0;0
1454080;Dino Galaxy Tennis;;0 - 20,000;29;0;29;0;0;0
1454090;Army of Numbers;;0 - 20,000;52;4;48;0;0;3
1454100;Project Hive;;20,000 - 50,000;40;16;24;0;0;0
1454110;Desolation - End of Days;;0 - 20,000;0;1;-1;0;0;0
1454140;SUPERCHICOS;;20,000 - 50,000;48;7;41;0;0;0
1454150;Battle Alchemy;;0 - 20,000;1;0;1;0;0;0
1454160;One More Island;;0 - 20,000;131;50;81;0;0;4
1454190;Nominal;;0 - 20,000;9;2;7;0;0;0
1454200;Ragozin on Moon;;0 - 20,000;11;3;8;0;0;0
1454240;Mr. Parkour;;0 - 20,000;22;19;3;0;0;0
1454320;LabRat;;0 - 20,000;3;1;2;0;0;0
1454340;Auto Island;;0 - 20,000;1;2;-1;0;0;0
1454360;Super Star Shooter 16;;0 - 20,000;2;0;2;0;0;0
1454390;The Farm;;0 - 20,000;30;6;24;0;0;0
1454400;Cookie Clicker;;2,000,000 - 5,000,000;40151;1125;39026;15440;5754;9844
1454410;Dato of Srivijaya;;0 - 20,000;5;9;-4;0;0;0
1454430;Arc Apellago;;50,000 - 100,000;297;42;255;0;0;0
1454480;Mystic Fate;;0 - 20,000;1;0;1;0;0;0
1454500;VTuber Editor;;50,000 - 100,000;226;37;189;0;0;6
1454520;MONOLISK;;50,000 - 100,000;333;87;246;0;0;0
1454540;LAPIN;;0 - 20,000;87;4;83;0;0;1
1454550;Goop Loop;;0 - 20,000;54;2;52;0;0;0
1454580;Trump VS Covid: Save The World Clicker;;0 - 20,000;15;7;8;0;0;0
1454580;Trump VS Covid: Save The World Clicker;;0 - 20,000;15;7;8;0;0;0
1454600;Doctor Bunny;;0 - 20,000;6;2;4;0;0;0
1454640;A Tale of Paper: Refolded;;0 - 20,000;47;7;40;0;0;1
1454650;Kanso;;0 - 20,000;11;0;11;0;0;0
1454660;Knight Of The Parking Lot;;0 - 20,000;3;0;3;0;0;0
1454690;Stupid Stories;;0 - 20,000;8;0;8;0;0;0
1454700;Cube Conflict;;50,000 - 100,000;5;1;4;0;0;2
1454720;International Tennis Open;;0 - 20,000;1;1;0;0;0;0
1454730;Chenso Club;;0 - 20,000;80;11;69;0;0;3
1454890;Titanfall­;;100,000 - 200,000;705;1160;-455;50;68;3
1454910;Substance 3D Designer 2021;;0 - 20,000;55;8;47;0;0;30
1454930;TechnoRunner;;0 - 20,000;5;0;5;0;0;0
1454950;XOB;;0 - 20,000;7;0;7;0;0;0
1454970;New Tales from the Borderlands;;50,000 - 100,000;236;268;-32;0;0;11
1455020;Tormenta do Tempo;;0 - 20,000;2;0;2;0;0;0
1455040;MINDMIST;;20,000 - 50,000;23;5;18;0;0;0
1455080;Minesweeper NG;;0 - 20,000;8;0;8;0;0;1
1455090;Good puzzle: Castles;;0 - 20,000;12;2;10;0;0;0
1455120;Pumping Simulator;;20,000 - 50,000;245;90;155;0;0;6
1455130;Number One Rich;;0 - 20,000;6;11;-5;0;0;0
1455220;Succubus Farm;;20,000 - 50,000;289;100;189;0;0;4
1455230;Dungeon Slime:  Puzzle's Adventure;;0 - 20,000;74;2;72;0;0;0
1455290;Lava Escape Mine;;0 - 20,000;2;0;2;0;0;0
1455300;Glory of Rome;;0 - 20,000;25;9;16;0;0;3
1455360;Virtual Studio;;20,000 - 50,000;4;6;-2;0;0;1
1455380;Quiet Godo;;20,000 - 50,000;45;17;28;0;0;0
1455410;Sparks - Episode One;;0 - 20,000;1;1;0;0;0;0
1455420;Choco Pixel S;;0 - 20,000;4;0;4;0;0;0
1455430;Harvest Green;;0 - 20,000;15;1;14;0;0;0
1455430;Harvest Green;;0 - 20,000;15;1;14;0;0;0
1455490;Deadzone: Exodus;;0 - 20,000;5;0;5;0;0;0
1455530;东方剑姬在西方旅行的故事;;0 - 20,000;52;18;34;8;8;0
1455530;东方剑姬在西方旅行的故事;;0 - 20,000;52;18;34;8;8;0
1455540;Smash Track Drifters;;0 - 20,000;2;3;-1;0;0;0
1455560;Cyberpunica 2.0.2.0;;0 - 20,000;12;5;7;0;0;0
1455590;Sword of the Necromancer - Prologue;;20,000 - 50,000;243;36;207;0;0;0
1455630;The Game of Life 2;;100,000 - 200,000;1888;500;1388;267;244;108
1455650;Facing;;0 - 20,000;18;3;15;0;0;0
1455660;Out of the Park Baseball 22;;50,000 - 100,000;1410;233;1177;3052;3052;199
1455680;BE HUNTED;;0 - 20,000;15;14;1;0;0;0
1455720;Mr. Parkour 2;;0 - 20,000;10;13;-3;0;0;0
1455730;Mahjong Worlds;;0 - 20,000;1;0;1;0;0;0
1455760;Moki;;0 - 20,000;24;2;22;0;0;0
1455780;Big Larry;;0 - 20,000;22;8;14;0;0;0
1455840;Dorfromantik;;500,000 - 1,000,000;21033;602;20431;972;251;717
1455850;Curvy3D GO;;0 - 20,000;13;2;11;0;0;0
1455890;Darklight: Origin;;0 - 20,000;0;1;-1;0;0;0
1455900;Plunder Panic;;0 - 20,000;447;88;359;0;0;2
1455910;Territory: Farming and Fighting;;0 - 20,000;116;13;103;0;0;52
1455920;EQI;;50,000 - 100,000;165;19;146;55;55;0
1455930;BringIT to MOM;;0 - 20,000;1;0;1;0;0;0
1456200;Initial Drift Online;;50,000 - 100,000;1614;491;1123;317;594;56
1456230;Escape / 逃脱;;50,000 - 100,000;89;31;58;0;0;0
1456250;Monstermoerder;;0 - 20,000;5;0;5;0;0;0
1456260;Flashlight;;0 - 20,000;3;0;3;0;0;0
1456280;Battle Arena VR;;100,000 - 200,000;39;12;27;0;0;0
1456290;BoltBreak;;20,000 - 50,000;32;6;26;0;0;0
1456340;Pocket Penguin DX ( ポケットペンギン): A Retro Style Adventure;;0 - 20,000;8;0;8;0;0;0
1456410;Paper Shooter!;;0 - 20,000;2;0;2;0;0;0
1456440;Pixel Game Maker Series STEOS -Sorrow song of Bounty hunter-;;0 - 20,000;1;1;0;0;0;0
1456470;Rolling Gunner;;0 - 20,000;12;0;12;0;0;0
1456490;Formosa Night Market VR Arcade(by Taiwan);;0 - 20,000;4;0;4;0;0;0
1456490;Formosa Night Market VR Arcade(by Taiwan);;0 - 20,000;4;0;4;0;0;0
1456630;Dawn of the Mexica;;20,000 - 50,000;26;3;23;0;0;0
1456640;NobleEscape;;0 - 20,000;2;0;2;0;0;0
1456650;Pascal's Wager: Definitive Edition;;20,000 - 50,000;711;322;389;398;398;14
1456710;Blood Knot;;0 - 20,000;4;1;3;0;0;0
1456720;Into the Abyss;;20,000 - 50,000;0;1;-1;0;0;0
1456750;Ceres;;0 - 20,000;26;27;-1;0;0;0
1456770;Sketchbots;;0 - 20,000;6;0;6;0;0;0
1456810;Don´t Spill;;0 - 20,000;13;0;13;0;0;0
1456820;Marfusha;;100,000 - 200,000;1743;112;1631;263;263;29
1456870;Stress Random;;20,000 - 50,000;1;0;1;0;0;0
1456880;ElecHead;;20,000 - 50,000;0;0;0;0;0;2
1456900;Labyrinth;;0 - 20,000;0;1;-1;0;0;0
1456920;Mr. Parkour 3;;0 - 20,000;11;14;-3;0;0;0
1456980;DREMA;;0 - 20,000;3;5;-2;0;0;0
1457070;Elmo's Kangaroo of the damned: PUNISHMENT EDITION;;0 - 20,000;10;1;9;0;0;0
1457100;Shattered Gardens;;0 - 20,000;0;1;-1;0;0;0
1457130;Forgotten Soundscape;;0 - 20,000;4;1;3;0;0;0
1457140;We're All Going To Die;;0 - 20,000;16;12;4;0;0;0
1457150;Leafling;;200,000 - 500,000;440;178;262;0;0;0
1457180;Honkstory 2: There was No 1;;0 - 20,000;4;0;4;0;0;0
1457330;Routine Racers;;0 - 20,000;15;0;15;0;0;0
1457340;Vulgord's Tower;;0 - 20,000;5;0;5;0;0;0
1457370;Victoria Clair and the Mystery Express;;20,000 - 50,000;31;3;28;0;0;0
1457480;The Dream of Shadowlands Episode 1;;0 - 20,000;31;3;28;0;0;0
1457500;Time Freeze;;0 - 20,000;5;0;5;0;0;0
1457510;The Legend of Heroes: Sen no Kiseki IV -THE END OF SAGA-;;0 - 20,000;183;29;154;0;0;100
1457520;The Legend of Heroes: Zero no Kiseki Kai;;0 - 20,000;209;34;175;0;0;24
1457540;Beautiful Masseuse;;0 - 20,000;20;22;-2;0;0;0
1457550;Melody/心跳旋律;;0 - 20,000;125;19;106;34;48;0
1457570;Taxi Chaos;;0 - 20,000;18;27;-9;0;0;0
1457580;Speed 3: Grand Prix;;0 - 20,000;5;11;-6;0;0;0
1457600;Amazing Joes Journey;;0 - 20,000;0;1;-1;0;0;0
1457620;幻想三国志;;20,000 - 50,000;176;79;97;0;0;21
1457630;幻想三国志2;;0 - 20,000;123;37;86;3;3;20
1457640;幻想三国志3;;0 - 20,000;47;60;-13;0;0;9
1457650;幻想三国志4;;0 - 20,000;32;20;12;0;0;10
1457660;幻想三国志4外传;;0 - 20,000;47;15;32;0;0;3
1457690;Dwarves  & Dungeons;;20,000 - 50,000;31;5;26;0;0;0
1457710;Ignatius;;20,000 - 50,000;21;2;19;0;0;0
1457730;Farmer's Life: Prologue;;0 - 20,000;145;58;87;0;0;1
1457740;Stars Die;;20,000 - 50,000;80;7;73;0;0;0
1457810;休闲游戏合集;;0 - 20,000;37;13;24;0;0;0
1457820;Cybergeist;;0 - 20,000;0;1;-1;0;0;0
1457840;Fishticuffs;;0 - 20,000;11;0;11;0;0;0
1457920;VITATIO 3;;50,000 - 100,000;1;1;0;0;0;0
1457930;Red Rage;;100,000 - 200,000;31;6;25;0;0;0
1457990;Yuligans: Christmas is Coming!;;0 - 20,000;18;1;17;0;0;0
1458000;Air Bounce - The Jump 'n' Run Challenge;;0 - 20,000;54;8;46;0;0;0
1458090;Hapland Trilogy;;0 - 20,000;14;0;14;0;0;1
1458100;Cozy Grove;;100,000 - 200,000;5383;588;4795;212;262;276
1458250;Christmas Rhythm;;0 - 20,000;1;0;1;0;0;0
1458330;Mythlands: Flappy Dragon;;20,000 - 50,000;1;1;0;0;0;0
1458340;Legend of Krannia: Cursed Fate;;0 - 20,000;12;2;10;0;0;0
1458370;Shuzzler;;0 - 20,000;2;1;1;0;0;0
1458390;Rule No. 1;;0 - 20,000;230;16;214;0;0;0
1458420;Nightfall;;0 - 20,000;26;15;11;0;0;3
1458460;Island Raft Survival 2021: Ocean Escape;;20,000 - 50,000;15;19;-4;0;0;0
1458480;Travellers;;0 - 20,000;0;5;-5;0;0;0
1458530;Ronister Adventure;;0 - 20,000;42;5;37;0;0;1
1458540;Velocity Legends - Action Racing Game;;0 - 20,000;5;2;3;0;0;0
1458550;Simulators2021;;0 - 20,000;1;1;0;0;0;0
1458560;I'm on Observation Duty 3;;200,000 - 500,000;138;38;100;37;37;5
1458590;Anime Artist 3: Harem;;0 - 20,000;42;9;33;1;1;0
1458650;Game Dev Company;;0 - 20,000;1;0;1;0;0;0
1458680;Bookshelf;;0 - 20,000;15;13;2;0;0;0
1458690;Mango;;0 - 20,000;72;5;67;0;0;0
1458900;Meridian 157: Prologue;;20,000 - 50,000;116;35;81;0;0;1
1458920;Meridian 157: Chapter 1;;20,000 - 50,000;147;10;137;0;0;1
1458930;Meridian 157: Chapter 2;;0 - 20,000;111;6;105;0;0;1
1458960;Tip Top;;0 - 20,000;8;2;6;0;0;0
1458980;Misery Mansion;;0 - 20,000;46;18;28;0;0;0
1458990;North Modding Company: Bergsbruk;;20,000 - 50,000;51;32;19;0;0;0
1459020;Memories of Tomorrow;;0 - 20,000;5;1;4;0;0;0
1459070;FADE, THE FIRST CHAPTER;;0 - 20,000;37;7;30;0;0;0
1459160;Dark Cave;;0 - 20,000;10;5;5;0;0;0
1459170;Military Crusaders;;0 - 20,000;5;2;3;0;0;0
1459210;L'intrépide, le futur de l'imparfait;;0 - 20,000;3;0;3;0;0;0
1459250;Temple Hunters;;0 - 20,000;4;0;4;0;0;0
1459260;Techlie;;20,000 - 50,000;1;0;1;0;0;0
1459300;Glittering Sword;;0 - 20,000;12;4;8;0;0;0
1459360;Brain Break;;0 - 20,000;113;32;81;0;0;0
1459360;Brain Break;;0 - 20,000;113;32;81;0;0;0
1459500;Atlas Architect;;20,000 - 50,000;155;36;119;0;0;2
1459510;The Seasons Collection: Spring;;0 - 20,000;1;2;-1;0;0;0
1459530;Elastic Fantastic;;0 - 20,000;2;0;2;0;0;0
1459540;Elephantasy;;0 - 20,000;24;1;23;0;0;1
1459560;Untitled Space Game;;0 - 20,000;22;13;9;0;0;0
1459570;27 Pages;;0 - 20,000;13;0;13;0;0;0
1459640;VR Zeppelin Airship Trips: Flying hotel experiences in VR;;0 - 20,000;10;2;8;0;0;0
1459660;Become a Gladiator VR : 1v1 PVP;;0 - 20,000;6;15;-9;0;0;3
1459740;Cubiya;;0 - 20,000;1;0;1;0;0;0
1459760;Mickey Storm and the Cursed Mask;;0 - 20,000;4;0;4;0;0;0
1459810;魅魔的冒险生活;;0 - 20,000;16;20;-4;0;0;0
1459840;Be : Twin;;0 - 20,000;1;0;1;0;0;0
1459850;Microjob;;0 - 20,000;3;0;3;0;0;0
1459870;King Pins;;0 - 20,000;63;9;54;0;0;0
1459910;Isolomus;;0 - 20,000;200;12;188;0;0;1
1459930;Just Take Your Left;;0 - 20,000;19;8;11;0;0;0
1459960;Glitchpunk;;0 - 20,000;101;80;21;0;0;0
1460000;Racing Djani 2;;0 - 20,000;1;2;-1;0;0;0
1460040;Love Fantasy;;20,000 - 50,000;207;62;145;13;13;2
1460050;Adventure Bit;;0 - 20,000;39;0;39;0;0;0
1460090;The Life and Suffering of Sir Brante — Chapter 1&2;;200,000 - 500,000;1942;69;1873;182;211;7
1460100;Distorted;;0 - 20,000;0;1;-1;0;0;0
1460120;Torchance 6;;0 - 20,000;8;8;0;0;0;0
1460220;Evil Nun: The Broken Mask;;50,000 - 100,000;483;21;462;0;0;13
1460230;Javols VR;;50,000 - 100,000;6;1;5;0;0;0
1460250;RedEx;;0 - 20,000;91;24;67;0;0;0
1460260;Cosmoscope;;0 - 20,000;4;0;4;0;0;0
1460290;Loop;;0 - 20,000;73;17;56;0;0;0
1460300;Kittens' Maze;;20,000 - 50,000;6;10;-4;0;0;0
1460310;The Cat Banny;;0 - 20,000;14;1;13;0;0;0
1460310;The Cat Banny;;0 - 20,000;14;1;13;0;0;0
1460440;Ruby Heart [Visual Novel / Otome];;0 - 20,000;16;0;16;0;0;0
1460480;On Key Up: A Game for Keyboards;;0 - 20,000;6;0;6;0;0;0
1460490;Majikoi! Love Me Seriously!;;0 - 20,000;102;6;96;0;0;1
1460510;CAEDES;;0 - 20,000;14;20;-6;0;0;0
1460530;Kilemol;;0 - 20,000;1;0;1;0;0;0
1460540;Farlanders: Prologue;;50,000 - 100,000;237;18;219;0;0;2
1460600;What's Left Behind;;0 - 20,000;3;3;0;0;0;0
1460610;hocus 2;;0 - 20,000;46;7;39;0;0;0
1460650;Lodestar;;0 - 20,000;45;17;28;0;0;0
1460670;Jungle Town: Birthday quest;;0 - 20,000;9;1;8;0;0;0
1460700;おんがくしつ / MUSIC ROOM;;0 - 20,000;10;23;-13;0;0;0
1460750;SUPER DRINK BROS.;;0 - 20,000;170;28;142;0;0;0
1460750;SUPER DRINK BROS.;;0 - 20,000;170;28;142;0;0;0
1460830;6 Seasons and a Game;;20,000 - 50,000;555;68;487;0;0;0
1460870;Amazing Pyramids: Rebirth;;0 - 20,000;19;6;13;0;0;0
1460910;Flippen Run Mike;;0 - 20,000;1;0;1;0;0;0
1460930;The Life of Bally;;0 - 20,000;4;0;4;0;0;0
1460970;Fish and Groove;;0 - 20,000;3;1;2;0;0;0
1461000;SPACE Craft;;0 - 20,000;6;3;3;0;0;0
1461020;Attack of the Mechadonk - The ultimate donkey;;0 - 20,000;7;1;6;0;0;0
1461030;Carnivores: Dinosaur Hunt;;0 - 20,000;58;36;22;0;0;3
1461040;Flying Hero X;;0 - 20,000;15;2;13;0;0;0
1461090;喰人記;;0 - 20,000;9;0;9;0;0;1
1461100;International Basketball Manager 22;;0 - 20,000;171;26;145;0;0;4
1461140;Crazy Chicken Xtreme;;0 - 20,000;8;1;7;0;0;0
1461190;jetPIN;;20,000 - 50,000;1;2;-1;0;0;0
1461200;Duck Life;;0 - 20,000;137;11;126;0;0;3
1461220;Wait! Where's My Lunch;;0 - 20,000;5;2;3;0;0;0
1461240;The Prologue to a Dream of Home;;0 - 20,000;1;0;1;0;0;0
1461360;Eggnog Incorporated;;0 - 20,000;27;1;26;0;0;0
1461400;Kris Kringle's Christmas Village VR;;0 - 20,000;1;2;-1;0;0;0
1461410;Ring Miner;;0 - 20,000;3;0;3;0;0;0
1461420;Subway Train Simulator 2D;;20,000 - 50,000;16;1;15;0;0;0
1461420;Subway Train Simulator 2D;;20,000 - 50,000;16;1;15;0;0;0
1461490;Hoppup!;;0 - 20,000;57;18;39;0;0;1
1461500;Cookie Store;;0 - 20,000;7;2;5;0;0;1
1461540;Corridor: Amount of Fear;;20,000 - 50,000;41;20;21;0;0;0
1461570;Odenavirus Online;;0 - 20,000;3;0;3;0;0;0
1461580;Molecule Builder;;0 - 20,000;0;2;-2;0;0;0
1461600;Project Sparrow;;100,000 - 200,000;1033;113;920;0;0;6
1461630;Magic Potion Millionaire;;0 - 20,000;23;1;22;0;0;6
1461680;第五件遗留物;;20,000 - 50,000;337;34;303;0;0;0
1461710;Kagura's Dreamland 神樂夢境;;0 - 20,000;16;1;15;0;0;0
1461730;Undercover brother;;0 - 20,000;0;4;-4;0;0;0
1461740;Mouse Painting Master;;20,000 - 50,000;234;36;198;0;0;0
1461770;Fantasy Tavern Sextet -Vol.2 Adventurer's Days-;;0 - 20,000;147;22;125;103;103;0
1461810;蜀山：初章;;200,000 - 500,000;4988;1369;3619;37;37;2387
1461920;The Legend of Heroes: Ao no Kiseki KAI;;0 - 20,000;130;8;122;0;0;24
1461930;Robotry!;;0 - 20,000;21;0;21;0;0;0
1461960;Baby Goat Billy;;0 - 20,000;25;3;22;0;0;0
1461990;傲剑情缘;;50,000 - 100,000;5;7;-2;0;0;0
1462040;FINAL FANTASY VII REMAKE INTERGRADE;;200,000 - 500,000;11776;1331;10445;2077;1658;843
1462060;Escape from hospital;;0 - 20,000;33;15;18;0;0;0
1462100;Panic Attack;;0 - 20,000;5;6;-1;0;0;0
1462150;R.B.I. Baseball 21;;0 - 20,000;98;83;15;0;0;1
1462170;Dragon Ninja Clan Sword Of Destiny Game;;0 - 20,000;4;1;3;0;0;0
1462190;Corpse Mansion;;0 - 20,000;6;3;3;0;0;0
1462200;Speyarranoth;;0 - 20,000;0;1;-1;0;0;0
1462210;Battle Bugs;;0 - 20,000;11;0;11;0;0;0
1462220;Mini War - Three Kingdoms;;0 - 20,000;20;2;18;0;0;0
1462330;Deus Lo Veult;;0 - 20,000;0;5;-5;0;0;0
1462340;The Never Ending Game;;0 - 20,000;4;0;4;0;0;0
1462420;TWWWR;;0 - 20,000;48;0;48;0;0;0
1462430;Ms.Director;;0 - 20,000;36;0;36;0;0;0
1462440;The Lost Shrine - Escape Room;;0 - 20,000;1;2;-1;0;0;0
1462470;Vectorio - Early Access;;100,000 - 200,000;1198;74;1124;0;0;27
1462520;BRINK Traveler;;0 - 20,000;89;11;78;0;0;1
1462540;DvG: Conquering Giants;;0 - 20,000;4;1;3;0;0;0
1462570;Lost in Random;;100,000 - 200,000;1912;214;1698;132;132;35
1462580;Space Station Sprint;;0 - 20,000;5;2;3;0;0;0
1462600;ONNANOKO KEEPER;;0 - 20,000;2;1;1;0;0;0
1462620;Odd Adventure of Chub, Color, 23 and You;;0 - 20,000;38;10;28;0;0;0
1462640;Alien world Millionaire;;0 - 20,000;18;5;13;0;0;0
1462650;LAST EMBRYO -EITHER OF BRAVE TO STORY-;;20,000 - 50,000;451;30;421;386;386;1
1462680;Asdivine Cross;;50,000 - 100,000;3;2;1;0;0;0
1462700;The Dark Method;;0 - 20,000;26;5;21;0;0;0
1462720;The OrangeRice;;0 - 20,000;11;0;11;0;0;0
1462740;Your way;;0 - 20,000;4;6;-2;0;0;0
1462760;Neon Wings: Air Race;;20,000 - 50,000;9;1;8;0;0;0
1462780;Outta This Kingdom;;0 - 20,000;6;1;5;0;0;0
1462780;Outta This Kingdom;;0 - 20,000;6;1;5;0;0;0
1462790;Fight of Animals: Arena;;0 - 20,000;48;3;45;0;0;2
1462810;WRC 10 FIA World Rally Championship;;50,000 - 100,000;1205;505;700;1279;1279;74
1462830;Super Sketchy Party;;0 - 20,000;1;1;0;0;0;0
1462860;Dots!;;0 - 20,000;11;2;9;0;0;0
1462880;Urban Basketball VR;;0 - 20,000;0;1;-1;0;0;0
1462900;Zball V;;20,000 - 50,000;6;8;-2;0;0;0
1462910;Twisted: A Dark Fairytale;;0 - 20,000;7;1;6;0;0;0
1462960;Evade Zero;;0 - 20,000;3;0;3;0;0;0
1462970;Jumpman;;0 - 20,000;7;4;3;0;0;0
1463010;Tank Mechanic Simulator VR;;0 - 20,000;15;5;10;0;0;4
1463030;Jump With Dragons;;50,000 - 100,000;3;4;-1;0;0;0
1463040;The Legend of Eratus: Dragonlord;;0 - 20,000;6;3;3;0;0;0
1463040;The Legend of Eratus: Dragonlord;;0 - 20,000;6;3;3;0;0;0
1463050;The Purification;;0 - 20,000;2;2;0;0;0;0
1463080;Snow Survival;;0 - 20,000;10;20;-10;0;0;0
1463080;Snow Survival;;0 - 20,000;10;20;-10;0;0;0
1463130;Robobo TM;;0 - 20,000;10;0;10;0;0;0
1463140;Destructo;;0 - 20,000;7;8;-1;0;0;2
1463170;Marble Parkour;;0 - 20,000;29;15;14;0;0;0
1463180;九个世界（Nine worlds）;;0 - 20,000;1;1;0;0;0;0
1463210;Just Old;;0 - 20,000;4;5;-1;0;0;0
1463350;WordTactics;;0 - 20,000;5;1;4;0;0;0
1463360;Eugene's Dream: The Daily Ins And Outs Of A Sane Robot In An Insane World;;0 - 20,000;1;2;-1;0;0;0
1463380;Big Cat Rescue VR;;0 - 20,000;1;0;1;0;0;0
1463420;INDICTED;;0 - 20,000;17;12;5;0;0;0
1463430;Niinamigota;;0 - 20,000;5;2;3;0;0;0
1463450;Fallstreak: Requiem for my Homeland;;0 - 20,000;39;0;39;0;0;0
1463470;Ruff Night At The Gallery;;20,000 - 50,000;178;16;162;0;0;0
1463500;Conrun Virtual Gym;;0 - 20,000;2;1;1;0;0;0
1463510;英雄坛说X·归来;;20,000 - 50,000;9;2;7;0;0;0
1463730;Arid;;50,000 - 100,000;1301;197;1104;0;0;10
1463760;The Beardless Wizard;;0 - 20,000;14;0;14;0;0;0
1463830;Vostok 2061;;0 - 20,000;22;4;18;0;0;0
1463840;Warp Out;;0 - 20,000;11;1;10;0;0;0
1463870;Jumping Knight;;0 - 20,000;24;5;19;0;0;0
1463890;Slay the Dragon!;;20,000 - 50,000;297;12;285;0;0;1
1463920;hexceed;;200,000 - 500,000;1696;190;1506;589;712;92
1463930;Fly Away Baseball;;0 - 20,000;0;1;-1;0;0;0
1463980;Proven: A Math RPG;;0 - 20,000;6;2;4;0;0;0
1464000;Ascent;;0 - 20,000;102;4;98;0;0;0
1464010;YOLKED - The Egg Game;;0 - 20,000;44;1;43;0;0;0
1464050;Dual Guns Fantasy;;0 - 20,000;5;1;4;0;0;0
1464100;Unlife;;0 - 20,000;14;3;11;0;0;0
1464120;600Seconds ~The Deep Church~;;0 - 20,000;6;2;4;0;0;0
1464130;Archons of Doom;;0 - 20,000;2;1;1;0;0;0
1464150;Hero Lilith;;0 - 20,000;3;1;2;0;0;0
1464190;Demon heart;;0 - 20,000;13;0;13;0;0;0
1464200;Divine Stone;;50,000 - 100,000;13;7;6;0;0;0
1464290;Splash Cars;;0 - 20,000;12;1;11;0;0;1
1464320;Callparin 2;;0 - 20,000;8;10;-2;0;0;0
1464350;Fear in The Modern House - CH2;;0 - 20,000;10;8;2;0;0;0
1464380;Eclipse;;100,000 - 200,000;132;34;98;0;0;0
1464390;Moonlit;;0 - 20,000;7;2;5;0;0;0
1464400;Mead Crafter;;0 - 20,000;5;1;4;0;0;0
1464410;末日杀 Might & Trap: Apocalypse;;0 - 20,000;11;3;8;0;0;3
1464420;Tower;;50,000 - 100,000;1;0;1;0;0;0
1464500;Ruvato: Original Complex;;0 - 20,000;42;8;34;0;0;0
1464520;Blewie;;0 - 20,000;3;0;3;0;0;0
1464550;RagingBlasters;;0 - 20,000;91;2;89;0;0;0
1464610;Dark Side of War;;0 - 20,000;42;20;22;0;0;0
1464620;Oona the Druid's Path;;20,000 - 50,000;27;3;24;0;0;0
1464630;Gravity in Space;;0 - 20,000;3;0;3;0;0;0
1464650;Planet Cracker;;20,000 - 50,000;3;3;0;0;0;0
1464730;Metal Commando;;0 - 20,000;31;17;14;0;0;0
1464840;Monolith;;50,000 - 100,000;3;0;3;0;0;0
1464850;CloseCall;;0 - 20,000;9;0;9;0;0;0
1464910;Quest: Escape Room 2;;0 - 20,000;25;5;20;0;0;1
1464930;Seek Girl Ⅶ;;50,000 - 100,000;870;328;542;54;33;2
1465040;TCSTRIKERS1;;20,000 - 50,000;7;5;2;0;0;0
1465050;HaremKingdom;;20,000 - 50,000;55;8;47;0;0;1
1465060;Tetrogue Dragons;;0 - 20,000;1;0;1;0;0;0
1465070;Legendary Tales;;100,000 - 200,000;1417;295;1122;701;1060;35
1465120;skelets;;0 - 20,000;4;1;3;0;0;0
1465160;Lantern Light VR;;20,000 - 50,000;1;2;-1;0;0;0
1465170;Seasons With Furry;;0 - 20,000;46;25;21;0;0;0
1465190;古代人生 Ancient Life;;0 - 20,000;52;58;-6;0;0;2
1465210;Gravulse;;0 - 20,000;57;15;42;0;0;0
1465210;Gravulse;;0 - 20,000;57;15;42;0;0;0
1465260;Cyberpunk SFX;;0 - 20,000;26;9;17;0;0;0
1465300;The Thought Police Hotline: Episode 1;;0 - 20,000;0;1;-1;0;0;0
1465310;Gun Mage;;0 - 20,000;4;0;4;0;0;0
1465330;Bird Pro Skater;;0 - 20,000;13;0;13;0;0;0
1465340;Free Spirit VR Meditation;;0 - 20,000;5;2;3;0;0;0
1465350;Model City;;0 - 20,000;1;2;-1;0;0;0
1465360;SnowRunner;;500,000 - 1,000,000;17444;2193;15251;2820;975;5164
1465370;Detective notes. Lighthouse Mystery Solitaire;;0 - 20,000;6;2;4;0;0;1
1465380;Hello From Darkness;;0 - 20,000;100;19;81;0;0;0
1465380;Hello From Darkness;;0 - 20,000;100;19;81;0;0;0
1465400;Kaverini Nuuk Adventures;;20,000 - 50,000;2;0;2;0;0;0
1465410;Spinny's Journey;;0 - 20,000;8;2;6;0;0;0
1465440;Obscurant;;20,000 - 50,000;19;1;18;0;0;0
1465450;Jetpack City Action VR;;0 - 20,000;3;4;-1;0;0;0
1465480;Bloody Sand : The Gods Of Assyria;;0 - 20,000;4;4;0;0;0;0
1465500;Hero Puzzle;;0 - 20,000;42;38;4;0;0;0
1465510;DUSK '82: ULTIMATE EDITION;;0 - 20,000;230;6;224;0;0;1
1465580;Trapmania;;0 - 20,000;1;0;1;0;0;0
1465590;Dead Warrior Tribute;;0 - 20,000;19;19;0;0;0;0
1465610;World Fighting Soccer 22;;0 - 20,000;27;6;21;0;0;1
1465640;Dead Man's Rest;;0 - 20,000;39;0;39;0;0;0
1465740;Wicked Rails VR;;0 - 20,000;2;4;-2;0;0;0
1465780;Silver Vault;;0 - 20,000;1;0;1;0;0;0
1465830;Torto: Cursed Divine;;0 - 20,000;2;0;2;0;0;0
1465860;*NEW* SCUFFED EPIC BHOP SIMULATOR 2023 (POG CHAMP);;200,000 - 500,000;4621;444;4177;0;0;1
1465890;武林志2 (Wushu Chronicles 2);;20,000 - 50,000;344;418;-74;104;104;4
1465950;Phoenix Hope;;0 - 20,000;86;22;64;0;0;2
1466010;FPV Speed Drone;;20,000 - 50,000;12;23;-11;0;0;1
1466030;Pamir Saga;;20,000 - 50,000;1;0;1;0;0;0
1466070;Fool's Paradise;;0 - 20,000;4;2;2;0;0;0
1466090;Gothic 1881;;0 - 20,000;6;2;4;0;0;0
1466100;RavenWeald;;0 - 20,000;11;1;10;0;0;1
1466110;Orbiterrion;;0 - 20,000;4;0;4;0;0;0
1466140;Sluggy Jean Takes a Hike;;0 - 20,000;2;0;2;0;0;0
1466170;Merchant of Phenistoria;;0 - 20,000;4;4;0;0;0;0
1466190;You Arrive in a Town;;0 - 20,000;9;10;-1;0;0;3
1466240;Dancing in the moonlight;;0 - 20,000;1;0;1;0;0;0
1466260;Two Die;;0 - 20,000;9;0;9;0;0;1
1466290;The Change Architect;;20,000 - 50,000;26;16;10;0;0;0
1466350;Jennifer Wilde: Unlikely Revolutionaries;;0 - 20,000;15;2;13;0;0;1
1466430;Aardvark;;0 - 20,000;5;2;3;0;0;0
1466490;TOKYO LOVE +;;0 - 20,000;1;1;0;0;0;0
1466530;Escape from Covid;;0 - 20,000;4;0;4;0;0;0
1466570;The Clot Thickens;;0 - 20,000;1;0;1;0;0;0
1466610;Combined Arms Operations Series;;20,000 - 50,000;12;2;10;0;0;0
1466620;The Guardians of Peace;;0 - 20,000;1;0;1;0;0;0
1466640;Road 96 ;;1,000,000 - 2,000,000;11096;1023;10073;574;600;93
1466680;Sakura MMO Extra;;0 - 20,000;45;11;34;0;0;1
1466830;Drift Long Racing;;0 - 20,000;18;15;3;0;0;0
1466840;Hyperblade;;0 - 20,000;4;1;3;0;0;0
1466860;Age of Empires IV: Anniversary Edition;;1,000,000 - 2,000,000;40418;6359;34059;3510;1278;17418
1466930;Survival Quiz CITY;;0 - 20,000;122;80;42;0;0;0
1466950;HangOutGame;;0 - 20,000;4;1;3;0;0;0
1466970;Elementowers;;0 - 20,000;1;1;0;0;0;0
1467020;Aefen Fall;;0 - 20,000;37;20;17;0;0;0
1467060;Secrets of Magic 4: Potion Master;;0 - 20,000;10;1;9;0;0;0
1467080;SamuraiZero;;0 - 20,000;1;3;-2;0;0;0
1467130;White Dandelion;;0 - 20,000;5;5;0;0;0;0
1467190;Plushie Dungeon;;0 - 20,000;1;0;1;0;0;0
1467200;Soliterix;;0 - 20,000;3;2;1;0;0;0
1467240;Young Archaeologist;;0 - 20,000;6;9;-3;0;0;0
1467260;PSIONIC;;0 - 20,000;21;9;12;0;0;0
1467320;Arthur's Revenge;;0 - 20,000;14;12;2;0;0;0
1467320;Arthur's Revenge;;0 - 20,000;14;12;2;0;0;0
1467330;Endline;;0 - 20,000;1;0;1;0;0;0
1467340;Quintaesencia;;20,000 - 50,000;6;2;4;0;0;0
1467360;Shotgun, Dungeons, Laser Traps;;20,000 - 50,000;1;2;-1;0;0;0
1467380;Ancient Warriors Casino Jackpot;;0 - 20,000;1;3;-2;0;0;0
1467390;StarPrey;;20,000 - 50,000;18;3;15;0;0;0
1467410;Isekai Eternal;;0 - 20,000;42;31;11;0;0;0
1467560;Desktop Panels;;0 - 20,000;4;0;4;0;0;1
1467580;GENIUS AT WORK!;;0 - 20,000;3;1;2;0;0;0
1467590;Frontiers Reach;;20,000 - 50,000;5;1;4;0;0;0
1467600;.;;0 - 20,000;0;5;-5;0;0;0
1467620;CLOWN;;0 - 20,000;12;8;4;0;0;0
1467740;Pocket Plants;;0 - 20,000;15;13;2;0;0;0
1467740;Pocket Plants;;0 - 20,000;15;13;2;0;0;0
1467830;SIIMI;;0 - 20,000;33;2;31;0;0;0
1467870;Mystery Case Files: Crossfade Collector's Edition;;0 - 20,000;7;3;4;0;0;2
1468000;These Nights Alone;;20,000 - 50,000;23;6;17;0;0;0
1468040;Elmarion: Dragon's Princess;;100,000 - 200,000;54;15;39;0;0;1
1468060;The Island of Dr. Yepstein;;0 - 20,000;10;6;4;0;0;0
1468090;akeytsu Indie 2021;;0 - 20,000;6;0;6;0;0;0
1468190;Hikeshi-Fireman-;;0 - 20,000;2;0;2;0;0;0
1468220;Sacrificial Lighthouse;;0 - 20,000;36;5;31;0;0;0
1468240;Carebotz;;0 - 20,000;31;9;22;0;0;0
1468250;Kukoos: Lost Pets;;0 - 20,000;26;1;25;0;0;0
1468260;Leaf Blower Revolution - Idle Game;;500,000 - 1,000,000;17850;924;16926;7083;442;1836
1468280;Inland;;20,000 - 50,000;43;7;36;0;0;0
1468370;Snow Strike;;50,000 - 100,000;1;1;0;0;0;0
1468380;The Sundew;;0 - 20,000;50;6;44;0;0;0
1468390;Argil;;0 - 20,000;4;1;3;0;0;0
1468720;Ultimate Epic Battle Simulator 2;;100,000 - 200,000;2709;353;2356;171;207;205
1468750;Fox in the Woods;;0 - 20,000;4;1;3;0;0;0
1468750;Fox in the Woods;;0 - 20,000;4;1;3;0;0;0
1468810;鬼谷八荒 Tale of Immortal;;10,000,000 - 20,000,000;108339;106354;1985;4224;2007;16516
1468820;The king is gone;;0 - 20,000;0;1;-1;0;0;0
1468950;Devil Edge;;0 - 20,000;1;0;1;0;0;0
1469000;Don't Crash - The Zombie Game;;0 - 20,000;9;6;3;0;0;0
1469090;Bounce;;0 - 20,000;1;0;1;0;0;0
1469160;Wartune Reborn;;50,000 - 100,000;107;62;45;0;0;61
1469170;Commandos 3 - HD Remaster;;0 - 20,000;106;70;36;0;0;19
1469220;Cat Simulator: Meow;;0 - 20,000;69;33;36;0;0;2
1469230;Angry Fugu;;0 - 20,000;1;0;1;0;0;0
1469250;Rubber Bandits: Christmas Prologue;;100,000 - 200,000;1045;103;942;55;39;1
1469280;SuchArt: Creative Space;;500,000 - 1,000,000;6002;122;5880;236;130;43
1469310;梦幻江湖;;0 - 20,000;4;4;0;0;0;0
1469330;Unlimited Fight;;200,000 - 500,000;3;1;2;0;0;0
1469340;GyroBlade;;0 - 20,000;12;3;9;0;0;0
1469350;Save the Planet;;0 - 20,000;8;6;2;0;0;0
1469370;Lighthouse Keeper;;50,000 - 100,000;136;40;96;0;0;0
1469450;Moon Caves;;0 - 20,000;3;0;3;0;0;0
1469460;Gone Upstate;;0 - 20,000;9;4;5;0;0;0
1469490;Awakened: Dark Space;;0 - 20,000;9;3;6;0;0;0
1469620;Epic Battle Fantasy Collection;;20,000 - 50,000;208;6;202;324;324;3
1469620;Epic Battle Fantasy Collection;;20,000 - 50,000;208;6;202;324;324;3
1469690;Drift King;;0 - 20,000;134;17;117;0;0;0
1469700;Playing Pride & Prejudice 1: An Austen Armoire;;0 - 20,000;4;0;4;0;0;0
1469700;Playing Pride & Prejudice 1: An Austen Armoire;;0 - 20,000;4;0;4;0;0;0
1469750;3x3 the immersive fiction chapter one : Math awakening;;200,000 - 500,000;4;0;4;0;0;0
1469800;Koma;;0 - 20,000;13;0;13;0;0;0
1469830;The Happy Little Virus;;0 - 20,000;3;1;2;0;0;0
1469860;Hollow Destiny;;0 - 20,000;5;0;5;0;0;0
1469890;NeoCube;;0 - 20,000;1;0;1;0;0;0
1469910;Slobbish Dragon Princess;;0 - 20,000;168;28;140;165;165;2
1469960;Explosive Candy World;;0 - 20,000;24;1;23;0;0;0
1470020;Dudes on a Map: Virtual Grid Paper;;20,000 - 50,000;31;2;29;0;0;1
1470030;Funtime with Buffy;;0 - 20,000;11;1;10;0;0;0
1470060;GHOSTWINTER;;0 - 20,000;12;11;1;0;0;0
1470130;Dominate Square;;20,000 - 50,000;2;1;1;0;0;0
1470150;Low Story;;0 - 20,000;8;1;7;0;0;0
1470220;Movie Tycoon Simulator 2020;;0 - 20,000;10;1;9;0;0;0
1470270;Powerboat VR;;0 - 20,000;14;7;7;0;0;0
1470300;Paper Tales - Catch Up Games;;0 - 20,000;2;2;0;0;0;0
1470320;Malmyr;;20,000 - 50,000;32;5;27;0;0;0
1470380;A Pretty Odd Bunny;;0 - 20,000;10;1;9;0;0;4
1470420;Re:Turn 2 - Runaway;;0 - 20,000;37;9;28;0;0;1
1470480;Guns Blazing;;0 - 20,000;9;1;8;0;0;0
1470550;Stranded;;0 - 20,000;6;13;-7;0;0;0
1470650;bullets;;0 - 20,000;2;1;1;0;0;0
1470650;bullets;;0 - 20,000;2;1;1;0;0;0
1470660;Amborettio;;50,000 - 100,000;2;0;2;0;0;0
1470670;Squirrelmageddon!;;20,000 - 50,000;22;21;1;0;0;0
1470680;Seiso Master KEN;;0 - 20,000;1;0;1;0;0;0
1470690;Ritum Bitum;;0 - 20,000;0;2;-2;0;0;0
1470720;Misery Street;;0 - 20,000;4;1;3;0;0;0
1470720;Misery Street;;0 - 20,000;4;1;3;0;0;0
1470730;Russian Reality;;0 - 20,000;19;10;9;0;0;0
1470730;Russian Reality;;0 - 20,000;19;10;9;0;0;0
1470750;MAGIC POT&TER BATTLEGROUNDS;;0 - 20,000;5;8;-3;0;0;0
1470790;Doug Flutie's Maximum Football 2020;;0 - 20,000;28;27;1;0;0;2
1470820;Mad Bus;;0 - 20,000;15;5;10;0;0;0
1470820;Mad Bus;;0 - 20,000;15;5;10;0;0;0
1470900;Roscosmas Landing;;0 - 20,000;15;3;12;0;0;0
1470910;Blind_;;0 - 20,000;2;0;2;0;0;0
1470920;Howdy, Jacob!;;0 - 20,000;44;6;38;0;0;0
1470970;GraviFire;;0 - 20,000;18;1;17;0;0;0
1471000;Nevermore - Documentary Kinetic Novel;;50,000 - 100,000;2;1;1;0;0;0
1471040;Base One;;50,000 - 100,000;172;247;-75;0;0;1
1471120;弹幕大修仙 - 开篇;;0 - 20,000;2;1;1;0;0;0
1471180;梦江湖;;20,000 - 50,000;719;585;134;0;0;46
1471200;YUME;;50,000 - 100,000;735;598;137;77;78;3
1471220;Timothy ティモシー -神秘の森-;;0 - 20,000;1;0;1;0;0;0
1471250;Orion: The Eternal Punishment;;50,000 - 100,000;14;7;7;0;0;0
1471410;SYNTHETIK 2;;200,000 - 500,000;949;227;722;256;338;119
1471450;X遊戲;;0 - 20,000;1;2;-1;0;0;0
1471460;Dualism;;0 - 20,000;7;0;7;0;0;0
1471470;Tales of Lagoona;;20,000 - 50,000;11;1;10;0;0;0
1471490;Bob Help Them;;0 - 20,000;35;1;34;0;0;0
1471510;Tales of Lagoona 3: Frauds, Forgeries, and Fishsticks;;0 - 20,000;0;4;-4;0;0;2
1471530;100 hidden gnomes;;20,000 - 50,000;80;36;44;0;0;0
1471550;Variable;;0 - 20,000;1;2;-1;0;0;0
1471570;Industrial Firefighters;;0 - 20,000;16;5;11;0;0;0
1471630;MegaRamp;;0 - 20,000;11;2;9;0;0;0
1471680;Cyclemania;;100,000 - 200,000;4;1;3;0;0;0
1471730;Kick it, Bunny!;;0 - 20,000;6;0;6;0;0;0
1471850;Spike Match;;0 - 20,000;0;1;-1;0;0;0
1471900;Castle of the Land;;0 - 20,000;4;0;4;0;0;0
1471910;Killer Sudoku;;0 - 20,000;89;7;82;0;0;15
1471920;Christmas Elf;;0 - 20,000;6;1;5;0;0;0
1471940;Bahamian Rhapsody;;0 - 20,000;13;7;6;0;0;0
1471960;Room to Grow;;0 - 20,000;134;5;129;0;0;0
1471980;MedicalImagingVR;;0 - 20,000;5;2;3;0;0;0
1472040;Cat's Cradle;;0 - 20,000;9;0;9;0;0;0
1472060;Apollyon: River of Life;;0 - 20,000;7;0;7;0;0;0
1472250;ROG CITADEL XV;;50,000 - 100,000;373;161;212;0;0;3
1472260;Macro golf;;0 - 20,000;0;8;-8;0;0;0
1472320;Silver Cats;;0 - 20,000;8;1;7;0;0;0
1472330;NOMAD Revisited;;0 - 20,000;2;1;1;0;0;0
1472540;Save me Mr Tako: Definitive Edition;;0 - 20,000;28;1;27;0;0;1
1472560;I Am Fish;;50,000 - 100,000;1102;377;725;496;627;49
1472600;Terrene - An Evidence Of Life Game;;0 - 20,000;30;2;28;0;0;0
1472600;Terrene - An Evidence Of Life Game;;0 - 20,000;30;2;28;0;0;0
1472660;No Place Like Home;;100,000 - 200,000;2506;540;1966;400;276;57
1472740;Das Balkonzimmer;;50,000 - 100,000;25;17;8;0;0;0
1472790;Eluxia Enigma;;0 - 20,000;2;0;2;0;0;0
1472810;Slime Fantasy: the search for the lost sword;;0 - 20,000;1;0;1;0;0;0
1472820;Pokoh;;0 - 20,000;2;0;2;0;0;0
1473000;Lumber Party;;20,000 - 50,000;14;1;13;0;0;0
1473050;100 hidden birds;;20,000 - 50,000;386;23;363;0;0;0
1473070;Nova Genetics;;0 - 20,000;5;4;1;0;0;0
1473100;Guess Colors;;0 - 20,000;2;0;2;0;0;0
1473130;The Chaser's Voyage;;0 - 20,000;2;0;2;0;0;0
1473170;Aircraft Sketch Shooter;;0 - 20,000;10;1;9;0;0;0
1473220;Hundred Chances - The Fortress;;0 - 20,000;20;1;19;0;0;0
1473270;Are You Smarter Than The Crowd?;;0 - 20,000;28;16;12;0;0;0
1473420;HANAMI;;0 - 20,000;3;7;-4;0;0;0
1473480;A.V.A;;500,000 - 1,000,000;2918;3257;-339;3927;127;1824
1473500;Rise of the samurai in VR;;0 - 20,000;1;1;0;0;0;0
1473540;Gondola's Adventure;;0 - 20,000;2;0;2;0;0;0
1473550;Habroxia 2;;0 - 20,000;33;4;29;0;0;0
1473640;Space Nations - Battlearena;;50,000 - 100,000;3;0;3;0;0;0
1473650;The Fang;;0 - 20,000;2;2;0;0;0;0
1473660;Mrs. Santa's Gift Hunt;;0 - 20,000;41;2;39;0;0;0
1473740;Maritime Calling;;0 - 20,000;22;12;10;0;0;0
1473760;Beyond the Storm;;0 - 20,000;13;5;8;0;0;1
1473820;Kitty Tactics;;20,000 - 50,000;27;2;25;0;0;0
1473840;One Circle;;0 - 20,000;34;0;34;0;0;0
1473850;Golems TD;;0 - 20,000;0;1;-1;0;0;0
1473870;Hell Loop;;0 - 20,000;18;5;13;0;0;0
1473930;Head Worms;;0 - 20,000;8;2;6;0;0;0
1474000;Age of ilcoin VR : Retribution;;50,000 - 100,000;9;12;-3;0;0;0
1474200;Sudoku RPG;;20,000 - 50,000;141;21;120;0;0;1
1474220;Wonder Defense: Chapter Earth;;0 - 20,000;9;3;6;0;0;0
1474280;Last Kingdom - The Card Game;;0 - 20,000;7;1;6;0;0;0
1474410;Artillery Royale;;0 - 20,000;10;2;8;0;0;0
1474430;Stars Survivor;;20,000 - 50,000;5;2;3;0;0;0
1474440;Bog Lord;;20,000 - 50,000;5;1;4;0;0;0
1474440;Bog Lord;;20,000 - 50,000;5;1;4;0;0;0
1474550;Hexteria;;0 - 20,000;24;1;23;0;0;0
1474570;CYBER TENNIS;;0 - 20,000;3;2;1;0;0;0
1474740;Horse Tales: Emerald Valley Ranch;;0 - 20,000;318;202;116;17;17;13
1474790;Booom-Slang!;;0 - 20,000;4;3;1;0;0;0
1474840;Among Stars and Robots;;0 - 20,000;1;0;1;0;0;0
1474850;Black Ido;;0 - 20,000;14;3;11;0;0;0
1474860;Rotatex 2;;20,000 - 50,000;20;2;18;0;0;0
1474880;Cash Horse - Match 3 Puzzle Adventure;;0 - 20,000;23;6;17;0;0;0
1474940;Royal Roads 2 The Magic Box;;0 - 20,000;5;0;5;0;0;0
1474990;Deceased;;100,000 - 200,000;12;12;0;0;0;0
1475000;Laser Burst;;0 - 20,000;2;0;2;0;0;0
1475080;Relaxing Kite;;0 - 20,000;23;0;23;0;0;0
1475100;Double Jump;;0 - 20,000;4;0;4;0;0;0
1475140;Green Marquis;;0 - 20,000;16;6;10;0;0;0
1475150;White Rabbit;;0 - 20,000;10;5;5;0;0;0
1475160;Moi Mei 2;;0 - 20,000;21;14;7;0;0;0
1475170;Boots Versus Plants;;0 - 20,000;19;7;12;0;0;0
1475180;XPock;;0 - 20,000;15;4;11;0;0;0
1475200;Pickup Basketball VR;;0 - 20,000;62;13;49;0;0;1
1475200;Pickup Basketball VR;;0 - 20,000;62;13;49;0;0;1
1475250;Tiny Strife;;0 - 20,000;2;0;2;0;0;0
1475260;A Murmur in the Trees;;0 - 20,000;15;2;13;0;0;0
1475350;Breath;;0 - 20,000;9;0;9;0;0;0
1475380;TheDawn;;500,000 - 1,000,000;7520;566;6954;0;0;5
1475400;Run Prop, Run!;;50,000 - 100,000;570;130;440;0;0;9
1475420;Puzzling Peaks EXE;;0 - 20,000;14;0;14;0;0;0
1475430;天师;;0 - 20,000;223;148;75;0;0;27
1475430;天师;;0 - 20,000;223;148;75;0;0;27
1475440;REVISITOR;;0 - 20,000;40;1;39;0;0;1
1475440;REVISITOR;;0 - 20,000;40;1;39;0;0;1
1475460;3 Minute Heroes;;0 - 20,000;178;25;153;0;0;1
1475470;Space Sprinter VR;;0 - 20,000;1;0;1;0;0;0
1475570;Shadowbane;;100,000 - 200,000;294;129;165;0;0;20
1475600;The Santa Paradox;;0 - 20,000;1;1;0;0;0;0
1475650;12 Labours of Hercules XII: Timeless Adventure;;0 - 20,000;12;2;10;0;0;7
1475670;Invincible Cleopatra: Caesar's Dreams;;0 - 20,000;3;3;0;0;0;0
1475700;Arcade Game Machine Basketball;;0 - 20,000;4;0;4;0;0;0
1475740;Wonder Cave;;0 - 20,000;11;8;3;0;0;0
1475770;大正ゾンビろまん（プラス）;;0 - 20,000;2;0;2;0;0;0
1475780;Battle Strike World War;;0 - 20,000;19;0;19;0;0;0
1475810;Ghostwire: Tokyo;;200,000 - 500,000;9690;2010;7680;467;338;923
1475840;Rhythm Sprout: Sick Beats & Bad Sweets;;0 - 20,000;246;11;235;0;0;21
1475850;Rugby 22;;0 - 20,000;148;55;93;0;0;28
1475890;Mandinga - A Tale of Banzo;;20,000 - 50,000;31;3;28;0;0;0
1475960;Shindig;;0 - 20,000;39;1;38;0;0;0
1475970;Defentron;;0 - 20,000;19;4;15;0;0;1
1475970;Defentron;;0 - 20,000;19;4;15;0;0;1
1476080;Grow Big (or Go Home): Ultimate Edition;;20,000 - 50,000;12;0;12;0;0;0
1476100;A Rogue Escape;;0 - 20,000;27;5;22;0;0;0
1476140;Night Stalkers;;0 - 20,000;1;2;-1;0;0;0
1476160;Adventures of Sadukar - Chapter I;;0 - 20,000;1;1;0;0;0;0
1476170;Godstrike;;0 - 20,000;99;34;65;0;0;1
1476220;Catch a cat for 60 seconds;;20,000 - 50,000;6;0;6;0;0;0
1476230;Elmarion: the Lost Temple;;0 - 20,000;77;15;62;0;0;0
1476330;古龙传说;;20,000 - 50,000;6;3;3;0;0;1
1476340;The Adventure of NAYU;;50,000 - 100,000;1168;45;1123;86;86;2
1476350;Brain Meltdown - Into Despair;;0 - 20,000;187;12;175;152;152;1
1476390;The King of the Oceans;;0 - 20,000;2;2;0;0;0;0
1476410;Slidungeon;;0 - 20,000;5;0;5;0;0;0
1476420;ANIME Street Fight;;0 - 20,000;11;7;4;0;0;0
1476430;S.U.M. - Slay Uncool Monsters;;20,000 - 50,000;108;6;102;0;0;1
1476520;GunSoul Girl;;50,000 - 100,000;1059;356;703;105;163;1
1476680;A World of Little Legends;;0 - 20,000;54;10;44;0;0;0
1476690;15 puzzle;;0 - 20,000;10;8;2;0;0;0
1476720;Retro Run;;500,000 - 1,000,000;3;0;3;0;0;0
1476750;You are alone;;0 - 20,000;3;0;3;0;0;0
1476760;Amazing Fix;;20,000 - 50,000;31;1;30;0;0;8
1476800;Existensis;;0 - 20,000;36;1;35;0;0;0
1476830;Guillotine;;0 - 20,000;0;2;-2;0;0;0
1476850;Sea of Blood;;0 - 20,000;1;2;-1;0;0;0
1476890;Text Twisted Pro;;0 - 20,000;1;4;-3;0;0;0
1476920;football girl;;0 - 20,000;22;9;13;0;0;0
1476940;Skinwalkers;;20,000 - 50,000;3;6;-3;0;0;0
1476950;Planetary Control!;;0 - 20,000;7;1;6;0;0;0
1476970;Legends of IdleOn - Idle MMO;;500,000 - 1,000,000;8949;1073;7876;532;159;7603
1477000;Starship Turd Nugget: Too Cool For Stool;;20,000 - 50,000;6;0;6;0;0;0
1477020;Wordle 4;;0 - 20,000;57;41;16;0;0;0
1477020;Wordle 4;;0 - 20,000;57;41;16;0;0;0
1477050;Grim wanderings 2;;100,000 - 200,000;57;17;40;0;0;2
1477070;Depersonalization;;200,000 - 500,000;2432;170;2262;129;185;125
1477120;REVENGER;;0 - 20,000;1;2;-1;0;0;0
1477210;BoatMan;;0 - 20,000;2;4;-2;0;0;0
1477250;Puff Puff The Magic Pipe;;0 - 20,000;4;0;4;0;0;0
1477300;Ninja Blast;;0 - 20,000;2;3;-1;0;0;0
1477320;Warring States;;20,000 - 50,000;2;3;-1;0;0;0
1477330;Soulestination;;100,000 - 200,000;453;43;410;0;0;7
1477440;Mahjong Solitaire 100;;0 - 20,000;3;0;3;0;0;0
1477560;PetrifactionUnderRuin;;0 - 20,000;1;0;1;0;0;0
1477570;Gunspell 2 – Match 3 Puzzle RPG;;50,000 - 100,000;55;52;3;0;0;6
1477590;EZ2ON REBOOT : R;;50,000 - 100,000;4155;560;3595;2022;2922;361
1477630;Swing Dunk;;100,000 - 200,000;340;117;223;0;0;9
1477640;The Last Islands of Man;;0 - 20,000;2;1;1;0;0;0
1477650;VR Jurassic Escape;;0 - 20,000;33;21;12;0;0;0
1477660;VR Atlantis Search: with Deep Diving;;0 - 20,000;3;0;3;0;0;0
1477700;Project Wunderwaffe;;20,000 - 50,000;193;111;82;0;0;5
1477730;Extreme Soccer;;0 - 20,000;59;35;24;0;0;0
1477770;Shokuo Shoujo;;0 - 20,000;219;68;151;0;0;1
1477790;Luna's Fishing Garden;;20,000 - 50,000;1320;63;1257;24;24;20
1477830;HudSight - custom crosshair overlay;;100,000 - 200,000;1619;198;1421;3904;4023;812
1477850;Millennium Atoll;;20,000 - 50,000;2;0;2;0;0;0
1477870;Elemental;;50,000 - 100,000;11;3;8;0;0;0
1477880;Super tanks RPG;;0 - 20,000;15;3;12;0;0;0
1477900;Ricky did nothing wrong;;100,000 - 200,000;5;2;3;0;0;0
1477920;Night Book;;20,000 - 50,000;246;115;131;0;0;2
1477950;Lazy Galaxy 2;;0 - 20,000;116;26;90;0;0;12
1477980;Freud's Bones-the game;;0 - 20,000;50;5;45;0;0;0
1478030;Mambo Wave;;0 - 20,000;74;4;70;0;0;0
1478030;Mambo Wave;;0 - 20,000;74;4;70;0;0;0
1478050;Exploratombe;;20,000 - 50,000;170;57;113;0;0;3
1478070;Fights in Tight Spaces (Prologue);;100,000 - 200,000;752;41;711;53;59;1
1478080;Omi Domini;;0 - 20,000;2;1;1;0;0;0
1478080;Omi Domini;;0 - 20,000;2;1;1;0;0;0
1478160;Nyaruru Fishy Fight;;20,000 - 50,000;629;46;583;471;471;1
1478180;The Legion of Maelstrom;;0 - 20,000;26;0;26;0;0;0
1478210;Scramble;;0 - 20,000;6;1;5;0;0;0
1478220;Puzzle Together;;200,000 - 500,000;2965;412;2553;0;0;245
1478240;The Wormaid;;0 - 20,000;11;0;11;0;0;0
1478310;Alien Life Simulator;;0 - 20,000;9;3;6;0;0;0
1478320;Parallel Shift;;0 - 20,000;23;1;22;0;0;0
1478340;Turbo Sliders Unlimited;;100,000 - 200,000;64;8;56;0;0;0
1478350;Game Dev Masters;;0 - 20,000;115;17;98;0;0;1
1478410;像素男友 语音完整版;;0 - 20,000;232;7;225;0;0;1
1478420;Poco In Dungeon;;0 - 20,000;13;4;9;0;0;0
1478440;Perfect Decision;;0 - 20,000;11;12;-1;0;0;0
1478470;Fishy But In 2.5D;;20,000 - 50,000;7;3;4;0;0;0
1478480;Fizik;;0 - 20,000;4;0;4;0;0;0
1478590;Enemy Remains;;20,000 - 50,000;16;6;10;0;0;0
1478600;Amulet of Time: Shadow of La Rochelle;;0 - 20,000;36;15;21;0;0;1
1478620;Return of the Heir;;0 - 20,000;13;1;12;0;0;0
1478630;Brutality club;;0 - 20,000;1;2;-1;0;0;0
1478650;Diggles: The Myth of Fenris;;100,000 - 200,000;413;51;362;815;815;8
1478670;Smashing time;;0 - 20,000;22;20;2;0;0;0
1478780;You Are Weak;;0 - 20,000;6;1;5;0;0;0
1478830;Baobabs Mausoleum Grindhouse Edition - Country of Woods and Creepy Tales;;0 - 20,000;3;7;-4;0;0;0
1478880;Sep's Diner;;0 - 20,000;9;0;9;0;0;0
1478980;Pinball;;0 - 20,000;3;2;1;0;0;0
1479000;Shredded Secrets;;0 - 20,000;4;0;4;0;0;0
1479010;Christmas day;;0 - 20,000;5;2;3;0;0;0
1479020;Life of A Yandere Simp;;0 - 20,000;8;1;7;0;0;0
1479030;2ECONDS TO STΔRLIVHT: My Heart's Reflection;;0 - 20,000;71;11;60;0;0;0
1479050;Aggressive Robot Vacuum;;0 - 20,000;4;6;-2;0;0;0
1479090;The Cruel Dreamer Marchosias;;0 - 20,000;1;1;0;0;0;0
1479100;Worst Nightmare;;0 - 20,000;1;3;-2;0;0;0
1479170;Meatball;;0 - 20,000;71;19;52;0;0;0
1479210;Hustomten;;20,000 - 50,000;5;1;4;0;0;0
1479310;Spare Parts: Episode 1;;0 - 20,000;24;0;24;0;0;1
1479340;Derelict Void;;0 - 20,000;31;18;13;0;0;0
1479370;Pixel Game Maker Series Werewolf Princess Kaguya;;0 - 20,000;11;0;11;0;0;0
1479390;Alekon;;0 - 20,000;86;3;83;0;0;0
1479400;Riffle Effect;;20,000 - 50,000;13;0;13;0;0;1
1479460;Naginata;;20,000 - 50,000;25;5;20;0;0;0
1479470;Maniac Path 2;;0 - 20,000;16;4;12;0;0;0
1479480;Polity;;100,000 - 200,000;31;15;16;0;0;0
1479500;Rail of Möbius;;50,000 - 100,000;361;14;347;0;0;1
1479530;On Closer Inspection;;0 - 20,000;7;1;6;0;0;0
1479540;Dragon Mission;;0 - 20,000;16;1;15;0;0;0
1479610;Planeta;;0 - 20,000;11;4;7;0;0;0
1479750;KINESIS;;0 - 20,000;5;1;4;0;0;0
1479760;NA.NO;;0 - 20,000;2;0;2;0;0;0
1479830;Gem Deeps;;0 - 20,000;7;1;6;0;0;0
1479840;Vidya Poker;;0 - 20,000;13;0;13;0;0;0
1479850;Chompy Chomp Chomp Party;;100,000 - 200,000;1;0;1;0;0;1
1479870;Schoolmates: The Mystery of the Magical Bracelet;;0 - 20,000;4;5;-1;0;0;0
1479880;Role of Hex;;0 - 20,000;10;2;8;0;0;0
1479890;Inua - A Story in Ice and Time;;0 - 20,000;32;3;29;0;0;0
1479910;Monstrous Molecules;;0 - 20,000;1;0;1;0;0;0
1479940;Fragments;;50,000 - 100,000;22;5;17;0;0;1
1479960;Arcus;;20,000 - 50,000;33;1;32;0;0;0
1479980;Dragon Saddle Melee;;0 - 20,000;13;0;13;0;0;0
1480010;Christmas Stories: The Christmas Tree Forest Collector's Edition;;0 - 20,000;15;0;15;0;0;2
1480020;Pripyat-3;;0 - 20,000;7;11;-4;0;0;0
1480030;A Way To Be Dead;;0 - 20,000;66;27;39;0;0;0
1480050;Survival RPG: The Lost Treasure;;0 - 20,000;15;2;13;0;0;0
1480050;Survival RPG: The Lost Treasure;;0 - 20,000;15;2;13;0;0;0
1480120;100 hidden eternals;;50,000 - 100,000;319;24;295;128;192;1
1480140;RPG Sounds;;20,000 - 50,000;82;4;78;0;0;5
1480190;Salyut π;;20,000 - 50,000;1;0;1;0;0;0
1480210;The Garden of Orilon;;50,000 - 100,000;1;0;1;0;0;0
1480240;You Pilot A Piece Of S***: GAIDEN;;0 - 20,000;4;1;3;0;0;0
1480240;You Pilot A Piece Of S***: GAIDEN;;0 - 20,000;4;1;3;0;0;0
1480260;Rathe: The Beginning;;50,000 - 100,000;0;1;-1;0;0;0
1480340;A traveler's photo album;;50,000 - 100,000;663;240;423;27;35;0
1480370;Love Puzzle;;50,000 - 100,000;135;138;-3;7;7;1
1480400;Ramses: Rise of Empire;;0 - 20,000;5;2;3;0;0;0
1480410;Sentinel: Cursed Knight;;100,000 - 200,000;15;4;11;0;0;1
1480440;Desktop NEKO Girl;;0 - 20,000;31;9;22;0;0;1
1480470;Go! Birdie;;0 - 20,000;8;0;8;0;0;0
1480480;DesktopMMD3:Miss Fish;;20,000 - 50,000;176;73;103;7;7;4
1480520;Faye/Sleepwalker;;0 - 20,000;21;9;12;0;0;0
1480540;FICTION #F3F;;0 - 20,000;34;4;30;0;0;0
1480570;Finding Alina;;0 - 20,000;5;2;3;0;0;0
1480600;Red Hands – 2-Player Game;;20,000 - 50,000;5;1;4;0;0;0
1480630;Memory Maze;;0 - 20,000;6;0;6;0;0;0
1480650;A Very Bad Christmas Eve;;0 - 20,000;11;12;-1;0;0;0
1480690;Pangea;;20,000 - 50,000;5;1;4;0;0;0
1480740;Doomsday Room;;0 - 20,000;11;2;9;0;0;0
1480830;Evil Tonight;;0 - 20,000;235;26;209;0;0;1
1480860;Tortuga;;0 - 20,000;1;0;1;0;0;0
1480870;Lightning Fast;;0 - 20,000;41;52;-11;0;0;0
1480910;Tomb of The Lost Sentry;;20,000 - 50,000;8;0;8;0;0;0
1480930;Monkey Split;;0 - 20,000;73;18;55;0;0;0
1480960;Godsbane;;0 - 20,000;96;21;75;0;0;1
1480970;Brandins Buttons;;0 - 20,000;3;0;3;0;0;0
1481000;Triversal;;0 - 20,000;22;1;21;0;0;0
1481020;Without my arms;;0 - 20,000;14;0;14;0;0;0
1481030;Cafe Simulator;;0 - 20,000;1;2;-1;0;0;0
1481060;The Dark World: Edge of Eternity;;0 - 20,000;20;7;13;0;0;0
1481060;The Dark World: Edge of Eternity;;0 - 20,000;20;7;13;0;0;0
1481070;Max Raider;;20,000 - 50,000;2;0;2;0;0;0
1481080;DRAMAtical Murder;;50,000 - 100,000;1694;65;1629;0;0;30
1481120;Re-Nullum;;0 - 20,000;17;0;17;0;0;0
1481140;Lost Astronaut;;0 - 20,000;25;1;24;0;0;0
1481150;Weltreich: Political Strategy Simulator;;0 - 20,000;4;3;1;0;0;1
1481160;The Astronomy Game;;0 - 20,000;4;0;4;0;0;0
1481210;Psychoscopy;;0 - 20,000;19;3;16;0;0;0
1481310;TeamJumpers 2: New Reality;;0 - 20,000;4;1;3;0;0;0
1481360;Move Forward;;0 - 20,000;4;2;2;0;0;0
1481430;No Sushi, No Life;;20,000 - 50,000;2;3;-1;0;0;0
1481440;Guardians VR;;0 - 20,000;81;9;72;0;0;1
1481480;Tank Firing;;0 - 20,000;0;1;-1;0;0;0
1481550;Resistance: The 8th Wave;;0 - 20,000;8;7;1;0;0;0
1481580;Milkyway Funland;;0 - 20,000;8;9;-1;0;0;0
1481600;Fake Racing;;0 - 20,000;8;1;7;0;0;0
1481660;Sun Girls;;0 - 20,000;4;0;4;0;0;0
1481670;Hollywood Hero;;0 - 20,000;11;16;-5;0;0;0
1481680;Lab Craft Survival;;0 - 20,000;24;7;17;0;0;0
1481710;pleXus VR;;0 - 20,000;5;1;4;0;0;0
1481720;ShemHaMephorash;;0 - 20,000;13;0;13;0;0;0
1481720;ShemHaMephorash;;0 - 20,000;13;0;13;0;0;0
1481730;Cosmo Clash;;0 - 20,000;2;0;2;0;0;0
1481780;Dragon Fist: VR Kung Fu;;0 - 20,000;265;13;252;51;55;2
1481810;Ostrich Runner;;0 - 20,000;30;5;25;0;0;0
1481840;Frisbros;;0 - 20,000;7;1;6;0;0;0
1481870;Emanate;;0 - 20,000;3;0;3;0;0;0
1481880;Invincible Fins;;0 - 20,000;1;0;1;0;0;0
1481930;Trajectory Fracture;;0 - 20,000;2;0;2;0;0;0
1481940;Medium: The Psychic Party Game;;0 - 20,000;0;1;-1;0;0;0
1481960;Death off the Cuff;;20,000 - 50,000;5;1;4;0;0;0
1481970;Drugs and Crime Idle;;20,000 - 50,000;154;63;91;0;0;4
1482050;Space Ship Infinity;;0 - 20,000;16;3;13;0;0;0
1482090;La légende des Diamétis, la quête de Chloé;;0 - 20,000;0;2;-2;0;0;0
1482130;Teodoro;;0 - 20,000;34;1;33;0;0;0
1482320;琉隐;;0 - 20,000;73;34;39;0;0;1
1482330;MECHA AND TANK FIGHTING;;20,000 - 50,000;13;1;12;0;0;0
1482340;Battle Bears -1;;0 - 20,000;84;3;81;0;0;0
1482420;Insect: Bombardier beetle;;0 - 20,000;2;1;1;0;0;0
1482430;Simona's Requiem;;0 - 20,000;36;0;36;0;0;0
1482450;Rosy Manga;;0 - 20,000;5;4;1;0;0;0
1482510;Tap-Tap Adventure;;0 - 20,000;2;2;0;0;0;0
1482530;GeometryBricks;;0 - 20,000;8;0;8;0;0;0
1482550;I Am the Captain Now;;0 - 20,000;3;1;2;0;0;0
1482610;Critical Damage;;0 - 20,000;15;1;14;0;0;0
1482610;Critical Damage;;0 - 20,000;15;1;14;0;0;0
1482640;Nurose;;0 - 20,000;69;10;59;0;0;0
1482640;Nurose;;0 - 20,000;69;10;59;0;0;0
1482670;Oscillate;;0 - 20,000;4;4;0;0;0;0
1482680;The Day They Came;;0 - 20,000;2;6;-4;0;0;0
1482700;Speed Stars;;0 - 20,000;31;2;29;0;0;7
1482710;Samurai Revenge;;0 - 20,000;18;5;13;0;0;1
1482720;The Scary Square;;0 - 20,000;19;12;7;0;0;1
1482730;Hollywood Hero: Comeback;;0 - 20,000;5;9;-4;0;0;0
1482740;Atomic Guardians;;0 - 20,000;4;0;4;0;0;0
1482750;Waves of Steel;;0 - 20,000;252;25;227;253;253;25
1482780;Eggineer;;0 - 20,000;1;1;0;0;0;0
1482790;ZooSim;;0 - 20,000;0;1;-1;0;0;0
1482800;Faraway Qualia;;0 - 20,000;9;0;9;0;0;1
1482830;Ho-Ho-Home Invasion;;0 - 20,000;95;6;89;0;0;0
1482850;Big Adventure Of Fighting Chicken;;0 - 20,000;5;2;3;0;0;0
1482860;Idle Research;;100,000 - 200,000;850;132;718;0;0;220
1482870;Midnight Legends;;0 - 20,000;32;1;31;0;0;0
1482910;Idle Monster TD;;50,000 - 100,000;522;187;335;0;0;74
1482940;Rumours From Elsewhere;;20,000 - 50,000;12;0;12;0;0;0
1482970;Limb Hunter;;20,000 - 50,000;14;1;13;0;0;1
1482980;Theater of Carnage;;0 - 20,000;2;0;2;0;0;0
1483010;Fight For Eden;;20,000 - 50,000;7;6;1;0;0;0
1483020;Redneck Rift;;0 - 20,000;1;1;0;0;0;0
1483030;Debatto: Delivery Battle;;0 - 20,000;5;1;4;0;0;0
1483040;Hexagon puzzle;;0 - 20,000;20;0;20;0;0;0
1483060;Cube Paradox;;0 - 20,000;15;1;14;0;0;0
1483060;Cube Paradox;;0 - 20,000;15;1;14;0;0;0
1483100;One More Dungeon 2;;0 - 20,000;91;14;77;19;19;2
1483110;Alien AI;;50,000 - 100,000;9;8;1;0;0;0
1483130;Puzlkind;;0 - 20,000;14;3;11;0;0;0
1483140;The Trap;;0 - 20,000;4;0;4;0;0;0
1483300;MazM: The Phantom of the Opera;;0 - 20,000;36;14;22;0;0;1
1483310;大禹治水 Flood Fighting Hero;;20,000 - 50,000;60;8;52;0;0;0
1483330;Dice Rollers;;0 - 20,000;23;11;12;0;0;0
1483340;极限挑战（Challenge Of Limits）;;0 - 20,000;0;1;-1;0;0;0
1483350;Diving Disorder-下潜症;;0 - 20,000;115;11;104;0;0;0
1483360;VR Library: Beyond Reading;;0 - 20,000;2;0;2;0;0;1
1483370;The Use of Life;;0 - 20,000;236;17;219;0;0;3
1483400;Heroic Adventures;;0 - 20,000;5;21;-16;0;0;0
1483470;Catty & Batty: The Spirit Guide;;0 - 20,000;31;0;31;0;0;0
1483570;Lost Lands: Redemption;;0 - 20,000;34;7;27;0;0;3
1483580;Death Ski;;0 - 20,000;7;0;7;0;0;0
1483600;逢魔之時;;50,000 - 100,000;3;1;2;0;0;0
1483610;GravitreX Arcade;;0 - 20,000;9;1;8;0;0;0
1483780;Tested on Humans: Escape Room;;50,000 - 100,000;293;39;254;101;101;1
1483800;Adventure Llama;;0 - 20,000;34;0;34;0;0;0
1483860;Super Space Serpent SE;;0 - 20,000;2;1;1;0;0;0
1483870;Draw & Guess;;1,000,000 - 2,000,000;24187;4396;19791;416;304;1008
1483890;Loopomotive;;0 - 20,000;21;4;17;0;0;0
1483940;Slide Stories: Bonds & Memories;;0 - 20,000;27;0;27;0;0;0
1483970;Nullmaze;;0 - 20,000;9;3;6;0;0;0
1483980;Phi;;0 - 20,000;81;15;66;0;0;0
1484010;Farty Bird;;0 - 20,000;1;0;1;0;0;0
1484030;Raw Element;;20,000 - 50,000;9;19;-10;0;0;3
1484050;MADE : Interactive Movie – 01. Run away!;;0 - 20,000;23;19;4;0;0;0
1484100;Matt's Project Zombies: Endless;;20,000 - 50,000;4;0;4;0;0;0
1484130;S-IN;;0 - 20,000;25;0;25;0;0;0
1484150;VR Museum Tour Grand Collection;;0 - 20,000;2;2;0;0;0;0
1484250;All is Fair in Dust and Air;;0 - 20,000;9;2;7;0;0;0
1484280;Demeo;;50,000 - 100,000;1257;105;1152;222;293;33
1484580;The First Friend;;0 - 20,000;19;9;10;0;0;0
1484600;Stand By Me;;0 - 20,000;20;0;20;0;0;0
1484610;YABAI MANTIS VR;;0 - 20,000;2;1;1;0;0;0
1484620;Arcade Spirits: The New Challengers;;0 - 20,000;95;5;90;0;0;3
1484660;Drabidiboo;;0 - 20,000;2;0;2;0;0;0
1484680;CrazyFlasher7 Mercenary Empire;;50,000 - 100,000;167;384;-217;0;0;37
1484720;Dead Estate;;100,000 - 200,000;2659;141;2518;448;431;378
1484730;Papa's Quiz;;0 - 20,000;78;6;72;0;0;1
1484740;Space Abyss;;0 - 20,000;4;2;2;0;0;0
1484750;Maze Escape;;0 - 20,000;0;1;-1;0;0;0
1484800;Zardy's Maze;;100,000 - 200,000;1135;96;1039;0;0;7
1484900;Hoa;;50,000 - 100,000;1720;184;1536;79;79;7
1484960;Escape to Moscow;;20,000 - 50,000;308;50;258;0;0;0
1484970;Shoot Your Friends;;0 - 20,000;2;0;2;0;0;0
1484980;Super Huey 1 & 2 Airdrop;;0 - 20,000;2;0;2;0;0;0
1485030;Tobari 2: Nightmare;;0 - 20,000;7;0;7;0;0;0
1485050;NANOCELLS - Mission: Back Home;;20,000 - 50,000;28;3;25;0;0;0
1485070;Esse Proxy;;0 - 20,000;84;22;62;0;0;0
1485120;BoomBox;;0 - 20,000;132;13;119;0;0;0
1485140;Ultrawings 2;;0 - 20,000;64;19;45;0;0;0
1485250;Frame of Mind;;50,000 - 100,000;716;37;679;0;0;2
1485260;Visitations;;0 - 20,000;33;5;28;0;0;0
1485280;Demian: The Ritual;;0 - 20,000;21;7;14;0;0;0
1485340;Game Of Mafia;;0 - 20,000;85;16;69;0;0;0
1485350;Mech Mechanic Simulator: Prologue;;20,000 - 50,000;89;29;60;0;0;1
1485370;Futuclass Hub;;0 - 20,000;3;3;0;0;0;1
1485380;iGuide Knossos VR;;0 - 20,000;2;0;2;0;0;0
1485450;Free Kick X;;0 - 20,000;36;7;29;0;0;0
1485580;Chess Valley;;0 - 20,000;29;3;26;0;0;0
1485600;Pipo Park;;0 - 20,000;8;3;5;0;0;0
1485630;Colonials Programme;;20,000 - 50,000;14;2;12;0;0;0
1485650;Zen World;;0 - 20,000;41;9;32;0;0;1
1485730;Dash Hale;;0 - 20,000;3;2;1;0;0;0
1485760;RunningMarty;;0 - 20,000;1;2;-1;0;0;0
1485860;Isekai: Reincarnation in a New World;;0 - 20,000;5;2;3;0;0;0
1485860;Isekai: Reincarnation in a New World;;0 - 20,000;5;2;3;0;0;0
1485870;Evil Inside - Prologue;;200,000 - 500,000;521;216;305;0;0;12
1485900;Eye, caramba!;;0 - 20,000;37;1;36;0;0;0
1485940;CATTCH;;0 - 20,000;2;1;1;0;0;0
1485970;SIK Space Invader Kreature;;20,000 - 50,000;7;1;6;0;0;0
1485980;Orpheus: Fall For Eurydice;;0 - 20,000;3;0;3;0;0;0
1486030;Hollow Witch;;0 - 20,000;18;4;14;0;0;1
1486050;Let's Learn Shogi;;0 - 20,000;13;5;8;0;0;0
1486080;Time Master;;0 - 20,000;62;2;60;0;0;0
1486120;2020: THE RIDE;;20,000 - 50,000;24;15;9;0;0;0
1486180;Weatherworn: The Adventure of Pap & Pup;;0 - 20,000;2;0;2;0;0;0
1486190;StreamSavers;;0 - 20,000;4;1;3;0;0;0
1486270;Agent of Chaos;;;;;0;;;
1486280;The Backrooms: Mass Extinction;;0 - 20,000;35;21;14;0;0;0
1486330;VR探索梅西爾;;0 - 20,000;3;4;-1;0;0;0
1486350;VRoid Studio v0.13.1;;200,000 - 500,000;2709;157;2552;364;107;552
1486430;约会模拟器：原型;;0 - 20,000;5;1;4;0;0;0
1486440;Graze Counter GM;;0 - 20,000;69;1;68;0;0;1
1486520;Mermaid Adventures: The Magic Pearl;;0 - 20,000;16;5;11;0;0;0
1486540;VR Skydiving;;0 - 20,000;7;6;1;0;0;0
1486620;Live Inc.;;20,000 - 50,000;84;24;60;0;0;0
1486630;Intravenous;;50,000 - 100,000;1421;121;1300;117;171;23
1486660;Dragon VR;;50,000 - 100,000;65;33;32;0;0;3
1486670;Shadow Lost;;0 - 20,000;5;5;0;0;0;0
1486690;Flower in the Snow - Resurrection;;0 - 20,000;63;3;60;0;0;2
1486750;传奇世界之仗剑天涯H5;;20,000 - 50,000;40;46;-6;0;0;0
1486790;Portal Mortal;;0 - 20,000;19;0;19;0;0;1
1486800;Chess Knights: High Noon;;20,000 - 50,000;28;13;15;0;0;0
1486840;SantaCraft;;0 - 20,000;83;1;82;0;0;0
1486860;Penelope;;0 - 20,000;0;1;-1;0;0;0
1486870;Hiddenverse: Ominous Opus;;20,000 - 50,000;1;9;-8;0;0;0
1486890;Slide Mini;;0 - 20,000;12;6;6;0;0;0
1486950;The Underground Man 2;;0 - 20,000;106;13;93;0;0;0
1486970;PetDrivr;;0 - 20,000;2;1;1;0;0;0
1487030;Cygnus Pizza Race;;0 - 20,000;17;0;17;0;0;0
1487080;DressMaker;;0 - 20,000;2;7;-5;0;0;0
1487100;Lost to Time;;0 - 20,000;7;1;6;0;0;0
1487100;Lost to Time;;0 - 20,000;7;1;6;0;0;0
1487120;Monkey Doomsday;;20,000 - 50,000;36;5;31;0;0;0
1487140;Ochitsubaki;;0 - 20,000;3;1;2;0;0;0
1487160;Ultimate Battle;;20,000 - 50,000;2;1;1;0;0;0
1487230;FutureKreate;;0 - 20,000;1;0;1;0;0;0
1487270;Last Command;;20,000 - 50,000;1204;41;1163;155;229;23
1487320;Astro Sentai Jarbonder;;50,000 - 100,000;21;6;15;0;0;0
1487360;dstnce.;;0 - 20,000;21;0;21;0;0;0
1487360;dstnce.;;0 - 20,000;21;0;21;0;0;0
1487390;ANVIL;;100,000 - 200,000;1298;752;546;1114;1163;7
1487420;Wilhelm Gustloff's Death;;0 - 20,000;12;3;9;0;0;0
1487430;Muse:Night Out;;0 - 20,000;130;112;18;58;70;0
1487440;Live Labyrinth;;20,000 - 50,000;10;5;5;0;0;0
1487450;迷禁 Lost in Abyss;;0 - 20,000;27;3;24;0;0;0
1487460;Battle Bears 1: Zombies;;0 - 20,000;19;3;16;0;0;0
1487460;Battle Bears 1: Zombies;;0 - 20,000;19;3;16;0;0;0
1487470;秋田・男鹿ミステリー案内 凍える銀鈴花;;0 - 20,000;5;4;1;0;0;0
1487520;蘑菇的冒险 MoGu's Adventure;;0 - 20,000;2;1;1;0;0;0
1487560;StarCrawlers Chimera;;100,000 - 200,000;16;3;13;0;0;13
1487590;Yoshiwara Higanbana;;0 - 20,000;248;17;231;0;0;2
1487610;ISLAND MIRRORGE VR;;0 - 20,000;6;1;5;0;0;0
1487620;VikingStory;;0 - 20,000;1;4;-3;0;0;0
1487640;16-Bit Soccer;;0 - 20,000;5;1;4;0;0;0
1487650;VR Plant Journey;;0 - 20,000;1;0;1;0;0;0
1487680;Broken Universe - Tower Defense;;20,000 - 50,000;185;17;168;0;0;83
1487730;Carperation;;0 - 20,000;4;0;4;0;0;0
1487740;Mobile Soldiers: Plastic Army;;0 - 20,000;0;1;-1;0;0;0
1487840;Chess Destroyer;;0 - 20,000;17;2;15;0;0;0
1487870;Putin kills: Christmas;;0 - 20,000;34;6;28;0;0;1
1487900;Beastie Land;;0 - 20,000;7;1;6;0;0;0
1487940;Nuumonsters;;0 - 20,000;22;8;14;0;0;0
1487990;Relax Memory Game;;0 - 20,000;2;5;-3;0;0;0
1488000;Zone Of War;;0 - 20,000;1;0;1;0;0;0
1488020;Bird;;0 - 20,000;5;5;0;0;0;0
1488040;EPEJSODION Dodgeball Speed;;0 - 20,000;1;0;1;0;0;0
1488050;Beyond The Diorama: Caribou World;;0 - 20,000;4;0;4;0;0;0
1488060;Lasertron;;0 - 20,000;1;1;0;0;0;0
1488070;Vesper: Ether Saga - Episode 1;;20,000 - 50,000;4;0;4;0;0;0
1488100;IncrediMarble;;0 - 20,000;68;5;63;0;0;1
1488110;Puzzle Box;;0 - 20,000;4;0;4;0;0;0
1488150;Twinstick Arcade;;0 - 20,000;4;0;4;0;0;0
1488160;The Deed of Deception;;0 - 20,000;1;0;1;0;0;0
1488170;Mediterranean Assault: 1943;;0 - 20,000;1;1;0;0;0;0
1488200;Symphony of War: The Nephilim Saga;;200,000 - 500,000;6091;283;5808;1015;1473;3620
1488220;VR Brewing Simulator;;0 - 20,000;1;0;1;0;0;0
1488250;幻想啟示錄;;0 - 20,000;1;0;1;0;0;0
1488380;Superstar Racing;;20,000 - 50,000;93;64;29;0;0;0
1488420;Wind from city;;50,000 - 100,000;2;0;2;0;0;0
1488430;Fueled Up;;0 - 20,000;64;19;45;25;25;4
1488500;The Adventures on Uranus;;0 - 20,000;3;0;3;0;0;0
1488560;Football Simulator;;0 - 20,000;183;39;144;0;0;8
1488620;Blind Shot;;20,000 - 50,000;16;1;15;0;0;0
1488640;Wholesome Slaughter;;200,000 - 500,000;38;3;35;0;0;0
1488650;Velocity Noodle;;0 - 20,000;33;2;31;0;0;0
1488670;Physics Cake;;0 - 20,000;6;2;4;0;0;0
1488700;CABARET 4 CARD;;0 - 20,000;1;0;1;0;0;0
1488720;VR Mad Asylum;;0 - 20,000;1;1;0;0;0;0
1488730;VR Basketball Hoops;;0 - 20,000;1;1;0;0;0;0
1488740;The Best BJ;;0 - 20,000;9;1;8;0;0;2
1488750;VR Immortal Fight;;0 - 20,000;25;4;21;0;0;0
1488810;Rabbit Hole;;20,000 - 50,000;141;32;109;0;0;1
1488820;Dark Fantasy Warriors;;20,000 - 50,000;31;21;10;0;0;0
1488860;Insiders;;0 - 20,000;40;10;30;0;0;0
1488960;Something Strange in the Woods;;0 - 20,000;0;1;-1;0;0;0
1489000;The World's Hardest Game 3D;;0 - 20,000;18;0;18;0;0;0
1489000;The World's Hardest Game 3D;;0 - 20,000;18;0;18;0;0;0
1489010;The Picture in The House;;20,000 - 50,000;52;50;2;0;0;1
1489020;Eternal Secret;;20,000 - 50,000;3;0;3;0;0;0
1489060;InvaderSwarm;;0 - 20,000;9;14;-5;0;0;0
1489110;Zapling Bygone;;0 - 20,000;103;10;93;0;0;1
1489120;sunny-place;;0 - 20,000;83;4;79;0;0;0
1489160;Destinata RED;;0 - 20,000;2;2;0;0;0;0
1489220;Four Course Combat;;0 - 20,000;1;0;1;0;0;0
1489290;Dice and the Tower of the Reanimator: Glorious Princess;;0 - 20,000;28;4;24;0;0;0
1489300;Operation STEEL;;0 - 20,000;47;3;44;0;0;1
1489340;Retailer Tycoon;;0 - 20,000;1;1;0;0;0;0
1489380;Bad boy simulator;;0 - 20,000;36;21;15;0;0;0
1489390;Lost Angel;;20,000 - 50,000;23;16;7;0;0;0
1489400;Fortuito: Lost History;;50,000 - 100,000;41;10;31;0;0;0
1489410;Alice Escaped!;;0 - 20,000;115;20;95;0;0;8
1489470;Do You See the Waving Cape;;0 - 20,000;35;10;25;0;0;0
1489480;MUMMMASTER!;;0 - 20,000;9;2;7;0;0;0
1489500;Crowhille - Detective Case Files VR;;20,000 - 50,000;95;10;85;0;0;0
1489500;Crowhille - Detective Case Files VR;;20,000 - 50,000;95;10;85;0;0;0
1489520;Gun-REViper;;0 - 20,000;2;0;2;0;0;0
1489600;Nix Umbra;;20,000 - 50,000;70;6;64;0;0;1
1489610;Saturn Quest: Blast Effect;;0 - 20,000;7;2;5;0;0;0
1489630;Carrier Command 2;;50,000 - 100,000;1770;461;1309;110;144;73
1489660;Copy Editor: A RegEx Puzzle;;0 - 20,000;30;22;8;98;98;1
1489660;Copy Editor: A RegEx Puzzle;;0 - 20,000;30;22;8;98;98;1
1489680;Pixross;;0 - 20,000;39;1;38;0;0;0
1489690;Bakery Magnate: Online;;0 - 20,000;10;8;2;0;0;0
1489810;I Want to Fly;;0 - 20,000;20;1;19;0;0;0
1489820;Zombrio;;0 - 20,000;1;6;-5;0;0;0
1489850;Dispersio 2;;0 - 20,000;10;3;7;0;0;0
1489880;Orange Cast: Prologue;;100,000 - 200,000;43;60;-17;0;0;0
1489900;OUTSP4CE;;0 - 20,000;0;3;-3;0;0;0
1489970;Highrise City;;50,000 - 100,000;251;107;144;1244;1244;16
1490010;Phoenix Squadron: Northern Star;;50,000 - 100,000;7;9;-2;0;0;0
1490030;Cyber Dodge;;0 - 20,000;4;0;4;0;0;0
1490060;Disillusion;;0 - 20,000;84;14;70;0;0;1
1490130;CrashMetal - Cyberpunk;;50,000 - 100,000;306;147;159;0;0;2
1490180;For Sparta;;0 - 20,000;24;3;21;0;0;0
1490180;For Sparta;;0 - 20,000;24;3;21;0;0;0
1490190;Happy New Year, Zeliria!;;0 - 20,000;84;8;76;0;0;0
1490290;Ultra Imposer;;0 - 20,000;2;1;1;0;0;0
1490310;Gladiators IDLE;;0 - 20,000;23;8;15;0;0;0
1490330;Content Creator's Internet Adventure;;20,000 - 50,000;3;0;3;0;0;0
1490340;We Are OFK;;0 - 20,000;146;6;140;0;0;1
1490400;Disc Golf Adventure 2 VR;;0 - 20,000;2;9;-7;0;0;0
1490410;The fairy tale you don't know;;0 - 20,000;136;35;101;78;78;1
1490460;Exorcist Fairy;;20,000 - 50,000;190;84;106;0;0;0
1490490;Kingslayer: The First Assassin;;0 - 20,000;36;0;36;0;0;0
1490500;In Between;;0 - 20,000;0;1;-1;0;0;0
1490550;The Expanse;;0 - 20,000;0;1;-1;0;0;0
1490610;METALLIC CHILD;;50,000 - 100,000;970;152;818;1565;1565;5
1490620;Pray And Spray;;0 - 20,000;5;2;3;0;0;0
1490680;God Sword;;0 - 20,000;17;27;-10;0;0;19
1490790;Christmas Adventures: A Winter Night's Dream;;0 - 20,000;23;28;-5;0;0;0
1490790;Christmas Adventures: A Winter Night's Dream;;0 - 20,000;23;28;-5;0;0;0
1490840;Bloodshore;;20,000 - 50,000;355;130;225;122;122;4
1490850;KILLING A SUPERSTAR;;0 - 20,000;8;4;4;0;0;0
1490860;Til Nord;;50,000 - 100,000;430;87;343;0;0;6
1490870;Pale Night;;0 - 20,000;17;0;17;0;0;0
1490880;2D Owen;;0 - 20,000;2;0;2;0;0;0
1490890;Demon Slayer -Kimetsu no Yaiba- The Hinokami Chronicles;;500,000 - 1,000,000;13228;1771;11457;722;768;149
1490910;Fast Cubes;;0 - 20,000;15;1;14;0;0;0
1490970;Freaky Clown : Town Mystery;;;;;0;;;
1490980;Mirror Layers;;0 - 20,000;76;2;74;0;0;3
1491000;War Robots: Frontiers;;0 - 20,000;125;41;84;253;253;19
1491040;Binarystar Infinity;;0 - 20,000;25;2;23;0;0;0
1491050;Altarage;;0 - 20,000;3;1;2;0;0;0
1491090;Downslope;;0 - 20,000;19;2;17;0;0;0
1491120;Galaxy's Extreme;;50,000 - 100,000;6;2;4;0;0;0
1491150;100 Worlds - Escape Room Game;;0 - 20,000;13;8;5;0;0;3
1491170;Vertical Slice: A Game Dev Story;;0 - 20,000;222;92;130;0;0;0
1491180;Survival RPG 2: The Temple Ruins;;0 - 20,000;3;0;3;0;0;0
1491200;Few Nights More;;0 - 20,000;88;4;84;0;0;3
1491220;FartPart;;0 - 20,000;6;7;-1;0;0;0
1491280;Jane Angel 2: Fallen Heaven;;0 - 20,000;12;6;6;0;0;0
1491290;Discover;;20,000 - 50,000;3;0;3;0;0;0
1491290;Discover;;20,000 - 50,000;3;0;3;0;0;0
1491340;Marble World;;20,000 - 50,000;616;69;547;254;323;36
1491400;Sucker Punch VR;;0 - 20,000;10;1;9;0;0;1
1491460;Tor Eternum;;0 - 20,000;53;13;40;0;0;0
1491480;Grave Complex;;0 - 20,000;1;0;1;0;0;0
1491490;Cosmonious High;;0 - 20,000;173;5;168;357;357;3
1491510;Recon Control;;0 - 20,000;81;8;73;0;0;1
1491530;Mastermine;;0 - 20,000;15;2;13;0;0;0
1491540;MAP GAME: Or Something;;0 - 20,000;1;0;1;0;0;0
1491550;Accident On the Simple Rd;;0 - 20,000;23;12;11;0;0;0
1491570;Pesky Humans;;0 - 20,000;1;0;1;0;0;0
1491640;Understanding, The Game;;0 - 20,000;242;48;194;0;0;0
1491660;Nefasto's Misadventure: Meeting Noeroze;;0 - 20,000;1;0;1;0;0;0
1491680;Fiendish Thieves;;0 - 20,000;4;6;-2;0;0;0
1491710;CRIMESIGHT;;20,000 - 50,000;483;158;325;582;582;2
1491720;Frick, Inc.;;20,000 - 50,000;4;0;4;0;0;0
1491730;Cosmotronik;;50,000 - 100,000;4;1;3;0;0;0
1491770;KEEP OUT;;20,000 - 50,000;51;24;27;0;0;0
1491780;Bloody Paws Unleashed;;0 - 20,000;14;1;13;0;0;0
1491790;Atom;;0 - 20,000;17;4;13;0;0;0
1491850;ZombieWave-UnlimitedChallenges;;100,000 - 200,000;5;2;3;0;0;0
1491910;Andromeda 2 Zombies;;0 - 20,000;16;17;-1;0;0;0
1491950;BrightSeeker;;0 - 20,000;8;2;6;0;0;0
1491960;Time Storm;;0 - 20,000;16;0;16;0;0;0
1491980;Towards The Stars;;0 - 20,000;5;4;1;0;0;0
1492000;Unfolded : Camellia Tales - Prologue;;20,000 - 50,000;15;2;13;0;0;0
1492040;The Research Age;;0 - 20,000;1;0;1;0;0;0
1492070;Sker Ritual;;20,000 - 50,000;384;96;288;0;0;2
1492080;IdleCoin;;20,000 - 50,000;25;11;14;0;0;0
1492150;Primal Survivors;;0 - 20,000;31;3;28;0;0;3
1492160;Doll Explorer Prologue;;100,000 - 200,000;204;12;192;0;0;0
1492190;Orbi's chronicles;;0 - 20,000;4;0;4;0;0;0
1492210;Starlight: Eye of the Storm;;0 - 20,000;23;1;22;0;0;0
1492230;Zaacar;;0 - 20,000;7;6;1;0;0;0
1492250;44 Minutes in Nightmare;;0 - 20,000;38;4;34;0;0;0
1492260;RECONNECT - The Heart of Darkness;;0 - 20,000;7;1;6;0;0;0
1492270;Iblis;;20,000 - 50,000;6;5;1;0;0;0
1492310;Asterix & Obelix: Slap them All!;;0 - 20,000;84;53;31;0;0;1
1492320;New Joe & Mac - Caveman Ninja;;0 - 20,000;4;6;-2;0;0;0
1492360;Recipe for Disaster;;20,000 - 50,000;425;117;308;1992;3286;16
1492370;Retis Tormentum;;0 - 20,000;0;1;-1;0;0;0
1492380;Jumping Over It With Neko Girl;;0 - 20,000;4;9;-5;0;0;0
1492420;EQUALINE;;0 - 20,000;17;0;17;0;0;0
1492450;Pixel Poops;;50,000 - 100,000;61;8;53;0;0;0
1492480;Half Past Fate: Romantic Distancing;;0 - 20,000;26;4;22;0;0;0
1492510;Intelligence Operation;;0 - 20,000;6;7;-1;0;0;0
1492570;Race To Sanity;;0 - 20,000;20;5;15;0;0;0
1492590;Let's Learn Japanese: Deluxe;;0 - 20,000;5;2;3;0;0;0
1492610;Moonshot - The Great Espionage;;20,000 - 50,000;13;1;12;0;0;1
1492620;Jelly Is Sticky;;0 - 20,000;69;2;67;0;0;2
1492640;Mixx Island: Remix;;0 - 20,000;26;2;24;0;0;1
1492650;Crooks Like Us;;0 - 20,000;16;1;15;0;0;0
1492680;The Pathless;;0 - 20,000;782;69;713;0;0;15
1492720;GunBlocks - Prologue;;20,000 - 50,000;95;3;92;0;0;0
1492730;DORAEMON STORY OF SEASONS: Friends of the Great Kingdom;;0 - 20,000;176;16;160;1114;1114;57
1492750;Mega Knockdown;;0 - 20,000;34;1;33;0;0;0
1492780;Monolith VR;;0 - 20,000;2;0;2;0;0;0
1492860;三国志奇侠传;;0 - 20,000;4;18;-14;0;0;0
1492870;堕星之乱;;0 - 20,000;14;8;6;0;0;0
1492900;The Alien Trials;;0 - 20,000;29;2;27;0;0;0
1492930;IMUGI;;200,000 - 500,000;3;2;1;0;0;0
1492940;Break Sky;;0 - 20,000;2;3;-1;0;0;0
1492990;Fission;;0 - 20,000;14;10;4;0;0;0
1493000;VR Bike Tour/Exercise in 22nd Century World;;0 - 20,000;2;3;-1;0;0;0
1493020;Song of Farca: Prologue;;20,000 - 50,000;130;18;112;59;59;1
1493050;Forest Battle 森林战斗;;0 - 20,000;7;0;7;0;0;0
1493060;Immortal Legacy: The Jade Cipher[VR];;0 - 20,000;65;22;43;0;0;0
1493070;VR World War II battlefield experience;;0 - 20,000;13;1;12;0;0;0
1493160;DARK MINUTE: Kira's Adventure;;0 - 20,000;21;3;18;0;0;0
1493230;Kiiroi Hana;;0 - 20,000;19;8;11;0;0;0
1493240;La Porte des Fauconniers : Guerre Médiévale;;20,000 - 50,000;18;0;18;0;0;1
1493300;100 hidden aliens;;20,000 - 50,000;240;32;208;0;0;0
1493310;Brave Hero;;0 - 20,000;14;3;11;0;0;0
1493320;魔帝1 Magic Emperor1;;0 - 20,000;3;2;1;0;0;0
1493360;Clouzy!;;0 - 20,000;32;22;10;0;0;0
1493380;Hell's Revenge 3D;;0 - 20,000;2;0;2;0;0;0
1493400;Jack's Labyrinth;;0 - 20,000;16;6;10;0;0;0
1493400;Jack's Labyrinth;;0 - 20,000;16;6;10;0;0;0
1493410;Mini Car Money Chase;;0 - 20,000;24;3;21;0;0;0
1493410;Mini Car Money Chase;;0 - 20,000;24;3;21;0;0;0
1493450;Save daddy trump 2: The Final Triumph;;0 - 20,000;69;10;59;0;0;0
1493490;Demonicute;;0 - 20,000;5;0;5;0;0;0
1493520;Beat Hazard 3;;0 - 20,000;195;7;188;0;0;5
1493530;Spartan Firefight;;0 - 20,000;42;1;41;0;0;3
1493560;Journey On;;20,000 - 50,000;11;1;10;0;0;0
1493570;Arboreal;;0 - 20,000;0;2;-2;0;0;0
1493590;Hell Pages;;0 - 20,000;4;1;3;0;0;0
1493660;Spiky;;0 - 20,000;1;0;1;0;0;0
1493690;Seeds of Friendship;;0 - 20,000;6;3;3;0;0;0
1493800;Aircraft Carrier Survival: Prologue;;50,000 - 100,000;830;333;497;0;0;2
1493810;Sillyfun Valley;;0 - 20,000;17;8;9;0;0;0
1493840;BOT.vinnik Chess: Opening Traps;;0 - 20,000;47;5;42;0;0;0
1493880;Mira's Brush;;0 - 20,000;0;0;0;0;0;0
1493910;COROPATA;;0 - 20,000;29;3;26;0;0;0
1493930;JankBrain;;0 - 20,000;5;0;5;0;0;0
1493940;Airoheart;;0 - 20,000;28;17;11;0;0;0
1493950;Subterene;;0 - 20,000;5;2;3;0;0;0
1493960;Move 78;;0 - 20,000;31;2;29;0;0;0
1493970;The Chameleon;;0 - 20,000;95;11;84;0;0;0
1494050;The Deepest;;0 - 20,000;0;7;-7;0;0;0
1494100;VIRTUAL SOLDIERS;;50,000 - 100,000;0;6;-6;0;0;0
1494110;QV;;0 - 20,000;194;23;171;0;0;1
1494120;인하로 77번길 : Muscle Dog Simulation;;0 - 20,000;2;3;-1;0;0;0
1494140;7Days Origins;;0 - 20,000;132;20;112;0;0;1
1494180;Night: Silent Killer;;0 - 20,000;13;1;12;0;0;0
1494190;秘密舞会;;0 - 20,000;521;10;511;97;97;0
1494220;Soft Wind;;0 - 20,000;17;8;9;0;0;0
1494230;A Western Drama;;0 - 20,000;2;0;2;0;0;0
1494260;Loot River;;0 - 20,000;232;88;144;0;0;1
1494280;Beat Stickman: Beyond;;0 - 20,000;14;2;12;0;0;3
1494310;Panmorphia: Enchanted;;0 - 20,000;7;1;6;0;0;0
1494320;JEI VR;;20,000 - 50,000;3;4;-1;0;0;0
1494370;Insights - Maniac Vortex;;0 - 20,000;9;1;8;0;0;1
1494390;Nostalgici Anonimi;;20,000 - 50,000;5;3;2;0;0;0
1494400;VR JAPAN;;0 - 20,000;43;11;32;0;0;1
1494440;Garbage: Hobo Prophecy;;100,000 - 200,000;1033;344;689;85;126;2
1494450;Oakenfold;;0 - 20,000;38;2;36;0;0;0
1494460;Desktop+;;50,000 - 100,000;371;48;323;0;0;114
1494470;BUSTAFELLOWS;;20,000 - 50,000;341;35;306;0;0;22
1494500;FWsim - Fireworks Display Simulator;;0 - 20,000;58;1;57;0;0;2
1494510;Demon Killer VR;;0 - 20,000;2;2;0;0;0;0
1494530;Cubo ao topo;;0 - 20,000;1;0;1;0;0;0
1494570;Path of Memory;;0 - 20,000;7;0;7;0;0;0
1494580;Refuge For Troubles. Episode 1: Dear Stranger;;0 - 20,000;2;0;2;0;0;0
1494670;Space Dance Harmony;;0 - 20,000;18;2;16;0;0;0
1494680;BasCatball Jupiter: Basketball & Cat;;0 - 20,000;15;0;15;0;0;0
1494680;BasCatball Jupiter: Basketball & Cat;;0 - 20,000;15;0;15;0;0;0
1494720;Mini Moves: Among Stars;;0 - 20,000;19;1;18;0;0;1
1494780;Mage Mountain;;0 - 20,000;3;0;3;0;0;1
1494840;Scoot;;20,000 - 50,000;482;69;413;0;0;20
1494860;CLEARWORLD;;0 - 20,000;16;7;9;0;0;0
1494860;CLEARWORLD;;0 - 20,000;16;7;9;0;0;0
1494910;pemsa;;20,000 - 50,000;112;10;102;0;0;3
1494920;星帷之瓣;;20,000 - 50,000;74;2;72;0;0;3
1494950;Space Cats Tactics: Prologue;;50,000 - 100,000;96;5;91;0;0;1
1494990;Stop the War;;0 - 20,000;2;16;-14;0;0;0
1495050;1001 Jigsaw: Earth Chronicles 3;;0 - 20,000;5;3;2;0;0;1
1495060;1001 Jigsaw Home Sweet Home Wedding Ceremony;;0 - 20,000;1;2;-1;0;0;0
1495070;Alice's Jigsaw Time Travel;;0 - 20,000;5;1;4;0;0;0
1495080;Asian Riddles 4;;0 - 20,000;10;0;10;0;0;0
1495090;Christmas Mosaic Puzzle;;0 - 20,000;3;0;3;0;0;1
1495100;Detective Solitaire: Inspector Magic And The Forbidden Magic;;0 - 20,000;3;0;3;0;0;0
1495110;Fairytale Mosaics Beauty And The Beast 2;;0 - 20,000;4;0;4;0;0;0
1495120;Fairytale Mosaics Cinderella 2;;0 - 20,000;4;0;4;0;0;0
1495130;Fill And Cross Christmas Riddles;;0 - 20,000;7;1;6;0;0;0
1495140;Halloween Night Mahjong;;0 - 20,000;5;1;4;0;0;0
1495240;Deep Enigma;;0 - 20,000;0;1;-1;0;0;0
1495250;LineVox;;200,000 - 500,000;11;9;2;0;0;0
1495260;Fly The Cloud;;0 - 20,000;0;2;-2;0;0;0
1495280;Mouse Hero;;0 - 20,000;5;0;5;0;0;0
1495350;AVROD;;0 - 20,000;6;6;0;0;0;0
1495370;Fun Christmas Santa VR;;0 - 20,000;2;3;-1;0;0;0
1495380;Tricky Machines;;0 - 20,000;26;4;22;0;0;3
1495400;制服少女;;0 - 20,000;8;0;8;0;0;2
1495420;Dragon Creek;;0 - 20,000;108;16;92;0;0;4
1495460;Orange Santa;;0 - 20,000;14;2;12;0;0;0
1495480;Galaxy V;;0 - 20,000;0;2;-2;0;0;0
1495510;Mey Rescuer;;0 - 20,000;17;0;17;0;0;0
1495560;OBEN;;0 - 20,000;0;3;-3;0;0;0
1495580;Aquarelle;;0 - 20,000;18;18;0;0;0;0
1495640;Estigma [Steam Edition];;20,000 - 50,000;127;14;113;0;0;0
1495670;Leaper;;50,000 - 100,000;29;13;16;0;0;0
1495690;Hike;;20,000 - 50,000;29;21;8;0;0;0
1495760;Karen;;0 - 20,000;7;2;5;0;0;0
1495780;Isometric Nonogram;;0 - 20,000;7;3;4;0;0;0
1495800;Moon Defence;;50,000 - 100,000;1;2;-1;0;0;0
1495830;Rokka;;20,000 - 50,000;44;12;32;0;0;0
1495860;What The Dub?!;;0 - 20,000;225;16;209;624;1028;9
1495870;PowerNap: Ultimate Game Updater;;0 - 20,000;33;4;29;0;0;2
1495910;Omega Blade;;20,000 - 50,000;3;1;2;0;0;0
1495920;BulletGarden;;0 - 20,000;17;1;16;0;0;1
1495990;ClickCells: Summer;;0 - 20,000;34;4;30;0;0;0
1496090;Urban Street Fighter;;0 - 20,000;2;2;0;0;0;0
1496120;Phantast;;0 - 20,000;0;2;-2;0;0;0
1496150;Fury Fight;;0 - 20,000;19;7;12;0;0;0
1496180;Cinderella Phenomenon: Evermore;;0 - 20,000;148;5;143;0;0;3
1496210;Centrifugal;;0 - 20,000;4;0;4;0;0;0
1496220;Laser Cup;;0 - 20,000;3;1;2;0;0;0
1496250;Mary Skelter 2;;0 - 20,000;85;10;75;0;0;6
1496320;Time Machine - Find Objects. Hidden Pictures Game;;0 - 20,000;65;13;52;0;0;1
1496350;Hamster Logic 3D;;0 - 20,000;4;2;2;0;0;0
1496380;艾斯菲尔的谎言;;0 - 20,000;44;19;25;0;0;0
1496430;Relax Fly;;0 - 20,000;17;3;14;0;0;0
1496470;Fall Balance Ball;;0 - 20,000;1;0;1;0;0;0
1496500;Pan-Arcade Airlines;;0 - 20,000;6;3;3;0;0;0
1496510;Pack Per Duck;;100,000 - 200,000;2;5;-3;0;0;0
1496530;Cinders Of Hades;;0 - 20,000;1;2;-1;0;0;0
1496620;Color Cube;;0 - 20,000;14;2;12;0;0;0
1496640;Scrapping Simulator;;0 - 20,000;31;1;30;0;0;0
1496680;A Token War;;0 - 20,000;15;3;12;0;0;0
1496710;Zombie Alert;;0 - 20,000;2;7;-5;0;0;0
1496790;Gotham Knights;;200,000 - 500,000;9218;4186;5032;819;974;1120
1496930;Rotten Tide;;0 - 20,000;6;4;2;0;0;0
1496990;Barrage Fantasia;;0 - 20,000;10;0;10;0;0;2
1497000;OceanCraft;;0 - 20,000;51;6;45;0;0;0
1497080;ChessBase 16 Steam Edition;;0 - 20,000;29;3;26;0;0;22
1497110;Actors;;0 - 20,000;63;14;49;0;0;0
1497120;Movavi Screen Recorder 22;;0 - 20,000;30;11;19;0;0;31
1497170;ONNANOKO KEEPER 2;;0 - 20,000;1;1;0;0;0;0
1497180;Nemesis: Race Against The Pandemic;;50,000 - 100,000;19;22;-3;0;0;0
1497230;Cauldrons of War - Stalingrad;;0 - 20,000;65;9;56;0;0;3
1497240;LoopWorlds;;0 - 20,000;1;0;1;0;0;0
1497290;Personal Rocket;;0 - 20,000;5;0;5;0;0;0
1497330;Bad Way;;0 - 20,000;32;13;19;0;0;1
1497450;A Memoir Blue;;0 - 20,000;207;29;178;15;15;2
1497510;Final Winter;;0 - 20,000;7;1;6;0;0;0
1497520;TenebriS;;0 - 20,000;5;3;2;0;0;0
1497530;StarPicker;;0 - 20,000;2;0;2;0;0;0
1497590;Saints and Sinners;;0 - 20,000;43;9;34;0;0;0
1497600;Poker Squadrons;;0 - 20,000;14;2;12;0;0;1
1497630;Where's Samantha?;;0 - 20,000;15;4;11;0;0;0
1497640;Traitors in Salem;;100,000 - 200,000;629;352;277;0;0;11
1497650;Squareometry;;0 - 20,000;21;1;20;0;0;0
1497700;景安区奇案-Jing 'an District Copstories;;20,000 - 50,000;23;11;12;0;0;0
1497710;Galaxy Tales: Story of Rapunzel;;0 - 20,000;30;0;30;0;0;1
1497780;无眠夜曲;;0 - 20,000;33;2;31;0;0;0
1497790;Faircroft’s Antiques: Home for Christmas;;0 - 20,000;9;0;9;0;0;1
1497820;Golden Rails: Small Town Story;;0 - 20,000;30;0;30;886;886;4
1497830;Apsis;;0 - 20,000;1;0;1;0;0;0
1497850;SNIPER;;0 - 20,000;10;2;8;0;0;1
1497950;EARTH DEFENSE FORCE: WORLD BROTHERS;;20,000 - 50,000;510;117;393;483;852;7
1498040;Bio Prototype;;50,000 - 100,000;731;43;688;412;501;263
1498140;Cafe Owner Simulator;;0 - 20,000;215;100;115;72;72;26
1498180;BELLING COINS;;0 - 20,000;8;17;-9;0;0;0
1498220;MyHouseMyRules;;0 - 20,000;8;2;6;0;0;0
1498250;Gun Duel;;20,000 - 50,000;60;16;44;0;0;0
1498250;Gun Duel;;20,000 - 50,000;60;16;44;0;0;0
1498280;The Christmas Spirit: Journey Before Christmas Collector's Edition;;0 - 20,000;12;1;11;0;0;0
1498310;100 hidden cupcakes;;0 - 20,000;124;49;75;0;0;0
1498400;Jigsaw Puzzle - Pixel Art Master;;0 - 20,000;2;0;2;0;0;0
1498460;Bridge to Another World: Secrets of the Nutcracker Collector's Edition;;0 - 20,000;6;1;5;0;0;1
1498490;Dead Herring VR;;20,000 - 50,000;11;1;10;0;0;0
1498570;THE KING OF FIGHTERS XV;;100,000 - 200,000;4358;989;3369;787;839;1619
1498590;Fat Prisoner Simulator 3;;0 - 20,000;77;10;67;0;0;0
1498600;Neko Chan;;0 - 20,000;19;5;14;0;0;0
1498630;Click on their Heads;;0 - 20,000;9;1;8;0;0;0
1498660;Star Ships;;0 - 20,000;1;2;-1;0;0;0
1498680;Poker Pretty Girls Battle : Fantasy World Edition;;0 - 20,000;5;6;-1;0;0;0
1498710;Recycle My World;;0 - 20,000;3;1;2;0;0;0
1498790;Black Lazar;;50,000 - 100,000;2;0;2;0;0;0
1498840;Rushing Beat Of Rage;;0 - 20,000;7;1;6;0;0;0
1498900;Chef's Tail;;0 - 20,000;4;2;2;0;0;0
1498940;Binky's Trash Service;;0 - 20,000;16;1;15;0;0;0
1498990;PD Howler 21;;0 - 20,000;5;0;5;0;0;0
1499030;3D Double Dealing Character;;50,000 - 100,000;5;1;4;0;0;0
1499120;I Expect You To Die 2;;20,000 - 50,000;893;31;862;225;225;10
1499180;Don't Get Bit;;0 - 20,000;25;1;24;0;0;0
1499190;Lost Caves;;0 - 20,000;32;1;31;0;0;0
1499210;Rorschach Plus;;0 - 20,000;12;1;11;0;0;0
1499220;Kungfu Cowboy;;0 - 20,000;31;1;30;0;0;0
1499230;What's Wrong With You?;;0 - 20,000;1;0;1;0;0;0
1499240;Brookhaven Grimoire;;0 - 20,000;101;49;52;0;0;0
1499300;dogpet;;0 - 20,000;123;3;120;0;0;1
1499400;Retro Classix: SRD - Super Real Darwin;;0 - 20,000;4;0;4;0;0;0
1499420;VR Wonderland: mini civilizations in a forest;;0 - 20,000;2;0;2;0;0;0
1499430;What We Pretend To Be;;0 - 20,000;3;7;-4;0;0;0
1499520;スピリットウィッシュ〜三英雄と冒険の大地‪〜;;200,000 - 500,000;20;22;-2;0;0;13
1499550;VR Luxury Life (Be a Billionaire);;0 - 20,000;2;4;-2;0;0;0
1499560;LastCloudia;;100,000 - 200,000;135;46;89;193;204;586
1499640;Y.E.T.I;;50,000 - 100,000;12;3;9;0;0;0
1499660;Cute animal jigsaw puzzle;;0 - 20,000;32;2;30;0;0;0
1499680;Ertugrul Gazi;;0 - 20,000;21;10;11;0;0;0
1499690;夢游仙境ロマネスク: Chronicles of Refugia;;0 - 20,000;16;2;14;0;0;0
1499700;Golazo! 2;;0 - 20,000;55;14;41;0;0;1
1499720;Era of Defense;;0 - 20,000;4;6;-2;0;0;0
1499750;The Frost Rebirth;;0 - 20,000;8;15;-7;0;0;0
1499780;Beat The Moles;;0 - 20,000;3;5;-2;0;0;0
1499800;Geometric Sniper - Blood in Paris;;20,000 - 50,000;55;15;40;0;0;0
1499810;Parking Сar;;0 - 20,000;0;2;-2;0;0;0
1499820;VR Graffiti World;;0 - 20,000;0;2;-2;0;0;0
1499860;Fast Wings;;100,000 - 200,000;0;4;-4;0;0;0
1499890;Into The Eternal;;0 - 20,000;7;5;2;0;0;0
1499900;Chat Millions - Stream Quiz Game;;0 - 20,000;2;1;1;0;0;0
1499930;Draft Day Sports: College Football 2021;;0 - 20,000;17;10;7;0;0;0
1499940;My Low Poly City;;0 - 20,000;0;1;-1;0;0;0
1499980;Road To Adventure!;;0 - 20,000;4;0;4;0;0;0
1499990;Forgetter;;0 - 20,000;37;4;33;0;0;0
1500030;The Snowman's Journey;;0 - 20,000;2;0;2;0;0;0
1500060;Fluid Simulator;;0 - 20,000;6;0;6;0;0;0
1500100;Spheria's Familiar;;0 - 20,000;36;17;19;0;0;0
1500110;KNIGHT SLAVE -The Dark Valkyrie of Depravity-;;0 - 20,000;12;7;5;5;5;0
1500120;DARK SPHERE;;0 - 20,000;12;7;5;1;1;0
1500130;Monitor Girl | 监控姬;;0 - 20,000;23;8;15;0;0;0
1500220;Arcane Eyes;;0 - 20,000;6;5;1;0;0;0
1500230;Pour There;;0 - 20,000;3;0;3;0;0;0
1500240;Connected Towers;;0 - 20,000;6;3;3;0;0;0
1500250;Der Blaue Diamant;;0 - 20,000;5;1;4;0;0;0
1500260;Desert Mystery;;0 - 20,000;1;13;-12;0;0;0
1500270;Windows Particle Effect;;0 - 20,000;3;1;2;0;0;0
1500280;Spellbound : The Magic Within;;0 - 20,000;4;0;4;0;0;0
1500280;Spellbound : The Magic Within;;0 - 20,000;4;0;4;0;0;0
1500290;Desktop Honey;;0 - 20,000;19;5;14;0;0;0
1500300;Snake Man's Adventure;;0 - 20,000;4;1;3;0;0;0
1500310;Choco Pixel D;;0 - 20,000;4;1;3;0;0;0
1500320;Flykt;;0 - 20,000;1;22;-21;0;0;0
1500350;Until Sunset;;0 - 20,000;9;1;8;0;0;0
1500350;Until Sunset;;0 - 20,000;9;1;8;0;0;0
1500380;Night in Riverager;;200,000 - 500,000;172;32;140;0;0;0
1500390;Happy Bones;;0 - 20,000;17;0;17;0;0;0
1500400;Sokoban Gianta;;0 - 20,000;1;0;1;0;0;0
1500410;Don't Mess With Nanny;;0 - 20,000;2;2;0;0;0;0
1500470;Angel Made;;50,000 - 100,000;20;0;20;0;0;3
1500480;Yeminj;;0 - 20,000;4;0;4;0;0;0
1500540;Hardwar;;20,000 - 50,000;6;0;6;0;0;6
1500580;Cyber Defense 2088;;0 - 20,000;1;0;1;0;0;0
1500600;Demonpact: Clarice;;20,000 - 50,000;65;3;62;0;0;0
1500620;Tavern Tales: Tabletop Adventures;;0 - 20,000;3;3;0;0;0;0
1500650;Cyber Girl;;50,000 - 100,000;9;12;-3;0;0;0
1500660;Block Destruction;;0 - 20,000;1;1;0;0;0;0
1500750;Tauren maze;;0 - 20,000;22;15;7;0;0;0
1500760;Scraplers;;20,000 - 50,000;4;2;2;0;0;0
1500780;Champoo Club;;0 - 20,000;1;0;1;0;0;0
1500800;Mr.Bottle and his dream;;0 - 20,000;28;4;24;0;0;1
1500810;Necrojacks;;0 - 20,000;0;2;-2;0;0;0
1500820;Caravaneer 2;;100,000 - 200,000;306;20;286;0;0;21
1500830;Aliens Adventure;;0 - 20,000;1;2;-1;0;0;0
1500860;SAW HELL;;0 - 20,000;4;2;2;0;0;0
1500870;Madness Robots;;0 - 20,000;5;1;4;0;0;0
1500940;Far Lands;;0 - 20,000;52;20;32;0;0;7
1500960;Aeris&Zack;;0 - 20,000;3;1;2;0;0;0
1500970;BlackChain;;0 - 20,000;77;11;66;0;0;0
1500980;Doomsday Vault;;0 - 20,000;18;4;14;0;0;0
1501090;Yin Yang;;0 - 20,000;21;2;19;0;0;0
1501100;Key Escape;;0 - 20,000;26;10;16;0;0;0
1501110;Aim: Warmup;;20,000 - 50,000;2;1;1;0;0;0
1501120;Samurai Cat;;0 - 20,000;35;5;30;0;0;1
1501120;Samurai Cat;;0 - 20,000;35;5;30;0;0;1
1501140;Taekwondo Demonstration Team Simulator;;0 - 20,000;5;2;3;0;0;0
1501150;Pebble Witch;;0 - 20,000;9;1;8;0;0;0
1501160;CLOSER - anagnorisis;;0 - 20,000;9;8;1;0;0;0
1501210;ARENIX;;0 - 20,000;1;1;0;0;0;0
1501320;Prison Girl;;0 - 20,000;17;53;-36;0;0;0
1501340;Sprint Racer;;0 - 20,000;1;1;0;0;0;0
1501360;开心扑克Happy Poker;;20,000 - 50,000;307;136;171;0;0;0
1501390;KING PONG;;20,000 - 50,000;12;3;9;0;0;0
1501420;Novena Diabolos;;20,000 - 50,000;36;1;35;0;0;1
1501440;Fritz & Chesster - Learn to Play Chess Vol. 1;;0 - 20,000;2;3;-1;0;0;0
1501470;tanxy;;20,000 - 50,000;1;0;1;0;0;0
1501480;Hachi Hachi Mystery;;0 - 20,000;4;3;1;0;0;0
1501490;Ship Handling Simulator;;0 - 20,000;66;7;59;0;0;0
1501500;Battle Mine Sweeper;;0 - 20,000;6;0;6;0;0;0
1501530;Voxel Battle Simulator;;0 - 20,000;7;2;5;0;0;0
1501540;Paladin's Lance;;0 - 20,000;1;0;1;0;0;0
1501640;Fallen Rebellion;;20,000 - 50,000;1;0;1;0;0;0
1501650;Whisperwind;;0 - 20,000;69;5;64;0;0;0
1501760;Rogun Arena;;50,000 - 100,000;2;0;2;0;0;0
1501790;Forge Squad;;0 - 20,000;5;0;5;0;0;0
1501800;Rope Cow - Rope it to The Cow;;0 - 20,000;9;0;9;0;0;0
1501830;Coveneth;;0 - 20,000;1;0;1;0;0;0
1501850;Love and Romance Interactive [Co-op for Couples];;0 - 20,000;0;1;-1;0;0;0
1501900;Tube Tussle;;0 - 20,000;14;6;8;0;0;0
1501920;Toewr le Fence - REMASTERED (COMING SOON);;0 - 20,000;6;1;5;0;0;0
1501950;eia : A short story;;0 - 20,000;8;1;7;0;0;0
1501960;MONSTER X;;0 - 20,000;1;0;1;0;0;0
1501970;白马非马 a white horse is not a horse;;0 - 20,000;36;6;30;0;0;10
1502010;Friki;;20,000 - 50,000;39;21;18;0;0;0
1502040;大衍江湖 - Evolution Of JiangHu;;20,000 - 50,000;444;240;204;143;143;19
1502060;Boxed-In;;20,000 - 50,000;5;1;4;0;0;0
1502070;Survival In Africa;;0 - 20,000;24;21;3;0;0;0
1502080;ALTDEUS: Beyond Chronos;;20,000 - 50,000;272;12;260;0;0;3
1502160;FAUN AIR -フォーンアイル-;;20,000 - 50,000;2;1;1;0;0;0
1502180;Gnomes Garden: Return Of The Queen;;0 - 20,000;14;2;12;0;0;0
1502190;From Space;;100,000 - 200,000;1042;413;629;339;471;37
1502230;Tower of Waifus;;20,000 - 50,000;206;77;129;46;52;4
1502260;Figment 2: Creed Valley - Prologue;;20,000 - 50,000;101;11;90;0;0;1
1502380;Combat Mission Black Sea;;0 - 20,000;300;43;257;0;0;36
1502410;CLT;;0 - 20,000;10;3;7;0;0;0
1502480;Z-Blood Mission;;0 - 20,000;7;4;3;0;0;0
1502490;Corona Samurai;;0 - 20,000;2;0;2;0;0;0
1502520;The Mermaid of Zennor;;0 - 20,000;31;0;31;0;0;0
1502520;The Mermaid of Zennor;;0 - 20,000;31;0;31;0;0;0
1502540;The Sisters - Party of the Year;;20,000 - 50,000;5;0;5;0;0;1
1502550;Winter Sleigh;;0 - 20,000;2;0;2;0;0;0
1502560;The Smurfs - Mission Vileaf;;0 - 20,000;156;21;135;91;91;4
1502570;Story of a tiny earth, the symbolic ages;;0 - 20,000;1;0;1;0;0;0
1502600;Alien X;;0 - 20,000;31;19;12;0;0;0
1502600;Alien X;;0 - 20,000;31;19;12;0;0;0
1502610;Darkest Hour;;0 - 20,000;2;0;2;0;0;0
1502630;Neon Parkour;;0 - 20,000;20;1;19;0;0;0
1502660;Untrusted;;100,000 - 200,000;807;131;676;0;0;13
1502680;Dobo's Heroes;;0 - 20,000;22;1;21;0;0;0
1502710;Agent Intercept;;0 - 20,000;48;6;42;0;0;0
1502730;Street Football;;0 - 20,000;3;10;-7;0;0;0
1502760;Dungeon Delver;;20,000 - 50,000;20;8;12;0;0;0
1502790;Gun Witch;;50,000 - 100,000;215;20;195;0;0;0
1502800;Escape Machine City: Airborne;;0 - 20,000;27;3;24;0;0;1
1502950;Quarantine: Global Pandemic;;20,000 - 50,000;10;3;7;0;0;0
1502970;Atelier Sophie: The Alchemist of the Mysterious Book DX;;100,000 - 200,000;475;45;430;28;28;56
1502980;Atelier Firis: The Alchemist and the Mysterious Journey DX;;0 - 20,000;161;45;116;0;0;25
1502990;Atelier Lydie & Suelle: The Alchemists and the Mysterious Paintings DX;;0 - 20,000;172;13;159;0;0;6
1503000;The Chaos Gene;;0 - 20,000;3;0;3;0;0;0
1503040;Purplis Sandbox;;0 - 20,000;135;44;91;0;0;0
1503090;SinSeed;;0 - 20,000;35;27;8;0;0;0
1503130;CyberNEON;;0 - 20,000;1;2;-1;0;0;0
1503140;Wave War One;;0 - 20,000;2;7;-5;0;0;0
1503180;Elementite;;20,000 - 50,000;7;7;0;0;0;0
1503220;王国的魔法战争;;0 - 20,000;0;2;-2;0;0;0
1503250;Muslim 3D;;20,000 - 50,000;13;0;13;0;0;0
1503270;PePiBo: Peregrino Pinata Bowling;;0 - 20,000;3;0;3;0;0;0
1503350;Cyberpunch;;50,000 - 100,000;3;2;1;0;0;0
1503370;Francisca 2;;0 - 20,000;10;7;3;0;0;0
1503390;Drunk Soccer is the Best Soccer;;0 - 20,000;29;5;24;0;0;0
1503410;Children's Jigsaw Puzzles;;0 - 20,000;3;1;2;0;0;0
1503430;Groov;;0 - 20,000;12;0;12;0;0;0
1503440;DreamScapes Dimensions;;20,000 - 50,000;25;43;-18;0;0;1
1503480;Paradigm Shift;;20,000 - 50,000;5;0;5;0;0;0
1503530;Minit Fun Racer;;0 - 20,000;192;8;184;0;0;1
1503540;Mission IDLE;;20,000 - 50,000;34;14;20;0;0;0
1503580;Epic City Builder 4;;0 - 20,000;20;6;14;0;0;1
1503590;Range is HOT!;;0 - 20,000;29;13;16;0;0;0
1503630;Arm of Revenge Re-Edition;;0 - 20,000;20;8;12;0;0;0
1503630;Arm of Revenge Re-Edition;;0 - 20,000;20;8;12;0;0;0
1503670;[Chilla's Art] The Caregiver | 終焉介護;;20,000 - 50,000;237;48;189;0;0;0
1503750;Inglorious Aztecs;;0 - 20,000;7;0;7;0;0;0
1503820;Ballfrog;;20,000 - 50,000;36;11;25;0;0;0
1503850;中年失业模拟器When a man lose his job;;20,000 - 50,000;246;69;177;0;0;3
1503880;The Alpha 001;;0 - 20,000;2;1;1;0;0;0
1503920;Aery - A Journey Beyond Time;;0 - 20,000;61;7;54;0;0;0
1503930;Glam's Incredible Run: Escape from Dukha;;0 - 20,000;9;4;5;0;0;0
1503990;Tomorrow;;0 - 20,000;28;9;19;0;0;0
1504010;Negative: The Way of Shinobi;;0 - 20,000;0;3;-3;0;0;0
1504020;Mosaique Neko Waifus 4;;100,000 - 200,000;4133;200;3933;968;314;9
1504030;Hover Ship;;20,000 - 50,000;5;7;-2;0;0;0
1504050;JAB!;;0 - 20,000;5;3;2;0;0;0
1504100;Playground VR;;0 - 20,000;6;7;-1;0;0;0
1504110;Grandiose;;0 - 20,000;48;28;20;0;0;0
1504110;Grandiose;;0 - 20,000;48;28;20;0;0;0
1504140;Ninja Ming;;0 - 20,000;27;1;26;0;0;0
1504150;Hello Guest: Hello Neighbor 2 pre-alpha;;100,000 - 200,000;325;50;275;91;91;6
1504200;Elon's Dream 2;;0 - 20,000;11;3;8;0;0;0
1504220;The Penguin IQ Test;;0 - 20,000;63;1;62;0;0;0
1504230;Skyratz;;0 - 20,000;2;0;2;0;0;0
1504260;My Last Memories About You;;0 - 20,000;17;1;16;0;0;0
1504270;Napoleon Maiden ~A maiden without the word impossible~;;50,000 - 100,000;39;6;33;0;0;3
1504310;Azure Sky;;0 - 20,000;21;6;15;0;0;0
1504320;GOC Royale;;0 - 20,000;6;0;6;0;0;0
1504340;CrushBorgs;;0 - 20,000;118;2;116;0;0;0
1504350;Anime Catgirl Runner;;0 - 20,000;3;1;2;0;0;0
1504360;Happy Day;;0 - 20,000;4;13;-9;0;0;0
1504480;Through the Helios;;0 - 20,000;0;1;-1;0;0;0
1504490;bridg;;0 - 20,000;32;24;8;0;0;0
1504500;OPUS: Echo of Starsong - Full Bloom Edition;;100,000 - 200,000;6267;186;6081;451;554;27
1504550;循环世界;;0 - 20,000;8;6;2;0;0;0
1504570;Cultivation Tales;;500,000 - 1,000,000;4972;8353;-3381;440;440;308
1504580;Maze Party;;0 - 20,000;3;0;3;0;0;0
1504610;VR Wonderland 2：Adventures in a Fruit Boat;;0 - 20,000;1;2;-1;0;0;0
1504630;Zero-G Revolution;;0 - 20,000;0;3;-3;0;0;0
1504660;Arc Wizards 3;;0 - 20,000;11;5;6;0;0;0
1504670;VR Plane Crash;;0 - 20,000;3;8;-5;0;0;0
1504690;Cassidy;;0 - 20,000;5;8;-3;0;0;0
1504740;Find Yourself;;20,000 - 50,000;670;106;564;50;50;5
1504760;그랑 엠파이어;;0 - 20,000;156;11;145;0;0;1
1504910;Sakura Mochi;;0 - 20,000;5;9;-4;0;0;0
1505010;Blockdown;;0 - 20,000;13;1;12;0;0;1
1505220;Roboggled;;0 - 20,000;2;0;2;0;0;0
1505230;Mothercore;;0 - 20,000;1;0;1;0;0;0
1505240;Tales From Yeoldeburg;;0 - 20,000;11;7;4;0;0;0
1505270;荣光的见证 Glory's Witness;;0 - 20,000;8;1;7;0;0;0
1505380;A hermit crab is finding a house;;0 - 20,000;26;0;26;0;0;0
1505390;Librarian;;0 - 20,000;15;4;11;0;0;0
1505400;Robot Robert;;0 - 20,000;21;5;16;0;0;0
1505420;Run Ralph Run;;0 - 20,000;19;7;12;0;0;0
1505430;Inversion;;0 - 20,000;25;7;18;0;0;0
1505440;Neon Warrior;;0 - 20,000;10;6;4;0;0;0
1505460;Neon;;0 - 20,000;27;1;26;0;0;0
1505470;Arnold;;0 - 20,000;23;3;20;0;0;0
1505500;Fluffy Gore;;0 - 20,000;6;1;5;0;0;0
1505540;Get Together: A Coop Adventure;;0 - 20,000;54;18;36;122;122;0
1505560;Little Lives;;0 - 20,000;161;29;132;0;0;10
1505560;Little Lives;;0 - 20,000;161;29;132;0;0;10
1505570;labyrinth 3;;0 - 20,000;3;0;3;0;0;0
1505670;Crafty;;0 - 20,000;3;0;3;0;0;0
1505680;BAND OF BROTHERS;;0 - 20,000;20;19;1;0;0;0
1505690;Lux mina;;0 - 20,000;2;0;2;0;0;0
1505700;Berzerk Flashback;;0 - 20,000;54;1;53;0;0;2
1505720;Apostle 3D;;0 - 20,000;2;2;0;0;0;0
1505740;Lunar Base Camp 2030+;;0 - 20,000;0;1;-1;0;0;0
1505790;Edifice of Fiends;;0 - 20,000;3;2;1;0;0;0
1505830;Evil Shogun;;50,000 - 100,000;0;2;-2;0;0;0
1505840;Hexacore;;0 - 20,000;4;0;4;0;0;0
1505960;Kuguru;;0 - 20,000;2;0;2;0;0;0
1505980;Cat Go! Ultimate Challenge;;20,000 - 50,000;21;7;14;0;0;0
1506010;Agent Roswell : Tactics;;0 - 20,000;4;0;4;0;0;0
1506020;MARK-I: Mission Pilot;;0 - 20,000;6;0;6;0;0;0
1506080;Fuzz Dungeon;;0 - 20,000;42;0;42;0;0;0
1506100;Languish;;0 - 20,000;15;11;4;0;0;0
1506100;Languish;;0 - 20,000;15;11;4;0;0;0
1506230;Bigfoot Forest;;0 - 20,000;97;25;72;0;0;0
1506280;Erophone;;100,000 - 200,000;1831;450;1381;71;88;3
1506300;Scribble Fight;;0 - 20,000;5;3;2;0;0;0
1506410;MOON BASE;;0 - 20,000;38;32;6;0;0;0
1506420;Agent X;;0 - 20,000;7;10;-3;0;0;0
1506430;Asteroids Belt: Try to Survive!;;20,000 - 50,000;23;4;19;0;0;0
1506440;Batora: Lost Haven;;0 - 20,000;124;26;98;102;102;2
1506450;DIY MY LADY IN VR WORLD;;0 - 20,000;66;22;44;0;0;0
1506460;Eliminate Drips - 消灭水滴;;0 - 20,000;2;1;1;0;0;0
1506510;The Ramp;;20,000 - 50,000;980;57;923;15;17;2
1506520;Green world: Catharsis;;50,000 - 100,000;21;2;19;0;0;0
1506610;King's Cup: The online multiplayer drinking game;;0 - 20,000;18;1;17;0;0;0
1506620;Horror Squad;;50,000 - 100,000;331;247;84;0;0;2
1506630;Minicraft Shooter;;500,000 - 1,000,000;2;8;-6;0;0;0
1506640;Hatchpunk;;0 - 20,000;10;2;8;0;0;0
1506660;Battle Cube;;0 - 20,000;26;9;17;0;0;0
1506680;Horror Tycoon;;0 - 20,000;63;28;35;0;0;0
1506710;Nemesis - RPG;;0 - 20,000;13;1;12;0;0;0
1506720;Smoked Gun;;0 - 20,000;23;13;10;0;0;0
1506760;A House of Thieves;;0 - 20,000;67;14;53;55;55;0
1506770;Crawler;;0 - 20,000;5;7;-2;0;0;0
1506820;Kiki & Ana - The Child;;0 - 20,000;45;2;43;0;0;0
1506830;FIFA 22;;2,000,000 - 5,000,000;90450;22377;68073;7495;4008;15872
1506850;Cards & Tankards;;50,000 - 100,000;500;33;467;0;0;7
1506940;Muffin Fight;;0 - 20,000;8;3;5;0;0;2
1506980;Lay a Beauty to Rest: The Darkness Peach Blossom Spring;;100,000 - 200,000;4172;140;4032;923;1357;34
1507080;弗洛伊斯(FREUS);;0 - 20,000;3;0;3;0;0;0
1507110;Kill The Emperor;;0 - 20,000;25;2;23;0;0;0
1507140;汉字数独;;0 - 20,000;1;0;1;0;0;0
1507180;Math Hero - Minimalist Puzzle;;0 - 20,000;22;4;18;0;0;0
1507190;Machinika Museum;;50,000 - 100,000;507;50;457;35;35;5
1507210;aerofly RC 8;;0 - 20,000;63;12;51;0;0;6
1507260;Cannon Lab 13;;50,000 - 100,000;8;1;7;0;0;0
1507270;Grab Toy;;0 - 20,000;5;0;5;0;0;0
1507280;Rowfall;;0 - 20,000;1;0;1;0;0;0
1507310;To The Snowland Platformer Game;;0 - 20,000;2;0;2;0;0;0
1507400;Soobmarinno;;0 - 20,000;2;0;2;0;0;0
1507410;Coloring Book for Kids;;50,000 - 100,000;71;8;63;0;0;4
1507510;Horus IDLE;;0 - 20,000;2;5;-3;0;0;0
1507600;Tail Trail;;20,000 - 50,000;9;5;4;0;0;0
1507620;ENDO;;0 - 20,000;22;0;22;0;0;0
1507640;Mage Hunters;;0 - 20,000;12;1;11;0;0;0
1507650;The Lodge;;0 - 20,000;2;0;2;0;0;0
1507700;Fractaltopia: Edit & Visualize;;0 - 20,000;0;4;-4;0;0;0
1507720;Märchen Forest;;0 - 20,000;210;34;176;0;0;64
1507740;Vamp Night;;0 - 20,000;11;2;9;0;0;0
1507760;Cold Wind;;0 - 20,000;7;10;-3;0;0;0
1507770;Bloomee;;0 - 20,000;1;1;0;0;0;0
1507780;Space Warlord Organ Trading Simulator;;20,000 - 50,000;414;39;375;30;30;2
1507790;Witch Strandings;;0 - 20,000;24;6;18;0;0;0
1507850;Gospel of Abaddon;;0 - 20,000;16;2;14;0;0;0
1507860;Endocrisis;;0 - 20,000;14;0;14;0;0;0
1507890;The Demon Rush: Legends Corrupt;;20,000 - 50,000;1;0;1;0;0;0
1507910;Survival Engine;;0 - 20,000;53;17;36;0;0;2
1507910;Survival Engine;;0 - 20,000;53;17;36;0;0;2
1507930;Oculux;;0 - 20,000;3;0;3;0;0;0
1507950;Dying Flame;;0 - 20,000;14;0;14;0;0;0
1507970;Word Game: Episode 0;;200,000 - 500,000;4334;47;4287;0;0;9
1507980;Leap of Love - Safe Edition;;0 - 20,000;1;0;1;0;0;0
1507990;A Day;;0 - 20,000;14;2;12;0;0;0
1508000;Venice 2089;;0 - 20,000;9;1;8;0;0;0
1508030;Object N;;100,000 - 200,000;670;112;558;0;0;1
1508060;Snowy Love;;0 - 20,000;4;4;0;0;0;0
1508200;Cyber Rider;;0 - 20,000;35;9;26;0;0;0
1508220;Broken Thorns: West Gate;;0 - 20,000;4;0;4;0;0;0
1508230;Meat Lead Fire;;0 - 20,000;4;0;4;0;0;0
1508250;Box And Ball;;0 - 20,000;1;0;1;0;0;0
1508260;Tortured Hearts - Or How I Saved The Universe. Again.;;0 - 20,000;25;6;19;0;0;0
1508270;Doctor Who: The Lonely Assassins;;100,000 - 200,000;537;66;471;208;208;0
1508280;2076 - Midway Multiverse;;20,000 - 50,000;32;7;25;0;0;1
1508340;Forsaken Universe;;0 - 20,000;3;4;-1;0;0;0
1508360;Town Of The Dead Life 死寂之城;;20,000 - 50,000;113;50;63;0;0;2
1508370;Hisato no Saku;;0 - 20,000;8;1;7;0;0;0
1508400;Kaiju Wars;;20,000 - 50,000;137;27;110;153;153;3
1508410;Pirate of Madagascar Island;;0 - 20,000;4;1;3;0;0;0
1508430;Kemono Mahjong;;0 - 20,000;79;7;72;0;0;4
1508440;Rage Chicken 2;;0 - 20,000;2;0;2;0;0;0
1508450;She Doesn't Walk;;20,000 - 50,000;5;4;1;0;0;0
1508460;Annalynn;;20,000 - 50,000;324;6;318;0;0;0
1508490;Commie Killer 2069;;20,000 - 50,000;71;14;57;0;0;0
1508530;Epiphany City;;20,000 - 50,000;179;12;167;0;0;1
1508570;Summer~Life in the Countryside~;;0 - 20,000;279;101;178;0;0;6
1508640;Leave The Red;;0 - 20,000;15;3;12;0;0;0
1508650;正宗台灣十六張麻將;;0 - 20,000;22;1;21;0;0;1
1508660;正宗台灣十六張麻將2;;0 - 20,000;29;3;26;0;0;1
1508670;正宗台湾十六张麻将3;;0 - 20,000;18;11;7;0;0;1
1508680;Love n War: Warlord by Chance;;50,000 - 100,000;1058;161;897;249;294;13
1508730;末日血战;;20,000 - 50,000;9;15;-6;0;0;7
1508740;Xuan-Yuan Sword 2;;50,000 - 100,000;152;24;128;0;0;3
1508750;Xuan-Yuan Sword: Dance of the Maple Leaves;;20,000 - 50,000;197;7;190;0;0;10
1508840;Great Exploration VR: New Colony beyond Viking Raiders;;0 - 20,000;1;1;0;0;0;0
1508860;Minforiga;;0 - 20,000;2;1;1;0;0;0
1508900;MahjongSchool;;0 - 20,000;51;16;35;0;0;0
1508920;Coffee flavor of love 咖啡甜恋;;0 - 20,000;169;5;164;0;0;0
1508980;Cheese Runner;;50,000 - 100,000;19;0;19;0;0;1
1509000;Mighty Vikings;;0 - 20,000;23;12;11;0;0;0
1509010;Curiosaurios Club. Un viaje espacial;;20,000 - 50,000;0;2;-2;0;0;0
1509050;Space of Retaliation;;0 - 20,000;13;7;6;0;0;0
1509080;Nox Archaist;;0 - 20,000;38;4;34;0;0;1
1509080;Nox Archaist;;0 - 20,000;38;4;34;0;0;1
1509090;Seek Girl Ⅷ;;20,000 - 50,000;284;242;42;22;22;3
1509130;Corona Frustration Elimination;;0 - 20,000;5;1;4;0;0;0
1509150;The Holy Silence;;0 - 20,000;4;1;3;0;0;0
1509180;Sqr(2);;0 - 20,000;1;0;1;0;0;0
1509210;Food Stranding;;0 - 20,000;6;7;-1;0;0;0
1509340;The song of Star night;;0 - 20,000;33;9;24;0;0;0
1509350;Club Girl;;0 - 20,000;40;13;27;0;0;0
1509370;Thread Fred;;0 - 20,000;3;3;0;0;0;0
1509400;Cargo Transportation: Low Poly ;;20,000 - 50,000;20;6;14;0;0;0
1509460;Retrowave Drive;;0 - 20,000;7;2;5;0;0;0
1509460;Retrowave Drive;;0 - 20,000;7;2;5;0;0;0
1509510;Settlement Survival;;100,000 - 200,000;4672;639;4033;893;457;476
1509520;White Girl;;0 - 20,000;13;2;11;0;0;0
1509590;Fujiwara Bittersweet;;50,000 - 100,000;294;29;265;0;0;4
1509630;During Before And After COVID-19;;20,000 - 50,000;3;3;0;0;0;0
1509640;Viking Warrior;;0 - 20,000;3;19;-16;0;0;0
1509650;I Am Jesus Christ: Prologue;;0 - 20,000;528;200;328;0;0;29
1509660;重生战士;;0 - 20,000;0;1;-1;0;0;0
1509670;VHAIP;;0 - 20,000;5;1;4;0;0;0
1509700;Marble Ball Racing;;0 - 20,000;2;1;1;0;0;0
1509710;City Retreat;;0 - 20,000;2;0;2;0;0;0
1509720;Hot Dodge!;;0 - 20,000;12;1;11;0;0;0
1509750;Cold Heart;;0 - 20,000;18;1;17;0;0;0
1509770;Million on Mars: Space to Venture;;20,000 - 50,000;9;5;4;0;0;4
1509790;The Other: Rosie's Road of Love;;0 - 20,000;9;0;9;0;0;0
1509810;Hazordhu;;0 - 20,000;9;0;9;0;0;0
1509820;Cloud Climber;;200,000 - 500,000;3435;299;3136;15;17;5
1509830;Superstorm Melon Date;;20,000 - 50,000;56;5;51;0;0;0
1509840;Tower of Doom;;0 - 20,000;11;2;9;0;0;0
1509840;Tower of Doom;;0 - 20,000;11;2;9;0;0;0
1509850;Swallow The Blue: Remastered;;20,000 - 50,000;44;23;21;0;0;0
1509850;Swallow The Blue: Remastered;;20,000 - 50,000;44;23;21;0;0;0
1509960;PICO PARK;;1,000,000 - 2,000,000;16598;1493;15105;212;166;475
1510030;Knights College;;50,000 - 100,000;1604;45;1559;480;480;9
1510040;Swingy boy;;0 - 20,000;4;1;3;0;0;0
1510070;Cliff & Field Tower Defense;;0 - 20,000;32;6;26;0;0;2
1510090;Quantum Project;;0 - 20,000;10;3;7;0;0;0
1510100;Bushfires: Animal Rescue;;0 - 20,000;6;4;2;0;0;0
1510150;Survival Draw;;0 - 20,000;5;2;3;0;0;0
1510280;Isles of Cubes;;0 - 20,000;11;1;10;0;0;0
1510310;Dream Escape;;0 - 20,000;0;3;-3;0;0;0
1510370;MADE VR : Interactive Movie - 01. Run away!;;0 - 20,000;1;9;-8;0;0;0
1510380;Burst Squad;;0 - 20,000;36;11;25;0;0;0
1510390;Wind Wind;;0 - 20,000;3;0;3;0;0;0
1510400;萌娘三国;;0 - 20,000;19;23;-4;0;0;3
1510410;Inkslinger;;0 - 20,000;22;2;20;0;0;0
1510460;Chicken Invaders Universe;;20,000 - 50,000;1969;192;1777;0;0;222
1510570;Toy Tinker Simulator: Prologue;;0 - 20,000;119;19;100;0;0;0
1510580;Toy Tinker Simulator;;0 - 20,000;149;79;70;145;271;2
1510590;Buried Under Rocks;;0 - 20,000;1;1;0;0;0;0
1510600;Anime Arena: Infinite War;;0 - 20,000;3;5;-2;0;0;0
1510620;Pocket Watch;;0 - 20,000;32;1;31;0;0;1
1510630;Everybody Wham Wham;;0 - 20,000;127;5;122;0;0;0
1510670;ZADETTE;;0 - 20,000;55;2;53;0;0;0
1510720;Hajji Tours;;0 - 20,000;2;0;2;0;0;0
1510730;Auto World Tycoon;;0 - 20,000;4;5;-1;0;0;0
1510740;The Virus;;0 - 20,000;6;2;4;0;0;0
1510780;Hollow Ghost;;0 - 20,000;0;2;-2;0;0;0
1510800;The Great Plague Exodus;;0 - 20,000;16;8;8;0;0;0
1510820;Briddle;;0 - 20,000;3;3;0;0;0;0
1510860;Out of Sight;;0 - 20,000;95;29;66;0;0;1
1510890;Micro Annihilation;;0 - 20,000;15;2;13;0;0;0
1510900;Pilfered Liberty;;20,000 - 50,000;1;0;1;0;0;0
1510930;CYBER EMOJI TALE 2099;;50,000 - 100,000;111;14;97;0;0;0
1510950;NKODICE;;20,000 - 50,000;395;12;383;10;12;0
1511000;Collapse;;0 - 20,000;2;2;0;0;0;0
1511090;Great Paintings VR;;20,000 - 50,000;77;6;71;0;0;0
1511140;Laser Attraction;;0 - 20,000;47;0;47;0;0;0
1511190;Super Toy Cars Offroad;;0 - 20,000;27;11;16;0;0;0
1511230;Summit in Space;;0 - 20,000;34;7;27;0;0;0
1511240;SpaceNET - A Space Adventure;;20,000 - 50,000;27;0;27;0;0;0
1511250;Vector Race;;0 - 20,000;3;5;-2;0;0;0
1511310;Destroy the Demon Army - Modified;;0 - 20,000;9;0;9;0;0;0
1511320;Legend Of Vengeancev;;0 - 20,000;2;1;1;0;0;0
1511330;Digital Zoo Gallery;;0 - 20,000;32;6;26;0;0;0
1511360;飞花令 春饼;;0 - 20,000;5;2;3;0;0;0
1511400;Stream Quest;;0 - 20,000;6;0;6;0;0;0
1511410;Grass Cutters Academy - Idle Game;;0 - 20,000;28;21;7;0;0;1
1511450;Two Brain Sides;;0 - 20,000;15;1;14;0;0;0
1511460;InfraSpace;;100,000 - 200,000;771;104;667;2063;2063;109
1511490;Happy Valentine's Day;;0 - 20,000;7;3;4;0;0;0
1511500;Elven Truth;;0 - 20,000;2;4;-2;0;0;0
1511540;DW;;0 - 20,000;3;0;3;0;0;0
1511540;DW;;0 - 20,000;3;0;3;0;0;0
1511610;Gang wars;;0 - 20,000;4;1;3;0;0;0
1511620;Dark spot;;0 - 20,000;1;2;-1;0;0;0
1511630;TrackDayR;;0 - 20,000;231;56;175;270;270;28
1511650;Andromeda: Rebirth of Humanity;;20,000 - 50,000;57;33;24;0;0;1
1511670;Enter The Backrooms;;20,000 - 50,000;795;102;693;0;0;3
1511690;Fragmented Mind;;0 - 20,000;35;6;29;0;0;0
1511780;Last Call BBS;;20,000 - 50,000;693;24;669;776;776;33
1511830;Shadows Behind the Throne 2;;20,000 - 50,000;33;9;24;0;0;1
1511850;Dungeons Of The Deep;;0 - 20,000;10;8;2;0;0;0
1511870;末日竟在我身边 - Zombies Everywhere;;0 - 20,000;57;9;48;0;0;0
1511870;末日竟在我身边 - Zombies Everywhere;;0 - 20,000;57;9;48;0;0;0
1511950;Magellania;;50,000 - 100,000;27;0;27;0;0;1
1511970;最后的守护者之虚幻的梦;;0 - 20,000;32;5;27;0;0;0
1511970;最后的守护者之虚幻的梦;;0 - 20,000;32;5;27;0;0;0
1512070;VR Hiroshima 1945;;0 - 20,000;24;12;12;0;0;0
1512200;PYTHIAN;;0 - 20,000;24;10;14;0;0;0
1512210;Ultra App Kit;;0 - 20,000;15;8;7;0;0;0
1512240;记得我;;0 - 20,000;102;20;82;0;0;0
1512240;记得我;;0 - 20,000;102;20;82;0;0;0
1512290;UfoPilot : The Phadt Menace - Steam Edition;;0 - 20,000;1;0;1;0;0;0
1512300;Quick Race;;0 - 20,000;11;8;3;0;0;0
1512320;Yabgits: Haunted Cemetery;;0 - 20,000;10;1;9;0;0;0
1512320;Yabgits: Haunted Cemetery;;0 - 20,000;10;1;9;0;0;0
1512350;As Fast As Possible;;0 - 20,000;4;0;4;0;0;0
1512370;Furry Shakespeare: Dreamin' of One Lazy Dead Midsummer;;20,000 - 50,000;1;0;1;0;0;0
1512390;The Whispering Valley | La vallée qui murmure;;0 - 20,000;65;2;63;0;0;1
1512450;MonkeyPox: The Plague;;0 - 20,000;1;1;0;0;0;0
1512480;Gunlocked;;20,000 - 50,000;260;24;236;0;0;4
1512520;4096;;50,000 - 100,000;3;2;1;0;0;0
1512530;极限求生;;200,000 - 500,000;6;8;-2;0;0;1
1512540;Beyond The Waterfalls;;0 - 20,000;1;0;1;0;0;0
1512570;She turned me into a newt!;;0 - 20,000;10;0;10;0;0;0
1512590;Punch A Bunch;;0 - 20,000;389;72;317;137;137;21
1512590;Punch A Bunch;;0 - 20,000;389;72;317;137;137;21
1512650;孙美琪疑案 第三季;;50,000 - 100,000;4;2;2;0;0;0
1512660;The Light of Summer;;0 - 20,000;2;0;2;0;0;0
1512720;Stardom;;0 - 20,000;64;2;62;0;0;0
1512730;Relax It's Aqua;;0 - 20,000;1;0;1;0;0;0
1512750;LeHweng LeHweng;;0 - 20,000;10;14;-4;0;0;0
1512790;Reach the Summit;;0 - 20,000;18;15;3;0;0;0
1512800;Mars Quest;;20,000 - 50,000;2;1;1;0;0;0
1512840;Virtual Gallery;;20,000 - 50,000;10;1;9;0;0;0
1512860;Pixelot;;100,000 - 200,000;23;3;20;0;0;0
1512890;I Am Robot;;0 - 20,000;8;24;-16;0;0;0
1512940;Malody V;;0 - 20,000;95;85;10;15;15;12
1512950;BullyBall;;0 - 20,000;0;1;-1;0;0;0
1512960;Parkalien: a ludo in the space;;0 - 20,000;11;2;9;0;0;0
1513090;Blimps;;20,000 - 50,000;6;2;4;0;0;0
1513110;ShapeNeon Chaos;;0 - 20,000;28;2;26;0;0;0
1513120;The Zodiac Trial;;50,000 - 100,000;99;3;96;0;0;2
1513130;No Lights;;0 - 20,000;6;5;1;0;0;0
1513130;No Lights;;0 - 20,000;6;5;1;0;0;0
1513180;Lo-Fi Lounge;;0 - 20,000;4;2;2;0;0;0
1513180;Lo-Fi Lounge;;0 - 20,000;4;2;2;0;0;0
1513240;Lonza the Bounty Hunter;;20,000 - 50,000;2;0;2;0;0;0
1513250;溪风谷之战(roguelike moba game);;0 - 20,000;5;3;2;0;0;1
1513270;Exit Strategy;;20,000 - 50,000;4;2;2;0;0;0
1513300;Marswar TD;;0 - 20,000;1;9;-8;0;0;0
1513310;Blockee - Sliding Puzzle;;0 - 20,000;40;1;39;0;0;0
1513330;KnockDown;;0 - 20,000;1;1;0;0;0;0
1513370;Angkor: Runefall;;0 - 20,000;5;1;4;0;0;0
1513390;夏日的回忆;;20,000 - 50,000;1;0;1;0;0;0
1513400;Karma - Chapter 1;;0 - 20,000;2;2;0;0;0;0
1513450;TWO MONTHS;;0 - 20,000;34;1;33;0;0;0
1513460;Antimatter Elevator;;20,000 - 50,000;17;1;16;0;0;0
1513460;Antimatter Elevator;;20,000 - 50,000;17;1;16;0;0;0
1513500;Plumber;;0 - 20,000;6;3;3;0;0;0
1513510;AudioTheory Piano Keys;;0 - 20,000;11;1;10;0;0;0
1513530;Phucker in the Ashes;;0 - 20,000;19;0;19;0;0;0
1513550;Table Tennis Pro;;0 - 20,000;2;2;0;0;0;0
1513580;Transporter Manager Tycoon;;0 - 20,000;21;14;7;0;0;0
1513640;FEEET;;0 - 20,000;7;0;7;0;0;0
1513650;Gun Bots;;20,000 - 50,000;1;0;1;0;0;0
1513660;Stalked;;0 - 20,000;6;3;3;0;0;0
1513670;Fono;;0 - 20,000;16;0;16;0;0;0
1513680;Wizardry Squared;;0 - 20,000;17;0;17;0;0;1
1513690;Elly;;0 - 20,000;5;1;4;0;0;0
1513700;Pond Scum;;0 - 20,000;2;0;2;0;0;0
1513710;Crystal sword;;0 - 20,000;2;2;0;0;0;0
1513740;Warriors Of Titus - F2P;;20,000 - 50,000;10;3;7;0;0;0
1513760;Girls Pinball;;0 - 20,000;2;6;-4;0;0;0
1513790;The Unbreakable Chain;;0 - 20,000;8;0;8;0;0;0
1513800;JPN Burst;;0 - 20,000;2;0;2;0;0;0
1513840;V.O.D.K.A. Open World Survival Shooter;;0 - 20,000;34;44;-10;0;0;0
1513860;Raptor Territory;;0 - 20,000;36;12;24;0;0;0
1513910;I WILL BE THERE;;0 - 20,000;2;1;1;0;0;1
1513950;Motor Assailant: Prologue;;100,000 - 200,000;7;1;6;0;0;0
1514000;Anime Holidays;;0 - 20,000;21;1;20;0;0;0
1514010;Cannibal Coast!;;0 - 20,000;1;0;1;0;0;0
1514070;Video Realms;;0 - 20,000;4;3;1;0;0;1
1514100;Adventure War : Battlefield;;0 - 20,000;17;14;3;0;0;0
1514170;BIRBOUT!;;0 - 20,000;3;0;3;0;0;0
1514190;This rain will never end - noir adventure detective;;20,000 - 50,000;3;2;1;0;0;0
1514250;Freed Soft;;0 - 20,000;2;1;1;0;0;0
1514290;Kazakh 'Jack;;0 - 20,000;1;0;1;0;0;0
1514300;The Tower Of TigerQiuQiu 2;;20,000 - 50,000;2;3;-1;0;0;0
1514360;Laid-Back Camp - Virtual - Lake Motosu;;20,000 - 50,000;259;73;186;0;0;0
1514370;Laid-Back Camp - Virtual - Fumoto Campsite;;0 - 20,000;105;11;94;0;0;0
1514370;Laid-Back Camp - Virtual - Fumoto Campsite;;0 - 20,000;105;11;94;0;0;0
1514380;COGEN: Sword of Rewind / COGEN: 大鳥こはくと刻の剣;;0 - 20,000;58;19;39;0;0;1
1514430;Reek N' Havok;;0 - 20,000;4;0;4;0;0;0
1514480;Lucid Cycle;;0 - 20,000;39;14;25;0;0;0
1514580;The Great Chicken Thief;;0 - 20,000;1;1;0;0;0;0
1514610;Rising Mist;;0 - 20,000;26;6;20;0;0;0
1514620;Quiet Thoughts;;0 - 20,000;12;4;8;0;0;0
1514640;Scrapshoot;;20,000 - 50,000;15;0;15;0;0;0
1514650;Waifu's Spooky Space Station;;20,000 - 50,000;16;1;15;0;0;0
1514660;Battle Ball;;50,000 - 100,000;387;63;324;0;0;0
1514690;Peekaboo Lite;;0 - 20,000;124;53;71;0;0;0
1514690;Peekaboo Lite;;0 - 20,000;124;53;71;0;0;0
1514730;The Dream of Shadowlands Episode 2;;20,000 - 50,000;5;0;5;0;0;0
1514740;Chaos Road;;0 - 20,000;1;2;-1;0;0;0
1514780;Battle for Esturia;;20,000 - 50,000;31;2;29;0;0;1
1514840;All-In-One Sports VR;;0 - 20,000;358;66;292;304;405;12
1514890;VR Shark;;0 - 20,000;3;2;1;0;0;0
1514910;LURE: FREE;;0 - 20,000;6;59;-53;0;0;0
1514920;Base Jump;;0 - 20,000;1;0;1;0;0;0
1514930;Erica;;100,000 - 200,000;1078;284;794;115;182;2
1514950;Neodash;;0 - 20,000;362;40;322;68;68;1
1514980;Kingdom Builders;;;;;0;;;
1515040;Bloks;;0 - 20,000;8;7;1;0;0;0
1515140;Huntfeast;;50,000 - 100,000;11;12;-1;0;0;5
1515170;Maze Escape;;0 - 20,000;1;1;0;0;0;0
1515180;Junkyard Simulator: First Car (Prologue 2);;100,000 - 200,000;319;140;179;0;0;4
1515200;Mission in Snowdriftland;;0 - 20,000;238;8;230;0;0;3
1515210;The Past Within;;500,000 - 1,000,000;8426;458;7968;168;158;226
1515280;Detective Story;;50,000 - 100,000;59;31;28;0;0;0
1515290;Boodunnit;;20,000 - 50,000;289;106;183;0;0;3
1515320;Harvest Days: My Dream Farm;;0 - 20,000;70;30;40;0;0;6
1515340;Lazy Postman;;0 - 20,000;11;5;6;0;0;0
1515390;Splunk VR;;0 - 20,000;2;0;2;0;0;0
1515420;The Vampire Regent;;0 - 20,000;24;6;18;0;0;1
1515460;Prison Tycoon: Under New Management;;0 - 20,000;97;50;47;189;189;4
1515490;System Purge;;0 - 20,000;115;4;111;0;0;0
1515600;SSCS;;0 - 20,000;1;0;1;0;0;0
1515610;Primeval;;0 - 20,000;5;1;4;0;0;0
1515730;Yellowlooper;;0 - 20,000;2;0;2;0;0;0
1515740;Super Sports Blast;;0 - 20,000;29;4;25;0;0;3
1515750;Star Squadron: Student Driver;;20,000 - 50,000;2;1;1;0;0;0
1515820;Guns of Succubus;;0 - 20,000;49;7;42;0;0;1
1515830;No.L85;;0 - 20,000;7;7;0;0;0;0
1515890;TAISHO x ALICE episode 3;;20,000 - 50,000;209;13;196;0;0;6
1515900;Heaven Dust 2;;20,000 - 50,000;539;51;488;1112;1112;5
1515930;Wild Workshop;;100,000 - 200,000;0;2;-2;0;0;0
1515950;Capcom Arcade Stadium;;2,000,000 - 5,000,000;1718;1568;150;207;187;34
1515970;Spin & Roll;;0 - 20,000;2;0;2;0;0;0
1515980;Kill Demons;;20,000 - 50,000;8;9;-1;0;0;0
1516050;PixageFX Studio;;0 - 20,000;103;10;93;0;0;5
1516080;That Time I Got Reincarnated as an Orc;;20,000 - 50,000;276;27;249;0;0;3
1516190;A Hole In Space;;0 - 20,000;14;3;11;0;0;1
1516240;Mitoza;;100,000 - 200,000;2430;79;2351;0;0;4
1516320;Skeleton King;;100,000 - 200,000;25;2;23;0;0;1
1516330;Acolyte;;20,000 - 50,000;40;7;33;0;0;7
1516350;Textreme 2;;0 - 20,000;16;1;15;0;0;1
1516360;Red Galaxy;;20,000 - 50,000;8;0;8;0;0;0
1516400;Gaia Project;;0 - 20,000;180;64;116;0;0;20
1516400;Gaia Project;;0 - 20,000;180;64;116;0;0;20
1516440;ATC Infinite;;0 - 20,000;26;13;13;0;0;0
1516450;Red Mist: Rivers of Blood;;0 - 20,000;3;0;3;0;0;0
1516490;CompactO - Idle Game;;20,000 - 50,000;48;16;32;0;0;6
1516510;INFINITE VERSUS: 3D MUGEN;;0 - 20,000;28;25;3;0;0;0
1516530;Super Retro World;;0 - 20,000;0;1;-1;0;0;0
1516550;Vectors;;0 - 20,000;22;0;22;0;0;0
1516560;Ministry of Pandemic;;0 - 20,000;3;1;2;0;0;1
1516580;Unknown Woods;;20,000 - 50,000;3;2;1;0;0;0
1516600;HyperShot;;0 - 20,000;1;0;1;0;0;0
1516610;RC Airplane Challenge;;0 - 20,000;4;0;4;0;0;0
1516680;De'Vine: Heavenly Acres;;0 - 20,000;23;5;18;0;0;1
1516750;Alien Marauder;;20,000 - 50,000;187;66;121;0;0;12
1516750;Alien Marauder;;20,000 - 50,000;187;66;121;0;0;12
1516760;Cat Colony Crisis;;0 - 20,000;37;4;33;0;0;1
1516820;春秋;;0 - 20,000;192;95;97;0;0;7
1516900;RASPBERRY MASH;;0 - 20,000;21;7;14;0;0;0
1516960;Flying Frags World Tour;;50,000 - 100,000;3;1;2;0;0;0
1516980;Crazy Defense Heroes;;0 - 20,000;14;23;-9;0;0;0
1517110;After Meeting;;0 - 20,000;5;0;5;0;0;0
1517120;Tiny Defender;;0 - 20,000;6;1;5;0;0;0
1517150;Project Castle;;50,000 - 100,000;619;64;555;0;0;4
1517160;Under The Ghost Mountain;;0 - 20,000;26;0;26;0;0;0
1517190;The Daunting House;;20,000 - 50,000;3;3;0;0;0;0
1517220;Crazy Factory;;0 - 20,000;0;1;-1;0;0;0
1517230;Visiting a celebrity;;0 - 20,000;20;4;16;0;0;0
1517240;CHESS with LASERS;;0 - 20,000;27;0;27;0;0;1
1517290;Battlefield 2042;;5,000,000 - 10,000,000;58765;117131;-58366;3119;1683;9730
1517320;1000 Shards;;0 - 20,000;12;4;8;0;0;0
1517340;From The Darkness;;50,000 - 100,000;1718;172;1546;101;124;8
1517350;Hidden Memory - Neko's Life;;0 - 20,000;50;5;45;0;0;0
1517370;PACT - Process Affinity Control Tool;;0 - 20,000;1;0;1;0;0;0
1517390;Mars Mission;;0 - 20,000;2;6;-4;0;0;0
1517440;Star Aegis;;0 - 20,000;7;0;7;0;0;0
1517490;Peaceful Gunner;;0 - 20,000;17;0;17;0;0;0
1517520;Foglight Online;;0 - 20,000;42;42;0;0;0;0
1517530;Sparkles & Gems;;0 - 20,000;16;1;15;0;0;0
1517560;Droplet: States of Matter;;0 - 20,000;5;0;5;0;0;0
1517770;Astrokicker;;0 - 20,000;4;0;4;0;0;0
1517810;反图灵测试/Anti-TuringTest;;0 - 20,000;26;4;22;0;0;0
1517830;Miska's Cave;;0 - 20,000;151;20;131;0;0;1
1517870;StalakMiner;;50,000 - 100,000;8;0;8;0;0;0
1517890;SynthVR;;0 - 20,000;49;6;43;0;0;1
1517960;Rebirth:Beware of Mr.Wang;;50,000 - 100,000;1439;690;749;142;166;13
1517970;Aeterna Noctis;;0 - 20,000;791;173;618;2254;2254;13
1517990;Aruna;;0 - 20,000;0;1;-1;0;0;0
1518000;CooKing;;0 - 20,000;4;3;1;0;0;0
1518020;Tales From The Cache;;0 - 20,000;7;0;7;0;0;0
1518090;Freelancer Life Simulator: Prologue;;0 - 20,000;3;15;-12;0;0;0
1518100;Build Em' Faster;;0 - 20,000;2;1;1;0;0;0
1518140;Dear Mom;;0 - 20,000;13;5;8;0;0;0
1518200;Agent Murphy;;0 - 20,000;28;5;23;0;0;0
1518200;Agent Murphy;;0 - 20,000;28;5;23;0;0;0
1518240;PATHFINDER 08;;0 - 20,000;3;2;1;0;0;0
1518300;Two Guys One Cabin;;20,000 - 50,000;47;19;28;0;0;0
1518320;Minesweeper Versus;;0 - 20,000;5;0;5;0;0;0
1518350;Higgs Boson: Minimal Puzzle;;0 - 20,000;36;2;34;0;0;0
1518360;UnearthU;;0 - 20,000;21;1;20;0;0;0
1518370;Theme Park Mystery;;0 - 20,000;1;0;1;0;0;0
1518380;The Killing Cloud;;0 - 20,000;1;0;1;0;0;0
1518430;Eiyu*Senki Gold – A New Conquest;;20,000 - 50,000;258;48;210;0;0;2
1518610;Revertia;;0 - 20,000;1;0;1;0;0;0
1518630;Pretty Girls Panic! PLUS;;0 - 20,000;3;3;0;0;0;0
1518640;VR Girls’ Room in Darkness;;0 - 20,000;10;5;5;0;0;0
1518680;Travel Fanz;;0 - 20,000;1;0;1;0;0;0
1518690;Nevermore: The Chamber Door;;0 - 20,000;50;4;46;0;0;0
1518770;Re: LieF ~ Shin'ainaru Anata e~;;0 - 20,000;587;23;564;1;1;10
1518810;Koi Farm;;20,000 - 50,000;616;29;587;96;96;9
1518820;Horse Club Adventures;;0 - 20,000;67;7;60;0;0;13
1518870;Across;;0 - 20,000;4;1;3;0;0;0
1518890;Triblock;;0 - 20,000;2;1;1;0;0;0
1518990;Degradation(Alpha);;20,000 - 50,000;1;0;1;0;0;0
1519000;Confusing game;;0 - 20,000;3;0;3;0;0;0
1519010;Kamikaze Veggies;;0 - 20,000;70;3;67;0;0;0
1519020;Boom;;0 - 20,000;17;3;14;0;0;0
1519040;Kombi Travels - Jigsaw Landscapes;;0 - 20,000;16;2;14;0;0;0
1519050;SGS Heia Safari;;0 - 20,000;14;1;13;0;0;0
1519060;SGS Taipings;;0 - 20,000;83;12;71;0;0;23
1519070;SGS Halls of Montezuma;;0 - 20,000;22;6;16;0;0;1
1519110;ChillaxVR;;0 - 20,000;10;5;5;0;0;0
1519130;CARGAME;;100,000 - 200,000;51;28;23;0;0;0
1519140;[Neolithic]To the End;;20,000 - 50,000;11;1;10;0;0;0
1519190;Duck Flight Simulator 2021;;0 - 20,000;11;7;4;0;0;0
1519230;The Last From Mars;;0 - 20,000;3;1;2;0;0;0
1519310;AI Dungeon—Traveler Edition;;100,000 - 200,000;220;201;19;236;236;83
1519340;LASHEK;;;;;0;;;
1519350;Madden NFL 22;;200,000 - 500,000;3725;3346;379;2512;2623;400
1519360;The Legends in Kylamar;;0 - 20,000;1;1;0;0;0;0
1519420;DMN7;;0 - 20,000;1;0;1;0;0;0
1519470;Endless Furry Killer 3D;;0 - 20,000;67;8;59;0;0;0
1519490;The Doors of Trithius;;0 - 20,000;119;4;115;0;0;6
1519550;Rebellion Gaia;;20,000 - 50,000;14;3;11;0;0;3
1519560;Coin Flipping Simulator for Probability and Statistics;;0 - 20,000;12;0;12;0;0;0
1519570;Starter Pack;;0 - 20,000;1;0;1;0;0;0
1519590;Sentimental Trickster: Yaoi BL Gay Visual Novel;;0 - 20,000;63;1;62;0;0;1
1519610;Assau!t;;20,000 - 50,000;1;0;1;0;0;0
1519620;X air combat;;20,000 - 50,000;1;5;-4;0;0;0
1519640;Simulation world;;0 - 20,000;51;6;45;0;0;0
1519650;Haunted Nightmares;;0 - 20,000;5;0;5;0;0;0
1519660;Goat over it;;0 - 20,000;28;11;17;0;0;1
1519680;Ultimatum: Casting;;0 - 20,000;3;0;3;0;0;0
1519690;STAY;;0 - 20,000;38;1;37;0;0;0
1519730;Wildfire - Ticket to Rock;;0 - 20,000;6;0;6;0;0;0
1519770;n-body;;0 - 20,000;12;0;12;0;0;0
1519790;Fast Food Manager;;0 - 20,000;167;66;101;0;0;1
1519800;Halloween Trouble 2;;0 - 20,000;6;5;1;0;0;0
1519850;STOP and MOVE;;0 - 20,000;6;1;5;0;0;0
1519880;Skullbangers!;;0 - 20,000;4;0;4;0;0;0
1519890;Tiny Space Academy;;0 - 20,000;29;17;12;0;0;0
1519900;MASAGORO;;0 - 20,000;39;14;25;0;0;0
1519910;Utopia Process;;0 - 20,000;3;1;2;0;0;0
1520090;Jin Conception;;0 - 20,000;6;7;-1;0;0;0
1520110;Etched Memories Demo;;0 - 20,000;73;34;39;0;0;0
1520120;Death Dream;;0 - 20,000;19;8;11;0;0;0
1520150;Witch's Reign;;0 - 20,000;1;2;-1;0;0;0
1520170;Sexy Sniper;;0 - 20,000;37;13;24;0;0;0
1520250;Gnome Jigsaw Puzzles;;0 - 20,000;33;1;32;0;0;1
1520260;Skill at Time;;0 - 20,000;14;3;11;0;0;0
1520270;Kyvir: Rebirth;;0 - 20,000;331;64;267;0;0;2
1520290;Crumbling City;;0 - 20,000;5;1;4;0;0;0
1520310;We'll always have Paris;;0 - 20,000;9;1;8;0;0;0
1520330;TechBeat Heart;;0 - 20,000;66;5;61;0;0;0
1520370;Mon Bazou;;100,000 - 200,000;6571;202;6369;5344;7755;1572
1520380;HALF DEAD 3;;0 - 20,000;309;98;211;36;36;2
1520390;Hotel Paris;;0 - 20,000;2;3;-1;0;0;0
1520460;Adventure Field 4;;0 - 20,000;2;1;1;0;0;0
1520470;封灵档案;;2,000,000 - 5,000,000;14593;3602;10991;2263;46;1087
1520510;Itadaki Smash;;0 - 20,000;14;3;11;0;0;0
1520570;DreamCatcher: Reflections Volume 1;;20,000 - 50,000;3;0;3;0;0;0
1520580;Blood of the Alchemists;;0 - 20,000;1;0;1;0;0;0
1520610;BlackJack Math Cross Numbers;;0 - 20,000;13;4;9;0;0;0
1520640;Ultimate Bumper Cars - Dodgems;;0 - 20,000;2;1;1;0;0;0
1520670;Escape of Pinball;;0 - 20,000;1;0;1;0;0;0
1520680;Tetra Cube;;0 - 20,000;46;7;39;0;0;0
1520690;Die Rangliste;;20,000 - 50,000;1;0;1;0;0;0
1520710;Entodrive;;0 - 20,000;13;4;9;0;0;0
1520760;Tyrant's Blessing;;0 - 20,000;132;46;86;3;3;5
1520760;Tyrant's Blessing;;0 - 20,000;132;46;86;3;3;5
1520810;Flatline;;50,000 - 100,000;10;6;4;0;0;0
1520830;Casual Commando;;0 - 20,000;4;0;4;0;0;0
1520850;Mess Adventures 2;;0 - 20,000;68;10;58;0;0;0
1520880;The Last Bastion;;0 - 20,000;6;0;6;0;0;0
1520900;Castle Cardians;;0 - 20,000;94;19;75;0;0;2
1520950;ChatManager;;0 - 20,000;5;1;4;0;0;0
1521040;Nature Treks: Together;;0 - 20,000;15;12;3;0;0;0
1521050;ZombieVan Drive;;0 - 20,000;2;3;-1;0;0;0
1521070;The Pegasus Expedition;;0 - 20,000;62;17;45;0;0;3
1521110;Black Baby;;0 - 20,000;70;5;65;0;0;1
1521160;Are You Smarter Than A 5th Grader;;0 - 20,000;17;5;12;0;0;6
1521190;Love in the distance;;20,000 - 50,000;221;116;105;0;0;0
1521410;Manic Archers;;0 - 20,000;6;1;5;0;0;0
1521490;My Dream Sport Dating Simulator;;0 - 20,000;13;3;10;0;0;0
1521520;SKIIIIIIIIIIIIIIID;;0 - 20,000;38;6;32;0;0;0
1521580;Perfect Heist 2;;200,000 - 500,000;1502;83;1419;252;428;239
1521670;Flesh Eating Geriatric Internet Predator;;20,000 - 50,000;9;12;-3;0;0;0
1521690;Lost Robot;;0 - 20,000;4;4;0;0;0;0
1521760;Dodge Dancer;;0 - 20,000;2;1;1;0;0;0
1521770;Ero Tennis;;0 - 20,000;3;10;-7;0;0;0
1521780;Ruin;;20,000 - 50,000;2;1;1;0;0;0
1521810;Salamander County Public Television;;20,000 - 50,000;50;1;49;0;0;3
1521820;LightWave;;0 - 20,000;4;0;4;0;0;0
1521870;Riddle of the Sphinx The Awakening (Enhanced Edition);;50,000 - 100,000;68;10;58;0;0;1
1521900;Rome 2077: Space Wars;;0 - 20,000;3;0;3;0;0;0
1521920;Merchants of the Caribbean;;0 - 20,000;12;4;8;0;0;0
1521930;A Tale for Anna;;0 - 20,000;78;6;72;0;0;1
1521960;Just Shake It;;0 - 20,000;5;0;5;0;0;0
1521980;Giants;;200,000 - 500,000;25;25;0;0;0;0
1522010;Firescout;;20,000 - 50,000;4;2;2;0;0;0
1522030;SUKAKKO;;0 - 20,000;1;0;1;0;0;0
1522040;MessiahEnd Refrain;;0 - 20,000;4;0;4;0;0;0
1522070;Zenith Into Maronarium;;0 - 20,000;8;0;8;0;0;0
1522120;Thrilling Triple Treat;;0 - 20,000;2;0;2;0;0;0
1522140;Demon Skin;;0 - 20,000;77;23;54;0;0;0
1522180;Destiny Island;;0 - 20,000;11;10;1;0;0;0
1522180;Destiny Island;;0 - 20,000;11;10;1;0;0;0
1522190;ASTRA;;20,000 - 50,000;11;7;4;0;0;0
1522230;Wild West Crops;;0 - 20,000;12;2;10;0;0;0
1522280;Grim Realms;;0 - 20,000;170;47;123;0;0;8
1522300;Trenga Unlimited;;20,000 - 50,000;5;0;5;0;0;0
1522320;Nyanco Desktop Mascot;;20,000 - 50,000;52;4;48;0;0;0
1522350;Zombie Drift;;0 - 20,000;1;2;-1;0;0;0
1522470;Deck Adventurers - Origins;;0 - 20,000;19;0;19;0;0;0
1522490;Boring in paradise;;0 - 20,000;2;1;1;0;0;0
1522530;Ero Snooker;;0 - 20,000;0;7;-7;0;0;0
1522560;100 hidden mice;;0 - 20,000;199;15;184;0;0;0
1522570;Mauri Mursu's Hangover;;0 - 20,000;1;0;1;0;0;0
1522630;Dark Treasury;;0 - 20,000;38;14;24;0;0;0
1522640;Short Fuse;;0 - 20,000;7;0;7;0;0;0
1522660;Introvert: A Teenager Simulator;;100,000 - 200,000;536;157;379;0;0;0
1522710;LX Patterns;;0 - 20,000;22;2;20;0;0;0
1522770;The Sych story;;20,000 - 50,000;40;3;37;0;0;0
1522800;Imercyve: Living with Intellectual Disability;;0 - 20,000;1;2;-1;0;0;0
1522820;Orcs Must Die! 3;;2,000,000 - 5,000,000;8744;1577;7167;669;632;404
1522850;Watermelon Blocks;;0 - 20,000;35;0;35;0;0;0
1522860;flaming/million;;0 - 20,000;3;2;1;0;0;0
1522870;Supraland Six Inches Under;;200,000 - 500,000;2138;66;2072;476;536;58
1522900;Pizza Shop Manager;;0 - 20,000;1;3;-2;0;0;0
1522930;Transiruby;;0 - 20,000;166;11;155;0;0;2
1522930;Transiruby;;0 - 20,000;166;11;155;0;0;2
1522950;Dadish;;0 - 20,000;132;6;126;0;0;1
1522970;AmIHero;;0 - 20,000;6;0;6;0;0;0
1522980;Cavebound;;0 - 20,000;3;2;1;0;0;0
1523010;Puppy Pipy;;0 - 20,000;28;1;27;0;0;0
1523100;Isolationist Nightclub Simulator;;0 - 20,000;9;4;5;0;0;0
1523100;Isolationist Nightclub Simulator;;0 - 20,000;9;4;5;0;0;0
1523130;神启神落;;20,000 - 50,000;0;5;-5;0;0;0
1523150;Ascension: Transition and Silver;;0 - 20,000;45;3;42;0;0;1
1523170;Aladdin : Save The Princess;;0 - 20,000;17;2;15;0;0;0
1523220;Overpower;;0 - 20,000;3;2;1;0;0;0
1523260;迷霧國度: 傳承 Myth of Mist：Legacy;;0 - 20,000;77;19;58;0;0;5
1523290;Blacksmith Legends: Prologue;;0 - 20,000;90;54;36;0;0;0
1523350;Rocket Drift;;20,000 - 50,000;12;0;12;0;0;1
1523360;VR Parallel World;;0 - 20,000;18;9;9;0;0;0
1523370;A.D. 2047;;50,000 - 100,000;107;35;72;0;0;0
1523390;Fantasy Tavern Sextet -Vol.3 Postlude Days-;;0 - 20,000;157;16;141;0;0;0
1523400;Livestream: Escape from Hotel Izanami;;0 - 20,000;416;93;323;138;138;4
1523400;Livestream: Escape from Hotel Izanami;;0 - 20,000;416;93;323;138;138;4
1523510;Cave Digger 2: Dig Harder;;0 - 20,000;69;13;56;0;0;0
1523630;World of Fantasy: Zero;;20,000 - 50,000;0;1;-1;0;0;0
1523670;Eggy;;0 - 20,000;36;4;32;0;0;0
1523680;Jigsaw Pieces - Sweet Times;;0 - 20,000;12;0;12;0;0;1
1523720;Cook-Out;;0 - 20,000;179;20;159;110;153;11
1523780;Hajji VR;;0 - 20,000;0;1;-1;0;0;0
1523790;Hope's Journey: A Therapeutic Experience;;0 - 20,000;13;2;11;0;0;0
1523800;Mighty Forest;;0 - 20,000;50;33;17;0;0;1
1523990;Vampire: The Masquerade — Sins of the Sires;;0 - 20,000;43;66;-23;0;0;2
1524020;Escape from Terror City;;0 - 20,000;23;4;19;0;0;0
1524110;Stories of Liane;;50,000 - 100,000;71;21;50;0;0;0
1524150;Tales of Farhollow;;0 - 20,000;5;0;5;0;0;0
1524160;孙美琪疑案 第四季;;100,000 - 200,000;3;1;2;0;0;0
1524170;Pixel Game Maker Series Remote Bomber;;0 - 20,000;3;1;2;0;0;0
1524190;POSSESSED BLOODY ASYLUM;;0 - 20,000;1;2;-1;0;0;0
1524230;Mori's Nightmare : Hide and seek;;20,000 - 50,000;37;19;18;0;0;1
1524290;留白(WhiteWash);;0 - 20,000;4;0;4;0;0;0
1524340;Street karate 3;;50,000 - 100,000;36;5;31;0;0;0
1524350;ReversEstory;;0 - 20,000;53;8;45;0;0;0
1524370;Astellia Royal;;50,000 - 100,000;184;301;-117;0;0;0
1524380;Dr. oil;;0 - 20,000;45;4;41;0;0;0
1524400;Ragdoll: Fall Simulator;;0 - 20,000;62;16;46;0;0;0
1524550;Madshot;;50,000 - 100,000;98;13;85;0;0;8
1524580;Dual Cars;;0 - 20,000;4;0;4;0;0;0
1524650;Sakura Forest Girls;;0 - 20,000;36;7;29;0;0;1
1524690;Chess Brain: Dark Troops;;20,000 - 50,000;47;2;45;0;0;0
1524710;Dark Flowers;;0 - 20,000;24;3;21;0;0;0
1524710;Dark Flowers;;0 - 20,000;24;3;21;0;0;0
1524750;Dude Simulator 4;;0 - 20,000;204;147;57;0;0;2
1524790;Loneliness;;20,000 - 50,000;97;12;85;0;0;0
1524810;Carotic - Academic Version;;0 - 20,000;6;0;6;0;0;0
1524920;ThroughHelltoHeaven;;0 - 20,000;5;0;5;0;0;0
1524930;To Be With You;;0 - 20,000;21;0;21;0;0;1
1524990;Survive after hell;;0 - 20,000;4;2;2;0;0;0
1525060;UNPLUGGED;;0 - 20,000;11;0;11;0;0;0
1525190;Monster Outbreak;;20,000 - 50,000;60;22;38;0;0;1
1525210;Steel Graves;;20,000 - 50,000;4;1;3;0;0;0
1525270;Sports Paradise VR;;0 - 20,000;4;1;3;0;0;0
1525320;Dadish 2;;0 - 20,000;51;1;50;0;0;1
1525330;Guardians of Hyelore;;0 - 20,000;28;17;11;0;0;7
1525370;Amazing Chicken Adventures ;;0 - 20,000;2;1;1;0;0;0
1525390;Eternity Protectors;;0 - 20,000;1;0;1;0;0;0
1525410;Wulin Chess;;20,000 - 50,000;327;88;239;0;0;4
1525420;Heads Will Roll;;0 - 20,000;119;34;85;0;0;0
1525440;VR Shooting Range: Multiple Weapons;;20,000 - 50,000;16;8;8;0;0;0
1525490;异世界攻略组 Another World Adventure;;0 - 20,000;49;13;36;0;0;0
1525540;Double world. cave song castle;;20,000 - 50,000;3;0;3;0;0;0
1525560;A Knights Adventure;;0 - 20,000;3;0;3;0;0;0
1525620;The Architect: Paris;;0 - 20,000;162;45;117;0;0;2
1525640;The Build And Race Hotrod Game;;0 - 20,000;0;2;-2;0;0;0
1525650;Solo Fox;;0 - 20,000;18;3;15;0;0;0
1525660;Sunblaze;;0 - 20,000;268;22;246;69;69;0
1525700;Tavern Master;;200,000 - 500,000;4598;359;4239;416;454;117
1525760;Taxi Driver - The Simulation;;0 - 20,000;5;6;-1;0;0;0
1525770;The Dark Side of the Moon: An Interactive FMV Thriller;;100,000 - 200,000;83;41;42;0;0;0
1525810;BoomXR;;0 - 20,000;5;1;4;0;0;0
1525890;Death Park 2;;0 - 20,000;114;13;101;0;0;1
1525900;Infinite Dungeon Crawler;;20,000 - 50,000;11;16;-5;0;0;0
1525970;Typed82;;0 - 20,000;9;0;9;0;0;1
1525990;Cubiti pARti;;0 - 20,000;0;1;-1;0;0;0
1526000;folding maze;;0 - 20,000;1;0;1;0;0;0
1526020;Bullet Time;;20,000 - 50,000;3;2;1;0;0;0
1526090;Rising Noracam;;0 - 20,000;10;2;8;0;0;0
1526120;HARD TAPES;;0 - 20,000;33;31;2;0;0;0
1526160;Four Kings: Video Poker;;0 - 20,000;5;1;4;0;0;1
1526170;Dig Deep: Race To The Core!;;0 - 20,000;1;1;0;0;0;0
1526180;Hide and Seek;;0 - 20,000;82;23;59;45;45;0
1526190;Mysteries of Shaola: The Cave;;20,000 - 50,000;2;0;2;0;0;0
1526220;Spacegirl;;0 - 20,000;1;0;1;0;0;0
1526260;Days of Heroes: D-Day;;0 - 20,000;29;14;15;0;0;0
1526330;Lilith Was Dead;;20,000 - 50,000;9;1;8;0;0;0
1526340;Jetscout: Boot Camp;;0 - 20,000;10;0;10;0;0;0
1526350;Harlow;;0 - 20,000;21;3;18;0;0;0
1526360;Customers From Hell - Game For Retail Workers (Zombie Survival Game);;0 - 20,000;2;1;1;0;0;0
1526380;Excavator Simulator VR;;0 - 20,000;34;20;14;47;47;0
1526480;battle Tank;;0 - 20,000;2;9;-7;0;0;0
1526490;Fear Surrounds;;200,000 - 500,000;8699;1332;7367;3942;1883;857
1526580;Zombie Dungeon;;0 - 20,000;1;3;-2;0;0;0
1526600;MaJiang;;0 - 20,000;2;8;-6;0;0;0
1526680;Russian Prison Tattoo Simulator;;0 - 20,000;12;1;11;0;0;0
1526690;Chinese Bull;;0 - 20,000;5;1;4;0;0;0
1526750;Remember When;;0 - 20,000;36;6;30;0;0;0
1526780;Dark Podval;;50,000 - 100,000;14;8;6;0;0;0
1526790;Soldier in the darkness;;50,000 - 100,000;6;5;1;0;0;0
1526920;Forest Dash;;0 - 20,000;24;0;24;0;0;0
1526930;PolyCore Defense;;0 - 20,000;42;4;38;0;0;2
1527060;Cat Gets Medieval;;0 - 20,000;87;1;86;0;0;0
1527070;Commanding Nations;;0 - 20,000;24;14;10;0;0;1
1527080;XTHRUST;;0 - 20,000;9;11;-2;0;0;1
1527090;Cat's Menace;;50,000 - 100,000;6;7;-1;0;0;0
1527110;Play Enactor;;0 - 20,000;2;3;-1;0;0;0
1527140;SC2KRender;;0 - 20,000;15;0;15;0;0;0
1527170;Flying Girls;;0 - 20,000;18;2;16;0;0;0
1527230;UC KART;;0 - 20,000;1;3;-2;0;0;0
1527260;The Last Town: Excape;;0 - 20,000;49;13;36;0;0;0
1527260;The Last Town: Excape;;0 - 20,000;49;13;36;0;0;0
1527280;Starship Tunnel;;0 - 20,000;1;2;-1;0;0;0
1527380;引力魔方(Gravity rubik's cube);;0 - 20,000;10;2;8;0;0;0
1527460;Azrael;;0 - 20,000;8;1;7;0;0;0
1527500;Pro Strategy Football 2022;;0 - 20,000;78;10;68;0;0;3
1527510;Romeow: in the cracked world;;0 - 20,000;93;2;91;0;0;0
1527520;Bombing!!: A Graffiti Sandbox;;20,000 - 50,000;84;8;76;0;0;0
1527620;The Little Trashmaid Puzzletime;;0 - 20,000;23;1;22;0;0;0
1527640;The Lost Game: Royal Game Of Ur;;0 - 20,000;6;0;6;0;0;0
1527670;Goblin Dungeoneer;;0 - 20,000;6;8;-2;0;0;1
1527710;Earth Elements;;50,000 - 100,000;2;2;0;0;0;0
1527780;Crossbow Crusade;;0 - 20,000;17;4;13;0;0;0
1527830;Gate to Site 8;;0 - 20,000;19;6;13;0;0;0
1527880;Darkness Under My Bed;;0 - 20,000;60;6;54;0;0;1
1527890;Dysterra;;20,000 - 50,000;257;184;73;0;0;43
1527910;Gladio and Glory;;200,000 - 500,000;2918;252;2666;0;0;17
1527920;Biotech Samurai;;0 - 20,000;7;5;2;0;0;0
1527930;RHEM III SE;;0 - 20,000;18;4;14;0;0;1
1527950;Wartales;;200,000 - 500,000;8783;892;7891;2029;1932;3589
1527960;The Help Desk;;0 - 20,000;1;0;1;0;0;0
1528020;Afterlife VR;;0 - 20,000;102;23;79;0;0;1
1528110;Athena, the rabbit - Jigsaw Puzzle;;0 - 20,000;18;0;18;0;0;0
1528120;ComPressure;;50,000 - 100,000;46;6;40;0;0;0
1528130;Suicide Countdown: 7 Days;;100,000 - 200,000;741;138;603;122;178;0
1528200;Endurance Labyrinth;;0 - 20,000;18;1;17;0;0;0
1528230;Tabbris Yor;;0 - 20,000;0;1;-1;0;0;0
1528240;Super Dirt Racers;;20,000 - 50,000;187;47;140;0;0;0
1528290;Across the demon realm;;0 - 20,000;1;2;-1;0;0;0
1528300;Mythic Zombies;;0 - 20,000;9;3;6;0;0;0
1528300;Mythic Zombies;;0 - 20,000;9;3;6;0;0;0
1528370;CHACAL;;0 - 20,000;14;4;10;0;0;0
1528430;Rolf;;0 - 20,000;1;0;1;0;0;0
1528470;Starlight: Defence Command;;0 - 20,000;7;2;5;0;0;0
1528520;Fenrir's Prelude;;100,000 - 200,000;5;2;3;0;0;0
1528570;Royale Island Showdown;;20,000 - 50,000;104;18;86;0;0;0
1528580;Neon Ships: The Type'em Up Shooter;;20,000 - 50,000;42;3;39;0;0;0
1528680;Inn Mage;;0 - 20,000;9;13;-4;0;0;2
1528770;RoadPunk;;0 - 20,000;4;2;2;0;0;0
1528780;ABERRATION TOWN;;0 - 20,000;3;8;-5;0;0;0
1528810;Exodus Borealis;;0 - 20,000;202;15;187;0;0;3
1528820;Unconventional Ragdoll Game;;0 - 20,000;1;1;0;0;0;0
1528860;The Legend of Karl;;20,000 - 50,000;224;65;159;0;0;0
1528880;Time to GOLF;;0 - 20,000;12;2;10;0;0;0
1528890;Climb Human;;0 - 20,000;16;18;-2;0;0;0
1528900;Charge Champs;;0 - 20,000;2;0;2;0;0;0
1528920;Andromeda Zombies Colonies;;0 - 20,000;22;22;0;0;0;0
1528980;Pit of Ascension;;0 - 20,000;4;0;4;0;0;0
1529100;What The Maze;;0 - 20,000;3;3;0;0;0;0
1529110;Bloody Raid;;100,000 - 200,000;68;20;48;0;0;0
1529160;Gunborg: Dark Matters;;0 - 20,000;42;1;41;0;0;1
1529220;Block'Em!;;0 - 20,000;57;6;51;76;76;0
1529240;AudiobookConverter;;0 - 20,000;17;5;12;0;0;5
1529410;Jigsaw Pieces - Romance;;0 - 20,000;10;2;8;0;0;0
1529430;Panic Mode;;0 - 20,000;20;0;20;0;0;0
1529440;Bomb Escape;;50,000 - 100,000;1;1;0;0;0;0
1529470;Ethereal Estate;;20,000 - 50,000;180;26;154;0;0;1
1529570;MorphVOX Pro 5 - Voice Changer;;0 - 20,000;52;56;-4;0;0;65
1529710;Симулятор Прыгания по Гаражам;;0 - 20,000;410;112;298;0;0;3
1529710;Симулятор Прыгания по Гаражам;;0 - 20,000;410;112;298;0;0;3
1529770;Tezz;;0 - 20,000;27;1;26;0;0;0
1529800;SpacePOM;;20,000 - 50,000;5;0;5;0;0;0
1529810;Psycholonials;;0 - 20,000;562;74;488;0;0;4
1529860;Ulna Online;;0 - 20,000;12;8;4;0;0;3
1530020;Broken Dungeon;;0 - 20,000;6;1;5;0;0;0
1530040;Creas;;20,000 - 50,000;3;2;1;0;0;0
1530070;#Snake2 DX: Reawakening;;0 - 20,000;3;0;3;0;0;0
1530120;You Must Survive;;50,000 - 100,000;1;4;-3;0;0;0
1530130;Billiards Dungeon;;0 - 20,000;9;1;8;0;0;0
1530140;Aventura Copilului Albastru și Urât;;50,000 - 100,000;2256;15;2241;0;0;1
1530150;Worn Thin;;0 - 20,000;116;40;76;0;0;0
1530150;Worn Thin;;0 - 20,000;116;40;76;0;0;0
1530180;孙美琪疑案 第五季;;20,000 - 50,000;2;1;1;0;0;0
1530230;Restless Night;;0 - 20,000;13;2;11;0;0;0
1530260;Zahhak;;0 - 20,000;1;0;1;0;0;0
1530260;Zahhak;;0 - 20,000;1;0;1;0;0;0
1530280;Pixel Game Maker Series Puzzle Pedestrians;;0 - 20,000;3;1;2;0;0;0
1530290;Nonestory P1;;0 - 20,000;2;0;2;0;0;0
1530340;Incremental Epic Hero;;50,000 - 100,000;183;68;115;127;127;119
1530360;endlessCorona;;0 - 20,000;1;0;1;0;0;0
1530370;Speedy Gun Savage;;0 - 20,000;19;6;13;0;0;0
1530440;Balance Ball;;0 - 20,000;9;2;7;0;0;1
1530580;Lame Defenders;;0 - 20,000;0;1;-1;0;0;0
1530630;Couch Monsters;;0 - 20,000;43;0;43;0;0;0
1530670;Buyhads;;0 - 20,000;12;5;7;0;0;0
1530720;Sport Mode;;20,000 - 50,000;361;63;298;0;0;2
1530750;EVERSLAUGHT;;50,000 - 100,000;233;100;133;0;0;0
1530770;Star Wars Pinball VR;;0 - 20,000;62;98;-36;0;0;1
1530790;Paper Jam!;;0 - 20,000;5;1;4;0;0;0
1530860;Mental Hospital VR;;0 - 20,000;40;15;25;0;0;0
1530890;Car Constructor;;0 - 20,000;51;32;19;0;0;0
1530920;Crush Depth: U-Boat Simulator;;0 - 20,000;64;8;56;0;0;0
1531000;Crime Stories 2: In the Shadows;;0 - 20,000;10;3;7;0;0;0
1531010;Collisus;;0 - 20,000;20;3;17;0;0;0
1531030;NORSK: Epistle;;0 - 20,000;7;0;7;0;0;0
1531040;Pavlov's House;;0 - 20,000;42;0;42;0;0;2
1531070;Sixth Extinction;;0 - 20,000;12;0;12;0;0;0
1531190;Paper Glider;;0 - 20,000;5;0;5;0;0;0
1531200;Pixelstar Hero;;0 - 20,000;2;0;2;0;0;0
1531230;Match Puzzle;;0 - 20,000;1;0;1;0;0;0
1531250;Defend the Rook;;50,000 - 100,000;143;38;105;0;0;5
1531270;Dance with me;;0 - 20,000;2;0;2;0;0;0
1531290;Nebuli;;0 - 20,000;2;0;2;0;0;0
1531300;Galaxy X;;0 - 20,000;3;3;0;0;0;0
1531460;Distorted world;;0 - 20,000;3;2;1;0;0;0
1531490;Harmony's Odyssey;;0 - 20,000;124;5;119;21;21;3
1531540;Distant Worlds 2;;50,000 - 100,000;1522;727;795;1111;1797;173
1531610;Home Designer - Home Sweet Home;;0 - 20,000;9;4;5;0;0;0
1531620;reIterate();;0 - 20,000;42;1;41;0;0;0
1531650;Ancient Gladiators;;0 - 20,000;2;4;-2;0;0;0
1531720;Need for Drive - Open World Multiplayer Racing;;100,000 - 200,000;1264;720;544;15;16;6
1531730;Japanese Drag Racing (JDM) - ジェイディーエム;;0 - 20,000;25;13;12;0;0;0
1531750;Highway Traffic Racer;;0 - 20,000;36;12;24;0;0;0
1531780;废土黄昏 Dusk of the wasteland age;;0 - 20,000;6;3;3;0;0;0
1531790;Silent Earth;;0 - 20,000;14;2;12;0;0;0
1531800;Retro Racer;;0 - 20,000;10;11;-1;0;0;0
1531840;OLEG MONGOL;;0 - 20,000;131;19;112;0;0;0
1531930;Rubicon : a conspiracy of silence;;0 - 20,000;4;0;4;0;0;0
1532080;HeadCount;;0 - 20,000;9;1;8;0;0;0
1532180;Evo\Wave;;50,000 - 100,000;431;17;414;0;0;0
1532240;PocketCiv;;0 - 20,000;2;0;2;0;0;0
1532250;The Catacombs of Solaris Revisited;;0 - 20,000;53;6;47;0;0;0
1532260;Sliko;;20,000 - 50,000;31;3;28;0;0;0
1532300;Sugar Story;;100,000 - 200,000;2;3;-1;0;0;0
1532350;Rogue Explorer;;0 - 20,000;15;16;-1;0;0;0
1532360;Joyspring;;0 - 20,000;102;26;76;0;0;0
1532380;大头侏罗纪;;0 - 20,000;6;2;4;0;0;0
1532400;4 Witch Seasons & Convenant;;0 - 20,000;8;2;6;0;0;0
1532460;The Fridge is Red;;0 - 20,000;90;60;30;0;0;0
1532510;Purrfect Apawcalypse: Love at Furst Bite;;0 - 20,000;336;5;331;65;65;1
1532520;Day Repeat Day;;0 - 20,000;27;3;24;0;0;0
1532640;El Mucho;;0 - 20,000;1;0;1;0;0;0
1532680;The Damathos Clan;;20,000 - 50,000;1;2;-1;0;0;1
1532690;BLACKTAIL;;20,000 - 50,000;585;95;490;66;66;23
1532710;Lucy Dreaming;;0 - 20,000;184;1;183;0;0;6
1532750;Jigsaw Pieces 2 - Shades of Mood;;0 - 20,000;6;0;6;0;0;0
1532760;Jigsaw Pieces 3 - Fantasy;;0 - 20,000;18;0;18;0;0;1
1532780;The Magnets;;0 - 20,000;18;2;16;0;0;0
1532800;Squirrel Divorce;;0 - 20,000;17;4;13;0;0;0
1532810;Gongo;;0 - 20,000;7;5;2;0;0;0
1532830;Red Laser Z;;0 - 20,000;10;1;9;0;0;0
1532840;Annual Intruders;;0 - 20,000;12;2;10;0;0;0
1532920;Clutter IX: Clutter IXtreme;;0 - 20,000;11;0;11;0;0;4
1533050;Press Ctrl;;20,000 - 50,000;341;36;305;0;0;1
1533070;Oracle Trials;;0 - 20,000;16;2;14;0;0;0
1533080;Lumexa;;0 - 20,000;21;6;15;0;0;0
1533120;Shonen Adventure : The Dual Blades Hero;;0 - 20,000;8;2;6;0;0;3
1533260;Morph Space;;0 - 20,000;3;18;-15;0;0;0
1533300;T. B. P.;;0 - 20,000;10;6;4;0;0;0
1533370;Undiscovered House;;0 - 20,000;13;6;7;0;0;0
1533390;Gorilla Tag;;500,000 - 1,000,000;23685;2536;21149;323;32;997
1533410;Mollycoddle Mayhem;;0 - 20,000;4;0;4;0;0;0
1533420;Neon White;;100,000 - 200,000;10176;172;10004;687;1023;203
1533430;LOCO music;;0 - 20,000;11;2;9;0;0;0
1533470;TimeShifters;;20,000 - 50,000;100;1;99;0;0;0
1533500;ORKANA CONFLICT VR;;0 - 20,000;32;3;29;0;0;0
1533520;VR Black Hole Travel Hypothesis;;20,000 - 50,000;0;3;-3;0;0;0
1533560;守卫魔兽-Guardian of Warcraft;;0 - 20,000;11;2;9;0;0;0
1533570;Word Wise;;0 - 20,000;7;2;5;0;0;0
1533590;Three Fairies' Hoppin' Flappin' Great Journey!;;0 - 20,000;111;16;95;0;0;1
1533600;The 2020 Trail;;0 - 20,000;54;6;48;0;0;0
1533650;Knight Throde;;0 - 20,000;7;1;6;0;0;0
1533680;Dead Grid;;0 - 20,000;222;17;205;0;0;5
1533720;Over The Phone;;0 - 20,000;58;9;49;0;0;0
1533750;小小精灵塔防(Little elf tower defense);;0 - 20,000;2;2;0;0;0;0
1533760;CrazyDoc;;0 - 20,000;1;8;-7;0;0;0
1533770;The Thief Girl ~ 盗賊少女 ~;;0 - 20,000;1;0;1;0;0;0
1533780;A Walk Through Echoes;;0 - 20,000;5;0;5;0;0;0
1533870;Atrius Star;;100,000 - 200,000;5;0;5;0;0;0
1533880;Hunter Girl;;0 - 20,000;0;2;-2;0;0;0
1533940;轮回修真OL;;0 - 20,000;18;22;-4;0;0;36
1533960;Liars Village;;0 - 20,000;2;1;1;0;0;0
1533980;Swiss Alps Jigsaw Puzzles;;0 - 20,000;4;0;4;0;0;1
1534000;Asteroid Arena;;0 - 20,000;1;0;1;0;0;0
1534050;SCP: Breakout;;0 - 20,000;13;10;3;0;0;0
1534180;Super Woden GP;;20,000 - 50,000;232;20;212;0;0;1
1534200;Nothing;;0 - 20,000;72;8;64;0;0;2
1534240;"""Drop Blox""";;0 - 20,000;1;3;-2;0;0;0
1534250;Appease the Spider;;0 - 20,000;5;1;4;0;0;0
1534260;TitTok;;0 - 20,000;97;12;85;0;0;0
1534270;Bard Harder!;;0 - 20,000;70;1;69;0;0;0
1534290;Space Mages: Dimension 33;;0 - 20,000;15;2;13;0;0;0
1534290;Space Mages: Dimension 33;;0 - 20,000;15;2;13;0;0;0
1534340;Fi da Puti Samurai;;0 - 20,000;105;5;100;0;0;5
1534430;Play The Fox;;20,000 - 50,000;1;1;0;0;0;0
1534480;CELLAR | Roguelike + Quest;;20,000 - 50,000;6;1;5;0;0;0
1534490;Motion Studio;;0 - 20,000;8;8;0;0;0;0
1534510;Thalassophobia;;0 - 20,000;7;13;-6;0;0;0
1534520;STRAY KITTEN;;0 - 20,000;78;10;68;0;0;0
1534550;Sovietpunk: Chapter one;;20,000 - 50,000;115;34;81;0;0;0
1534590;Farm Dungeons;;0 - 20,000;6;4;2;0;0;0
1534610;ZombiesWaves;;0 - 20,000;28;37;-9;0;0;0
1534630;The Sound of Fireworks: The Haiku;;0 - 20,000;9;0;9;0;0;0
1534700;Swords & Bones;;0 - 20,000;37;1;36;0;0;0
1534770;DrakulA;;0 - 20,000;11;6;5;0;0;0
1534810;CityPunk;;0 - 20,000;4;1;3;0;0;0
1534810;CityPunk;;0 - 20,000;4;1;3;0;0;0
1534850;Floor Plan 2;;0 - 20,000;54;7;47;195;195;3
1534860;Behold The Dark;;0 - 20,000;3;1;2;0;0;0
1534900;VR Guardians;;20,000 - 50,000;3;4;-1;0;0;0
1534930;Ascii the Brave Cat;;0 - 20,000;9;0;9;0;0;0
1534980;Terminus: Zombie Survivors;;20,000 - 50,000;346;16;330;0;0;8
1535030;Go Home;;0 - 20,000;2;0;2;0;0;0
1535040;The Great Unborn;;0 - 20,000;0;1;-1;0;0;0
1535060;Incremental Epic Breakers;;0 - 20,000;34;43;-9;0;0;20
1535090;VR Kyoto: Beauty of Japan;;0 - 20,000;16;8;8;0;0;0
1535100;Nadir: A Grimdark Deckbuilder;;0 - 20,000;129;49;80;0;0;11
1535190;Middle Age Conquest;;0 - 20,000;38;6;32;0;0;0
1535200;Rocket Skates VR;;0 - 20,000;47;8;39;0;0;0
1535240;Sonucido: The Mage - A Dungeon Crawler by Daniel da Silva;;0 - 20,000;3;0;3;0;0;0
1535270;Vacation Adventures: Park Ranger 4;;0 - 20,000;3;1;2;0;0;0
1535290;Venus: Improbable Dream;;0 - 20,000;14;0;14;0;0;0
1535420;Stream Toys by Zokya;;0 - 20,000;4;0;4;0;0;0
1535480;the office simulation;;20,000 - 50,000;25;10;15;0;0;0
1535490;Eggcelerate!;;0 - 20,000;85;3;82;0;0;0
1535500;Mini Car Racing - Tiny Split Screen Tournament;;0 - 20,000;31;8;23;0;0;0
1535550;The Bits That Saved the Galaxy;;0 - 20,000;2;1;1;0;0;0
1535590;flChess 2;;0 - 20,000;5;4;1;0;0;0
1535610;Soul Nomad & the World Eaters;;20,000 - 50,000;99;29;70;49;49;4
1535780;Imp of the Sun;;0 - 20,000;64;14;50;0;0;0
1535790;Sword of Hypotenuse;;20,000 - 50,000;0;1;-1;0;0;0
1535880;The Curse of Illmoore Bay;;0 - 20,000;4;0;4;0;0;0
1535900;Hunt N Cloak;;0 - 20,000;6;2;4;0;0;0
1535910;Kakuro Blend;;0 - 20,000;3;0;3;0;0;0
1535960;Pixel Game Maker Series Osyaberi! Horijyo! Holin Slash;;0 - 20,000;5;0;5;0;0;0
1536000;Breath of Spirits;;0 - 20,000;7;8;-1;0;0;0
1536070;Sword and Fairy 3;;50,000 - 100,000;1091;200;891;366;699;98
1536080;Sword and Fairy 3 Ex;;0 - 20,000;274;53;221;8;8;14
1536150;VR 뉴욕 스토리;;0 - 20,000;2;2;0;0;0;0
1536190;FIREFIGHTER;;0 - 20,000;4;0;4;0;0;0
1536210;IRA;;0 - 20,000;97;21;76;0;0;1
1536260;Odenavirus: Zombie Invasion;;0 - 20,000;0;1;-1;0;0;0
1536420;Clip maker;;0 - 20,000;83;27;56;0;0;1
1536470;a guard walks into a tavern;;20,000 - 50,000;132;12;120;0;0;0
1536590;Cyclotronica;;0 - 20,000;2;0;2;0;0;0
1536600;Digital Diamond Baseball V9;;0 - 20,000;17;2;15;0;0;1
1536610;OpenTTD;;1,000,000 - 2,000,000;8504;352;8152;0;0;800
1536690;FoxPaww: a furry breakout-lite adventure;;0 - 20,000;6;0;6;0;0;0
1536720;Deep Sea Valentine;;20,000 - 50,000;19;1;18;0;0;0
1536730;Chaos Chain;;0 - 20,000;23;3;20;0;0;0
1536740;TrackMaster: Free-For-All Motorsport;;0 - 20,000;8;0;8;0;0;0
1536750;Holy Chick!;;0 - 20,000;13;7;6;0;0;0
1536770;Learn Programming: Python - Retro;;0 - 20,000;40;17;23;430;430;0
1536830;41 Hours: Prologue;;20,000 - 50,000;31;27;4;0;0;0
1536870;High Smileson;;0 - 20,000;11;2;9;0;0;0
1536890;Godbeast Mk.II;;0 - 20,000;9;0;9;0;0;0
1537010;Player City;;0 - 20,000;2;0;2;0;0;0
1537090;Flying Flogger;;0 - 20,000;10;0;10;0;0;0
1537340;Nano Fighter Anti Disease;;0 - 20,000;4;1;3;0;0;0
1537390;Goddess Of Card War;;0 - 20,000;18;4;14;0;0;0
1537430;Mask Up;;0 - 20,000;10;0;10;0;0;0
1537470;Velocity Vector;;0 - 20,000;10;6;4;0;0;0
1537480;玉言·离光;;20,000 - 50,000;123;41;82;0;0;1
1537540;Dichotomy;;20,000 - 50,000;6;1;5;0;0;0
1537600;Spring Flower;;0 - 20,000;11;2;9;0;0;2
1537700;Plasma Spheres;;0 - 20,000;1;0;1;0;0;0
1537820;Super Clown Adventures;;20,000 - 50,000;48;14;34;0;0;0
1537850;Smart Moves 2;;0 - 20,000;4;0;4;0;0;0
1537910;Chaos Galaxy 2;;0 - 20,000;159;23;136;0;0;20
1537930;DaCapo Delivers;;0 - 20,000;3;0;3;0;0;0
1537940;Bow & Crystal Tower Defense;;0 - 20,000;2;4;-2;0;0;0
1537960;Click and Relax;;0 - 20,000;0;13;-13;0;0;0
1537970;Death Box;;20,000 - 50,000;11;1;10;0;0;0
1537980;Myriavora;;0 - 20,000;7;0;7;0;0;0
1538040;Horde Slayer;;0 - 20,000;1;0;1;0;0;0
1538090;Virtual Orator;;0 - 20,000;3;0;3;0;0;0
1538160;Outsourcing - IT company simulator;;0 - 20,000;0;2;-2;0;0;0
1538170;A Sleeper's Quest: A Labyrinth to Thee;;0 - 20,000;1;1;0;0;0;0
1538270;Kuro Tactics;;20,000 - 50,000;5;3;2;0;0;0
1538340;Field Survivor;;0 - 20,000;11;0;11;0;0;0
1538350;Unit Down;;0 - 20,000;14;0;14;0;0;0
1538370;奇迹之旅;;0 - 20,000;2;0;2;0;0;0
1538380;Animal Babysister Fighter : Zombie Coming!;;0 - 20,000;9;2;7;0;0;0
1538400;Orbatron;;0 - 20,000;7;0;7;0;0;0
1538460;Sword and Fairy 2;;50,000 - 100,000;797;101;696;539;549;41
1538470;ISDDS - Drone VR Simulator;;0 - 20,000;0;2;-2;0;0;0
1538480;Redeliver;;0 - 20,000;6;0;6;0;0;0
1538570;Patron;;100,000 - 200,000;1487;502;985;297;505;50
1538600;INCARNA: R•AI•D;;0 - 20,000;19;3;16;0;0;0
1538610;Legacy - Witch Island 3;;0 - 20,000;9;3;6;0;0;1
1538620;Zoo Cleaner;;0 - 20,000;31;23;8;0;0;0
1538640;Void -Dementia-;;0 - 20,000;22;12;10;0;0;0
1538650;The Chronicles of Hercules: The 12 Labours;;0 - 20,000;17;4;13;0;0;0
1538680;Blake: The Visual Novel;;0 - 20,000;38;1;37;0;0;0
1538770;Food Comes From Above;;0 - 20,000;2;0;2;0;0;0
1538810;Physics car FOREVER;;0 - 20,000;4;19;-15;0;0;0
1538850;Grotto;;0 - 20,000;145;8;137;0;0;1
1538910;Old Evil;;0 - 20,000;15;9;6;0;0;1
1538920;Starcaller;;0 - 20,000;12;4;8;0;0;0
1539040;MultiDimensional 4-in-a-row;;0 - 20,000;2;0;2;0;0;0
1539080;The Immortal;;0 - 20,000;2;1;1;0;0;0
1539090;Attack of the Mutant Penguins;;0 - 20,000;5;1;4;0;0;0
1539100;Noah's Ark;;0 - 20,000;2;1;1;0;0;1
1539150;Analytical World;;0 - 20,000;3;1;2;0;0;0
1539250;Karakuri-kun: A Japanese Tale;;0 - 20,000;5;1;4;0;0;0
1539360;Charlie The Roach;;0 - 20,000;4;0;4;0;0;0
1539580;Bird;;0 - 20,000;470;89;381;0;0;1
1539590;Omniblast;;0 - 20,000;2;1;1;0;0;0
1539620;MONARK;;0 - 20,000;125;30;95;120;120;3
1539640;VR Walking Simulator;;0 - 20,000;14;8;6;0;0;0
1539680;Project Kuragava;;0 - 20,000;1;1;0;0;0;0
1539750;Realms of Antiquity: The Shattered Crown;;0 - 20,000;40;1;39;0;0;1
1539770;Six F and Six 0;;0 - 20,000;25;1;24;0;0;0
1539780;Winning Love by Daylight;;20,000 - 50,000;116;14;102;0;0;0
1539800;Baldy Bounce;;0 - 20,000;2;0;2;0;0;0
1539810;FreeDraw;;0 - 20,000;15;3;12;0;0;0
1539870;Cats In Space;;0 - 20,000;4;0;4;0;0;0
1539890;Avoid!;;0 - 20,000;1;3;-2;0;0;0
1539950;Slav Dangerous;;0 - 20,000;2;0;2;0;0;0
1540060;Angry Putin;;0 - 20,000;136;14;122;0;0;0
1540100;Shy Eye Labyrinth: The Incredible Mystery;;0 - 20,000;2;2;0;0;0;0
1540130;Vaccine Delivery Simulator;;0 - 20,000;12;2;10;0;0;0
1540150;Crazy Flasher Series 2021;;100,000 - 200,000;2163;266;1897;79;91;29
1540190;RUSH!!!;;0 - 20,000;1;0;1;0;0;0
1540220;Sugar * Style;;0 - 20,000;188;6;182;0;0;7
1540330;MUMBA IV: Egypt Jewels ;;0 - 20,000;16;1;15;0;0;1
1540360;Carrier Battles WW2: Admiral of the Fleet;;0 - 20,000;6;5;1;0;0;0
1540400;Lost Dream;;0 - 20,000;52;20;32;0;0;0
1540410;Retro Classix: Joe & Mac - Caveman Ninja;;0 - 20,000;22;5;17;0;0;0
1540420;Retro Classix: Super BurgerTime;;0 - 20,000;8;3;5;0;0;1
1540430;Retro Classix: Gate of Doom;;20,000 - 50,000;15;1;14;11;11;0
1540440;Retro Classix: Wizard Fire;;20,000 - 50,000;6;5;1;16;16;0
1540450;Retro Classix: Two Crude;;20,000 - 50,000;9;3;6;0;0;0
1540470;Retro Classix: Heavy Barrel;;0 - 20,000;8;5;3;0;0;0
1540550;Hack Jump;;0 - 20,000;4;0;4;0;0;0
1540560;Operator;;20,000 - 50,000;729;489;240;48;48;0
1540570;Fractal Block World;;0 - 20,000;8;0;8;0;0;0
1540600;Ballistic M.A.D.ness;;20,000 - 50,000;5;0;5;0;0;0
1540740;Dungen;;0 - 20,000;4;2;2;0;0;0
1540780;灭顶之灾—救赎;;50,000 - 100,000;9;6;3;0;0;0
1540790;VoidOut Parkour;;0 - 20,000;1;0;1;0;0;0
1540830;Conspiracy Girls;;20,000 - 50,000;9;2;7;0;0;0
1540840;Sausage Fiesta;;0 - 20,000;8;3;5;0;0;0
1540910;City Maker;;0 - 20,000;17;4;13;0;0;0
1540920;Neonverse Defenders;;0 - 20,000;5;1;4;0;0;0
1540960;Underworld Idle;;100,000 - 200,000;472;201;271;0;0;590
1541020;Kakele Online - MMORPG;;20,000 - 50,000;133;25;108;0;0;56
1541040;Formula Bit Racing;;0 - 20,000;1;2;-1;0;0;0
1541110;Demon Zombie Outpost;;20,000 - 50,000;1;1;0;0;0;0
1541130;Researcher;;0 - 20,000;6;6;0;0;0;0
1541130;Researcher;;0 - 20,000;6;6;0;0;0;0
1541240;BOOOOOOOOOOOOOOOUNCE;;0 - 20,000;17;7;10;0;0;0
1541250;Super Raft Boat;;100,000 - 200,000;767;53;714;0;0;4
1541390;Chinese mother in law;;0 - 20,000;2;9;-7;0;0;0
1541400;Cutthroat Cove;;0 - 20,000;0;4;-4;0;0;0
1541410;One Pixel;;0 - 20,000;28;1;27;0;0;0
1541440;Darkness Shooter;;0 - 20,000;3;6;-3;0;0;0
1541450;Must Reach;;0 - 20,000;2;7;-5;0;0;0
1541530;Animal Drop Safari;;0 - 20,000;10;2;8;0;0;0
1541590;Intergalactic Rescue;;20,000 - 50,000;4;0;4;0;0;0
1541670;Giant Blobs From Mars;;20,000 - 50,000;2;1;1;0;0;0
1541690;Concealment;;50,000 - 100,000;16;6;10;0;0;0
1541710;Wyvern;;20,000 - 50,000;66;29;37;0;0;1
1541730;Candy Fall;;0 - 20,000;2;0;2;0;0;0
1541750;Toggle;;0 - 20,000;3;0;3;0;0;0
1541790;Punk Wars;;20,000 - 50,000;65;33;32;0;0;0
1541850;Endless Furry Clicker;;0 - 20,000;22;5;17;0;0;0
1541860;NULLORE: beginning;;0 - 20,000;5;2;3;0;0;0
1542000;Thearchy;;20,000 - 50,000;1;1;0;0;0;0
1542010;Mariuccha Alchemy Queen;;0 - 20,000;2;0;2;0;0;0
1542060;Forgotten Spirits;;0 - 20,000;14;1;13;0;0;1
1542080;Super Crazy Nynja;;0 - 20,000;1;0;1;0;0;0
1542100;Wheelie King Online;;0 - 20,000;96;15;81;0;0;5
1542120;Tanky Tanks;;0 - 20,000;15;3;12;0;0;0
1542130;Detective Puz;;20,000 - 50,000;5;2;3;0;0;0
1542160;Vacation Adventures: Park Ranger 5;;0 - 20,000;3;0;3;0;0;0
1542170;vissekom;;0 - 20,000;0;0;0;0;0;0
1542280;明星志願2;;20,000 - 50,000;219;46;173;0;0;17
1542330;Assimilation X;;50,000 - 100,000;1;0;1;0;0;0
1542370;Football Academy Clicker;;0 - 20,000;5;1;4;0;0;0
1542440;Kosmonavtes: Escape Reality;;20,000 - 50,000;5;5;0;0;0;0
1542450;Kosmonavtes: Academy Escape;;20,000 - 50,000;4;1;3;0;0;0
1542460;ZenFarm;;0 - 20,000;6;4;2;0;0;0
1542550;Scrap Riders;;0 - 20,000;10;1;9;0;0;0
1542560;SyncGo Desktop Calendar;;0 - 20,000;0;1;-1;0;0;2
1542610;MOF;;0 - 20,000;2;3;-1;0;0;0
1542670;Gachi Dungeon Master;;0 - 20,000;42;7;35;0;0;0
1542710;Dreams of an Exile;;0 - 20,000;14;2;12;0;0;2
1542760;Cyber Cult City;;0 - 20,000;7;0;7;0;0;0
1542790;SRX: The Game;;0 - 20,000;131;14;117;0;0;4
1542810;Sunshine Heavy Industries;;0 - 20,000;274;2;272;0;0;1
1542810;Sunshine Heavy Industries;;0 - 20,000;274;2;272;0;0;1
1542820;Roguely;;0 - 20,000;6;0;6;0;0;0
1542840;PuzzlePet - Feed your cat;;0 - 20,000;42;1;41;0;0;1
1542850;Destroy The Cubes;;0 - 20,000;28;1;27;0;0;0
1542860;Dungeon Slime 2: Puzzle in the Dark Forest;;0 - 20,000;37;0;37;0;0;0
1542870;Gaggle Brains!;;0 - 20,000;1;0;1;0;0;0
1542930;Red Man;;0 - 20,000;4;0;4;0;0;0
1542970;VR Spaceship Battle;;0 - 20,000;0;3;-3;0;0;0
1542980;Siege of the Swine;;0 - 20,000;1;0;1;0;0;0
1543020;Rise 2.0;;0 - 20,000;2;0;2;0;0;0
1543030;Sword and Fairy 7;;500,000 - 1,000,000;10363;4055;6308;1448;1644;501
1543040;轮回修仙决;;0 - 20,000;1;3;-2;0;0;1
1543080;Cute Honey 3;;50,000 - 100,000;418;221;197;21;25;3
1543090;LiBER;;0 - 20,000;65;11;54;0;0;0
1543100;Farmers Co-op: Out of This World;;0 - 20,000;10;5;5;0;0;0
1543120;Flying Angel;;0 - 20,000;12;2;10;0;0;0
1543150;The Fermi Paradox;;50,000 - 100,000;583;165;418;235;235;11
1543210;Quest: Escape Room 3;;0 - 20,000;25;7;18;0;0;0
1543240;Gigapocalypse;;0 - 20,000;121;7;114;0;0;3
1543270;Clash of Irons;;20,000 - 50,000;38;23;15;0;0;4
1543290;Hack Grid;;0 - 20,000;28;0;28;0;0;0
1543320;The Road to Gelendzhik Palace;;20,000 - 50,000;5;13;-8;0;0;0
1543330;揭谛/GATE;;0 - 20,000;25;1;24;0;0;0
1543340;Sheriff Exam;;0 - 20,000;9;5;4;0;0;0
1543360;StarFlint the BlackHole Prophecy;;0 - 20,000;29;30;-1;0;0;6
1543380;I Fetch Rocks;;0 - 20,000;64;1;63;0;0;1
1543400;Yellow Brick Road;;0 - 20,000;0;14;-14;0;0;0
1543430;Terrain of Magical Expertise;;20,000 - 50,000;105;25;80;0;0;3
1543460;The Sin;;50,000 - 100,000;117;14;103;0;0;1
1543470;aMAZE Gears 3;;0 - 20,000;11;3;8;0;0;0
1543520;Devil Inside Us: Roots of Evil;;0 - 20,000;56;0;56;0;0;0
1543530;Path of Insanity;;0 - 20,000;1;1;0;0;0;0
1543550;Eviron's Chronicles;;0 - 20,000;14;5;9;0;0;1
1543590;Wildshape - Map Editor + VTT;;0 - 20,000;62;21;41;18;34;1
1543620;Paintings Jigsaw Puzzles;;20,000 - 50,000;2;0;2;0;0;0
1543630;Mind Lock;;0 - 20,000;2;0;2;0;0;0
1543650;Car Looper;;0 - 20,000;2;0;2;0;0;0
1543750;Jewel Match Atlantis Solitaire 2 - Collector's Edition;;0 - 20,000;21;2;19;0;0;2
1543760;Steep Slopes;;20,000 - 50,000;34;4;30;0;0;0
1543760;Steep Slopes;;20,000 - 50,000;34;4;30;0;0;0
1543820;PaperCraft;;0 - 20,000;12;1;11;0;0;0
1543830;The Addams Family: Mansion Mayhem;;0 - 20,000;10;6;4;0;0;4
1543930;Retro Wars;;0 - 20,000;0;1;-1;0;0;0
1543940;Tapeworm Disco Puzzle;;0 - 20,000;3;0;3;0;0;0
1543970;Heart of Enya;;20,000 - 50,000;34;7;27;0;0;0
1543990;Project Blue Book: Hidden Mysteries;;0 - 20,000;3;2;1;0;0;1
1544000;For a Vast Future;;20,000 - 50,000;26;1;25;0;0;0
1544020;The Callisto Protocol;;200,000 - 500,000;15634;9876;5758;577;671;334
1544040;Medieval Shop Simulator;;0 - 20,000;1;4;-3;0;0;0
1544080;Counter Fight ICHIRAN;;0 - 20,000;13;5;8;0;0;0
1544110;Darkened Glory;;0 - 20,000;3;0;3;0;0;0
1544140;The Great Empire: Relic of Egypt;;0 - 20,000;7;1;6;0;0;0
1544240;VR Pianist;;0 - 20,000;3;1;2;0;0;0
1544250;Trickery&Strategy;;0 - 20,000;9;1;8;0;0;1
1544300;Super Can Cannon;;0 - 20,000;1;0;1;0;0;0
1544360;LEGO Builder's Journey;;100,000 - 200,000;2363;498;1865;99;118;7
1544380;VR Galactic Roller Coaster;;0 - 20,000;1;0;1;0;0;0
1544430;Golf With Your Grandmother;;0 - 20,000;8;3;5;0;0;1
1544450;Pixel Game Maker Series DRAGON PEAK;;0 - 20,000;1;4;-3;0;0;0
1544460;The Third Day;;0 - 20,000;43;11;32;0;0;0
1544470;Princess Tier:Part 1;;20,000 - 50,000;6;1;5;0;0;0
1544480;Book of the Old;;0 - 20,000;9;0;9;0;0;0
1544540;ALONE;;50,000 - 100,000;105;13;92;0;0;1
1544570;Plot of the Druid: Nightwatch;;50,000 - 100,000;103;10;93;0;0;2
1544580;Would you like to run an idol café?;;0 - 20,000;23;5;18;0;0;0
1544600;JS Page;;0 - 20,000;4;0;4;0;0;0
1544720;4th & Inches;;0 - 20,000;2;0;2;0;0;0
1544730;Fast Break;;0 - 20,000;1;0;1;0;0;0
1544740;MicroProse Soccer;;0 - 20,000;7;2;5;0;0;0
1544810;HANDMADE CARPROGRAM;;0 - 20,000;0;1;-1;0;0;0
1544820;A Nasty Farm;;0 - 20,000;2;0;2;0;0;0
1544890;Ship Simulator Realistic;;0 - 20,000;29;7;22;0;0;1
1544970;HighQ Quiz;;0 - 20,000;1;0;1;0;0;0
1545000;Island Herders;;0 - 20,000;1;0;1;0;0;0
1545010;ExZeus: The Complete Collection;;0 - 20,000;2;1;1;0;0;0
1545040;Jump/Die/Live;;0 - 20,000;2;1;1;0;0;0
1545250;ECHOLOCAUTION;;0 - 20,000;58;0;58;0;0;0
1545250;ECHOLOCAUTION;;0 - 20,000;58;0;58;0;0;0
1545260;Stickman Escape;;0 - 20,000;3;2;1;0;0;0
1545270;Power Of Slide;;0 - 20,000;2;0;2;0;0;0
1545280;Garetto;;0 - 20,000;7;1;6;0;0;0
1545280;Garetto;;0 - 20,000;7;1;6;0;0;0
1545290;Sword and Fairy 5 prequel;;0 - 20,000;80;15;65;0;0;12
1545340;Asian Mahjong;;0 - 20,000;7;4;3;0;0;0
1545350;Caribbean Jigsaw;;0 - 20,000;9;1;8;0;0;0
1545360;Christmas Griddlers;;0 - 20,000;1;0;1;0;0;0
1545370;Christmas Griddlers Journey to Santa;;0 - 20,000;2;2;0;0;0;0
1545380;Boxoku!;;0 - 20,000;1;0;1;0;0;0
1545450;Incredibox;;50,000 - 100,000;1969;52;1917;170;195;43
1545570;Wolf Adventures;;0 - 20,000;18;1;17;0;0;0
1545590;World Splitter;;0 - 20,000;15;2;13;0;0;0
1545600;Grapple Hoops;;0 - 20,000;36;8;28;0;0;0
1545620;Arcane Arts Academy;;0 - 20,000;30;2;28;0;0;1
1545700;Guns N' Runs;;0 - 20,000;29;3;26;0;0;0
1545780;Post Cards;;0 - 20,000;6;1;5;0;0;0
1545810;COUNT THE DEAD;;0 - 20,000;1;0;1;0;0;0
1545830;Yaengard;;0 - 20,000;89;24;65;0;0;1
1545850;Tetragon;;0 - 20,000;32;7;25;0;0;0
1545970;Wall Street Bets;;0 - 20,000;7;1;6;0;0;0
1545990;Deadeye Deepfake Simulacrum;;20,000 - 50,000;241;1;240;0;0;3
1546010;Fallen girl - Black rose and the fire of desire;;50,000 - 100,000;835;328;507;273;388;5
1546100;A Musical Story;;0 - 20,000;122;16;106;0;0;0
1546120;Void Explorer;;0 - 20,000;3;0;3;0;0;0
1546140;Soccer VR Football;;0 - 20,000;2;1;1;0;0;0
1546190;Life is sad;;0 - 20,000;2;7;-5;0;0;0
1546210;Destroy It;;0 - 20,000;7;15;-8;0;0;0
1546280;Mad Pack;;0 - 20,000;189;76;113;0;0;0
1546320;Your Chronicle;;100,000 - 200,000;890;225;665;2906;4049;1459
1546340;Detective Riddles - Sherlock's Heritage;;0 - 20,000;5;2;3;0;0;0
1546350;Detective Riddles - Sherlock's Heritage 2;;0 - 20,000;4;1;3;0;0;0
1546360;Easter Riddles;;0 - 20,000;3;1;2;0;0;0
1546370;Fill and Cross Magic Journey;;0 - 20,000;5;2;3;0;0;0
1546380;Fill and Cross Pirate Riddles;;0 - 20,000;4;6;-2;0;0;1
1546400;GigaBash;;20,000 - 50,000;645;53;592;0;0;17
1546420;BangBangShooting;;0 - 20,000;1;3;-2;0;0;0
1546440;Lycanthorn II - Rain of Beasts;;20,000 - 50,000;179;14;165;0;0;0
1546500;Warplanes: WW1 Fighters;;0 - 20,000;339;32;307;85;85;0
1546540;The Tenants - Free Trial;;200,000 - 500,000;1964;139;1825;43;40;1
1546570;Sword and Fairy;;100,000 - 200,000;2710;70;2640;712;934;79
1546630;Tank War Nexus;;20,000 - 50,000;1;0;1;0;0;0
1546770;The Vagabond Emperor;;0 - 20,000;25;7;18;0;0;0
1546790;Peace, Death! 2;;20,000 - 50,000;625;20;605;793;965;3
1546830;Tiani;;0 - 20,000;2;1;1;0;0;0
1546860;Saiko no sutoka;;100,000 - 200,000;2246;117;2129;0;0;20
1546900;Escape From My Turrets;;0 - 20,000;4;2;2;0;0;0
1546910;Sophistry - Love & Despair;;0 - 20,000;5;0;5;0;0;0
1546920;Overboard!;;50,000 - 100,000;330;28;302;170;244;7
1546930;Angry Angry Shark;;0 - 20,000;211;39;172;0;0;1
1546940;Beard Blade;;0 - 20,000;81;14;67;0;0;1
1546960;Escape The Ordinary: Tales of Romina Manor;;0 - 20,000;4;2;2;0;0;0
1546970;Grand Theft Auto III – The Definitive Edition;;0 - 20,000;418;245;173;0;0;122
1546970;Grand Theft Auto III – The Definitive Edition;;0 - 20,000;418;245;173;0;0;122
1546990;Grand Theft Auto: Vice City – The Definitive Edition;;20,000 - 50,000;508;214;294;0;0;152
1547000;Grand Theft Auto: San Andreas – The Definitive Edition;;20,000 - 50,000;760;378;382;0;0;365
1547000;Grand Theft Auto: San Andreas – The Definitive Edition;;20,000 - 50,000;760;378;382;0;0;365
1547030;Outcasts of Orion;;20,000 - 50,000;22;3;19;0;0;0
1547050;Fantasy Adventure;;0 - 20,000;3;7;-4;0;0;0
1547060;回纹集换卡牌TCG;;0 - 20,000;2;1;1;0;0;0
1547070;Wow Dance;;0 - 20,000;15;8;7;0;0;1
1547090;Fantasma;;0 - 20,000;15;12;3;0;0;7
1547110;Commandos Pro Simulator;;100,000 - 200,000;5;10;-5;0;0;0
1547150;Combat Cycle;;0 - 20,000;19;13;6;0;0;0
1547160;Infinite Jump;;20,000 - 50,000;370;71;299;14;14;3
1547170;斗魂大陆;;0 - 20,000;3;5;-2;0;0;0
1547220;No Going Back;;0 - 20,000;1;0;1;0;0;0
1547250;Snow Wars;;0 - 20,000;6;3;3;0;0;0
1547260;Elder Puzzle;;0 - 20,000;3;3;0;0;0;0
1547270;Ninety Days;;0 - 20,000;3;9;-6;0;0;0
1547290;Nina Aquila: Legal Eagle, Season One;;0 - 20,000;68;1;67;0;0;1
1547300;Drawy;;0 - 20,000;35;3;32;0;0;5
1547310;Number Game:24 Points;;0 - 20,000;0;1;-1;0;0;0
1547320;Escape: Underground;;0 - 20,000;6;1;5;0;0;0
1547340;Puzzle Car;;0 - 20,000;58;1;57;0;0;1
1547350;Toru;;0 - 20,000;36;2;34;0;0;0
1547370;Dark Pathways;;0 - 20,000;1;0;1;0;0;0
1547380;KINGDOM of the DEAD;;0 - 20,000;173;39;134;0;0;1
1547380;KINGDOM of the DEAD;;0 - 20,000;173;39;134;0;0;1
1547410;DnD Adventure: Wizard's Choice;;0 - 20,000;33;2;31;0;0;1
1547420;Siphonophore;;50,000 - 100,000;3;3;0;0;0;0
1547430;Endro;;0 - 20,000;3;2;1;0;0;0
1547470;PewPew!;;50,000 - 100,000;6;3;3;0;0;0
1547480;Present Danger;;0 - 20,000;4;0;4;0;0;0
1547490;Black Cat;;0 - 20,000;7;6;1;0;0;0
1547500;Snowboard;;0 - 20,000;8;20;-12;0;0;0
1547580;Welcome To... Chichester 2 - Part II : No Extra Regrets For The Future;;0 - 20,000;7;1;6;0;0;0
1547620;JezzBall Atomic;;0 - 20,000;8;0;8;0;0;1
1547780;焚魂之梦;;0 - 20,000;8;1;7;0;0;0
1547790;Roze Blud;;20,000 - 50,000;6;0;6;0;0;0
1547820;TOP TRUCK DRIVER;;0 - 20,000;11;9;2;0;0;0
1547830;After Off War;;0 - 20,000;1;6;-5;0;0;0
1547860;EBOLA 3;;0 - 20,000;186;45;141;0;0;5
1547890;Let's Build a Zoo;;100,000 - 200,000;2055;225;1830;303;391;63
1547900;Active Mummy;;20,000 - 50,000;13;4;9;0;0;0
1547910;Plasma Attack;;0 - 20,000;3;1;2;0;0;0
1547920;Piano Practice;;0 - 20,000;0;2;-2;0;0;0
1547930;Romeo Must Live;;0 - 20,000;2;1;1;0;0;0
1547970;lightblue;;0 - 20,000;15;9;6;0;0;0
1547970;lightblue;;0 - 20,000;15;9;6;0;0;0
1547990;Vivian's Kurse;;20,000 - 50,000;2;2;0;0;0;0
1548010;Flipol;;0 - 20,000;6;0;6;0;0;0
1548030;Tatarian aster;;0 - 20,000;2;0;2;0;0;0
1548050;Presence;;0 - 20,000;62;18;44;0;0;0
1548090;Nether Nightmare;;0 - 20,000;28;31;-3;0;0;0
1548110;The Depths;;20,000 - 50,000;4;1;3;0;0;0
1548110;The Depths;;20,000 - 50,000;4;1;3;0;0;0
1548190;yarne;;0 - 20,000;27;0;27;0;0;0
1548270;Darkilson;;0 - 20,000;11;1;10;0;0;0
1548280;Great Battles of Carolus XII;;0 - 20,000;4;1;3;0;0;0
1548320;GET OUT!;;100,000 - 200,000;365;22;343;0;0;0
1548400;Roll a Ball With Your Friends;;0 - 20,000;60;3;57;0;0;0
1548430;Sacrifice of The Spirit;;0 - 20,000;5;6;-1;0;0;2
1548510;Love With Dating;;0 - 20,000;272;87;185;12;12;1
1548540;Z.O.M.B.I.E.;;0 - 20,000;26;8;18;0;0;0
1548590;Cold Breath;;0 - 20,000;4;6;-2;0;0;0
1548620;Infected spaceship generator;;0 - 20,000;11;2;9;0;0;0
1548630;Grappling Ball;;0 - 20,000;1;1;0;0;0;0
1548660;Bunker Down;;0 - 20,000;5;0;5;0;0;0
1548660;Bunker Down;;0 - 20,000;5;0;5;0;0;0
1548680;Untitled Crossing Record;;50,000 - 100,000;58;29;29;0;0;1
1548750;Conway: Disappearance at Dahlia View;;0 - 20,000;189;31;158;0;0;2
1548800;Wizard Of Walls;;0 - 20,000;23;1;22;0;0;0
1548820;Happy Puzzle;;0 - 20,000;268;35;233;24;42;0
1548830;TAL: Arctic 4;;0 - 20,000;19;2;17;0;0;0
1548860;Farlight Commanders: Prologue;;0 - 20,000;8;5;3;0;0;0
1548890;Colossus Mission - adventure in space, arcade game;;50,000 - 100,000;6;1;5;0;0;0
1548910;Life in Willowdale: Farm Adventures;;0 - 20,000;5;6;-1;0;0;2
1548930;Viking Story;;0 - 20,000;22;5;17;0;0;0
1548940;RUN: The world in-between;;0 - 20,000;112;2;110;0;0;0
1548970;Wayports;;0 - 20,000;1;1;0;0;0;0
1549000;Retro Classix: Express Raider;;0 - 20,000;5;0;5;0;0;0
1549030;100 hidden snails 2;;50,000 - 100,000;281;14;267;0;0;1
1549070;SugarWinds: Prologue;;50,000 - 100,000;10;9;1;0;0;0
1549130;Quick Packer 2;;0 - 20,000;4;0;4;0;0;0
1549140;Apolune 2;;20,000 - 50,000;4;0;4;0;0;0
1549160;Childhood Friends;;0 - 20,000;13;5;8;0;0;0
1549180;Propnight;;200,000 - 500,000;9760;4702;5058;319;294;576
1549200;Anachronism\>;;20,000 - 50,000;21;10;11;0;0;0
1549220;Storyblocks: The King;;0 - 20,000;15;3;12;0;0;0
1549270;Marooned;;0 - 20,000;5;2;3;0;0;0
1549420;メンヘラフレシア　フラワリングアビス;;0 - 20,000;25;1;24;0;0;0
1549440;MeiQi 2019;;0 - 20,000;30;1;29;0;0;2
1549550;Haven Park;;0 - 20,000;543;23;520;178;178;3
1549570;Halloween Sweetplechase;;0 - 20,000;3;0;3;0;0;0
1549620;Push The Box 3D;;0 - 20,000;12;2;10;0;0;0
1549640;Hook Only;;0 - 20,000;6;0;6;0;0;0
1549650;The Last Place;;0 - 20,000;4;6;-2;0;0;0
1549680;The Lost Valley;;0 - 20,000;6;11;-5;0;0;0
1549710;Cybernetica: Final;;0 - 20,000;0;5;-5;0;0;0
1549750;Vomitoreum;;20,000 - 50,000;652;60;592;143;143;0
1549850;Virtual Hunter;;0 - 20,000;56;19;37;0;0;1
1549870;Human Defense [RTS];;0 - 20,000;0;2;-2;0;0;0
1549950;Domino killer;;0 - 20,000;0;3;-3;0;0;0
1549970;Aliens: Fireteam Elite;;1,000,000 - 2,000,000;13994;3335;10659;1831;1291;356
1549980;Dairy Dave;;20,000 - 50,000;14;1;13;0;0;0
1550020;Fastest Hands In The WASD;;0 - 20,000;29;3;26;0;0;0
1550030;Problem Here;;20,000 - 50,000;4;2;2;0;0;0
1550050;Raptors of SouthEdge;;50,000 - 100,000;3;0;3;0;0;0
1550080;LootLite;;0 - 20,000;24;4;20;0;0;0
1550100;Nova Odessa - The Strange Tower;;0 - 20,000;7;1;6;0;0;0
1550230;Arden's Wake;;0 - 20,000;30;5;25;0;0;1
1550260;BloodRayne Betrayal: Fresh Bites;;0 - 20,000;47;17;30;0;0;0
1550270;Togges;;0 - 20,000;27;2;25;0;0;5
1550280;Jamie's Toy Box;;50,000 - 100,000;15;5;10;0;0;0
1550340;The hardest game in the universe;;0 - 20,000;3;4;-1;0;0;0
1550380;Faircroft's Antiques: The Heir of Glen Kinnoch;;0 - 20,000;6;0;6;0;0;0
1550430;Shooty;;0 - 20,000;4;0;4;0;0;0
1550450;Cyjin: The Cyborg Ninja;;0 - 20,000;36;2;34;0;0;0
1550460;My Dear Frankenstein;;0 - 20,000;9;1;8;0;0;0
1550470;Polgar: Magic detective;;0 - 20,000;0;1;-1;0;0;0
1550510;Creepy Tale 2;;50,000 - 100,000;719;106;613;0;0;7
1550630;Radon Blast;;20,000 - 50,000;7;0;7;0;0;0
1550650;Lords of Solgrund;;0 - 20,000;31;5;26;0;0;0
1550650;Lords of Solgrund;;0 - 20,000;31;5;26;0;0;0
1550660;Oakrot - it's literally a book;;0 - 20,000;16;0;16;0;0;0
1550680;Feudalia;;0 - 20,000;8;1;7;0;0;1
1550710;Warbox;;50,000 - 100,000;1679;713;966;799;850;17
1550730;Ikonei Island: An Earthlock Adventure;;0 - 20,000;106;9;97;0;0;6
1550740;Ignited Steel: Mech Tactics;;20,000 - 50,000;54;19;35;0;0;0
1550760;Blast Brigade vs. the Evil Legion of Dr. Cread;;0 - 20,000;164;13;151;0;0;1
1550800;Omega-Altro;;20,000 - 50,000;1;0;1;0;0;0
1550810;Puzzle Challengers;;0 - 20,000;2;4;-2;0;0;0
1550830;Dangerous sea area;;0 - 20,000;1;3;-2;0;0;0
1550840;RATUZ;;0 - 20,000;192;24;168;181;181;1
1550840;RATUZ;;0 - 20,000;192;24;168;181;181;1
1550870;The Indigo Parallel;;0 - 20,000;21;0;21;0;0;2
1550950;Pirates of the Asteroid Belt;;0 - 20,000;1;4;-3;0;0;0
1550990;Jurassic Attack;;0 - 20,000;35;10;25;0;0;0
1551010;Starlight Shores;;0 - 20,000;20;2;18;0;0;0
1551030;涨粉二维码;;20,000 - 50,000;174;41;133;0;0;0
1551050;Unsung Knight;;0 - 20,000;15;6;9;0;0;0
1551080;Age of Legion;;0 - 20,000;19;3;16;0;0;0
1551110;Mythic Prelude - Concept Demo;;0 - 20,000;2;1;1;0;0;0
1551110;Mythic Prelude - Concept Demo;;0 - 20,000;2;1;1;0;0;0
1551120;Victor;;0 - 20,000;1;0;1;0;0;0
1551160;Combat Mission Cold War;;0 - 20,000;92;46;46;0;0;10
1551180;TF Visualizer;;0 - 20,000;16;2;14;0;0;0
1551220;King and Kingdoms;;200,000 - 500,000;23;38;-15;0;0;3
1551230;Demon Slayer Akagi;;0 - 20,000;34;2;32;0;0;0
1551280;WAR FACTORY;;0 - 20,000;1;4;-3;0;0;0
1551290;RoHoEn Rumble;;0 - 20,000;4;1;3;0;0;0
1551330;Skyfall;;0 - 20,000;4;1;3;0;0;1
1551340;Unlikely Heroes;;0 - 20,000;2;0;2;0;0;0
1551360;Forza Horizon 5;;2,000,000 - 5,000,000;93586;12776;80810;3403;1792;8200
1551480;The Girl Who Sees;;100,000 - 200,000;3;0;3;0;0;0
1551510;Psychic Guardian Super Splendor;;0 - 20,000;100;34;66;0;0;2
1551520;Kamikaze Kommittee Ouka 2;;0 - 20,000;88;26;62;0;0;1
1551540;Tower of Ardia;;0 - 20,000;75;16;59;0;0;1
1551560;Into the Nightmare;;0 - 20,000;105;11;94;0;0;15
1551570;Kung Fu Grand King;;0 - 20,000;104;29;75;3;3;0
1551620;Letina's Odyssey;;0 - 20,000;33;9;24;0;0;18
1551660;Gravity Mastery;;0 - 20,000;3;1;2;0;0;0
1551760;Struggling Ball;;0 - 20,000;3;1;2;0;0;0
1551770;Too Many Zombies!;;0 - 20,000;4;0;4;0;0;0
1551820;Twin Mind: Murderous Jealousy Collector's Edition;;20,000 - 50,000;2;2;0;0;0;0
1551830;Passengers Of Execution;;20,000 - 50,000;6;0;6;0;0;0
1551850;Star Steel;;0 - 20,000;10;4;6;0;0;1
1551920;Whisper Trip;;100,000 - 200,000;46;24;22;0;0;0
1551990;Home Creator;;0 - 20,000;2;11;-9;0;0;0
1552040;Dominant Mind;;0 - 20,000;2;0;2;0;0;0
1552080;Deepest Chamber: Resurrection;;0 - 20,000;135;41;94;0;0;2
1552090;Cursed House 9 - Match 3 Puzzle;;0 - 20,000;5;1;4;0;0;2
1552210;Scary Buddies;;0 - 20,000;12;4;8;0;0;1
1552220;LakeSide;;0 - 20,000;75;21;54;103;103;7
1552240;Lux, City of Secrets;;0 - 20,000;16;6;10;0;0;0
1552250;Three of Cards;;50,000 - 100,000;290;16;274;0;0;0
1552310;JANITOR BLEEDS;;20,000 - 50,000;152;12;140;0;0;0
1552350;The Jackbox Party Pack 8;;100,000 - 200,000;973;108;865;473;240;161
1552400;Pirate Island;;0 - 20,000;17;3;14;0;0;0
1552430;Keeper of the Day and Night;;0 - 20,000;29;1;28;0;0;2
1552490;BouncyBoi in Puzzle Land;;0 - 20,000;5;1;4;0;0;0
1552530;Silverwing;;20,000 - 50,000;8;3;5;0;0;0
1552530;Silverwing;;20,000 - 50,000;8;3;5;0;0;0
1552550;Castlevania Advance Collection;;20,000 - 50,000;1112;92;1020;1093;1073;21
1552570;INFINITE VERSUS: 3D MUGEN - Open Beta;;20,000 - 50,000;24;24;0;0;0;0
1552620;Expedition Agartha;;500,000 - 1,000,000;362;122;240;0;0;11
1552630;MOONWAVE OVERDRIVE;;0 - 20,000;2;4;-2;0;0;0
1552680;Escape FishStop 3D;;0 - 20,000;57;0;57;0;0;0
1552730;Fireworks Simulator: Realistic;;0 - 20,000;108;27;81;0;0;3
1552740;First Days of Atlantis;;0 - 20,000;14;0;14;0;0;0
1552760;Ghostist;;20,000 - 50,000;28;2;26;0;0;0
1552790;Destroy the Dummies;;0 - 20,000;2;1;1;0;0;0
1552810;Twin Mirror;;20,000 - 50,000;255;76;179;448;448;5
1552830;Veg Out Crew;;0 - 20,000;2;0;2;0;0;0
1552940;Minigolf;;0 - 20,000;6;0;6;0;0;0
1552960;John Christian;;0 - 20,000;30;8;22;0;0;1
1553080;Nikola Tesla: War of the Currents;;0 - 20,000;13;1;12;0;0;6
1553120;The Inheritance of Crimson Manor;;0 - 20,000;274;34;240;1224;2281;3
1553170;Quest for Cathrinite;;0 - 20,000;3;2;1;0;0;0
1553200;All-Inn;;20,000 - 50,000;8;0;8;0;0;0
1553230;Trailer Shop Simulator;;0 - 20,000;102;41;61;0;0;0
1553290;Multiplicity KVM;;0 - 20,000;2;1;1;0;0;0
1553320;Inside Depth 6;;50,000 - 100,000;165;26;139;0;0;2
1553360;王国英雄志 Kingdom and Hero;;0 - 20,000;6;1;5;0;0;0
1553400;Smash Crates;;0 - 20,000;8;0;8;0;0;1
1553420;Rifle Strike;;100,000 - 200,000;28;13;15;0;0;0
1553480;The Architect's Game;;0 - 20,000;1;0;1;0;0;0
1553570;MineSweeper 3D 三维扫雷;;100,000 - 200,000;6;3;3;0;0;0
1553680;Park Walk;;0 - 20,000;6;8;-2;0;0;0
1553690;How does it work!?;;0 - 20,000;13;11;2;0;0;0
1553740;Cat’s Princess - visual novel / Otome;;0 - 20,000;14;1;13;0;0;0
1553800;Notebook Ninja Fights;;0 - 20,000;1;0;1;0;0;0
1553840;Super Bombinhas;;0 - 20,000;14;1;13;0;0;0
1553850;Tartaron;;0 - 20,000;2;0;2;0;0;0
1553880;Greats of the Gridiron;;0 - 20,000;2;1;1;0;0;0
1553910;My Friend Stalin;;0 - 20,000;303;41;262;0;0;1
1553940;Space Cube Tower Defense;;0 - 20,000;0;5;-5;0;0;0
1553970;GOLD IS MINE;;0 - 20,000;8;15;-7;0;0;0
1553980;GEAR TuNNEL;;0 - 20,000;0;1;-1;0;0;0
1553990;TheLastHope;;0 - 20,000;1;0;1;0;0;0
1554020;HUNDUN;;0 - 20,000;0;1;-1;0;0;0
1554030;我要成为铸剑师;;0 - 20,000;10;9;1;0;0;0
1554050;Ad Wars;;0 - 20,000;14;0;14;0;0;1
1554070;Fore Score;;20,000 - 50,000;20;1;19;0;0;0
1554080;The Stonks Market;;0 - 20,000;26;4;22;0;0;0
1554110;Disaster crisis/灾难危机;;0 - 20,000;4;0;4;0;0;0
1554130;Draft Day Sports: College Basketball 2021;;0 - 20,000;36;7;29;0;0;13
1554160;LIRE;;20,000 - 50,000;19;1;18;0;0;0
1554220;Paleon;;0 - 20,000;150;20;130;0;0;2
1554280;Asteroids Maneuvers;;0 - 20,000;2;2;0;0;0;0
1554320;Freedom Physics;;0 - 20,000;4;1;3;0;0;0
1554340;Toys & Physics;;0 - 20,000;10;5;5;0;0;0
1554380;Cyberpunk Madness;;0 - 20,000;22;7;15;0;0;0
1554400;Paint Chips;;20,000 - 50,000;123;11;112;0;0;0
1554460;Bibou Quest;;0 - 20,000;20;3;17;0;0;0
1554520;Smackball;;0 - 20,000;3;0;3;0;0;0
1554550;Unlock The Cat;;0 - 20,000;89;2;87;0;0;1
1554600;Wife Quest;;0 - 20,000;130;31;99;0;0;0
1554640;Super Sami Roll;;0 - 20,000;93;11;82;0;0;1
1554660;Cat way Domino;;0 - 20,000;43;2;41;0;0;0
1554700;Inglorious Waifu VS Nazi Zombies;;50,000 - 100,000;298;15;283;0;0;0
1554750;Occultism Limbo: The ritual of little nightmares;;0 - 20,000;2;1;1;0;0;0
1554760;Blessings of No-more;;0 - 20,000;2;2;0;0;0;0
1554790;Coloring Game 4;;100,000 - 200,000;1405;92;1313;2506;583;89
1554840;Toree 3D;;200,000 - 500,000;1005;32;973;34;34;1
1554850;One Try Tower;;0 - 20,000;2;1;1;0;0;0
1554920;Neon Shooter;;0 - 20,000;2;0;2;0;0;0
1554960;Parkour Game;;20,000 - 50,000;10;7;3;0;0;0
1554970;Rogue Spirit;;0 - 20,000;105;26;79;0;0;0
1555070;ANOTHER DERBY!;;0 - 20,000;8;0;8;0;0;0
1555080;Sniper Ships: Shoot'em Up on Rails;;0 - 20,000;20;3;17;0;0;0
1555130;Where Wind Becomes Quiet;;0 - 20,000;18;14;4;0;0;0
1555160;Frog story;;0 - 20,000;9;10;-1;0;0;0
1555210;Uncle Ted;;0 - 20,000;2;2;0;0;0;0
1555220;Artemishea;;0 - 20,000;141;133;8;0;0;0
1555230;Starvoly;;0 - 20,000;7;5;2;0;0;0
1555270;Alexei Run;;0 - 20,000;28;11;17;0;0;0
1555290;Hormone Wars - Tower Defense;;200,000 - 500,000;1;1;0;0;0;0
1555300;Family;;0 - 20,000;2;2;0;0;0;0
1555310;Castle Constructor;;0 - 20,000;22;9;13;0;0;0
1555350;Drift Mania;;20,000 - 50,000;4;14;-10;0;0;0
1555380;RPG IDLE;;0 - 20,000;4;2;2;0;0;1
1555400;Gomoku Let's Go;;50,000 - 100,000;535;67;468;0;0;5
1555420;Little Shell's Adventure;;0 - 20,000;4;1;3;0;0;0
1555500;PLACEFRONT;;0 - 20,000;2;0;2;0;0;0
1555540;CodeWalkers;;0 - 20,000;3;0;3;0;0;0
1555560;Wind Angel;;0 - 20,000;16;7;9;0;0;0
1555570;Legacy of Vane;;0 - 20,000;6;2;4;0;0;0
1555580;Invisible Services - Pixel Art Jigsaw Puzzle;;0 - 20,000;19;0;19;0;0;0
1555590;Fish Person Shooter;;0 - 20,000;28;2;26;0;0;0
1555640;Time Jumper;;0 - 20,000;4;4;0;0;0;0
1555650;HEXCRAFT: Harlequin Fair;;200,000 - 500,000;31;1;30;0;0;0
1555660;卢沟桥事变;;0 - 20,000;1;0;1;0;0;0
1555710;OMFG: One Million Fatal Guns;;200,000 - 500,000;1897;108;1789;0;0;9
1555770;Rogue Sentry;;0 - 20,000;14;1;13;0;0;0
1555780;鸭子达奇 Duck Duchy;;0 - 20,000;2;0;2;0;0;0
1555890;Paradise Lost;;0 - 20,000;5;15;-10;0;0;1
1555900;Life Is Not The End!;;0 - 20,000;2;0;2;0;0;0
1555920;CAN ANDROIDS SURVIVE;;0 - 20,000;8;0;8;0;0;0
1555950;TYPO;;0 - 20,000;9;0;9;0;0;0
1556040;Aritana and the Twin Masks;;0 - 20,000;2;0;2;0;0;0
1556120;RAKETENWASCHMACHINE;;0 - 20,000;2;5;-3;0;0;0
1556140;Show me VR;;0 - 20,000;1;2;-1;0;0;0
1556150;UPH!;;0 - 20,000;12;0;12;0;0;0
1556160;Techno Tanks;;0 - 20,000;18;0;18;0;0;0
1556200;Predator: Hunting Grounds;;200,000 - 500,000;2303;700;1603;423;759;64
1556250;Tezz: Portals;;0 - 20,000;17;2;15;0;0;0
1556350;Math Castle;;0 - 20,000;1;2;-1;0;0;1
1556420;Wide Open;;0 - 20,000;19;1;18;0;0;0
1556430;Deep Therapy;;0 - 20,000;3;0;3;0;0;0
1556480;KARMA;;0 - 20,000;4;11;-7;0;0;0
1556490;Retreat To Enen;;20,000 - 50,000;185;109;76;46;46;7
1556550;Chiasm;;0 - 20,000;1;0;1;0;0;0
1556610;A Conversation With Mister Rabbit;;0 - 20,000;20;9;11;0;0;0
1556650;Castle of Shikigami 2;;0 - 20,000;32;2;30;0;0;0
1556660;Shell Out Showdown;;0 - 20,000;14;0;14;0;0;0
1556670;I'm a King;;0 - 20,000;3;6;-3;0;0;0
1556680;OVERSTARS;;0 - 20,000;1;0;1;0;0;0
1556740;Oplitak;;0 - 20,000;3;0;3;0;0;0
1556790;Isonzo;;100,000 - 200,000;4562;844;3718;340;443;197
1556860;Role Player: Full Immersion;;20,000 - 50,000;139;45;94;0;0;0
1556870;Golf Club Wasteland;;200,000 - 500,000;611;127;484;52;85;3
1556930;Being Loved;;0 - 20,000;9;1;8;0;0;0
1556960;Red Frozen;;0 - 20,000;6;0;6;0;0;0
1556980;Internet Generation;;50,000 - 100,000;950;182;768;0;0;3
1557050;Combat Chess;;0 - 20,000;5;1;4;0;0;2
1557060;Wonhon: Prologue;;200,000 - 500,000;47;10;37;0;0;0
1557070;Cut Them Up;;0 - 20,000;1;1;0;0;0;0
1557100;Out Of The Shelter;;0 - 20,000;8;2;6;0;0;0
1557190;REFICUL 666;;0 - 20,000;11;6;5;0;0;0
1557200;My Eyes;;0 - 20,000;13;1;12;0;0;2
1557230;Rabbit Riot;;0 - 20,000;41;5;36;0;0;0
1557240;Sheriff Rage;;0 - 20,000;12;5;7;0;0;0
1557350;Wanderlust: The Bermuda Secret Collector's Edition;;0 - 20,000;5;4;1;0;0;1
1557360;ITERRIA ZONE;;0 - 20,000;2;0;2;0;0;0
1557410;BLACK WITCHCRAFT;;0 - 20,000;76;20;56;0;0;1
1557420;SHIPS AT WAR;;0 - 20,000;165;46;119;0;0;6
1557430;Midnight is Lost;;0 - 20,000;16;3;13;0;0;0
1557480;Project MIKHAIL: A Muv-Luv War Story;;20,000 - 50,000;347;275;72;0;0;10
1557510;Myastere -Ruins of Deazniff-;;0 - 20,000;25;11;14;0;0;0
1557540;Cutie Bear;;0 - 20,000;10;6;4;0;0;0
1557550;Rogues Adventure;;0 - 20,000;12;4;8;0;0;0
1557580;DON'T LOOK AWAY;;0 - 20,000;101;18;83;0;0;0
1557670;Outright;;0 - 20,000;9;0;9;0;0;0
1557690;三国演义之蜀汉传奇;;0 - 20,000;11;8;3;0;0;1
1557700;The World After;;20,000 - 50,000;40;12;28;0;0;0
1557740;ROUNDS;;500,000 - 1,000,000;14987;722;14265;625;363;793
1557760;6 Feet Behind;;20,000 - 50,000;7;1;6;0;0;0
1557760;6 Feet Behind;;20,000 - 50,000;7;1;6;0;0;0
1557780;Help Me!;;0 - 20,000;223;63;160;0;0;0
1557840;Maze;;0 - 20,000;48;7;41;0;0;0
1557860;Gear.Club Unlimited 2 - Ultimate Edition;;0 - 20,000;50;23;27;213;213;2
1557870;Red Robin;;0 - 20,000;2;2;0;0;0;0
1557880;Wood Killer;;0 - 20,000;4;9;-5;0;0;0
1557990;Retail Royale;;200,000 - 500,000;2495;666;1829;0;0;57
1558020;Lazy Chess;;0 - 20,000;5;6;-1;0;0;0
1558070;Dragon Blast - Crazy Action Super Hero Game;;0 - 20,000;1;0;1;0;0;0
1558100;PixPhys;;0 - 20,000;149;43;106;0;0;1
1558180;u evade;;;;;0;;;
1558210;FortressCraft : Chapter 1;;0 - 20,000;24;1;23;0;0;0
1558290;Rise of Mavros;;0 - 20,000;16;2;14;0;0;0
1558320;Sky Goddess;;0 - 20,000;16;3;13;0;0;1
1558330;Mall of Mayhem;;0 - 20,000;15;10;5;0;0;0
1558360;Mystery Tales: Master of Puppets Collector's Edition;;0 - 20,000;3;2;1;0;0;0
1558420;Galaxy Arena;;20,000 - 50,000;13;4;9;0;0;0
1558430;SgyuinBaldo;;0 - 20,000;28;13;15;0;0;0
1558440;SPY ESCAPE;;0 - 20,000;14;2;12;0;0;2
1558490;Firelight Fantasy: Resistance;;0 - 20,000;51;13;38;0;0;0
1558510;MECHANICA: A Ballad of the Rabbit and Mercury;;50,000 - 100,000;591;21;570;19;37;1
1558530;Brawler;;0 - 20,000;2;2;0;0;0;0
1558630;Limitless Bit;;0 - 20,000;13;2;11;0;0;6
1558650;Alphadeck;;0 - 20,000;7;10;-3;0;0;0
1558670;Survive The Dark;;0 - 20,000;26;6;20;0;0;0
1558710;Generals. Positional Warfare;;0 - 20,000;1;0;1;0;0;0
1558730;Alexey's Winter: Night Adventure;;0 - 20,000;25;4;21;0;0;0
1558730;Alexey's Winter: Night Adventure;;0 - 20,000;25;4;21;0;0;0
1558740;Planetary Defense;;20,000 - 50,000;1;1;0;0;0;0
1558750;Let's Learn Xiangqi (Chinese Chess);;0 - 20,000;6;1;5;0;0;0
1558840;Path of Kami: Journey Begins;;0 - 20,000;20;5;15;0;0;1
1558900;Pandemic Love;;20,000 - 50,000;197;14;183;0;0;0
1558930;Little Orpheus;;0 - 20,000;123;40;83;0;0;1
1558970;Hair of the Dog;;20,000 - 50,000;65;1;64;0;0;1
1559040;Project Elysium;;0 - 20,000;0;1;-1;0;0;0
1559060;Ultra Bushwick;;0 - 20,000;5;0;5;0;0;0
1559070;Yet Another Hard Game;;0 - 20,000;3;1;2;0;0;0
1559100;Miguelshroom: First day at school;;0 - 20,000;30;5;25;0;0;0
1559180;Survival on Amazonia;;0 - 20,000;2;0;2;0;0;1
1559270;Infinity Square;;0 - 20,000;5;0;5;0;0;0
1559300;流言侦探;;20,000 - 50,000;79;14;65;0;0;2
1559330;Destroy The Hexons;;0 - 20,000;20;2;18;0;0;0
1559370;Goblins!;;0 - 20,000;2;0;2;0;0;0
1559390;Fate Seeker II;;200,000 - 500,000;11018;1113;9905;1329;1497;251
1559430;Purrfect Apawcalypse: Purrgatory Furever;;0 - 20,000;131;1;130;0;0;1
1559450;Veneficium: A witch's tale;;20,000 - 50,000;38;24;14;0;0;0
1559460;Hero's everyday life;;0 - 20,000;14;4;10;0;0;2
1559500;Happy Halloween;;0 - 20,000;18;12;6;0;0;0
1559560;Dream's Reach: Village of the Gods;;0 - 20,000;3;0;3;0;0;0
1559570;Hellstuck: Rage With Your Friends;;0 - 20,000;88;10;78;0;0;0
1559580;Gladihaters;;100,000 - 200,000;5;1;4;0;0;0
1559590;Trapped;;0 - 20,000;2;1;1;0;0;0
1559660;Trap Arena;;0 - 20,000;13;7;6;0;0;0
1559670;Sandbox Testing Game;;0 - 20,000;1;3;-2;0;0;0
1559680;Amazing Frog? V3;;20,000 - 50,000;204;58;146;0;0;20
1559700;Dreamer;;0 - 20,000;27;1;26;0;0;0
1559740;Sword and Space;;0 - 20,000;0;1;-1;0;0;0
1559760;Island Diary;;0 - 20,000;61;1;60;0;0;1
1559770;Microgravity;;0 - 20,000;0;1;-1;0;0;0
1559790;SLASH OF BULLET;;20,000 - 50,000;7;3;4;0;0;0
1559810;Salto;;0 - 20,000;15;4;11;0;0;0
1559840;只是一座楼;;0 - 20,000;13;0;13;0;0;0
1559850;Space Survival;;0 - 20,000;7;2;5;0;0;0
1559870;ORBTRAIN - Slot Racing;;0 - 20,000;0;1;-1;0;0;0
1559920;The Game For Skippers;;0 - 20,000;16;1;15;0;0;0
1559960;Grey Bones;;0 - 20,000;17;1;16;0;0;0
1559970;Froggerty Arcade (Triple Game Pack);;0 - 20,000;7;1;6;0;0;0
1559990;Exorcised;;20,000 - 50,000;3;1;2;0;0;0
1560050;A Snake In A Maze;;0 - 20,000;4;0;4;0;0;0
1560060;封神外传;;0 - 20,000;175;7;168;0;0;0
1560100;Super Stupid Game;;0 - 20,000;3;0;3;0;0;0
1560110;PIRATECRAFT;;0 - 20,000;25;20;5;0;0;0
1560130;Joe and the Gun;;0 - 20,000;17;1;16;0;0;0
1560200;DzombZ;;0 - 20,000;20;3;17;0;0;1
1560250;Rising Front;;20,000 - 50,000;650;86;564;192;192;87
1560320;Endless Furry Pinball 2D;;50,000 - 100,000;13;9;4;0;0;0
1560330;Utopos;;0 - 20,000;48;50;-2;0;0;0
1560390;Archer Master;;0 - 20,000;3;3;0;0;0;0
1560400;重叠·前夜谭：猫与少女;;0 - 20,000;4;0;4;0;0;0
1560450;the Sequence [2];;0 - 20,000;21;0;21;0;0;0
1560480;Huckleberry Fields Forever;;0 - 20,000;0;1;-1;0;0;0
1560510;HardCop 2;;0 - 20,000;2;3;-1;0;0;0
1560530;VR BOXING MASTER;;0 - 20,000;0;2;-2;0;0;0
1560560;村庄-The Village;;200,000 - 500,000;5;6;-1;0;0;0
1560590;Reality's Reverse Side;;20,000 - 50,000;19;3;16;0;0;0
1560640;Ninja Lexx;;0 - 20,000;14;4;10;0;0;0
1560730;Replay-A Puzzle Game;;0 - 20,000;3;0;3;0;0;0
1560750;Partless Ron;;0 - 20,000;3;7;-4;0;0;0
1560760;Lost Gold;;0 - 20,000;0;1;-1;0;0;0
1560770;Tower of Waifus 2;;0 - 20,000;150;37;113;31;31;0
1560850;Piozila;;0 - 20,000;10;1;9;0;0;0
1560860;Necromancer : Winter;;20,000 - 50,000;5;1;4;0;0;0
1560880;Automatrons;;0 - 20,000;3;1;2;0;0;0
1560940;Puzzle & Chess;;0 - 20,000;12;10;2;0;0;0
1560960;Night Monsters;;0 - 20,000;3;3;0;0;0;0
1560970;Islandville: A New Home;;0 - 20,000;5;0;5;0;0;4
1561020;Island Domination;;0 - 20,000;6;6;0;0;0;0
1561100;Another Warfare;;0 - 20,000;6;1;5;0;0;0
1561350;Gladia;;0 - 20,000;10;13;-3;0;0;0
1561380;RE:CALL;;0 - 20,000;23;1;22;0;0;5
1561430;Urban Mage;;0 - 20,000;14;0;14;0;0;0
1561470;World Of Stalkers;;0 - 20,000;0;3;-3;0;0;0
1561480;Duty in the Forest;;0 - 20,000;1;6;-5;0;0;0
1561500;子非猫;;0 - 20,000;4;0;4;0;0;0
1561530;Project:Solace;;0 - 20,000;4;1;3;0;0;0
1561560;Deadly Daycare VR;;50,000 - 100,000;28;3;25;0;0;0
1561590;修仙重生记;;0 - 20,000;3;1;2;0;0;0
1561600;Coeus Plan;;20,000 - 50,000;2;5;-3;0;0;0
1561610;Sweep;;100,000 - 200,000;7;2;5;0;0;0
1561660;The Lightbringer;;0 - 20,000;30;10;20;0;0;2
1561670;Dominating the skies;;20,000 - 50,000;6;1;5;0;0;0
1561720;Wisdom;;0 - 20,000;1;3;-2;0;0;0
1561750;Mission in Snowdriftland - Snowlogue;;0 - 20,000;205;20;185;0;0;0
1561780;Zombie Friday;;0 - 20,000;3;0;3;0;0;0
1561800;ROUGH KUTS: Night of the Living Dead;;200,000 - 500,000;14;4;10;0;0;0
1561850;Sefir: Mafia Story;;0 - 20,000;45;15;30;0;0;0
1561860;Marble Muse Arcade;;0 - 20,000;8;2;6;0;0;0
1561870;FALCO AXE;;20,000 - 50,000;21;2;19;0;0;0
1561880;Hell's Gate - Slide Puzzle;;0 - 20,000;14;0;14;0;0;0
1561890;Recursive Ruin;;0 - 20,000;135;21;114;0;0;1
1561980;PaintBall War 2;;0 - 20,000;40;24;16;0;0;1
1561990;R.T.O. Tales of the Dark Lands - Deluxe Edition;;0 - 20,000;1;0;1;0;0;0
1562060;DotStrike;;0 - 20,000;5;0;5;0;0;0
1562070;Pirate Story;;0 - 20,000;10;2;8;0;0;0
1562230;Entity Researchers;;20,000 - 50,000;41;4;37;0;0;0
1562240;TOOTHY HISTORY;;0 - 20,000;23;9;14;0;0;0
1562260;Camping Simulator: The Squad;;20,000 - 50,000;459;228;231;55;55;2
1562270;Small Town Robot;;0 - 20,000;6;0;6;0;0;0
1562340;TraxWorld;;0 - 20,000;0;3;-3;0;0;0
1562420;FOREWARNED;;200,000 - 500,000;3747;358;3389;484;399;118
1562440;SunSenSim;;50,000 - 100,000;1;0;1;0;0;0
1562470;Rurizakura;;0 - 20,000;12;5;7;0;0;0
1562540;SpeedingRoad;;0 - 20,000;12;5;7;0;0;0
1562550;Little Monkeys Eat Bananas;;0 - 20,000;2;0;2;0;0;0
1562700;SANABI;;50,000 - 100,000;2158;72;2086;129;129;5
1562700;SANABI;;50,000 - 100,000;2158;72;2086;129;129;5
1562740;Helix;;0 - 20,000;2;0;2;0;0;0
1562780;Broilers;;0 - 20,000;2;0;2;0;0;0
1562800;Photographer;;0 - 20,000;24;5;19;0;0;0
1562860;Distancing;;20,000 - 50,000;119;35;84;0;0;0
1562870;Mind Rite;;0 - 20,000;24;5;19;0;0;0
1562880;Ponk's Jam;;20,000 - 50,000;5;0;5;0;0;0
1562920;7 Years From Now;;0 - 20,000;55;0;55;0;0;1
1562930;World for Two;;0 - 20,000;36;5;31;0;0;0
1562940;THE LEGEND OF HEROES: HAJIMARI NO KISEKI;;20,000 - 50,000;570;124;446;0;0;43
1562970;Hyperspace : Andy's Adventure;;0 - 20,000;4;2;2;0;0;0
1562980;Destroyer of Worlds;;0 - 20,000;11;3;8;0;0;0
1563010;Bunny's Ban;;0 - 20,000;22;0;22;0;0;0
1563030;Dangerous Lands;;50,000 - 100,000;11;5;6;0;0;0
1563100;Nightmare Survival;;0 - 20,000;5;4;1;0;0;0
1563110;boom faster;;50,000 - 100,000;3;1;2;0;0;0
1563130;SuperPower 3;;50,000 - 100,000;116;955;-839;0;0;4
1563150;Cataplexy;;0 - 20,000;37;5;32;0;0;0
1563170;Kitchen Island VR;;0 - 20,000;9;3;6;0;0;0
1563180;Internet Cafe Simulator 2;;200,000 - 500,000;5801;2146;3655;516;691;180
1563190;Teomim Island;;20,000 - 50,000;2;4;-2;0;0;0
1563310;You You N Music;;0 - 20,000;1;2;-1;0;0;0
1563320;Sleep Tight;;0 - 20,000;26;3;23;0;0;0
1563340;The Most Boring Game Ever;;0 - 20,000;153;18;135;0;0;0
1563360;Slayer Cat;;0 - 20,000;2;1;1;0;0;0
1563380;Cpt.Balloney - painful days at home;;20,000 - 50,000;3;0;3;0;0;0
1563380;Cpt.Balloney - painful days at home;;20,000 - 50,000;3;0;3;0;0;0
1563420;Crazy Christmas;;20,000 - 50,000;2;1;1;0;0;0
1563550;Childhood Fears;;0 - 20,000;9;0;9;0;0;0
1563550;Childhood Fears;;0 - 20,000;9;0;9;0;0;0
1563680;Long Road;;0 - 20,000;4;9;-5;0;0;0
1563700;当火车鸣笛三秒;;20,000 - 50,000;265;56;209;0;0;1
1563720;Captain Coffer 2D;;0 - 20,000;9;2;7;0;0;0
1563730;Witching Hour;;0 - 20,000;34;13;21;0;0;1
1563770;New Yankee: Under the Genie's Thumb;;0 - 20,000;9;1;8;0;0;0
1563780;BOK-BOK: A Chicken Dating Sim;;0 - 20,000;26;2;24;0;0;0
1563800;Traffic City;;50,000 - 100,000;25;8;17;0;0;0
1563820;Inside My Mind;;0 - 20,000;19;6;13;0;0;0
1563830;Battle Cat vs Treacherous Mice;;0 - 20,000;16;5;11;0;0;0
1563840;蚂蚁模拟器（Ant simulator）;;0 - 20,000;21;2;19;0;0;0
1563850;DIY MY LADY;;0 - 20,000;105;50;55;0;0;0
1563860;Christmas Stories: The Gift of the Magi Collector's Edition;;0 - 20,000;13;4;9;0;0;0
1563900;MiniRacer;;0 - 20,000;14;12;2;0;0;0
1563950;머준이의 사건파일 ~쌍둥이 저택의 비밀~;;50,000 - 100,000;37;5;32;0;0;0
1563950;머준이의 사건파일 ~쌍둥이 저택의 비밀~;;50,000 - 100,000;37;5;32;0;0;0
1563960;TravelRacer;;0 - 20,000;8;2;6;0;0;0
1563970;Surviving West;;0 - 20,000;24;13;11;0;0;2
1564010;CLOSED HANDS;;0 - 20,000;4;0;4;0;0;0
1564020;The Dark;;0 - 20,000;6;2;4;0;0;0
1564020;The Dark;;0 - 20,000;6;2;4;0;0;0
1564080;ADD;;20,000 - 50,000;3;8;-5;0;0;0
1564090;Landlord of the Woods;;20,000 - 50,000;349;7;342;0;0;1
1564100;Synth Drift;;0 - 20,000;13;3;10;0;0;1
1564110;Beside Myself;;0 - 20,000;162;67;95;0;0;1
1564130;Adam The Storyteller;;0 - 20,000;4;0;4;0;0;0
1564140;白玉的幻梦 Dream of Hakugyokurou;;0 - 20,000;7;0;7;0;0;0
1564150;Lost in Blindness;;0 - 20,000;27;1;26;0;0;0
1564180;Steel Nations;;0 - 20,000;5;10;-5;0;0;0
1564190;Legacy Bites;;0 - 20,000;1;0;1;0;0;0
1564220;Q.U.B.E. 10th Anniversary;;0 - 20,000;59;5;54;93;93;1
1564230;RAZE 2070;;0 - 20,000;1;1;0;0;0;0
1564240;Gob;;0 - 20,000;5;0;5;0;0;0
1564280;Augury;;0 - 20,000;4;0;4;0;0;0
1564340;FGTeeV Goozy;;0 - 20,000;47;5;42;0;0;0
1564400;Symbol Sudoku;;0 - 20,000;1;0;1;0;0;0
1564410;Zerone 2D;;0 - 20,000;1;0;1;0;0;0
1564450;The Gorcs' Forge;;0 - 20,000;20;10;10;0;0;0
1564470;Vaccine Hunter;;0 - 20,000;12;19;-7;0;0;0
1564550;Mini Words: Polyglot;;0 - 20,000;43;5;38;0;0;1
1564560;Island Farmer - Jigsaw Puzzle;;0 - 20,000;297;22;275;6;6;2
1564580;Nevertales: Faryon Collector's Edition;;0 - 20,000;5;0;5;0;0;0
1564590;Easy Quiz;;0 - 20,000;9;2;7;0;0;0
1564630;Find Girl | 发现女孩;;0 - 20,000;33;23;10;0;0;0
1564660;Bongo Arena;;0 - 20,000;6;1;5;0;0;1
1564670;合成大西瓜 | Big watermelon;;0 - 20,000;8;0;8;0;0;0
1564690;cherry blossom fleet;;0 - 20,000;4;1;3;0;0;0
1564700;House Cleaning Survival;;0 - 20,000;7;8;-1;0;0;0
1564710;The Reason Why Raeliana Ended up at the Duke's Mansion;;0 - 20,000;14;3;11;0;0;0
1564720;先民的遗迹Relics of ancestors;;0 - 20,000;4;2;2;0;0;0
1564760;Bro, where's My head???;;0 - 20,000;24;7;17;0;0;0
1564800;Hopeless Dregs;;0 - 20,000;6;4;2;0;0;0
1564850;Bed Survival!;;0 - 20,000;7;10;-3;0;0;0
1564920;Shots fired in the Dark Forest;;0 - 20,000;19;3;16;0;0;0
1564930;Angry Space Bees;;0 - 20,000;20;4;16;0;0;0
1564940;A Strange City;;0 - 20,000;15;3;12;0;0;0
1564950;Two Legs;;0 - 20,000;26;3;23;0;0;0
1564970;雪糕猫;;0 - 20,000;3;0;3;0;0;0
1564980;Diego: Mission Red Tomato;;0 - 20,000;19;1;18;0;0;0
1565030;Wind of shuriken;;0 - 20,000;3;1;2;0;0;0
1565060;Revenants: Spirit & Mind;;20,000 - 50,000;16;3;13;0;0;0
1565060;Revenants: Spirit & Mind;;20,000 - 50,000;16;3;13;0;0;0
1565090;GearHead Caramel;;50,000 - 100,000;12;1;11;0;0;0
1565150;Maya's Dice;;20,000 - 50,000;2;0;2;0;0;0
1565180;Insanium;;20,000 - 50,000;1;1;0;0;0;0
1565200;Road Flash;;0 - 20,000;3;0;3;0;0;0
1565230;End of Days;;0 - 20,000;15;36;-21;0;0;0
1565290;Survival Horror #8,436;;0 - 20,000;16;20;-4;0;0;1
1565450;STERN;;0 - 20,000;9;0;9;0;0;0
1565480;Mysterious Blocks;;20,000 - 50,000;5;4;1;0;0;0
1565500;Somewhere in a Clay Nowhere;;0 - 20,000;5;0;5;0;0;0
1565530;Avoid The Rain 2;;0 - 20,000;3;0;3;0;0;0
1565580;Mini Island: Spring;;0 - 20,000;9;2;7;0;0;0
1565650;Pokitaire;;0 - 20,000;9;8;1;0;0;0
1565660;S.P.A.T.;;0 - 20,000;49;28;21;64;64;0
1565670;Five Nations;;0 - 20,000;131;24;107;0;0;3
1565680;The Dark Prophecy;;0 - 20,000;26;7;19;0;0;0
1565710;Dragon's Bane;;0 - 20,000;4;3;1;0;0;0
1565720;To Save Humanity From Virus;;0 - 20,000;5;0;5;0;0;0
1565740;Sea Battle: Annihilation;;0 - 20,000;2;1;1;0;0;0
1565780;Scaper Dash;;0 - 20,000;4;0;4;0;0;0
1565780;Scaper Dash;;0 - 20,000;4;0;4;0;0;0
1565800;Tower Attack;;20,000 - 50,000;1;0;1;0;0;0
1565830;Expert on Domestication;;0 - 20,000;2;4;-2;0;0;0
1565840;PuppeTNetiK - Speedrun Challenge;;20,000 - 50,000;10;0;10;0;0;0
1565860;Rotate To Find The Difference;;0 - 20,000;2;2;0;0;0;0
1565870;Fight for that Ball;;0 - 20,000;2;0;2;0;0;0
1565890;RaceLeague;;0 - 20,000;132;54;78;0;0;4
1565910;CRAFTSMAN;;0 - 20,000;9;18;-9;0;0;0
1565910;CRAFTSMAN;;0 - 20,000;9;18;-9;0;0;0
1565940;Maya Treasures;;0 - 20,000;9;9;0;0;0;0
1566050;GB Rober;;50,000 - 100,000;17;0;17;0;0;0
1566090;Malice & Greed;;0 - 20,000;58;5;53;0;0;0
1566120;Russian Drunken Boxers;;0 - 20,000;12;2;10;0;0;0
1566150;Nox Terrorem: Lost Souls;;0 - 20,000;1;3;-2;0;0;0
1566220;Terafall: Survival;;20,000 - 50,000;16;13;3;0;0;0
1566230;Turn on all the lights;;0 - 20,000;61;4;57;0;0;0
1566250;Lighton: Duo;;0 - 20,000;40;0;40;0;0;0
1566340;DARK AROUND YOU;;0 - 20,000;18;4;14;0;0;0
1566350;Re:Kuroi;;0 - 20,000;5;0;5;0;0;0
1566360;Gallantry;;0 - 20,000;12;3;9;0;0;0
1566370;Contrast Tunnel;;0 - 20,000;4;2;2;0;0;0
1566390;Seed of the Dead: Sweet Home;;50,000 - 100,000;1880;387;1493;270;462;19
1566410;Touhou Kouryudou ~ Unconnected Marketeers.;;50,000 - 100,000;1585;33;1552;741;741;24
1566460;Freyr's Love;;20,000 - 50,000;9;0;9;0;0;0
1566490;LONER;;0 - 20,000;27;19;8;0;0;0
1566500;Strife: The Expanse;;50,000 - 100,000;3;0;3;0;0;0
1566510;Maze Workout - Lost Urban Exit Game - Trials1;;0 - 20,000;1;0;1;0;0;0
1566540;New York Rat Simulator;;0 - 20,000;91;15;76;0;0;0
1566550;A Walk With My Dog;;0 - 20,000;13;0;13;0;0;0
1566560;Ritual;;0 - 20,000;11;6;5;0;0;0
1566580;Neocense;;0 - 20,000;9;1;8;0;0;0
1566590;Pilot's Misadventures;;20,000 - 50,000;2;1;1;0;0;0
1566600;Magic Balls;;0 - 20,000;1;3;-2;0;0;0
1566610;The Sand Dunes;;0 - 20,000;2;3;-1;0;0;0
1566620;Puzzletronics Analog Eletronics;;0 - 20,000;44;9;35;0;0;0
1566680;Still Model 3;;0 - 20,000;18;8;10;0;0;0
1566700;VR Prison Escape;;0 - 20,000;4;12;-8;0;0;0
1566720;仙路志异;;0 - 20,000;8;4;4;0;0;0
1566740;PRISONER 17;;20,000 - 50,000;7;4;3;0;0;0
1566810;Emerland Solitaire 2 Collector's Edition;;0 - 20,000;3;3;0;0;0;0
1566820;Cooking Trip New Challenge;;0 - 20,000;9;1;8;0;0;1
1566830;Magna Graecia;;0 - 20,000;14;6;8;0;0;0
1566830;Magna Graecia;;0 - 20,000;14;6;8;0;0;0
1566910;Riddle Girl;;0 - 20,000;18;9;9;0;0;0
1566960;Goddess Of War Ashley;;0 - 20,000;12;3;9;0;0;0
1566990;-A-;;0 - 20,000;10;3;7;0;0;0
1566990;-A-;;0 - 20,000;10;3;7;0;0;0
1567020;The Dark Pictures Anthology: The Devil in Me;;50,000 - 100,000;1338;1101;237;303;303;63
1567060;WILD-9;;0 - 20,000;18;3;15;0;0;0
1567200;The Wolf;;0 - 20,000;92;28;64;0;0;3
1567270;Castle survival;;0 - 20,000;5;17;-12;0;0;0
1567310;DARK FACETS;;0 - 20,000;5;2;3;0;0;0
1567370;just a game to test your lQ;;50,000 - 100,000;199;93;106;0;0;1
1567400;Yakyosho - Terror and escape at school;;0 - 20,000;33;5;28;0;0;0
1567440;inbento;;0 - 20,000;306;13;293;46;46;5
1567460;Sir Christopher;;50,000 - 100,000;12;12;0;0;0;0
1567480;Realtime Mining Simulator;;0 - 20,000;16;8;8;0;0;0
1567490;Alien Death Mob;;0 - 20,000;40;3;37;0;0;0
1567520;Blackwind;;0 - 20,000;31;25;6;0;0;1
1567670;雪国の少女;;0 - 20,000;5;0;5;0;0;0
1567720;Streamer Dancefloor;;0 - 20,000;6;0;6;0;0;1
1567800;星空列车与白的旅行;;20,000 - 50,000;1975;17;1958;156;156;16
1567830;蛋蛋掌门日志;;0 - 20,000;26;34;-8;0;0;0
1567840;Farming Tractor Simulator 2021: Farmer Life;;0 - 20,000;3;5;-2;0;0;0
1567870;KingdomDefense;;20,000 - 50,000;2;0;2;0;0;0
1567930;War Tank combat;;0 - 20,000;13;0;13;0;0;0
1567950;Disco Ball;;0 - 20,000;12;1;11;0;0;0
1567950;Disco Ball;;0 - 20,000;12;1;11;0;0;0
1567960;Chronicles of Elmyra;;20,000 - 50,000;1;1;0;0;0;0
1567980;Tachyon Wars;;0 - 20,000;3;5;-2;0;0;0
1567990;The test of beauty | 小姐姐的考验;;0 - 20,000;2;3;-1;0;0;0
1568040;Vacation Adventures: Park Ranger 11;;0 - 20,000;1;0;1;0;0;0
1568050;Pinned;;0 - 20,000;15;0;15;0;0;2
1568060;Killer 19;;20,000 - 50,000;0;1;-1;0;0;0
1568070;Burning Ball;;0 - 20,000;15;6;9;0;0;0
1568130;Spaceship for Newbies;;0 - 20,000;18;0;18;0;0;0
1568180;USA Truck Simulator;;0 - 20,000;32;26;6;0;0;0
1568190;Cat's Life Jigsaw Puzzles;;0 - 20,000;12;0;12;0;0;1
1568210;Mantle;;0 - 20,000;18;0;18;0;0;1
1568240;Castle Itter - The Strangest Battle of WWII;;0 - 20,000;4;0;4;0;0;0
1568260;Terra Earth;;0 - 20,000;4;0;4;0;0;0
1568270;Wild Times;;0 - 20,000;5;6;-1;0;0;0
1568280;Evil Buster;;0 - 20,000;5;9;-4;0;0;0
1568290;Best Miner;;0 - 20,000;4;7;-3;0;0;0
1568310;Penguin Climbing;;0 - 20,000;30;5;25;0;0;0
1568320;COMBOHEAD;;0 - 20,000;1;0;1;0;0;0
1568330;Samurai Chess;;100,000 - 200,000;21;9;12;0;0;0
1568470;Potion Meister;;0 - 20,000;0;2;-2;0;0;0
1568480;Knighted;;0 - 20,000;15;2;13;0;0;0
1568490;The Survivor After;;20,000 - 50,000;1;1;0;0;0;0
1568560;Faction Wars;;0 - 20,000;0;2;-2;0;0;0
1568570;Retro Tank Party;;0 - 20,000;7;4;3;0;0;0
1568580;Hands of Wisp;;0 - 20,000;17;0;17;0;0;0
1568580;Hands of Wisp;;0 - 20,000;17;0;17;0;0;0
1568620;MetaPhysical;;50,000 - 100,000;159;29;130;0;0;4
1568650;*NEW* SCUFFED EPIC VISUAL NOVEL;;0 - 20,000;39;2;37;0;0;0
1568720;Plague Breaker;;0 - 20,000;18;1;17;0;0;0
1568790;Red White Yellow;;0 - 20,000;5;0;5;0;0;0
1568880;秘封フラグメント;;0 - 20,000;112;4;108;0;0;1
1568900;肉牛养殖计划;;0 - 20,000;0;3;-3;0;0;0
1568920;Clean Slate;;20,000 - 50,000;16;1;15;0;0;0
1568960;True Spring Love;;0 - 20,000;14;4;10;0;0;0
1569040;Football Manager 2022;;1,000,000 - 2,000,000;18650;1510;17140;20587;12435;16136
1569090;Vivid Knight;;50,000 - 100,000;1334;129;1205;804;1352;35
1569120;Towards the Sky;;0 - 20,000;4;1;3;0;0;0
1569150;Glyph☀️;;0 - 20,000;115;4;111;0;0;4
1569170;A Way Back;;0 - 20,000;8;0;8;0;0;0
1569180;The Kotonoha Sisters and the Legend of Lysant Island;;20,000 - 50,000;102;6;96;0;0;1
1569200;Brewmaster: Beer Brewing Simulator;;20,000 - 50,000;557;76;481;411;421;9
1569220;Abermore;;0 - 20,000;8;33;-25;0;0;0
1569270;Choco Rabbit Revenge;;0 - 20,000;9;18;-9;0;0;0
1569340;Dwarves Craft. Father's home;;0 - 20,000;2;0;2;0;0;1
1569350;I Make Saints (Steam Edition);;20,000 - 50,000;29;6;23;0;0;0
1569380;Triple Dungeon;;0 - 20,000;2;1;1;0;0;0
1569470;TEOCIDA;;0 - 20,000;78;3;75;0;0;1
1569520;IRMÃO Grande & Brasileiro 2;;50,000 - 100,000;413;11;402;244;244;18
1569540;Top Gang;;0 - 20,000;2;0;2;0;0;0
1569550;Dread X Collection: The Hunt;;50,000 - 100,000;300;26;274;373;373;1
1569560;The Simplest Game;;0 - 20,000;8;1;7;0;0;0
1569650;Palladise Island;;0 - 20,000;101;12;89;0;0;6
1569670;inPixio Photo Studio Pro;;0 - 20,000;2;0;2;0;0;1
1569760;Lab BreakOut;;0 - 20,000;14;5;9;0;0;0
1569920;Saphyro;;0 - 20,000;6;2;4;0;0;0
1569930;Sword and Fairy 5;;0 - 20,000;29;19;10;0;0;6
1569990;Choco Pixel X;;0 - 20,000;4;0;4;0;0;0
1570010;FAR: Changing Tides;;50,000 - 100,000;2189;149;2040;816;871;16
1570020;World's End Club;;0 - 20,000;95;39;56;0;0;1
1570050;Break through 50;;0 - 20,000;8;1;7;0;0;0
1570070;Beholder 3;;100,000 - 200,000;970;443;527;1308;1308;10
1570120;BUNKER;;0 - 20,000;7;6;1;0;0;0
1570130;GameCreator;;0 - 20,000;28;5;23;0;0;9
1570160;Skip Lake;;0 - 20,000;28;1;27;0;0;0
1570290;Hyper Dungeon Crawler;;0 - 20,000;6;2;4;0;0;0
1570320;Battle Star Asteroids;;0 - 20,000;13;0;13;0;0;0
1570330;West Hunt;;20,000 - 50,000;569;70;499;271;271;44
1570420;Clan of Death;;0 - 20,000;8;1;7;0;0;0
1570500;Space Moth: Lunar Edition;;0 - 20,000;17;0;17;0;0;0
1570510;Undernauts: Labyrinth of Yomi;;0 - 20,000;81;13;68;0;0;9
1570610;Herbis;;0 - 20,000;3;0;3;0;0;0
1570620;Universe 25;;100,000 - 200,000;4;0;4;0;0;0
1570650;The Last Order: Dungeons;;0 - 20,000;16;2;14;0;0;0
1570680;Slayers, Inc.;;0 - 20,000;6;0;6;0;0;0
1570740;Sacred Cubes;;0 - 20,000;8;7;1;0;0;0
1570750;Hextones;;0 - 20,000;61;4;57;0;0;0
1570760;Variables 2;;100,000 - 200,000;379;40;339;0;0;2
1570790;2D Platformer GAME (Toy Factory);;0 - 20,000;51;3;48;0;0;0
1570850;Frauki's Adventure!;;0 - 20,000;21;5;16;0;0;0
1570850;Frauki's Adventure!;;0 - 20,000;21;5;16;0;0;0
1570860;Little Wolf;;0 - 20,000;3;2;1;0;0;0
1570990;Chroma Quaternion;;0 - 20,000;5;0;5;0;0;0
1571000;Alphadia Genesis 2;;0 - 20,000;1;1;0;0;0;0
1571010;物理世界;;0 - 20,000;77;11;66;0;0;1
1571040;恶搞赛车 湿身吧！ Splash To Wild Kids;;0 - 20,000;1;1;0;0;0;0
1571070;Felix The Toy;;0 - 20,000;40;6;34;0;0;0
1571090;Beast Crimes;;0 - 20,000;20;2;18;0;0;0
1571120;Crucible;;50,000 - 100,000;14;0;14;0;0;0
1571140;东方十昊狱 ～ Hella Dazzling Hell!!;;0 - 20,000;75;14;61;0;0;0
1571160;Lost Scavenger;;20,000 - 50,000;131;70;61;0;0;0
1571210;Scientific Shutdown;;0 - 20,000;2;0;2;0;0;0
1571220;Chessplosion;;0 - 20,000;114;4;110;0;0;1
1571330;Battle Royale Craft;;0 - 20,000;9;3;6;0;0;0
1571360;Puzzle Pieces;;0 - 20,000;1;0;1;0;0;0
1571440;Lunch Lady;;200,000 - 500,000;8756;1413;7343;94;77;133
1571450;Bear Haven Nights 2;;0 - 20,000;5;0;5;0;0;0
1571460;Zorro The Chronicles;;0 - 20,000;32;5;27;0;0;1
1571480;Tiger Tank;;0 - 20,000;4;1;3;0;0;0
1571540;Gimmick in the Chaos Dimension;;0 - 20,000;10;0;10;0;0;0
1571600;Dark Romance: Sleepy Hollow Collector's Edition;;0 - 20,000;19;0;19;0;0;0
1571640;stardust;;0 - 20,000;5;0;5;0;0;0
1571660;Au-Delà;;0 - 20,000;11;1;10;0;0;3
1571730;Castle Of Collapse;;0 - 20,000;5;2;3;0;0;0
1571750;Gun Game;;0 - 20,000;4;0;4;0;0;0
1571890;JAM GODS;;0 - 20,000;33;5;28;0;0;0
1571940;Ctrl Alt Ego;;0 - 20,000;256;9;247;3421;3421;15
1571950;Slick Racing Game;;0 - 20,000;27;14;13;0;0;0
1571960;The Corpsmen;;0 - 20,000;24;16;8;0;0;1
1572040;Through The Fragmentation;;20,000 - 50,000;116;3;113;0;0;0
1572050;Crash Race;;0 - 20,000;13;4;9;0;0;0
1572120;Unblock Me Car;;0 - 20,000;40;2;38;0;0;0
1572140;Get-A-Grip Chip and the Body Bugs;;0 - 20,000;6;0;6;0;0;0
1572150;The Monster Mole;;0 - 20,000;3;5;-2;0;0;0
1572170;Pandemic Pandemonium;;0 - 20,000;5;0;5;0;0;0
1572190;Hyposphere Z;;50,000 - 100,000;18;6;12;0;0;0
1572220;Guns and Grapples;;0 - 20,000;6;0;6;0;0;0
1572230;Nami;;0 - 20,000;3;0;3;0;0;0
1572270;F.I.S.H.;;0 - 20,000;194;10;184;0;0;0
1572320;Malfunction II;;0 - 20,000;2;1;1;0;0;0
1572330;Hero of the Demon;;0 - 20,000;39;12;27;0;0;1
1572340;Ark of Artemis;;20,000 - 50,000;172;32;140;0;0;2
1572400;Elemental Angel;;0 - 20,000;22;0;22;0;0;0
1572420;Leenie Boog;;0 - 20,000;124;29;95;0;0;0
1572440;Bakery Shop Simulator;;0 - 20,000;172;83;89;0;0;0
1572460;My Simple Puzzle;;0 - 20,000;2;0;2;0;0;0
1572470;Höll Space 5D6;;100,000 - 200,000;8;4;4;0;0;0
1572790;Gustavo : Kingdom Rebirth;;0 - 20,000;3;5;-2;0;0;0
1572800;Neon Snake;;0 - 20,000;12;1;11;0;0;0
1572810;МЕМОЛОГИЯ;;0 - 20,000;287;48;239;0;0;0
1572810;МЕМОЛОГИЯ;;0 - 20,000;287;48;239;0;0;0
1572830;Before the battery´s over;;0 - 20,000;20;2;18;0;0;0
1572970;Liberation Mutagenix;;0 - 20,000;3;0;3;0;0;0
1572990;Twilight Town: A Cyberpunk Day In Life;;0 - 20,000;73;10;63;0;0;1
1573070;Endless Furry Blackjack;;50,000 - 100,000;1;4;-3;0;0;0
1573090;Impaler;;20,000 - 50,000;210;10;200;51;51;3
1573110;Azy;;0 - 20,000;2;1;1;0;0;0
1573130;VR Chinese Garden Tour (HD): Flying as a dragonfly;;0 - 20,000;11;1;10;0;0;0
1573210;Desktop AI - Lily;;0 - 20,000;4;2;2;0;0;0
1573240;ONNANOKO KEEPER 3;;0 - 20,000;2;0;2;0;0;0
1573250;Allura: The Three Realms;;0 - 20,000;11;2;9;0;0;0
1573280;WW2 Rebuilder;;50,000 - 100,000;525;65;460;266;383;50
1573330;Unreal Sandbox;;0 - 20,000;2;1;1;0;0;0
1573350;Coastline Flight Simulator;;0 - 20,000;11;4;7;0;0;1
1573390;Lila’s Sky Ark;;0 - 20,000;61;8;53;0;0;1
1573500;Red Measures;;0 - 20,000;4;1;3;0;0;0
1573530;Prison 69;;0 - 20,000;0;1;-1;0;0;0
1573540;Spaceship Simulator;;0 - 20,000;16;2;14;0;0;2
1573580;CATch the Stars: Japan;;0 - 20,000;94;5;89;0;0;1
1573630;Choice of Life: Middle Ages 2;;20,000 - 50,000;367;12;355;0;0;22
1573700;Dropshipping Simulator;;0 - 20,000;61;32;29;0;0;0
1573710;Monster In The Dark;;20,000 - 50,000;1;0;1;0;0;0
1573720;Agatha Christie - Hercule Poirot: The First Cases;;50,000 - 100,000;457;133;324;160;160;11
1573730;Helicopter Simulator VR 2021 - Rescue Missions;;0 - 20,000;115;22;93;0;0;0
1573750;100 hidden mushrooms;;50,000 - 100,000;247;20;227;0;0;0
1573760;Battle In The City;;0 - 20,000;3;2;1;0;0;0
1573800;The Steps as we know them;;0 - 20,000;5;0;5;0;0;0
1574020;Automation* of Sorts;;0 - 20,000;1;0;1;0;0;0
1574030;War Of Freedom;;0 - 20,000;8;3;5;0;0;0
1574060;AnotherQuizzGame;;0 - 20,000;1;0;1;0;0;0
1574110;Lying Souls;;0 - 20,000;4;1;3;0;0;0
1574200;Lucid: Parables of the Ubermensch;;0 - 20,000;14;0;14;0;0;0
1574240;Dread Delusion;;20,000 - 50,000;518;38;480;529;529;9
1574250;SPOOKWARE;;20,000 - 50,000;487;27;460;238;238;2
1574270;Sucker for Love: First Date;;50,000 - 100,000;1968;30;1938;341;341;11
1574320;神秘世界 Mysterious world;;0 - 20,000;0;1;-1;0;0;0
1574330;魔法少女は自由に変身できない。;;0 - 20,000;51;1;50;0;0;0
1574370;Catsperience;;0 - 20,000;5;1;4;0;0;0
1574390;Converter;;0 - 20,000;22;0;22;0;0;0
1574450;O.V.N.I. Abduction;;50,000 - 100,000;18;6;12;0;0;0
1574470;Hop Step Sing! VR Live 《Hop★Summer Tour 2020》;;0 - 20,000;48;0;48;0;0;0
1574510;Kartoffl;;20,000 - 50,000;3;0;3;0;0;0
1574530;Just get in through the door;;0 - 20,000;10;1;9;0;0;0
1574540;Pixel Game Maker Series  ISEKAI QUARTET Adventure Action Game;;0 - 20,000;2;1;1;0;0;0
1574580;Strange Horticulture;;200,000 - 500,000;6001;276;5725;1490;1570;86
1574610;Drone Gladiator;;20,000 - 50,000;3;0;3;0;0;0
1574620;A Cat in Dungeons;;0 - 20,000;20;2;18;0;0;0
1574670;Kaboom!;;0 - 20,000;1;0;1;0;0;0
1574690;Extreme Peg Solitaire;;0 - 20,000;1;0;1;0;0;0
1574740;In the dark forest;;0 - 20,000;10;10;0;0;0;0
1574750;Super Retro Fighter;;0 - 20,000;66;16;50;0;0;0
1574850;Music95;;0 - 20,000;13;3;10;0;0;0
1574900;Salt 2: Shores of Gold;;50,000 - 100,000;564;77;487;28;28;35
1574910;The Bart Bonte collection;;0 - 20,000;63;1;62;0;0;3
1575030;Slime Dungeon Escape;;0 - 20,000;5;1;4;0;0;0
1575040;Starlight X-2: Space Sudoku;;0 - 20,000;7;0;7;0;0;0
1575100;Ziode Shadow;;20,000 - 50,000;7;0;7;0;0;0
1575230;Paid Trade;;0 - 20,000;2;1;1;0;0;0
1575240;Neon Dimension;;0 - 20,000;0;6;-6;0;0;0
1575270;Robin: Race!;;0 - 20,000;4;0;4;0;0;0
1575290;Haunting At Cliffhouse;;0 - 20,000;8;1;7;0;0;0
1575290;Haunting At Cliffhouse;;0 - 20,000;8;1;7;0;0;0
1575300;No Parachute;;0 - 20,000;120;9;111;0;0;0
1575320;Curiosity;;0 - 20,000;1;0;1;0;0;0
1575380;In the Wild;;0 - 20,000;4;0;4;0;0;0
1575430;The Bounty Huntress;;0 - 20,000;13;6;7;0;0;0
1575450;Dark Siren;;0 - 20,000;89;9;80;0;0;2
1575470;Frogun;;20,000 - 50,000;238;38;200;0;0;4
1575480;Once Upon a Sea;;0 - 20,000;0;1;-1;0;0;0
1575520;Fruit Ninja VR 2;;50,000 - 100,000;48;12;36;0;0;0
1575580;The Royal Game of Ur 3D;;20,000 - 50,000;12;0;12;0;0;0
1575590;Alder Forge;;0 - 20,000;10;0;10;0;0;0
1575640;SOL CRESTA;;0 - 20,000;60;17;43;0;0;3
1575650;Love Decision;;0 - 20,000;10;3;7;0;0;0
1575670;SNK VS. CAPCOM: THE MATCH OF THE MILLENNIUM;;0 - 20,000;90;4;86;0;0;0
1575690;Super Maze Labyrinth;;0 - 20,000;8;0;8;0;0;0
1575710;AutoChess of Gensokyo;;0 - 20,000;215;74;141;0;0;3
1575730;Descending I - House of Nightmares;;20,000 - 50,000;32;4;28;0;0;1
1575750;ShapeVS;;0 - 20,000;4;0;4;0;0;0
1575860;BasCatball Saturn: Basketball & Cat;;0 - 20,000;14;1;13;0;0;0
1575870;UpGun;;50,000 - 100,000;1142;197;945;147;194;146
1575900;Old Stories: Fireheart;;20,000 - 50,000;3;0;3;0;0;0
1575910;Mega Solitaire Collection;;0 - 20,000;7;4;3;0;0;0
1575920;Cyberdunk Anime Edition;;0 - 20,000;48;16;32;0;0;0
1575950;Wisly and the Chickens!;;0 - 20,000;19;0;19;0;0;0
1576000;Pain Party;;0 - 20,000;50;9;41;0;0;0
1576020;Saighead;;0 - 20,000;3;0;3;0;0;0
1576050;Super Pixel World;;0 - 20,000;6;0;6;0;0;0
1576060;Suspects: Mystery Mansion;;50,000 - 100,000;857;215;642;0;0;59
1576130;IdolDays;;0 - 20,000;93;15;78;56;56;0
1576140;2002XX;;0 - 20,000;0;1;-1;0;0;0
1576150;JUNK: The Legend of Junichi Kato;;0 - 20,000;10;3;7;0;0;0
1576220;Protoplasm-Mutiny;;0 - 20,000;1;0;1;0;0;0
1576230;An Un-epic story: The adventure of Enki and Tiny Freddie;;0 - 20,000;26;5;21;0;0;0
1576240;The Shadow of Yidhra;;20,000 - 50,000;711;35;676;172;172;4
1576290;BENTO GIRL;;0 - 20,000;13;8;5;0;0;0
1576300;Dr Iwan: Evolution;;0 - 20,000;4;2;2;0;0;0
1576350;Blair Witch VR;;0 - 20,000;99;44;55;0;0;2
1576370;REPLIKATOR;;0 - 20,000;76;10;66;0;0;0
1576470;Memento Vivere;;20,000 - 50,000;2;1;1;0;0;0
1576480;Ultima Adventum;;20,000 - 50,000;3;2;1;0;0;0
1576490;Dark Sheep;;0 - 20,000;32;2;30;0;0;0
1576510;Shining Cubes;;0 - 20,000;4;4;0;0;0;0
1576540;WaveTiles;;0 - 20,000;1;0;1;0;0;0
1576550;Otaku Club;;0 - 20,000;8;4;4;0;0;0
1576570;Legend Of Maratha Warriors;;0 - 20,000;7;0;7;0;0;0
1576600;Matraquinha PAIR;;0 - 20,000;24;7;17;0;0;0
1576620;Mission Mars;;0 - 20,000;3;1;2;0;0;0
1576660;PLAYBOOK;;0 - 20,000;5;3;2;0;0;0
1576720;Armageddon Empires;;0 - 20,000;22;5;17;0;0;1
1576740;One Escape;;0 - 20,000;2;1;1;0;0;0
1576750;Gravity run;;0 - 20,000;5;9;-4;0;0;0
1576770;Superhero Recruitment Simulator;;0 - 20,000;3;0;3;0;0;0
1576790;FPS Tactics;;0 - 20,000;7;13;-6;0;0;1
1576830;Fruit Sudoku;;0 - 20,000;10;0;10;0;0;1
1576840;Ball Challenge;;0 - 20,000;10;1;9;0;0;0
1576860;Last Dance;;0 - 20,000;4;1;3;0;0;0
1576910;Hellgate VR;;0 - 20,000;10;23;-13;0;0;0
1576930;Man of the World;;0 - 20,000;1;1;0;0;0;0
1576970;The Lost King of Avallon;;0 - 20,000;15;9;6;0;0;0
1576990;SUPER METBOY!;;0 - 20,000;4;0;4;0;0;0
1577120;The Quarry;;100,000 - 200,000;6874;2014;4860;464;584;314
1577140;TETRIX 3D;;0 - 20,000;5;0;5;0;0;0
1577190;Arkan Tower;;0 - 20,000;13;16;-3;0;0;0
1577240;Cions of Vega;;0 - 20,000;49;12;37;0;0;0
1577250;The Chant;;0 - 20,000;250;58;192;61;61;2
1577260;Dininho Adventures: Definitive Edition;;0 - 20,000;53;1;52;0;0;2
1577280;Chicken Holmes - The Mystery of Bartolomeu;;0 - 20,000;27;7;20;0;0;0
1577290;Bonegard;;50,000 - 100,000;4;2;2;0;0;0
1577300;Mars Accident;;0 - 20,000;1;2;-1;0;0;0
1577310;Cave Nightmare;;0 - 20,000;5;2;3;0;0;0
1577320;Somewhere in the Shadow;;50,000 - 100,000;443;105;338;0;0;7
1577350;The Black Hole;;0 - 20,000;4;0;4;0;0;0
1577470;Straya;;0 - 20,000;25;2;23;0;0;0
1577530;Spider-Robots War;;0 - 20,000;16;9;7;0;0;0
1577570;Juno's Journey;;0 - 20,000;3;0;3;0;0;0
1577590;Pineapple Island;;0 - 20,000;3;1;2;0;0;0
1577620;The Signal State;;20,000 - 50,000;320;41;279;689;689;5
1577660;Trash Quest;;0 - 20,000;71;3;68;0;0;0
1577660;Trash Quest;;0 - 20,000;71;3;68;0;0;0
1577680;Neon GraVel;;0 - 20,000;3;0;3;0;0;0
1577690;Video Game Fables;;0 - 20,000;27;1;26;0;0;2
1577710;Human Guise: Chapter Ⅰ;;0 - 20,000;15;0;15;0;0;1
1577750;Hamster All-Stars;;0 - 20,000;19;1;18;0;0;1
1577860;Code Lab（代码实验室）;;0 - 20,000;2;0;2;0;0;0
1577900;Contact Me;;0 - 20,000;6;1;5;0;0;0
1577910;Ghost Cash Collect;;0 - 20,000;6;1;5;0;0;0
1577940;Redaxium;;20,000 - 50,000;8;2;6;0;0;0
1577990;Robo-Worms;;0 - 20,000;3;0;3;0;0;0
1578060;Mastho is Together;;0 - 20,000;37;0;37;0;0;0
1578070;Fish Feast;;50,000 - 100,000;1;0;1;0;0;0
1578080;DEADLUCK;;0 - 20,000;1;2;-1;0;0;0
1578110;God of Riffs;;0 - 20,000;11;1;10;0;0;0
1578160;Bots Are Stupid;;0 - 20,000;49;10;39;0;0;3
1578190;Arttista;;0 - 20,000;4;0;4;0;0;0
1578250;Warplane inc.;;0 - 20,000;15;8;7;0;0;0
1578250;Warplane inc.;;0 - 20,000;15;8;7;0;0;0
1578270;Love Notes;;0 - 20,000;4;4;0;7;7;0
1578280;纸上谈兵模拟器;;0 - 20,000;3;3;0;0;0;0
1578300;Race - Total Toon Race;;0 - 20,000;2;0;2;0;0;0
1578330;Doki Doki Ragnarok;;0 - 20,000;19;1;18;0;0;2
1578380;10K & The Kriminal World - Sammy's Attack;;0 - 20,000;1;0;1;0;0;0
1578390;My Garage;;20,000 - 50,000;942;93;849;2569;2569;118
1578410;Aviano;;0 - 20,000;5;5;0;0;0;0
1578470;Hide Seek Survive;;0 - 20,000;6;6;0;0;0;0
1578500;Starless;;0 - 20,000;34;0;34;0;0;0
1578540;A Night Before the Deadline;;0 - 20,000;13;3;10;0;0;0
1578540;A Night Before the Deadline;;0 - 20,000;13;3;10;0;0;0
1578550;Aero Battle;;0 - 20,000;8;9;-1;0;0;0
1578570;Destroy Geometric Shapes;;0 - 20,000;19;3;16;0;0;0
1578650;Citizen Sleeper;;200,000 - 500,000;2815;161;2654;661;877;89
1578660;80s Volleyball;;0 - 20,000;5;3;2;0;0;0
1578700;Fruit Row;;0 - 20,000;13;7;6;0;0;0
1578710;REDITUM;;0 - 20,000;3;0;3;0;0;0
1578730;ParticuLights;;0 - 20,000;1;0;1;0;0;0
1578750;Endless Furry Asteroids;;0 - 20,000;2;0;2;0;0;0
1578760;Ember Knight Solitaire;;0 - 20,000;3;0;3;0;0;0
1578860;Billionaire Lovers;;100,000 - 200,000;2914;127;2787;12;12;15
1578890;Murder at Midnight;;0 - 20,000;13;0;13;0;0;8
1578920;CrateTastrophe;;20,000 - 50,000;5;0;5;0;0;0
1578950;Lady in Mystery;;0 - 20,000;109;5;104;0;0;1
1578960;VAR: Exterminate;;0 - 20,000;113;12;101;30;30;1
1578980;Wind Angel Ⅱ;;0 - 20,000;15;2;13;0;0;0
1579000;Super Head Ball;;20,000 - 50,000;10;0;10;0;0;0
1579010;狗蛋神冒险-搞笑的声控冒险;;20,000 - 50,000;9;2;7;0;0;0
1579020;Golfie;;0 - 20,000;140;31;109;47;47;10
1579030;Caveman;;0 - 20,000;1;5;-4;0;0;0
1579190;Daenerys Miracle;;20,000 - 50,000;18;3;15;0;0;0
1579200;Renova;;0 - 20,000;3;2;1;0;0;0
1579250;Tactical Battle Chronicles: Prelude to a War;;0 - 20,000;1;0;1;0;0;0
1579260;Disc Golf Valley VR;;0 - 20,000;41;18;23;0;0;3
1579300;Birb Café;;0 - 20,000;14;1;13;0;0;1
1579310;Light Infantry;;0 - 20,000;23;3;20;0;0;0
1579380;Shadow Tactics: Aiko's Choice;;200,000 - 500,000;3074;224;2850;729;932;43
1579450;DVOREC;;0 - 20,000;1;1;0;0;0;0
1579490;Dangerous Chris;;20,000 - 50,000;8;2;6;0;0;0
1579530;Rebound Raver;;0 - 20,000;10;0;10;0;0;0
1579590;SDST: Deluxe;;0 - 20,000;9;1;8;0;0;0
1579610;Ragdoll Funhouse;;0 - 20,000;1;0;1;0;0;0
1579670;Pocket Mina;;0 - 20,000;1;0;1;0;0;0
1579680;Host 714;;0 - 20,000;17;0;17;0;0;0
1579690;Void Surfer;;0 - 20,000;1;1;0;0;0;0
1579710;NaÀra: Contos de Resistência;;0 - 20,000;5;2;3;0;0;0
1579720;Sol Dorado Heist;;0 - 20,000;8;4;4;0;0;0
1579780;Brave Deeds of Rescue Team;;0 - 20,000;16;3;13;0;0;7
1579800;Hundreds of Mysteries:Wendy's Home2;;20,000 - 50,000;4;3;1;0;0;1
1579850;夏まつりのハナビィ Hanaby's Summer Festival;;0 - 20,000;38;1;37;0;0;0
1579930;Zombie Hazard;;0 - 20,000;0;2;-2;0;0;0
1580010;HUMANS CONNECT;;0 - 20,000;15;6;9;0;0;0
1580040;Trial of Two;;0 - 20,000;2;0;2;0;0;0
1580140;Tiddy Bounce;;0 - 20,000;5;0;5;0;0;0
1580150;Between Time: Escape Room;;20,000 - 50,000;182;21;161;0;0;4
1580240;Rune Factory 4 Special;;50,000 - 100,000;1124;133;991;4;4;76
1580250;Pearls of the Oceans;;0 - 20,000;1;0;1;0;0;0
1580260;"Agoraphobia ""Knock Knock""";;0 - 20,000;9;19;-10;0;0;0
1580300;Witchcraft U;;0 - 20,000;6;3;3;0;0;1
1580330;Cosmica;;0 - 20,000;2;1;1;0;0;0
1580340;Aventura Pisicului Pierdut;;0 - 20,000;17;0;17;0;0;0
1580380;Descent Vector: Space Runner;;0 - 20,000;10;1;9;0;0;0
1580420;Ambidextrous Psychopath;;0 - 20,000;8;0;8;0;0;0
1580440;The LastOnesLeft;;0 - 20,000;15;10;5;0;0;0
1580460;Godspell Defender;;0 - 20,000;7;0;7;0;0;0
1580500;Cardlike;;0 - 20,000;1;0;1;0;0;0
1580510;VR Fighter Jets War;;0 - 20,000;10;3;7;0;0;0
1580520;Lost Eidolons;;200,000 - 500,000;740;232;508;254;277;98
1580560;Puzzledorf;;0 - 20,000;22;0;22;0;0;0
1580570;Blokker;;0 - 20,000;52;3;49;0;0;0
1580600;Hunted: Kobayashi Tower;;0 - 20,000;12;0;12;0;0;0
1580640;银魂：Silver Soul;;50,000 - 100,000;14;14;0;0;0;0
1580670;Ghost or Trick;;0 - 20,000;3;1;2;0;0;0
1580750;G-MODEアーカイブス01 フライハイトクラウディア;;0 - 20,000;6;0;6;0;0;0
1580770;HIGH & LOW ~ Aim! 26 consecutive wins! Road to 5,000 trillion yen ~;;0 - 20,000;10;0;10;0;0;0
1580780;[NINJA GAIDEN: Master Collection] NINJA GAIDEN Σ;;50,000 - 100,000;1307;316;991;176;256;22
1580790;[NINJA GAIDEN: Master Collection] NINJA GAIDEN Σ2;;50,000 - 100,000;846;281;565;382;433;26
1580800;Erannorth Chronicles;;20,000 - 50,000;223;24;199;0;0;20
1580850;Escape Abstraction;;0 - 20,000;1;2;-1;0;0;0
1580870;Thief Shop;;0 - 20,000;0;1;-1;0;0;0
1580890;Save The Heart Planet;;20,000 - 50,000;0;2;-2;0;0;0
1580960;The Trigger;;0 - 20,000;9;3;6;0;0;0
1580980;The Floor is [Blank];;0 - 20,000;3;0;3;0;0;0
1581010;Haunted House - The Murder;;0 - 20,000;0;3;-3;0;0;0
1581040;El Shaddai ASCENSION OF THE METATRON HD Remaster;;20,000 - 50,000;236;31;205;0;0;0
1581040;El Shaddai ASCENSION OF THE METATRON HD Remaster;;20,000 - 50,000;236;31;205;0;0;0
1581050;Memento Infernum;;0 - 20,000;9;1;8;0;0;0
1581050;Memento Infernum;;0 - 20,000;9;1;8;0;0;0
1581070;Lock Lock: Farm;;0 - 20,000;12;0;12;0;0;0
1581080;Food Delivery Service;;0 - 20,000;21;10;11;0;0;1
1581090;Kupechestvo;;0 - 20,000;6;1;5;0;0;0
1581170;The Hundred Year Kingdom;;0 - 20,000;53;14;39;0;0;0
1581190;Toilet Paper War;;0 - 20,000;3;0;3;0;0;0
1581200;Enemy Engaged 2: Desert Operations;;50,000 - 100,000;1;5;-4;0;0;0
1581210;Sword Princess Amaltea - The Visual Novel;;0 - 20,000;3;2;1;0;0;0
1581240;Der Geisterjäger / The Ghost Hunter;;0 - 20,000;9;0;9;0;0;0
1581280;Combat Labs;;0 - 20,000;12;0;12;0;0;0
1581310;Dark Runner;;0 - 20,000;3;0;3;0;0;0
1581380;Survive Into Night;;0 - 20,000;4;1;3;0;0;0
1581420;Pets No More;;0 - 20,000;13;9;4;0;0;0
1581500;Dragon Drop;;0 - 20,000;45;0;45;0;0;0
1581580;The Legend of Bear-Truck Trucker;;0 - 20,000;43;1;42;0;0;0
1581590;VR Nara Park;;0 - 20,000;1;4;-3;0;0;0
1581600;Reconnect;;0 - 20,000;2;1;1;0;0;0
1581660;LOOSEPO;;0 - 20,000;12;1;11;0;0;0
1581670;The Five Covens;;0 - 20,000;4;0;4;0;0;0
1581720;Operation Thunder;;0 - 20,000;16;0;16;0;0;0
1581740;Kosmo Laika : Guide to Space;;0 - 20,000;21;0;21;0;0;0
1581750;Rapper Life Simulation;;0 - 20,000;10;12;-2;0;0;0
1581760;Poetry, wine and sword;;0 - 20,000;2;3;-1;0;0;0
1581770;SpellForce: Conquest of Eo;;50,000 - 100,000;758;201;557;1359;2026;1352
1581800;Slow living with Princess;;50,000 - 100,000;420;33;387;2988;4284;12
1581830;Super Sunny Island;;0 - 20,000;26;1;25;0;0;0
1581860;Unlocked;;0 - 20,000;14;0;14;0;0;0
1581880;Super Mega Zero;;0 - 20,000;34;1;33;0;0;0
1581890;The magic of three;;0 - 20,000;2;0;2;0;0;0
1581990;Memorize V;;20,000 - 50,000;5;3;2;0;0;0
1582070;The Forgotten Isles;;0 - 20,000;7;0;7;0;0;0
1582090;Wild Wild Chess;;0 - 20,000;20;4;16;0;0;0
1582130;Parallax Tunnel;;0 - 20,000;11;5;6;0;0;0
1582160;Rounded Hills;;0 - 20,000;7;0;7;0;0;0
1582180;Hello Puppets: Midnight Show;;0 - 20,000;40;7;33;0;0;3
1582260;Color Pixel Heroes;;20,000 - 50,000;3;0;3;0;0;0
1582290;LumbearJack;;0 - 20,000;77;1;76;0;0;0
1582410;Manafinder;;0 - 20,000;40;1;39;0;0;0
1582500;Purple War;;0 - 20,000;66;13;53;0;0;13
1582510;Mercenaries Blaze;;50,000 - 100,000;355;108;247;0;0;7
1582680;Trolley Problem, Inc.;;0 - 20,000;529;249;280;0;0;1
1582700;Capsule;;0 - 20,000;4;3;1;0;0;0
1582720;Recapture the Castle;;0 - 20,000;11;6;5;0;0;0
1582730;Abyss Memory Fallen Angel and the Path of Magic;;0 - 20,000;4;0;4;0;0;0
1582740;Reknum Cheri Dreamland;;0 - 20,000;13;4;9;0;0;0
1582790;Frail Faces;;0 - 20,000;4;0;4;0;0;0
1582870;Slickpoo The Clown;;0 - 20,000;4;1;3;0;0;0
1582950;Cinemoji;;0 - 20,000;27;2;25;0;0;0
1582990;Blon;;0 - 20,000;14;1;13;0;0;2
1583000;Theofil;;20,000 - 50,000;5;2;3;0;0;0
1583060;POPOP!;;20,000 - 50,000;1;1;0;0;0;0
1583070;Landing Confirmed;;0 - 20,000;1;0;1;0;0;0
1583080;Professor Crackbrain - And the awakening of the weredog;;0 - 20,000;4;0;4;0;0;1
1583130;Replicators Defence;;20,000 - 50,000;2;1;1;0;0;0
1583140;War Mines: WW2;;0 - 20,000;36;5;31;0;0;0
1583170;Herder;;0 - 20,000;10;0;10;0;0;0
1583180;Super Vili;;0 - 20,000;6;0;6;0;0;0
1583190;Space Explore;;0 - 20,000;2;4;-2;0;0;0
1583230;High On Life;;100,000 - 200,000;7910;912;6998;460;460;370
1583300;Cute Girls: Find Secrets;;0 - 20,000;28;10;18;0;0;0
1583320;Pro Soccer Online;;200,000 - 500,000;8466;768;7698;973;545;1520
1583370;In Marte - The First Moon;;0 - 20,000;1;2;-1;0;0;0
1583390;Meat Beating: No More Horny;;0 - 20,000;77;5;72;0;0;3
1583450;BURNT ASHES;;0 - 20,000;4;0;4;0;0;0
1583530;Crazy indian;;0 - 20,000;12;11;1;0;0;0
1583570;СИМУЛЯТОР ОДИНОЧЕСТВА В РУССКОЙ ДЕРЕВНЕ;;20,000 - 50,000;617;177;440;0;0;0
1583590;BLACKOUT;;0 - 20,000;25;19;6;0;0;0
1583610;Soulbound Steel;;0 - 20,000;5;0;5;0;0;0
1583660;Shiba Inu Rescue;;0 - 20,000;3;0;3;0;0;0
1583670;卡牌冒险者;;0 - 20,000;5;10;-5;0;0;0
1583690;Elijah and the Out of this World Adventure;;50,000 - 100,000;7;0;7;0;0;0
1583730;FindDark;;0 - 20,000;1;3;-2;0;0;0
1583780;Dragon Hunters;;100,000 - 200,000;1;1;0;0;0;0
1583820;Z-Company;;0 - 20,000;11;6;5;0;0;0
1583830;Little Octopus;;0 - 20,000;5;0;5;0;0;0
1583840;R-Naught;;20,000 - 50,000;2;0;2;0;0;0
1583880;Mind Shadows;;20,000 - 50,000;7;4;3;0;0;0
1583950;Brian the Brain;;0 - 20,000;8;1;7;0;0;0
1584060;Battle Guns Simulator;;0 - 20,000;2;0;2;0;0;0
1584090;Touhou Mystia's Izakaya;;200,000 - 500,000;12614;398;12216;1339;1222;526
1584140;Employee：mika;;0 - 20,000;6;1;5;0;0;0
1584190;Hungry Dino;;0 - 20,000;34;5;29;0;0;0
1584340;Space Ship DRIFT;;0 - 20,000;3;3;0;0;0;0
1584350;Battle for Sea 3D;;0 - 20,000;6;10;-4;0;0;0
1584420;Russian Mailman Simulator;;0 - 20,000;20;1;19;0;0;0
1584440;Where is my mom;;0 - 20,000;11;1;10;0;0;0
1584450;Rooten;;0 - 20,000;56;6;50;0;0;0
1584500;Spacey Vade;;0 - 20,000;2;0;2;0;0;0
1584530;Elevated;;0 - 20,000;3;0;3;0;0;0
1584540;Perseverance Mission - Astronaut Charlie;;100,000 - 200,000;26;1;25;0;0;0
1584560;Idle Poker;;0 - 20,000;3;2;1;0;0;1
1584630;RescueTeam;;0 - 20,000;0;1;-1;0;0;0
1584690;TrinityS;;0 - 20,000;108;17;91;0;0;35
1584720;Devil, It's me;;0 - 20,000;25;5;20;0;0;0
1584750;Cloud Cutter;;0 - 20,000;84;13;71;0;0;0
1584770;Green Phoenix;;20,000 - 50,000;2;1;1;0;0;0
1584800;Dark Frame;;0 - 20,000;1;2;-1;0;0;0
1584830;Duck Creator;;0 - 20,000;183;10;173;0;0;0
1584830;Duck Creator;;0 - 20,000;183;10;173;0;0;0
1584840;AGAINST;;0 - 20,000;201;60;141;0;0;1
1584860;JumpBeard;;0 - 20,000;10;2;8;0;0;0
1584900;Faerie's Bargain: The Price of Business;;0 - 20,000;10;5;5;0;0;13
1584950;Park Story;;0 - 20,000;3;0;3;0;0;0
1585020;JUNKPUNK;;20,000 - 50,000;376;98;278;0;0;12
1585030;Dark Forest: Lost Story VR;;0 - 20,000;18;10;8;0;0;0
1585040;Death Upon Us;;20,000 - 50,000;0;1;-1;0;0;0
1585040;Death Upon Us;;20,000 - 50,000;0;1;-1;0;0;0
1585050;Cliffhanger: Challenger of Tomorrow;;20,000 - 50,000;6;1;5;0;0;0
1585120;The Cryptologist Room;;0 - 20,000;3;4;-1;0;0;0
1585130;VERSUS: The Deathscapes;;0 - 20,000;6;9;-3;0;0;0
1585160;Secrets of Egypt;;0 - 20,000;10;11;-1;0;0;0
1585220;Melatonin;;20,000 - 50,000;1270;58;1212;186;256;109
1585230;CorePiercer;;0 - 20,000;17;4;13;0;0;0
1585250;The Space Between;;0 - 20,000;20;5;15;0;0;0
1585250;The Space Between;;0 - 20,000;20;5;15;0;0;0
1585330;Survival Z;;0 - 20,000;7;1;6;0;0;0
1585400;Gjallarhorn;;0 - 20,000;14;2;12;0;0;2
1585440;They Always Run;;0 - 20,000;466;91;375;14;14;2
1585440;They Always Run;;0 - 20,000;466;91;375;14;14;2
1585450;Furry Shakespeare: To Date Or Not To Date Spooky Cat Girls?;;0 - 20,000;1;0;1;0;0;0
1585460;Furry Shakespeare: Oops! All Dragons!;;0 - 20,000;1;0;1;0;0;0
1585530;Gun World VR;;0 - 20,000;69;34;35;0;0;0
1585540;Snow-Swept Quest;;20,000 - 50,000;225;26;199;0;0;2
1585570;Workplace Rhapsody;;20,000 - 50,000;957;134;823;198;254;81
1585580;Sky Goddess Ⅱ;;0 - 20,000;14;3;11;0;0;0
1585640;Aquillanto;;0 - 20,000;7;0;7;0;0;0
1585650;OrbWars;;20,000 - 50,000;12;0;12;0;0;0
1585680;Mini Crafty;;0 - 20,000;22;10;12;0;0;0
1585700;Trap Genesis;;0 - 20,000;254;11;243;18;19;2
1585750;Dwarves: build and survive;;0 - 20,000;4;0;4;0;0;0
1585830;Quickly, Quackley!;;0 - 20,000;42;3;39;0;0;0
1585910;Roll;;0 - 20,000;290;20;270;67;67;6
1585930;Pure Bowl VR Bowling;;0 - 20,000;4;4;0;0;0;0
1586010;Dream Catchers;;0 - 20,000;2;0;2;0;0;0
1586090;The Most Boring Life Ever;;0 - 20,000;4;2;2;0;0;0
1586120;Becoming;;0 - 20,000;4;3;1;0;0;0
1586150;Ephesus;;0 - 20,000;55;36;19;0;0;0
1586230;Jogward;;0 - 20,000;35;3;32;0;0;0
1586240;Pro Deer Hunting 2;;0 - 20,000;3;5;-2;0;0;1
1586270;Katja's Abyss: Tactics;;100,000 - 200,000;9;1;8;0;0;0
1586290;CARNAL;;20,000 - 50,000;151;13;138;0;0;1
1586300;Jacob The Farmer;;0 - 20,000;35;16;19;0;0;0
1586330;WeeRPG;;100,000 - 200,000;2;4;-2;0;0;0
1586350;NEOGEO POCKET COLOR SELECTION Vol. 1 Steam Edition;;0 - 20,000;20;1;19;919;919;0
1586370;Anopek;;0 - 20,000;53;0;53;0;0;1
1586510;Clessidra;;0 - 20,000;3;0;3;0;0;0
1586530;Super Soccer Blast: America vs Europe;;0 - 20,000;27;7;20;0;0;0
1586540;Super TECHPACK;;0 - 20,000;2;0;2;0;0;0
1586570;24世纪后;;20,000 - 50,000;1;0;1;0;0;0
1586620;Robot.Start - Puzzle Game;;0 - 20,000;17;0;17;0;0;0
1586630;Jigsaw Foundry;;0 - 20,000;1;0;1;0;0;0
1586650;Pillow Bellow;;0 - 20,000;1;0;1;0;0;0
1586700;MARSUPILAMI - HOOBADVENTURE;;0 - 20,000;106;7;99;0;0;3
1586740;RATOMON;;0 - 20,000;1;1;0;0;0;0
1586750;Two Strikes;;0 - 20,000;83;15;68;0;0;1
1586800;Lil Gator Game;;20,000 - 50,000;1767;7;1760;104;104;32
1586820;The List;;50,000 - 100,000;64;14;50;0;0;0
1586840;ppL;;0 - 20,000;74;10;64;0;0;1
1586880;Essays on Empathy;;20,000 - 50,000;86;19;67;0;0;1
1586920;Freedom's eye;;20,000 - 50,000;8;8;0;0;0;0
1586930;Extreme racing;;0 - 20,000;2;5;-3;0;0;0
1586960;Cute Bite;;0 - 20,000;75;6;69;0;0;2
1586980;Wilma's Dreams;;0 - 20,000;9;1;8;0;0;0
1587020;Parapsychology;;0 - 20,000;8;7;1;0;0;0
1587090;The Journey - Episode 1: Whatever This Is;;0 - 20,000;264;5;259;0;0;0
1587130;Blood West;;50,000 - 100,000;1326;113;1213;261;261;14
1587190;Puzzletronics Digital Infinite;;0 - 20,000;36;7;29;0;0;0
1587210;Cowboys, Vampires, Pirates & Ghosts;;0 - 20,000;3;0;3;0;0;0
1587240;Alchemist of Pipi Forest;;0 - 20,000;28;6;22;0;0;0
1587260;Way Back Witness;;0 - 20,000;64;1;63;0;0;0
1587350;Build Molecules for Vick - Chemistry Puzzle;;20,000 - 50,000;15;1;14;0;0;0
1587390;Network;;20,000 - 50,000;2;4;-2;0;0;0
1587430;Flappy Bat;;0 - 20,000;0;1;-1;0;0;0
1587490;Unending War: Grand-Strategy Chess;;0 - 20,000;2;2;0;0;0;0
1587500;SUPER DUPER ISLAND ADVENTURE;;0 - 20,000;3;1;2;0;0;0
1587530;Rescue Friends Solitaire;;0 - 20,000;2;0;2;0;0;0
1587540;Anvil Saga;;50,000 - 100,000;603;155;448;146;146;64
1587560;100 hidden cats;;50,000 - 100,000;1180;70;1110;80;115;1
1587610;Little drift;;0 - 20,000;10;3;7;0;0;1
1587630;1 Hop;;0 - 20,000;1;0;1;0;0;0
1587660;奇迹世界 miracle world;;0 - 20,000;0;1;-1;0;0;0
1587680;Marionette lab;;0 - 20,000;2;0;2;0;0;0
1587700;The Adventures of Mr. Poop;;0 - 20,000;7;3;4;0;0;0
1587710;Fossil Corner;;0 - 20,000;208;2;206;0;0;1
1587720;Fantasy Dungeon;;0 - 20,000;8;13;-5;0;0;0
1587750;Fat Fritz 2.0 SE;;0 - 20,000;2;1;1;0;0;3
1587770;The Temple Of;;0 - 20,000;3;1;2;0;0;0
1587790;Desert Parkour;;0 - 20,000;24;12;12;0;0;1
1587800;Queer and Chill;;0 - 20,000;6;0;6;0;0;0
1587810;Spell Swap;;0 - 20,000;28;1;27;0;0;0
1587860;Let's Ride! Silver Buckle Stables;;0 - 20,000;40;0;40;0;0;3
1587940;DuelVox: Max Quality;;0 - 20,000;11;6;5;0;0;0
1587950;Jumpin' Tanks;;0 - 20,000;3;0;3;0;0;0
1587970;ArcticBoy: The Interactive Story;;0 - 20,000;68;24;44;0;0;0
1588000;Archer boy;;0 - 20,000;4;1;3;0;0;0
1588010;PGA TOUR 2K23;;50,000 - 100,000;718;395;323;1098;1636;509
1588040;Dungeon Clicker;;0 - 20,000;19;16;3;0;0;1
1588050;Village Defender;;0 - 20,000;2;7;-5;0;0;0
1588060;Sato Dreams;;0 - 20,000;2;9;-7;0;0;0
1588070;DuckMan;;0 - 20,000;2;10;-8;0;0;0
1588100;Cat Knight;;0 - 20,000;7;5;2;0;0;0
1588110;The Sunken Hero;;0 - 20,000;4;5;-1;0;0;0
1588120;SwapOut;;0 - 20,000;10;3;7;0;0;1
1588130;MAZE: A VR Adventure;;0 - 20,000;4;1;3;0;0;0
1588130;MAZE: A VR Adventure;;0 - 20,000;4;1;3;0;0;0
1588140;Monkey vs Dino;;0 - 20,000;24;16;8;0;0;0
1588160;Putin VS Zombies;;0 - 20,000;71;9;62;0;0;0
1588250;Contract Killer;;0 - 20,000;21;0;21;0;0;0
1588300;Tower Alchemy;;20,000 - 50,000;1;0;1;0;0;0
1588340;Riftbound;;0 - 20,000;40;2;38;0;0;1
1588380;Blaster Master Zero 3;;0 - 20,000;279;33;246;0;0;4
1588510;Gaslamp Cases: The deadly Machine;;50,000 - 100,000;12;4;8;0;0;0
1588530;Dungeon Alchemist;;50,000 - 100,000;1352;53;1299;710;1321;159
1588580;Little Party Legends;;0 - 20,000;4;4;0;0;0;0
1588590;Akyrikon VR;;0 - 20,000;4;0;4;0;0;0
1588600;Sorcs: Siege Chronicles;;0 - 20,000;4;1;3;0;0;0
1588610;Beers and Boomerangs;;0 - 20,000;28;0;28;0;0;0
1588620;ORIMON.1 - Bilfy & Krotroklon;;0 - 20,000;13;2;11;0;0;0
1588650;Factory Manager Simulator;;0 - 20,000;19;33;-14;0;0;0
1588700;Race me now;;0 - 20,000;18;5;13;0;0;0
1588760;Switchball HD;;0 - 20,000;73;9;64;0;0;1
1588780;Laser Droplets;;0 - 20,000;1;0;1;0;0;0
1588870;iBLiS;;50,000 - 100,000;192;229;-37;0;0;5
1588910;Peppy's Adventure;;0 - 20,000;50;5;45;0;0;0
1588940;Storm Tale 2;;0 - 20,000;37;4;33;0;0;6
1589010;Newton's Life at Home - Pixel Art Jigsaw Puzzle;;0 - 20,000;27;4;23;0;0;0
1589040;Fruit Juice;;0 - 20,000;10;7;3;0;0;0
1589080;Grim Tales: Trace in Time Collector's Edition;;20,000 - 50,000;9;4;5;0;0;0
1589260;Happy Z-Day;;20,000 - 50,000;6;0;6;0;0;0
1589290;Kitsu's Destiny;;0 - 20,000;2;1;1;0;0;0
1589340;Solo ReflectioN!;;0 - 20,000;1;2;-1;0;0;0
1589360;StarScraper;;0 - 20,000;15;7;8;0;0;0
1589380;Horatio Goes Snowboarding;;0 - 20,000;95;20;75;0;0;0
1589410;Bunny Factory;;0 - 20,000;8;2;6;0;0;0
1589420;Memorize Cards;;0 - 20,000;1;0;1;0;0;0
1589440;Calculate It!;;0 - 20,000;4;0;4;0;0;0
1589450;Frogiee;;0 - 20,000;2;0;2;0;0;0
1589460;Little Fighters on Stream;;0 - 20,000;5;1;4;0;0;0
1589490;MeiQi 2022;;0 - 20,000;84;20;64;0;0;0
1589520;Acquiescence;;0 - 20,000;4;1;3;0;0;0
1589540;Whispers in the Dark;;0 - 20,000;15;4;11;0;0;0
1589560;Box Cat Bash;;0 - 20,000;5;0;5;0;0;0
1589580;Small Town Terrors: Galdor's Bluff Collector's Edition;;0 - 20,000;2;1;1;0;0;1
1589670;Bullfrogs;;0 - 20,000;3;0;3;0;0;0
1589680;Torii;;0 - 20,000;19;1;18;0;0;1
1589830;Lords of the Darkreign;;20,000 - 50,000;2;0;2;0;0;0
1589860;MAYBE I CAN;;20,000 - 50,000;1;0;1;0;0;0
1589880;Tower Of Wishes: Match 3 Puzzle;;0 - 20,000;5;1;4;0;0;2
1589890;便利商店‪6;;0 - 20,000;0;11;-11;0;0;0
1589920;Long Ago: A Puzzle Tale;;0 - 20,000;7;0;7;0;0;0
1590000;Tales of the Black Death;;0 - 20,000;8;3;5;0;0;0
1590010;Re-Spawn Tournament;;50,000 - 100,000;4;0;4;0;0;0
1590080;Color Souls;;0 - 20,000;29;1;28;0;0;0
1590130;Car Drive;;0 - 20,000;2;5;-3;0;0;0
1590150;Alone in the Office;;0 - 20,000;4;6;-2;0;0;0
1590160;Liberte;;0 - 20,000;75;31;44;0;0;2
1590180;Shillelagh;;200,000 - 500,000;11;5;6;0;0;0
1590190;Self-Delusion;;0 - 20,000;69;3;66;0;0;0
1590270;Partitas;;0 - 20,000;30;4;26;0;0;0
1590270;Partitas;;0 - 20,000;30;4;26;0;0;0
1590330;Lasagna Boy;;0 - 20,000;15;11;4;0;0;0
1590420;YoyoMonkeyAdventure;;0 - 20,000;1;0;1;0;0;0
1590500;Before Began 开始之前;;0 - 20,000;4;0;4;0;0;0
1590640;Savior of the Abyss;;20,000 - 50,000;162;46;116;0;0;0
1590660;Mr. Hopp's Playhouse 2;;20,000 - 50,000;447;29;418;0;0;1
1590680;PandaSG;;0 - 20,000;20;4;16;0;0;0
1590700;My Military Life;;20,000 - 50,000;83;10;73;0;0;0
1590750;JARS;;0 - 20,000;51;18;33;0;0;0
1590790;Killer Motive;;20,000 - 50,000;14;7;7;0;0;0
1590840;Depths Of Horror: Mushroom Day;;0 - 20,000;16;4;12;0;0;0
1590850;DeadOS;;0 - 20,000;65;3;62;0;0;1
1590910;Forgive Me Father;;100,000 - 200,000;2088;342;1746;178;200;22
1590920;The Wave Story;;0 - 20,000;17;2;15;0;0;0
1590920;The Wave Story;;0 - 20,000;17;2;15;0;0;0
1590970;Woebegone Woods;;20,000 - 50,000;2;0;2;0;0;0
1591130;The Station: Escape Room;;20,000 - 50,000;9;13;-4;0;0;0
1591140;Idle Roboto;;0 - 20,000;3;2;1;0;0;0
1591150;Paranormal Detective: Escape from the 90's;;0 - 20,000;40;5;35;0;0;0
1591160;SCP: Undeads Winter's;;100,000 - 200,000;3;2;1;0;0;0
1591290;Tree Simulator 2022;;20,000 - 50,000;1125;31;1094;9;9;30
1591310;World Racing '95;;20,000 - 50,000;7;4;3;0;0;0
1591310;World Racing '95;;20,000 - 50,000;7;4;3;0;0;0
1591340;Night Blade;;0 - 20,000;29;12;17;0;0;0
1591340;Night Blade;;0 - 20,000;29;12;17;0;0;0
1591350;Island World;;0 - 20,000;3;8;-5;0;0;0
1591380;Uncle Nook's Monster Emporium;;0 - 20,000;15;0;15;0;0;0
1591400;Taoyuan Adventure;;0 - 20,000;1;2;-1;0;0;0
1591420;Hmmsim Metro;;20,000 - 50,000;928;91;837;393;393;30
1591440;中外名将对决;;0 - 20,000;1;1;0;0;0;0
1591450;Aka;;0 - 20,000;197;65;132;0;0;10
1591490;Distant Memoraĵo;;0 - 20,000;121;1;120;0;0;2
1591500;猫头鹰和灯塔;;0 - 20,000;10;6;4;0;0;0
1591520;Clownfield 2042;;200,000 - 500,000;3945;652;3293;77;50;160
1591530;SAMURAI WARRIORS 5;;20,000 - 50,000;949;199;750;1270;1270;34
1591540;Hard Minus Classic Redux;;20,000 - 50,000;14;1;13;0;0;0
1591630;Bone Mayhem;;0 - 20,000;1;3;-2;0;0;0
1591650;Go home, go home?;;0 - 20,000;3;1;2;0;0;0
1591670;Mark & Lara: Partners In Justice;;0 - 20,000;48;6;42;0;0;0
1591690;DEATHRUN TV;;0 - 20,000;50;7;43;0;0;0
1591840;Avoid The Demons;;0 - 20,000;3;1;2;0;0;0
1591860;审判者;;20,000 - 50,000;117;216;-99;0;0;0
1591870;Drift Phonk 666;;0 - 20,000;0;0;0;0;0;0
1591900;My Universe - Interior Designer;;0 - 20,000;2;4;-2;0;0;0
1591910;The Hurt in Secret;;0 - 20,000;16;4;12;0;0;0
1591950;Life-Winner Cong's Double Dragon Dream;;0 - 20,000;13;0;13;0;0;0
1592020;Demonsions: Industry;;0 - 20,000;7;1;6;0;0;0
1592110;Spirit of the Island;;50,000 - 100,000;673;259;414;0;0;33
1592120;Paladin Dream;;0 - 20,000;7;2;5;0;0;1
1592190;BONELAB;;200,000 - 500,000;8054;2414;5640;344;365;239
1592230;Cards of the Dead;;0 - 20,000;48;13;35;0;0;0
1592290;PARANOIA PLACE;;0 - 20,000;52;5;47;0;0;33
1592320;Aztech Forgotten Gods;;0 - 20,000;26;10;16;0;0;0
1592340;Underland: The Climb;;20,000 - 50,000;49;2;47;0;0;1
1592360;Kitten Burst;;0 - 20,000;26;0;26;0;0;0
1592370;Cinemoji: Oscar;;0 - 20,000;13;0;13;0;0;0
1592390;Driving Simulator 2022;;0 - 20,000;8;3;5;0;0;0
1592520;WitchSpring3 Re:Fine - The Story of Eirudy -;;20,000 - 50,000;633;36;597;0;0;13
1592520;WitchSpring3 Re:Fine - The Story of Eirudy -;;20,000 - 50,000;633;36;597;0;0;13
1592530;Blub Emporium;;0 - 20,000;38;2;36;0;0;0
1592540;Loretta;;20,000 - 50,000;45;2;43;0;0;18
1592550;My Sweet Ants!;;0 - 20,000;12;5;7;0;0;0
1592600;Beasties - Monster Trainer Puzzle RPG;;0 - 20,000;0;0;0;0;0;1
1592640;Sakura Alien;;0 - 20,000;22;5;17;0;0;0
1592670;Soda Crisis;;100,000 - 200,000;2265;160;2105;361;300;5
1592740;Railroad Ink Challenge;;0 - 20,000;62;12;50;0;0;3
1592860;Keezeh The Spector of Time;;0 - 20,000;2;0;2;0;0;0
1592880;Sokocat - Islands;;0 - 20,000;26;3;23;0;0;0
1592900;PrisonShow;;0 - 20,000;0;1;-1;0;0;0
1592930;Night Wanderings;;20,000 - 50,000;10;4;6;0;0;0
1592950;Deadlokk;;0 - 20,000;1;7;-6;0;0;0
1592970;Colorado Cocoa Club;;0 - 20,000;11;6;5;0;0;0
1592980;The Guardian;;0 - 20,000;20;2;18;0;0;0
1592990;Raccoon Arrival;;0 - 20,000;9;0;9;0;0;0
1593040;Belle-de-Nuit;;0 - 20,000;20;3;17;0;0;0
1593100;Earth Marines;;0 - 20,000;15;5;10;0;0;0
1593130;Spritify;;0 - 20,000;0;1;-1;0;0;0
1593170;Veil of Dust: A Homesteading Game;;0 - 20,000;41;0;41;0;0;0
1593180;Ragnarok Chess;;0 - 20,000;17;12;5;0;0;0
1593190;Lost Islands;;0 - 20,000;2;6;-4;0;0;0
1593210;Shinobi's Way - a jigsaw chess tale;;0 - 20,000;16;0;16;0;0;0
1593220;Jessie 'Boom' James - a jigsaw chess tale;;0 - 20,000;15;1;14;0;0;0
1593260;Floating Girl;;0 - 20,000;6;10;-4;0;0;0
1593280;8089: The Next Action RPG;;20,000 - 50,000;53;9;44;0;0;0
1593350;Increlution;;50,000 - 100,000;634;87;547;513;513;1127
1593410;The Awakening of Mummies;;0 - 20,000;24;1;23;0;0;0
1593490;Rescue Operation;;0 - 20,000;195;29;166;0;0;0
1593500;God of War;;2,000,000 - 5,000,000;91656;2756;88900;1445;1188;4411
1593570;Zen Arts: Relaxing Pendulum Paint Simulator;;0 - 20,000;0;1;-1;0;0;0
1593640;Stone River;;0 - 20,000;1;7;-6;0;0;0
1593660;Crime District;;0 - 20,000;13;1;12;0;0;1
1593700;You, Calligrapher;;0 - 20,000;42;1;41;0;0;0
1593760;Chubby Bear Smash;;0 - 20,000;7;1;6;0;0;0
1593780;Organs Please;;0 - 20,000;106;6;100;164;251;4
1593790;iF Visual Novel Game Maker;;0 - 20,000;30;9;21;0;0;5
1593860;Girl Jigsaw;;0 - 20,000;204;52;152;12;12;0
1593920;Tombstone;;20,000 - 50,000;3;1;2;0;0;0
1593950;Don't Touch this Button!;;0 - 20,000;45;2;43;0;0;0
1594120;Dangerous! TOO SWEET!!;;0 - 20,000;36;4;32;0;0;1
1594130;Excidio The Kaiju Game;;0 - 20,000;34;2;32;0;0;0
1594200;Heir Obscure: A Hunt in the Dark;;0 - 20,000;5;5;0;0;0;0
1594290;Abridge;;0 - 20,000;5;0;5;0;0;0
1594300;Police Monster Drift;;0 - 20,000;0;2;-2;0;0;0
1594310;Midnight Ohota;;0 - 20,000;3;1;2;0;0;0
1594320;Captain of Industry;;100,000 - 200,000;2754;195;2559;6360;11681;1132
1594340;Last Village VIP Game;;0 - 20,000;34;10;24;0;0;0
1594370;No Hope;;20,000 - 50,000;8;1;7;0;0;0
1594400;GAI Stops Auto: Right Version Simulator;;20,000 - 50,000;251;36;215;0;0;1
1594440;Give the People What They Want;;0 - 20,000;2;1;1;0;0;0
1594460;I See Red;;50,000 - 100,000;52;4;48;0;0;0
1594490;ZeroChance;;0 - 20,000;7;4;3;0;0;0
1594560;Chrome Switcher;;0 - 20,000;2;0;2;0;0;0
1594610;Woods of Death 2;;0 - 20,000;3;0;3;0;0;0
1594810;ASMR LIGHTness - Light painting;;20,000 - 50,000;9;2;7;0;0;0
1594910;Keep Talk Until You Dead;;0 - 20,000;3;1;2;0;0;0
1594940;Little Witch in the Woods;;200,000 - 500,000;5289;460;4829;426;433;83
1594970;BARBAROS;;0 - 20,000;3;0;3;0;0;0
1594980;Elixir of Life;;0 - 20,000;3;1;2;0;0;0
1595000;Firelight Fantasy: Phoenix Crew;;20,000 - 50,000;28;13;15;0;0;0
1595020;Otteretto;;0 - 20,000;26;1;25;0;0;1
1595050;PBA Pro Bowling 2023;;0 - 20,000;21;15;6;0;0;6
1595090;Swarming Planet;;20,000 - 50,000;3;3;0;0;0;0
1595100;MY PSYCHOLOGIST | BOT-Assistant;;0 - 20,000;0;2;-2;0;0;0
1595180;Crazy Gravity;;0 - 20,000;23;1;22;0;0;0
1595230;Lottery Center Simulator;;0 - 20,000;0;1;-1;0;0;0
1595250;Dirty Blood;;0 - 20,000;5;4;1;0;0;1
1595260;Defiance & Mr. Good Looking;;0 - 20,000;5;2;3;0;0;0
1595270;NOREN;;0 - 20,000;2;7;-5;0;0;0
1595280;卡牌缔造者-CardMaker;;0 - 20,000;143;54;89;0;0;2
1595300;Kells;;0 - 20,000;3;0;3;0;0;0
1595340;Sweet Home Puzzle;;0 - 20,000;3;0;3;0;0;0
1595410;NUC: After The Blast;;100,000 - 200,000;13;5;8;0;0;0
1595460;Haywire;;0 - 20,000;5;0;5;0;0;0
1595510;Smasher and the Will o' the Thiccs;;0 - 20,000;66;2;64;0;0;0
1595600;Last Generation: Survival;;0 - 20,000;8;5;3;0;0;0
1595620;Pair of Aces;;0 - 20,000;3;0;3;0;0;0
1595630;Underwater Life;;0 - 20,000;12;8;4;0;0;0
1595640;Tres-Bashers;;0 - 20,000;117;2;115;0;0;1
1595710;Chased by Darkness;;20,000 - 50,000;218;86;132;0;0;5
1595760;ScreenSpace;;0 - 20,000;1;0;1;0;0;0
1595770;SUFFER 2;;0 - 20,000;5;0;5;0;0;0
1595790;Astral Cube;;0 - 20,000;1;0;1;0;0;0
1595930;The Far Kingdoms: Hidden Magic;;20,000 - 50,000;4;3;1;0;0;0
1595950;A Strange Hotel;;0 - 20,000;6;2;4;0;0;0
1596010;Martin and the Magic Staff;;0 - 20,000;7;2;5;0;0;0
1596030;JETMAN;;0 - 20,000;10;0;10;0;0;0
1596060;Infinity ZigZag;;0 - 20,000;1;1;0;0;0;0
1596070;Angry Squirrel;;0 - 20,000;74;24;50;0;0;0
1596170;One True Hero;;0 - 20,000;18;3;15;0;0;1
1596240;Overlay Balls & Mouse Tails;;0 - 20,000;8;1;7;0;0;0
1596250;Fish. Love. Danger.;;0 - 20,000;7;3;4;0;0;0
1596270;Neon Souls;;0 - 20,000;25;0;25;0;0;0
1596290;JumpCubox;;0 - 20,000;1;0;1;0;0;0
1596310;Crypto Mining Simulator;;100,000 - 200,000;886;363;523;154;210;7
1596330;XOMBEE;;0 - 20,000;6;2;4;0;0;0
1596360;Unnatural Investigations;;0 - 20,000;1;3;-2;0;0;0
1596370;Beat Souls;;20,000 - 50,000;57;14;43;0;0;0
1596430;Loop Knight;;0 - 20,000;0;1;-1;0;0;0
1596440;ARKOS;;0 - 20,000;100;15;85;0;0;0
1596540;TAISHO x ALICE epilogue;;20,000 - 50,000;283;8;275;0;0;2
1596580;SPYCITY;;0 - 20,000;23;3;20;0;0;0
1596610;Dead Night;;0 - 20,000;21;3;18;0;0;0
1596640;Dark Chronicles: The Soul Reaver;;0 - 20,000;30;8;22;0;0;1
1596690;OUTLIER;;0 - 20,000;45;29;16;18;18;0
1596750;Buddy and Lucky Solitaire;;0 - 20,000;82;18;64;0;0;2
1596810;ArtPuzzle VR;;0 - 20,000;2;0;2;0;0;1
1596820;Monstrous Lovers;;0 - 20,000;3;2;1;0;0;0
1596940;Ryan's Rescue Squad;;0 - 20,000;4;3;1;0;0;1
1596990;Asteroid Blasters;;0 - 20,000;1;1;0;0;0;0
1597040;Fossilfuel;;0 - 20,000;64;23;41;0;0;0
1597060;Bubbaruka!;;100,000 - 200,000;41;4;37;0;0;0
1597070;Criminal T;;0 - 20,000;0;2;-2;0;0;0
1597090;Ressifice;;0 - 20,000;14;9;5;0;0;0
1597160;SpiderPunks;;20,000 - 50,000;0;1;-1;0;0;0
1597170;Endless Furry Killer Infinity;;0 - 20,000;15;3;12;0;0;0
1597200;ConnecTank;;0 - 20,000;23;3;20;0;0;2
1597210;Fantasy Dungeon VR;;0 - 20,000;1;2;-1;0;0;0
1597260;BLIND;;0 - 20,000;5;11;-6;0;0;0
1597270;Crime Reaper;;0 - 20,000;34;3;31;0;0;0
1597280;Live Empire 2;;0 - 20,000;85;67;18;9;9;1
1597290;Swarm the City: Zombie Evolved;;0 - 20,000;133;41;92;10;10;2
1597350;Godlike;;0 - 20,000;2;3;-1;0;0;0
1597400;LOST EGG 2: Be together;;0 - 20,000;166;26;140;88;88;3
1597440;Wax Museum - Seek and Find - Mystery Hidden Object Adventure;;0 - 20,000;19;7;12;0;0;2
1597470;31st prototype;;50,000 - 100,000;10;0;10;0;0;0
1597520;Rounded;;20,000 - 50,000;59;4;55;0;0;0
1597550;Highrise Mogul;;0 - 20,000;27;24;3;0;0;0
1597580;Clid The Snail;;0 - 20,000;78;22;56;0;0;0
1597650;Larger Than Light;;20,000 - 50,000;4;0;4;0;0;0
1597670;Astralis;;50,000 - 100,000;2;0;2;0;0;0
1597730;Dogs Organized Neatly;;0 - 20,000;707;9;698;45;45;5
1597750;Phobyark;;0 - 20,000;1;0;1;0;0;0
1597780;新城镇;;0 - 20,000;10;1;9;0;0;0
1597820;Pazing By;;0 - 20,000;8;0;8;0;0;0
1597900;Let's Learn Janggi (Korean Chess);;0 - 20,000;5;1;4;0;0;0
1597970;Escape Room VR: Vaudeville;;0 - 20,000;5;0;5;0;0;0
1598020;Warspace;;100,000 - 200,000;1;5;-4;0;0;0
1598030;ZONERS;;0 - 20,000;5;0;5;0;0;0
1598160;Bloodwash;;0 - 20,000;806;74;732;0;0;7
1598180;Seishin Destiny;;0 - 20,000;9;0;9;0;0;0
1598190;We Are Live;;0 - 20,000;8;0;8;0;0;0
1598210;Milli & Greg;;0 - 20,000;47;2;45;0;0;0
1598220;Moon Observatory Iris;;0 - 20,000;15;1;14;0;0;0
1598470;PixelGround;;0 - 20,000;15;6;9;0;0;0
1598490;EyeRoll;;0 - 20,000;1;0;1;0;0;0
1598540;Nilspace;;0 - 20,000;6;0;6;0;0;0
1598590;此刻探索中;;0 - 20,000;3;2;1;0;0;0
1598600;Robin Hood: Hail to the King;;0 - 20,000;13;2;11;0;0;3
1598710;Wild world;;0 - 20,000;6;7;-1;0;0;0
1598730;Shanhe;;50,000 - 100,000;412;119;293;497;497;9
1598750;魔法与高塔;;20,000 - 50,000;17;0;17;0;0;0
1598810;Life of Fly 2;;0 - 20,000;25;2;23;0;0;0
1598840;Northern Blades;;0 - 20,000;6;0;6;0;0;0
1598920;Farmer Life Simulator;;0 - 20,000;88;103;-15;0;0;2
1598930;见习侦探;;0 - 20,000;66;20;46;0;0;0
1598970;Magnus Failure;;0 - 20,000;16;3;13;0;0;0
1599000;ARK-ADE;;0 - 20,000;66;1;65;0;0;0
1599020;Tinykin;;20,000 - 50,000;1024;13;1011;704;704;14
1599110;The Great Pickle Adventure;;0 - 20,000;3;0;3;0;0;0
1599130;#tacticalunderground arcade;;0 - 20,000;10;1;9;0;0;0
1599150;Warlike;;20,000 - 50,000;20;7;13;0;0;1
1599210;Line of War;;0 - 20,000;22;7;15;0;0;0
1599220;League Space;;50,000 - 100,000;0;1;-1;0;0;0
1599230;Puppy Adventure;;0 - 20,000;11;8;3;0;0;0
1599250;BORIS RUSSIAN BEAR;;0 - 20,000;295;46;249;0;0;0
1599270;Crazy Race;;0 - 20,000;13;5;8;0;0;0
1599280;Crystal Rider;;0 - 20,000;0;9;-9;0;0;0
1599300;DressMaker Pro;;0 - 20,000;7;1;6;0;0;0
1599340;Lost Ark;;20,000,000 - 50,000,000;136238;53281;82957;3495;711;195413
1599390;Word Hunt Fever;;0 - 20,000;11;1;10;0;0;0
1599430;Drunken Samurai;;0 - 20,000;1;7;-6;0;0;0
1599470;Purrfect Apawcalypse: Patches' Infurno;;0 - 20,000;139;1;138;0;0;1
1599510;Deadly Threat;;0 - 20,000;15;17;-2;0;0;1
1599520;Sacred Cubes 2;;0 - 20,000;9;3;6;0;0;0
1599530;Little adventure;;0 - 20,000;22;14;8;0;0;0
1599560;Wanderer;;20,000 - 50,000;561;95;466;53;53;8
1599590;Traveler;;0 - 20,000;7;0;7;0;0;0
1599600;PlateUp!;;500,000 - 1,000,000;10366;398;9968;1214;900;3544
1599630;Planet Miner;;0 - 20,000;47;10;37;0;0;0
1599660;Sackboy: A Big Adventure;;20,000 - 50,000;1166;153;1013;473;473;124
1599670;Offroad Truck Racing;;;;;0;;;
1599680;Street Racing: United;;;;;0;;;
1599690;WORDLAND;;0 - 20,000;31;1;30;0;0;1
1599700;Magic Exposure – Yuri Visual Novel;;0 - 20,000;3;0;3;0;0;0
1599860;Vanaris Tactics;;20,000 - 50,000;82;27;55;0;0;0
1599880;Cats in Time;;20,000 - 50,000;693;20;673;297;297;8
1599910;Space Worthy;;0 - 20,000;3;1;2;0;0;0
1599930;Endless Thief: a Fluffy Stealth Adventure;;0 - 20,000;4;0;4;0;0;0
1600030;Ghost of the Seas;;0 - 20,000;0;2;-2;0;0;0
1600070;Keyboard Master;;0 - 20,000;3;0;3;0;0;0
1600170;Solitaire Legend of the Pirates 3;;0 - 20,000;1;0;1;0;0;1
1600180;Solitaire Game Halloween 2;;0 - 20,000;2;1;1;0;0;0
1600190;Solitaire Victorian Picnic 2;;0 - 20,000;2;0;2;0;0;1
1600200;Solitaire Jack Frost Winter Adventures 2;;0 - 20,000;3;0;3;0;0;0
1600210;Halloween Night Mahjong 2;;0 - 20,000;3;0;3;0;0;0
1600220;Lost Sunday Comics;;0 - 20,000;21;0;21;0;0;0
1600230;Mahjong Carnaval 2;;0 - 20,000;2;1;1;0;0;1
1600240;Spooky Mahjong;;0 - 20,000;3;0;3;0;0;0
1600250;Jurassic mahjong;;0 - 20,000;4;2;2;0;0;0
1600280;Cute Animals Memory Card Game;;0 - 20,000;5;4;1;0;0;0
1600300;Cube Flip;;20,000 - 50,000;8;1;7;0;0;0
1600330;Hero Sword;;20,000 - 50,000;4;7;-3;0;0;0
1600350;Retro Clicker;;0 - 20,000;6;8;-2;0;0;0
1600370;Not Tonight 2;;0 - 20,000;195;31;164;0;0;2
1600440;Keep looking;;0 - 20,000;0;2;-2;0;0;0
1600450;Pride and Prejudice: Blood Ties;;0 - 20,000;6;5;1;0;0;2
1600460;Camelot: Wrath of the Green Knight;;0 - 20,000;2;1;1;0;0;0
1600500;유어 블라이트;;0 - 20,000;168;2;166;0;0;25
1600550;Imaginaria;;0 - 20,000;11;0;11;0;0;1
1600570;Parallelia;;0 - 20,000;1;3;-2;0;0;0
1600600;ZAR;;20,000 - 50,000;13;8;5;0;0;0
1600620;MINICHEF;;0 - 20,000;4;0;4;0;0;1
1600670;DawnWander;;0 - 20,000;6;8;-2;0;0;0
1600690;Keep It Live;;0 - 20,000;4;0;4;0;0;0
1600700;Cosmophage;;0 - 20,000;4;0;4;0;0;0
1600720;A Curse From Beyond;;0 - 20,000;28;2;26;0;0;0
1600780;MY LITTLE PONY: A Maretime Bay Adventure;;0 - 20,000;302;72;230;0;0;5
1600810;Pixel Speedrun;;0 - 20,000;12;1;11;0;0;0
1600820;Pill Puzzle;;0 - 20,000;27;4;23;0;0;0
1600840;Was It Worth It?;;20,000 - 50,000;26;1;25;0;0;1
1600880;Madness Beverage;;0 - 20,000;7;5;2;0;0;1
1600890;恶灵退散 Go Back to Hell;;50,000 - 100,000;38;4;34;0;0;0
1600900;怕不怕趴喵霸霸 Ghost Party Nyanbaba;;0 - 20,000;223;3;220;0;0;0
1600930;Foul Play - Yuri Visual Novel;;0 - 20,000;27;1;26;0;0;0
1600950;PROPHUNT;;0 - 20,000;16;9;7;0;0;0
1600960;Seafarers;;0 - 20,000;1;1;0;0;0;0
1600980;MONSTER SLAYER;;0 - 20,000;4;0;4;0;0;0
1601040;Leaf on Wind;;0 - 20,000;13;3;10;0;0;0
1601080;King of Heroes;;0 - 20,000;4;1;3;0;0;0
1601190;Ultimate Demolition;;0 - 20,000;2;1;1;0;0;0
1601220;Smoots Summer Games;;0 - 20,000;1;5;-4;0;0;0
1601260;Project Scav;;0 - 20,000;0;1;-1;0;0;0
1601360;Smoots Golf;;0 - 20,000;5;2;3;0;0;0
1601380;The Marauder Chronicles: Curse Over Valdria;;0 - 20,000;6;2;4;0;0;0
1601410;Far Away Train;;0 - 20,000;14;7;7;0;0;0
1601680;The Advisor - Episode 1: Royal Pain;;20,000 - 50,000;500;7;493;0;0;0
1601740;Corpse Keeper;;0 - 20,000;407;127;280;0;0;774
1601750;Pack of Demons;;0 - 20,000;1;0;1;0;0;0
1601790;Mini Island: Summer;;0 - 20,000;4;1;3;0;0;0
1601860;Warp Factory;;0 - 20,000;39;2;37;0;0;1
1601900;Slordax: The Unknown Enemy;;0 - 20,000;2;0;2;0;0;0
1601970;Tunguska: The Visitation;;50,000 - 100,000;219;42;177;0;0;15
1601990;Opa Definitive Edition;;0 - 20,000;2;0;2;0;0;0
1602010;Persona 4 Arena Ultimax;;50,000 - 100,000;2215;428;1787;1369;1282;93
1602080;Soulstice;;50,000 - 100,000;729;194;535;15;15;20
1602110;Kredolis;;0 - 20,000;25;21;4;0;0;3
1602150;Bus stop in the fog;;0 - 20,000;2;3;-1;0;0;0
1602170;Need For Conquest;;0 - 20,000;3;0;3;0;0;0
1602190;Alma;;0 - 20,000;1;0;1;0;0;0
1602200;Nature Park;;0 - 20,000;5;16;-11;0;0;0
1602330;clown town 1443;;0 - 20,000;23;1;22;0;0;0
1602350;MENOS: PSI-SHATTER;;20,000 - 50,000;24;1;23;0;0;0
1602380;Ambush;;0 - 20,000;21;1;20;0;0;0
1602420;When I reincarnate, I'm a cube!?;;0 - 20,000;0;5;-5;0;0;0
1602440;Pasta Master;;0 - 20,000;10;0;10;0;0;0
1602460;Mazeing;;0 - 20,000;1;0;1;0;0;0
1602490;Waifus Smash;;0 - 20,000;124;41;83;37;47;2
1602590;Kaiju Crush;;0 - 20,000;1;2;-1;0;0;0
1602600;UNIVERSE PRISON;;0 - 20,000;1;1;0;0;0;0
1602810;Metaverse: Origins;;0 - 20,000;2;0;2;0;0;0
1602880;The Lord of the Parties;;0 - 20,000;36;9;27;0;0;3
1602930;Pedro's Adventures in Spanish [Learn Spanish];;20,000 - 50,000;72;7;65;0;0;1
1602970;Gedel Escape;;0 - 20,000;1;0;1;0;0;0
1602980;Insight;;0 - 20,000;49;9;40;0;0;0
1602990;POG;;0 - 20,000;19;7;12;0;0;0
1603020;Overcoming Obstacles;;0 - 20,000;11;6;5;0;0;0
1603260;Re.Surs;;0 - 20,000;30;4;26;0;0;0
1603270;Monster Battle Quest;;0 - 20,000;5;1;4;0;0;0
1603280;Chasing the wind;;0 - 20,000;3;4;-1;0;0;0
1603290;Project Hacker;;0 - 20,000;2;1;1;0;0;0
1603300;Timothy Leary's Mind Mirror;;0 - 20,000;1;0;1;0;0;0
1603360;SHADOW STEP;;0 - 20,000;1;3;-2;0;0;0
1603410;Lost Nova;;20,000 - 50,000;243;11;232;0;0;3
1603460;Chromatic Labyrinth;;0 - 20,000;2;0;2;0;0;0
1603480;Avarice;;0 - 20,000;3;0;3;0;0;0
1603500;The Elevator Game with Catgirls;;0 - 20,000;41;0;41;0;0;1
1603600;Daldos;;0 - 20,000;3;1;2;0;0;0
1603640;The House of Da Vinci 3;;0 - 20,000;283;22;261;0;0;55
1603720;Thy Creature;;0 - 20,000;102;16;86;0;0;0
1603780;Pincushion;;0 - 20,000;0;3;-3;0;0;0
1603860;The Frosts: First Ones;;0 - 20,000;55;6;49;0;0;0
1603860;The Frosts: First Ones;;0 - 20,000;55;6;49;0;0;0
1603920;暴れん坊天狗 & ZOMBIE NATION;;0 - 20,000;11;3;8;0;0;0
1603930;The Hell Hives;;0 - 20,000;1;4;-3;0;0;0
1603940;Nuclear War Simulator;;0 - 20,000;46;28;18;0;0;18
1603960;Mini Madness;;0 - 20,000;9;3;6;0;0;0
1603970;Panmorphia: Awakened;;0 - 20,000;5;0;5;0;0;0
1604000;Milk outside a bag of milk outside a bag of milk;;200,000 - 500,000;9345;241;9104;185;224;103
1604020;Many Bricks Breaker;;0 - 20,000;62;23;39;42;42;2
1604030;V Rising;;2,000,000 - 5,000,000;52983;6827;46156;1887;1298;3534
1604060;Cricket Captain 2021;;0 - 20,000;47;18;29;0;0;23
1604100;Revolver and Co;;0 - 20,000;6;0;6;0;0;0
1604110;Pippu - Bauble Quest;;0 - 20,000;4;0;4;0;0;0
1604160;Jivitam;;0 - 20,000;4;2;2;0;0;0
1604180;Laika;;20,000 - 50,000;13;0;13;0;0;0
1604210;Grid Slayer;;0 - 20,000;21;4;17;0;0;0
1604240;Sumotori Dreams Classic;;0 - 20,000;131;5;126;128;128;2
1604280;STHELL;;0 - 20,000;26;6;20;0;0;0
1604300;LOVE 3;;0 - 20,000;81;3;78;0;0;2
1604320;Daffy Fish;;0 - 20,000;2;0;2;0;0;0
1604370;Garden Magic;;0 - 20,000;0;1;-1;0;0;0
1604380;Hamidashi Creative;;0 - 20,000;405;10;395;2181;2181;24
1604390;PROVIDER;;0 - 20,000;1;2;-1;0;0;0
1604450;AI Battle Royale Generator;;0 - 20,000;9;0;9;0;0;0
1604540;TURK: The Demon Slayer;;0 - 20,000;22;5;17;0;0;0
1604600;DROPSHIP;;20,000 - 50,000;5;0;5;0;0;0
1604700;Small Press Tycoon;;0 - 20,000;6;0;6;0;0;0
1604710;Random Blacksmith Game;;0 - 20,000;0;1;-1;0;0;1
1604780;Lovely Planet Remix;;0 - 20,000;32;1;31;0;0;1
1604790;After School;;0 - 20,000;1;1;0;0;0;0
1604840;Super Fowlst 2;;0 - 20,000;7;1;6;0;0;0
1605010;Adorable Witch;;50,000 - 100,000;1337;141;1196;43;58;7
1605050;Crossy Bridge;;0 - 20,000;3;3;0;0;0;0
1605120;Kate Kite;;0 - 20,000;1;0;1;0;0;0
1605190;Connect The Dots;;0 - 20,000;8;1;7;0;0;0
1605220;Dune: Spice Wars;;500,000 - 1,000,000;5737;1267;4470;505;877;343
1605280;HuoChaiRenRPG;;0 - 20,000;3;6;-3;0;0;0
1605300;Hack Bomb BOMA-YE;;0 - 20,000;1;0;1;0;0;0
1605310;Heltons Haunted Hotel;;0 - 20,000;1;2;-1;0;0;0
1605320;Unusual Findings;;20,000 - 50,000;236;21;215;0;0;4
1605340;Atlantis Adventure VR;;0 - 20,000;1;4;-3;0;0;0
1605440;Ragdoll Madness;;0 - 20,000;25;6;19;0;0;0
1605480;Albacete Warrior;;0 - 20,000;18;3;15;0;0;0
1605590;Fimbul Winter;;0 - 20,000;3;13;-10;0;0;0
1605600;Final Stand: Ragnarök;;0 - 20,000;4;4;0;0;0;0
1605640;Empower;;20,000 - 50,000;2;1;1;0;0;0
1605640;Empower;;20,000 - 50,000;2;1;1;0;0;0
1605720;Eternia: Pet Whisperer;;0 - 20,000;13;0;13;0;0;0
1605760;Mystery Trackers: Forgotten Voices Collector's Edition;;20,000 - 50,000;5;6;-1;0;0;0
1605910;宇宙终极秘密-灵魂The ultimate secret of the universe：Soul;;0 - 20,000;0;1;-1;0;0;0
1605910;宇宙终极秘密-灵魂The ultimate secret of the universe：Soul;;0 - 20,000;0;1;-1;0;0;0
1605930;Babol the Walking Box;;0 - 20,000;10;7;3;0;0;0
1605950;SpaceShips;;20,000 - 50,000;1;2;-1;0;0;0
1606030;The Tower of Wowers;;20,000 - 50,000;20;0;20;0;0;0
1606210;Heck Deck;;0 - 20,000;38;3;35;0;0;0
1606300;Puzzle Light;;0 - 20,000;38;2;36;0;0;0
1606340;Conquest of Elysium 5;;50,000 - 100,000;594;70;524;3071;3071;68
1606450;BunnyShot;;0 - 20,000;1;0;1;0;0;0
1606490;Alive Cursor;;0 - 20,000;4;5;-1;0;0;0
1606500;Miracle field;;0 - 20,000;1;3;-2;0;0;0
1606510;Steel Rain - Dawn of the Machines;;0 - 20,000;0;2;-2;0;0;0
1606520;暴打萌鼠;;0 - 20,000;7;0;7;0;0;0
1606590;The Killer of Dishonor;;0 - 20,000;16;7;9;0;0;0
1606610;Rescuer;;0 - 20,000;2;3;-1;0;0;0
1606620;Train Tycoon;;0 - 20,000;0;4;-4;0;0;0
1606640;GrandMa Badass - a crazy point and click adventure;;20,000 - 50,000;43;0;43;0;0;1
1606670;Zen Cube;;0 - 20,000;2;3;-1;0;0;0
1606730;Coin Dash;;0 - 20,000;2;2;0;0;0;0
1606760;Unlock the Block;;0 - 20,000;16;7;9;0;0;0
1606770;Somniphobia;;20,000 - 50,000;9;3;6;0;0;1
1606790;Instrumentalist;;0 - 20,000;1;1;0;0;0;0
1606800;FTD2;;0 - 20,000;7;0;7;0;0;0
1606890;Gun'eM;;0 - 20,000;2;0;2;0;0;0
1606890;Gun'eM;;0 - 20,000;2;0;2;0;0;0
1606910;Jigsaw Puzzle VR;;0 - 20,000;0;1;-1;0;0;0
1606920;Undergrowth: VR Maze;;0 - 20,000;2;2;0;0;0;0
1606940;The Mystery of Caketropolis;;50,000 - 100,000;74;1;73;0;0;0
1606950;Squeaky Clean;;0 - 20,000;21;9;12;0;0;0
1606950;Squeaky Clean;;0 - 20,000;21;9;12;0;0;0
1606980;Ouroboros Dungeon;;50,000 - 100,000;8;4;4;0;0;0
1607000;Half Wing;;0 - 20,000;1;1;0;0;0;0
1607040;Evertried;;0 - 20,000;46;10;36;0;0;1
1607040;Evertried;;0 - 20,000;46;10;36;0;0;1
1607140;Valley General Hospital: NiVR;;0 - 20,000;1;0;1;0;0;0
1607170;Magical Girl Noble Rose;;0 - 20,000;21;6;15;0;0;0
1607180;Big Quest 2: the Adventure;;0 - 20,000;1;2;-1;0;0;0
1607200;Cyanotype Daydream -The Girl Who Dreamed the World-;;0 - 20,000;307;50;257;0;0;8
1607280;YUME 2 : Sleepless Night;;50,000 - 100,000;613;616;-3;39;41;2
1607310;汽车帝国;;0 - 20,000;46;41;5;0;0;2
1607310;汽车帝国;;0 - 20,000;46;41;5;0;0;2
1607340;Game Design Studio：游戏设计工具箱;;0 - 20,000;11;0;11;0;0;0
1607370;Afterlife Beans;;0 - 20,000;9;1;8;0;0;0
1607400;Occupation 2.5;;0 - 20,000;15;5;10;0;0;0
1607430;Memories of East Coast;;0 - 20,000;13;1;12;0;0;0
1607450;Uniboom-War of Unicorns;;0 - 20,000;4;0;4;0;0;0
1607470;Escape;;0 - 20,000;2;4;-2;0;0;0
1607480;最后一搏 The last fight;;0 - 20,000;5;7;-2;0;0;0
1607500;Schmutznik;;0 - 20,000;6;0;6;0;0;0
1607530;Treasures of the Aegean;;0 - 20,000;63;3;60;0;0;1
1607570;Cute Girls Love Books;;0 - 20,000;2;3;-1;0;0;0
1607640;Arcade Drift;;0 - 20,000;7;1;6;0;0;0
1607670;Secret Agent HD;;0 - 20,000;110;1;109;0;0;4
1607720;Rimebeard;;0 - 20,000;7;1;6;0;0;0
1607740;Mecha Tactics;;20,000 - 50,000;2;0;2;0;0;0
1607740;Mecha Tactics;;20,000 - 50,000;2;0;2;0;0;0
1607770;Endless Zombie Tower;;0 - 20,000;4;0;4;0;0;0
1607780;Gun on the Chickahominy;;0 - 20,000;3;0;3;0;0;0
1607820;Ele-Mental;;20,000 - 50,000;2;0;2;0;0;0
1607850;Planets Battle;;0 - 20,000;3;11;-8;0;0;0
1607860;Water Drift;;0 - 20,000;3;10;-7;0;0;0
1607870;Cub Gym;;0 - 20,000;1;0;1;0;0;0
1607970;梦落凡尘;;20,000 - 50,000;5;1;4;0;0;0
1608010;Unchosen: Forsaken;;50,000 - 100,000;1;2;-1;0;0;0
1608040;Castle Morihisa;;0 - 20,000;259;106;153;0;0;1
1608040;Castle Morihisa;;0 - 20,000;259;106;153;0;0;1
1608070;CRISIS CORE –FINAL FANTASY VII– REUNION;;100,000 - 200,000;3227;314;2913;481;772;250
1608090;Attack of the Giant Crab;;0 - 20,000;29;5;24;0;0;0
1608180;Infested: Space Colony;;0 - 20,000;3;1;2;0;0;0
1608200;The Far Kingdoms: Forgotten Relics;;0 - 20,000;9;3;6;0;0;1
1608220;Sentry:Obelisk Of Dawn;;0 - 20,000;8;0;8;0;0;0
1608250;Soralio: Cooperation mystery solving game;;0 - 20,000;2;1;1;0;0;0
1608270;FILMECHANISM;;0 - 20,000;24;0;24;0;0;1
1608290;GNOSIA;;50,000 - 100,000;1692;98;1594;1594;1594;89
1608400;Vermillion - VR Painting;;0 - 20,000;458;21;437;129;149;6
1608450;Hellslave;;0 - 20,000;398;100;298;0;0;1
1608460;青之镇物语;;0 - 20,000;4;1;3;0;0;0
1608470;Warstride Challenges;;50,000 - 100,000;150;11;139;222;222;0
1608550;Firegirl: Hack 'n Splash Rescue DX;;0 - 20,000;98;30;68;0;0;1
1608560;AI Drone Simulator;;0 - 20,000;161;19;142;0;0;6
1608660;Overhaul;;0 - 20,000;64;6;58;0;0;1
1608680;Midnight Driver;;0 - 20,000;91;39;52;0;0;2
1608700;Soundfall;;0 - 20,000;674;185;489;177;276;9
1608710;Gridform;;0 - 20,000;8;0;8;0;0;0
1608740;Darkness Arrives;;20,000 - 50,000;1;3;-2;0;0;0
1608780;Everpixel Tactics;;0 - 20,000;4;0;4;0;0;0
1608780;Everpixel Tactics;;0 - 20,000;4;0;4;0;0;0
1608820;OGgolf;;0 - 20,000;2;0;2;0;0;0
1608860;XANDO: Xtreme & Over the Top;;0 - 20,000;1;1;0;0;0;1
1608890;VR Europe Tour;;0 - 20,000;10;0;10;0;0;0
1608940;Beat Boy;;0 - 20,000;4;0;4;0;0;0
1609030;Immortus Temporus;;0 - 20,000;5;0;5;0;0;0
1609070;Calluna;;0 - 20,000;3;0;3;0;0;0
1609080;Summer of '58;;100,000 - 200,000;2726;272;2454;72;105;29
1609090;Drunken Dad Simulator;;0 - 20,000;65;6;59;0;0;0
1609170;Gunmancer;;0 - 20,000;5;0;5;0;0;0
1609220;Cthulhu pub;;0 - 20,000;17;1;16;0;0;2
1609230;Scarlet Hollow;;20,000 - 50,000;1061;10;1051;0;0;32
1609300;ENEMIES;;0 - 20,000;11;2;9;0;0;0
1609310;Now Testing: 407;;0 - 20,000;12;10;2;0;0;0
1609440;Cemetery Warrior V;;50,000 - 100,000;14;7;7;0;0;0
1609470;The Frog Game;;0 - 20,000;6;4;2;0;0;1
1609570;Agonize;;0 - 20,000;83;49;34;0;0;1
1609580;Fragments Of A Mind;;0 - 20,000;7;1;6;0;0;0
1609600;Bunny's Buddy;;0 - 20,000;2;0;2;0;0;0
1609660;Altruism;;0 - 20,000;1;0;1;0;0;0
1609690;the secret of dyes;;0 - 20,000;2;0;2;0;0;0
1609710;vreezy: Girl's Pictorial Story Vol.1;;0 - 20,000;0;1;-1;0;0;0
1609720;Asterism Basketball;;0 - 20,000;1;0;1;0;0;0
1609730;Aliens vs. Ghosts;;50,000 - 100,000;169;19;150;0;0;4
1609780;Invader TD;;0 - 20,000;25;2;23;0;0;0
1609800;Akinofa;;0 - 20,000;2;0;2;0;0;0
1609860;Dungeonite;;0 - 20,000;1;0;1;0;0;0
1609870;Pro Basketball Manager 2022;;0 - 20,000;87;36;51;0;0;6
1610020;KING HAJWALA;;0 - 20,000;7;6;1;0;0;0
1610060;Echoes;;0 - 20,000;30;7;23;0;0;0
1610120;MY FOX - Desktop Wild Pet;;0 - 20,000;31;11;20;0;0;0
1610130;Zombie Freaks;;0 - 20,000;9;5;4;0;0;0
1610140;Skeleton Wave;;0 - 20,000;7;4;3;0;0;0
1610310;Battle Snakes;;0 - 20,000;1;0;1;0;0;0
1610330;Realm of Night: The Forbidden Knowledge;;0 - 20,000;33;6;27;0;0;0
1610370;Horror Royale;;20,000 - 50,000;39;17;22;0;0;0
1610460;Monster Energy Supercross - The Official Videogame 5;;0 - 20,000;231;130;101;357;357;75
1610470;MXGP 2021 - The Official Motocross Videogame;;0 - 20,000;278;68;210;0;0;29
1610500;Bibots;;0 - 20,000;31;22;9;0;0;0
1610530;The Annoying Game;;0 - 20,000;3;0;3;0;0;0
1610560;Cyber Hunter: Awakening;;0 - 20,000;8;6;2;0;0;0
1610610;糊剧101;;0 - 20,000;18;16;2;0;0;1
1610630;BURGER MAN;;0 - 20,000;18;13;5;0;0;0
1610650;●LIVE IN DUNGEON;;0 - 20,000;34;6;28;0;0;0
1610660;Throw Knives;;0 - 20,000;15;6;9;0;0;0
1610670;Detective VR: NFT secret Files;;0 - 20,000;7;9;-2;0;0;0
1610700;Clutter 1000;;0 - 20,000;9;0;9;0;0;2
1610730;Fallen from the sky;;0 - 20,000;5;9;-4;0;0;0
1610790;Cossack and Magic;;50,000 - 100,000;14;0;14;0;0;2
1610840;Virtuous Western;;0 - 20,000;40;3;37;0;0;0
1610860;Merek's Market;;0 - 20,000;17;1;16;0;0;0
1610890;Boney's Research On Humans!;;0 - 20,000;14;1;13;0;0;0
1610960;Wizard's Duty;;0 - 20,000;1;3;-2;0;0;0
1610990;Distortion VR;;0 - 20,000;3;7;-4;0;0;0
1611060;LA FORET DE PAGO 2 : SOUVENIR DE GLACE;;20,000 - 50,000;22;1;21;0;0;0
1611110;AMID THE LINES;;20,000 - 50,000;5;3;2;0;0;0
1611130;Playback Trauma: The Beach;;0 - 20,000;11;4;7;0;0;0
1611140;The Dawning;;0 - 20,000;2;1;1;0;0;0
1611270;Vitality Girl;;0 - 20,000;14;2;12;0;0;0
1611280;G-MODEアーカイブス09 フライハイトクラウディア2;;0 - 20,000;2;0;2;0;0;0
1611300;Happy Guy;;20,000 - 50,000;452;117;335;147;163;1
1611320;Path to Heaven;;0 - 20,000;1;0;1;0;0;0
1611350;晴天咖啡館 Sunny Cafe;;0 - 20,000;48;2;46;0;0;0
1611410;Stardom 3;;20,000 - 50,000;962;69;893;163;163;117
1611420;Sea Horizon;;0 - 20,000;102;20;82;0;0;1
1611430;The Bridge Curse Road to Salvation;;100,000 - 200,000;1445;161;1284;216;254;59
1611460;Hide and Run;;0 - 20,000;183;70;113;156;156;0
1611490;[Chilla's Art] Night Delivery | 例外配達;;50,000 - 100,000;674;159;515;0;0;4
1611540;Magic Frame;;0 - 20,000;11;5;6;0;0;0
1611580;Behind Glass: Aquarium Simulator;;0 - 20,000;159;7;152;47;47;6
1611600;WARNO;;100,000 - 200,000;3794;919;2875;970;509;923
1611640;Toverblade;;0 - 20,000;10;1;9;0;0;0
1611650;Acheron's Souls;;0 - 20,000;6;0;6;0;0;0
1611760;A Sketchbook About Her Sun;;0 - 20,000;12;2;10;0;0;0
1611800;Curving Over It with Evgeny Podoynikov;;0 - 20,000;8;0;8;0;0;0
1611830;TeamTower;;20,000 - 50,000;47;14;33;0;0;0
1611850;The Marionette 提线木偶;;0 - 20,000;12;1;11;0;0;1
1611870;Loot City;;0 - 20,000;4;1;3;0;0;0
1611880;Degenerate Souls;;0 - 20,000;3;8;-5;0;0;0
1611890;Retrowave Road;;0 - 20,000;6;2;4;0;0;0
1611900;Wandering Trails: A Hiking Game;;0 - 20,000;6;5;1;0;0;1
1611910;Warhammer 40,000: Chaos Gate - Daemonhunters;;200,000 - 500,000;6564;1740;4824;1067;952;595
1611930;Henry's Day;;0 - 20,000;8;0;8;0;0;0
1612030;Planet Surf: The Last Wave;;20,000 - 50,000;20;2;18;0;0;0
1612100;Big Earth;;0 - 20,000;30;1;29;0;0;0
1612110;Magic LightHouse;;0 - 20,000;15;4;11;0;0;0
1612140;Мухосранск | Russian City Sim;;0 - 20,000;102;36;66;0;0;0
1612150;Forgotten Forest: Eye of the Great One;;20,000 - 50,000;1;1;0;0;0;0
1612180;Slime's Revenge;;0 - 20,000;3;1;2;0;0;0
1612200;Blokker: Orange;;0 - 20,000;29;0;29;0;0;1
1612270;Soul Survivor;;0 - 20,000;3;1;2;0;0;0
1612350;Robbed Money;;0 - 20,000;5;2;3;0;0;0
1612380;Combat Casino;;0 - 20,000;3;2;1;0;0;0
1612420;Suit for Hire;;0 - 20,000;214;10;204;0;0;1
1612480;Heal Hitler;;0 - 20,000;133;48;85;0;0;0
1612520;SmallZ;;0 - 20,000;16;12;4;0;0;1
1612550;Haunted Hotel: Eternity Collector's Edition;;20,000 - 50,000;7;1;6;0;0;2
1612620;Never Return;;200,000 - 500,000;1254;345;909;147;147;10
1612770;Sweet Transit;;100,000 - 200,000;480;135;345;1737;2006;113
1612780;The Centennial Case : A Shijima Story;;20,000 - 50,000;496;134;362;91;91;4
1612850;Drowned Gems;;0 - 20,000;9;4;5;0;0;0
1612900;Two Against the Legion;;20,000 - 50,000;6;1;5;0;0;0
1612910;異星病毒Alien virus;;0 - 20,000;41;7;34;0;0;0
1612920;NIGHTSLINK;;0 - 20,000;75;11;64;0;0;0
1612950;Comic Company Manager;;0 - 20,000;7;1;6;0;0;1
1612960;Balloon Flight;;0 - 20,000;39;1;38;0;0;0
1612980;VR Game Station;;50,000 - 100,000;1;1;0;0;0;0
1613000;旅途;;0 - 20,000;1;3;-2;0;0;0
1613050;Flex hooks;;0 - 20,000;42;2;40;0;0;0
1613080;Rift Drifter;;0 - 20,000;7;2;5;0;0;0
1613090;GunKour;;0 - 20,000;8;4;4;0;0;0
1613100;Rioters 2025;;0 - 20,000;13;16;-3;0;0;0
1613150;BOX: Space Station;;0 - 20,000;29;0;29;0;0;0
1613220;World CHAMPIONS: Decathlon;;0 - 20,000;8;0;8;0;0;0
1613230;ShootRun;;0 - 20,000;2;0;2;0;0;0
1613470;Roboplant;;0 - 20,000;32;10;22;0;0;3
1613490;Nothing To Remember;;0 - 20,000;15;6;9;0;0;2
1613530;SYRAK: the War in the Middle-East;;0 - 20,000;3;0;3;0;0;0
1613580;ARRIVAL: ZERO EARTH;;0 - 20,000;56;6;50;75;75;3
1613630;Dungeon D14;;0 - 20,000;1;2;-1;0;0;0
1613670;Anglerfish;;0 - 20,000;143;17;126;0;0;1
1613680;Arrow Sudoku;;0 - 20,000;60;1;59;0;0;7
1613770;Cave Quest 2;;0 - 20,000;40;3;37;0;0;6
1613950;Sovereign Tea;;0 - 20,000;17;2;15;0;0;0
1613960;The Death Into Trouble;;0 - 20,000;15;1;14;0;0;1
1614020;Yokai Taiji;;50,000 - 100,000;1;0;1;0;0;0
1614030;Electrogene;;0 - 20,000;2;0;2;0;0;0
1614250;Dungeon Girl;;0 - 20,000;21;12;9;0;0;0
1614270;Submerged: Hidden Depths;;0 - 20,000;208;14;194;0;0;4
1614340;Matchsticks - Coffee Break Club;;0 - 20,000;72;2;70;0;0;0
1614360;Super Ember Kaboom;;0 - 20,000;55;2;53;0;0;0
1614380;Pnevmo-Capsula: Domiki;;0 - 20,000;97;25;72;0;0;0
1614500;Run and Jump Little Vico;;0 - 20,000;14;1;13;0;0;0
1614550;Astro Colony;;50,000 - 100,000;946;154;792;584;584;119
1614620;The Chronicler;;0 - 20,000;2;0;2;0;0;0
1614680;Perspective;;0 - 20,000;4;2;2;0;0;0
1614780;BAD DREAMS;;20,000 - 50,000;27;4;23;0;0;0
1614850;Colosseum VR;;20,000 - 50,000;42;6;36;0;0;0
1614890;Baldo: The Guardian Owls;;0 - 20,000;102;63;39;0;0;2
1614920;BricksVR;;0 - 20,000;23;2;21;0;0;2
1614960;Miko Adventures Puffball;;0 - 20,000;14;0;14;0;0;2
1614990;Grid Leaper;;20,000 - 50,000;9;1;8;0;0;0
1615060;Yummy Girl;;20,000 - 50,000;131;34;97;0;0;0
1615100;The Last Stand Legacy Collection;;50,000 - 100,000;1225;137;1088;106;170;12
1615290;Ravenous Devils;;200,000 - 500,000;5176;385;4791;261;324;49
1615470;Hexio;;0 - 20,000;4;0;4;0;0;0
1615740;Machina Blade;;0 - 20,000;28;9;19;0;0;6
1615750;Wolfriders A Sniper Adventure;;0 - 20,000;1;0;1;0;0;0
1615870;Cube;;0 - 20,000;4;0;4;0;0;0
1615890;Dice Knight: Mystery of the Moirai;;0 - 20,000;11;0;11;0;0;0
1615930;[International] Absented Age: Squarebound;;0 - 20,000;28;1;27;0;0;3
1616030;Soaring Machinariae;;0 - 20,000;22;0;22;0;0;0
1616050;RealityMinds;;0 - 20,000;7;0;7;0;0;0
1616210;Mystery Of Camp Enigma;;0 - 20,000;3;4;-1;0;0;0
1616230;LineArt Jigsaw Puzzle - Airplanes;;0 - 20,000;5;7;-2;0;0;0
1616270;Chronicles of Tal'Dun: The Remainder - Act 2;;0 - 20,000;5;0;5;0;0;0
1616280;Chronicles of Tal'Dun: The Remainder;;0 - 20,000;79;2;77;0;0;0
1616300;Space Flex;;0 - 20,000;5;4;1;0;0;0
1616510;PhotoWorld: Smooth Сorners;;0 - 20,000;14;5;9;0;0;0
1616520;リトルハーツ;;0 - 20,000;26;0;26;0;0;4
1616540;Exodus H;;0 - 20,000;2;9;-7;0;0;0
1616550;Eyewitness Hopper;;0 - 20,000;1;3;-2;0;0;0
1616580;Ninja Frog;;0 - 20,000;36;5;31;0;0;0
1616690;Action Commando;;20,000 - 50,000;17;8;9;0;0;0
1616740;Scraftion;;0 - 20,000;1;1;0;0;0;0
1616870;Dininho Space Adventure;;0 - 20,000;11;4;7;0;0;0
1617020;Alien Planet Explorer;;50,000 - 100,000;10;6;4;0;0;0
1617030;tERRORbane;;20,000 - 50,000;220;25;195;0;0;4
1617090;Setup Developer Tool 2021;;0 - 20,000;4;2;2;0;0;1
1617160;Mad Wild Fairy Tale;;0 - 20,000;8;1;7;0;0;0
1617200;Santa Soccer;;20,000 - 50,000;1;0;1;0;0;0
1617270;The Faraway Land;;0 - 20,000;58;11;47;0;0;0
1617360;Desperation;;50,000 - 100,000;7;3;4;0;0;0
1617370;Bridge to Another World: Endless Game Collector's Edition;;20,000 - 50,000;6;1;5;0;0;0
1617420;Logistics Simulator;;0 - 20,000;13;8;5;0;0;0
1617430;Bunhouse;;0 - 20,000;377;19;358;0;0;8
1617450;Panqueca & Paçoca: A Friendship Jigsaw;;0 - 20,000;39;1;38;0;0;0
1617480;Fight Party;;0 - 20,000;94;26;68;0;0;0
1617510;Oversight;;0 - 20,000;1;0;1;0;0;0
1617560;Super Swarm Smash;;0 - 20,000;1;0;1;0;0;0
1617600;Survive Avalon;;0 - 20,000;0;1;-1;0;0;0
1617770;Cam Circle VR;;0 - 20,000;3;4;-1;0;0;0
1617800;Kin's Chronicle (Development Halted);;20,000 - 50,000;2;1;1;0;0;0
1617880;Cleithrophobia;;0 - 20,000;2;0;2;0;0;0
1617890;Imprisoned Hyperion;;0 - 20,000;2;3;-1;0;0;1
1617900;Head 2 Head;;0 - 20,000;32;4;28;0;0;1
1618000;Monkey Hit;;0 - 20,000;2;0;2;0;0;0
1618030;Titan Nebula;;0 - 20,000;0;4;-4;0;0;0
1618050;Synth Retro Vapor Wave;;0 - 20,000;35;5;30;0;0;0
1618090;Lingering Legacy;;0 - 20,000;2;0;2;0;0;0
1618140;Whack A Rat VR;;0 - 20,000;2;0;2;0;0;0
1618210;Speedbreak Hyperdrive;;0 - 20,000;1;0;1;0;0;0
1618220;窓の中の先にあるもの;;0 - 20,000;17;0;17;0;0;0
1618230;恋爱关系/Romance;;50,000 - 100,000;1642;250;1392;124;193;7
1618240;The Alien Way;;0 - 20,000;12;4;8;0;0;0
1618280;Idle Tentacles;;0 - 20,000;6;18;-12;0;0;3
1618290;TRAIN CREW;;0 - 20,000;126;4;122;0;0;19
1618330;Out of Order;;20,000 - 50,000;15;1;14;0;0;0
1618340;Dabado Puzzles;;0 - 20,000;7;2;5;0;0;0
1618380;Spellmasons;;0 - 20,000;69;8;61;0;0;43
1618450;Anatidae;;0 - 20,000;21;2;19;0;0;0
1618510;Poulet Poulet;;0 - 20,000;5;0;5;0;0;0
1618540;Ghost Exorcism INC.;;200,000 - 500,000;3795;1280;2515;155;192;126
1618580;Run, Doodleguy!;;0 - 20,000;5;0;5;0;0;0
1619080;Cake Invaders;;0 - 20,000;27;2;25;0;0;0
1619150;Gustav Vasa: Adventures in the Dales;;0 - 20,000;1;0;1;0;0;0
1619200;票者！小慧的打工大作戰;;0 - 20,000;11;12;-1;0;0;0
1619260;Flag Color Number - Painting and Coloring;;0 - 20,000;2;1;1;0;0;0
1619330;Firelight Fantasy: Force Energy;;0 - 20,000;27;12;15;0;0;0
1619350;DeepStates [VR];;0 - 20,000;65;7;58;0;0;0
1619390;Zen Landscape Editor;;0 - 20,000;3;0;3;0;0;0
1619450;Heart of a Warrior;;2,000,000 - 5,000,000;0;1;-1;0;0;0
1619550;Shank the Cop;;0 - 20,000;0;1;-1;0;0;0
1619790;Aggressor;;0 - 20,000;94;59;35;0;0;1
1619890;Yupi;;0 - 20,000;4;0;4;0;0;0
1619940;Mix-A-Max;;0 - 20,000;6;0;6;0;0;0
1619970;Minable & Create / ミナクリ;;0 - 20,000;6;4;2;0;0;0
1620040;Nickelodeon Kart Racers 3: Slime Speedway;;0 - 20,000;36;17;19;0;0;4
1620050;The Sole Survivor;;0 - 20,000;3;1;2;0;0;0
1620060;Clockwork Dungeon;;0 - 20,000;7;0;7;0;0;0
1620070;Mortal and Monster;;0 - 20,000;4;0;4;0;0;0
1620110;Slobbish Dragon Princess LOVE + PLUS;;0 - 20,000;47;2;45;0;0;2
1620290;Zombie Cure Lab;;20,000 - 50,000;165;28;137;32;32;15
1620340;Wrestling Empire;;50,000 - 100,000;1198;70;1128;0;0;84
1620360;Draw IT!;;0 - 20,000;1;3;-2;0;0;0
1620380;INREAL;;0 - 20,000;39;15;24;0;0;0
1620390;Spare Parts: Episode 2;;0 - 20,000;21;0;21;0;0;0
1620410;Federation77;;0 - 20,000;65;11;54;0;0;0
1620490;Magical Girl Creator;;0 - 20,000;1;1;0;0;0;0
1620540;Pixel Cup Soccer - Ultimate Edition;;0 - 20,000;378;40;338;0;0;33
1620600;Master of Puppets;;0 - 20,000;2;0;2;0;0;0
1620700;DemonPandemicVR;;0 - 20,000;3;1;2;0;0;0
1620720;The Forest Quartet;;;;;0;;;
1620800;Helix;;0 - 20,000;10;2;8;0;0;0
1620850;OmegaBot;;0 - 20,000;16;1;15;0;0;0
1620860;Chicken Holmes - Chanislavski Whispers;;50,000 - 100,000;16;5;11;0;0;0
1620920;Guazu: The Rescue;;0 - 20,000;48;2;46;0;0;0
1620970;Blue Rabbit;;0 - 20,000;2;1;1;0;0;0
1621000;Ultimate Waifu Battle Online;;0 - 20,000;2;2;0;0;0;0
1621070;DeadPoly;;100,000 - 200,000;2890;694;2196;146;156;105
1621100;Sorcerous;;0 - 20,000;3;2;1;0;0;0
1621140;Clawfish;;0 - 20,000;273;13;260;26;26;0
1621200;Hot Pot VR;;0 - 20,000;18;5;13;0;0;0
1621210;Nemithia - Tale of the Legendary Saviors;;20,000 - 50,000;0;1;-1;0;0;1
1621310;Atelier Sophie 2: The Alchemist of the Mysterious Dream;;50,000 - 100,000;1557;82;1475;1785;1785;115
1621380;Scampr;;0 - 20,000;11;3;8;0;0;0
1621420;After Shadows;;0 - 20,000;7;5;2;0;0;1
1621450;Biscuitts 4;;0 - 20,000;3;1;2;0;0;0
1621560;Black One Blood Brothers;;0 - 20,000;400;112;288;37;37;5
1621680;Sword and Fairy 4;;0 - 20,000;127;36;91;0;0;13
1621690;Core Keeper;;500,000 - 1,000,000;20124;1801;18323;1289;698;5020
1621760;Decision: Red Daze;;20,000 - 50,000;295;126;169;670;670;8
1621950;ULTRA NINJA SOUL;;0 - 20,000;6;0;6;0;0;0
1621980;Territory: Animals Genetic Strategy;;0 - 20,000;23;6;17;0;0;0
1622010;Castle Greyrot;;0 - 20,000;6;0;6;0;0;0
1622040;Lila's Tale and the Hidden Forest;;0 - 20,000;21;0;21;0;0;2
1622060;Dark Threads;;20,000 - 50,000;16;9;7;0;0;0
1622090;Water Ball;;20,000 - 50,000;10;7;3;0;0;0
1622180;Frame Game;;0 - 20,000;12;0;12;0;0;0
1622250;Dead Hospital;;0 - 20,000;4;19;-15;0;0;0
1622270;COINS BATTLE;;0 - 20,000;2;15;-13;0;0;0
1622360;Stellona;;0 - 20,000;6;0;6;0;0;0
1622470;Content;;0 - 20,000;24;3;21;0;0;0
1622510;Touhou 3D Dungeon;;0 - 20,000;11;3;8;0;0;0
1622560;Interplanetary Gardener;;0 - 20,000;9;2;7;0;0;1
1622600;Moxina;;0 - 20,000;4;2;2;0;0;0
1622600;Moxina;;0 - 20,000;4;2;2;0;0;0
1622610;Hell Slayer;;0 - 20,000;8;1;7;0;0;1
1622640;Search;;0 - 20,000;9;7;2;0;0;0
1622770;Doors: Paradox;;0 - 20,000;403;31;372;0;0;9
1622800;Super Dungeon Maker;;0 - 20,000;240;18;222;153;153;7
1622830;Stardrytch;;0 - 20,000;10;2;8;0;0;2
1622840;Apollo in Outer Space;;0 - 20,000;14;0;14;0;0;0
1622920;Fire Dogs;;0 - 20,000;33;7;26;0;0;0
1622970;Packing House;;0 - 20,000;53;11;42;0;0;2
1622990;Dr. Byte;;0 - 20,000;0;1;-1;0;0;0
1623000;Kate: Collateral Damage;;0 - 20,000;45;4;41;0;0;1
1623060;Endless Heck;;0 - 20,000;1;0;1;0;0;0
1623070;Master of Magic;;50,000 - 100,000;417;152;265;0;0;140
1623080;Aery - Calm Mind;;0 - 20,000;53;10;43;0;0;0
1623090;From Earth To Heaven;;0 - 20,000;18;4;14;0;0;0
1623130;Multigravity;;0 - 20,000;0;1;-1;0;0;0
1623210;Soulash;;20,000 - 50,000;279;87;192;196;382;9
1623220;Ball Twist;;0 - 20,000;2;0;2;0;0;1
1623240;Maguntsche: Chapter One Remastered;;20,000 - 50,000;12;5;7;0;0;0
1623300;Model Building Restoration;;0 - 20,000;0;18;-18;0;0;0
1623310;Empire Chronicles;;0 - 20,000;4;0;4;0;0;0
1623320;Little Big Guy;;20,000 - 50,000;2;2;0;0;0;0
1623370;Ohio John: Get Out!;;50,000 - 100,000;1;1;0;0;0;0
1623380;ACIIIIIIIIIIIIIIID;;0 - 20,000;17;4;13;0;0;0
1623390;Unplugged;;0 - 20,000;41;21;20;35;35;0
1623420;Serious Sam: Kamikaze Attack!;;0 - 20,000;133;29;104;0;0;0
1623440;TIME BREAKER;;0 - 20,000;16;3;13;0;0;0
1623640;The Witch's Maze;;20,000 - 50,000;4;0;4;0;0;0
1623650;Don't Cut Your Hand 2;;0 - 20,000;15;0;15;0;0;0
1623690;异界转生 这次变成了传说中的勇者呢（受）;;0 - 20,000;16;3;13;0;0;1
1623700;Deiland: Pocket Planet;;0 - 20,000;101;45;56;0;0;3
1623720;BrainTeaser;;0 - 20,000;1;2;-1;0;0;0
1623880;Noob - Les Sans-Factions;;20,000 - 50,000;751;131;620;285;285;2
1623960;Loot Slider;;0 - 20,000;18;0;18;0;0;0
1624050;Myth of Ethary;;0 - 20,000;1;0;1;0;0;0
1624140;Cladmen;;0 - 20,000;20;12;8;0;0;0
1624160;Sword of Paladin RE;;0 - 20,000;3;0;3;0;0;0
1624180;VOICE;;0 - 20,000;11;1;10;0;0;0
1624210;Flowers for You: a pleasant walk;;0 - 20,000;18;1;17;0;0;0
1624220;IT TAKES THE BALL;;0 - 20,000;7;2;5;0;0;0
1624340;Joystick Party: LAN Controller Emulator;;0 - 20,000;3;0;3;0;0;0
1624350;Super Onion Boy 2;;0 - 20,000;20;0;20;0;0;0
1624380;Horny Sekai;;0 - 20,000;78;22;56;127;127;0
1624460;THE FANGS HUNTRESS;;20,000 - 50,000;17;4;13;0;0;0
1624470;Mirror Of Life;;0 - 20,000;5;0;5;0;0;0
1624560;Far Away Horse;;0 - 20,000;3;0;3;0;0;0
1624570;Midnight Calling: Jeronimo Collector's Edition;;20,000 - 50,000;8;1;7;0;0;0
1624600;Realms VR;;0 - 20,000;7;2;5;0;0;0
1624610;Mecha Snake;;0 - 20,000;1;1;0;0;0;0
1624620;SuperSecret;;20,000 - 50,000;3;1;2;0;0;0
1624830;Path of Sacrifice;;0 - 20,000;101;8;93;0;0;0
1624860;Tasty Jigsaw Happy Hour 2;;0 - 20,000;1;1;0;0;0;0
1624870;Mystery Solitaire Powerful Alchemist;;0 - 20,000;4;0;4;0;0;1
1624880;1001 Jigsaw Legends of Mystery 2;;0 - 20,000;6;3;3;0;0;0
1624890;Mystery Solitaire Grimm's Tales 3;;0 - 20,000;4;0;4;0;0;1
1624900;1001 Jigsaw Detective;;0 - 20,000;7;1;6;0;0;1
1624910;Detective Solitaire The Ghost Agency;;0 - 20,000;1;0;1;0;0;1
1624920;1001 Jigsaw. Home Sweet Home. Back from Vacation;;0 - 20,000;3;2;1;0;0;0
1624940;Restaurant Solitaire Delicious Lunch;;0 - 20,000;2;1;1;0;0;0
1624950;1001 Jigsaw. Earth Chronicles 9;;0 - 20,000;2;1;1;0;0;0
1624960;Solitaire Bonbon;;0 - 20,000;4;0;4;0;0;0
1624970;Gnomes Solitaire;;0 - 20,000;1;1;0;0;0;0
1624990;Alzheimer's: Memories;;0 - 20,000;38;1;37;0;0;0
1625060;Lost Scale: Part One;;0 - 20,000;11;8;3;0;0;0
1625100;TempleFight;;0 - 20,000;10;0;10;0;0;0
1625110;Ghost Blood;;100,000 - 200,000;30;10;20;0;0;0
1625130;Orbit-X;;20,000 - 50,000;2;1;1;0;0;0
1625190;ANYEK - The Keyboard Puzzle;;0 - 20,000;1;0;1;0;0;0
1625230;NOeSIS Ⅱ-人间无常（先行版）;;0 - 20,000;88;2;86;0;0;0
1625260;中国象棋-残局大师;;0 - 20,000;16;8;8;0;0;0
1625280;Shackled;;20,000 - 50,000;3;0;3;0;0;0
1625280;Shackled;;20,000 - 50,000;3;0;3;0;0;0
1625340;United Assault - Battle of the Bulge;;0 - 20,000;16;10;6;0;0;4
1625420;Skyward Descent;;20,000 - 50,000;3;2;1;0;0;0
1625510;Insect Adventure;;0 - 20,000;13;3;10;0;0;0
1625520;Seance;;0 - 20,000;59;4;55;0;0;0
1625670;AutoCube;;0 - 20,000;3;0;3;0;0;0
1625700;The Chatters Show;;0 - 20,000;1;0;1;0;0;0
1625710;ANIME MATCH;;0 - 20,000;7;0;7;0;0;0
1625760;Dave Dave Dave;;0 - 20,000;8;0;8;0;0;1
1625790;Unicorn and Sweets;;0 - 20,000;11;4;7;0;0;0
1625830;Brendan Keogh's Putting Challenge;;0 - 20,000;24;1;23;0;0;0
1625840;Rabbit Run;;0 - 20,000;3;1;2;0;0;0
1625900;Astroroxx;;0 - 20,000;0;1;-1;0;0;0
1625960;Loverowind;;0 - 20,000;49;24;25;0;0;0
1626110;Space Porter;;0 - 20,000;9;4;5;0;0;0
1626130;Allura: Curse of the Mermaid;;0 - 20,000;7;1;6;0;0;0
1626140;DEKONSTRUKT;;0 - 20,000;5;3;2;0;0;0
1626180;Squad Killer;;0 - 20,000;1;0;1;0;0;0
1626370;Raybound;;0 - 20,000;17;0;17;0;0;0
1626410;Walk of Shame;;0 - 20,000;3;2;1;0;0;0
1626480;Slime Labs;;0 - 20,000;2;0;2;0;0;0
1626490;We Are Open;;0 - 20,000;1;1;0;0;0;0
1626530;Facteroids;;0 - 20,000;27;3;24;0;0;1
1626570;Super Hot Potato;;0 - 20,000;2;0;2;0;0;0
1626600;桃夭塔 TaoYaoTa;;0 - 20,000;35;14;21;0;0;0
1626680;Surgeball;;0 - 20,000;2;1;1;0;0;0
1626710;Ray Attack;;20,000 - 50,000;0;1;-1;0;0;0
1626890;坏小孩;;100,000 - 200,000;1228;32;1196;405;405;3
1626950;The Case of Maneki;;0 - 20,000;4;0;4;0;0;1
1627030;Bloon Rush;;0 - 20,000;1;0;1;0;0;0
1627040;학생들의 공포괴담 終 (Students' horrible stories FIN);;20,000 - 50,000;54;8;46;0;0;0
1627120;Operation Body Count;;100,000 - 200,000;9;5;4;0;0;0
1627130;Shadoworlds;;200,000 - 500,000;1;0;1;0;0;0
1627140;Sabre Team;;1,000,000 - 2,000,000;0;2;-2;0;0;0
1627150;Retro Classix: Joe & Mac Returns;;0 - 20,000;13;1;12;0;0;0
1627180;Operation Insanity;;0 - 20,000;0;1;-1;0;0;0
1627220;Retro Classix: Night Slashers;;50,000 - 100,000;7;18;-11;0;0;0
1627230;Retro Classix: BreakThru;;20,000 - 50,000;3;0;3;0;0;0
1627240;At the behest of the Pike: Time To Run;;0 - 20,000;14;7;7;0;0;0
1627280;Operation: VICUS;;50,000 - 100,000;0;2;-2;0;0;0
1627310;Ralph and the Blue Ball;;0 - 20,000;69;1;68;0;0;0
1627330;Instinct War - Card Game;;50,000 - 100,000;27;2;25;0;0;0
1627360;Vulkan: Lost Planet;;0 - 20,000;17;1;16;0;0;0
1627420;Lilly's rescue;;50,000 - 100,000;12;1;11;0;0;0
1627480;Aplestia: Retold;;0 - 20,000;5;0;5;0;0;0
1627480;Aplestia: Retold;;0 - 20,000;5;0;5;0;0;0
1627560;JIGOKU UNKO;;20,000 - 50,000;1;1;0;0;0;0
1627610;Jgsw;;0 - 20,000;22;1;21;0;0;2
1627630;Dungeon Adventure;;0 - 20,000;125;56;69;0;0;1
1627680;Love n War: Hero by Chance II;;20,000 - 50,000;187;38;149;11;11;30
1627740;SHAKESPEARE? More like THIRSTspeare, amirite?;;0 - 20,000;1;1;0;0;0;0
1627850;Deadly Broadcast;;0 - 20,000;228;105;123;0;0;7
1627920;QB Planets;;0 - 20,000;2;0;2;0;0;0
1628060;Project E.V.A. Remake;;0 - 20,000;1;3;-2;0;0;0
1628130;Who Pressed Mute on Uncle Marcus?;;20,000 - 50,000;342;108;234;0;0;5
1628300;Adventure Light;;0 - 20,000;3;2;1;0;0;0
1628370;Lipstick Assassin;;50,000 - 100,000;0;1;-1;0;0;0
1628400;Hiragana Katakana Ninja;;0 - 20,000;0;2;-2;0;0;0
1628440;Trick & Treat Remake;;0 - 20,000;42;0;42;0;0;0
1628470;Monster Academy;;0 - 20,000;3;0;3;0;0;0
1628480;Коты Воители;;0 - 20,000;10;15;-5;0;0;0
1628670;Move the Window;;0 - 20,000;3;1;2;0;0;0
1628790;幻想殇物语;;0 - 20,000;2;0;2;0;0;0
1628790;幻想殇物语;;0 - 20,000;2;0;2;0;0;0
1628890;NecroBoy : Path to Evilship;;0 - 20,000;23;3;20;0;0;1
1628930;Cupcake Remember;;0 - 20,000;1;0;1;0;0;0
1628940;Street Striker;;0 - 20,000;13;11;2;0;0;0
1629040;No Fear;;0 - 20,000;3;2;1;0;0;0
1629060;Colibri XR Immersive Art Gallery;;0 - 20,000;15;3;12;0;0;0
1629150;Gazmatera: Return Of The Generals;;50,000 - 100,000;4;0;4;0;0;0
1629160;Peg Solitaire;;50,000 - 100,000;2;0;2;0;0;0
1629190;Spin the World;;0 - 20,000;6;2;4;0;0;0
1629200;Anima : The Reign of Darkness;;50,000 - 100,000;386;175;211;0;0;9
1629220;Escape From Ruby Castle;;0 - 20,000;3;0;3;0;0;0
1629250;Gravitaze: Two;;0 - 20,000;4;1;3;0;0;0
1629300;Kiteboarding Pro;;0 - 20,000;7;1;6;0;0;0
1629380;Last Soul;;0 - 20,000;1;1;0;0;0;0
1629400;Towerbots;;0 - 20,000;4;3;1;0;0;0
1629450;Underwater;;0 - 20,000;4;11;-7;0;0;0
1629480;The Last Dance Saloon;;20,000 - 50,000;2;0;2;0;0;0
1629520;A Little to the Left;;50,000 - 100,000;1578;234;1344;202;237;625
1629530;Spark the Electric Jester 3;;20,000 - 50,000;1027;24;1003;0;0;29
1629550;Hagia Sophia VR Experience;;0 - 20,000;3;3;0;0;0;0
1629570;Spacegirl 2038;;0 - 20,000;0;1;-1;0;0;0
1629600;Hidden Shapes Lovely Cats - Jigsaw Puzzle Game;;0 - 20,000;36;6;30;0;0;1
1629650;Stinky feet: The adventure of BigFoot;;0 - 20,000;3;0;3;0;0;0
1629680;Artifacting;;0 - 20,000;1;0;1;0;0;0
1629770;Whispered Secrets: Ripple of the Heart Collector's Edition;;0 - 20,000;4;0;4;0;0;0
1629910;Souls of Chronos;;20,000 - 50,000;48;8;40;0;0;7
1629940;A Walk With Yiayia;;0 - 20,000;42;0;42;0;0;1
1629940;A Walk With Yiayia;;0 - 20,000;42;0;42;0;0;1
1630110;Gungrave G.O.R.E;;0 - 20,000;164;93;71;0;0;8
1630180;The hidden game society;;20,000 - 50,000;19;9;10;0;0;0
1630340;Smackit hamster;;0 - 20,000;5;0;5;0;0;0
1630360;Matanga 2;;0 - 20,000;31;5;26;0;0;0
1630490;Sakura Forest Girls 2;;0 - 20,000;25;2;23;0;0;0
1630500;Would you like to run an idol café? 2;;0 - 20,000;12;2;10;0;0;0
1630520;EverWorld;;0 - 20,000;3;2;1;0;0;0
1630530;Universe999999;;0 - 20,000;1;0;1;0;0;1
1630590;Paint Drying Simulator;;0 - 20,000;138;10;128;0;0;8
1630640;Ichth.ys;;50,000 - 100,000;1;0;1;0;0;0
1630650;Neko Beach;;0 - 20,000;90;13;77;0;0;0
1630690;Equin 2: The Warren Peace;;0 - 20,000;12;0;12;0;0;2
1630740;Silent Night - A Christmas Delivery;;0 - 20,000;5;1;4;0;0;0
1630760;Infinity Valley;;0 - 20,000;5;0;5;0;0;0
1630780;Heartless Dark;;0 - 20,000;17;0;17;0;0;1
1630800;Crystal Sequence;;0 - 20,000;12;0;12;0;0;0
1630890;Rift Adventure;;0 - 20,000;20;5;15;0;0;1
1630910;SATANIC PANIC 666;;0 - 20,000;60;11;49;0;0;0
1630920;Bright Lights of Svetlov;;20,000 - 50,000;804;57;747;0;0;2
1630940;HUMBLE ZOMBIE;;20,000 - 50,000;7;1;6;0;0;0
1630960;Centipede: Recharged;;0 - 20,000;58;12;46;0;0;1
1631010;Goldenjar Fall;;0 - 20,000;19;0;19;0;0;0
1631090;Alien Maze;;0 - 20,000;123;12;111;0;0;1
1631100;One Hell of a Trip;;0 - 20,000;1;0;1;0;0;0
1631120;Void Warfare;;0 - 20,000;0;3;-3;0;0;0
1631130;审判者 高清重制全章节版;;20,000 - 50,000;57;136;-79;0;0;1
1631140;BIAS;;0 - 20,000;14;2;12;0;0;1
1631160;Logic Car;;0 - 20,000;23;3;20;0;0;1
1631170;Objective H.A.S.T.E. - Survival Horror Escape;;20,000 - 50,000;3;0;3;0;0;0
1631190;The Invasion;;0 - 20,000;0;1;-1;0;0;0
1631200;Hi Poker 3D:Texas Holdem;;0 - 20,000;3;4;-1;0;0;2
1631210;Be My Girlfriends;;20,000 - 50,000;282;94;188;15;15;0
1631280;The Jean-Paul Software Screen Explosion;;0 - 20,000;21;0;21;0;0;7
1631290;Wounded;;0 - 20,000;1;2;-1;0;0;0
1631290;Wounded;;0 - 20,000;1;2;-1;0;0;0
1631330;Equestrian Training ;;0 - 20,000;1;2;-1;0;0;0
1631350;Fight of Steel: Infinity Warrior;;0 - 20,000;55;3;52;0;0;5
1631400;JEFF-16;;0 - 20,000;4;1;3;0;0;0
1631410;Endless Crawler;;0 - 20,000;1;8;-7;0;0;0
1631420;Red Adventure;;0 - 20,000;5;6;-1;0;0;0
1631430;Smirkers;;0 - 20,000;4;1;3;0;0;0
1631500;Dumpy and Bumpy;;0 - 20,000;29;1;28;0;0;1
1631540;Squeakers II;;20,000 - 50,000;24;2;22;0;0;0
1631600;Tourney;;0 - 20,000;26;9;17;0;0;0
1631640;异变战区  E.E.R.I.E;;50,000 - 100,000;362;94;268;78;78;0
1631690;Wild Rat;;0 - 20,000;4;2;2;0;0;0
1631700;Useful Cat;;0 - 20,000;1;4;-3;0;0;0
1631710;Ragdoll Knight;;0 - 20,000;0;10;-10;0;0;0
1631770;The Indestructible Moxy Boxy;;0 - 20,000;3;1;2;0;0;0
1631780;Deep Rune;;0 - 20,000;13;0;13;0;0;0
1631790;Dawnbreaker - Aeon's Reach;;0 - 20,000;23;17;6;11;11;2
1631830;Squish;;0 - 20,000;13;0;13;0;0;1
1631850;PolyClassic: Wild;;20,000 - 50,000;42;11;31;0;0;0
1631860;My Cute Pagangirl;;0 - 20,000;63;21;42;0;0;1
1631900;Hex of the Lich;;0 - 20,000;12;1;11;0;0;2
1631930;The Insignia Project;;50,000 - 100,000;3;1;2;0;0;0
1631950;Fimbul Winter VR;;0 - 20,000;0;2;-2;0;0;0
1632000;Yoko & Yuki: Dr. Rat's Revenge;;0 - 20,000;2;0;2;0;0;0
1632030;Soran;;0 - 20,000;6;0;6;0;0;0
1632040;Magic defense;;0 - 20,000;1;5;-4;0;0;0
1632140;Girl Agent;;0 - 20,000;40;2;38;0;0;0
1632160;祛魅·格心（祛魅3） - Disenchantment Heart;;0 - 20,000;19;4;15;0;0;0
1632170;Belle Boomerang;;0 - 20,000;11;0;11;0;0;0
1632220;Violent Witches: the Vindicator;;0 - 20,000;3;2;1;0;0;0
1632230;Newtonian Inversion;;20,000 - 50,000;1;2;-1;0;0;0
1632260;水果祖玛 | Fruit Zumba;;0 - 20,000;1;0;1;0;0;0
1632310;A Princess of Fallen Kingdom;;0 - 20,000;17;6;11;0;0;0
1632330;Calamity Eliminator;;0 - 20,000;61;12;49;0;0;2
1632360;Coolors;;0 - 20,000;2;5;-3;0;0;0
1632480;BeatJunkies;;0 - 20,000;1;0;1;0;0;0
1632500;DOOMER'S ADVENTURE;;0 - 20,000;48;6;42;0;0;0
1632590;The Silent Sky Part I;;0 - 20,000;13;4;9;0;0;2
1632610;Puzzle Light: One Move;;0 - 20,000;39;0;39;0;0;0
1632640;Bouncing Traveler;;0 - 20,000;8;5;3;0;0;0
1632650;Daardoa;;0 - 20,000;13;1;12;0;0;0
1632670;Cave Guessers;;0 - 20,000;18;6;12;0;0;0
1632690;SORALAND;;0 - 20,000;3;4;-1;0;0;0
1632820;Our Beautiful Earth 2;;0 - 20,000;1;0;1;0;0;0
1632890;smart3Dplanner;;0 - 20,000;3;4;-1;0;0;0
1632910;MemeNgin;;0 - 20,000;13;2;11;0;0;0
1632920;Jolly Bunny's Adventure;;0 - 20,000;4;0;4;0;0;0
1632930;Cycled;;0 - 20,000;8;0;8;0;0;0
1632960;Luminyte;;0 - 20,000;1;1;0;0;0;0
1632980;schoolbreak.io;;0 - 20,000;6;2;4;0;0;0
1633000;Starsation;;0 - 20,000;7;8;-1;0;0;0
1633010;Teraphobia: The Beginning Of Beelzebub;;0 - 20,000;9;2;7;0;0;0
1633020;Wood Brothers Flying Colours;;0 - 20,000;4;1;3;0;0;0
1633050;Devoul- Curse of the Soulless;;0 - 20,000;7;0;7;0;0;0
1633080;JUST HOOPS;;0 - 20,000;14;2;12;0;0;0
1633100;Dinobag's Arcade;;0 - 20,000;1;0;1;0;0;0
1633110;ШХД: ЛЕТО / IT'S SUMMER;;0 - 20,000;19;9;10;0;0;0
1633140;Crystal Plague;;0 - 20,000;12;1;11;0;0;0
1633160;Aquarium Travels;;0 - 20,000;2;1;1;0;0;0
1633210;Medieval Hero;;0 - 20,000;14;3;11;0;0;0
1633230;FREEDOM: Hunt Kill Fly;;0 - 20,000;5;4;1;0;0;0
1633260;SICKO ISLAND;;0 - 20,000;8;3;5;0;0;0
1633300;ANIQUILATION;;20,000 - 50,000;4;0;4;0;0;0
1633370;Boat Crew;;0 - 20,000;26;0;26;0;0;0
1633400;Puzzle & Maze;;0 - 20,000;0;1;-1;0;0;0
1633460;罪印 Seal of sins;;0 - 20,000;13;5;8;0;0;0
1633470;爱与命的彼端;;50,000 - 100,000;3;2;1;0;0;0
1633550;Dark Harvest;;50,000 - 100,000;3;4;-1;0;0;0
1633580;Our Battle Has Just Begun! episode 1;;0 - 20,000;14;1;13;0;0;0
1633640;Papertris;;0 - 20,000;9;1;8;0;0;1
1633660;Girl Jigsaw 2;;20,000 - 50,000;313;60;253;96;96;0
1633740;Pegasus: Broken Wings;;100,000 - 200,000;12;3;9;0;0;0
1633750;Cross Numbers;;0 - 20,000;7;1;6;0;0;0
1633770;Abyss;;0 - 20,000;1;0;1;0;0;0
1633780;The Tau Ceti Terminus;;0 - 20,000;3;2;1;0;0;0
1633820;Crypto Is Dead;;20,000 - 50,000;4;6;-2;0;0;0
1633830;The Shape On The Ground (Steam Edition);;0 - 20,000;15;7;8;0;0;0
1633930;SEN.TUR.;;20,000 - 50,000;1;0;1;0;0;0
1633930;SEN.TUR.;;20,000 - 50,000;1;0;1;0;0;0
1634090;Mini Racing World;;0 - 20,000;12;8;4;0;0;0
1634130;Color Escape: VR Coop;;0 - 20,000;2;0;2;0;0;0
1634150;Behind the Frame: The Finest Scenery;;100,000 - 200,000;3849;157;3692;74;74;6
1634290;Chuhou Joutai 2: Paraided!;;50,000 - 100,000;3;0;3;0;0;0
1634320;Archon-9 : Alien Defense;;0 - 20,000;4;1;3;0;0;0
1634380;COCKEYED HELICOPTERS;;0 - 20,000;0;2;-2;0;0;0
1634410;Animal Rivals: Up In The Air;;0 - 20,000;6;0;6;0;0;0
1634430;Equilibrium;;0 - 20,000;0;1;-1;0;0;0
1634450;B-17 Flying Fortress: World War II Bombers in Action;;0 - 20,000;9;2;7;0;0;1
1634540;Children's Jigsaw Puzzles - Beautifully Illustrated;;20,000 - 50,000;1;0;1;0;0;0
1634680;Ficket: 追剧引擎;;20,000 - 50,000;880;307;573;95;186;755
1634940;The Altered Lands;;0 - 20,000;23;11;12;0;0;0
1634970;Idle Master Hunter Steam Edition;;0 - 20,000;3;4;-1;0;0;0
1634980;Escape Room: The Sorcerer's Curse;;0 - 20,000;4;2;2;0;0;0
1634990;Mark Out! The Wrestling Card Game;;0 - 20,000;46;2;44;0;0;1
1635020;Untitled Marble Game;;20,000 - 50,000;33;3;30;0;0;0
1635120;POG 2;;0 - 20,000;10;3;7;0;0;0
1635150;Protect the Earth;;0 - 20,000;3;0;3;0;0;0
1635210;Broken Blades;;0 - 20,000;16;3;13;0;0;0
1635250;Legend of Chilli Tree;;0 - 20,000;32;1;31;0;0;0
1635290;Detective Bureau Simulator;;0 - 20,000;0;3;-3;0;0;0
1635350;Leave No One Behind: Ia Drang;;0 - 20,000;94;92;2;0;0;5
1635450;Longvinter;;50,000 - 100,000;2437;1189;1248;261;386;955
1635590;My Friend Peppa Pig;;0 - 20,000;591;85;506;0;0;10
1635600;PJ MASKS: HEROES OF THE NIGHT;;0 - 20,000;12;5;7;0;0;2
1635630;Are You a Boat?;;0 - 20,000;2;0;2;0;0;0
1635650;Chromatic Fantasy;;0 - 20,000;3;0;3;0;0;0
1635750;Air Racing VR;;0 - 20,000;0;1;-1;0;0;0
1635780;芯之迷城;;0 - 20,000;4;1;3;0;0;0
1635790;ChessCraft;;20,000 - 50,000;27;2;25;0;0;1
1635800;Dungeon Warriors;;0 - 20,000;13;11;2;0;0;0
1635920;A Dog Named Mato;;0 - 20,000;16;7;9;0;0;0
1635950;Circular;;0 - 20,000;7;4;3;0;0;0
1635980;Kubinashi Recollection;;0 - 20,000;111;4;107;0;0;0
1636000;Tybot Invasion: The Typing Runner;;0 - 20,000;23;0;23;0;0;1
1636050;Last Boss -9x9 Action Battle-;;0 - 20,000;3;0;3;0;0;0
1636070;Totally Convenient;;0 - 20,000;14;0;14;0;0;0
1636150;Heavyarms Assemble: WWII;;0 - 20,000;59;19;40;0;0;0
1636190;The Absorber;;0 - 20,000;2;0;2;0;0;0
1636250;Toaster Defense;;20,000 - 50,000;14;0;14;0;0;1
1636260;Detective Rosie Morgan: Murder on the River Thames;;0 - 20,000;6;3;3;0;0;0
1636300;浪迹三国;;0 - 20,000;4;4;0;0;0;0
1636360;DRUM'N'BASS MASSACRE;;0 - 20,000;1;5;-4;0;0;0
1636370;Horror House;;0 - 20,000;1;3;-2;0;0;0
1636380;I.O.R.C  Impact Orbital Rescue Crew;;0 - 20,000;1;0;1;0;0;0
1636490;Star Of The Show;;0 - 20,000;3;3;0;0;0;0
1636550;Laruaville 11 Match 3 Puzzle;;0 - 20,000;7;1;6;0;0;2
1636570;Wild Souls;;0 - 20,000;2;1;1;0;0;0
1636660;Absolute Tactics: Daughters of Mercy;;50,000 - 100,000;76;29;47;0;0;3
1636700;Wirewalk()↳;;0 - 20,000;41;1;40;0;0;0
1636730;functional;;0 - 20,000;17;11;6;0;0;0
1636850;CYBRID;;20,000 - 50,000;69;9;60;0;0;0
1636900;Inside The Line;;0 - 20,000;1;0;1;0;0;0
1636910;Slikoban;;50,000 - 100,000;16;0;16;0;0;0
1636970;Shining Blade;;0 - 20,000;1;0;1;0;0;0
1636990;Zahalia: The Curse of Zezor;;0 - 20,000;3;0;3;0;0;0
1637030;TANKBOX;;50,000 - 100,000;16;1;15;0;0;0
1637110;MoneyFalls - Coin Pusher Simulator;;0 - 20,000;9;12;-3;0;0;0
1637230;METAL MAX Xeno Reborn;;0 - 20,000;203;89;114;0;0;0
1637300;Nightwalker 2;;0 - 20,000;4;2;2;0;0;0
1637320;Dome Keeper;;500,000 - 1,000,000;5443;543;4900;605;716;547
1637490;Alone on Mars;;0 - 20,000;17;8;9;0;0;0
1637510;Whitehaven;;0 - 20,000;25;16;9;0;0;0
1637520;The Handbook;;20,000 - 50,000;6;1;5;0;0;1
1637540;The Village;;0 - 20,000;10;0;10;0;0;0
1637570;Order Road;;0 - 20,000;3;0;3;0;0;0
1637630;Catarro;;0 - 20,000;20;2;18;0;0;0
1637700;Infiltration: Alone in Combat;;20,000 - 50,000;2;2;0;0;0;0
1637730;Crystal Project;;200,000 - 500,000;1344;110;1234;133;133;58
1637760;Dungeon Master;;0 - 20,000;383;38;345;0;0;0
1637950;Cloaks and Capes;;0 - 20,000;19;1;18;0;0;0
1637970;LOGistICAL 3;;0 - 20,000;16;4;12;0;0;3
1638000;890B;;0 - 20,000;0;1;-1;0;0;0
1638100;​Cubeetle - Game of creation;;50,000 - 100,000;23;5;18;0;0;0
1638220;Xuan-Yuan Sword: The Scar of Sky;;50,000 - 100,000;1432;92;1340;1603;1603;54
1638300;Solargene;;50,000 - 100,000;300;88;212;0;0;22
1638330;Darius Cozmic Collection Arcade;;0 - 20,000;80;4;76;45;45;1
1638340;Cat Simulator : Animals on Farm;;0 - 20,000;82;5;77;0;0;1
1638390;Indies' Lies;;0 - 20,000;399;112;287;1023;1023;62
1638450;Shipwreck Escape;;0 - 20,000;6;0;6;0;0;0
1638520;Hyperglide;;0 - 20,000;27;10;17;0;0;0
1638530;Sprite Generator;;0 - 20,000;1;2;-1;0;0;0
1638680;Rhythm Hero;;0 - 20,000;1;2;-1;0;0;0
1638690;Legends of Mathmatica²: Under the Shadow of Certainty;;0 - 20,000;2;1;1;0;0;0
1638870;Zombie Wars;;0 - 20,000;9;3;6;0;0;0
1638910;The Crows Cry;;0 - 20,000;1;5;-4;0;0;0
1638920;Mystery Trackers: Nightsville Horror Collector's Edition;;20,000 - 50,000;4;3;1;0;0;0
1639040;There Will Be No Turkey This Christmas;;0 - 20,000;42;2;40;0;0;0
1639090;Survive Isolation;;0 - 20,000;13;7;6;0;0;0
1639120;Anime Sunset Ride;;0 - 20,000;28;13;15;0;0;0
1639140;Mouse adventure;;0 - 20,000;8;0;8;0;0;0
1639180;Dance Assembly;;0 - 20,000;10;0;10;0;0;0
1639250;SokoMatch: Lizard Saga;;0 - 20,000;21;0;21;0;0;0
1639340;Waifu vs Evil;;0 - 20,000;30;15;15;0;0;0
1639390;Thermonuclear;;20,000 - 50,000;6;0;6;0;0;0
1639430;Princess&Blade;;20,000 - 50,000;674;157;517;80;90;8
1639480;Bodies of Water VR;;0 - 20,000;4;1;3;0;0;0
1639490;Brick Breaker Heart Collector;;0 - 20,000;1;2;-1;0;0;0
1639520;Sweet Dream;;0 - 20,000;1;3;-2;0;0;0
1639530;Bitten! Someone has to be a villain;;0 - 20,000;5;5;0;0;0;0
1639590;Cold House;;0 - 20,000;62;46;16;0;0;0
1639610;Save Me, Sakuya-san!;;0 - 20,000;524;14;510;35;35;4
1639610;Save Me, Sakuya-san!;;0 - 20,000;524;14;510;35;35;4
1639660;Topper Carrier;;0 - 20,000;8;2;6;0;0;0
1639690;Flowering Across 樱下花期;;0 - 20,000;44;2;42;0;0;0
1639730;MTB Dirt;;0 - 20,000;26;7;19;0;0;1
1639780;Willage;;50,000 - 100,000;15;2;13;0;0;0
1639790;Northern Journey;;50,000 - 100,000;1028;31;997;0;0;5
1639860;Magic Manny;;0 - 20,000;9;1;8;0;0;0
1639920;Embraced by Autumn;;0 - 20,000;21;2;19;0;0;0
1639930;Last Days;;20,000 - 50,000;151;7;144;0;0;0
1640000;Bird's Eye;;0 - 20,000;0;1;-1;0;0;0
1640030;Adventures With a Girl;;0 - 20,000;15;3;12;0;0;0
1640080;Another Eye;;20,000 - 50,000;3;0;3;0;0;0
1640090;Alone;;0 - 20,000;0;1;-1;0;0;0
1640100;War Mines: WW1;;0 - 20,000;37;2;35;0;0;1
1640160;G-Darius HD;;0 - 20,000;83;3;80;0;0;1
1640180;Rebel! Pure love fighters!;;0 - 20,000;66;29;37;0;0;1
1640210;Build a Boss;;0 - 20,000;7;0;7;0;0;0
1640260;ChineseZodiac;;50,000 - 100,000;3;0;3;0;0;0
1640300;Project Warlock II;;0 - 20,000;332;68;264;32;32;5
1640320;B.I.O.T.A.;;0 - 20,000;119;14;105;0;0;14
1640360;Fantasy Friends: Under The Sea;;0 - 20,000;4;3;1;0;0;0
1640540;Desolatium: Prologue;;50,000 - 100,000;69;14;55;0;0;0
1640670;Infected City;;0 - 20,000;8;10;-2;0;0;0
1640710;Interregnum Chronicles: Signal;;0 - 20,000;21;12;9;0;0;0
1640760;WORDLAND 2;;0 - 20,000;19;0;19;0;0;0
1640780;Star Pixie;;0 - 20,000;1;1;0;0;0;0
1640810;Maybe Immortal;;0 - 20,000;37;16;21;0;0;1
1640930;BeeFense BeeMastered;;0 - 20,000;23;4;19;0;0;0
1641020;my brother lives in a canyon;;0 - 20,000;38;1;37;0;0;0
1641060;Castles & Catapults;;50,000 - 100,000;1;2;-1;0;0;0
1641080;Big Bang West;;0 - 20,000;9;1;8;0;0;0
1641100;Model Railway Easily 2;;0 - 20,000;11;7;4;0;0;0
1641210;莫西比亚岛;;0 - 20,000;14;1;13;0;0;0
1641220;Super Gobang;;0 - 20,000;7;3;4;0;0;0
1641230;Buck Borris in Action;;0 - 20,000;12;2;10;0;0;0
1641250;Silver Blue;;0 - 20,000;6;0;6;0;0;0
1641300;Rhythium;;0 - 20,000;12;4;8;0;0;1
1641330;Tree Strike;;50,000 - 100,000;2;0;2;0;0;0
1641370;If You Go Down In The Woods Today;;0 - 20,000;1;0;1;0;0;0
1641450;Listen to the Wind;;0 - 20,000;324;113;211;0;0;1
1641470;Final Foe;;0 - 20,000;4;3;1;0;0;0
1641500;The Blind Of The New World;;0 - 20,000;71;2;69;0;0;0
1641510;Armed Emeth;;20,000 - 50,000;7;3;4;0;0;0
1641520;The Octots Survival;;0 - 20,000;23;5;18;0;0;0
1641600;Made to be Crushed;;0 - 20,000;2;0;2;0;0;0
1641660;RPGolf Legends;;0 - 20,000;11;5;6;0;0;6
1641670;EdgeOfTheAbyssAwaken;;50,000 - 100,000;399;162;237;0;0;1
1641780;Armored;;0 - 20,000;9;4;5;0;0;0
1641820;Abyss King;;0 - 20,000;1;0;1;0;0;0
1641830;Axis Football 2021;;0 - 20,000;81;47;34;95;95;1
1641840;Frosty Jumper;;0 - 20,000;2;0;2;0;0;0
1641880;Raising Torolith;;0 - 20,000;1;1;0;0;0;0
1641890;Lust from Beyond: M Edition;;0 - 20,000;137;56;81;58;102;3
1642010;h8machine;;0 - 20,000;0;0;0;0;0;0
1642040;BzzzController;;0 - 20,000;24;3;21;0;0;2
1642110;BATS: Bloodsucker Anti-Terror Squad;;20,000 - 50,000;7;0;7;0;0;0
1642170;Dawn of the Monsters;;0 - 20,000;79;6;73;0;0;1
1642190;Toilet paper wants to be a basketball;;0 - 20,000;8;2;6;0;0;0
1642220;FIND ALL;;0 - 20,000;305;17;288;0;0;1
1642230;Why Not?;;50,000 - 100,000;6;9;-3;0;0;0
1642250;Swift Elf;;0 - 20,000;7;6;1;0;0;0
1642330;Fairy Godmother Stories: Puss in Boots Collector's Edition;;0 - 20,000;2;3;-1;0;0;0
1642350;Hunger in Paradise;;0 - 20,000;6;2;4;0;0;0
1642460;Grey Lucidity - Horror Visual Novel;;0 - 20,000;2;3;-1;0;0;0
1642480;The phenomenon of Edgar Allan Poe 1/2;;0 - 20,000;1;0;1;0;0;0
1642560;Stardom MiniGames;;0 - 20,000;4;1;3;0;0;1
1642580;明星志願2000;;0 - 20,000;119;22;97;0;0;3
1642590;Stars SLIDE;;0 - 20,000;14;6;8;0;0;0
1642590;Stars SLIDE;;0 - 20,000;14;6;8;0;0;0
1642600;Mud River;;0 - 20,000;2;0;2;0;0;0
1642610;魔法迷域;;0 - 20,000;113;7;106;0;0;0
1642640;Gravity Runner;;0 - 20,000;14;0;14;0;0;0
1642690;DREAMWORLD;;0 - 20,000;1;0;1;0;0;0
1642790;Deepening Fire;;0 - 20,000;243;43;200;0;0;0
1642800;Miss Intelligence;;0 - 20,000;4;1;3;0;0;0
1642890;Disc Golf Valley;;0 - 20,000;171;24;147;48;48;23
1642940;Hidden Office;;0 - 20,000;23;4;19;0;0;3
1643040;SPACE BANDITOS;;0 - 20,000;7;1;6;0;0;0
1643100;Noun Town: VR Language Learning;;0 - 20,000;50;1;49;168;168;2
1643170;Kill Them With Cuteness;;0 - 20,000;3;2;1;0;0;0
1643180;Artist Life Simulator;;0 - 20,000;60;12;48;0;0;8
1643190;Beyond The Gates;;0 - 20,000;7;4;3;0;0;0
1643280;Fancy the Frog;;0 - 20,000;36;5;31;0;0;0
1643340;Just 15 minutes;;0 - 20,000;23;18;5;0;0;0
1643460;たたかえ！ハルモニア音楽隊;;20,000 - 50,000;1;0;1;0;0;0
1643470;Flying Corps;;0 - 20,000;1;3;-2;0;0;0
1643520;Mutant;;0 - 20,000;2;1;1;0;0;0
1643530;The Pirate King Ultimate;;0 - 20,000;4;3;1;0;0;0
1643600;SUPER BOT;;0 - 20,000;5;3;2;0;0;0
1643700;Visitors: First Contact;;0 - 20,000;1;1;0;0;0;0
1643820;Age of Jura;;0 - 20,000;11;3;8;0;0;1
1643850;Slaycation Paradise;;0 - 20,000;52;8;44;0;0;2
1644020;Incredible Dracula: Legacy of the Valkyries;;0 - 20,000;12;1;11;0;0;0
1644030;Selection Process;;0 - 20,000;3;0;3;0;0;0
1644080;Rock 'n' Roll Will Never Die!;;20,000 - 50,000;18;1;17;0;0;1
1644150;OshiRabu: Waifus Over Husbandos ~Love･or･die~;;0 - 20,000;382;74;308;340;340;1
1644190;IsoCubes;;20,000 - 50,000;11;1;10;0;0;0
1644200;Now you can't see me;;0 - 20,000;27;6;21;0;0;0
1644220;Lethal Pongbat;;0 - 20,000;2;0;2;0;0;0
1644280;The Jewel of Monostructure;;20,000 - 50,000;76;1;75;0;0;0
1644330;Pugmire: Treasure of the Sea Dogs;;0 - 20,000;1;1;0;0;0;1
1644390;HyperFeat;;20,000 - 50,000;1;1;0;0;0;0
1644490;Occult;;50,000 - 100,000;1141;355;786;197;266;27
1644560;Endings;;0 - 20,000;2;1;1;0;0;0
1644600;BSurfing;;0 - 20,000;11;1;10;0;0;0
1644630;Mad Mustache;;0 - 20,000;3;6;-3;0;0;0
1644640;Dangerous Planet;;0 - 20,000;6;7;-1;0;0;0
1644650;Defense Tower Simulator;;0 - 20,000;5;6;-1;0;0;0
1644670;Elfblade;;0 - 20,000;3;1;2;0;0;0
1644680;Broken Robot;;0 - 20,000;7;2;5;0;0;0
1644690;Orc Scrolls;;0 - 20,000;5;8;-3;0;0;0
1644810;Navy Strike;;0 - 20,000;1;2;-1;0;0;0
1644830;Galactic Dreams;;0 - 20,000;0;2;-2;0;0;0
1644840;Kittens and Yarn;;0 - 20,000;126;8;118;0;0;1
1644920;Love in Belarus;;0 - 20,000;45;7;38;0;0;0
1644930;Fastlane Bowling;;0 - 20,000;2;5;-3;0;0;0
1644960;NBA 2K22;;500,000 - 1,000,000;21773;15707;6066;9610;4778;6726
1645070;Beat Defender;;0 - 20,000;6;2;4;0;0;0
1645140;Apple Bang!;;0 - 20,000;31;3;28;0;0;0
1645270;Art of Destruction;;0 - 20,000;39;14;25;0;0;0
1645570;Greedy Bubble;;0 - 20,000;17;1;16;0;0;0
1645620;Axiom Alternative II;;0 - 20,000;5;1;4;0;0;0
1645640;No Ghost in Stay Home;;0 - 20,000;74;3;71;0;0;0
1645680;Zombies Desert and Guns;;0 - 20,000;0;3;-3;0;0;0
1645720;HELPLESS;;0 - 20,000;14;9;5;0;0;0
1645720;HELPLESS;;0 - 20,000;14;9;5;0;0;0
1645780;Grayscale Memories;;0 - 20,000;14;1;13;0;0;0
1645820;SurrounDead;;50,000 - 100,000;2108;229;1879;418;701;314
1645870;Ninja Ken;;0 - 20,000;1;1;0;0;0;0
1645940;Flaskoman;;20,000 - 50,000;5;1;4;0;0;0
1645950;Cat Dungeon Escape;;0 - 20,000;9;1;8;0;0;0
1645990;Church of the Midnight Sailor;;0 - 20,000;1;0;1;0;0;0
1646000;Gobot;;0 - 20,000;1;0;1;0;0;0
1646030;Cat Slide Tiles;;0 - 20,000;105;1;104;0;0;0
1646090;Tokyo Rogue;;0 - 20,000;14;0;14;0;0;1
1646120;Citizens: Far Lands;;0 - 20,000;82;7;75;7;7;0
1646180;Succubus Runa and the Erotic Dungeon;;0 - 20,000;7;4;3;0;0;3
1646200;Django;;0 - 20,000;5;2;3;0;0;0
1646230;PEOPLEDOWN;;0 - 20,000;1;0;1;0;0;0
1646240;FukTopia 2;;0 - 20,000;1;1;0;0;0;0
1646280;Endustry;;0 - 20,000;6;3;3;0;0;0
1646350;夏恋幻梦;;0 - 20,000;150;8;142;0;0;0
1646580;Project Demigod;;0 - 20,000;66;13;53;0;0;3
1646600;ReBall;;0 - 20,000;1;1;0;0;0;0
1646650;VR Another World;;0 - 20,000;4;3;1;0;0;0
1646710;Demon Cycle;;0 - 20,000;12;0;12;0;0;0
1646730;POLE;;0 - 20,000;191;169;22;0;0;1
1646750;Stonescape;;0 - 20,000;1;10;-9;0;0;0
1646770;Cold Hill;;0 - 20,000;1;0;1;0;0;0
1646790;Striving for Light;;0 - 20,000;48;11;37;0;0;1
1646830;Infinite Brick Breaker;;0 - 20,000;1;8;-7;0;0;0
1646850;SpaceBourne 2;;20,000 - 50,000;161;35;126;67;67;282
1646880;Rumble Runners;;20,000 - 50,000;2;0;2;0;0;0
1646890;Hot Summer;;0 - 20,000;16;4;12;0;0;0
1646910;Checkmate Kings;;0 - 20,000;0;0;0;0;0;0
1646930;The Feeble Files;;50,000 - 100,000;18;0;18;0;0;0
1647020;Chicken Utopia;;0 - 20,000;2;0;2;0;0;0
1647050;Arcade Boy;;100,000 - 200,000;2;2;0;0;0;0
1647070;Fast Food Mania 3D;;0 - 20,000;10;4;6;0;0;0
1647190;World End Diner;;0 - 20,000;287;14;273;0;0;25
1647200;BEAT ARENA;;0 - 20,000;22;16;6;0;0;0
1647250;KUUKIYOMI 3: Consider It More and More!! - Father to Son;;0 - 20,000;50;10;40;404;404;1
1647360;Little Dog Bob;;0 - 20,000;8;0;8;0;0;0
1647390;Dexter Stardust : Adventures in Outer Space;;0 - 20,000;63;3;60;0;0;3
1647390;Dexter Stardust : Adventures in Outer Space;;0 - 20,000;63;3;60;0;0;3
1647420;GROSS;;0 - 20,000;96;14;82;0;0;7
1647430;Black Mansion;;20,000 - 50,000;1;0;1;0;0;0
1647490;Mahjong Gold 2. Pirates Island;;0 - 20,000;2;0;2;0;0;0
1647550;NEO: The World Ends with You;;0 - 20,000;404;22;382;0;0;42
1647700;Animal Defense Versus;;0 - 20,000;12;3;9;0;0;3
1647730;Zool Redimensioned;;0 - 20,000;102;3;99;0;0;0
1647740;1f y0u're a gh0st ca11 me here! 幽铃热线;;0 - 20,000;84;3;81;0;0;0
1647770;Ankora: Lost Days;;0 - 20,000;36;11;25;0;0;2
1647860;Sadness Of Valor;;0 - 20,000;1;0;1;0;0;0
1648000;Heroines;;0 - 20,000;3;4;-1;0;0;0
1648040;There You Are;;0 - 20,000;10;0;10;0;0;0
1648080;Manual Intervention VR;;0 - 20,000;2;1;1;0;0;0
1648100;Kinduo;;20,000 - 50,000;69;3;66;0;0;2
1648160;Kestrel;;0 - 20,000;5;0;5;0;0;0
1648230;Inside the Memories;;0 - 20,000;15;2;13;0;0;0
1648250;Freddy Frog;;0 - 20,000;1;0;1;0;0;0
1648310;Pillars Of Protection;;0 - 20,000;0;1;-1;0;0;0
1648390;ScooterFlow;;50,000 - 100,000;1117;66;1051;0;0;103
1648450;Card Tower Defence;;0 - 20,000;3;2;1;0;0;0
1648460;Space One - Electron;;0 - 20,000;7;3;4;0;0;1
1648470;谜语女孩;;0 - 20,000;80;22;58;0;0;2
1648560;Nursery Slime;;20,000 - 50,000;92;9;83;0;0;1
1648580;Athletics 3: Summer Sports;;0 - 20,000;2;8;-6;0;0;0
1648590;UndercoverAgent;;50,000 - 100,000;670;135;535;59;84;2
1648610;Malum;;20,000 - 50,000;393;125;268;0;0;0
1648730;S.O.T.A 2;;20,000 - 50,000;194;130;64;0;0;0
1648760;subROV : Underwater Discoveries;;0 - 20,000;30;1;29;0;0;0
1648800;Husky's Adventures;;20,000 - 50,000;7;13;-6;0;0;0
1649080;Two Point Campus;;100,000 - 200,000;2487;401;2086;1266;1354;667
1649240;Returnal;;50,000 - 100,000;1516;360;1156;493;729;4940
1649430;Trap Adventure;;0 - 20,000;10;3;7;0;0;0
1649440;Football Bus Battle 2021;;0 - 20,000;2;0;2;0;0;0
1649570;Super Grave Snatchers;;0 - 20,000;43;6;37;0;0;0
1649630;Berserk Mode;;0 - 20,000;105;7;98;0;0;0
1649730;xiuzhen idle;;100,000 - 200,000;901;348;553;223;223;143
1649820;Unicorn and Sweets 2;;0 - 20,000;10;3;7;0;0;0
1649830;Tales of the Mirror;;20,000 - 50,000;123;101;22;972;972;1
1649870;Bullet Wave;;20,000 - 50,000;8;5;3;0;0;0
1649900;什么找茬;;0 - 20,000;2;1;1;0;0;0
1649920;Coronation;;0 - 20,000;61;26;35;0;0;7
1650040;HuGe;;0 - 20,000;17;6;11;0;0;0
1650080;Mysterious Blocks 2;;50,000 - 100,000;12;2;10;0;0;0
1650150;Island of the Ancients;;0 - 20,000;7;4;3;0;0;2
1650200;Scholar of the Arcane Arts;;0 - 20,000;19;0;19;0;0;1
1650250;ToruTaru;;0 - 20,000;53;8;45;0;0;0
1650250;ToruTaru;;0 - 20,000;53;8;45;0;0;0
1650390;Academy Quest | アカデミークエスト;;0 - 20,000;9;1;8;0;0;0
1650400;Randy And Teddy Adventure Road;;0 - 20,000;15;1;14;0;0;0
1650430;Sci-Fantasy Defence;;0 - 20,000;1;0;1;0;0;0
1650450;Yin Yuh;;0 - 20,000;0;1;-1;0;0;0
1650550;Workshop Simulator;;0 - 20,000;165;87;78;94;94;6
1650590;Nightmare Frames;;0 - 20,000;144;3;141;0;0;1
1650610;Flight 74;;0 - 20,000;21;7;14;0;0;0
1650670;Sokobear: Winter;;0 - 20,000;11;0;11;0;0;0
1650680;To Kill A King;;0 - 20,000;1;0;1;0;0;0
1650690;BattleDead;;0 - 20,000;0;2;-2;0;0;0
1650740;Grim Tales: Threads of Destiny Collector's Edition;;0 - 20,000;4;1;3;0;0;1
1650810;Loopmancer;;0 - 20,000;390;117;273;0;0;1
1650830;No!Ah!'s Ark;;0 - 20,000;71;14;57;0;0;1
1650860;Chambers of Devious Design;;0 - 20,000;70;5;65;0;0;3
1650890;One more game;;0 - 20,000;13;5;8;0;0;0
1651000;Zombie Apocalypse 2021;;0 - 20,000;1;0;1;0;0;0
1651020;Loopindex;;0 - 20,000;5;0;5;0;0;0
1651030;Dandy & Randy DX;;0 - 20,000;11;1;10;0;0;1
1651090;Crown of Pain;;0 - 20,000;37;9;28;0;0;1
1651280;Burnit Quest;;0 - 20,000;14;3;11;0;0;0
1651290;Play a ball;;0 - 20,000;4;13;-9;0;0;0
1651360;Fisticubes - One Button Boxing!;;0 - 20,000;10;0;10;0;0;0
1651390;Gos Castle Runner;;0 - 20,000;1;2;-1;0;0;0
1651440;Rhythm Knights Classic;;0 - 20,000;12;13;-1;0;0;0
1651450;POG 3;;0 - 20,000;6;4;2;0;0;0
1651500;Harvest Hero Origins;;0 - 20,000;27;1;26;0;0;0
1651540;Memories with my Kitten;;0 - 20,000;60;2;58;0;0;1
1651610;Last Night of Winter;;0 - 20,000;52;4;48;0;0;2
1651680;The Colorful Creature;;0 - 20,000;40;1;39;0;0;1
1651730;Balloon Jump;;0 - 20,000;14;3;11;0;0;0
1651750;Short Hop Laser;;0 - 20,000;3;0;3;0;0;0
1651780;Sophie's Safecracking Simulator;;0 - 20,000;50;2;48;0;0;0
1651870;Nighthunt;;20,000 - 50,000;126;94;32;0;0;0
1651880;Welcome To Lakewood;;200,000 - 500,000;7;2;5;0;0;0
1651890;Haunted Hotel: Phoenix Collector's Edition;;0 - 20,000;3;1;2;0;0;0
1651940;U.F.O. K.O. Tower Defense;;0 - 20,000;3;1;2;0;0;0
1651950;En Route: Space;;0 - 20,000;31;11;20;0;0;0
1651960;Hextech Mayhem: A League of Legends Story;;200,000 - 500,000;1763;417;1346;89;104;4
1652040;魔女低语时;;0 - 20,000;4;2;2;0;0;0
1652080;Weapons Knight;;0 - 20,000;2;0;2;0;0;0
1652090;Key: Maze of Illusions;;0 - 20,000;3;1;2;0;0;0
1652120;Find the Cats;;0 - 20,000;8;1;7;0;0;0
1652170;Space puzzle;;0 - 20,000;1;8;-7;0;0;0
1652220;Adventurer Liz and the Erotic Dungeon;;0 - 20,000;10;5;5;0;0;3
1652300;Mousey Mick;;0 - 20,000;12;0;12;0;0;0
1652480;OMNIA;;0 - 20,000;5;1;4;0;0;0
1652490;Boxing Club Manager;;0 - 20,000;41;31;10;0;0;1
1652510;Hard Steel;;0 - 20,000;3;4;-1;0;0;0
1652520;Dungeon Tactics;;0 - 20,000;3;0;3;0;0;0
1652600;Summer In Memoria;;0 - 20,000;3;0;3;0;0;0
1652650;WORDLAND 3;;0 - 20,000;12;0;12;0;0;0
1652680;GAME.exe;;0 - 20,000;301;62;239;0;0;0
1652710;MouseBot: Escape from CatLab;;20,000 - 50,000;17;3;14;0;0;1
1652720;Hextones: Spacetime;;0 - 20,000;18;1;17;0;0;0
1652740;True Visions;;0 - 20,000;6;3;3;0;0;1
1652960;Higgs Boson: Challenging Puzzle;;0 - 20,000;25;2;23;0;0;0
1652990;HABITAT: Race To Mars;;20,000 - 50,000;1;0;1;0;0;0
1653030;Ren the Summoner and the Erotic Dungeon;;0 - 20,000;9;8;1;0;0;0
1653050;长明火计划 Project: Eternal Flame;;0 - 20,000;86;5;81;0;0;0
1653060;孤胆惊魂2：消失的207（Fear 2: The Disappeared 207）;;100,000 - 200,000;10;1;9;0;0;0
1653100;Heliotropism;;0 - 20,000;64;7;57;0;0;1
1653120;通天魔塔-MagicTower;;20,000 - 50,000;4;4;0;0;0;0
1653120;通天魔塔-MagicTower;;20,000 - 50,000;4;4;0;0;0;0
1653170;Woute;;0 - 20,000;4;2;2;0;0;0
1653180;What Is Love? Anime Visual Novel Vol. 1;;0 - 20,000;20;4;16;0;0;0
1653250;Alien Flex;;0 - 20,000;4;0;4;0;0;0
1653260;Zombaliens;;0 - 20,000;5;1;4;0;0;1
1653320;Amneron's Legacy;;20,000 - 50,000;6;1;5;0;0;0
1653420;Train Travel Simulator;;0 - 20,000;25;20;5;0;0;0
1653510;cross board soccer;;0 - 20,000;4;0;4;0;0;0
1653640;Tank Fantastic;;0 - 20,000;11;6;5;0;0;0
1653650;Lucid Dream Simulator;;0 - 20,000;16;2;14;0;0;0
1653660;Box Pusher;;0 - 20,000;6;5;1;0;0;0
1653700;Lona: Realm Of Colors;;0 - 20,000;20;8;12;0;0;0
1653760;NewTaskbar;;0 - 20,000;12;20;-8;0;0;0
1653770;2089 - Space Divided;;0 - 20,000;16;1;15;0;0;2
1653790;Sisters of Silent Liberty Online Multiplayer Shooter REBRANDED;;0 - 20,000;2;15;-13;0;0;0
1653860;Battle Rollers;;0 - 20,000;2;0;2;0;0;0
1653870;Hidden Shapes Old West - Jigsaw Puzzle Game;;0 - 20,000;30;2;28;0;0;0
1653980;Goblin Town;;0 - 20,000;7;6;1;0;0;0
1654070;MayBlues;;0 - 20,000;1;0;1;0;0;0
1654130;孙美琪疑案:雨儿胡同;;0 - 20,000;47;15;32;0;0;0
1654200;Propulsion;;0 - 20,000;23;2;21;0;0;0
1654310;Gang of Paws;;0 - 20,000;2;1;1;0;0;0
1654330;AudioSpace;;0 - 20,000;8;2;6;0;0;0
1654360;Zannon;;0 - 20,000;4;1;3;0;0;0
1654520;Ergo;;0 - 20,000;12;0;12;0;0;1
1654620;Adventures of Human Being;;0 - 20,000;1;0;1;0;0;0
1654680;Red Wings: American Aces;;0 - 20,000;17;3;14;0;0;0
1654700;Bigger Trucks;;0 - 20,000;8;10;-2;0;0;0
1654710;Purry Furry Adventurry;;0 - 20,000;7;0;7;0;0;0
1654800;RC Rush;;0 - 20,000;30;1;29;0;0;0
1654830;Kochu's Dream;;0 - 20,000;0;0;0;0;0;0
1654860;Luffy: Way Back Home;;0 - 20,000;18;1;17;0;0;0
1654890;Sigma Impact;;0 - 20,000;70;1;69;0;0;0
1654920;Changes;;0 - 20,000;4;0;4;0;0;0
1655010;Theseus - Mythological Hero;;0 - 20,000;1;2;-1;0;0;0
1655020;GlassSmash 2;;0 - 20,000;3;0;3;0;0;0
1655050;The Fear Island;;20,000 - 50,000;10;12;-2;0;0;0
1655060;Switch It;;0 - 20,000;1;0;1;0;0;0
1655090;Thirty Minute Nightmare;;0 - 20,000;13;6;7;0;0;0
1655190;AIKAGI;;0 - 20,000;19;0;19;0;0;1
1655210;明明如月;;0 - 20,000;1;1;0;0;0;0
1655220;Star Trek Prodigy: Supernova;;0 - 20,000;9;4;5;0;0;2
1655410;Witchaven;;20,000 - 50,000;40;5;35;15;27;0
1655440;Themes of Dark and Light;;0 - 20,000;1;0;1;0;0;0
1655480;Freebooter of SPLORR!!;;0 - 20,000;16;0;16;0;0;0
1655520;Two Hundred Ways;;0 - 20,000;7;1;6;0;0;1
1655550;A wave of enemies;;0 - 20,000;14;5;9;0;0;0
1655560;Speeder;;0 - 20,000;10;3;7;0;0;0
1655670;Rob Riches;;0 - 20,000;56;1;55;0;0;0
1655700;Mrs.Cat In Mars;;0 - 20,000;48;1;47;0;0;0
1655710;Lovely Kitchen;;0 - 20,000;8;9;-1;0;0;0
1655720;Baseball Adventure;;50,000 - 100,000;2;8;-6;0;0;0
1655740;Slime's Journey;;0 - 20,000;12;0;12;0;0;0
1655800;System Under Surveillance;;20,000 - 50,000;8;0;8;0;0;0
1655850;Vacation Adventures: Park Ranger 6;;0 - 20,000;1;1;0;0;0;0
1655890;Sokobos;;0 - 20,000;52;0;52;0;0;0
1655910;World Legends;;100,000 - 200,000;1;2;-1;0;0;0
1655920;Shin Lotion Samurai;;0 - 20,000;13;1;12;0;0;0
1655940;Earth's Shadow;;0 - 20,000;64;5;59;0;0;2
1655960;Maptroid: Worlds;;0 - 20,000;39;2;37;0;0;0
1656210;The Adventures of Herbie & Katt LeChatt;;0 - 20,000;2;0;2;0;0;0
1656600;Fluffy Cubed;;0 - 20,000;74;4;70;0;0;1
1656640;Four Color Jump;;0 - 20,000;312;33;279;14;14;1
1656650;Express Simulator;;0 - 20,000;2;3;-1;0;0;0
1656740;Mercenary Operator: Wolves;;0 - 20,000;0;1;-1;0;0;0
1656780;Hero's Hour;;200,000 - 500,000;2726;701;2025;676;474;147
1656820;COTTON REBOOT!;;0 - 20,000;24;12;12;0;0;3
1656850;Schematic;;0 - 20,000;5;0;5;0;0;0
1656880;Dungless;;0 - 20,000;20;7;13;0;0;0
1656890;Hoverboard Chase;;0 - 20,000;3;5;-2;0;0;0
1657020;Word Escape;;0 - 20,000;4;0;4;0;0;0
1657080;Soulfire : Weapon Master;;0 - 20,000;6;2;4;0;0;0
1657150;Going the Distance;;20,000 - 50,000;6;0;6;0;0;0
1657200;Star Chaser in Sea World;;0 - 20,000;2;0;2;0;0;0
1657210;AFTER;;0 - 20,000;0;1;-1;0;0;0
1657280;Super Shield Dash;;0 - 20,000;1;0;1;0;0;0
1657290;The Elysian Field;;0 - 20,000;7;2;5;0;0;0
1657350;Cyberflight;;0 - 20,000;5;4;1;0;0;0
1657550;MyHoriZen;;0 - 20,000;1;0;1;0;0;0
1657600;Christmas Stories: Puss in Boots Collector's Edition;;20,000 - 50,000;14;2;12;0;0;0
1657630;Slime Rancher 2;;500,000 - 1,000,000;16895;822;16073;431;318;2428
1657810;Combots;;20,000 - 50,000;469;52;417;0;0;1
1657900;Carrier Command 2 VR;;0 - 20,000;66;59;7;1;1;0
1657960;Anime puzzle;;0 - 20,000;3;4;-1;0;0;0
1658050;Really Weird Pool;;0 - 20,000;6;2;4;0;0;0
1658210;Witty witch;;0 - 20,000;1;0;1;0;0;0
1658290;Eiyuden Chronicle: Rising;;50,000 - 100,000;1161;162;999;1150;2178;74
1658370;Dress-up Pups;;0 - 20,000;8;2;6;0;0;0
1658390;Albert and Puzzle Mansion;;0 - 20,000;3;0;3;0;0;0
1658400;The Mountain Hunting;;0 - 20,000;11;6;5;0;0;0
1658450;GrubDash Driver: Food Delivery Driver Simulator;;0 - 20,000;6;3;3;0;0;0
1658480;EQDRIVE.IO;;0 - 20,000;5;4;1;0;0;0
1658490;Thukothea Defender;;0 - 20,000;3;3;0;0;0;0
1658650;Space Drone: Rescue Mission;;50,000 - 100,000;12;1;11;0;0;0
1658740;Zyconix;;50,000 - 100,000;0;2;-2;0;0;0
1658770;Grandmaster Chess;;0 - 20,000;2;0;2;0;0;0
1658870;New Home: Medieval Village;;0 - 20,000;97;49;48;0;0;1
1658880;汉字大冒险;;0 - 20,000;45;1;44;0;0;0
1658910;SpellHunter;;0 - 20,000;0;2;-2;0;0;0
1658930;Blazing Aries;;0 - 20,000;212;17;195;0;0;2
1659040;HITMAN 3;;1,000,000 - 2,000,000;9388;2012;7376;1250;690;4065
1659070;Charisma X: Bulk Instagram Media Downloader;;0 - 20,000;0;2;-2;0;0;0
1659080;THE LAST DEFENSE!;;0 - 20,000;5;3;2;0;0;0
1659170;Snowboarding;;0 - 20,000;7;7;0;0;0;0
1659180;TD Worlds;;0 - 20,000;21;9;12;0;0;0
1659210;Uninvited Guest;;0 - 20,000;136;40;96;0;0;1
1659270;Sprite Sequence Chapter 2;;0 - 20,000;1;0;1;0;0;0
1659300;Hour Night;;0 - 20,000;4;0;4;0;0;0
1659340;Be The ONE;;0 - 20,000;10;0;10;0;0;1
1659410;Dungeon Lad;;0 - 20,000;23;1;22;0;0;1
1659420;UNCHARTED: Legacy of Thieves Collection;;200,000 - 500,000;9781;1200;8581;1014;1350;1064
1659470;Mouse Hunter;;0 - 20,000;15;7;8;0;0;0
1659560;Nekoba RocknRoll;;0 - 20,000;3;0;3;0;0;0
1659560;Nekoba RocknRoll;;0 - 20,000;3;0;3;0;0;0
1659590;Fallow;;0 - 20,000;102;2;100;0;0;0
1659600;Teenage Mutant Ninja Turtles: The Cowabunga Collection;;0 - 20,000;387;74;313;88;109;12
1659600;Teenage Mutant Ninja Turtles: The Cowabunga Collection;;0 - 20,000;387;74;313;88;109;12
1659650;7th Chance;;0 - 20,000;37;11;26;0;0;0
1659670;Bunny Flush;;0 - 20,000;0;3;-3;0;0;0
1659710;Devileader;;20,000 - 50,000;6;0;6;0;0;0
1659760;Puzzle Cafe VR;;0 - 20,000;0;1;-1;0;0;0
1659800;Sweet House;;20,000 - 50,000;326;84;242;83;113;0
1659910;Mystery of Camp Enigma 2: Point & Click Puzzle Adventure;;0 - 20,000;3;4;-1;0;0;0
1660040;Upaon: A Snake's Journey;;0 - 20,000;29;0;29;0;0;0
1660200;Neon: Eternal;;0 - 20,000;1;0;1;0;0;0
1660240;ATOLL;;0 - 20,000;1;1;0;0;0;0
1660270;Rain Island: Orange;;0 - 20,000;4;1;3;0;0;0
1660280;H-Isekai Loves;;100,000 - 200,000;821;132;689;172;187;6
1660290;Monmusu Gladiator;;0 - 20,000;71;3;68;0;0;1
1660310;Master Boy;;0 - 20,000;4;1;3;0;0;0
1660360;RE:Jump Boy;;0 - 20,000;1;0;1;0;0;0
1660370;Wildlife Match;;0 - 20,000;12;3;9;0;0;0
1660420;Endless Love;;0 - 20,000;11;7;4;0;0;0
1660430;The Wolf's Den;;20,000 - 50,000;11;4;7;0;0;0
1660460;Hoples;;0 - 20,000;11;11;0;0;0;0
1660490;Unreal Golf;;0 - 20,000;10;11;-1;0;0;0
1660500;Party Host 85;;0 - 20,000;2;0;2;0;0;0
1660560;Chess Valley 2;;0 - 20,000;13;3;10;0;0;0
1660580;Invasion: Neo Earth;;0 - 20,000;1;0;1;0;0;0
1660590;Detective Story: Reporter;;0 - 20,000;15;13;2;0;0;0
1660750;UFO vs Bikini;;0 - 20,000;12;1;11;0;0;0
1660860;The Harem Life of Peerless Swordsmen;;20,000 - 50,000;133;40;93;0;0;2
1660890;混沌小队（CHAOS SQUAD）;;0 - 20,000;4;14;-10;0;0;0
1661020;BATTLE STEED : GUNMA (배틀 스티드 : 군마);;0 - 20,000;28;33;-5;0;0;0
1661210;wav ocs game;;0 - 20,000;1;0;1;0;0;0
1661240;Bubble Shooter FX;;0 - 20,000;16;3;13;0;0;1
1661360;The Book of the Game (Adventures in Leman);;0 - 20,000;23;8;15;0;0;4
1661380;Abandoned Croxon Mansion;;0 - 20,000;2;1;1;0;0;0
1661390;Duelist;;0 - 20,000;8;0;8;0;0;0
1661450;The Lost Robot - Jigsaw Puzzle Stories;;0 - 20,000;15;0;15;0;0;0
1661460;CodeWorks: Visual Scripting Framework for GameGuru;;0 - 20,000;2;1;1;0;0;1
1661580;Sur;;0 - 20,000;14;2;12;0;0;0
1661640;Tough Law;;0 - 20,000;38;2;36;0;0;0
1661690;Inflatable doll;;0 - 20,000;8;10;-2;0;0;0
1661700;Tyfortress: Tactical Typing;;0 - 20,000;27;3;24;0;0;0
1661760;Icewords;;0 - 20,000;2;0;2;0;0;0
1661840;Quiet Valley 2;;0 - 20,000;3;3;0;0;0;0
1661840;Quiet Valley 2;;0 - 20,000;3;3;0;0;0;0
1661900;Human Apocalypse - Reverse Horror Zombie Indie RPG Adventure;;0 - 20,000;48;17;31;0;0;1
1661920;Ancient: Legacy of Azul;;0 - 20,000;43;9;34;0;0;0
1661950;Ace Breakout;;0 - 20,000;1;0;1;0;0;0
1662010;Project Absentia;;0 - 20,000;20;0;20;0;0;1
1662080;Goonya Monster;;0 - 20,000;87;47;40;0;0;1
1662140;Real estate tycoon;;50,000 - 100,000;303;92;211;99;99;5
1662260;Code angel;;0 - 20,000;1;1;0;0;0;0
1662340;Case 02: Paranormal Evil;;0 - 20,000;28;1;27;0;0;1
1662350;World War 2 Operation Husky;;0 - 20,000;10;2;8;0;0;0
1662450;Home Office;;0 - 20,000;4;1;3;0;0;0
1662480;Nuclear Blaze;;0 - 20,000;473;15;458;17;17;3
1662570;Rescue Party: Live!;;20,000 - 50,000;120;48;72;0;0;0
1662750;Wraiths of SENTINEL;;0 - 20,000;12;2;10;0;0;9
1662790;REVO;;0 - 20,000;10;0;10;0;0;0
1662830;Salt and Sails;;0 - 20,000;10;2;8;0;0;2
1662840;PARQUET;;50,000 - 100,000;1670;74;1596;737;737;5
1662850;Renai Karichaimashita: Koikari - Love For Hire;;0 - 20,000;198;8;190;0;0;6
1662860;Trapper: Drug Dealing RPG;;0 - 20,000;30;1;29;0;0;1
1662910;GridlessDB;;0 - 20,000;9;2;7;0;0;0
1662940;Anatomy of Fear;;500,000 - 1,000,000;13;11;2;0;0;0
1662990;Explosiver;;100,000 - 200,000;1;3;-2;0;0;0
1663030;Droid404;;0 - 20,000;3;1;2;0;0;0
1663140;女孩与七匹狼;;20,000 - 50,000;1;2;-1;0;0;0
1663170;Airplane Tycoon;;0 - 20,000;3;7;-4;0;0;1
1663250;Hyper Gunsport;;0 - 20,000;23;0;23;0;0;1
1663270;Below The Ocean;;0 - 20,000;55;0;55;0;0;0
1663380;Cat Powered UFO;;0 - 20,000;17;0;17;0;0;1
1663390;Snake Deluxe;;0 - 20,000;13;1;12;0;0;0
1663410;Happenlance;;0 - 20,000;40;3;37;0;0;0
1663560;G-MODEアーカイブス15 ちゅら島暮らし;;0 - 20,000;2;0;2;0;0;0
1663580;Thrice in a row: A new adventure;;0 - 20,000;12;3;9;0;0;1
1663640;The Last Oricru;;20,000 - 50,000;172;79;93;0;0;5
1663650;Knife To Meet You;;20,000 - 50,000;16;1;15;0;0;1
1663730;SGS Afrika Korps: Tunisia;;0 - 20,000;12;1;11;0;0;4
1663860;The Guardian Stone;;0 - 20,000;15;3;12;0;0;1
1663870;VALAKAS: Immortal;;20,000 - 50,000;7;0;7;0;0;0
1663890;Shopping Mahjong connect;;0 - 20,000;15;6;9;0;0;1
1663950;Battlemage: Magic by Mail;;0 - 20,000;11;6;5;0;0;0
1663970;The Play's the Thing;;0 - 20,000;9;1;8;0;0;0
1664010;Dungeon Crawler Daniel;;0 - 20,000;13;2;11;0;0;0
1664050;Tricks Magician;;0 - 20,000;18;3;15;0;0;0
1664090;Magic gems;;0 - 20,000;10;10;0;0;0;0
1664100;FIGHT BOTS;;0 - 20,000;5;0;5;0;0;0
1664220;TRAIL OUT;;50,000 - 100,000;1520;305;1215;310;310;25
1664240;Venaitura;;0 - 20,000;23;1;22;0;0;1
1664370;The Teleport;;0 - 20,000;48;3;45;0;0;50
1664580;Terra Ventura;;0 - 20,000;8;3;5;0;0;0
1664670;Refactor;;100,000 - 200,000;357;45;312;146;228;2
1664910;Murder Diaries;;0 - 20,000;23;4;19;0;0;0
1664920;Fantasy Heroes: Character Editor & Sprite Sheet Maker;;0 - 20,000;8;2;6;0;0;0
1664980;1001 Jigsaw: Earth Chronicles 4;;0 - 20,000;5;2;3;0;0;0
1664990;1001 Jigsaw: Earth Chronicles 5;;0 - 20,000;1;3;-2;0;0;0
1665000;Alice's Jigsaw Time Travel 2;;0 - 20,000;4;0;4;0;0;0
1665010;Fill and Cross Pirate Riddles 2;;0 - 20,000;4;0;4;0;0;0
1665020;Fill and Cross Trick or Treat;;0 - 20,000;1;2;-1;0;0;0
1665040;Griddlers Beach Season;;0 - 20,000;1;0;1;0;0;0
1665050;Griddlers TED and PET 2;;0 - 20,000;2;0;2;0;0;0
1665060;Halloween Patchwork Trick or Treat;;0 - 20,000;4;2;2;0;0;0
1665080;JUMANJI: The Curse Returns;;0 - 20,000;27;22;5;0;0;1
1665120;LGBT Color by Number for Adults;;0 - 20,000;4;0;4;0;0;0
1665130;PAC-MAN MUSEUM+;;0 - 20,000;216;30;186;0;0;7
1665170;The Patagonians;;0 - 20,000;1;2;-1;0;0;0
1665190;Monster Prom 3: Monster Roadtrip;;50,000 - 100,000;1900;17;1883;0;0;196
1665200;Printersim;;0 - 20,000;13;0;13;0;0;1
1665210;Sakura Forest Girls 3;;0 - 20,000;18;0;18;0;0;1
1665250;Nightmare;;0 - 20,000;10;4;6;0;0;2
1665270;Soulmate;;0 - 20,000;3;2;1;0;0;0
1665280;Skábma - Snowfall;;0 - 20,000;74;10;64;0;0;0
1665490;Dead Survival;;0 - 20,000;5;16;-11;0;0;1
1665500;Hypnagogia 無限の夢 Boundless Dreams;;0 - 20,000;256;7;249;77;77;2
1665520;Fire and Dungeon;;20,000 - 50,000;10;4;6;0;0;0
1665570;Brickbuilder VR;;0 - 20,000;6;2;4;0;0;0
1665610;Wishlair;;0 - 20,000;6;0;6;0;0;0
1665650;Metal and Hauling RPG Simulator;;0 - 20,000;3;0;3;0;0;0
1665780;Coalhero;;20,000 - 50,000;2;0;2;0;0;0
1665830;xPack Texture Packing;;0 - 20,000;4;0;4;0;0;0
1665900;SHINORUBI;;200,000 - 500,000;8;5;3;0;0;0
1665990;Selene's Nightmare;;0 - 20,000;4;1;3;0;0;0
1666070;Shoal;;0 - 20,000;12;0;12;0;0;2
1666090;Karanos Solitaire;;0 - 20,000;3;0;3;0;0;0
1666170;Vacancy Unlimited;;0 - 20,000;22;4;18;0;0;0
1666190;Yellow Ballman;;0 - 20,000;2;1;1;0;0;0
1666240;Crimson Glaive Sigma;;0 - 20,000;5;0;5;0;0;0
1666250;Circus Electrique;;20,000 - 50,000;148;45;103;0;0;5
1666310;Parasomnia Verum;;0 - 20,000;33;6;27;0;0;0
1666430;Candy land;;20,000 - 50,000;2;5;-3;0;0;0
1666500;Write 'n' Fight;;0 - 20,000;6;9;-3;0;0;1
1666510;Magical Valkyrie Lyristia;;20,000 - 50,000;195;67;128;315;315;3
1666600;The Dragon Apprentice;;50,000 - 100,000;0;1;-1;0;0;0
1666660;Destruction Time!;;0 - 20,000;24;8;16;0;0;0
1666770;The New Earth;;0 - 20,000;2;0;2;0;0;0
1666810;POG 4;;0 - 20,000;10;6;4;0;0;0
1666850;More. The Eternal Utopia;;0 - 20,000;4;1;3;0;0;0
1666970;Frog Fight;;0 - 20,000;24;4;20;0;0;0
1667110;Metempsychosis;;0 - 20,000;11;9;2;0;0;6
1667120;PHYSARUM: Slime Mold Simulator;;0 - 20,000;11;2;9;0;0;0
1667160;入替人-ReplaceR-;;0 - 20,000;71;12;59;0;0;0
1667170;Claustrophobia;;0 - 20,000;10;5;5;0;0;0
1667190;奥术卡牌;;0 - 20,000;1;0;1;0;0;0
1667210;Mini ship wars;;0 - 20,000;0;4;-4;0;0;0
1667240;My name is human;;0 - 20,000;17;3;14;0;0;0
1667270;Lone McLonegan : A Western Adventure;;0 - 20,000;45;4;41;0;0;0
1667280;Fiore I: Daffodil;;0 - 20,000;0;1;-1;0;0;0
1667290;Anime Cards;;0 - 20,000;2;2;0;0;0;0
1667320;PRODUCER 2021;;50,000 - 100,000;93;0;93;0;0;0
1667400;Cute Cats;;0 - 20,000;142;12;130;0;0;1
1667490;Fostering Apocalypse;;0 - 20,000;50;3;47;0;0;0
1667540;Dragon's Vengeance;;0 - 20,000;5;1;4;0;0;0
1667590;Junebug vs. Evil;;0 - 20,000;8;0;8;0;0;0
1667720;Demon Lord Jill -REVIVAL-;;0 - 20,000;23;15;8;0;0;0
1667800;Dodge;;0 - 20,000;5;3;2;0;0;0
1667840;Slime Story;;0 - 20,000;7;0;7;0;0;0
1668010;Virtual Amusement;;0 - 20,000;1;0;1;0;0;0
1668080;Flåklypa Grand Prix;;20,000 - 50,000;152;141;11;0;0;4
1668130;orbit.industries;;20,000 - 50,000;0;0;0;0;0;0
1668190;Once Upon a Jester;;0 - 20,000;70;0;70;0;0;0
1668210;A Sad Journey;;0 - 20,000;3;1;2;0;0;0
1668480;HamsterVeRse;;0 - 20,000;0;1;-1;0;0;0
1668510;The Legend of Heroes: Trails from Zero;;0 - 20,000;526;11;515;1893;1893;57
1668510;The Legend of Heroes: Trails from Zero;;0 - 20,000;526;11;515;1893;1893;57
1668530;The Legend of Nayuta: Boundless Trails;;0 - 20,000;20;1;19;0;0;7
1668630;Escape War;;0 - 20,000;6;0;6;0;0;0
1668650;Maya Star;;0 - 20,000;5;3;2;0;0;0
1668660;Radio;;0 - 20,000;3;1;2;0;0;0
1668690;Alina of the Arena;;50,000 - 100,000;2562;216;2346;405;466;111
1668720;The Cloud Dream of the Nine;;0 - 20,000;38;7;31;0;0;4
1668780;Firelight Fantasy: Vengeance;;0 - 20,000;18;6;12;0;0;0
1668800;Maze Mania: The Ultimate 3D Maze Game;;0 - 20,000;2;0;2;0;0;0
1668810;Midsummer Madness;;0 - 20,000;1;2;-1;0;0;0
1668930;African Safari;;0 - 20,000;1;1;0;0;0;0
1668950;Pluvia - Episode I;;0 - 20,000;4;0;4;0;0;0
1668990;Our Mountain;;0 - 20,000;6;0;6;0;0;0
1669030;Indigo 7;;0 - 20,000;4;1;3;0;0;0
1669050;Beastrun;;0 - 20,000;26;13;13;0;0;0
1669120;Go Rocket;;0 - 20,000;0;1;-1;0;0;0
1669130;Retrowave Universe;;20,000 - 50,000;3;0;3;0;0;0
1669170;Northend Tower Defense;;20,000 - 50,000;478;110;368;75;110;3
1669220;Rabbit Hole;;0 - 20,000;2;1;1;0;0;0
1669330;残世界的鸢尾花;;0 - 20,000;33;2;31;0;0;0
1669340;尘埃见闻录;;0 - 20,000;87;8;79;0;0;0
1669360;Socialism Simulator;;0 - 20,000;161;5;156;0;0;2
1669390;The Tragedy of little Joy;;0 - 20,000;3;0;3;0;0;0
1669420;Islets;;0 - 20,000;383;19;364;477;477;4
1669420;Islets;;0 - 20,000;383;19;364;477;477;4
1669430;Domination;;0 - 20,000;4;1;3;0;0;0
1669560;Into the Loop;;0 - 20,000;8;0;8;0;0;0
1669820;Haunted Hotel: A Past Redeemed Collector's Edition;;0 - 20,000;5;2;3;0;0;0
1670010;Inverse Evolver;;0 - 20,000;26;5;21;0;0;2
1670070;My Personal Hilopet;;0 - 20,000;11;0;11;0;0;0
1670120;Turn the Line!;;0 - 20,000;82;5;77;0;0;1
1670200;觉梦：赛博;;0 - 20,000;0;1;-1;0;0;0
1670210;ChibiClubTD;;0 - 20,000;3;0;3;0;0;0
1670310;孑游列国;;0 - 20,000;15;5;10;0;0;0
1670320;Sky Creator;;0 - 20,000;24;7;17;0;0;0
1670700;Influence, Inc.;;0 - 20,000;13;2;11;0;0;0
1670860;CYBERUSH;;0 - 20,000;0;1;-1;0;0;0
1670870;MADiSON;;20,000 - 50,000;1539;226;1313;301;418;24
1670880;Devils Gold;;20,000 - 50,000;11;3;8;0;0;0
1670890;Lamia's Plan;;50,000 - 100,000;10;5;5;0;0;0
1671060;Ammo 666;;0 - 20,000;1;0;1;0;0;0
1671090;Ultra Boat Game!!!;;0 - 20,000;5;1;4;0;0;0
1671180;Ricochet Ranger;;0 - 20,000;12;0;12;0;0;2
1671240;Death Realm;;0 - 20,000;4;13;-9;0;0;0
1671280;Prognostic;;0 - 20,000;348;18;330;0;0;2
1671310;Trash is Fun;;0 - 20,000;18;2;16;0;0;0
1671330;Suspect Enemy;;0 - 20,000;23;4;19;0;0;0
1671350;Touhou Monster TD ~ 幻想乡妖怪塔防;;50,000 - 100,000;628;61;567;172;297;15
1671390;Ancient Dino Runner;;0 - 20,000;9;5;4;0;0;1
1671400;Waifu Covered 2 : Censored Edition;;0 - 20,000;3;1;2;0;0;0
1671410;Somerville;;0 - 20,000;301;179;122;221;221;4
1671420;Hidden Object: Detective Holmes - Heirloom;;0 - 20,000;30;2;28;0;0;2
1671440;Cliché Adventure;;20,000 - 50,000;0;1;-1;0;0;0
1671480;ABRISS - build to destroy;;20,000 - 50,000;289;35;254;0;0;4
1671500;Ancient Huntsmen;;0 - 20,000;6;2;4;0;0;0
1671550;[Chilla's Art] The Night Way Home | 帰り道;;20,000 - 50,000;163;70;93;0;0;1
1671590;Paladin's Oath;;20,000 - 50,000;65;7;58;0;0;2
1671630;Dwarves Craft. Mountain Brothers;;0 - 20,000;1;0;1;0;0;0
1671670;Splash Road;;0 - 20,000;2;4;-2;0;0;0
1671710;Golf For Fun;;0 - 20,000;10;0;10;0;0;0
1672140;Bot Wars;;50,000 - 100,000;530;37;493;112;159;5
1672170;FOOTBALLER;;0 - 20,000;8;5;3;0;0;0
1672200;Mystery Trackers: Paxton Creek Avenger Collector's Edition;;0 - 20,000;5;1;4;0;0;1
1672230;Pogo Rocket;;0 - 20,000;3;0;3;0;0;0
1672240;Surface: Lost Tales Collector's Edition;;20,000 - 50,000;3;0;3;0;0;0
1672280;Donutis Simulator;;0 - 20,000;6;3;3;0;0;0
1672340;Street Racer;;0 - 20,000;2;3;-1;0;0;0
1672350;First Samurai;;0 - 20,000;3;1;2;0;0;0
1672360;Second Samurai;;50,000 - 100,000;2;0;2;0;0;0
1672420;Wing Chun Pak Sung Bo Legends;;0 - 20,000;3;0;3;0;0;0
1672460;FLYING PUDDING;;0 - 20,000;19;0;19;0;0;0
1672610;Book of Adventum;;0 - 20,000;4;0;4;0;0;0
1672630;Mononoke Slashdown;;0 - 20,000;12;5;7;0;0;0
1672670;彷徨之街 The Street of Adrift;;50,000 - 100,000;1146;356;790;355;355;6
1672680;Kungfu Football Captain;;0 - 20,000;7;5;2;0;0;0
1672690;Across the Galaxy: Stellar Dominator;;20,000 - 50,000;24;2;22;0;0;1
1672700;Tiny Hunter;;0 - 20,000;7;0;7;0;0;0
1672780;Dice & Dungeons;;20,000 - 50,000;26;12;14;0;0;0
1672840;Nyctophobia: Devil Unleashed;;0 - 20,000;44;11;33;0;0;0
1672930;梅斯特姆;;0 - 20,000;7;9;-2;0;0;1
1672960;Endorfire Tower Defense;;0 - 20,000;13;6;7;0;0;1
1672970;Minecraft Dungeons;;500,000 - 1,000,000;6316;584;5732;1750;1798;502
1673020;All Ashes and Illusions;;0 - 20,000;23;0;23;0;0;1
1673140;FEAR background;;0 - 20,000;4;22;-18;0;0;0
1673180;That Role Playing;;0 - 20,000;3;3;0;0;0;0
1673190;Bahamut2-dragon's bride;;0 - 20,000;371;7;364;0;0;12
1673220;Meteor Genocide;;0 - 20,000;0;1;-1;0;0;0
1673230;Angle Soccer;;0 - 20,000;16;0;16;0;0;0
1673300;Shiba Mekuri 柴めくり;;0 - 20,000;1;0;1;0;0;0
1673320;Survivor;;20,000 - 50,000;110;90;20;0;0;4
1673360;MY TIME ALIVE;;0 - 20,000;8;1;7;0;0;0
1673370;Kanamono;;0 - 20,000;3;0;3;0;0;0
1673420;Demon's Residence;;0 - 20,000;21;17;4;0;0;0
1673450;Geisterland;;0 - 20,000;1;0;1;0;0;0
1673460;Swoon! Earth Escape;;0 - 20,000;1;0;1;0;0;0
1673470;Finding A Prince: The Game;;0 - 20,000;6;0;6;0;0;0
1673520;Mini Kart Racing;;0 - 20,000;3;7;-4;0;0;0
1673530;Fantasy Mahjong connect;;0 - 20,000;16;16;0;0;0;0
1673550;Barking Puzzle;;0 - 20,000;11;8;3;0;0;0
1673560;Murder on the Marine Express;;0 - 20,000;28;0;28;0;0;0
1673570;Game of Love;;0 - 20,000;8;4;4;0;0;0
1673580;Battery-out;;0 - 20,000;5;0;5;0;0;0
1673620;Rhythmetallic;;0 - 20,000;8;1;7;0;0;0
1673630;Eternal Evil;;0 - 20,000;288;72;216;0;0;3
1673650;¡Arre Unicornio!;;0 - 20,000;11;0;11;0;0;0
1673720;They're Coming;;0 - 20,000;4;0;4;0;0;0
1673840;The Absolutely Hilarious Cat Game;;0 - 20,000;13;3;10;0;0;0
1673920;50 Waves Hero;;0 - 20,000;4;2;2;0;0;0
1673940;BITGUN;;0 - 20,000;31;5;26;0;0;1
1674020;Lost in Red Valley;;0 - 20,000;4;4;0;0;0;0
1674030;Custodian: Beginning of the End;;0 - 20,000;36;9;27;0;0;0
1674060;The Search For Fran;;0 - 20,000;106;16;90;0;0;0
1674100;Subject 95;;0 - 20,000;8;6;2;0;0;0
1674160;DeHexTD;;0 - 20,000;1;0;1;0;0;0
1674170;Sprocket;;100,000 - 200,000;5983;411;5572;456;580;386
1674270;Cyberfrags '69;;0 - 20,000;112;0;112;0;0;0
1674370;战斗俄罗斯方块;;0 - 20,000;0;1;-1;0;0;0
1674440;Submarine War;;0 - 20,000;21;4;17;0;0;0
1674470;ELYON;;500,000 - 1,000,000;2421;2046;375;470;176;1
1674490;Only Me;;0 - 20,000;5;0;5;0;0;0
1674620;Construct VR - The Volumetric Movie;;0 - 20,000;63;15;48;0;0;0
1674640;XEL;;0 - 20,000;83;64;19;0;0;2
1674710;For another day;;0 - 20,000;0;3;-3;0;0;0
1674720;Rage Quit;;0 - 20,000;28;9;19;0;0;0
1674730;RGByte;;0 - 20,000;1;0;1;0;0;0
1674780;Lone Fungus;;0 - 20,000;114;5;109;0;0;3
1674820;TFC: The Fertile Crescent;;0 - 20,000;99;7;92;0;0;0
1674840;My Universe - Puppies & Kittens;;0 - 20,000;4;4;0;0;0;1
1674880;Lost Kittens: Maze Garden;;0 - 20,000;22;1;21;0;0;0
1674890;Idle Calibur;;50,000 - 100,000;1008;132;876;4284;4284;25
1674960;Marble Parkour 2: Roll and roll;;20,000 - 50,000;14;3;11;0;0;0
1674980;Viking Heroes 2;;0 - 20,000;16;0;16;0;0;4
1675020;RPG: Squad battle;;0 - 20,000;21;8;13;0;0;0
1675030;XSection;;0 - 20,000;2;0;2;0;0;0
1675040;Asfalia: Anger;;0 - 20,000;16;0;16;0;0;3
1675050;Iselin Saga;;0 - 20,000;2;1;1;0;0;0
1675090;Car Physics Simulator;;0 - 20,000;19;19;0;0;0;0
1675100;AE86 EUROBEAT DRIFT;;0 - 20,000;22;1;21;0;0;0
1675110;My Downtown;;0 - 20,000;4;0;4;0;0;1
1675130;Domum;;0 - 20,000;2;1;1;0;0;0
1675150;「３」;;0 - 20,000;2;0;2;0;0;0
1675170;VRAstroSmash;;0 - 20,000;0;2;-2;0;0;0
1675270;Hanoi Puzzles: Flip Match;;0 - 20,000;17;0;17;0;0;1
1675410;There May Be Ninety-Nine Of Us, But We Have To Win In Ninety-Nine Turns!;;0 - 20,000;1;0;1;0;0;0
1675440;Moxie's Lemon;;20,000 - 50,000;5;0;5;0;0;0
1675480;Advent Crossroad;;0 - 20,000;12;2;10;0;0;1
1675620;Last Light;;0 - 20,000;140;29;111;0;0;0
1675640;Planet B24;;0 - 20,000;34;14;20;0;0;1
1675690;WoodHeart;;0 - 20,000;4;1;3;0;0;0
1675760;Blipz;;0 - 20,000;4;1;3;0;0;1
1675910;Mavis Beacon Teaches Typing;;0 - 20,000;3;3;0;0;0;0
1675920;Jewel Match Solitaire Summertime;;0 - 20,000;15;3;12;0;0;3
1675940;江湖行;;0 - 20,000;13;8;5;0;0;0
1676030;SINGULARITY WORLD;;0 - 20,000;4;1;3;0;0;0
1676060;Beta Escape;;0 - 20,000;2;0;2;0;0;0
1676130;Deadlink;;200,000 - 500,000;701;47;654;0;0;18
1676150;Endless Boss Fight;;0 - 20,000;36;1;35;0;0;0
1676200;Underwater;;0 - 20,000;50;19;31;0;0;0
1676200;Underwater;;0 - 20,000;50;19;31;0;0;0
1676260;Calmed by the Dark Leviathan;;0 - 20,000;1;1;0;0;0;0
1676350;摆地摊;;0 - 20,000;6;5;1;0;0;0
1676380;Kingdom of Atham: Crown of the Champions;;0 - 20,000;206;43;163;0;0;13
1676380;Kingdom of Atham: Crown of the Champions;;0 - 20,000;206;43;163;0;0;13
1676390;Take town;;0 - 20,000;0;2;-2;0;0;0
1676420;Blood Labs;;0 - 20,000;2;1;1;0;0;0
1676550;Dull Grey;;20,000 - 50,000;44;6;38;0;0;0
1676560;Redux;;0 - 20,000;4;0;4;0;0;0
1676570;Kosmo Laika: Space and Beyond;;0 - 20,000;10;0;10;0;0;0
1676590;BULLET HEAT;;0 - 20,000;0;2;-2;0;0;0
1676600;末日航路-The Termination;;0 - 20,000;3;1;2;0;0;0
1676710;Robogal;;0 - 20,000;39;20;19;0;0;0
1676720;White Eyes;;0 - 20,000;1;0;1;0;0;0
1676740;Animus: Revenant;;0 - 20,000;10;9;1;0;0;0
1676740;Animus: Revenant;;0 - 20,000;10;9;1;0;0;0
1676870;ECO HOLE;;20,000 - 50,000;33;1;32;0;0;2
1676910;Onde;;0 - 20,000;110;6;104;0;0;1
1676920;Save The Octo;;0 - 20,000;13;6;7;0;0;0
1677020;Magirune 2;;0 - 20,000;15;0;15;0;0;4
1677080;Asteroid Five;;0 - 20,000;6;0;6;0;0;0
1677090;Godless;;0 - 20,000;18;2;16;0;0;4
1677140;CUCCCHI;;0 - 20,000;49;4;45;0;0;0
1677180;Neko Hacker Plus;;0 - 20,000;36;13;23;0;0;0
1677190;Twelve Floors Below.;;0 - 20,000;23;12;11;0;0;0
1677260;Oatmeal;;0 - 20,000;39;4;35;0;0;0
1677300;Gemstone Defense;;0 - 20,000;4;0;4;0;0;0
1677380;Astronium;;0 - 20,000;25;0;25;0;0;1
1677400;Black Lotus Motel;;20,000 - 50,000;14;2;12;0;0;2
1677400;Black Lotus Motel;;20,000 - 50,000;14;2;12;0;0;2
1677430;Gabriel's Worlds The Adventure;;0 - 20,000;16;0;16;0;0;0
1677480;Coral Quest;;20,000 - 50,000;3;1;2;0;0;0
1677480;Coral Quest;;20,000 - 50,000;3;1;2;0;0;0
1677490;청춘향전 Cheongchunhyang Jeon;;0 - 20,000;47;9;38;0;0;0
1677570;Vacuum Pilot;;20,000 - 50,000;148;11;137;0;0;1
1677580;My Master's A Moron;;0 - 20,000;23;3;20;0;0;1
1677620;TurBot;;0 - 20,000;15;0;15;0;0;0
1677630;In Space No One Can Hear You Clean;;20,000 - 50,000;2;0;2;0;0;0
1677650;CubeCube;;0 - 20,000;6;0;6;0;0;0
1677660;Gypsy Retro TV Media Player;;0 - 20,000;1;0;1;0;0;0
1677730;Beauty Agent;;0 - 20,000;4;21;-17;0;0;0
1677740;Stumble Guys;;2,000,000 - 5,000,000;62869;8958;53911;366;102;15310
1677770;The Case of the Golden Idol;;200,000 - 500,000;2514;23;2491;660;1137;53
1677800;Tiger Trio's Tasty Travels;;0 - 20,000;7;1;6;0;0;0
1677840;Color Your World;;0 - 20,000;4;1;3;0;0;0
1677870;Gefragt Gejagt - Das Spiel;;0 - 20,000;4;9;-5;0;0;1
1677980;Unmatched: Digital Edition;;0 - 20,000;0;0;0;0;0;13
1678030;Burn Me Alive;;0 - 20,000;31;14;17;0;0;0
1678060;Tactical Vanguard Saga;;100,000 - 200,000;0;2;-2;0;0;0
1678090;Dark Home;;0 - 20,000;12;12;0;0;0;0
1678100;Long Tail;;0 - 20,000;5;2;3;0;0;1
1678140;Shades of Sakura;;50,000 - 100,000;294;131;163;40;55;2
1678250;Old Future: Post-Apocalyptic Times;;20,000 - 50,000;23;12;11;0;0;0
1678280;Little Devourers;;0 - 20,000;9;0;9;0;0;0
1678320;Heat Death;;0 - 20,000;42;2;40;0;0;1
1678340;Side Effect;;0 - 20,000;3;0;3;0;0;0
1678360;TheBlackHouse;;0 - 20,000;2;5;-3;0;0;0
1678410;They All Come Back;;20,000 - 50,000;6;0;6;0;0;0
1678430;PowerSlave Exhumed;;0 - 20,000;455;40;415;126;126;8
1678450;StOoPiD Puzzle Game;;0 - 20,000;10;4;6;0;0;0
1678510;My Story;;0 - 20,000;5;0;5;0;0;0
1678520;Rent's Due: The Game;;0 - 20,000;11;2;9;0;0;0
1678550;Summer Mission;;0 - 20,000;4;1;3;0;0;0
1678590;Missing Love;;20,000 - 50,000;1;0;1;0;0;0
1678630;CHILDHOOD GONE: SHADOWED WAND;;0 - 20,000;1;1;0;0;0;0
1678740;Soccer Cup Solitaire;;0 - 20,000;7;2;5;0;0;0
1678750;SALIGIA;;0 - 20,000;8;8;0;0;0;0
1678760;Arcano: The Trickery;;0 - 20,000;8;2;6;0;0;0
1678770;Ecstasy Elf Shotenken -Naruru's Sexy Adventure-;;0 - 20,000;6;11;-5;3;3;1
1678860;TV Kid;;0 - 20,000;53;3;50;0;0;0
1678930;Ultimo Soccer UDC;;0 - 20,000;2;0;2;0;0;0
1678950;Panda City;;0 - 20,000;12;9;3;0;0;1
1678960;OFFICESCAPE;;0 - 20,000;12;3;9;0;0;0
1678980;Reef Rumble;;0 - 20,000;2;0;2;0;0;0
1679060;NMDC;;50,000 - 100,000;2;0;2;0;0;0
1679070;Emotion;;0 - 20,000;2;0;2;0;0;0
1679130;Spinner Breaker;;0 - 20,000;2;2;0;0;0;0
1679170;Cold Start: The Callisto;;0 - 20,000;10;1;9;0;0;1
1679180;MEMORIES;;0 - 20,000;1;0;1;0;0;0
1679180;MEMORIES;;0 - 20,000;1;0;1;0;0;0
1679200;BridgeFix 2=3-1;;0 - 20,000;16;0;16;0;0;0
1679210;The Spirit and the Mouse;;0 - 20,000;294;3;291;0;0;0
1679220;Portal Dungeon;;20,000 - 50,000;373;57;316;572;572;301
1679320;100 hidden cats 2;;50,000 - 100,000;478;31;447;69;100;0
1679330;Heroes of Yore;;0 - 20,000;6;0;6;0;0;0
1679410;Labyrinths of the World: The Game of Minds Collector's Edition;;0 - 20,000;3;3;0;0;0;0
1679490;Sphere Arena;;0 - 20,000;3;0;3;0;0;0
1679670;Prehistoric Marine Monsters;;0 - 20,000;19;20;-1;0;0;1
1679690;The Secret Blue Forest;;20,000 - 50,000;13;1;12;0;0;0
1679700;Suhoshin;;0 - 20,000;86;8;78;0;0;0
1679740;Once in Flowerlake;;0 - 20,000;68;22;46;0;0;0
1679800;Get Tanked!;;50,000 - 100,000;2;0;2;0;0;0
1679830;Chernobyl inferno;;0 - 20,000;23;2;21;0;0;1
1679840;Birb Race;;0 - 20,000;12;0;12;0;0;0
1679880;Gedaria;;0 - 20,000;6;0;6;0;0;0
1679910;Blow & Fly;;0 - 20,000;16;0;16;0;0;0
1679930;Mini Golf Worlds VR;;0 - 20,000;13;0;13;0;0;0
1680000;Rewrite+;;0 - 20,000;216;17;199;0;0;8
1680020;Oath of Miko;;0 - 20,000;17;2;15;0;0;0
1680050;DarkFighter;;20,000 - 50,000;10;3;7;0;0;1
1680070;Casual Golf;;100,000 - 200,000;2;2;0;0;0;0
1680250;Craft Craft Craft!;;0 - 20,000;23;7;16;0;0;0
1680260;Dead-End Detective: The Sixpence Strangler;;20,000 - 50,000;3;0;3;0;0;0
1680270;SaberStyle;;0 - 20,000;5;4;1;0;0;1
1680280;Amidst The Darkness;;0 - 20,000;4;2;2;0;0;0
1680300;Spades;;0 - 20,000;2;5;-3;0;0;1
1680310;Cubiverse;;0 - 20,000;16;0;16;0;0;0
1680340;Succubus With Guns;;0 - 20,000;44;35;9;0;0;2
1680380;Oozing Islands;;0 - 20,000;4;2;2;0;0;0
1680400;Argus Panoptes;;0 - 20,000;17;0;17;0;0;2
1680440;Sin-Cay;;20,000 - 50,000;1;5;-4;0;0;0
1680500;Roar of Revenge;;0 - 20,000;29;0;29;0;0;0
1680530;3AM;;0 - 20,000;8;0;8;0;0;0
1680620;Tree of Mu;;0 - 20,000;4;2;2;0;0;1
1680660;Synth Run;;20,000 - 50,000;3;2;1;0;0;0
1680670;Mango Mischief;;20,000 - 50,000;14;1;13;0;0;3
1680770;The Grass;;0 - 20,000;1;1;0;0;0;0
1680870;kana!kana?;;0 - 20,000;2;1;1;0;0;0
1680880;Forspoken;;100,000 - 200,000;3065;2252;813;754;819;498
1680890;Coldage;;100,000 - 200,000;7;0;7;0;0;0
1680900;Escape from Nowhere;;0 - 20,000;11;7;4;0;0;0
1681010;Go! Go! PogoGirl;;0 - 20,000;27;0;27;0;0;0
1681020;SPACE STORESHIP -スペースストアシップ-;;0 - 20,000;17;1;16;0;0;0
1681040;Murder Diaries 2;;0 - 20,000;25;1;24;0;0;0
1681080;New Supper Banana!;;0 - 20,000;4;1;3;0;0;0
1681110;Drunken Nuke'em;;0 - 20,000;11;2;9;0;0;1
1681120;Dark Side of Fate;;0 - 20,000;15;9;6;0;0;0
1681310;In Your Books;;0 - 20,000;9;2;7;0;0;0
1681350;时空梦魇Ⅰ代号608;;50,000 - 100,000;7;5;2;0;0;0
1681380;Haos;;0 - 20,000;1;1;0;0;0;0
1681400;Magic Adventures;;0 - 20,000;6;5;1;0;0;0
1681490;Pandora : Wild Origins;;0 - 20,000;5;2;3;0;0;0
1681510;Trenches - World War 1 Horror Survival Game;;0 - 20,000;76;20;56;0;0;0
1681520;Fifefer Island - Terrena's Adventure;;20,000 - 50,000;14;0;14;0;0;0
1681540;Latarnix Puzzle;;0 - 20,000;7;0;7;0;0;0
1681560;Hungry Bunny;;0 - 20,000;15;4;11;0;0;0
1681580;Draken - Escape from Vampire Lair;;0 - 20,000;12;17;-5;0;0;1
1681620;Mines & Dragons;;0 - 20,000;6;2;4;0;0;0
1681840;Summoners Fate;;0 - 20,000;166;12;154;0;0;3
1681860;Ultimate Sadou- tea or coffee?;;0 - 20,000;2;2;0;0;0;0
1681870;Cobra Kai 2: Dojos Rising;;0 - 20,000;20;18;2;0;0;0
1681880;NHRA Championship Drag Racing: Speed For All;;0 - 20,000;42;80;-38;0;0;2
1681890;Little League World Series Baseball 2022;;0 - 20,000;3;9;-6;0;0;0
1681920;Medieval Arms;;50,000 - 100,000;3;6;-3;0;0;0
1681970;神都不良探 Underdog Detective;;100,000 - 200,000;1639;695;944;513;515;46
1681990;Ninja Usagimaru: Two Tails of Adventure;;0 - 20,000;3;0;3;0;0;0
1682030;Dire Vengeance;;20,000 - 50,000;11;0;11;0;0;0
1682050;PropHunter;;0 - 20,000;230;34;196;92;111;29
1682060;Warriors of the Nile 2;;50,000 - 100,000;653;116;537;0;0;62
1682060;Warriors of the Nile 2;;50,000 - 100,000;653;116;537;0;0;62
1682070;ball heroes;;0 - 20,000;7;0;7;0;0;0
1682120;Welcome to Dreamville;;0 - 20,000;1;1;0;0;0;0
1682210;You Can't Finish;;0 - 20,000;8;0;8;0;0;0
1682260;Black Sheep;;20,000 - 50,000;346;295;51;59;59;22
1682320;Barn Finders VR;;0 - 20,000;5;0;5;0;0;0
1682380;Survive The Hill;;0 - 20,000;44;21;23;0;0;0
1682410;寂寞神明的心愿手记;;20,000 - 50,000;251;57;194;423;814;1
1682420;Creeping Darkness;;0 - 20,000;3;3;0;0;0;0
1682420;Creeping Darkness;;0 - 20,000;3;3;0;0;0;0
1682450;Mimir's Recruit;;0 - 20,000;14;0;14;0;0;0
1682450;Mimir's Recruit;;0 - 20,000;14;0;14;0;0;0
1682530;Exotic;;0 - 20,000;5;11;-6;0;0;0
1682550;Lost and found - What if I come and find it;;0 - 20,000;30;0;30;0;0;0
1682580;Smithy Wars;;0 - 20,000;19;6;13;0;0;0
1682600;Rolling Car;;0 - 20,000;11;6;5;0;0;0
1682610;Tank Zombie Smasher;;0 - 20,000;12;6;6;0;0;0
1682620;Ascent;;0 - 20,000;8;9;-1;0;0;0
1682840;Evorales;;0 - 20,000;13;0;13;0;0;0
1682880;Stolen Eggs;;0 - 20,000;6;5;1;0;0;0
1682890;Golden Boy;;0 - 20,000;3;3;0;0;0;0
1682950;Dream Mirror;;0 - 20,000;6;5;1;0;0;0
1682980;Azurael’s Circle: Chapter 5;;20,000 - 50,000;5;1;4;0;0;0
1683000;Geometric Sniper - Z;;0 - 20,000;24;5;19;0;0;1
1683010;Cat from the box;;0 - 20,000;3;3;0;0;0;0
1683020;Haunted Hotel: The X Collector's Edition;;0 - 20,000;10;3;7;0;0;0
1683050;Xenomare;;20,000 - 50,000;5;0;5;0;0;0
1683050;Xenomare;;20,000 - 50,000;5;0;5;0;0;0
1683090;Auction;;50,000 - 100,000;5;9;-4;0;0;0
1683100;Ultra Age;;0 - 20,000;190;35;155;0;0;1
1683140;Anima Forest;;0 - 20,000;6;0;6;0;0;0
1683200;Dark Witch Music Episode: Rudymical;;0 - 20,000;12;2;10;0;0;0
1683240;Misha Adventures;;0 - 20,000;10;12;-2;0;0;0
1683310;Heartbeat: Regret;;0 - 20,000;3;2;1;0;0;0
1683320;Power & Revolution 2021 Edition;;20,000 - 50,000;436;314;122;0;0;71
1683340;Kayak VR: Mirage;;20,000 - 50,000;522;70;452;10;12;5
1683350;Pixel Ramen - Easy Pixel Art and Pixel GIF Creator;;0 - 20,000;2;2;0;0;0;0
1683510;Runes of Avalon 2;;0 - 20,000;3;4;-1;0;0;1
1683580;SPACE DANCE;;20,000 - 50,000;8;4;4;0;0;0
1683590;Hustle Game;;0 - 20,000;9;4;5;0;0;0
1683610;Profectus;;0 - 20,000;1;0;1;0;0;0
1683620;Plan B from Outer Space: A Bavarian Odyssey;;50,000 - 100,000;20;0;20;0;0;0
1683630;Oval Racer Series - Sandbox;;0 - 20,000;1;0;1;0;0;0
1683670;Robot Labs Remake;;0 - 20,000;7;5;2;0;0;0
1683680;Longphort;;20,000 - 50,000;4;3;1;0;0;0
1683690;Skiing VR;;0 - 20,000;24;4;20;0;0;0
1683720;Hungry Fish;;100,000 - 200,000;19;5;14;0;0;0
1683730;Welcome to PINEHILLS;;0 - 20,000;7;12;-5;0;0;0
1683890;RETROLD;;0 - 20,000;15;0;15;0;0;0
1683900;Hunter Girls;;0 - 20,000;58;22;36;0;0;0
1683910;Cyber Defense;;0 - 20,000;10;1;9;0;0;0
1684010;Sail;;0 - 20,000;38;5;33;0;0;1
1684080;Toroom;;0 - 20,000;106;19;87;0;0;1
1684100;Halluci-Sabbat of Koishi;;0 - 20,000;215;8;207;0;0;0
1684120;4 Alice Magical Autistic Girls;;0 - 20,000;13;0;13;0;0;0
1684210;Horror Villa 恐怖撤锁;;0 - 20,000;25;12;13;0;0;0
1684220;SEDOMAIRI / せどまいり;;0 - 20,000;15;3;12;0;0;0
1684240;Metal Faith;;20,000 - 50,000;1;0;1;0;0;0
1684330;VGL: Imperative;;0 - 20,000;17;3;14;0;0;0
1684400;Best Month Ever!;;0 - 20,000;0;0;0;0;0;0
1684410;Seal World;;0 - 20,000;320;2;318;0;0;0
1684480;Atelier Agnes;;0 - 20,000;9;6;3;0;0;26
1684530;100 Doors: Escape from Work;;0 - 20,000;9;4;5;0;0;0
1684670;Best Forklift Operator;;0 - 20,000;146;27;119;0;0;2
1684710;CAT Interstellar: Recast;;20,000 - 50,000;31;2;29;0;0;0
1684750;I deserve a happy ending;;0 - 20,000;8;1;7;0;0;1
1684820;PEGGO!;;0 - 20,000;54;26;28;0;0;6
1684830;Meow'n'Dash;;0 - 20,000;18;1;17;0;0;0
1684840;Hot Tub Simulator;;0 - 20,000;107;22;85;0;0;0
1684870;Lifing;;0 - 20,000;3;2;1;0;0;0
1684880;Reset;;0 - 20,000;0;1;-1;0;0;0
1684900;Pop it, Please!;;0 - 20,000;27;7;20;0;0;0
1684910;Kitsune Killer;;0 - 20,000;1;3;-2;0;0;0
1684920;Dungless 2;;0 - 20,000;8;3;5;0;0;0
1684930;CULTIC;;50,000 - 100,000;3550;32;3518;225;225;46
1685020;Cat Attack;;100,000 - 200,000;2;1;1;0;0;0
1685030;Pop This Pop-It;;0 - 20,000;11;3;8;0;0;0
1685260;Asdivine Saga;;20,000 - 50,000;2;0;2;0;0;0
1685460;A-Train: All Aboard! Tourism;;0 - 20,000;88;32;56;0;0;30
1685500;简单的跑酷(Simple parkour);;0 - 20,000;2;0;2;0;0;0
1685510;Couch Combat;;0 - 20,000;20;6;14;0;0;0
1685520;Hyper Treasure - Macaronic Labyrinth;;0 - 20,000;3;2;1;0;0;0
1685550;Zombardment;;0 - 20,000;1;0;1;0;0;0
1685610;Jigsaw Frame: Relax;;0 - 20,000;11;3;8;0;0;0
1685750;Capcom Fighting Collection;;20,000 - 50,000;436;37;399;138;200;17
1685940;Highway Rampage;;0 - 20,000;4;0;4;0;0;0
1685950;Seblen: Battle!;;0 - 20,000;2;0;2;0;0;0
1686010;Rival Fury;;0 - 20,000;1;6;-5;0;0;0
1686060;Unshaded;;20,000 - 50,000;13;1;12;0;0;0
1686070;Powerjackers - VR Superhero Battle Royale;;0 - 20,000;0;1;-1;0;0;0
1686130;Deep Despair 2;;0 - 20,000;65;13;52;0;0;0
1686150;Pipe Dreamin' VR: The Big Easy;;0 - 20,000;3;2;1;0;0;0
1686150;Pipe Dreamin' VR: The Big Easy;;0 - 20,000;3;2;1;0;0;0
1686160;SAVE THE UNICORN;;0 - 20,000;3;2;1;0;0;0
1686250;StickyOrbs;;0 - 20,000;4;0;4;0;0;0
1686340;AirFighter;;0 - 20,000;13;5;8;0;0;0
1686370;Match3 mania!;;50,000 - 100,000;11;4;7;0;0;0
1686380;Pingo's Revenge;;0 - 20,000;13;0;13;0;0;0
1686440;Yoshimitsu Hatsumi;;0 - 20,000;11;6;5;0;0;0
1686480;Goddess detective;;20,000 - 50,000;7;6;1;0;0;0
1686500;Discord Bot Workshop [EARLY ACCESS];;0 - 20,000;0;10;-10;0;0;0
1686540;my fluffy life;;0 - 20,000;71;9;62;0;0;0
1686570;Plush Madness;;0 - 20,000;0;2;-2;0;0;0
1686670;Dreamlands: Cotton Candy Hunt;;0 - 20,000;6;1;5;0;0;0
1686680;The Witch Eye;;20,000 - 50,000;2;1;1;0;0;0
1686690;408 - The Forbidden Room;;0 - 20,000;7;5;2;0;0;1
1686790;P1441vr;;0 - 20,000;4;1;3;0;0;0
1686840;Loop Room;;0 - 20,000;3;1;2;0;0;0
1686850;Untangle;;0 - 20,000;21;1;20;0;0;0
1686870;中华富甲三国;;0 - 20,000;20;8;12;0;0;2
1686890;Terragon: Symbol Of Magic;;0 - 20,000;4;2;2;0;0;0
1686900;Lucky day;;0 - 20,000;6;5;1;0;0;0
1686980;TIERRA - Mystery Point & Click Adventure;;50,000 - 100,000;9;5;4;0;0;0
1687020;OneForAll;;0 - 20,000;9;3;6;0;0;0
1687030;Follow Your Heart;;0 - 20,000;12;4;8;0;0;0
1687040;Toadomination;;0 - 20,000;11;5;6;0;0;1
1687050;TeleNovela;;0 - 20,000;3;0;3;0;0;0
1687070;Ayoub Episode 1;;0 - 20,000;2;0;2;0;0;0
1687080;Bugged Dungeon;;0 - 20,000;14;0;14;0;0;0
1687100;Era of Combat: Boxing;;0 - 20,000;28;16;12;0;0;2
1687130;The Dead Rooms;;0 - 20,000;0;3;-3;0;0;0
1687150;Leaf Me Alone;;0 - 20,000;33;0;33;0;0;0
1687190;Starlight Explorers;;20,000 - 50,000;17;0;17;0;0;1
1687280;Starfighter Aces;;50,000 - 100,000;1;1;0;0;0;0
1687300;Forever Alone;;0 - 20,000;1;0;1;0;0;0
1687430;Z Mutants;;0 - 20,000;5;2;3;0;0;0
1687460;Dumb Bomb Game;;0 - 20,000;1;0;1;0;0;0
1687470;Stolen Crown;;0 - 20,000;15;0;15;0;0;1
1687480;DEX : Speed Run - Level Maker - World Records;;0 - 20,000;1;2;-1;0;0;0
1687550;Bear's Restaurant;;0 - 20,000;339;9;330;0;0;1
1687570;Rogue Rising;;0 - 20,000;2;0;2;0;0;0
1687590;Mars Base;;20,000 - 50,000;21;12;9;0;0;1
1687710;Everdine - A Lost Girl's Tale;;0 - 20,000;14;2;12;0;0;0
1687780;THE ADVENTURES OF LWANDA MAGERE;;0 - 20,000;5;1;4;0;0;0
1687940;Lolita Expedition;;20,000 - 50,000;172;8;164;0;0;5
1687950;Persona 5 Royal;;500,000 - 1,000,000;29448;790;28658;4398;2674;7762
1687980;Kselebox;;0 - 20,000;49;10;39;0;0;1
1687990;Clunky Hero;;0 - 20,000;69;9;60;0;0;5
1688030;CyberLink PowerDirector 20 Ultra;;0 - 20,000;2;1;1;0;0;1
1688040;CyberLink PowerDirector 20 Ultimate;;0 - 20,000;6;4;2;0;0;3
1688050;CyberLink PhotoDirector 13 Ultra;;0 - 20,000;0;1;-1;0;0;0
1688080;Aeternum Vale;;0 - 20,000;21;1;20;0;0;0
1688100;Cat Museum;;20,000 - 50,000;480;40;440;115;115;2
1688130;Wave Shooter;;0 - 20,000;0;2;-2;0;0;0
1688200;War Of Gold;;0 - 20,000;16;8;8;0;0;0
1688240;Escape from the Office;;0 - 20,000;17;6;11;0;0;0
1688250;PRINCESS IN AIRINESS;;0 - 20,000;2;0;2;0;0;0
1688270;I've Seen Everything;;0 - 20,000;4;2;2;0;0;0
1688290;Destroy All The Cubes;;0 - 20,000;12;1;11;0;0;2
1688340;Timore Redo;;0 - 20,000;10;0;10;0;0;0
1688390;Nightron Wars;;0 - 20,000;1;2;-1;0;0;0
1688400;B.Y.O.O.L. - Best Years Of Our Lives;;0 - 20,000;1;2;-1;0;0;0
1688470;Rat Prison;;0 - 20,000;9;4;5;0;0;0
1688520;Abyss Protection;;0 - 20,000;4;2;2;0;0;0
1688530;My Living Things;;0 - 20,000;4;0;4;0;0;0
1688580;A YEAR OF SPRINGS;;0 - 20,000;392;8;384;77;77;2
1688600;Emperial Knights;;0 - 20,000;1;0;1;0;0;0
1688750;AMV Maker for Vroid VRM and MMD Mac Supported;;0 - 20,000;85;12;73;0;0;1
1688780;Light Fighter;;0 - 20,000;4;4;0;0;0;0
1688800;Monkey Tantrum;;0 - 20,000;2;1;1;0;0;0
1688810;Mini Jumper;;0 - 20,000;3;1;2;0;0;0
1688980;Cube Runk;;50,000 - 100,000;4;0;4;0;0;0
1689020;Hidden Forest;;0 - 20,000;2;4;-2;0;0;0
1689030;VR Eagles of Victorian England;;0 - 20,000;1;0;1;0;0;0
1689060;Endless Soul Light Solitaire;;0 - 20,000;2;0;2;0;0;0
1689090;CITY WARS: TOKYO REIGN;;0 - 20,000;22;8;14;0;0;0
1689140;Altarays;;0 - 20,000;1;2;-1;0;0;0
1689150;Milena's manor house;;0 - 20,000;7;8;-1;0;0;0
1689190;RAYZE;;0 - 20,000;79;5;74;22;22;0
1689220;Unholy Alliance - Tower Defense;;0 - 20,000;4;0;4;0;0;0
1689250;GATE;;0 - 20,000;21;2;19;0;0;0
1689270;Raven's Hike;;0 - 20,000;39;3;36;0;0;0
1689310;The story of Bill Bear;;0 - 20,000;16;9;7;0;0;0
1689350;My life as an archeologist;;20,000 - 50,000;253;33;220;307;307;1
1689410;Armada;;0 - 20,000;4;1;3;0;0;0
1689420;Road Bustle;;0 - 20,000;8;1;7;0;0;0
1689510;RPGScenery;;0 - 20,000;11;9;2;0;0;2
1689520;A Cure for Jessica;;0 - 20,000;3;2;1;0;0;0
1689530;Big Fish;;0 - 20,000;1;2;-1;0;0;0
1689780;真人恋爱大冒险;;0 - 20,000;1;2;-1;0;0;0
1689870;Meridian 157: Chapter 3;;20,000 - 50,000;190;4;186;0;0;1
1689880;Killer Gin Battle Arcade;;0 - 20,000;2;0;2;0;0;0
1689910;Dōkyūsei: Bangin' Summer;;20,000 - 50,000;1130;59;1071;453;453;10
1689930;Alley Cat Bowling;;0 - 20,000;9;0;9;0;0;1
1689980;Yummy Mahjong;;20,000 - 50,000;12;3;9;0;0;1
1689980;Yummy Mahjong;;20,000 - 50,000;12;3;9;0;0;1
1690040;Metavusking;;0 - 20,000;6;4;2;0;0;1
1690060;Gelly Break Deluxe;;0 - 20,000;17;4;13;0;0;0
1690210;Sea of Dreams;;20,000 - 50,000;17;1;16;0;0;0
1690240;Emergency Crew Volcano Eruption;;0 - 20,000;5;2;3;0;0;1
1690270;Amazing Superhero Squad;;0 - 20,000;22;10;12;0;0;0
1690290;duamo;;0 - 20,000;2;0;2;0;0;0
1690340;Stand Of Arms;;0 - 20,000;3;2;1;0;0;0
1690360;Gachimuchi Life Simulator;;0 - 20,000;22;3;19;0;0;0
1690390;Escape to Mars;;0 - 20,000;4;0;4;0;0;0
1690400;Kula;;0 - 20,000;50;6;44;0;0;1
1690440;Another Tomorrow;;0 - 20,000;28;3;25;0;0;1
1690500;Meteor Storm;;0 - 20,000;4;0;4;0;0;0
1690560;Mortal Meal;;0 - 20,000;4;0;4;0;0;0
1690640;THE ILLUSION;;0 - 20,000;8;2;6;0;0;0
1690650;Zombie Survivors;;0 - 20,000;45;20;25;0;0;1
1690740;Mandacaru;;0 - 20,000;1;1;0;0;0;0
1690790;Hate Free Heroes RPG [2D/3D RPG Enhanced];;0 - 20,000;2;1;1;0;0;0
1690820;Parking Slide;;0 - 20,000;29;10;19;0;0;0
1690990;NaGongGan Infinite;;0 - 20,000;21;2;19;0;0;0
1691010;On Scene - The Horror Stories of Fred & Karen;;0 - 20,000;8;6;2;0;0;0
1691040;SonicLoop - Realtime VJ content creator for streaming, music videos and live performance;;0 - 20,000;0;1;-1;0;0;0
1691130;Bigger Bikes;;0 - 20,000;6;2;4;0;0;0
1691170;Virus ON;;0 - 20,000;12;6;6;0;0;0
1691270;Pizza Ghest;;0 - 20,000;23;8;15;0;0;2
1691290;Little adventure 2;;0 - 20,000;20;13;7;0;0;0
1691370;ball.io;;0 - 20,000;5;2;3;0;0;0
1691380;One thousand baht simulator;;0 - 20,000;5;0;5;0;0;0
1691420;START AGAIN: a prologue;;50,000 - 100,000;109;4;105;0;0;4
1691480;World Titans War;;20,000 - 50,000;39;31;8;0;0;2
1691560;Mido and Di;;50,000 - 100,000;185;151;34;0;0;1
1691620;Titanium Hound;;0 - 20,000;8;2;6;0;0;0
1691630;DOMINUS RAGE;;0 - 20,000;1;2;-1;0;0;0
1691700;Football tournament;;0 - 20,000;3;2;1;0;0;0
1691760;Survival Escape Room;;0 - 20,000;2;1;1;0;0;0
1691790;Porter in the Castle;;0 - 20,000;0;4;-4;0;0;0
1691830;Temple with traps;;0 - 20,000;0;8;-8;0;0;0
1691830;Temple with traps;;0 - 20,000;0;8;-8;0;0;0
1691860;Vizzle;;0 - 20,000;8;0;8;0;0;0
1691890;Higgs Boson: Timed Puzzle;;0 - 20,000;16;2;14;0;0;0
1691970;Danganronpa S: Ultimate Summer Camp;;0 - 20,000;178;107;71;0;0;63
1691990;Meister2;;0 - 20,000;3;3;0;0;0;0
1692000;雨音スイッチ - Amane Switch -;;0 - 20,000;5;14;-9;0;0;0
1692010;Bizarre Mutation World;;0 - 20,000;2;0;2;0;0;0
1692060;Bad Dream: Stories;;0 - 20,000;44;1;43;0;0;0
1692080;SVFI;;50,000 - 100,000;0;0;0;3793;3793;97
1692210;Trump Loves Russia;;0 - 20,000;41;11;30;0;0;0
1692220;Sneezeman: Return To Planet Sneeze;;0 - 20,000;1;0;1;0;0;0
1692250;F1 22;;500,000 - 1,000,000;13197;5875;7322;2190;1941;4430
1692280;- R E F L E C T E D -;;0 - 20,000;18;3;15;0;0;1
1692290;INHUMAN;;0 - 20,000;52;28;24;0;0;0
1692310;The Last Hope: Zombie Defense TD;;0 - 20,000;23;9;14;0;0;0
1692390;Another Cat in Dungeons;;0 - 20,000;11;0;11;0;0;0
1692400;Last Shape Standing;;0 - 20,000;5;0;5;0;0;0
1692470;The Trader;;0 - 20,000;5;2;3;0;0;0
1692520;Robots n Lasers;;0 - 20,000;2;0;2;0;0;0
1692570;Fm45's Sprite Man Adventures;;0 - 20,000;3;0;3;0;0;0
1692580;Hidden Shapes Black Skull - Jigsaw Puzzle Game;;0 - 20,000;31;1;30;0;0;1
1692590;Puzzles with cats;;0 - 20,000;5;8;-3;0;0;0
1692620;Water Physics Simulation;;0 - 20,000;32;6;26;0;0;0
1692700;SimplePlanes VR;;0 - 20,000;132;29;103;0;0;5
1692850;Historic Fighters;;50,000 - 100,000;1;1;0;0;0;0
1692890;VR Military Reporter in Middle East (with tanks & helicopters);;0 - 20,000;0;1;-1;0;0;0
1692900;CS Horizon;;0 - 20,000;5;10;-5;0;0;0
1692990;Spherical Trilogy;;0 - 20,000;3;0;3;0;0;0
1693000;Within the Range;;0 - 20,000;146;53;93;0;0;1
1693010;Pop's;;0 - 20,000;2;0;2;0;0;0
1693040;Synthwave Burnout;;20,000 - 50,000;122;16;106;0;0;0
1693060;Magic Thief;;0 - 20,000;4;2;2;0;0;0
1693090;V.R.G.;;0 - 20,000;11;0;11;0;0;1
1693100;Fomalhaut Flowers;;0 - 20,000;1;1;0;0;0;0
1693140;ONCE IN MY HEAD;;20,000 - 50,000;2;1;1;0;0;0
1693150;PROPHECY OF THE NUN;;0 - 20,000;2;11;-9;0;0;0
1693160;Zone B Korosu;;0 - 20,000;1;0;1;0;0;0
1693190;Cursed House;;0 - 20,000;20;9;11;0;0;0
1693200;Make a Path for the Chicken;;0 - 20,000;45;2;43;0;0;0
1693230;Puzzle Soccer;;0 - 20,000;10;1;9;0;0;0
1693250;Ancient Wars: Sparta Definitive Edition;;0 - 20,000;151;50;101;0;0;13
1693260;Yugo Puzzle;;0 - 20,000;176;3;173;0;0;7
1693300;Dann Fox & The Time Machine;;20,000 - 50,000;3;0;3;0;0;0
1693310;Winging It;;0 - 20,000;37;0;37;0;0;0
1693360;Dark Forest Project;;0 - 20,000;3;3;0;0;0;0
1693390;XOMBEE MPFPS;;100,000 - 200,000;3;0;3;0;0;0
1693430;Dungeon Overseer;;0 - 20,000;17;21;-4;0;0;3
1693460;KILLER;;20,000 - 50,000;2;1;1;0;0;0
1693460;KILLER;;20,000 - 50,000;2;1;1;0;0;0
1693480;Queenchantment;;0 - 20,000;17;3;14;0;0;0
1693500;Fairy Sister;;0 - 20,000;3;4;-1;0;0;0
1693540;Dash Realm;;0 - 20,000;3;0;3;0;0;0
1693580;The Hunter's Journals - Tattered Sails;;0 - 20,000;0;1;-1;0;0;0
1693610;Sudokolorful;;0 - 20,000;17;4;13;0;0;0
1693620;The Vaults of Minos;;0 - 20,000;2;0;2;0;0;0
1693650;COPPER ODYSSEY;;0 - 20,000;31;2;29;0;0;0
1693660;Cards of Patience;;0 - 20,000;19;2;17;0;0;0
1693660;Cards of Patience;;0 - 20,000;19;2;17;0;0;0
1693680;Sword Maker;;0 - 20,000;8;0;8;0;0;1
1693760;The Ditty of Carmeana;;0 - 20,000;42;2;40;0;0;0
1693780;Orbital Combat;;0 - 20,000;8;10;-2;0;0;1
1693900;Saving Ghost;;0 - 20,000;2;1;1;0;0;0
1693970;PARTY RUSH!!;;200,000 - 500,000;12;6;6;0;0;3
1693980;Dead Space;;200,000 - 500,000;18347;1638;16709;888;867;3991
1693990;虫鸣;;50,000 - 100,000;78;40;38;0;0;0
1694100;幸存者乐园;;0 - 20,000;23;5;18;0;0;0
1694120;Space Intervention;;0 - 20,000;1;1;0;0;0;0
1694150;Crate Knight;;0 - 20,000;2;0;2;0;0;0
1694180;Find the cubs;;0 - 20,000;3;12;-9;0;0;0
1694260;Moons of Ardan;;0 - 20,000;51;2;49;0;0;1
1694270;DOG'S DONUTS;;0 - 20,000;27;3;24;0;0;1
1694310;Valor;;0 - 20,000;37;2;35;0;0;0
1694320;Nilia;;20,000 - 50,000;2;0;2;0;0;0
1694380;Am Madness;;0 - 20,000;4;0;4;0;0;0
1694420;Card Survival: Tropical Island;;20,000 - 50,000;1103;35;1068;2831;2831;817
1694430;Dynamic Dungeons Editor;;0 - 20,000;78;42;36;8;8;56
1694500;The Craft of the Samurai;;0 - 20,000;9;2;7;0;0;0
1694510;Barista Simulator;;0 - 20,000;103;17;86;0;0;38
1694530;Wardwell House VR;;0 - 20,000;4;2;2;0;0;0
1694550;Hype Prototype;;0 - 20,000;15;0;15;0;0;0
1694560;A Bavarian Tale - Totgeschwiegen;;200,000 - 500,000;111;5;106;0;0;17
1694560;A Bavarian Tale - Totgeschwiegen;;200,000 - 500,000;111;5;106;0;0;17
1694600;THE HOUSE OF THE DEAD: Remake;;50,000 - 100,000;896;343;553;81;84;7
1694610;Beku;;0 - 20,000;2;2;0;0;0;0
1694620;Ragtag Racing;;50,000 - 100,000;6;2;4;0;0;0
1694640;Absurd Chess;;0 - 20,000;3;0;3;0;0;0
1694670;Apotheorasis • Lab of the Blind Gods;;0 - 20,000;36;4;32;0;0;0
1694740;Simple Sky;;0 - 20,000;1;0;1;0;0;0
1694820;The Stone of God;;0 - 20,000;3;2;1;0;0;0
1694830;The Witch Doctor;;0 - 20,000;5;0;5;0;0;1
1694840;Baptism of Fire;;0 - 20,000;1;2;-1;0;0;0
1694880;Spectrolite;;0 - 20,000;36;1;35;0;0;0
1694960;Furry Feet;;20,000 - 50,000;602;169;433;24;24;9
1694960;Furry Feet;;20,000 - 50,000;602;169;433;24;24;9
1694970;Jude;;20,000 - 50,000;0;2;-2;0;0;0
1695040;Cupid's Palace;;20,000 - 50,000;1;1;0;0;0;0
1695150;末路希冀;;0 - 20,000;13;3;10;0;0;1
1695200;星月之歌2;;0 - 20,000;21;6;15;0;0;0
1695260;Timothy and the Tower of Mu;;0 - 20,000;21;6;15;0;0;1
1695310;Pro Pain Labs;;0 - 20,000;1;2;-1;0;0;0
1695340;西湖断桥白娘子;;50,000 - 100,000;168;140;28;0;0;0
1695400;Lucky Fish Bread;;0 - 20,000;19;0;19;0;0;0
1695480;Hellblusser;;0 - 20,000;67;4;63;0;0;2
1695510;G-MODEアーカイブス19 マジカルドロップDX;;0 - 20,000;1;3;-2;0;0;0
1695600;Bunny Puzzle;;0 - 20,000;1;0;1;0;0;0
1695620;CHR$(143);;0 - 20,000;46;0;46;0;0;0
1695670;ScrewUp;;0 - 20,000;184;68;116;0;0;1
1695830;Baldur's Gate: Dark Alliance;;50,000 - 100,000;572;105;467;603;603;18
1695830;Baldur's Gate: Dark Alliance;;50,000 - 100,000;572;105;467;603;603;18
1695840;Fear Therapy;;100,000 - 200,000;1824;740;1084;142;152;74
1695970;CUBE-e;;0 - 20,000;1;4;-3;0;0;0
1696040;Paranormal Files: Ghost Chapter Collector's Edition;;0 - 20,000;5;3;2;0;0;1
1696080;Deadwater Saloon;;20,000 - 50,000;123;49;74;0;0;4
1696090;HYPERBALL TACHYON;;0 - 20,000;14;0;14;0;0;1
1696220;FixFox;;0 - 20,000;183;20;163;0;0;3
1696300;VR Pirates of the Caribbean Life Experience;;0 - 20,000;0;1;-1;0;0;0
1696310;Starveling Way;;0 - 20,000;3;4;-1;0;0;0
1696380;Mr.Knight;;0 - 20,000;2;4;-2;0;0;0
1696400;Movie Studio 18 Steam Edition;;0 - 20,000;2;7;-5;0;0;1
1696420;Movie Studio 18 Platinum Steam Edition;;0 - 20,000;2;5;-3;0;0;0
1696670;Agarta;;20,000 - 50,000;220;62;158;0;0;1
1696710;Inventory Manager;;0 - 20,000;25;10;15;0;0;1
1696720;PsiloSybil;;0 - 20,000;76;3;73;216;216;2
1696810;Railroads Online;;200,000 - 500,000;2752;648;2104;736;1092;495
1696890;Anima Toon :3D Voxel Character Animation;;0 - 20,000;10;3;7;0;0;1
1696930;Conundrum;;0 - 20,000;2;2;0;0;0;0
1696960;Lake Haven - Chrysalis;;0 - 20,000;183;2;181;0;0;2
1697060;Volcanon;;0 - 20,000;5;0;5;0;0;0
1697080;Pill Puzzle: One Move;;0 - 20,000;16;1;15;0;0;0
1697110;Grim Tranquility;;20,000 - 50,000;6;1;5;0;0;0
1697180;Amaze Adventure;;0 - 20,000;0;1;-1;0;0;0
1697190;Do 11;;0 - 20,000;22;5;17;0;0;0
1697250;Brick People;;50,000 - 100,000;1;3;-2;0;0;0
1697300;Snooker Loopy Pro;;0 - 20,000;1;1;0;0;0;0
1697420;Alien Destroyer;;0 - 20,000;9;4;5;0;0;0
1697460;Coin Pusher World;;0 - 20,000;42;4;38;0;0;18
1697470;Color by Number - Medieval Portrait;;0 - 20,000;1;0;1;0;0;1
1697540;AFTERGLOW;;0 - 20,000;2;0;2;0;0;0
1697590;Palette Swap;;0 - 20,000;14;0;14;0;0;1
1697600;Funny Truck;;0 - 20,000;32;3;29;0;0;0
1697620;TAG Police Sentri;;0 - 20,000;13;3;10;0;0;0
1697630;DROPTCH;;0 - 20,000;0;2;-2;0;0;0
1697700;Who's Lila?;;50,000 - 100,000;811;39;772;444;487;8
1697720;The Heilwald Loophole;;0 - 20,000;135;2;133;0;0;0
1697760;DC League of Super-Pets: The Adventures of Krypto and Ace;;0 - 20,000;7;1;6;0;0;1
1697790;Cybermere;;0 - 20,000;0;1;-1;0;0;0
1697810;LoBlocks;;0 - 20,000;12;0;12;0;0;0
1697880;Junkyard Truck;;0 - 20,000;450;119;331;574;574;33
1697940;The Whisperer | Le murmureur;;20,000 - 50,000;55;12;43;0;0;0
1698020;Reflection;;0 - 20,000;16;0;16;0;0;2
1698040;Multia Space Program;;0 - 20,000;2;0;2;0;0;0
1698110;Project:Special Forces;;0 - 20,000;2;4;-2;0;0;0
1698280;CAPITALISM The action board game for one player;;0 - 20,000;8;2;6;0;0;0
1698340;VEGAS 19 Edit Steam Edition;;0 - 20,000;36;12;24;0;0;14
1698400;A Day In Space;;0 - 20,000;18;5;13;0;0;0
1698440;Shape Shift Shawn Episode 1: Tale of the Transmogrified;;0 - 20,000;7;1;6;0;0;0
1698470;Roady Life;;0 - 20,000;7;4;3;0;0;0
1698520;Simple Fish Adventure;;0 - 20,000;200;22;178;0;0;0
1698570;Kursor;;0 - 20,000;40;2;38;0;0;0
1698630;Sword of the Stars: The Pit 2;;0 - 20,000;38;5;33;0;0;1
1698640;Pill Puzzle 2;;0 - 20,000;16;0;16;0;0;0
1698680;LowPolyExplorer;;0 - 20,000;3;1;2;0;0;0
1698690;Automation;;0 - 20,000;13;3;10;0;0;0
1698750;Thomas' Tales;;0 - 20,000;10;0;10;0;0;0
1698810;Fractured;;0 - 20,000;6;1;5;0;0;0
1698870;Silver Axe - The Honest Elf;;0 - 20,000;40;0;40;0;0;0
1698910;Hardcore Trivia;;0 - 20,000;0;3;-3;0;0;0
1698920;Kick It;;0 - 20,000;1;2;-1;0;0;0
1698930;Chaos Brigade;;0 - 20,000;17;0;17;0;0;0
1699120;Light Up The Room;;0 - 20,000;2;0;2;0;0;0
1699130;KaraDedeler 1989;;50,000 - 100,000;9;20;-11;0;0;0
1699320;You Have to Play This Game;;0 - 20,000;3;0;3;0;0;0
1699380;Super Shooter;;0 - 20,000;27;3;24;0;0;0
1699390;Roxy Raccoon;;0 - 20,000;31;1;30;0;0;0
1699450;POG 5;;0 - 20,000;5;2;3;0;0;0
1699460;Jubilane;;0 - 20,000;16;0;16;0;0;1
1699490;Qualia's Sweets Craft;;0 - 20,000;1;0;1;0;0;0
1699500;Move Dodge and Kill;;0 - 20,000;14;0;14;0;0;0
1699510;Reincarnation of Ocean;;0 - 20,000;0;1;-1;0;0;0
1699530;HIDEAWAY;;0 - 20,000;5;17;-12;0;0;4
1699690;Pow!;;0 - 20,000;14;0;14;0;0;0
1699740;Dungeon Danger Traps;;0 - 20,000;16;2;14;0;0;2
1699770;Plumber 2;;0 - 20,000;1;4;-3;0;0;0
1699780;Splash Jump;;0 - 20,000;7;4;3;0;0;0
1699820;The Adventures of Dinobot and Tiara!;;0 - 20,000;5;2;3;0;0;0
1699860;Parkour Tag;;0 - 20,000;150;15;135;0;0;1
1699880;Siren Head Horror Bunker VR;;0 - 20,000;3;0;3;0;0;0
1699960;Falta;;20,000 - 50,000;34;1;33;0;0;0
1699970;Brotate;;0 - 20,000;6;0;6;0;0;0
1699980;Daydream;;0 - 20,000;5;0;5;0;0;0
1700010;瀚辰书院;;0 - 20,000;1;1;0;0;0;0
1700040;Neon Nights Pinball;;0 - 20,000;9;4;5;0;0;0
1700130;Baking Bustle: Ashley’s Dream;;0 - 20,000;12;1;11;0;0;1
1700140;Hermes: Tricks of Thanatos;;0 - 20,000;14;0;14;0;0;1
1700220;东方远空界 ~ Ultimate Vitality of Imagination;;0 - 20,000;52;6;46;0;0;1
1700240;The Revenge of Sophia Red;;0 - 20,000;9;0;9;0;0;0
1700250;Cypherpunk Essentials;;0 - 20,000;49;8;41;0;0;1
1700330;Chetz!;;0 - 20,000;3;1;2;0;0;0
1700380;Twin Balls;;0 - 20,000;0;3;-3;0;0;0
1700420;FUN Platformer;;0 - 20,000;1;3;-2;0;0;0
1700450;Watashi no Kokoro!  君の事が好きです。;;0 - 20,000;3;3;0;0;0;4
1700600;ESTEN;;0 - 20,000;7;2;5;0;0;0
1700630;天下镖局;;0 - 20,000;133;77;56;0;0;6
1700680;Ki11er Clutter;;0 - 20,000;5;0;5;0;0;3
1700690;Grandma's Footsteps;;0 - 20,000;17;3;14;0;0;0
1700800;Break Bounds: Exile 越界：流放者;;20,000 - 50,000;28;3;25;0;0;2
1700870;Clanfolk;;100,000 - 200,000;1421;159;1262;62;102;183
1700890;Asteroids: Recharged;;0 - 20,000;35;8;27;0;0;1
1700920;The Last War;;0 - 20,000;0;1;-1;0;0;0
1700940;Anime Zodiac;;0 - 20,000;76;24;52;0;0;0
1700940;Anime Zodiac;;0 - 20,000;76;24;52;0;0;0
1700960;Chibi Girl VS Evil Zombie Dead;;0 - 20,000;0;1;-1;0;0;0
1701040;Hexagon World;;0 - 20,000;2;6;-4;0;0;0
1701140;Atomic Cards;;20,000 - 50,000;38;9;29;0;0;0
1701150;Cats - Classic Onet Connect;;0 - 20,000;2;1;1;0;0;1
1701190;Chessformer;;0 - 20,000;124;1;123;0;0;0
1701380;Cricket 22;;20,000 - 50,000;920;261;659;0;0;296
1701380;Cricket 22;;20,000 - 50,000;920;261;659;0;0;296
1701400;HangTogether;;0 - 20,000;1;0;1;0;0;0
1701470;Ball Partner;;0 - 20,000;4;0;4;0;0;0
1701560;RUINSMAGUS;;0 - 20,000;116;25;91;0;0;0
1701640;Trashyard;;0 - 20,000;20;12;8;0;0;0
1701650;Baklava Simulator;;0 - 20,000;8;1;7;0;0;0
1701670;Hats Are Not Allowed;;20,000 - 50,000;25;0;25;0;0;1
1701740;Noctem;;0 - 20,000;32;10;22;0;0;3
1701760;Park Rangers of The Undead;;0 - 20,000;5;1;4;0;0;0
1701820;TCSTRIKERS4;;0 - 20,000;1;1;0;0;0;0
1701830;Tangent Rush;;0 - 20,000;16;0;16;0;0;1
1701930;Catch The Donut;;0 - 20,000;9;1;8;0;0;0
1701950;Crossing Guard Joe;;0 - 20,000;9;2;7;0;0;0
1702100;Believe;;0 - 20,000;8;0;8;0;0;0
1702170;epic maze;;0 - 20,000;3;2;1;0;0;0
1702180;Goat's Tale;;0 - 20,000;273;48;225;0;0;0
1702210;Piecewise: build chat bots with blocks;;0 - 20,000;12;0;12;0;0;2
1702220;Cool Animals;;0 - 20,000;14;1;13;0;0;1
1702260;DEADCRAFT;;0 - 20,000;71;25;46;0;0;1
1702320;PIGGY: Hunt;;50,000 - 100,000;1020;229;791;9;9;14
1702330;Rune Factory 5;;20,000 - 50,000;844;195;649;3714;3714;94
1702350;Mind Space;;0 - 20,000;1;0;1;0;0;0
1702370;Combatant;;0 - 20,000;2;2;0;0;0;0
1702380;Harbor Tycoon;;0 - 20,000;0;2;-2;0;0;0
1702390;Voor De Kroon;;20,000 - 50,000;56;6;50;0;0;0
1702450;Língua;;0 - 20,000;28;1;27;0;0;0
1702540;Chimeras: Cursed and Forgotten Collector's Edition;;0 - 20,000;8;1;7;0;0;0
1702550;The Birth of an Artificial Intelligence;;20,000 - 50,000;30;8;22;0;0;0
1702740;Who dies first;;0 - 20,000;29;5;24;0;0;0
1702750;idol Live;;0 - 20,000;1;0;1;0;0;0
1702780;Infinity Tempest;;0 - 20,000;12;0;12;0;0;0
1702830;BLACKJACK and WAIFUS Hentai Version;;0 - 20,000;83;17;66;8;8;1
1702840;Paradox of Hope VR;;0 - 20,000;382;39;343;0;0;2
1702840;Paradox of Hope VR;;0 - 20,000;382;39;343;0;0;2
1702880;LinearShooter Remixed;;0 - 20,000;11;0;11;0;0;5
1703010;Burning Brick Breaker;;0 - 20,000;1;0;1;0;0;0
1703030;The Key of Rednow;;50,000 - 100,000;1;1;0;0;0;0
1703040;Decision in the Desert;;20,000 - 50,000;2;2;0;0;0;0
1703060;Conflict in Vietnam;;20,000 - 50,000;2;1;1;0;0;0
1703070;Airborne Ranger;;50,000 - 100,000;1;1;0;0;0;0
1703080;F-15 Strike Eagle;;0 - 20,000;1;0;1;0;0;0
1703090;Solo Flight;;0 - 20,000;6;1;5;0;0;0
1703100;Crusade in Europe;;100,000 - 200,000;7;1;6;0;0;0
1703120;My Wife;;0 - 20,000;7;0;7;0;0;0
1703140;Isle of Jura;;0 - 20,000;67;10;57;0;0;0
1703180;Handyman Corporation;;0 - 20,000;71;33;38;0;0;29
1703210;Box to the Box;;0 - 20,000;9;0;9;0;0;0
1703230;Colors!;;0 - 20,000;74;12;62;0;0;0
1703340;The Stanley Parable: Ultra Deluxe;;500,000 - 1,000,000;17863;1115;16748;288;263;239
1703460;Balls! Balls!;;0 - 20,000;2;4;-2;0;0;0
1703470;12 locks and keys;;20,000 - 50,000;13;10;3;0;0;0
1703480;DRAMA;;0 - 20,000;68;25;43;0;0;0
1703500;Pirates of Gravitae;;0 - 20,000;3;0;3;0;0;0
1703640;BattleGrounds : War, Tanks And Nukes;;0 - 20,000;2;3;-1;0;0;0
1703650;Hashi: Light;;0 - 20,000;12;0;12;0;0;1
1703740;HOPE VR: Progressive Meditation;;0 - 20,000;21;4;17;0;0;0
1703950;The Far Kingdoms:  Magic Mosaics;;0 - 20,000;4;2;2;0;0;0
1704060;Vtuber Simulator : Vtuber模擬器;;20,000 - 50,000;386;53;333;0;0;0
1704080;Bean Stalker;;0 - 20,000;166;25;141;39;39;0
1704130;Mithos;;0 - 20,000;0;1;-1;0;0;0
1704170;Tank Battle Royale;;0 - 20,000;2;1;1;0;0;0
1704260;Chromancy;;0 - 20,000;1;0;1;0;0;0
1704310;Burning Horns: A Bara Isekai JRPG;;0 - 20,000;11;1;10;0;0;0
1704490;Inferno;;0 - 20,000;4;0;4;0;0;0
1704490;Inferno;;0 - 20,000;4;0;4;0;0;0
1704530;100 days;;0 - 20,000;0;4;-4;0;0;0
1704540;Pico Islands;;0 - 20,000;3;0;3;0;0;0
1704620;Harrier Jump Jet;;0 - 20,000;1;0;1;0;0;0
1704630;Dogfight: 80 Years of Aerial Warfare;;20,000 - 50,000;3;0;3;0;0;0
1704640;The Ancient Art of War in the Skies;;20,000 - 50,000;5;0;5;0;0;0
1704730;Vacant Kingdom;;0 - 20,000;46;0;46;0;0;0
1704780;Pirates vs monkeys;;0 - 20,000;1;5;-4;0;0;0
1704820;GUN&DUN;;0 - 20,000;6;1;5;0;0;0
1704830;DR4X;;0 - 20,000;27;1;26;0;0;0
1704920;Scelestum;;0 - 20,000;2;1;1;0;0;0
1704980;Jigsaw Puzzle - Jack and the Beanstalk;;0 - 20,000;11;0;11;0;0;2
1705020;AimGoGoGo;;0 - 20,000;11;1;10;0;0;0
1705030;Wadality;;0 - 20,000;31;1;30;0;0;0
1705130;Super Liquid Soccer;;0 - 20,000;4;0;4;0;0;0
1705150;SKULL CHAINZ;;0 - 20,000;30;1;29;0;0;1
1705180;Gunner, HEAT, PC!;;50,000 - 100,000;1819;154;1665;184;307;110
1705220;烈山海贰;;0 - 20,000;51;9;42;0;0;2
1705350;DarkCoating;;0 - 20,000;8;0;8;0;0;0
1705480;Escape from DuFo;;0 - 20,000;10;5;5;0;0;0
1705500;Jelly;;0 - 20,000;2;2;0;0;0;0
1705540;Dungeon Arena;;0 - 20,000;5;4;1;0;0;0
1705560;Kitty Adventure;;0 - 20,000;23;7;16;0;0;0
1705580;SiNKR 3;;0 - 20,000;24;0;24;0;0;0
1705610;PushOps;;0 - 20,000;7;1;6;0;0;0
1705730;Ingredienta;;0 - 20,000;0;1;-1;0;0;0
1705860;Blind Postman;;0 - 20,000;2;1;1;0;0;0
1705870;CUBE-e 2;;100,000 - 200,000;9;5;4;0;0;1
1705880;4 Months of You;;0 - 20,000;9;3;6;0;0;0
1705930;Born Into Fear;;20,000 - 50,000;144;12;132;0;0;1
1705930;Born Into Fear;;20,000 - 50,000;144;12;132;0;0;1
1705970;LATAMAN;;0 - 20,000;1;0;1;0;0;0
1706050;Penguin Panic;;0 - 20,000;0;1;-1;0;0;0
1706060;Cubic Dweller;;0 - 20,000;1;2;-1;0;0;0
1706090;Bean and Nothingness;;0 - 20,000;82;1;81;0;0;4
1706150;Master Theft TVs;;0 - 20,000;7;0;7;0;0;0
1706170;Dark Crypt;;0 - 20,000;24;0;24;0;0;0
1706190;SudoKats;;0 - 20,000;57;2;55;0;0;0
1706210;Reloader: test_subject;;20,000 - 50,000;207;12;195;0;0;2
1706220;KOBOLOK;;0 - 20,000;19;10;9;0;0;0
1706260;Unionatic;;0 - 20,000;1;0;1;0;0;0
1706260;Unionatic;;0 - 20,000;1;0;1;0;0;0
1706270;Go Run a Dungeon;;0 - 20,000;0;2;-2;0;0;0
1706300;Venatio;;100,000 - 200,000;5;9;-4;0;0;0
1706310;Star Shift Origins;;200,000 - 500,000;46;2;44;0;0;0
1706440;Island of Girls Dreams;;0 - 20,000;4;4;0;0;0;0
1706470;Space to Grow;;0 - 20,000;8;1;7;0;0;1
1706540;Limitless Hunger;;0 - 20,000;52;6;46;0;0;0
1706570;Chupacabras: Night Hunt;;0 - 20,000;86;30;56;65;65;0
1706610;PIXASSO;;0 - 20,000;35;5;30;0;0;0
1706670;War Beasts;;0 - 20,000;20;5;15;0;0;0
1706720;Adventurers Guild;;20,000 - 50,000;1;0;1;0;0;0
1706810;ARC Alien Raid Combat;;0 - 20,000;16;6;10;0;0;0
1706870;Sven's SudokuPad;;0 - 20,000;41;3;38;0;0;16
1706890;Find Objects;;0 - 20,000;1;0;1;0;0;0
1706920;Firekeep;;0 - 20,000;20;4;16;0;0;0
1706970;Haunted Shores;;0 - 20,000;2;4;-2;0;0;0
1706980;Bookstore Simulator;;50,000 - 100,000;2;1;1;0;0;0
1707030;Axial Drift;;0 - 20,000;2;2;0;0;0;0
1707090;EscapeThisBigMaze!;;0 - 20,000;1;0;1;0;0;0
1707100;VAZIAL SAGA XX;;0 - 20,000;3;0;3;0;0;0
1707120;Cepheus Protocol Anthology Season 1;;0 - 20,000;8;0;8;0;0;0
1707220;Chicken Fall;;0 - 20,000;26;2;24;0;0;3
1707280;ShiroKuro's Adventure;;0 - 20,000;2;0;2;0;0;0
1707400;Larcin Lazer;;0 - 20,000;123;0;123;0;0;2
1707410;Aspect;;0 - 20,000;6;0;6;0;0;0
1707450;地獄廚房RPG;;0 - 20,000;4;0;4;0;0;0
1707470;Zombie Quest;;0 - 20,000;1;0;1;0;0;0
1707540;Escape From Monster;;0 - 20,000;156;78;78;0;0;1
1707560;Lost Alone Ep.1 - Sorellina;;20,000 - 50,000;71;13;58;0;0;1
1707570;Merchant's Game;;0 - 20,000;2;2;0;0;0;0
1707610;Imperium BCE;;0 - 20,000;7;5;2;0;0;1
1707630;Dungeon Conqueror;;0 - 20,000;1;0;1;0;0;0
1707650;Swords and Sandals Immortals;;20,000 - 50,000;475;49;426;0;0;14
1707650;Swords and Sandals Immortals;;20,000 - 50,000;475;49;426;0;0;14
1707690;Star Fisher;;0 - 20,000;1;0;1;0;0;0
1707720;Blood for Poppies;;20,000 - 50,000;6;3;3;0;0;0
1707740;BorderCollie Blaster;;0 - 20,000;2;0;2;0;0;0
1707770;Animals Memory: Monkeys;;0 - 20,000;13;3;10;0;0;0
1707790;Dorfs: Hammers for Hire;;0 - 20,000;17;0;17;0;0;0
1707850;Cheaphaven;;0 - 20,000;19;0;19;0;0;1
1707870;RiffTrax: The Game;;0 - 20,000;150;9;141;0;0;11
1707880;Red Brick Hotel;;0 - 20,000;0;2;-2;0;0;0
1707890;Bacteria Wars;;20,000 - 50,000;0;2;-2;0;0;0
1707890;Bacteria Wars;;20,000 - 50,000;0;2;-2;0;0;0
1708030;SpaceSeals;;20,000 - 50,000;0;2;-2;0;0;0
1708190;100 hidden rams;;0 - 20,000;161;3;158;0;0;1
1708190;100 hidden rams;;0 - 20,000;161;3;158;0;0;1
1708200;On Your Hands;;20,000 - 50,000;19;0;19;0;0;4
1708270;Running Robot Man 4;;0 - 20,000;2;1;1;0;0;0
1708290;灵异AE;;0 - 20,000;3;0;3;0;0;0
1708300;Magical Girls Second Magic;;0 - 20,000;3;0;3;0;0;0
1708410;Dudu Monkey;;0 - 20,000;3;6;-3;0;0;0
1708420;Defence Your Organism;;0 - 20,000;5;7;-2;0;0;0
1708460;Obsideo;;20,000 - 50,000;607;204;403;37;37;1
1708460;Obsideo;;20,000 - 50,000;607;204;403;37;37;1
1708470;Oh, Dungeon Master;;0 - 20,000;3;10;-7;0;0;0
1708520;F1 Manager 2022;;200,000 - 500,000;5775;2288;3487;2648;1745;1688
1708550;Cassiodora;;0 - 20,000;18;0;18;0;0;2
1708570;Those Who Came: Healing Solarus;;20,000 - 50,000;15;5;10;0;0;0
1708580;Pug With Bomb;;0 - 20,000;3;8;-5;0;0;0
1708590;The Rescue Squad;;0 - 20,000;4;2;2;0;0;0
1708610;Pretty Girls Breakout!;;0 - 20,000;16;5;11;0;0;0
1708710;Food Delivery Battle;;0 - 20,000;14;0;14;0;0;10
1708730;Traffic Chase;;0 - 20,000;7;0;7;0;0;0
1708810;COTTOn Boomerang - Saturn Tribute;;0 - 20,000;7;4;3;0;0;0
1708820;Guardian Force - Saturn Tribute;;0 - 20,000;10;2;8;0;0;1
1708970;The Prince of Landis;;0 - 20,000;9;0;9;0;0;0
1708990;Bingus: My Beloved;;0 - 20,000;64;1;63;0;0;1
1709030;AirGun;;0 - 20,000;8;1;7;0;0;0
1709050;Nitro Kid;;0 - 20,000;214;16;198;190;190;8
1709070;Car Tehc;;0 - 20,000;36;0;36;0;0;0
1709090;Candy gun;;20,000 - 50,000;0;4;-4;0;0;0
1709170;Paradise Marsh;;0 - 20,000;194;3;191;0;0;1
1709180;Solitaire Expeditions;;0 - 20,000;40;1;39;0;0;7
1709210;Love Duction! The Guide for Galactic Lovers;;0 - 20,000;10;0;10;0;0;0
1709240;Strange Investigations: Becoming Collector's Edition;;0 - 20,000;7;0;7;0;0;1
1709260;Dice Tourney;;0 - 20,000;10;11;-1;0;0;0
1709290;Laser Bounce;;0 - 20,000;4;1;3;0;0;0
1709450;Grim Tales: The Heir Collector's Edition;;20,000 - 50,000;9;1;8;0;0;1
1709460;Hot And Lovely 4;;0 - 20,000;139;32;107;13;13;0
1709500;Adorable Witch 2;;0 - 20,000;405;65;340;15;18;4
1709510;Remoteness;;0 - 20,000;68;37;31;0;0;2
1709550;Schizm: Mysterious Journey;;0 - 20,000;1;0;1;0;0;0
1709570;Delicious Fruitworld;;0 - 20,000;1;0;1;0;0;0
1709580;Tiny Robots Recharged;;0 - 20,000;18;2;16;0;0;3
1709630;Iraq War;;0 - 20,000;7;12;-5;0;0;0
1709660;Archie;;0 - 20,000;2;1;1;0;0;0
1709730;Beyond The Edge Of Owlsgard;;0 - 20,000;75;1;74;0;0;2
1709780;Cute Invaders;;0 - 20,000;15;11;4;0;0;0
1709820;Custom Machinery;;0 - 20,000;7;2;5;0;0;0
1709830;Memories of War Undead Decimation;;0 - 20,000;0;2;-2;0;0;0
1709900;Tower Tactics: Liberation;;20,000 - 50,000;659;57;602;198;201;297
1709950;Lounge zone;;0 - 20,000;9;2;7;0;0;0
1710040;SAVED;;0 - 20,000;1;0;1;0;0;0
1710100;Bing in Wonderland;;20,000 - 50,000;1010;36;974;218;218;68
1710140;Puzzle Light: Slide;;0 - 20,000;30;1;29;0;0;1
1710170;Blade of Darkness;;50,000 - 100,000;1463;90;1373;374;374;21
1710220;Walking into Walls;;0 - 20,000;0;1;-1;0;0;0
1710250;Alice Trapped Beyond Wonderland;;0 - 20,000;20;3;17;0;0;0
1710290;Helper Cat;;0 - 20,000;34;8;26;0;0;1
1710310;Route Me Mail and Delivery Co;;0 - 20,000;2;1;1;0;0;0
1710340;Inertia;;0 - 20,000;1;0;1;0;0;0
1710490;Slime Killer;;0 - 20,000;6;0;6;0;0;0
1710500;Night Hunter;;0 - 20,000;7;2;5;0;0;0
1710530;Hit Confirmed;;0 - 20,000;3;2;1;0;0;0
1710550;World of bombs;;0 - 20,000;9;2;7;0;0;0
1710580;MotoGP22;;20,000 - 50,000;633;196;437;66;113;96
1710590;Overheat;;20,000 - 50,000;4;0;4;0;0;0
1710600;Jelly 2;;0 - 20,000;1;4;-3;0;0;0
1710620;Winter Games 2023;;0 - 20,000;15;7;8;0;0;0
1710670;Tracery of Fate;;0 - 20,000;86;12;74;0;0;0
1710690;Rebels - Under the Spell of Magic (Chapter 2);;0 - 20,000;3;0;3;0;0;0
1710690;Rebels - Under the Spell of Magic (Chapter 2);;0 - 20,000;3;0;3;0;0;0
1710710;Another Dungeon;;0 - 20,000;9;11;-2;0;0;1
1710750;Slit Mouthed - 口裂け女;;0 - 20,000;47;9;38;0;0;0
1710790;Finley's - The Colour of Radiation;;0 - 20,000;1;0;1;0;0;0
1710810;Legend Of The Ape;;0 - 20,000;22;1;21;0;0;0
1710830;Super Nano Blaster;;0 - 20,000;22;0;22;0;0;0
1710870;Super Drag Race;;0 - 20,000;19;5;14;0;0;0
1710890;Let Me Die (inside);;0 - 20,000;39;15;24;0;0;0
1710970;Vacation Adventures: Park Ranger 12;;0 - 20,000;1;0;1;0;0;0
1711120;Taxi Simulator;;0 - 20,000;16;14;2;0;0;0
1711160;Jigsaw With Animals;;0 - 20,000;1;3;-2;0;0;0
1711190;BOT.vinnik Chess: Early USSR Championships;;0 - 20,000;25;1;24;0;0;0
1711230;UnScared;;0 - 20,000;3;5;-2;0;0;0
1711400;排球入门指南;;0 - 20,000;98;1;97;0;0;1
1711420;Queer Man Peering Into A Rock Pool.jpg;;0 - 20,000;67;2;65;0;0;0
1711520;Great Marble Adventure;;0 - 20,000;12;0;12;0;0;1
1711530;Justice Chronicles;;20,000 - 50,000;4;1;3;0;0;0
1711540;Ghost Sync;;0 - 20,000;3;1;2;43;43;1
1711540;Ghost Sync;;0 - 20,000;3;1;2;43;43;1
1711610;Dungeon 100;;50,000 - 100,000;978;159;819;790;790;48
1711620;Demonheart: The Ice Demon;;0 - 20,000;54;6;48;0;0;2
1711690;Aran's Bike Trip;;20,000 - 50,000;17;2;15;0;0;0
1711740;Cheftastic!: Buffet Blast;;0 - 20,000;15;0;15;0;0;4
1711840;Ninja Stealth 4;;20,000 - 50,000;54;11;43;0;0;0
1711910;Street Dreams;;0 - 20,000;5;2;3;0;0;0
1711930;Between Two Cities - Stonemaier Games;;0 - 20,000;0;1;-1;0;0;0
1711940;beVaiR;;0 - 20,000;4;1;3;0;0;0
1711950;GWENT: Rogue Mage (Single-Player Expansion);;100,000 - 200,000;458;369;89;0;0;6
1711960;Orenji-iro no Kumo;;0 - 20,000;4;3;1;0;0;0
1712020;Too Many Santas!;;20,000 - 50,000;9;0;9;0;0;0
1712030;Flyland Wars: 1 Mountain Climb;;0 - 20,000;1;0;1;0;0;0
1712120;I'm a cowboy: Western Shooter;;0 - 20,000;6;3;3;0;0;0
1712150;Sokocat - Dungeon;;0 - 20,000;32;0;32;0;0;0
1712310;Panda in the clouds;;20,000 - 50,000;14;0;14;0;0;0
1712360;Rookie Bowman;;0 - 20,000;12;0;12;0;0;0
1712370;A Day of Maintenance;;0 - 20,000;16;0;16;0;0;0
1712420;Thats Life of Ralph;;0 - 20,000;17;1;16;0;0;0
1712490;Station 17;;20,000 - 50,000;2;0;2;0;0;0
1712510;Light Crawler;;0 - 20,000;1;0;1;0;0;0
1712530;Nikhil Murthy's Syphilisation;;0 - 20,000;1;0;1;0;0;1
1712570;The Dive;;0 - 20,000;39;27;12;0;0;0
1712590;Hoverbike Escape;;0 - 20,000;3;0;3;0;0;0
1712650;WhackAKyouka;;0 - 20,000;1;1;0;0;0;0
1712670;Idle Trading Simulator;;20,000 - 50,000;5;16;-11;0;0;0
1712680;Captures;;0 - 20,000;3;0;3;0;0;0
1712690;SourceWorlds;;0 - 20,000;13;0;13;0;0;2
1712730;Aptly Rolling;;0 - 20,000;17;4;13;0;0;3
1712750;PIXELS: Digital Creatures;;0 - 20,000;27;6;21;0;0;0
1712810;Minimal Crypt;;0 - 20,000;23;0;23;0;0;0
1712820;Brave Dungeon + Dark Witch's Story : Combat;;0 - 20,000;19;1;18;0;0;3
1712840;Tiny Tina's Assault on Dragon Keep: A Wonderlands One-shot Adventure;;20,000 - 50,000;247;109;138;1630;1630;24
1712890;Desolation Tycoon;;0 - 20,000;23;4;19;0;0;0
1712950;Logic Light;;0 - 20,000;57;1;56;0;0;0
1713030;Virtual world Primus;;0 - 20,000;0;2;-2;0;0;0
1713070;Bow Man;;0 - 20,000;4;3;1;0;0;0
1713100;江湖乐子人;;0 - 20,000;6;11;-5;0;0;2
1713140;Arctictopia;;0 - 20,000;13;2;11;0;0;1
1713170;Air Hunter;;100,000 - 200,000;3;0;3;0;0;0
1713190;Neko Candy Shop;;0 - 20,000;121;23;98;0;0;0
1713210;Go Emoji Go The Maze;;0 - 20,000;1;0;1;0;0;0
1713260;Relash;;0 - 20,000;12;1;11;0;0;1
1713340;Arpsic;;0 - 20,000;1;0;1;0;0;0
1713400;Chicken Cannon!;;0 - 20,000;6;3;3;0;0;0
1713410;Metal Golem: First Contact;;50,000 - 100,000;1;0;1;0;0;0
1713450;Cat Jump;;0 - 20,000;5;3;2;0;0;0
1713470;Mike the Cat;;0 - 20,000;12;0;12;0;0;0
1713530;Station Commander;;50,000 - 100,000;3;2;1;0;0;0
1713550;Star Witch;;50,000 - 100,000;0;1;-1;0;0;0
1713620;Wolf Attack;;0 - 20,000;8;2;6;0;0;1
1713660;Awesome Puzzle;;0 - 20,000;0;5;-5;0;0;0
1713680;80's Night;;0 - 20,000;27;16;11;0;0;0
1713710;Hand with hand;;0 - 20,000;0;3;-3;0;0;0
1713720;Wall of insanity;;0 - 20,000;30;13;17;0;0;0
1713750;Ginger - The Tooth Fairy;;0 - 20,000;1;0;1;0;0;0
1713770;Fracture Hell;;0 - 20,000;4;0;4;0;0;0
1713790;Bee Craft;;0 - 20,000;1;0;1;0;0;0
1713810;Lumencraft;;50,000 - 100,000;529;119;410;63;63;21
1713830;Ark of Loif;;0 - 20,000;2;0;2;0;0;0
1713860;Shuriken;;0 - 20,000;4;2;2;0;0;0
1713880;Rising - Hungry Lizard;;0 - 20,000;2;0;2;0;0;0
1713910;Robo-Boy  Risky Venture;;20,000 - 50,000;10;1;9;0;0;0
1713990;Parasomnia;;20,000 - 50,000;10;1;9;0;0;1
1714010;The Fortress of Varnolis;;0 - 20,000;7;1;6;0;0;0
1714020;RD Mars;;0 - 20,000;9;0;9;0;0;0
1714050;SOKOBOT;;0 - 20,000;27;0;27;0;0;1
1714070;Run Run Run;;0 - 20,000;68;3;65;0;0;0
1714080;---Red---Tether-->;;0 - 20,000;44;0;44;0;0;0
1714090;Watermelon Country;;0 - 20,000;4;0;4;0;0;0
1714100;Castle: Daybreak;;0 - 20,000;4;2;2;0;0;0
1714180;Black Widow: Recharged;;0 - 20,000;26;4;22;0;0;0
1714190;Breakout: Recharged;;0 - 20,000;44;7;37;0;0;0
1714200;パズルハムスター ～地球冒険記～;;0 - 20,000;1;0;1;0;0;0
1714280;Queen of Zarkov;;50,000 - 100,000;1;2;-1;0;0;0
1714300;Typomancer in the Feather's Way;;0 - 20,000;16;3;13;0;0;0
1714350;Badlands;;0 - 20,000;4;11;-7;0;0;0
1714380;Pirates of the Sea;;0 - 20,000;6;3;3;0;0;0
1714420;Fursan al-Aqsa: The Knights of the Al-Aqsa Mosque;;50,000 - 100,000;156;7;149;0;0;1
1714430;Time's Up in Tiny Town;;0 - 20,000;2;0;2;0;0;0
1714440;Angels Cove;;20,000 - 50,000;52;13;39;0;0;0
1714460;Starry Knight;;0 - 20,000;89;15;74;0;0;1
1714580;moon: Remix RPG Adventure;;0 - 20,000;137;8;129;0;0;3
1714590;Buck Up And Drive!;;50,000 - 100,000;500;31;469;128;188;3
1714640;Infinite sky;;0 - 20,000;4;4;0;0;0;0
1714660;Camellia Train;;0 - 20,000;22;1;21;0;0;0
1714680;Slimefrog;;20,000 - 50,000;12;1;11;0;0;0
1714820;Happy VR Plantation Farm;;0 - 20,000;0;1;-1;0;0;0
1714860;邪神大陆(Evil God Land);;0 - 20,000;3;5;-2;0;0;0
1714920;Charon's Staircase;;0 - 20,000;24;4;20;0;0;4
1714960;Astero Inc.;;20,000 - 50,000;5;0;5;0;0;0
1714960;Astero Inc.;;20,000 - 50,000;5;0;5;0;0;0
1715000;Road Builder;;0 - 20,000;18;5;13;0;0;0
1715040;Outer Space: War Gears;;0 - 20,000;0;1;-1;0;0;0
1715130;Crysis Remastered;;200,000 - 500,000;3289;1499;1790;197;215;121
1715160;Howloween Hero;;0 - 20,000;33;2;31;0;0;0
1715220;Extreme Speed;;0 - 20,000;3;7;-4;0;0;0
1715250;Project Martians;;0 - 20,000;1;3;-2;0;0;0
1715290;Little Cube Trip;;0 - 20,000;4;1;3;0;0;0
1715330;Infinity Treasures;;0 - 20,000;6;0;6;0;0;0
1715350;UNDETECTED;;20,000 - 50,000;40;6;34;0;0;0
1715370;The Niflhel Day;;50,000 - 100,000;16;2;14;0;0;0
1715470;Chronicles of Sarval: Bridges of Koni;;0 - 20,000;14;1;13;0;0;0
1715500;Impossible Simplified Cube;;0 - 20,000;1;0;1;0;0;0
1715530;Medieval Wars;;0 - 20,000;5;4;1;0;0;1
1715550;夜詛YASO curse of soirée;;0 - 20,000;26;11;15;0;0;0
1715660;Angelic Waves;;0 - 20,000;5;0;5;0;0;0
1715690;REKKR: Sunken Land;;20,000 - 50,000;77;4;73;0;0;2
1715720;MouthSimulater: MelonSeedsCracker;;0 - 20,000;3;0;3;0;0;0
1715730;Boo Men;;50,000 - 100,000;1102;176;926;107;138;79
1715780;The Crafter's Defense;;0 - 20,000;5;1;4;0;0;0
1715850;NAIR;;0 - 20,000;71;2;69;0;0;0
1715950;Puzzle Box;;0 - 20,000;4;0;4;0;0;1
1715970;ZEE.END;;0 - 20,000;13;21;-8;0;0;0
1715980;Bail or Jail(OBAKEIDORO!);;0 - 20,000;128;31;97;0;0;9
1716050;Dragon Question;;0 - 20,000;5;0;5;0;0;0
1716070;Smart Home Design;;0 - 20,000;10;17;-7;0;0;2
1716120;Monster Rancher 1 & 2 DX;;20,000 - 50,000;720;90;630;995;959;34
1716140;Above the Skies;;0 - 20,000;2;1;1;0;0;0
1716150;Fated Blade;;0 - 20,000;2;1;1;0;0;0
1716160;Photo Puzzles HD;;0 - 20,000;6;0;6;0;0;1
1716180;Fill and Cross Trick or Treat 2;;0 - 20,000;2;2;0;0;0;1
1716190;Fill and Cross Trick or Treat 3;;0 - 20,000;2;0;2;0;0;0
1716200;Holiday Solitaire Easter;;0 - 20,000;2;1;1;0;0;0
1716210;Halloween Riddles Mysterious Griddlers;;0 - 20,000;4;1;3;0;0;0
1716220;Holiday Jigsaw Easter;;0 - 20,000;5;0;5;0;0;0
1716230;Holiday Jigsaw Halloween;;0 - 20,000;3;0;3;0;0;0
1716240;Holiday Jigsaw Halloween 2;;0 - 20,000;2;0;2;0;0;0
1716250;Holiday Jigsaw Thanksgiving Day;;0 - 20,000;5;0;5;0;0;0
1716260;Holiday Jigsaw Thanksgiving Day 2;;0 - 20,000;1;2;-1;0;0;0
1716270;Holiday Mosaics Halloween Puzzles;;0 - 20,000;6;0;6;0;0;0
1716280;Snatch Media Toolbox;;0 - 20,000;1;0;1;0;0;0
1716370;2033: Das Erschwachen der Macht;;0 - 20,000;4;2;2;0;0;0
1716390;Floating Farmer - Logic Puzzle;;0 - 20,000;42;2;40;0;0;0
1716440;The Forger;;0 - 20,000;5;7;-2;0;0;0
1716470;Survival Night;;0 - 20,000;1;0;1;0;0;0
1716480;Tied by your Red;;0 - 20,000;37;0;37;0;0;1
1716500;Blue Fish Yokohama;;0 - 20,000;2;0;2;0;0;2
1716530;Ramen or Jail;;0 - 20,000;2;0;2;0;0;0
1716590;Old Hunter;;0 - 20,000;4;3;1;0;0;0
1716650;Spaceship War;;0 - 20,000;1;2;-1;0;0;0
1716660;Reflections of Life: Meridiem Collector's Edition;;0 - 20,000;4;0;4;0;0;0
1716690;Click and Slay;;0 - 20,000;7;26;-19;0;0;8
1716770;Air Traffic BLITZ VR;;0 - 20,000;12;2;10;0;0;0
1716790;2 Synchro Hedgehogs;;0 - 20,000;2;0;2;0;0;0
1716830;Sumo Seals;;0 - 20,000;4;0;4;0;0;0
1716860;Run Ninja Run;;0 - 20,000;3;0;3;0;0;0
1716910;Foot Massage;;0 - 20,000;12;13;-1;0;0;1
1716940;Ancient Gods;;0 - 20,000;179;72;107;484;484;3
1716950;Gra&Vity;;0 - 20,000;15;0;15;0;0;0
1717020;Ed-0: Zombie Uprising;;0 - 20,000;75;25;50;2;2;7
1717120;Endless mahjong;;20,000 - 50,000;5;0;5;0;0;0
1717160;FiberTales: DummyKart;;0 - 20,000;2;0;2;0;0;0
1717260;My Universe - Green Adventure - Farmers Friends;;0 - 20,000;6;3;3;0;0;0
1717270;Arkanoid - Eternal Battle;;0 - 20,000;69;47;22;0;0;1
1717300;Prank!;;20,000 - 50,000;27;17;10;0;0;0
1717370;The Müll Littoral;;0 - 20,000;9;1;8;0;0;0
1717410;Prince of Qin;;0 - 20,000;51;8;43;0;0;1
1717420;Branches;;0 - 20,000;3;6;-3;0;0;0
1717510;Time on Frog Island;;0 - 20,000;99;29;70;0;0;1
1717570;Pompom;;20,000 - 50,000;59;4;55;0;0;1
1717640;Mahokenshi;;20,000 - 50,000;206;58;148;0;0;20
1717660;PIXASSO 2;;0 - 20,000;10;2;8;0;0;0
1717770;The Upturned;;0 - 20,000;560;2;558;0;0;7
1717800;Gladiator of sparta;;20,000 - 50,000;2;1;1;0;0;0
1717880;Flappy Shooter;;0 - 20,000;13;5;8;0;0;0
1717920;Kick Ball;;0 - 20,000;0;2;-2;0;0;0
1718040;Clarence Goes to the F&#%ING Store;;0 - 20,000;13;0;13;0;0;0
1718130;SCP: Secret Files;;50,000 - 100,000;2650;278;2372;266;293;15
1718160;Crimzon Clover World EXplosion;;0 - 20,000;177;5;172;54;54;1
1718240;Beaver Clicker;;0 - 20,000;27;2;25;0;0;23
1718340;极简地牢 Simple Killer;;0 - 20,000;13;0;13;0;0;0
1718400;Makber;;0 - 20,000;1;3;-2;0;0;0
1718430;Mainly at Rest;;0 - 20,000;14;12;2;0;0;0
1718560;10th Corpse;;0 - 20,000;6;4;2;0;0;0
1718570;ASTLIBRA Revision;;500,000 - 1,000,000;11617;390;11227;1835;2800;1985
1718660;Shinobi Shift;;0 - 20,000;16;0;16;0;0;2
1718740;Space Battle SVF;;20,000 - 50,000;2;1;1;0;0;0
1718870;Spaceflight Simulator;;50,000 - 100,000;2456;94;2362;1094;1115;153
1718910;Prose & Codes;;0 - 20,000;116;1;115;0;0;2
1718920;Mega Monster Party - Multiplayer AirConsole;;0 - 20,000;13;5;8;0;0;2
1719000;My Best Nightmare;;0 - 20,000;10;3;7;0;0;0
1719180;Gobby McGobblenutz Presents - The Questionably Quirky Quiz Show;;0 - 20,000;113;2;111;0;0;0
1719200;Tar Alterra Adventure Game;;20,000 - 50,000;2;0;2;0;0;0
1719210;Calculator and monsters;;0 - 20,000;0;1;-1;0;0;0
1719220;Chimeras: What Wishes May Come Collector's Edition;;0 - 20,000;4;2;2;0;0;0
1719230;Poly Racing;;0 - 20,000;1;0;1;0;0;0
1719240;Illuminaria;;0 - 20,000;43;3;40;0;0;1
1719250;Danger Zombies;;0 - 20,000;0;1;-1;0;0;0
1719390;Cards and Castles 2;;0 - 20,000;32;5;27;0;0;1
1719450;生化迷城;;0 - 20,000;1;0;1;0;0;0
1719540;Balloon Azuna;;0 - 20,000;0;3;-3;0;0;0
1719550;Platypus Adventures;;0 - 20,000;28;0;28;0;0;0
1719660;My Cute Succubus;;0 - 20,000;134;27;107;13;13;1
1719660;My Cute Succubus;;0 - 20,000;134;27;107;13;13;1
1719690;MerFight;;0 - 20,000;20;0;20;0;0;1
1719730;METROPOCRE;;0 - 20,000;7;2;5;0;0;0
1719770;Not It: Spookiest Edition;;20,000 - 50,000;20;6;14;0;0;0
1719790;Lake of Shadows;;0 - 20,000;2;1;1;0;0;0
1719830;Sex Robot Road Trip: Highway to Harrisburg;;0 - 20,000;2;0;2;0;0;0
1719880;Return home;;0 - 20,000;14;2;12;0;0;2
1719890;Mummy, mummy, mummy!;;0 - 20,000;12;3;9;0;0;2
1719960;Ada And Cal;;0 - 20,000;2;0;2;0;0;0
1719980;Creepy Mahjong;;0 - 20,000;2;0;2;0;0;2
1719990;SnakeLaw Island;;0 - 20,000;3;0;3;0;0;0
1720040;Meria and The Island of Orcs;;0 - 20,000;10;0;10;0;0;2
1720060;Earthquake escape;;0 - 20,000;1;2;-1;0;0;0
1720090;Aspire: Ina's Tale;;0 - 20,000;157;27;130;161;161;1
1720160;旅者 Travelers;;0 - 20,000;45;8;37;0;0;0
1720180;Mini Island: Autumn;;0 - 20,000;4;0;4;0;0;0
1720200;Any Fish;;0 - 20,000;0;4;-4;0;0;0
1720210;BuriBoard;;0 - 20,000;16;1;15;0;0;1
1720220;Aqua Boy;;0 - 20,000;8;1;7;0;0;0
1720240;Animation Studio Manager;;0 - 20,000;8;3;5;0;0;1
1720370;My Life Changed - Jigsaw Puzzle;;0 - 20,000;29;2;27;0;0;2
1720470;The VII Enigma;;0 - 20,000;10;0;10;0;0;0
1720510;Mass Harvest;;0 - 20,000;4;9;-5;0;0;3
1720540;Unlock Kimono Cuties;;0 - 20,000;16;7;9;0;0;0
1720580;Any Candy;;0 - 20,000;0;8;-8;0;0;0
1720600;I Love Finding Cats;;0 - 20,000;19;0;19;0;0;1
1720650;Archer's Adventure;;0 - 20,000;3;6;-3;0;0;0
1720740;WORLD OF PARANOIA;;0 - 20,000;6;0;6;0;0;0
1720750;Kingdom of Assetia: The Clicker Game;;0 - 20,000;5;7;-2;0;0;1
1720770;Cosmo 02;;50,000 - 100,000;4;0;4;0;0;0
1720770;Cosmo 02;;50,000 - 100,000;4;0;4;0;0;0
1720780;12 Labours of Hercules XIII: Wonder-ful Builder;;0 - 20,000;6;0;6;0;0;2
1720790;Door3:Insignia;;0 - 20,000;8;0;8;0;0;0
1720800;Nino Maze LOFI II;;0 - 20,000;15;0;15;0;0;0
1720850;A=B;;50,000 - 100,000;470;16;454;90;90;10
1720860;Fox Goes Hunting ;;0 - 20,000;2;3;-1;0;0;0
1720950;Zombie Killer Drift - Racing Survival;;0 - 20,000;34;8;26;0;0;1
1720960;HyperFleet;;0 - 20,000;15;0;15;0;0;0
1720980;SILO27: Crashlanded;;20,000 - 50,000;1;0;1;0;0;0
1721010;Master of the Wizards;;0 - 20,000;2;1;1;0;0;0
1721050;Office Strike War - Multiplayer Battle Royale;;0 - 20,000;3;2;1;0;0;0
1721090;Chicken Defender;;0 - 20,000;8;4;4;0;0;0
1721100;CURSES;;0 - 20,000;5;1;4;0;0;0
1721130;Magic defense 2: The Return of the Legend;;0 - 20,000;0;5;-5;0;0;0
1721150;ET Superman : Wrath of Tyrannosaurus Rex;;0 - 20,000;7;0;7;0;0;0
1721170;What Lies in the Multiverse;;0 - 20,000;369;13;356;0;0;3
1721240;Ari's Journey;;0 - 20,000;5;0;5;0;0;0
1721250;Infinity war;;0 - 20,000;0;1;-1;0;0;0
1721270;Farm Kitten - Puzzle Pipes;;0 - 20,000;57;3;54;0;0;0
1721300;from view;;0 - 20,000;4;1;3;0;0;0
1721350;Horror Night;;20,000 - 50,000;105;79;26;2;2;2
1721440;DreamWorks Dragons: Legends of The Nine Realms;;0 - 20,000;6;3;3;0;0;1
1721470;Poppy Playtime;;2,000,000 - 5,000,000;37380;10596;26784;115;58;655
1721480;Haunted Game;;0 - 20,000;3;0;3;0;0;0
1721510;Aeternum Quest;;0 - 20,000;3;0;3;0;0;0
1721520;Freon;;0 - 20,000;3;2;1;0;0;0
1721530;The Captain;;100,000 - 200,000;220;16;204;85;156;1
1721620;George: A Horror Story;;0 - 20,000;4;2;2;0;0;0
1721690;Faircroft's Antiques: The Forbidden Crypt;;0 - 20,000;7;0;7;0;0;1
1721720;战地指挥官/Battleboom;;0 - 20,000;17;14;3;0;0;0
1721800;八尾;;0 - 20,000;3;1;2;0;0;0
1721830;Skotos;;0 - 20,000;11;8;3;0;0;0
1721870;Neon Sundown;;20,000 - 50,000;269;21;248;1560;1560;4
1721890;Googass;;0 - 20,000;0;1;-1;0;0;0
1721910;CABOUS;;20,000 - 50,000;3;1;2;0;0;0
1721930;深渊;;0 - 20,000;2;1;1;0;0;0
1721940;PIXASSO 3;;0 - 20,000;31;8;23;0;0;0
1721990;MannaWars;;0 - 20,000;1;0;1;0;0;0
1722020;Old Coin Pusher Friends;;20,000 - 50,000;308;34;274;3095;3110;47
1722020;Old Coin Pusher Friends;;20,000 - 50,000;308;34;274;3095;3110;47
1722100;Sky Tale;;0 - 20,000;26;1;25;0;0;0
1722110;CAPTAIN STARONE;;0 - 20,000;4;0;4;0;0;1
1722140;Hop Step Sing! Happy People;;0 - 20,000;31;1;30;0;0;0
1722300;Deep Madness;;0 - 20,000;3;0;3;0;0;0
1722310;Spellarium 7 - Match 3 Puzzle;;0 - 20,000;3;0;3;0;0;1
1722390;Osylla;;20,000 - 50,000;10;3;7;0;0;1
1722410;Perang Laut - Maritime Warfare;;0 - 20,000;1;1;0;0;0;0
1722440;Bunch of Games;;0 - 20,000;3;2;1;0;0;0
1722520;FIND ALL 2: Middle Ages;;0 - 20,000;170;1;169;0;0;3
1722580;Alien Colosseum;;0 - 20,000;1;0;1;0;0;0
1722590;Pilie Pals;;0 - 20,000;2;0;2;0;0;0
1722620;Toree 2;;50,000 - 100,000;622;8;614;7;7;1
1722760;My Singing Monsters Playground;;0 - 20,000;105;13;92;0;0;2
1722770;Dream Girls Collection;;0 - 20,000;52;20;32;0;0;0
1722780;Witch Stone;;20,000 - 50,000;8;3;5;0;0;0
1722840;Everdell;;0 - 20,000;226;25;201;0;0;31
1722860;Munchkin Digital;;20,000 - 50,000;253;97;156;0;0;50
1722890;Power Pals;;0 - 20,000;5;1;4;0;0;0
1723050;Escape Ninja;;0 - 20,000;0;2;-2;0;0;0
1723190;Lenny Loosejocks Goes Walkabout;;0 - 20,000;14;0;14;0;0;0
1723260;CaseCracker;;100,000 - 200,000;1590;77;1513;484;534;73
1723400;Infinite Cube Defense;;0 - 20,000;2;0;2;0;0;0
1723440;Space X Collector;;0 - 20,000;0;1;-1;0;0;0
1723530;Stones Keeper;;0 - 20,000;45;16;29;0;0;1
1723560;Ballads of Hongye;;20,000 - 50,000;396;283;113;0;0;13
1723560;Ballads of Hongye;;20,000 - 50,000;396;283;113;0;0;13
1723570;Quest of Wizard;;0 - 20,000;11;0;11;0;0;1
1723700;Remy Raccoon and the Lost Temple;;0 - 20,000;1;0;1;0;0;0
1723720;Suddenly Meow;;0 - 20,000;6;3;3;0;0;0
1723730;Me Vs You;;20,000 - 50,000;3;0;3;0;0;0
1723750;BarginToWin;;0 - 20,000;1;0;1;0;0;0
1723760;Sorcerer Knights;;0 - 20,000;8;0;8;0;0;0
1723820;BLOCK HEIST: Robbery Simulator;;0 - 20,000;12;3;9;0;0;0
1723920;DANGER: ELECTRIC SHOCK;;0 - 20,000;3;1;2;0;0;0
1724000;Time Lock VR 2;;20,000 - 50,000;71;9;62;0;0;0
1724010;Need More Troops;;0 - 20,000;18;1;17;0;0;0
1724020;Space Tower Defense;;0 - 20,000;11;7;4;0;0;1
1724060;Always The Same Nightmare;;0 - 20,000;4;0;4;0;0;0
1724060;Always The Same Nightmare;;0 - 20,000;4;0;4;0;0;0
1724070;Don't Hate My Music Taste;;0 - 20,000;1;1;0;0;0;0
1724120;ASTRONAUTILUS;;0 - 20,000;37;1;36;0;0;0
1724130;QUICKDRAW;;0 - 20,000;12;1;11;0;0;0
1724160;Heart & Soul;;0 - 20,000;16;1;15;0;0;2
1724180;Caves Of Mars;;0 - 20,000;1;0;1;0;0;0
1724290;Outergalactic Aliens Pinball;;100,000 - 200,000;5;1;4;0;0;0
1724320;Noelle Does Her Best!;;0 - 20,000;246;44;202;582;582;8
1724360;Stationery Frontier;;0 - 20,000;1;0;1;0;0;0
1724390;Power Chord;;0 - 20,000;61;21;40;0;0;20
1724410;Raster Prime [REMIX];;50,000 - 100,000;2;0;2;0;0;0
1724420;Ultra Thunderball;;20,000 - 50,000;1;0;1;0;0;0
1724440;Epic Fantasy Battle Simulator;;20,000 - 50,000;265;24;241;185;185;3
1724470;Valkyrie: Journey To Midgard;;200,000 - 500,000;7;4;3;0;0;0
1724510;Detective Gman;;20,000 - 50,000;2;0;2;0;0;0
1724530;Robo Go;;0 - 20,000;1;5;-4;0;0;0
1724570;Plunger Simulator;;0 - 20,000;3;0;3;0;0;0
1724580;Terrain Defender;;0 - 20,000;1;0;1;0;0;0
1724630;S.I.N. Unit: Ghost Investigation & Removal;;0 - 20,000;24;19;5;0;0;0
1724670;明途之境;;0 - 20,000;2;0;2;0;0;0
1724700;Almazy;;0 - 20,000;2;0;2;0;0;0
1724780;Carrot Girl Adventures;;0 - 20,000;12;5;7;0;0;0
1724840;Maken-shi Sara;;0 - 20,000;15;3;12;0;0;0
1724880;Animation Sketchpad;;0 - 20,000;8;5;3;0;0;0
1724910;幻想曹操传 Fantasy of Caocao;;0 - 20,000;46;107;-61;0;0;0
1725130;Nightmare: Les Origines;;0 - 20,000;14;10;4;0;0;0
1725330;Paradise;;0 - 20,000;3;4;-1;0;0;0
1725350;Mari and Bayu - The Road Home;;0 - 20,000;15;2;13;0;0;0
1725360;looK INside - Chapter 2;;0 - 20,000;24;6;18;0;0;0
1725430;Big FLAPPY Tower VS Tiny Square;;0 - 20,000;17;0;17;0;0;0
1725440;House of Rules;;20,000 - 50,000;107;10;97;0;0;1
1725440;House of Rules;;20,000 - 50,000;107;10;97;0;0;1
1725470;Enionax;;0 - 20,000;11;3;8;0;0;0
1725480;Follow The Cat;;0 - 20,000;10;4;6;0;0;0
1725620;Love, Death & Veggies;;20,000 - 50,000;39;0;39;0;0;0
1725640;Sudocats;;0 - 20,000;505;5;500;0;0;15
1725640;Sudocats;;0 - 20,000;505;5;500;0;0;15
1725680;YouRiding - Surfing and Bodyboarding Game;;0 - 20,000;25;7;18;0;0;1
1725860;Keng's Little Universe;;0 - 20,000;18;3;15;0;0;2
1725880;Project SNAQE;;0 - 20,000;11;1;10;0;0;1
1725950;魔塔地牢;;20,000 - 50,000;97;32;65;907;1312;54
1726050;Neon Depth;;0 - 20,000;17;0;17;0;0;1
1726120;Cursed to Golf;;100,000 - 200,000;292;70;222;114;114;6
1726180;Old Gods;;50,000 - 100,000;1;0;1;0;0;0
1726190;No Straight Roads: Encore Edition;;20,000 - 50,000;778;62;716;107;107;10
1726290;The Last Defense;;0 - 20,000;1;3;-2;0;0;0
1726330;Game Developer Simulator;;0 - 20,000;2;4;-2;0;0;0
1726360;Peter's Adventures in English [Learn English];;0 - 20,000;37;6;31;0;0;0
1726400;The Death | Thần Trùng;;50,000 - 100,000;2549;187;2362;157;170;5
1726410;Seal of Evil;;0 - 20,000;13;1;12;0;0;1
1726450;Flyland Wars: 2 Not Yours Mine;;20,000 - 50,000;1;0;1;0;0;0
1726590;Marble Mage;;0 - 20,000;10;1;9;0;0;0
1726590;Marble Mage;;0 - 20,000;10;1;9;0;0;0
1726690;Star Age: Space Combat;;0 - 20,000;1;0;1;0;0;0
1726730;You Must;;0 - 20,000;182;53;129;0;0;1
1726760;Curse Crackers: For Whom the Belle Toils;;0 - 20,000;88;2;86;0;0;5
1726790;Surface: Virtual Detective Collector's Edition;;0 - 20,000;2;0;2;0;0;0
1726850;Droopy Balls Simulator 2021;;0 - 20,000;17;1;16;0;0;0
1726860;Apocalyptic Adventure: Episode 1;;0 - 20,000;4;2;2;0;0;0
1726870;Nebraska;;20,000 - 50,000;48;12;36;0;0;2
1726870;Nebraska;;20,000 - 50,000;48;12;36;0;0;2
1726970;Where's My Lunch?!;;0 - 20,000;2;0;2;0;0;0
1727000;YuuYuu Jiteki no Yuukarin;;0 - 20,000;201;17;184;0;0;1
1727020;爆战联盟;;20,000 - 50,000;5;5;0;0;0;1
1727090;RX Racing 2021 Pro;;0 - 20,000;1;0;1;0;0;0
1727140;CYNOROID FORSAKEN;;0 - 20,000;10;1;9;0;0;0
1727180;NeverAwake;;0 - 20,000;97;4;93;0;0;1
1727220;Summoner's Mess;;0 - 20,000;76;2;74;0;0;0
1727250;The Hero of Bangaona;;0 - 20,000;1;1;0;0;0;0
1727260;Puzzle Fever;;100,000 - 200,000;1;0;1;0;0;1
1727310;Project: Cow;;0 - 20,000;4;0;4;0;0;0
1727320;Phoenix Pro Theater Media Player;;0 - 20,000;8;1;7;0;0;0
1727400;Captain Diarrhea and The Shartening;;0 - 20,000;6;0;6;0;0;0
1727420;Midinous;;0 - 20,000;25;1;24;0;0;0
1727430;BASIC ROGUE;;20,000 - 50,000;3;0;3;0;0;0
1727450;Secrets of the Middle Ages;;0 - 20,000;1;8;-7;0;0;0
1727500;Time Keeper;;0 - 20,000;1;1;0;0;0;0
1727520;Yamafuda! 2nd station;;0 - 20,000;135;0;135;0;0;2
1727660;Space Yandere;;20,000 - 50,000;28;0;28;0;0;0
1727670;Home Office Tasker;;0 - 20,000;20;7;13;0;0;0
1727720;Fuzor;;0 - 20,000;2;2;0;0;0;0
1727750;Old Salt;;0 - 20,000;0;1;-1;0;0;0
1727810;Diamond Hands: To The Moon;;0 - 20,000;31;7;24;0;0;0
1727840;The Judgement of Q;;0 - 20,000;6;0;6;0;0;0
1727860;Happy Bones Infernal;;0 - 20,000;7;0;7;0;0;0
1727910;Hope Trigger;;0 - 20,000;4;0;4;0;0;0
1727990;13 WOOD ST;;0 - 20,000;0;1;-1;0;0;0
1728010;Drowned Helicopter;;0 - 20,000;4;2;2;0;0;0
1728020;Plague Infection;;0 - 20,000;0;2;-2;0;0;0
1728080;Roseblight;;100,000 - 200,000;9;2;7;0;0;1
1728100;Wild West Rogue;;0 - 20,000;4;0;4;0;0;0
1728110;Auto Mechanic;;0 - 20,000;1;8;-7;0;0;0
1728120;Desert War;;0 - 20,000;5;4;1;0;0;0
1728130;Alone: Recode;;0 - 20,000;4;0;4;0;0;0
1728160;Flipping Beat;;0 - 20,000;2;0;2;0;0;0
1728180;Astral Shipwright;;0 - 20,000;3;5;-2;0;0;0
1728300;狂の世界-Crazy World-;;0 - 20,000;1;3;-2;0;0;0
1728390;Phantom Thief Mew's Secret Prima;;0 - 20,000;14;0;14;0;0;1
1728410;THORN DEMON HUNTER;;0 - 20,000;3;1;2;0;0;0
1728430;I wanna go home;;0 - 20,000;9;1;8;0;0;0
1728460;阴缘;;20,000 - 50,000;24;12;12;0;0;0
1728500;Kirkileons;;0 - 20,000;1;0;1;0;0;0
1728520;Xuan-Yuan Sword V;;0 - 20,000;31;22;9;0;0;8
1728560;致命游戏-Lethal Gamble 1 Werewolf Puzzle;;20,000 - 50,000;6;3;3;0;0;0
1728660;Rush Rally Origins;;0 - 20,000;121;7;114;145;145;2
1728680;Legendary Tales: Stolen Life;;0 - 20,000;23;1;22;0;0;3
1728690;Legendary Tales: Cataclysm;;0 - 20,000;16;1;15;0;0;4
1728700;Terranova;;0 - 20,000;14;1;13;0;0;1
1728770;Penguin Quest;;20,000 - 50,000;2;5;-3;0;0;0
1728830;Space Docker VR;;0 - 20,000;70;2;68;0;0;1
1728840;Beneath the Mountain;;50,000 - 100,000;95;40;55;18;18;4
1728880;CANNON;;0 - 20,000;15;9;6;0;0;0
1728960;Evolution of War;;20,000 - 50,000;0;1;-1;0;0;0
1729050;The Fox in the Forest;;0 - 20,000;14;0;14;0;0;1
1729060;Battle Brigade;;0 - 20,000;0;3;-3;0;0;0
1729090;Chameneon;;20,000 - 50,000;30;2;28;0;0;0
1729100;Chameleon - DYH;;0 - 20,000;4;0;4;0;0;0
1729150;Mysterious warrior;;0 - 20,000;12;3;9;0;0;1
1729160;Heartseeker;;0 - 20,000;23;0;23;0;0;0
1729170;Eternal Warfare;;0 - 20,000;17;0;17;0;0;2
1729210;Xtreme Aces Racing;;0 - 20,000;1;2;-1;0;0;0
1729250;Dashpong;;0 - 20,000;16;0;16;0;0;1
1729300;PlayForm: Human Dynamics;;0 - 20,000;71;7;64;0;0;1
1729340;Midnight School Walk 真夜中学園さんぽ;;0 - 20,000;2;0;2;0;0;0
1729410;Earthling's Undertaking;;50,000 - 100,000;551;175;376;89;89;32
1729420;PaintballX;;0 - 20,000;79;41;38;0;0;0
1729660;Hyper Bullet;;0 - 20,000;1;0;1;0;0;0
1729730;MageRun;;0 - 20,000;7;0;7;0;0;0
1729780;Gladiator: about to die;;0 - 20,000;7;7;0;0;0;1
1729790;Escape From School;;20,000 - 50,000;320;125;195;0;0;19
1729810;ボク姫PROJECT;;0 - 20,000;2;0;2;0;0;1
1729820;Eyeballs are your ENEMIES!;;0 - 20,000;1;0;1;0;0;0
1729840;Core Alpha;;0 - 20,000;4;2;2;0;0;0
1729900;Rhythm Brawl;;0 - 20,000;100;36;64;0;0;0
1729920;Wild West Z;;0 - 20,000;1;4;-3;0;0;0
1730000;Sqroma;;0 - 20,000;51;0;51;0;0;0
1730030;Skeleton Troubles;;100,000 - 200,000;4;5;-1;0;0;0
1730050;Last Minute;;0 - 20,000;2;2;0;0;0;0
1730060;Deep Space Salvage Crew VR;;0 - 20,000;12;6;6;0;0;1
1730090;Evil Soul;;0 - 20,000;4;2;2;0;0;0
1730110;Dinogotchi;;0 - 20,000;37;2;35;0;0;0
1730140;LIGHT: Black Cat & Amnesia Girl;;0 - 20,000;49;5;44;0;0;1
1730160;MoveUp;;0 - 20,000;2;0;2;0;0;0
1730170;Bull3000VRTS;;0 - 20,000;3;0;3;0;0;0
1730260;Retro Gadgets;;20,000 - 50,000;167;6;161;243;382;15
1730310;The Lonely Helmet;;0 - 20,000;6;0;6;0;0;0
1730340;FBG Arcade Machine;;0 - 20,000;6;0;6;0;0;0
1730360;I'm on Observation Duty 4;;20,000 - 50,000;484;9;475;0;0;13
1730380;World of MiniMonsters;;0 - 20,000;3;0;3;0;0;0
1730390;Your Show Has Been Cancelled;;0 - 20,000;4;0;4;0;0;0
1730450;Fira;;0 - 20,000;4;0;4;0;0;0
1730450;Fira;;0 - 20,000;4;0;4;0;0;0
1730540;Alchemistry;;0 - 20,000;11;4;7;0;0;2
1730590;The Entropy Centre;;50,000 - 100,000;1252;88;1164;159;193;11
1730630;The Dawning Clocks Of Time;;200,000 - 500,000;29;2;27;0;0;1
1730680;Klonoa Phantasy Reverie Series;;20,000 - 50,000;1163;34;1129;1014;1014;6
1730690;Anxiety Treatment with Relaxation;;0 - 20,000;0;1;-1;0;0;0
1730750;Hunkenstein;;0 - 20,000;5;3;2;0;0;0
1730750;Hunkenstein;;0 - 20,000;5;3;2;0;0;0
1730760;Color Connect;;0 - 20,000;19;1;18;0;0;1
1730800;Neutron and the Tri-Spark;;0 - 20,000;0;1;-1;0;0;0
1730820;FamilyWorldRoam;;0 - 20,000;3;3;0;0;0;0
1730840;Fantasy Gardens;;0 - 20,000;8;1;7;0;0;0
1730920;Hatch;;0 - 20,000;50;19;31;0;0;2
1730980;死前30天;;0 - 20,000;11;4;7;0;0;0
1731040;Shawarma or Shaverma;;50,000 - 100,000;10;3;7;0;0;0
1731120;Cloud Escape;;0 - 20,000;29;3;26;0;0;0
1731200;TRATRITLE;;0 - 20,000;433;34;399;459;459;5
1731200;TRATRITLE;;0 - 20,000;433;34;399;459;459;5
1731340;YARG;;0 - 20,000;3;0;3;0;0;0
1731360;中国战疫;;0 - 20,000;22;9;13;0;0;0
1731450;Yarn;;0 - 20,000;4;0;4;0;0;0
1731460;LEGO Brawls;;0 - 20,000;76;20;56;0;0;15
1731470;Storms 2;;0 - 20,000;6;1;5;0;0;0
1731490;Alien Hunt;;50,000 - 100,000;0;6;-6;0;0;0
1731520;Ark Mobius: Censored Edition;;50,000 - 100,000;828;47;781;32;39;2
1731630;Extrorb;;0 - 20,000;2;0;2;0;0;0
1731690;Night Darkness;;0 - 20,000;4;6;-2;0;0;0
1731700;Escape The Outbreak;;0 - 20,000;3;0;3;0;0;0
1731730;Snowyland;;0 - 20,000;26;1;25;0;0;0
1731820;DEBIE ZONE;;0 - 20,000;0;2;-2;0;0;0
1731850;Prop Factory;;0 - 20,000;2;0;2;0;0;0
1731860;Space Adventures;;0 - 20,000;1;4;-3;0;0;0
1731870;Viral Firar;;50,000 - 100,000;180;34;146;0;0;0
1731880;Upgrade VR;;0 - 20,000;12;3;9;0;0;0
1731930;Engineer Alpha;;0 - 20,000;12;1;11;0;0;0
1731940;Lost in Space;;0 - 20,000;16;19;-3;0;0;0
1732060;Makai Kingdom: Reclaimed and Rebound;;0 - 20,000;83;7;76;0;0;9
1732070;ZHP: Unlosing Ranger vs. Darkdeath Evilman;;0 - 20,000;29;8;21;0;0;37
1732090;Words Can Kill;;0 - 20,000;43;16;27;0;0;3
1732130;Motivational Hero;;0 - 20,000;17;0;17;0;0;0
1732140;Motivational Hero Vol. 2;;0 - 20,000;18;0;18;0;0;0
1732190;FATAL FRAME / PROJECT ZERO: Maiden of Black Water;;100,000 - 200,000;3713;944;2769;965;1311;88
1732260;Lucent Bounds;;0 - 20,000;3;0;3;0;0;0
1732310;Her Jentle Hi-ness;;0 - 20,000;4;0;4;0;0;0
1732330;Ys IX -Monstrum NOX-;;0 - 20,000;189;17;172;0;0;29
1732340;DEMON GAZE EXTRA;;0 - 20,000;33;15;18;0;0;5
1732390;Nayuta no Kiseki: KAI;;0 - 20,000;50;5;45;0;0;9
1732480;Takkoman -Kouzatsu World-;;0 - 20,000;25;1;24;0;0;0
1732590;玄龙山;;0 - 20,000;1;0;1;0;0;0
1732650;Fighting Robots;;0 - 20,000;108;51;57;0;0;3
1732660;Car Wash TD - Tower Defense;;0 - 20,000;5;1;4;0;0;0
1732720;周松传;;0 - 20,000;6;3;3;0;0;1
1732730;Captures II;;0 - 20,000;3;0;3;0;0;0
1732740;Sakura Hime;;20,000 - 50,000;1089;81;1008;32;29;4
1732740;Sakura Hime;;20,000 - 50,000;1089;81;1008;32;29;4
1732750;Havsala: Into the Soul Palace;;100,000 - 200,000;454;14;440;0;0;0
1732800;Cascade Tactics;;20,000 - 50,000;21;4;17;0;0;0
1732840;Destruction Dummies;;0 - 20,000;7;3;4;0;0;0
1732920;Bulanci;;20,000 - 50,000;141;52;89;73;73;1
1733030;Knights of the Tiny Table;;0 - 20,000;23;4;19;0;0;0
1733060;Ever Seen A Cat?;;20,000 - 50,000;465;3;462;0;0;2
1733090;Station 35;;0 - 20,000;2;0;2;0;0;0
1733100;The Twins' Experiment;;0 - 20,000;6;0;6;0;0;0
1733140;n2222;;0 - 20,000;1;0;1;0;0;0
1733190;Danplace;;0 - 20,000;4;2;2;0;0;0
1733230;Vortex;;0 - 20,000;2;0;2;0;0;0
1733310;One Fateful Night;;0 - 20,000;2;1;1;0;0;0
1733400;The Final Frontier;;0 - 20,000;1;0;1;0;0;0
1733430;RUM - Rust Utility Mod;;0 - 20,000;2;1;1;0;0;1
1733480;Diner Bros Inc;;0 - 20,000;11;2;9;0;0;0
1733500;Looking for Aliens;;0 - 20,000;120;1;119;0;0;5
1733610;Alpine - The Simulation Game;;0 - 20,000;16;16;0;287;287;0
1733660;Lawnmower Game: Battle;;0 - 20,000;30;5;25;0;0;0
1733680;战国异闻录;;0 - 20,000;112;34;78;0;0;5
1733830;Selfmade Devil;;0 - 20,000;2;0;2;0;0;0
1733840;Yurukill: The Calumniation Games;;0 - 20,000;31;6;25;0;0;3
1733860;Slime Factory;;0 - 20,000;2;10;-8;0;0;0
1733880;Gunvolt Chronicles: Luminous Avenger iX 2;;50,000 - 100,000;244;98;146;166;166;3
1733890;Warhammer 40,000: Battle Sister;;50,000 - 100,000;225;113;112;53;57;0
1733950;Galaxy's Edge;;0 - 20,000;1;0;1;0;0;0
1734160;Search of Galaxy;;0 - 20,000;13;6;7;0;0;2
1734230;WHATEVER;;0 - 20,000;11;1;10;0;0;1
1734250;Triple Take;;0 - 20,000;41;0;41;0;0;0
1734310;Dungeon Delvers;;0 - 20,000;1;0;1;0;0;0
1734320;Brutal Orchestra;;20,000 - 50,000;604;12;592;0;0;17
1734320;Brutal Orchestra;;20,000 - 50,000;604;12;592;0;0;17
1734330;POWERTRIP;;0 - 20,000;1;1;0;0;0;0
1734350;Chronomaster;;20,000 - 50,000;1;0;1;0;0;0
1734370;Timewreck Tales: A Rogue RPG;;50,000 - 100,000;4;1;3;0;0;0
1734390;The Pioneers: Surviving Desolation;;20,000 - 50,000;170;51;119;0;0;16
1734400;Mental Hospital - Child of Evil;;0 - 20,000;25;11;14;0;0;0
1734470;ROUGH KUTS: The Thirsty Dead;;20,000 - 50,000;10;2;8;0;0;0
1734470;ROUGH KUTS: The Thirsty Dead;;20,000 - 50,000;10;2;8;0;0;0
1734480;Neondrops;;0 - 20,000;2;0;2;0;0;0
1734540;PUPPETEERS;;0 - 20,000;13;30;-17;0;0;2
1734560;Kingdom of Heroes;;0 - 20,000;1;0;1;0;0;0
1734610;Robosnow;;0 - 20,000;10;5;5;0;0;0
1734790;The Cruel kings;;0 - 20,000;10;1;9;0;0;0
1734810;Cubyrinth;;0 - 20,000;2;0;2;0;0;0
1734820;Pixelpart;;0 - 20,000;8;0;8;0;0;0
1734870;Shiba Army;;0 - 20,000;7;3;4;0;0;0
1734890;Visual Novel Sisters;;20,000 - 50,000;17;3;14;0;0;0
1734900;Inspector Detective: Private Eye;;0 - 20,000;4;1;3;0;0;0
1734960;POWERNAUT 2;;0 - 20,000;3;2;1;0;0;0
1734970;Planet Hotpot;;0 - 20,000;2;0;2;0;0;0
1734980;Pumpkins;;0 - 20,000;16;0;16;0;0;0
1734990;The Netrunner Awaken1ng;;0 - 20,000;1;0;1;0;0;0
1735010;Pathological Tires;;0 - 20,000;3;0;3;0;0;0
1735060;Reed The Robotanist Plus;;0 - 20,000;4;0;4;0;0;1
1735090;Tea Time;;0 - 20,000;3;0;3;0;0;0
1735110;Museum of Mechanics: Lockpicking;;0 - 20,000;28;13;15;0;0;0
1735120;Abandoned;;0 - 20,000;2;3;-1;0;0;0
1735160;HAJWALA LINE;;0 - 20,000;5;3;2;0;0;0
1735280;NAGARE-BOSHI;;0 - 20,000;3;3;0;0;0;0
1735300;Gest!;;0 - 20,000;7;1;6;0;0;2
1735420;Fake Hostel;;100,000 - 200,000;251;136;115;13;15;0
1735470;Tax Fugitive;;0 - 20,000;11;11;0;0;0;3
1735480;Voice Visualizer;;0 - 20,000;2;2;0;0;0;0
1735600;Rolling Balls;;0 - 20,000;4;0;4;0;0;0
1735610;Multiply Factory;;0 - 20,000;10;0;10;0;0;1
1735640;Farmers' Market;;0 - 20,000;1;0;1;0;0;0
1735850;Mission 1985;;0 - 20,000;28;3;25;0;0;0
1735860;LyokoVR;;0 - 20,000;0;3;-3;0;0;0
1735940;FlightChess;;20,000 - 50,000;0;7;-7;0;0;0
1735950;Paper Bride;;100,000 - 200,000;1425;125;1300;317;369;19
1735980;Love Flute;;0 - 20,000;242;38;204;0;0;0
1736000;异星夺宝;;0 - 20,000;5;0;5;0;0;0
1736090;Demolish & Build VR;;0 - 20,000;11;18;-7;0;0;0
1736140;Drag Engineer;;0 - 20,000;2;0;2;0;0;0
1736250;Code Dread;;0 - 20,000;12;12;0;0;0;0
1736260;Home Designer - Makeover Blast;;0 - 20,000;10;4;6;0;0;1
1736270;They Are Coming!;;0 - 20,000;18;23;-5;0;0;0
1736300;LIBLADE;;0 - 20,000;91;8;83;0;0;1
1736400;TramSim Munich - The Tram Simulator;;0 - 20,000;313;153;160;0;0;13
1736480;YOGA MASTER;;0 - 20,000;18;1;17;0;0;0
1736490;Lazy Girl;;0 - 20,000;14;6;8;0;0;0
1736550;Deflector;;0 - 20,000;137;22;115;0;0;6
1736590;Shambled Spiral;;0 - 20,000;3;2;1;0;0;0
1736630;Minesweeper Ultimate;;0 - 20,000;64;16;48;0;0;5
1736670;Tilting Tiles;;0 - 20,000;9;0;9;0;0;0
1736680;Xio: Survival;;0 - 20,000;11;15;-4;0;0;0
1736710;Mummy Sandbox;;20,000 - 50,000;37;1;36;0;0;0
1736740;Cactus Clicker - Bofete Stories;;0 - 20,000;28;3;25;0;0;0
1736850;Camp Palut;;0 - 20,000;12;1;11;0;0;0
1736980;BounceShot;;20,000 - 50,000;19;2;17;0;0;1
1737010;Collector Thief;;0 - 20,000;1;0;1;0;0;0
1737070;风起长安：驭骨人;;0 - 20,000;216;35;181;0;0;3
1737130;Ducky;;0 - 20,000;5;3;2;0;0;0
1737170;Among Dots;;0 - 20,000;2;1;1;0;0;0
1737200;Ardarium;;0 - 20,000;12;0;12;0;0;0
1737240;天气;;0 - 20,000;16;1;15;0;0;0
1737280;Bad animals - rabbit;;0 - 20,000;10;3;7;0;0;1
1737330;雾尽时分;;0 - 20,000;14;3;11;0;0;3
1737340;Noobs Want to Live;;200,000 - 500,000;1351;116;1235;388;449;7596
1737450;Motorcycle Biker Simulator;;0 - 20,000;10;5;5;0;0;0
1737460;Into The Abyss;;0 - 20,000;1;4;-3;0;0;0
1737480;Super;;0 - 20,000;4;3;1;0;0;0
1737510;Hardworking Hero;;0 - 20,000;4;3;1;0;0;0
1737600;Alphabetical Order;;0 - 20,000;12;0;12;0;0;0
1737620;Please Duology;;20,000 - 50,000;11;1;10;0;0;0
1737690;Yacht Dice;;0 - 20,000;66;17;49;0;0;16
1737730;Neko Journey;;0 - 20,000;29;13;16;0;0;1
1737760;Platonic;;0 - 20,000;40;3;37;0;0;0
1737980;Galacticon;;20,000 - 50,000;42;0;42;0;0;0
1738100;Puzzle Light: Connect;;0 - 20,000;34;2;32;0;0;0
1738140;Campfire Tales;;0 - 20,000;2;1;1;0;0;0
1738150;Draft Day Sports: Pro Football 2022;;0 - 20,000;15;12;3;0;0;8
1738490;からかい上手の高木さんVR 2学期;;0 - 20,000;34;5;29;0;0;1
1738500;velvet clouds;;20,000 - 50,000;4;4;0;0;0;0
1738520;Bikini Armour Explorers;;0 - 20,000;84;34;50;0;0;2
1738550;Dalruan: World of Magic;;0 - 20,000;1;0;1;0;0;0
1738570;Taoist priest Yan;;0 - 20,000;16;1;15;0;0;0
1738610;First Class Escape: The Train of Thought;;0 - 20,000;178;73;105;0;0;9
1738630;Fantasy Sliding Puzzle;;0 - 20,000;9;4;5;0;0;0
1738650;Space Doomer;;0 - 20,000;10;6;4;0;0;0
1738670;Fairground Power Polyp Simulator;;0 - 20,000;5;1;4;0;0;0
1738850;Plumber 3;;0 - 20,000;0;5;-5;0;0;0
1738890;Naval Hurricane;;0 - 20,000;42;3;39;0;0;2
1739000;Franchise Hockey Manager 8;;0 - 20,000;148;37;111;0;0;63
1739010;Out of the Park Baseball 23;;20,000 - 50,000;738;161;577;0;0;1310
1739070;Bone's Cafe;;0 - 20,000;152;3;149;14;14;37
1739130;Cornmaze Craze;;0 - 20,000;2;0;2;0;0;0
1739150;Spookity Hollow;;0 - 20,000;9;0;9;0;0;0
1739160;――Chigau!!!;;0 - 20,000;12;0;12;0;0;0
1739200;Combo Babies;;0 - 20,000;21;0;21;0;0;0
1739300;Smack Studio;;0 - 20,000;82;16;66;0;0;1
1739340;Mr. Hopp's Manor Escape;;0 - 20,000;29;2;27;0;0;1
1739340;Mr. Hopp's Manor Escape;;0 - 20,000;29;2;27;0;0;1
1739360;Hold The Plates;;0 - 20,000;0;2;-2;0;0;0
1739420;Chessie Chicken;;0 - 20,000;1;0;1;0;0;0
1739480;Hordebreaker;;0 - 20,000;6;0;6;0;0;0
1739500;CAGE-FACE | Case 2: The Sewer;;0 - 20,000;6;1;5;0;0;0
1739590;LunarManVideoLibrary~月球人影库;;0 - 20,000;1;2;-1;0;0;0
1739650;Dimensions: Dreadnought Architect;;0 - 20,000;76;39;37;0;0;7
1739680;Tales of a Rabbit: The Story of Willie Hop;;0 - 20,000;1;1;0;0;0;0
1739710;Dreams Of The Elements;;0 - 20,000;1;0;1;0;0;0
1739770;Parking light;;0 - 20,000;10;0;10;0;0;0
1739850;Howling Village: Echoes;;0 - 20,000;2;2;0;0;0;1
1739880;Blood And Zombies;;0 - 20,000;171;83;88;189;189;1
1739910;Seaside Driving;;20,000 - 50,000;3;0;3;0;0;0
1740000;Cute Honey: Bunny Girl;;20,000 - 50,000;509;210;299;10;10;6
1740010;Undead Menace;;200,000 - 500,000;6;3;3;0;0;0
1740050;Hidden Objects - Sleeping Beauty - Puzzle Fairy Tales;;0 - 20,000;25;1;24;0;0;1
1740070;Heliopedia;;20,000 - 50,000;0;0;0;142;228;2
1740080;Level Up Simulator;;0 - 20,000;8;4;4;0;0;0
1740140;GHD;;0 - 20,000;14;15;-1;0;0;1
1740170;Tap Tap Builder;;0 - 20,000;4;3;1;0;0;0
1740180;Bombs Away;;50,000 - 100,000;1;0;1;0;0;0
1740240;100 hidden cups;;0 - 20,000;76;111;-35;0;0;0
1740320;Gutting Goblins!;;0 - 20,000;6;0;6;0;0;0
1740380;Pandea Stones;;0 - 20,000;6;0;6;0;0;0
1740420;Colors! Maze;;0 - 20,000;55;5;50;0;0;0
1740530;REDSIDE episode 1;;0 - 20,000;13;6;7;0;0;0
1740550;Sports Betting Simulator;;0 - 20,000;2;1;1;0;0;0
1740600;Knight&Princess;;0 - 20,000;1;1;0;0;0;0
1740660;Miraculous: Rise of the Sphinx;;0 - 20,000;29;27;2;0;0;2
1740670;VZX Creative;;0 - 20,000;3;1;2;0;0;0
1740680;Voodoo Detective;;0 - 20,000;131;3;128;0;0;0
1740720;Have a Nice Death;;100,000 - 200,000;5182;747;4435;382;293;177
1740760;Rayland;;0 - 20,000;55;4;51;0;0;0
1740850;角斗士学院（Gladiator School）;;20,000 - 50,000;340;11;329;0;0;2
1740870;Augmented Future;;0 - 20,000;0;2;-2;0;0;0
1740870;Augmented Future;;0 - 20,000;0;2;-2;0;0;0
1740890;I Love Finding Pups;;0 - 20,000;6;2;4;0;0;0
1740930;JellyCar Worlds;;0 - 20,000;281;4;277;4;4;17
1740990;Lawnmower Game: Space Fight;;0 - 20,000;7;4;3;0;0;0
1741030;Sanae Toumaden X2;;0 - 20,000;10;1;9;0;0;0
1741120;Fantasy General;;0 - 20,000;52;2;50;0;0;9
1741130;Pacific General;;0 - 20,000;12;5;7;0;0;4
1741150;War Wind II: Human Onslaught;;0 - 20,000;2;3;-1;0;0;0
1741160;Catch Me!;;0 - 20,000;38;1;37;0;0;0
1741210;Speedway Challenge 2021;;0 - 20,000;20;3;17;0;0;3
1741220;Forbidden place;;0 - 20,000;1;4;-3;0;0;0
1741230;Fantasy Heroes: 4-Directional Character Editor & Sprite Sheet Maker;;0 - 20,000;5;0;5;0;0;0
1741260;Faster Than Possible;;0 - 20,000;2;1;1;0;0;0
1741300;SIT DOWN, PLEASE;;50,000 - 100,000;5;3;2;0;0;0
1741400;Wander Hero;;20,000 - 50,000;427;64;363;0;0;63
1741480;Ultimaze;;0 - 20,000;5;0;5;0;0;0
1741490;Undying Lantern;;0 - 20,000;3;1;2;0;0;0
1741510;Traffic Command: Reborn;;0 - 20,000;1;4;-3;0;0;0
1741520;Air Strike;;100,000 - 200,000;5;7;-2;0;0;0
1741620;Spirit and Katana;;20,000 - 50,000;1;0;1;0;0;0
1741640;Shadows of Forbidden Gods;;20,000 - 50,000;350;10;340;689;689;40
1741670;Hedgie Simulator;;0 - 20,000;5;0;5;0;0;0
1741730;FORTRESS DEFENDER;;0 - 20,000;9;0;9;0;0;0
1741830;Texture Assembler;;0 - 20,000;2;0;2;0;0;0
1742060;Purify;;0 - 20,000;1;0;1;0;0;0
1742080;Fishing at Lotus Lakes;;0 - 20,000;7;1;6;0;0;0
1742120;Mary Knots - Garden Wedding;;0 - 20,000;3;2;1;0;0;0
1742140;VR crazy racing;;0 - 20,000;0;2;-2;0;0;0
1742170;Eco Park;;0 - 20,000;2;1;1;0;0;0
1742230;Sandfall;;0 - 20,000;2;3;-1;0;0;1
1742240;Hymns of Resurrection;;0 - 20,000;4;0;4;0;0;1
1742330;TARAKAN - Mystery Point & Click Adventure;;20,000 - 50,000;7;4;3;0;0;0
1742340;Submarine VR;;0 - 20,000;12;5;7;0;0;0
1742450;西游记2021;;50,000 - 100,000;343;18;325;0;0;0
1742480;Eternal night;;0 - 20,000;1;0;1;0;0;0
1742500;My Dear Frankenstein -English Edition-;;0 - 20,000;9;1;8;0;0;1
1742510;Wreckdigger;;0 - 20,000;2;2;0;0;0;0
1742590;TEMPUS;;20,000 - 50,000;43;14;29;0;0;0
1742600;Perish Song;;0 - 20,000;6;0;6;0;0;0
1742610;Spirits of the Hellements - TD;;0 - 20,000;249;14;235;0;0;6
1742610;Spirits of the Hellements - TD;;0 - 20,000;249;14;235;0;0;6
1742620;Sudoku Minimalist Infinite;;0 - 20,000;1;1;0;0;0;0
1742690;Requiem;;0 - 20,000;0;4;-4;0;0;0
1742820;TIMESCAPE: Altitude;;0 - 20,000;5;1;4;0;0;0
1742840;Puff Town;;0 - 20,000;241;73;168;17;17;0
1742880;ファントムゾーン　クリプトファシア;;0 - 20,000;1;0;1;0;0;0
1742910;The Forest Prison;;0 - 20,000;0;2;-2;0;0;0
1742910;The Forest Prison;;0 - 20,000;0;2;-2;0;0;0
1742940;Poly Puzzle: Furries;;0 - 20,000;4;3;1;0;0;0
1743010;One Last Memory;;0 - 20,000;23;10;13;0;0;0
1743080;Night Cascades;;20,000 - 50,000;70;3;67;0;0;0
1743080;Night Cascades;;20,000 - 50,000;70;3;67;0;0;0
1743140;I, W.O.M.A.N.;;50,000 - 100,000;2;0;2;0;0;0
1743190;LOVE! TRUTH! PUZZLE!;;0 - 20,000;4;4;0;0;0;0
1743220;Spectrum;;0 - 20,000;6;0;6;0;0;0
1743230;Time of the Clones;;0 - 20,000;11;0;11;0;0;0
1743280;Lola - The Escape;;20,000 - 50,000;4;0;4;0;0;0
1743380;SCP: Doki Doki Anomaly;;0 - 20,000;66;5;61;0;0;0
1743460;YEOLLEB Warrior;;0 - 20,000;5;4;1;0;0;0
1743530;Mireille and Amrita, the Forest of Illusions;;0 - 20,000;3;1;2;0;0;1
1743570;RFVR;;20,000 - 50,000;26;8;18;0;0;1
1743610;Running Water;;0 - 20,000;1;0;1;0;0;0
1743660;心灵迷宫（ Mind maze）;;0 - 20,000;5;0;5;0;0;0
1743710;100 Doors - Escape from Prison;;0 - 20,000;9;3;6;0;0;0
1743720;Typer Hero (打字英雄);;0 - 20,000;10;2;8;0;0;0
1743810;The forgotten phobia;;0 - 20,000;10;8;2;0;0;0
1743820;Orph - The Lost Boy;;0 - 20,000;27;10;17;0;0;0
1743850;HYPER DEMON;;100,000 - 200,000;1475;65;1410;13;13;23
1743880;Andalia;;0 - 20,000;8;3;5;0;0;2
1743930;Froggo Swing 'n Grapple;;0 - 20,000;8;1;7;0;0;0
1743940;誰是犯案者 Who is the Criminal;;0 - 20,000;35;1;34;0;0;0
1744050;Hidden Words;;0 - 20,000;10;2;8;0;0;1
1744060;DOGS.IO;;0 - 20,000;6;1;5;0;0;0
1744140;Conundrum;;0 - 20,000;28;2;26;0;0;0
1744200;City Legends: The Curse of the Crimson Shadow Collector's Edition;;0 - 20,000;4;0;4;0;0;0
1744330;No More Heroes 3;;0 - 20,000;265;33;232;0;0;1
1744380;Richard West and the Golden Mask;;20,000 - 50,000;16;1;15;0;0;0
1744380;Richard West and the Golden Mask;;20,000 - 50,000;16;1;15;0;0;0
1744400;Jujubos Puzzle;;0 - 20,000;11;0;11;0;0;0
1744420;Halloween Memory: Reborn;;0 - 20,000;1;4;-3;0;0;0
1744430;Fairy Godmother Stories: Miraculous Dream Collector's Edition;;0 - 20,000;3;0;3;0;0;1
1744450;Indirection;;0 - 20,000;16;1;15;0;0;0
1744450;Indirection;;0 - 20,000;16;1;15;0;0;0
1744460;Soul Climb;;0 - 20,000;8;0;8;0;0;0
1744510;Ballin';;0 - 20,000;4;0;4;0;0;0
1744580;EVAN QUEST;;0 - 20,000;6;3;3;0;0;0
1744620;Dance of Cubes;;0 - 20,000;1;0;1;0;0;0
1744640;Nineteen;;0 - 20,000;26;2;24;0;0;0
1744650;Iris Covenant –Song of the Forgotten Heroes–;;0 - 20,000;2;6;-4;0;0;0
1744750;TouHou Music Recording;;0 - 20,000;38;5;33;0;0;0
1744910;[Chilla's Art] The Radio Station | 深夜放送;;20,000 - 50,000;223;59;164;5;5;4
1745000;Fisherman's House;;0 - 20,000;20;9;11;0;0;0
1745040;History of Football World Cup;;0 - 20,000;8;0;8;0;0;0
1745170;Primitier;;0 - 20,000;101;4;97;0;0;2
1745210;Timewell: Trail of Celestes;;20,000 - 50,000;19;3;16;0;0;0
1745220;Mr.DomusMundi;;0 - 20,000;12;5;7;0;0;0
1745240;KEMONOPOLY;;0 - 20,000;2;0;2;0;0;0
1745280;Magitek VR;;0 - 20,000;19;2;17;0;0;2
1745370;Ragnar;;0 - 20,000;2;1;1;0;0;0
1745380;UNDER the WATER - an ocean survival game;;50,000 - 100,000;19;23;-4;0;0;2
1745400;League Manager 2022;;20,000 - 50,000;621;203;418;11;11;6
1745410;Skattered Dream;;0 - 20,000;6;2;4;0;0;0
1745480;Phantom Project;;20,000 - 50,000;165;26;139;0;0;1
1745510;Lunacid;;20,000 - 50,000;963;44;919;179;179;15
1745520;REDSHOT;;0 - 20,000;14;3;11;0;0;2
1745620;The Oath of The Dark Magic Queen;;0 - 20,000;16;4;12;1;1;1
1745640;MACE: Mapinguari's Temple;;0 - 20,000;17;0;17;0;0;0
1745710;Cato, the cat;;0 - 20,000;18;2;16;0;0;0
1745780;Substance 3D Modeler 2023;;0 - 20,000;17;8;9;0;0;4
1745790;City Zoomer;;0 - 20,000;121;4;117;0;0;1
1745800;Doom Work;;0 - 20,000;27;2;25;0;0;0
1745880;Zippo;;20,000 - 50,000;2;0;2;0;0;0
1745960;Circuit Breaker;;0 - 20,000;1;0;1;0;0;0
1745990;Lost but Lucid;;0 - 20,000;11;1;10;0;0;0
1746010;学霸的星期天;;0 - 20,000;1;0;1;0;0;0
1746110;人中怪物多人版;;0 - 20,000;1;2;-1;0;0;0
1746120;Halloween Trouble 3: Match 3 Puzzle;;0 - 20,000;2;1;1;0;0;0
1746210;日记簿;;0 - 20,000;8;0;8;0;0;0
1746230;Too Many Humans;;0 - 20,000;3;0;3;0;0;0
1746280;Ball Ranger;;0 - 20,000;7;1;6;0;0;0
1746420;Ripple 涟;;0 - 20,000;2;0;2;0;0;0
1746500;AsMagnet;;0 - 20,000;22;1;21;0;0;0
1746520;IDIOTIC (The Game);;0 - 20,000;11;4;7;0;0;0
1746530;Confessions at Candlewood Lake;;0 - 20,000;2;3;-1;0;0;0
1746540;游戏：异星;;0 - 20,000;0;2;-2;0;0;0
1746560;Blacken Slash;;0 - 20,000;27;0;27;0;0;0
1746620;Where is Paradise ?;;0 - 20,000;19;5;14;0;0;0
1746660;Space Ballers;;0 - 20,000;17;0;17;0;0;0
1746700;The Alchemist Shop: An Apprentice's Life;;0 - 20,000;16;0;16;0;0;0
1746730;Hidden Objects - Cartoon Fantasy;;0 - 20,000;0;1;-1;0;0;0
1746760;BOOMER SLAYERS;;0 - 20,000;2;0;2;0;0;0
1746770;The Chicken's Fall;;0 - 20,000;12;0;12;0;0;0
1746830;Sailing Stone;;0 - 20,000;1;0;1;0;0;0
1746920;Claydo:Easy 3D Modelling & Printing;;0 - 20,000;4;1;3;0;0;0
1746970;Cat Clicker;;0 - 20,000;18;0;18;0;0;0
1747030;The Trials;;0 - 20,000;23;0;23;0;0;0
1747050;Sam & Max: Beyond Time and Space;;0 - 20,000;212;4;208;0;0;7
1747110;Base Wars;;20,000 - 50,000;10;0;10;0;0;0
1747220;Neverspring Chronicles;;0 - 20,000;3;0;3;0;0;0
1747310;Catana;;0 - 20,000;9;0;9;0;0;0
1747330;A Lose Hero in the Castle of the Succubi;;0 - 20,000;30;5;25;10;10;0
1747430;Bomberpet;;0 - 20,000;8;1;7;0;0;0
1747440;Rocket Jump;;0 - 20,000;8;1;7;0;0;0
1747500;Crom: Journey of Conquest;;0 - 20,000;1;0;1;0;0;0
1747570;Crazy Athletics - Summer Sports & Games;;0 - 20,000;1;0;1;0;0;0
1747670;Jewel Match Twilight 3 Collector's Edition;;0 - 20,000;25;0;25;0;0;2
1747680;Faraway: Jungle Escape;;0 - 20,000;3;1;2;0;0;0
1747800;Legendary Mahjong 2;;0 - 20,000;4;0;4;0;0;1
1747830;Blossom Tales II: The Minotaur Prince;;0 - 20,000;80;4;76;0;0;5
1747850;Blocks Must Fall!;;0 - 20,000;9;0;9;0;0;0
1747890;Demon Turf: Neon Splash;;0 - 20,000;100;2;98;54;106;0
1747940;Neon Arena;;0 - 20,000;1;6;-5;0;0;0
1747940;Neon Arena;;0 - 20,000;1;6;-5;0;0;0
1747980;RedShip;;0 - 20,000;2;1;1;0;0;0
1748090;Juicy Bois: Fashion & Conflict;;0 - 20,000;4;0;4;0;0;0
1748160;Warlordocracy;;0 - 20,000;10;1;9;0;0;0
1748210;Lovely Animal Stories;;0 - 20,000;1;1;0;0;0;0
1748230;RESTLESS SOUL;;0 - 20,000;77;5;72;0;0;2
1748240;Rectitude;;0 - 20,000;2;0;2;0;0;0
1748310;Octofight Escape;;0 - 20,000;21;2;19;0;0;0
1748340;Finding Home;;0 - 20,000;4;4;0;0;0;0
1748390;Rocket Bot Royale;;20,000 - 50,000;518;82;436;101;101;11
1748610;Evil God Korone;;0 - 20,000;430;19;411;0;0;2
1748640;Jaksaljabi;;0 - 20,000;2;1;1;0;0;0
1748660;Voice of Cards: The Forsaken Maiden;;0 - 20,000;108;49;59;394;394;0
1748890;猫不语;;0 - 20,000;102;19;83;0;0;0
1748900;Soccer Boss;;0 - 20,000;4;2;2;0;0;0
1748910;KAIJU MONSTER VR;;0 - 20,000;0;2;-2;0;0;0
1748970;Extinction;;0 - 20,000;2;4;-2;0;0;0
1748980;QUIZxRPG;;0 - 20,000;2;4;-2;0;0;0
1749020;Trials of Proelium;;20,000 - 50,000;6;0;6;0;0;0
1749170;Human Madness;;0 - 20,000;2;7;-5;0;0;1
1749200;Hostile Planet: Survival;;0 - 20,000;68;28;40;0;0;0
1749210;Tile Connect - Onet Match;;0 - 20,000;1;0;1;0;0;1
1749260;String Rush;;0 - 20,000;1;0;1;0;0;0
1749310;Netherspace;;0 - 20,000;6;0;6;0;0;0
1749350;Gobby McGobblenutz Presents: The Art of the Dad Joke: Chapter 1;;0 - 20,000;131;11;120;0;0;0
1749360;Lucky Tlhalerwa's Cybernetic Titan;;0 - 20,000;2;2;0;0;0;0
1749380;Pieces of Beauty;;0 - 20,000;17;0;17;0;0;1
1749410;DARK MAGIC 2;;0 - 20,000;4;0;4;0;0;0
1749430;Reefland;;0 - 20,000;63;3;60;0;0;2
1749460;Battle Tops;;0 - 20,000;12;4;8;0;0;0
1749480;Gazmatera 2 America's Least Wanted;;20,000 - 50,000;3;0;3;0;0;0
1749710;Legends of Murder Collection;;50,000 - 100,000;1;0;1;0;0;0
1749750;Disgaea 6 Complete;;0 - 20,000;180;110;70;0;0;69
1749750;Disgaea 6 Complete;;0 - 20,000;180;110;70;0;0;69
1749980;SOMNI;;0 - 20,000;65;22;43;0;0;1
1750000;Sweet Match 3;;0 - 20,000;0;3;-3;0;0;0
1750110;Frenzy VR;;0 - 20,000;91;39;52;0;0;3
1750170;Fragmented Memories - Arc One;;20,000 - 50,000;17;3;14;0;0;0
1750210;Chat Generator;;0 - 20,000;1;0;1;0;0;0
1750280;Defend the Fort;;0 - 20,000;4;1;3;0;0;0
1750320;Last Genesis;;20,000 - 50,000;2;1;1;0;0;0
1750490;Bumballon;;0 - 20,000;40;1;39;0;0;0
1750540;Moonsters;;0 - 20,000;4;0;4;0;0;0
1750570;Subway Midnight;;50,000 - 100,000;701;139;562;366;366;1
1750600;Crate Mates;;0 - 20,000;41;0;41;0;0;0
1750630;Demolition Game;;0 - 20,000;1;1;0;0;0;0
1750640;Dear Agony Aunt;;0 - 20,000;11;0;11;0;0;1
1750690;Last Defenders;;20,000 - 50,000;1;0;1;0;0;0
1750710;Boxville;;0 - 20,000;103;8;95;0;0;1
1750740;战棋三国英雄;;0 - 20,000;80;10;70;0;0;10
1750770;Starcom: Unknown Space;;0 - 20,000;199;23;176;28;28;44
1750810;Wager;;0 - 20,000;3;1;2;0;0;0
1750900;Super Punchy Face;;0 - 20,000;3;0;3;0;0;0
1750960;Re: Summon;;0 - 20,000;2;0;2;0;0;0
1750980;Horror Maze;;0 - 20,000;10;2;8;0;0;0
1750990;Merge Chess;;0 - 20,000;1;0;1;0;0;0
1751100;G-MODEアーカイブス+ 怒首領蜂大往生DX;;0 - 20,000;29;4;25;0;0;0
1751110;Jeebo & Jerbo vs. Life;;20,000 - 50,000;11;0;11;0;0;0
1751160;Failling Capsule;;20,000 - 50,000;0;1;-1;0;0;0
1751190;MOVERS IN THE WAREHOUSE;;0 - 20,000;11;5;6;0;0;0
1751230;Kingdom Traveler;;0 - 20,000;13;1;12;0;0;1
1751270;GunsBox VR;;0 - 20,000;23;3;20;0;0;0
1751310;A Winter Story -- Original Edition and Highly Difficult;;0 - 20,000;4;7;-3;0;0;0
1751320;HotGirls Sliding Puzzle;;0 - 20,000;4;1;3;0;0;0
1751400;Winter Warfare: Survival;;0 - 20,000;13;8;5;0;0;0
1751470;Chill Panda;;0 - 20,000;3;0;3;0;0;0
1751560;Magurele Mystery;;0 - 20,000;43;5;38;0;0;0
1751610;Imoto;;0 - 20,000;1;0;1;0;0;0
1751630;Hello Lady! - Complete Edition;;0 - 20,000;224;29;195;0;0;4
1751700;Dungeon Arsenal;;0 - 20,000;6;0;6;0;0;0
1751710;Horror Stories: PLEASE COMPLY;;0 - 20,000;18;4;14;0;0;0
1751780;Perfectly Balanced;;0 - 20,000;24;3;21;0;0;0
1751850;Ghost Terminator;;0 - 20,000;5;1;4;0;0;0
1751860;Solo Royale;;0 - 20,000;0;2;-2;0;0;0
1751890;The Red Exile;;0 - 20,000;12;6;6;0;0;0
1751990;Table Gun;;0 - 20,000;2;0;2;0;0;0
1752050;Levenium;;0 - 20,000;1;0;1;0;0;0
1752090;Echoed Memories;;0 - 20,000;11;0;11;0;0;5
1752150;Slobbish Dragon Princess 2;;0 - 20,000;79;2;77;0;0;0
1752190;Cubicus;;0 - 20,000;1;2;-1;0;0;0
1752220;Relumine;;0 - 20,000;3;1;2;0;0;0
1752250;How To Bathe Your Cat;;0 - 20,000;87;5;82;0;0;1
1752260;Mythic;;0 - 20,000;31;20;11;0;0;0
1752400;Blade and Ham;;0 - 20,000;4;4;0;0;0;0
1752500;Badlands Racer;;0 - 20,000;15;9;6;0;0;0
1752610;Give Me More Pills;;0 - 20,000;31;3;28;0;0;0
1752660;Hovercraft Racing;;0 - 20,000;1;0;1;0;0;0
1752760;Soulstopia -PHI-;;0 - 20,000;23;2;21;0;0;0
1752810;PAPER BIRDS;;0 - 20,000;13;1;12;0;0;0
1752830;Hidden Flowers;;0 - 20,000;1;19;-18;0;0;0
1752850;Find Match Icons;;0 - 20,000;1;5;-4;0;0;0
1752890;2030;;0 - 20,000;3;1;2;0;0;0
1753010;Scale Enchanter;;0 - 20,000;22;3;19;0;0;0
1753050;My Inner Darkness Is A Hot Anime Girl!;;0 - 20,000;24;1;23;0;0;0
1753100;舔狗模拟器;;0 - 20,000;71;45;26;0;0;0
1753110;Once Upon a Time in the Colony;;0 - 20,000;0;1;-1;0;0;0
1753160;Legend of Labot: The Golden Pearl;;0 - 20,000;1;0;1;0;0;0
1753220;ANIME TETRIS;;0 - 20,000;31;8;23;0;0;1
1753270;Ketchup and Mayonnaise;;0 - 20,000;54;0;54;0;0;0
1753530;Memories Of Loneliness;;0 - 20,000;9;5;4;0;0;0
1753670;This Game is Crap;;0 - 20,000;5;0;5;0;0;0
1753690;Faye: A Tale of Shadow;;50,000 - 100,000;1;0;1;0;0;0
1753730;The 8 Sins: New Hell Order;;20,000 - 50,000;2;0;2;0;0;0
1753790;She Will Shoot;;0 - 20,000;60;55;5;0;0;0
1753800;Lowsy;;0 - 20,000;1;0;1;0;0;0
1753810;Sola;;0 - 20,000;1;0;1;0;0;0
1753890;El Pescador;;0 - 20,000;8;0;8;0;0;0
1753900;World of Motors;;0 - 20,000;11;8;3;0;0;0
1754000;The Elder Scrolls Online: High Isle;;0 - 20,000;138;101;37;0;0;0
1754040;Procedural Soccer;;0 - 20,000;2;2;0;0;0;0
1754150;Car Tuning Simulator;;0 - 20,000;62;63;-1;0;0;0
1754200;The Giraffe World;;0 - 20,000;7;0;7;0;0;0
1754260;Kill The Dragon;;0 - 20,000;60;13;47;0;0;0
1754300;Alec Adventure;;0 - 20,000;7;0;7;0;0;0
1754350;Cubicus 2;;0 - 20,000;0;3;-3;0;0;0
1754380;Magic Time;;0 - 20,000;12;9;3;0;0;0
1754390;Mystery Trackers: Train to Hellswich Collector's Edition;;20,000 - 50,000;2;2;0;0;0;1
1754470;Substance 3D Stager 2022;;0 - 20,000;9;12;-3;0;0;2
1754490;The Adventures of Emoji 4 : Fly High Mouse;;0 - 20,000;1;0;1;0;0;0
1754520;吾王的荣耀 Honor of Knight King;;0 - 20,000;7;1;6;0;0;0
1754740;Gems of Magic: Father's Day;;0 - 20,000;5;2;3;0;0;0
1754750;Pocket Rocket;;0 - 20,000;4;0;4;0;0;0
1754760;Scarred Stars: Traumatic Edition;;0 - 20,000;17;4;13;0;0;1
1754770;贸易与马车;;0 - 20,000;5;1;4;0;0;0
1754840;Hacker Simulator;;50,000 - 100,000;533;162;371;190;190;7
1754910;Don't Hate Me;;0 - 20,000;1;1;0;0;0;0
1754940;Treffen;;0 - 20,000;3;0;3;0;0;0
1755030;Mothmen 1966;;0 - 20,000;140;10;130;0;0;1
1755060;Eyes of the Night;;0 - 20,000;2;1;1;0;0;0
1755100;The Last Clockwinder;;0 - 20,000;304;6;298;334;478;5
1755110;Warlocks Entanglement;;20,000 - 50,000;2;0;2;0;0;0
1755110;Warlocks Entanglement;;20,000 - 50,000;2;0;2;0;0;0
1755150;Check, please! : Restaurant Simulator;;0 - 20,000;3;8;-5;0;0;0
1755170;Coloring Pixel - Fantasy Characters;;0 - 20,000;2;0;2;0;0;0
1755270;Cosmic Cube;;0 - 20,000;38;39;-1;0;0;0
1755270;Cosmic Cube;;0 - 20,000;38;39;-1;0;0;0
1755280;Super Grappling Gecko;;0 - 20,000;52;0;52;0;0;0
1755290;ARCH STONE vs The Zombie Specters;;0 - 20,000;3;1;2;0;0;0
1755300;Smart Factory Tycoon;;0 - 20,000;110;40;70;0;0;1
1755350;BBQ Simulator: The Squad;;0 - 20,000;633;110;523;62;83;0
1755420;Battlecruiser Generations;;0 - 20,000;8;1;7;0;0;0
1755460;Island Crusaders;;0 - 20,000;21;4;17;0;0;0
1755570;Matching Cats;;0 - 20,000;31;2;29;0;0;0
1755580;The Jackbox Party Starter;;0 - 20,000;119;6;113;162;162;39
1755600;Tri-Star;;0 - 20,000;12;0;12;0;0;0
1755650;C.A.P.S. - Cyber Animal Planet Survival;;0 - 20,000;10;0;10;0;0;1
1755650;C.A.P.S. - Cyber Animal Planet Survival;;0 - 20,000;10;0;10;0;0;1
1755670;The Sink Gods;;0 - 20,000;17;0;17;0;0;1
1755680;Everything Is For Humanity;;0 - 20,000;82;30;52;0;0;0
1755740;侵入：源代码;;0 - 20,000;29;6;23;0;0;0
1755790;Dance like a butterfly, Shot like a Bee!;;0 - 20,000;2;1;1;0;0;0
1755810;City Air Battle;;0 - 20,000;0;1;-1;0;0;0
1755870;The Monster Within;;0 - 20,000;51;13;38;0;0;1
1755890;Repit;;0 - 20,000;25;6;19;0;0;0
1755990;Try to Catch Up;;0 - 20,000;3;4;-1;0;0;0
1756060;Stint: Rift Apart;;0 - 20,000;1;0;1;0;0;0
1756080;Doomsday Defense;;0 - 20,000;0;5;-5;0;0;0
1756120;Your Sword Is So Big;;0 - 20,000;30;49;-19;0;0;0
1756150;SCP: Keter;;0 - 20,000;10;22;-12;0;0;0
1756160;Unsafe;;20,000 - 50,000;116;62;54;114;208;2
1756180;CARNAGE OFFERING;;0 - 20,000;144;26;118;0;0;1
1756320;DREAMVIBE;;50,000 - 100,000;12;3;9;0;0;0
1756330;Secrets of Magic 5: Back to School;;0 - 20,000;11;1;10;0;0;1
1756340;FishWitch Halloween;;0 - 20,000;6;1;5;0;0;0
1756390;Mercs Fully Loaded;;20,000 - 50,000;4;3;1;0;0;0
1756390;Mercs Fully Loaded;;20,000 - 50,000;4;3;1;0;0;0
1756450;Hero or Foe;;0 - 20,000;0;1;-1;0;0;0
1756480;Golf For Fun in Ice;;0 - 20,000;11;0;11;0;0;0
1756490;Angels vs Demons;;0 - 20,000;0;4;-4;0;0;0
1756550;Code.Breaker();;20,000 - 50,000;2;0;2;0;0;0
1756650;Lockes The Thief;;0 - 20,000;6;1;5;0;0;1
1756710;Mistral;;0 - 20,000;13;4;9;0;0;6
1756750;HERADÔNIA Director's cut;;0 - 20,000;1;3;-2;0;0;0
1756770;Little Robo Climber;;0 - 20,000;2;0;2;0;0;0
1756790;No Tyrant;;0 - 20,000;14;4;10;0;0;0
1756800;Casino Tycoon Simulator;;0 - 20,000;8;9;-1;0;0;1
1756810;Ninja Express;;0 - 20,000;2;4;-2;0;0;0
1756840;边缘项目 / Living Island Project;;0 - 20,000;11;1;10;0;0;2
1756900;Shoot!;;0 - 20,000;3;1;2;0;0;0
1756930;Brick Breaker;;0 - 20,000;4;3;1;0;0;0
1756960;末日竟在我身边2 - Zombies Everywhere 2;;0 - 20,000;11;0;11;0;0;0
1757010;The VanMan;;0 - 20,000;0;1;-1;0;0;0
1757120;SpritePile 2.0;;0 - 20,000;6;2;4;0;0;0
1757130;Pong Temple;;0 - 20,000;1;0;1;0;0;0
1757170;Notoris: The Goblin War;;0 - 20,000;3;0;3;0;0;0
1757240;Ghost Case;;50,000 - 100,000;9;5;4;0;0;1
1757250;Unreal Element World;;0 - 20,000;1;3;-2;0;0;0
1757260;Little Red Rocket Ship;;0 - 20,000;1;0;1;0;0;0
1757360;Shifting Dungeon;;20,000 - 50,000;2;0;2;0;0;0
1757400;The Last Will;;0 - 20,000;0;2;-2;0;0;0
1757420;The Summit High School: Prologue Episode;;0 - 20,000;5;0;5;0;0;0
1757440;Blazend;;0 - 20,000;10;1;9;0;0;1
1757470;Slide Stories: Bucky's Quest;;0 - 20,000;14;1;13;0;0;0
1757560;One Pixel TWB;;0 - 20,000;16;0;16;0;0;0
1757570;Capital Island;;0 - 20,000;2;1;1;0;0;0
1757890;Elohim Eternal: The Babel Code;;20,000 - 50,000;13;0;13;0;0;2
1757900;Alien Vision;;0 - 20,000;0;1;-1;0;0;0
1757920;Astral Flux;;0 - 20,000;11;1;10;0;0;0
1757950;回家 - Homeward;;0 - 20,000;14;0;14;0;0;1
1757960;SOUNDXWORLD;;0 - 20,000;0;1;-1;0;0;0
1757970;Oasis: Dark Forest;;0 - 20,000;8;1;7;0;0;0
1758010;Dungeon Raider;;0 - 20,000;2;2;0;0;0;0
1758020;Cosmic Cat;;0 - 20,000;3;3;0;0;0;0
1758030;Devil Tears;;0 - 20,000;0;3;-3;0;0;0
1758040;Violent Agent;;0 - 20,000;1;5;-4;0;0;0
1758050;LineVox 2: Forward to the Past;;50,000 - 100,000;2;1;1;0;0;0
1758060;Ceilless;;0 - 20,000;4;0;4;0;0;1
1758080;Empires of the Void II;;0 - 20,000;9;6;3;0;0;2
1758090;Shadow Killer;;0 - 20,000;3;1;2;0;0;0
1758100;Alien Accident;;0 - 20,000;2;2;0;0;0;0
1758110;Dracula Is Coming;;0 - 20,000;2;1;1;0;0;0
1758120;Puzzle Art: Dogs;;0 - 20,000;5;0;5;0;0;0
1758180;The Most Boring Life Ever 2 - Work From Home;;0 - 20,000;1;0;1;0;0;0
1758350;高射炮 flak;;0 - 20,000;0;1;-1;0;0;0
1758370;18Korea;;0 - 20,000;15;8;7;0;0;2
1758390;Idiot Brain Evolution;;0 - 20,000;4;1;3;0;0;0
1758440;Survival: Zombies aHead;;0 - 20,000;13;0;13;0;0;0
1758480;Astralojia: Season 1;;0 - 20,000;1;1;0;0;0;0
1758520;Broken Banners;;0 - 20,000;37;10;27;0;0;4
1758530;Pusheep;;0 - 20,000;3;1;2;0;0;0
1758550;契约唤灵师;;0 - 20,000;119;53;66;0;0;0
1758600;ATRIA-1;;0 - 20,000;4;1;3;0;0;0
1758640;Cat Capacity;;0 - 20,000;3;0;3;0;0;0
1758810;Little Island;;0 - 20,000;3;5;-2;0;0;0
1758870;Edgar's Room;;20,000 - 50,000;8;2;6;0;0;2
1758910;Time Commando;;200,000 - 500,000;40;1;39;0;0;2
1758920;Witch Explorer;;0 - 20,000;106;10;96;0;0;0
1759210;Greed Is Bad;;0 - 20,000;2;2;0;0;0;0
1759220;Return Alive;;0 - 20,000;1;3;-2;0;0;0
1759340;The Death Tree;;0 - 20,000;4;1;3;0;0;0
1759400;PolyBoost;;0 - 20,000;2;0;2;0;0;0
1759430;Rescue Troopers;;0 - 20,000;1;0;1;0;0;0
1759480;Funny puzzle;;0 - 20,000;1;4;-3;0;0;0
1759580;Tower To Heaven;;0 - 20,000;4;1;3;0;0;0
1759610;Substance 3D Sampler 2022;;0 - 20,000;17;4;13;0;0;2
1759640;Underground Life;;0 - 20,000;20;7;13;0;0;1
1759700;The Abandoned;;0 - 20,000;0;3;-3;0;0;0
1759710;MocapForAll;;0 - 20,000;3;1;2;0;0;0
1759930;Clarity of The Soul;;0 - 20,000;4;13;-9;0;0;0
1759980;Ecchi Beauties;;0 - 20,000;4;1;3;0;0;0
1760020;GROUND-UNBOUND;;0 - 20,000;53;1;52;0;0;0
1760040;Fleshport;;0 - 20,000;14;0;14;0;0;2
1760040;Fleshport;;0 - 20,000;14;0;14;0;0;2
1760090;Angry Dad;;0 - 20,000;24;0;24;0;0;0
1760140;Miraculo Island;;0 - 20,000;12;2;10;0;0;0
1760160;Game Theory At Christmas;;0 - 20,000;38;8;30;0;0;0
1760240;Skator Gator;;0 - 20,000;50;2;48;0;0;0
1760250;Madden NFL 23;;100,000 - 200,000;1848;2089;-241;1629;2182;4300
1760300;Jousting VR;;0 - 20,000;4;1;3;0;0;0
1760320;Leaf Tree;;0 - 20,000;19;1;18;0;0;0
1760340;ReFactory;;0 - 20,000;60;16;44;0;0;2
1760420;ENOH;;20,000 - 50,000;2;2;0;0;0;0
1760510;FAWE: Enchanted Forest;;0 - 20,000;1;0;1;0;0;0
1760590;Fantasy Sliding Puzzle 2;;0 - 20,000;6;0;6;0;0;0
1760640;Awakened Evil;;0 - 20,000;31;0;31;0;0;2
1760660;Press D to Die;;0 - 20,000;4;0;4;0;0;0
1760670;Mystery Swords;;0 - 20,000;1;6;-5;0;0;0
1760690;The Luffeltera Renovator;;0 - 20,000;14;8;6;0;0;1
1760700;Searching for objects in the forest;;0 - 20,000;3;3;0;0;0;0
1760700;Searching for objects in the forest;;0 - 20,000;3;3;0;0;0;0
1760980;P.U.R.G.A.T.O.R.Y;;0 - 20,000;13;7;6;0;0;1
1760990;Gecky The Deenosaur Stars In! Adventures In SunnyDoodle Swimmingland!;;0 - 20,000;0;3;-3;0;0;0
1761010;The Immaculate Drag;;0 - 20,000;46;2;44;0;0;0
1761040;Gear of Glass: Eolarn's war;;0 - 20,000;24;3;21;0;0;0
1761130;Lake Road;;0 - 20,000;12;2;10;0;0;0
1761230;Frontier of Fortune;;0 - 20,000;8;2;6;0;0;0
1761250;Higher;;0 - 20,000;1;0;1;0;0;0
1761290;Japanese Rail Sim: Journey to Kyoto;;0 - 20,000;64;7;57;0;0;1
1761320;Poly Puzzle: Furries 2;;0 - 20,000;2;1;1;0;0;0
1761380;Otherworld Legends 战魂铭人;;20,000 - 50,000;348;316;32;236;236;21
1761390;Hatsune Miku: Project DIVA Mega Mix+;;100,000 - 200,000;8576;737;7839;1256;1662;309
1761420;Without Pain;;0 - 20,000;14;4;10;0;0;0
1761450;Madrid Noir;;20,000 - 50,000;20;1;19;0;0;0
1761530;Princess Maira: Initiation;;0 - 20,000;11;3;8;0;0;0
1761600;JETT: The Far Shore + Given Time;;0 - 20,000;20;7;13;0;0;12
1761630;What's Your Gender?;;0 - 20,000;56;12;44;0;0;0
1761660;The Van of Justice;;50,000 - 100,000;5;0;5;0;0;0
1761670;Apré Lapli [After the rain];;0 - 20,000;1;0;1;0;0;0
1761740;My Cashy Side Job at Lost&Found in the Subway of Million-Person City;;0 - 20,000;27;8;19;0;0;0
1761750;CADE PRIME;;0 - 20,000;3;2;1;0;0;0
1761750;CADE PRIME;;0 - 20,000;3;2;1;0;0;0
1761790;FUUU...!;;0 - 20,000;3;0;3;0;0;0
1761870;FLASHOUT 3;;0 - 20,000;59;69;-10;0;0;0
1761900;EXOME;;0 - 20,000;142;29;113;0;0;6
1762010;Wrought Flesh;;20,000 - 50,000;454;122;332;132;132;1
1762100;Mad Trapper;;0 - 20,000;1;0;1;0;0;0
1762120;The Cruise;;0 - 20,000;5;1;4;0;0;0
1762130;Dungeon Avenger;;0 - 20,000;7;8;-1;0;0;0
1762270;Obama Boss Fight;;0 - 20,000;441;16;425;0;0;3
1762370;Balcony;;0 - 20,000;21;0;21;0;0;0
1762390;HeroBattle;;20,000 - 50,000;0;1;-1;0;0;0
1762400;I Am a Rock;;0 - 20,000;28;1;27;0;0;0
1762410;NORR part II: Will Walker;;0 - 20,000;2;3;-1;0;0;0
1762450;Haunted Hotel: The Axiom Butcher Collector's Edition;;0 - 20,000;7;1;6;0;0;0
1762490;Color Guys;;0 - 20,000;3;1;2;0;0;0
1762510;Cinnet;;0 - 20,000;3;8;-5;0;0;0
1762520;Guardians of Greenheart;;0 - 20,000;1;2;-1;0;0;0
1762520;Guardians of Greenheart;;0 - 20,000;1;2;-1;0;0;0
1762550;PixelOver;;0 - 20,000;62;7;55;0;0;9
1762560;In The Valley of Death -Prologue-;;0 - 20,000;3;0;3;0;0;0
1762680;Izanami;;0 - 20,000;1;2;-1;0;0;0
1762720;Lucy;;0 - 20,000;2;0;2;0;0;0
1762830;Death in the Family;;0 - 20,000;12;10;2;0;0;1
1763050;Fears to Fathom - Norwood Hitchhike;;50,000 - 100,000;917;131;786;91;100;19
1763060;Feral Flowers;;0 - 20,000;4;0;4;0;0;0
1763160;I Am 1;;0 - 20,000;5;0;5;0;0;0
1763180;Wormatozoa;;0 - 20,000;4;1;3;0;0;0
1763290;Fight Club - All Stars;;0 - 20,000;2;0;2;0;0;0
1763330;Polyslime;;0 - 20,000;2;0;2;0;0;0
1763350;Hop Skip and Thump;;0 - 20,000;3;0;3;0;0;0
1763540;Hell Dungeons - The Lost Soul;;0 - 20,000;0;4;-4;0;0;0
1763550;TatuBall: A Minimalist LoFi Puzzle;;0 - 20,000;11;0;11;0;0;0
1763590;Chair Spinning Simulator;;0 - 20,000;6;0;6;0;0;1
1763600;Blox 3D World;;0 - 20,000;14;1;13;0;0;0
1763610;Lightout;;0 - 20,000;8;9;-1;0;0;0
1763830;My Truck Game;;0 - 20,000;141;25;116;14;14;1
1763990;Dice vs Dice;;0 - 20,000;12;3;9;0;0;0
1764000;Fishing Frenzy;;0 - 20,000;0;4;-4;0;0;0
1764010;Gold Miner;;0 - 20,000;2;4;-2;0;0;0
1764030;PixGirls;;0 - 20,000;6;3;3;0;0;0
1764230;大小串串烧;;0 - 20,000;3;0;3;0;0;0
1764240;Jewel Match Atlantis Solitaire 3 - Collector's Edition;;0 - 20,000;11;1;10;0;0;9
1764390;BAD END THEATER;;100,000 - 200,000;4486;125;4361;114;165;11
1764410;Chao's Collection of Random Games;;0 - 20,000;6;0;6;0;0;0
1764530;Sailwind;;20,000 - 50,000;842;75;767;636;789;60
1764550;100 Pumpkins;;0 - 20,000;4;1;3;0;0;0
1764660;FROM FEAR;;0 - 20,000;21;16;5;0;0;20
1764670;Bloody Everybody;;0 - 20,000;21;1;20;0;0;0
1764710;Niiikotopia: Sky Fall;;0 - 20,000;0;1;-1;0;0;0
1764730;История бомжа 2: полицейский беспредел;;0 - 20,000;20;4;16;0;0;0
1764740;because King of Beasts.;;0 - 20,000;2;3;-1;0;0;0
1764790;Moon  Defense;;0 - 20,000;2;3;-1;0;0;0
1764810;TitTok 2;;0 - 20,000;34;1;33;0;0;0
1764820;PYRMD;;0 - 20,000;12;8;4;0;0;5
1764910;Spooky Horror Game;;100,000 - 200,000;2;1;1;0;0;0
1764950;INQUIR P.T.;;0 - 20,000;1;1;0;0;0;0
1764970;Echo - An Indie Tale;;0 - 20,000;6;0;6;0;0;0
1765010;Darwin's Aquarium;;0 - 20,000;1;1;0;0;0;0
1765020;Arm Wrestling Reborn;;0 - 20,000;0;1;-1;0;0;0
1765130;Monster Dice;;0 - 20,000;2;3;-1;0;0;0
1765150;Monkey King Simulator -- Chapter Huaguo Mountain;;0 - 20,000;115;11;104;0;0;0
1765160;封神榜  伏魔三太子（重制版）;;0 - 20,000;41;12;29;0;0;3
1765220;Emote Farming Simulator - With Twitch Integration;;0 - 20,000;1;0;1;0;0;0
1765240;RollingBall;;0 - 20,000;1;0;1;0;0;0
1765260;Cat Jumper;;0 - 20,000;5;0;5;0;0;0
1765280;Pleim;;0 - 20,000;11;3;8;0;0;0
1765310;Halloween is Crazy as Hell;;0 - 20,000;14;0;14;0;0;1
1765350;候鸟;;0 - 20,000;687;9;678;0;0;6
1765470;The Tainted;;0 - 20,000;1;0;1;0;0;0
1765480;Bomb Sweeper - Mine Finder;;0 - 20,000;2;1;1;0;0;0
1765510;The Railway;;0 - 20,000;4;0;4;0;0;0
1765520;Flippin Misfits;;0 - 20,000;61;79;-18;0;0;0
1765560;Pill Baby;;0 - 20,000;53;3;50;0;0;0
1765590;Workshop Tools;;0 - 20,000;16;1;15;0;0;7
1765600;The Song Out of Space;;0 - 20,000;4;0;4;0;0;0
1765690;World Wide Hack;;0 - 20,000;53;12;41;0;0;1
1765700;Quest Of Graal;;0 - 20,000;21;1;20;0;0;0
1765800;Hidden Caves;;0 - 20,000;1;15;-14;0;0;0
1765810;Hidden Lands;;0 - 20,000;2;17;-15;0;0;1
1765820;Tranquil Cove;;0 - 20,000;18;3;15;0;0;0
1765850;Cat Fish Island;;0 - 20,000;5;1;4;0;0;0
1765960;Chezzle;;0 - 20,000;11;1;10;0;0;2
1765980;Miasma 2: Freedom Uprising;;100,000 - 200,000;1;0;1;0;0;0
1765990;PuckOFF;;0 - 20,000;13;5;8;0;0;1
1766000;Path of Ra;;0 - 20,000;25;1;24;0;0;0
1766010;Force Reboot;;0 - 20,000;252;15;237;0;0;2
1766100;The Last Hero of Nostalgaia;;0 - 20,000;579;72;507;185;185;20
1766150;Robo Vacuum Simulator;;0 - 20,000;9;3;6;0;0;0
1766180;Cards Matching Memory Game;;0 - 20,000;1;0;1;0;0;0
1766200;Apocalich;;0 - 20,000;18;8;10;0;0;1
1766230;Don't run out of Soda;;0 - 20,000;5;3;2;0;0;0
1766250;Emi & The Super Boba;;0 - 20,000;6;0;6;0;0;0
1766270;Join Rush Attack / 加入突袭;;20,000 - 50,000;3;4;-1;0;0;0
1766310;Splodge Royale;;20,000 - 50,000;3;0;3;0;0;0
1766340;Professor of Magical Studies;;20,000 - 50,000;9;1;8;0;0;0
1766350;Heroes of Book & Paper;;0 - 20,000;17;0;17;0;0;0
1766380;LONELY, LUSTFUL, ARROGANT, HATEFUL;;0 - 20,000;14;6;8;0;0;0
1766390;FORWARD: Escape the Fold - Ultimate Edition;;0 - 20,000;458;70;388;223;223;7
1766390;FORWARD: Escape the Fold - Ultimate Edition;;0 - 20,000;458;70;388;223;223;7
1766400;qingping Bookstore;;0 - 20,000;9;10;-1;0;0;0
1766440;Sokoramp;;0 - 20,000;2;1;1;0;0;0
1766540;Wonderputt Forever;;0 - 20,000;12;0;12;0;0;0
1766550;A Visit to Friends;;100,000 - 200,000;5;1;4;0;0;0
1766580;Diptych;;0 - 20,000;20;2;18;0;0;0
1766650;Funny Card;;0 - 20,000;5;1;4;0;0;0
1766660;Rain Puzzle;;0 - 20,000;1;2;-1;0;0;0
1766690;Spidded;;0 - 20,000;0;3;-3;0;0;0
1766700;Master Whip;;0 - 20,000;2;2;0;0;0;0
1766710;Afterworld King;;0 - 20,000;3;5;-2;0;0;0
1766740;Choo-Choo Charles;;200,000 - 500,000;9303;808;8495;149;179;196
1766750;Spelldrifter;;20,000 - 50,000;8;3;5;0;0;0
1766790;100 hidden birds 2;;0 - 20,000;177;5;172;0;0;1
1766810;SnOut 2;;0 - 20,000;33;3;30;0;0;2
1766830;Louder Than Words ~The Story of a Field Trip~;;0 - 20,000;3;1;2;0;0;0
1767150;First Time in Paris;;0 - 20,000;2;0;2;0;0;1
1767160;I Love Finding MORE Cats;;0 - 20,000;6;0;6;0;0;0
1767170;Super Bullet Break;;0 - 20,000;223;37;186;0;0;4
1767180;GoldfishFlap;;0 - 20,000;2;1;1;0;0;0
1767190;Threaded;;0 - 20,000;15;0;15;0;0;0
1767220;The Kids We Were;;0 - 20,000;80;7;73;474;474;1
1767250;Shadow of the Guild;;0 - 20,000;32;1;31;0;0;0
1767270;Forest adventure;;0 - 20,000;31;7;24;0;0;1
1767310;Midnight Mahjong;;0 - 20,000;136;64;72;0;0;0
1767490;Typeds;;0 - 20,000;2;0;2;0;0;0
1767560;Pro Cycling Manager 2022;;20,000 - 50,000;403;81;322;1689;1689;1141
1767570;Tour de France 2022;;0 - 20,000;81;33;48;132;132;23
1767580;Twin Mind: Power of Love Collector's Edition;;50,000 - 100,000;6;0;6;0;0;1
1767590;TealGrounds;;0 - 20,000;2;0;2;0;0;0
1767610;Super Gunfight;;0 - 20,000;11;1;10;0;0;0
1767700;Kid Hallow;;0 - 20,000;17;0;17;0;0;2
1767710;Alan and the kid;;0 - 20,000;2;0;2;0;0;0
1767730;Crusade of Deitra;;0 - 20,000;4;1;3;0;0;1
1767760;Tomb Keeper Mansion Deluxe Pinball;;20,000 - 50,000;6;0;6;0;0;0
1767780;Deformity;;0 - 20,000;4;1;3;0;0;0
1767860;Spacecraft speed;;0 - 20,000;10;0;10;0;0;0
1767890;Puzzle Art: Cats;;0 - 20,000;9;1;8;0;0;0
1767930;Back again;;20,000 - 50,000;24;1;23;0;0;0
1767940;Puzzle Art: Birds;;0 - 20,000;3;4;-1;0;0;0
1767950;Slime Dice;;0 - 20,000;15;1;14;0;0;1
1768000;Puzzle Art: Snakes;;0 - 20,000;2;0;2;0;0;0
1768030;This & Cats;;0 - 20,000;2;0;2;0;0;0
1768100;Heatris;;0 - 20,000;2;0;2;0;0;0
1768270;F-Rank hero story;;0 - 20,000;63;5;58;0;0;0
1768280;Ozymandias: Bronze Age Empire Sim;;50,000 - 100,000;459;32;427;213;290;32
1768300;Grid Miner;;0 - 20,000;32;9;23;0;0;0
1768340;XPLORASI3D;;0 - 20,000;1;1;0;0;0;0
1768350;Multris;;0 - 20,000;3;2;1;0;0;1
1768400;アーキタイプ・アーカディア;;0 - 20,000;2;0;2;0;0;0
1768480;ASTRA;;20,000 - 50,000;1;7;-6;0;0;0
1768530;MIYAMOTO S;;0 - 20,000;9;3;6;0;0;0
1768660;Saffron Fields;;200,000 - 500,000;13;0;13;0;0;0
1768730;Alien Extraction;;0 - 20,000;14;1;13;0;0;1
1768790;Edwardo;;20,000 - 50,000;6;0;6;0;0;0
1768880;KAMIMAHOU 神之国的魔法使;;0 - 20,000;282;55;227;0;0;0
1768920;Splatter;;0 - 20,000;93;2;91;0;0;2
1768990;The Flea Evolution: Bugaboo;;0 - 20,000;2;0;2;0;0;0
1769010;Hockey VR;;0 - 20,000;4;2;2;0;0;0
1769090;Fly Or Die;;20,000 - 50,000;6;3;3;0;0;0
1769150;Toolnich Village;;0 - 20,000;4;0;4;0;0;0
1769170;Shattered Pixel Dungeon;;100,000 - 200,000;725;32;693;0;0;35
1769260;Unity Testing Grounds;;0 - 20,000;3;4;-1;0;0;0
1769270;Spikair Volleyball;;0 - 20,000;19;2;17;0;0;6
1769280;LTO Arcade;;0 - 20,000;3;0;3;0;0;0
1769320;Athanasy;;20,000 - 50,000;276;8;268;660;660;7
1769360;Move That Box!;;0 - 20,000;12;0;12;0;0;0
1769380;BlitzPunch;;0 - 20,000;3;3;0;0;0;0
1769390;Lack of Water;;0 - 20,000;1;0;1;0;0;0
1769420;Noble Fates;;50,000 - 100,000;849;164;685;175;233;35
1769470;Non-Euclidean Chess;;0 - 20,000;6;3;3;0;0;1
1769510;FEWAR-DVD;;0 - 20,000;44;0;44;0;0;0
1769570;Facility;;0 - 20,000;1;0;1;0;0;0
1769630;Grim Tales: Crimson Hollow Collector's Edition;;0 - 20,000;11;5;6;0;0;1
1769630;Grim Tales: Crimson Hollow Collector's Edition;;0 - 20,000;11;5;6;0;0;1
1769640;Wilderplace;;200,000 - 500,000;17;0;17;0;0;0
1769720;SCP Foundation: ITTLG - Chapter 1;;0 - 20,000;6;1;5;0;0;0
1769730;Connection;;50,000 - 100,000;1;0;1;0;0;0
1769760;Meet PIP;;0 - 20,000;1;1;0;0;0;0
1769780;The Graffiti Creator;;0 - 20,000;4;5;-1;0;0;0
1769930;Warcos;;0 - 20,000;13;19;-6;0;0;0
1770040;The Misty Tale;;0 - 20,000;2;2;0;0;0;0
1770190;Drunken Fist 2: Zombie Hangover;;0 - 20,000;4;0;4;0;0;0
1770200;Vacation Adventures: Cruise Director 3;;0 - 20,000;1;0;1;0;0;0
1770230;SudoKube;;0 - 20,000;35;6;29;0;0;1
1770350;Starblast: Retro Wars;;0 - 20,000;2;0;2;0;0;0
1770360;Desert Magic Adventures;;0 - 20,000;2;2;0;0;0;0
1770390;Bound by Love;;20,000 - 50,000;388;78;310;56;56;8
1770400;Re:BF;;0 - 20,000;186;39;147;0;0;9
1770440;Breadbox;;0 - 20,000;10;0;10;0;0;0
1770490;PAW Patrol: Grand Prix;;0 - 20,000;16;2;14;0;0;1
1770500;Gigantosaurus: Dino Kart;;0 - 20,000;1;2;-1;0;0;1
1770540;My name is Velcro;;0 - 20,000;13;1;12;0;0;0
1770630;Fear in The Modern House - CH3;;100,000 - 200,000;0;1;-1;0;0;0
1770660;Deluded I;;50,000 - 100,000;33;8;25;0;0;0
1770820;COSPLAY LOVE! : Enchanted princess;;0 - 20,000;39;0;39;0;0;0
1770830;Virtual Maid Streamer Ramie;;0 - 20,000;30;0;30;3;3;0
1770850;Jump! Fork!;;0 - 20,000;3;1;2;0;0;0
1771000;Cry Baby;;0 - 20,000;2;3;-1;0;0;0
1771070;Midnight Scenes: The Nanny;;0 - 20,000;119;2;117;0;0;0
1771130;OPEN DOOR;;20,000 - 50,000;17;2;15;0;0;2
1771180;No Fair Play;;0 - 20,000;17;1;16;0;0;0
1771200;Cat Box Paradox;;0 - 20,000;29;0;29;0;0;0
1771210;Tear Factory;;0 - 20,000;27;1;26;0;0;0
1771310;Ghost Tokyo;;0 - 20,000;2;1;1;0;0;0
1771340;Miasma: Citizens of Free Thought;;200,000 - 500,000;6;3;3;0;0;0
1771360;Gerda: A Flame in Winter;;0 - 20,000;158;1;157;50;50;10
1771400;Die, A.I.;;0 - 20,000;12;1;11;0;0;0
1771440;Bomb Club Deluxe;;0 - 20,000;26;0;26;0;0;0
1771520;Slap The Rocks;;20,000 - 50,000;34;4;30;0;0;0
1771540;ZenVR;;0 - 20,000;14;0;14;0;0;0
1771620;THE DARK DWELLERS;;0 - 20,000;17;5;12;0;0;0
1771730;The City Must Grow;;0 - 20,000;53;8;45;0;0;0
1771780;ClayTown Horror;;0 - 20,000;17;5;12;0;0;0
1771820;ItemShop;;0 - 20,000;4;5;-1;0;0;1
1771880;UNDEMON;;0 - 20,000;11;0;11;0;0;2
1771930;Weird Cinema;;0 - 20,000;12;0;12;0;0;0
1771960;Destroying The Asteroids (Along With Unfair Hurdles);;0 - 20,000;1;0;1;0;0;0
1771990;Nyaaaanvy;;0 - 20,000;43;2;41;0;0;0
1772070;Unveiled;;20,000 - 50,000;4;0;4;0;0;0
1772070;Unveiled;;20,000 - 50,000;4;0;4;0;0;0
1772160;Nonlinear System Tools;;0 - 20,000;2;0;2;0;0;0
1772180;Eat Colors;;0 - 20,000;17;1;16;0;0;0
1772270;Flappy Octane;;0 - 20,000;6;0;6;0;0;0
1772310;Grey Heritage: Faded Vision;;0 - 20,000;27;3;24;0;0;8
1772340;The House;;0 - 20,000;2;0;2;0;0;0
1772350;重装燎原;;20,000 - 50,000;10;3;7;0;0;2
1772370;Animals Fight;;0 - 20,000;8;6;2;0;0;0
1772380;飞机女孩;;0 - 20,000;4;7;-3;0;0;1
1772410;Blood Red Fists;;0 - 20,000;0;1;-1;0;0;0
1772480;Jelle's Marble League;;0 - 20,000;90;35;55;412;412;4
1772490;Dungeon Color;;0 - 20,000;40;2;38;0;0;0
1772620;Bad Guy: Neighborhood;;0 - 20,000;3;0;3;0;0;0
1772650;Stop the Bus!;;0 - 20,000;2;2;0;0;0;0
1772710;Aeroplane Blaster;;50,000 - 100,000;11;3;8;0;0;2
1772720;Village of Zombies;;0 - 20,000;29;5;24;0;0;3
1772750;知更鸟-The Robin;;20,000 - 50,000;11;3;8;0;0;0
1772750;知更鸟-The Robin;;20,000 - 50,000;11;3;8;0;0;0
1772780;Help Me;;0 - 20,000;23;11;12;0;0;0
1772800;Airborne Motocross;;0 - 20,000;2;0;2;0;0;0
1772840;Dragon War;;20,000 - 50,000;2;0;2;0;0;0
1772910;Dead District: Survival;;0 - 20,000;140;88;52;0;0;6
1772920;Para Bellum - Hold the Line;;0 - 20,000;11;2;9;0;0;0
1772950;Outbreak: Contagious Memories;;0 - 20,000;14;5;9;0;0;2
1773060;Shoot Trip Die;;0 - 20,000;43;5;38;0;0;0
1773110;Second to Nun;;0 - 20,000;3;0;3;0;0;0
1773180;The Matriarch;;20,000 - 50,000;400;102;298;45;45;4
1773200;NMNE;;20,000 - 50,000;50;9;41;0;0;0
1773320;Coin Treasures;;0 - 20,000;75;17;58;0;0;4
1773330;DESKTOP MONKEY;;0 - 20,000;13;2;11;0;0;0
1773360;Don't Get Distracted;;0 - 20,000;3;0;3;0;0;0
1773390;The Northern Gate : Special agent;;100,000 - 200,000;1;0;1;0;0;0
1773460;Assassin at Crimson Keep;;0 - 20,000;2;0;2;0;0;0
1773560;The Tree;;0 - 20,000;21;6;15;0;0;0
1773700;Hack and Slime;;0 - 20,000;107;7;100;0;0;1
1773840;Vacation Adventures: Cruise Director 4;;0 - 20,000;2;1;1;0;0;0
1773890;100 hidden dogs;;20,000 - 50,000;251;11;240;0;0;0
1773990;Power Pushout;;0 - 20,000;4;1;3;0;0;0
1774080;Impious Pumpkins;;0 - 20,000;25;3;22;0;0;0
1774110;Escape Halloween Forest;;0 - 20,000;2;1;1;0;0;0
1774130;QontoWars;;0 - 20,000;1;0;1;0;0;0
1774160;Frog Ball Rerolled;;0 - 20,000;4;2;2;0;0;0
1774200;Abeyance;;0 - 20,000;5;3;2;0;0;0
1774390;Alien Age;;20,000 - 50,000;3;0;3;0;0;0
1774630;Hallowlands;;0 - 20,000;3;1;2;0;0;0
1774650;Fossilfuel VR: Raptor Isolation;;0 - 20,000;5;3;2;0;0;0
1774700;INVERT;;0 - 20,000;48;1;47;0;0;0
1774770;Phantom Hysteria;;0 - 20,000;36;11;25;0;0;0
1774810;Laruaville 10 Match 3 Puzzle;;0 - 20,000;1;1;0;0;0;0
1774890;Bocce Time! VR;;0 - 20,000;40;0;40;0;0;1
1774910;Bubble POP IT ASMR;;0 - 20,000;4;0;4;0;0;0
1774980;Cursed  Dungeon;;20,000 - 50,000;15;5;10;0;0;0
1775080;Animal Simulator;;0 - 20,000;12;10;2;0;0;0
1775100;Dead Tunnel;;0 - 20,000;2;0;2;0;0;0
1775150;Space Depression;;20,000 - 50,000;1;0;1;0;0;0
1775160;Geo Zombies;;0 - 20,000;3;0;3;0;0;0
1775170;Hidden Investigation: Who did it?;;0 - 20,000;0;3;-3;0;0;0
1775300;News Reacts;;0 - 20,000;19;1;18;0;0;0
1775390;Substance 3D Painter 2022;;20,000 - 50,000;430;36;394;0;0;472
1775400;Substance 3D Designer 2022;;0 - 20,000;64;3;61;0;0;65
1775410;Banished Sir;;0 - 20,000;1;1;0;0;0;0
1775410;Banished Sir;;0 - 20,000;1;1;0;0;0;0
1775470;Romino's Adventure;;0 - 20,000;9;0;9;0;0;0
1775500;Interstellar Airgap;;20,000 - 50,000;5;0;5;0;0;0
1775510;Raiders of the Icepeak Mountains;;0 - 20,000;0;1;-1;0;0;0
1775520;The Soul Stone War 2;;0 - 20,000;16;1;15;0;0;19
1775550;Gary Grigsby's War in the East 2;;0 - 20,000;183;17;166;0;0;56
1775640;Biggest Stream Hover Racing;;0 - 20,000;5;2;3;0;0;0
1775740;KSTG;;0 - 20,000;7;4;3;0;0;0
1775750;Gardener's Path;;20,000 - 50,000;18;1;17;0;0;1
1775770;All To Race;;0 - 20,000;13;5;8;0;0;0
1775860;Space Roguelike Adventure;;0 - 20,000;18;1;17;0;0;2
1775980;Sweet Hero;;0 - 20,000;0;1;-1;0;0;0
1775990;County Hospital 2;;0 - 20,000;4;11;-7;0;0;0
1775990;County Hospital 2;;0 - 20,000;4;11;-7;0;0;0
1776000;Saturn Menace;;0 - 20,000;1;1;0;0;0;0
1776170;Barton Lynch Pro Surfing;;0 - 20,000;17;3;14;0;0;0
1776260;Crazy Truck;;0 - 20,000;9;7;2;0;0;0
1776290;X Fugitive;;0 - 20,000;6;2;4;0;0;0
1776300;Dangerous platform;;0 - 20,000;14;9;5;0;0;0
1776350;Bear Adventures;;0 - 20,000;15;8;7;0;0;1
1776380;STAR OCEAN THE DIVINE FORCE;;50,000 - 100,000;1013;450;563;458;458;43
1776400;Shikkoku no Sharnoth;;0 - 20,000;52;5;47;0;0;0
1776490;Now Boarding;;0 - 20,000;11;2;9;0;0;0
1776540;Lawnmower Game: Pinball;;0 - 20,000;12;3;9;0;0;0
1776600;Clutter 12: It's About Time - Collector's Edition;;0 - 20,000;9;0;9;0;0;2
1776800;KarmaCrown;;0 - 20,000;2;0;2;0;0;0
1776860;Tank Sudoku;;20,000 - 50,000;1;0;1;0;0;0
1776900;Sunny Beach;;0 - 20,000;12;1;11;0;0;0
1776920;Cursed Town;;0 - 20,000;0;1;-1;0;0;0
1776930;Undergrave;;0 - 20,000;0;0;0;0;0;2
1776940;Fleshgait;;0 - 20,000;0;4;-4;0;0;0
1776970;Tsuki ni Yorisou Otome no Sahou;;20,000 - 50,000;1783;28;1755;969;969;100
1777000;Cut to the Core;;0 - 20,000;78;3;75;0;0;1
1777010;GDO Masters;;0 - 20,000;6;0;6;0;0;0
1777080;Mistrun;;0 - 20,000;3;6;-3;0;0;0
1777090;Halloween Stories: Horror Movie Collector's Edition;;20,000 - 50,000;17;1;16;0;0;1
1777100;Head Pain;;0 - 20,000;1;1;0;0;0;0
1777110;DogFight Time;;20,000 - 50,000;2;1;1;0;0;0
1777160;Nuclear Assault;;0 - 20,000;14;0;14;0;0;0
1777280;惊险极速;;0 - 20,000;91;5;86;0;0;0
1777380;Bullet Grinder;;20,000 - 50,000;4;3;1;0;0;0
1777430;恋爱绮谭 不存在的真相;;20,000 - 50,000;1252;43;1209;1653;2539;21
1777550;Fuyu no Tsuma;;0 - 20,000;2;2;0;0;0;0
1777560;Assembly;;0 - 20,000;0;1;-1;0;0;0
1777620;Soul Hackers 2;;50,000 - 100,000;1472;726;746;1099;1789;44
1777650;Connect the Dots;;0 - 20,000;3;4;-1;0;0;0
1777670;Medieval Trader Simulator;;20,000 - 50,000;43;59;-16;0;0;0
1777750;Ninki Seiyuu: How to Make a Pop Voice Actress;;0 - 20,000;100;6;94;0;0;0
1777820;Toilet Flushing Simulator;;0 - 20,000;44;3;41;0;0;0
1777830;Midnight: Submersion - Nightmare Horror Story;;20,000 - 50,000;113;21;92;0;0;0
1777910;Make The Jump;;0 - 20,000;2;0;2;0;0;0
1777930;School Trip;;0 - 20,000;14;8;6;0;0;0
1777940;Quake Survivor;;0 - 20,000;0;2;-2;0;0;0
1777950;Elta7;;20,000 - 50,000;3;1;2;0;0;0
1777960;SnowRocket;;0 - 20,000;0;1;-1;0;0;0
1777980;Touhou Adventure;;0 - 20,000;1;0;1;0;0;0
1778040;Airplane Dogfight Racer;;0 - 20,000;2;2;0;0;0;0
1778090;Castle Life;;0 - 20,000;9;13;-4;0;0;1
1778100;Underwater Rescue;;0 - 20,000;8;0;8;0;0;0
1778110;Alone In The Mars;;0 - 20,000;5;1;4;0;0;0
1778120;Samurai Crawler;;0 - 20,000;1;3;-2;0;0;0
1778130;Sudden Darkness;;0 - 20,000;3;2;1;0;0;0
1778190;Dark effigy;;0 - 20,000;2;1;1;0;0;0
1778210;King Boo;;0 - 20,000;57;0;57;0;0;1
1778380;Mine Upgrade;;0 - 20,000;3;1;2;0;0;1
1778460;Hidden Water;;0 - 20,000;4;8;-4;0;0;0
1778470;Hidden Town;;0 - 20,000;8;16;-8;0;0;0
1778490;Hexagourds;;0 - 20,000;3;2;1;0;0;0
1778500;Dee's Nuts;;0 - 20,000;82;4;78;0;0;1
1778520;SquareMan;;0 - 20,000;5;0;5;0;0;0
1778560;Honey Villa;;0 - 20,000;4;12;-8;0;0;0
1778630;Bee: The Knight;;0 - 20,000;28;0;28;0;0;0
1778720;Blast Beat;;0 - 20,000;42;2;40;0;0;1
1778770;Academy of Magic: The Great Dark Wizard's Curse;;0 - 20,000;7;2;5;0;0;0
1778830;Skautfold: Knight's End;;0 - 20,000;9;3;6;0;0;0
1778870;Intruder In Antiquonia;;0 - 20,000;71;6;65;0;0;0
1778890;The Wrath Of The Erlik;;0 - 20,000;0;1;-1;0;0;0
1778910;Let It Slide;;0 - 20,000;6;1;5;0;0;0
1778960;Mystery of Fortune 2 Refine;;50,000 - 100,000;72;25;47;0;0;0
1779040;Poly Memory: Furries;;0 - 20,000;3;5;-2;0;0;0
1779070;Catnight;;0 - 20,000;0;0;0;0;0;0
1779180;Knight's Try;;0 - 20,000;108;7;101;379;379;0
1779190;Soulsland;;0 - 20,000;25;10;15;0;0;0
1779200;Thrive;;50,000 - 100,000;546;50;496;515;515;26
1779210;JAMM;;0 - 20,000;5;2;3;0;0;0
1779220;Pieces of Beauty 2;;0 - 20,000;11;1;10;0;0;0
1779230;Hammer time!;;0 - 20,000;24;6;18;0;0;0
1779240;天国病院-Heaven's Hospital-;;20,000 - 50,000;4;0;4;0;0;0
1779460;My Name is Mayo 3;;0 - 20,000;111;6;105;0;0;0
1779550;Galactic Federation;;0 - 20,000;1;1;0;0;0;0
1779560;Donut Dodo;;0 - 20,000;130;1;129;0;0;4
1779590;Project Runner;;0 - 20,000;2;0;2;0;0;0
1779630;Cosmo Player Z;;0 - 20,000;5;1;4;0;0;0
1779650;Us Against Aliens;;20,000 - 50,000;11;5;6;0;0;0
1779650;Us Against Aliens;;20,000 - 50,000;11;5;6;0;0;0
1779660;I am Your King;;0 - 20,000;1;1;0;0;0;0
1779670;Find the heart;;0 - 20,000;3;0;3;0;0;0
1779680;Proto Shooter Lychee;;0 - 20,000;2;3;-1;0;0;0
1779710;SEARCH ALL - ANIMALS;;0 - 20,000;42;16;26;0;0;0
1779770;MUNCHIES;;0 - 20,000;1;1;0;0;0;0
1779790;Deadly Infestation;;0 - 20,000;21;4;17;0;0;0
1779810;Pacifist Outside;;0 - 20,000;9;0;9;0;0;0
1779940;Play Outside Simulator;;0 - 20,000;1;0;1;0;0;0
1779960;Salome's Kiss;;0 - 20,000;53;6;47;0;0;1
1779970;Asterism: Apex of War;;0 - 20,000;1;1;0;0;0;0
1780110;Take As Needed;;0 - 20,000;3;1;2;0;0;0
1780260;Challenge Dream Cat;;0 - 20,000;9;1;8;0;0;0
1780270;Laptop Tycoon;;20,000 - 50,000;178;63;115;0;0;2
1780280;Find The Murderer;;20,000 - 50,000;5;5;0;0;0;0
1780280;Find The Murderer;;20,000 - 50,000;5;5;0;0;0;0
1780290;Let's Puzzle;;0 - 20,000;23;0;23;0;0;0
1780300;Hello World;;0 - 20,000;12;1;11;0;0;0
1780340;Cyber Runner 2048;;20,000 - 50,000;3;2;1;0;0;0
1780370;Mr. Rainer's Solve-It Service;;0 - 20,000;182;4;178;0;0;0
1780410;Christmas Slots - Casino Game;;0 - 20,000;1;1;0;0;0;0
1780410;Christmas Slots - Casino Game;;0 - 20,000;1;1;0;0;0;0
1780420;The Quiet Apocalypse;;20,000 - 50,000;13;7;6;0;0;2
1780430;Gruta;;0 - 20,000;4;0;4;0;0;0
1780450;Buggy Game;;0 - 20,000;15;0;15;0;0;1
1780480;One by One;;0 - 20,000;19;0;19;0;0;4
1780490;Skull Bullets;;0 - 20,000;2;7;-5;0;0;0
1780520;The Vellescian Gambit;;0 - 20,000;12;2;10;0;0;0
1780570;Rakuten;;0 - 20,000;2;0;2;0;0;0
1780620;流放之域;;0 - 20,000;2;0;2;0;0;0
1780720;Nott Longa;;0 - 20,000;13;0;13;0;0;0
1780730;그랑 엠파이어 : 아마네;;0 - 20,000;8;2;6;0;0;0
1780840;Loch Ness;;20,000 - 50,000;38;75;-37;0;0;0
1780850;Cthulhu Dungeon;;0 - 20,000;19;5;14;0;0;1
1780880;Queue Simulator;;0 - 20,000;7;0;7;0;0;1
1780900;Knockball pool;;0 - 20,000;2;0;2;0;0;0
1780940;Inquisitor’s Heart and Soul;;0 - 20,000;31;6;25;0;0;0
1780960;Sumy Shelltris - ICEBLOCKS 1;;0 - 20,000;4;2;2;0;0;0
1781030;Fishing Paradiso;;0 - 20,000;144;12;132;0;0;1
1781040;Super Kakuro - Cross Sums;;0 - 20,000;0;4;-4;0;0;0
1781050;Robin Hood: Spring of Life;;0 - 20,000;4;2;2;0;0;2
1781170;The Flow Experience;;0 - 20,000;3;2;1;0;0;0
1781230;Happy Summer Quest;;50,000 - 100,000;3;3;0;0;0;0
1781350;Fireboy & Watergirl: Fairy Tales;;20,000 - 50,000;98;4;94;37;37;4
1781430;NotiVR;;0 - 20,000;4;0;4;0;0;1
1781580;Anivenge;;0 - 20,000;1;0;1;0;0;0
1781590;Valley Knights;;20,000 - 50,000;2;0;2;0;0;0
1781640;Spermicide;;0 - 20,000;14;0;14;0;0;0
1781720;Unstrong: Space Calamity;;0 - 20,000;2;1;1;0;0;0
1781760;Shadow Life;;0 - 20,000;1;0;1;0;0;0
1781780;Rorys Restaurant Deluxe;;0 - 20,000;3;4;-1;0;0;0
1781840;里帰り | Satogaeri;;0 - 20,000;22;6;16;0;0;0
1781880;Hardwork Simulator;;0 - 20,000;33;2;31;0;0;0
1781960;Sigil of the Magi;;0 - 20,000;20;3;17;0;0;3
1781980;Mini Island: Winter;;0 - 20,000;3;0;3;0;0;0
1782010;Serendipity Hotel;;0 - 20,000;4;7;-3;0;0;1
1782030;Universal Enemies;;20,000 - 50,000;1;0;1;0;0;0
1782050;Bloxi: The Word Game;;0 - 20,000;7;3;4;0;0;0
1782080;Das Boot: German U-Boat Simulation;;0 - 20,000;1;0;1;0;0;0
1782120;ZERO Sievert;;200,000 - 500,000;5301;510;4791;789;802;1174
1782130;1/2 Red Riding Hood;;0 - 20,000;4;16;-12;0;0;0
1782150;OVERLORD: ESCAPE FROM NAZARICK;;0 - 20,000;269;142;127;0;0;1
1782150;OVERLORD: ESCAPE FROM NAZARICK;;0 - 20,000;269;142;127;0;0;1
1782190;Farlife;;0 - 20,000;1;1;0;0;0;0
1782330;Green Hell VR;;20,000 - 50,000;504;153;351;183;211;24
1782620;Gachi Dash;;0 - 20,000;35;7;28;0;0;0
1782750;Hydra Lists;;0 - 20,000;5;0;5;0;0;0
1782790;Animal Match;;0 - 20,000;4;3;1;0;0;0
1782880;Spacious Snake;;20,000 - 50,000;22;3;19;0;0;0
1782940;Cyndefense 2;;0 - 20,000;4;1;3;0;0;0
1782960;Laboratory of Nightmares;;0 - 20,000;6;0;6;0;0;0
1783000;Diner Runners;;0 - 20,000;25;30;-5;0;0;0
1783060;Chimeras: Mortal Medicine Collector's Edition;;20,000 - 50,000;4;1;3;0;0;0
1783090;Marmoset;;0 - 20,000;29;3;26;0;0;0
1783090;Marmoset;;0 - 20,000;29;3;26;0;0;0
1783100;Slot Factory Create and Play - Magic Brewery;;0 - 20,000;0;1;-1;0;0;0
1783180;Shaped Beats;;0 - 20,000;3;2;1;0;0;0
1783280;Ghostlore;;20,000 - 50,000;153;18;135;0;0;5
1783310;Violation;;0 - 20,000;3;11;-8;0;0;0
1783350;A Frustrating Platformer;;0 - 20,000;1;0;1;0;0;0
1783370;Aery - Dreamscape;;0 - 20,000;21;4;17;0;0;0
1783380;Murder Diaries 3 - Santa's Trail of Blood;;0 - 20,000;17;2;15;0;0;0
1783490;Basketball;;0 - 20,000;9;0;9;0;0;0
1783510;Bobok;;0 - 20,000;51;2;49;0;0;0
1783530;Movavi Video Editor Plus 2022 - Video Editing Software;;0 - 20,000;112;47;65;0;0;38
1783540;Movavi Video Suite 2022 Steam Edition - Video Making Software: Video Editor Plus, Screen Recorder and Video Converter Premium;;0 - 20,000;101;38;63;0;0;31
1783700;Gachi Bird;;0 - 20,000;45;8;37;0;0;0
1783740;Essence Of The Tjikko - Prologue;;0 - 20,000;12;1;11;0;0;1
1783750;Winds & Leaves;;0 - 20,000;16;2;14;0;0;0
1783900;Debt - Chasing Treasure;;0 - 20,000;4;3;1;0;0;0
1783910;Adventures Of Two Foxes;;0 - 20,000;5;0;5;0;0;0
1784020;East Trapper;;0 - 20,000;0;1;-1;0;0;0
1784100;CubeLines;;0 - 20,000;1;0;1;0;0;0
1784160;Ilum;;100,000 - 200,000;2;1;1;0;0;0
1784180;Fragment Hunters;;0 - 20,000;2;0;2;0;0;0
1784220;Chesskoban - Chess Puzzles;;0 - 20,000;30;2;28;0;0;0
1784470;Tightrope Walking;;0 - 20,000;15;5;10;0;0;0
1784550;Demolition race;;0 - 20,000;21;7;14;0;0;0
1784570;Trainz Railroad Simulator 2022;;0 - 20,000;64;28;36;0;0;56
1784580;时间之神的猫;;0 - 20,000;12;0;12;0;0;0
1784600;Kingdom of Dinza;;0 - 20,000;10;1;9;0;0;0
1784630;Alice!;;0 - 20,000;34;7;27;0;0;2
1784730;Master Forge;;50,000 - 100,000;43;3;40;0;0;0
1784780;Hero of the Kingdom: The Lost Tales 2;;20,000 - 50,000;454;53;401;188;188;4
1784840;Ball Gun Arena;;0 - 20,000;1;0;1;0;0;0
1784940;Doomsday Scavenger | 末日清道夫;;0 - 20,000;6;1;5;0;0;0
1784950;Kungen;;0 - 20,000;2;0;2;0;0;0
1784990;// OVERDRIVE;;0 - 20,000;23;2;21;0;0;0
1785000;Mokoko X;;0 - 20,000;106;7;99;0;0;1
1785080;Arrows;;20,000 - 50,000;5;0;5;0;0;0
1785100;Stop the Saturnians!;;0 - 20,000;5;0;5;0;0;0
1785120;Forsake: Urban horror;;50,000 - 100,000;100;26;74;0;0;14
1785200;Сhick Boy Adventures;;0 - 20,000;12;4;8;0;0;2
1785260;Hero of the day;;0 - 20,000;5;9;-4;0;0;0
1785270;L.O.L. Surprise! B.B.s BORN TO TRAVEL;;0 - 20,000;1;0;1;0;0;1
1785280;Word of Kitchen;;0 - 20,000;0;1;-1;0;0;0
1785320;Dead No-Head;;0 - 20,000;20;4;16;0;0;0
1785370;Slime Escape;;0 - 20,000;19;2;17;0;0;0
1785430;Space Gliders;;0 - 20,000;1;0;1;0;0;0
1785440;Russian Train Trip;;0 - 20,000;63;47;16;0;0;0
1785450;Brooke Vs. World Doom;;0 - 20,000;5;0;5;0;0;0
1785470;Magneta Box;;0 - 20,000;3;1;2;0;0;0
1785510;HOGuru Presents: The House With Too Many Zombies In It;;20,000 - 50,000;4;1;3;0;0;0
1785530;Starbase Gunship;;100,000 - 200,000;4;0;4;0;0;0
1785560;Sky DarkCrow;;0 - 20,000;4;0;4;0;0;0
1785600;Saboteur;;20,000 - 50,000;3;0;3;0;0;0
1785680;SPECWAR Tactics;;0 - 20,000;17;8;9;0;0;2
1785750;全托教师;;0 - 20,000;5;0;5;0;0;0
1785800;Bouncy Cube;;0 - 20,000;1;1;0;0;0;0
1785910;SBK22;;0 - 20,000;74;62;12;0;0;3
1785930;Return to Kurgansk;;0 - 20,000;10;6;4;0;0;0
1785970;RoboVanRush;;0 - 20,000;1;2;-1;0;0;0
1786030;Hidden Motives: The Diamond Rush Collector's Edition;;0 - 20,000;4;4;0;0;0;2
1786100;Helium Electric;;0 - 20,000;3;0;3;0;0;0
1786130;Asha;;0 - 20,000;1;0;1;0;0;0
1786230;Breakers Collection;;0 - 20,000;52;3;49;0;0;1
1786250;Puzzle Art: Artiodactyls;;0 - 20,000;0;1;-1;0;0;0
1786260;Puzzle Art: Horses;;0 - 20,000;1;1;0;0;0;0
1786270;Puzzle Art: Predators;;0 - 20,000;5;1;4;0;0;0
1786280;Puzzle Art: Primates;;0 - 20,000;3;1;2;0;0;0
1786300;Puzzle Art: Rodents;;0 - 20,000;4;0;4;0;0;0
1786330;The Pied Piper of Gamelin;;0 - 20,000;1;0;1;0;0;0
1786350;Seventh Angel;;0 - 20,000;0;2;-2;0;0;0
1786480;Like No Other: The Legend Of The Twin Books;;20,000 - 50,000;57;5;52;0;0;0
1786590;Elisa Dragon Hunter;;0 - 20,000;21;30;-9;0;0;0
1786620;Space Hoarders Inc.;;0 - 20,000;1;2;-1;0;0;0
1786660;Marimoth;;20,000 - 50,000;5;1;4;0;0;0
1786670;仙绣剑缘录;;20,000 - 50,000;624;102;522;0;0;2
1786690;Pinballer (3D Pinball);;0 - 20,000;5;4;1;0;0;0
1786780;Batsumaru;;0 - 20,000;6;0;6;0;0;0
1786790;Magical Girl Celesphonia;;50,000 - 100,000;1406;51;1355;876;898;124
1786800;Call of Senpai: Waifu Warfare;;0 - 20,000;9;17;-8;0;0;0
1786810;BINGIMAN: Trap Ochido;;0 - 20,000;1;2;-1;0;0;0
1786830;NecroBouncer;;0 - 20,000;70;11;59;0;0;3
1787010;Campground Owner;;0 - 20,000;12;2;10;0;0;0
1787050;Voxel Farm Island;;0 - 20,000;6;4;2;0;0;2
1787080;Office No.41: Prototype Edition;;200,000 - 500,000;20;9;11;0;0;0
1787090;MyDockFinder;;200,000 - 500,000;1848;668;1180;1998;852;3028
1787120;Sparkling Memories;;0 - 20,000;121;22;99;0;0;0
1787140;RagingFist;;0 - 20,000;0;1;-1;0;0;0
1787160;Cupid Nonogram;;0 - 20,000;74;6;68;0;0;1
1787170;Squidoku;;20,000 - 50,000;3;0;3;0;0;0
1787180;Revenge on the Streets 3;;0 - 20,000;6;0;6;0;0;0
1787190;Hamster Blitz!;;0 - 20,000;6;0;6;0;0;0
1787210;YOKAIWARE;;0 - 20,000;9;0;9;0;0;0
1787320;The Atlas Mystery: A VR Puzzle Game;;20,000 - 50,000;38;7;31;0;0;0
1787400;Mandala;;0 - 20,000;5;0;5;0;0;0
1787420;The mystery of the planet venus;;20,000 - 50,000;10;1;9;0;0;0
1787440;Xangel;;50,000 - 100,000;4;1;3;0;0;0
1787450;Where Is Here: New Home;;0 - 20,000;3;0;3;0;0;0
1787470;Snake Pit;;50,000 - 100,000;25;0;25;0;0;0
1787480;Metro Simulator 2;;0 - 20,000;101;45;56;0;0;8
1787500;山：临界幸存者;;0 - 20,000;348;18;330;0;0;0
1787520;Resonance Wars;;0 - 20,000;2;0;2;0;0;0
1787600;Dark Forest: The Horror;;20,000 - 50,000;22;10;12;0;0;0
1787630;Jump Challenge!;;0 - 20,000;10;0;10;0;0;2
1787640;Kings and Pigs Prequel;;0 - 20,000;12;5;7;0;0;0
1787650;Trick or Treat;;0 - 20,000;17;4;13;0;0;0
1787690;Blade Crusade;;0 - 20,000;3;0;3;0;0;0
1787760;Pets at Work;;0 - 20,000;108;8;100;0;0;0
1787790;Kirakira Monstars;;0 - 20,000;169;156;13;0;0;2
1787800;MotoX;;0 - 20,000;1;1;0;0;0;0
1787810;Song in the Smoke;;0 - 20,000;40;8;32;0;0;0
1787820;Mirror Party;;100,000 - 200,000;878;515;363;23;16;0
1787840;琴覆天下;;0 - 20,000;8;0;8;0;0;0
1787860;Crawlspace;;0 - 20,000;61;6;55;0;0;2
1787900;VR Pictures;;0 - 20,000;2;0;2;0;0;0
1787920;万界之门;;0 - 20,000;72;16;56;0;0;0
1787960;Milling Machine Simulator 3D;;0 - 20,000;39;7;32;0;0;2
1788100;Saimin Gakushū: Secret Desire;;0 - 20,000;194;61;133;213;352;0
1788120;French Crime;;20,000 - 50,000;30;3;27;0;0;1
1788170;FILTHY US;;0 - 20,000;217;58;159;0;0;0
1788390;Insect Seeker;;0 - 20,000;7;1;6;0;0;0
1788410;BOT.vinnik Chess: Mid-Century USSR Championships;;0 - 20,000;26;1;25;0;0;0
1788430;BOT.vinnik Chess: Late USSR Championships;;0 - 20,000;24;2;22;0;0;0
1788500;Princess Defender Episode 1;;0 - 20,000;5;0;5;0;0;0
1788520;OctoMaze;;0 - 20,000;2;0;2;0;0;0
1788560;Dream Of The Hikikomori;;0 - 20,000;9;1;8;0;0;0
1788620;Task Force 88: Hostile Contact;;0 - 20,000;0;2;-2;0;0;0
1788650;Alchera;;0 - 20,000;2;1;1;0;0;0
1788750;MedaAbi: The Mystery of Pusini;;0 - 20,000;1;0;1;0;0;0
1788760;Dragon Kingdom;;0 - 20,000;1;1;0;0;0;0
1788780;VenusBlood HOLLOW International;;20,000 - 50,000;204;9;195;0;0;12
1788790;Hungry Wolf;;0 - 20,000;5;0;5;0;0;0
1788840;Porcelana;;0 - 20,000;13;0;13;0;0;1
1788850;你已经猜到结局了吗;;20,000 - 50,000;203;13;190;0;0;5
1788860;labyrinth inf;;0 - 20,000;1;1;0;0;0;0
1788880;Argonauts Agency: Chair of Hephaestus;;0 - 20,000;4;1;3;0;0;0
1788890;Argonauts Agency: Glove of Midas;;0 - 20,000;6;3;3;0;0;1
1788900;Argonauts Agency: Captive of Circe;;0 - 20,000;6;0;6;0;0;1
1788910;Argonauts Agency: Missing Daughter;;0 - 20,000;4;0;4;0;0;1
1788920;New Lands;;0 - 20,000;7;2;5;0;0;0
1788930;New Lands 2 Collector's Edition;;0 - 20,000;6;1;5;0;0;0
1788940;Shadows: Price For Our Sins;;0 - 20,000;27;8;19;0;0;3
1788950;Valentine's Day Griddlers;;0 - 20,000;0;3;-3;0;0;0
1788960;True Detective Solitaire 2;;0 - 20,000;3;1;2;0;0;1
1788970;Thanksgiving Day Griddlers;;0 - 20,000;4;0;4;0;0;0
1788980;Solitaire TED and PET;;0 - 20,000;1;1;0;0;0;0
1789050;Fuchian Chronicles;;20,000 - 50,000;5;0;5;0;0;0
1789100;Roman Wars: Deck Building Game;;0 - 20,000;5;0;5;0;0;0
1789160;PixageFX Pixel Art;;0 - 20,000;4;0;4;0;0;1
1789180;Zoo Seeker;;0 - 20,000;18;0;18;0;0;0
1789210;Laypo Simulator;;0 - 20,000;1;0;1;0;0;0
1789220;Horror haze;;0 - 20,000;5;0;5;0;0;0
1789270;Sniper Game;;0 - 20,000;25;7;18;0;0;0
1789300;White Flower;;0 - 20,000;0;6;-6;0;0;0
1789310;Monsters Loot Swag;;0 - 20,000;2;1;1;0;0;0
1789360;Void Grimm;;0 - 20,000;8;5;3;0;0;0
1789440;Ani Leaving Sirius;;0 - 20,000;6;0;6;0;0;0
1789460;Alone;;0 - 20,000;0;1;-1;0;0;0
1789480;Marauders;;500,000 - 1,000,000;10050;2605;7445;950;727;1315
1789500;Boris the Sloth;;0 - 20,000;7;0;7;0;0;0
1789560;ReDrawn: The Painted Tower Collector's Edition;;0 - 20,000;8;1;7;0;0;0
1789620;Brimstone Manor;;0 - 20,000;8;4;4;0;0;2
1789650;NEKO-MIMI SWEET HOUSEMATES Vol. 1;;0 - 20,000;213;7;206;0;0;2
1789660;The story of archer;;0 - 20,000;15;6;9;0;0;0
1789670;Me and my eldritch parasite;;0 - 20,000;11;0;11;0;0;0
1789680;Artemis;;0 - 20,000;0;1;-1;0;0;0
1790250;Moon Dancer;;0 - 20,000;28;1;27;0;0;0
1790330;The Spanish Privateer;;20,000 - 50,000;9;1;8;0;0;0
1790340;KUUKIYOMI: Consider It! ONLINE;;0 - 20,000;138;152;-14;0;0;6
1790370;Rogue AI Simulator;;20,000 - 50,000;172;32;140;6;6;26
1790470;Halloween Stories: The Neglected Dead Collector's Edition;;0 - 20,000;7;1;6;0;0;2
1790490;Regular Factory: Escape Room;;20,000 - 50,000;122;4;118;0;0;3
1790560;Chronicles of Deeps;;100,000 - 200,000;2;0;2;0;0;0
1790580;Castle Mascot;;0 - 20,000;2;0;2;0;0;0
1790580;Castle Mascot;;0 - 20,000;2;0;2;0;0;0
1790630;Astral Masters;;0 - 20,000;36;5;31;0;0;1
1790640;ThumBeat: Button Basher Edition;;0 - 20,000;5;2;3;0;0;0
1790700;Alien worm;;0 - 20,000;3;8;-5;0;0;0
1790710;Monster Fighter;;0 - 20,000;3;0;3;0;0;0
1790730;TrapBot;;0 - 20,000;2;3;-1;0;0;0
1790740;Reflex;;0 - 20,000;1;0;1;0;0;0
1790760;After the first station;;0 - 20,000;0;0;0;0;0;0
1790780;Bimous;;0 - 20,000;2;0;2;0;0;0
1790800;Brave Doggy Quest;;20,000 - 50,000;12;3;9;0;0;0
1790810;Sludge Fighters;;0 - 20,000;0;3;-3;0;0;0
1790960;Escape from the Village;;0 - 20,000;5;4;1;0;0;0
1790990;Egg King;;0 - 20,000;8;3;5;0;0;0
1791030;Motherland;;0 - 20,000;47;21;26;0;0;0
1791030;Motherland;;0 - 20,000;47;21;26;0;0;0
1791090;Timmy the Tiger's Big Adventure;;0 - 20,000;1;0;1;0;0;0
1791230;Party Friends;;0 - 20,000;2;0;2;0;0;0
1791300;Protect The Treasure;;20,000 - 50,000;0;2;-2;0;0;0
1791400;Poppy Toast;;0 - 20,000;9;0;9;0;0;0
1791410;The rise of Tianling Sect;;0 - 20,000;7;1;6;0;0;0
1791460;Cinemoji: Halloween;;0 - 20,000;15;0;15;0;0;0
1791640;Froggy;;0 - 20,000;30;10;20;0;0;0
1791650;深渊公主 Release The Bride;;0 - 20,000;17;7;10;0;0;0
1791680;KAREN SEES;;0 - 20,000;29;8;21;0;0;0
1791710;Spacefolk City;;0 - 20,000;12;1;11;0;0;0
1791790;Fire and Steel;;0 - 20,000;171;24;147;0;0;0
1791820;Zeitgeist;;0 - 20,000;11;3;8;0;0;0
1791870;Spooky Typing: The Ghost Plague;;0 - 20,000;17;2;15;0;0;0
1791880;Zombie frenzy;;0 - 20,000;0;5;-5;0;0;0
1792170;Molecoole;;0 - 20,000;3;1;2;0;0;0
1792230;Dreamer: Puzzle;;0 - 20,000;15;0;15;0;0;0
1792250;Serious Sam: Siberian Mayhem;;100,000 - 200,000;2927;223;2704;328;445;56
1792270;Sky Caravan;;0 - 20,000;38;0;38;0;0;0
1792280;SUPER ICK;;20,000 - 50,000;7;0;7;0;0;0
1792380;Memory Lost-Pairs;;0 - 20,000;1;0;1;0;0;0
1792520;Rock Star Manager;;0 - 20,000;13;5;8;0;0;2
1792600;Dusk Diver 2;;0 - 20,000;56;6;50;0;0;1
1792650;SpookyKillers: Chapter 1;;0 - 20,000;5;1;4;0;0;0
1792660;Runaway Animals;;0 - 20,000;26;3;23;0;0;0
1792700;the hardest game in the universe 2;;0 - 20,000;2;0;2;0;0;0
1792790;Dead Way;;0 - 20,000;1;3;-2;0;0;0
1792810;Acid Trip;;0 - 20,000;2;1;1;0;0;1
1792820;Blade&Sword;;50,000 - 100,000;361;199;162;11;11;2
1792890;Dreamy Planet;;0 - 20,000;23;4;19;0;0;0
1793000;Unfair Souls: Darkest Grind;;0 - 20,000;3;0;3;0;0;0
1793020;Celerity;;0 - 20,000;93;27;66;0;0;2
1793030;Romancing SaGa -Minstrel Song- Remastered;;0 - 20,000;144;19;125;0;0;95
1793040;GRAVV: Between Two Worlds;;0 - 20,000;11;0;11;0;0;0
1793070;Aery VR - Little Bird Adventure;;0 - 20,000;15;1;14;0;0;0
1793110;Hardcore: The Game;;0 - 20,000;1;0;1;0;0;0
1793120;Prototype Blocks;;0 - 20,000;16;4;12;0;0;0
1793210;DayDream Mosaics;;0 - 20,000;3;2;1;0;0;0
1793220;Airship Killer;;0 - 20,000;9;2;7;0;0;1
1793240;Destroy The Cubes 2;;0 - 20,000;12;2;10;0;0;1
1793340;Under The Warehouse;;0 - 20,000;8;0;8;0;0;0
1793360;Expresso Espresso;;0 - 20,000;0;5;-5;0;0;0
1793380;Roll The Cat;;0 - 20,000;57;2;55;0;0;0
1793420;Hovercars 3077: Underground racing;;0 - 20,000;25;1;24;0;0;0
1793500;Christmas Live Wallpaper;;0 - 20,000;28;3;25;0;0;56
1793680;The Holy Chalice;;0 - 20,000;3;0;3;0;0;0
1793780;Poly Memory: Furries 2;;0 - 20,000;1;0;1;0;0;0
1793900;Spooky Mahjong;;0 - 20,000;13;7;6;0;0;1
1793910;Drone Crash Course;;0 - 20,000;9;1;8;0;0;0
1793960;Space Rocks Blaster;;0 - 20,000;1;1;0;0;0;0
1794020;Death Slayer V;;0 - 20,000;1;2;-1;0;0;0
1794030;From Lex to Rex;;0 - 20,000;8;3;5;0;0;0
1794120;Little Stars;;0 - 20,000;2;0;2;0;0;0
1794160;Blue Barbarian Man;;0 - 20,000;2;2;0;0;0;0
1794190;Faded Memories: Video Game Edition;;0 - 20,000;2;1;1;0;0;0
1794250;After Dark VR;;0 - 20,000;56;31;25;0;0;0
1794300;BLUE WISH DESIRE;;0 - 20,000;36;0;36;0;0;0
1794380;Jump1000;;0 - 20,000;1;0;1;0;0;0
1794390;Drug Business;;0 - 20,000;18;19;-1;0;0;1
1794400;Plinko Panic!;;20,000 - 50,000;30;2;28;0;0;1
1794490;SPY RUMBLE;;0 - 20,000;11;5;6;0;0;12
1794580;Enraged;;0 - 20,000;1;2;-1;0;0;0
1794600;Dark Tales from México: Prelude. Just a Dream... with The Sack Man;;0 - 20,000;6;1;5;0;0;0
1794620;Park Life - Circuit of Happiness -;;0 - 20,000;16;8;8;0;0;0
1794670;Limited Rescue;;0 - 20,000;5;0;5;0;0;0
1794680;Vampire Survivors;;2,000,000 - 5,000,000;182923;2193;180730;1562;990;10456
1794690;Nihongo Heroes;;0 - 20,000;5;0;5;0;0;0
1794710;Infinite Progression;;0 - 20,000;3;7;-4;0;0;0
1794730;THE SPRITE TRIALS;;0 - 20,000;1;0;1;0;0;0
1794740;Fears of Glasses  o-o;;0 - 20,000;11;3;8;0;0;1
1794760;Memetric: Final Lifeforms;;0 - 20,000;16;2;14;0;0;0
1794780;SiNiSistar Lite Version;;0 - 20,000;298;26;272;0;0;6
1794860;Zombie Crush VR;;0 - 20,000;3;4;-1;0;0;0
1794930;EGG FLY;;0 - 20,000;4;0;4;0;0;0
1794950;LOST BUBBLES: Sweet mates;;0 - 20,000;44;19;25;0;0;6
1794960;Sonic Origins;;50,000 - 100,000;1587;931;656;1084;1618;59
1795010;Funtasia;;0 - 20,000;18;1;17;0;0;1
1795070;Escape Logan Estate;;0 - 20,000;7;2;5;0;0;0
1795110;150+ Card Games Solitaire Pack;;0 - 20,000;7;2;5;0;0;4
1795180;Ice Station Z;;20,000 - 50,000;82;26;56;0;0;4
1795340;Drynk: Board and Drinking Game;;0 - 20,000;1;2;-1;0;0;0
1795390;Carnage Cross;;0 - 20,000;15;3;12;0;0;0
1795410;JENTRIX;;0 - 20,000;16;0;16;0;0;1
1795420;Nanny;;0 - 20,000;2;4;-2;0;0;0
1795430;Sakura Succubus 5;;0 - 20,000;64;6;58;0;0;2
1795560;Welcome Home 2;;0 - 20,000;7;1;6;0;0;0
1795750;Conquest;;0 - 20,000;25;7;18;0;0;0
1795760;Void Heart;;0 - 20,000;3;1;2;0;0;0
1795770;Pretty Girls Rivers (Shisen-Sho);;0 - 20,000;25;5;20;0;0;0
1795780;Trance;;0 - 20,000;4;2;2;0;0;0
1795830;2021;;20,000 - 50,000;2;1;1;0;0;0
1795960;Twins Edge : Back and Forth;;0 - 20,000;110;74;36;9;9;3
1795980;Reborn Tribe;;0 - 20,000;15;4;11;0;0;5
1796080;Hero King Quest: Peacemaker Prologue;;0 - 20,000;40;6;34;0;0;0
1796100;Precursors: Armored Angels;;20,000 - 50,000;6;0;6;0;0;0
1796130;Scare: Project of Fear;;0 - 20,000;6;6;0;0;0;0
1796180;Peculiar Tales of Mid-Lake Pavilion;;0 - 20,000;147;7;140;0;0;0
1796200;Who's Who?;;20,000 - 50,000;272;73;199;241;246;0
1796200;Who's Who?;;20,000 - 50,000;272;73;199;241;246;0
1796270;Circus Pocus;;0 - 20,000;11;1;10;0;0;0
1796350;R.E.A.C.T;;0 - 20,000;0;1;-1;0;0;0
1796410;The Touryst;;0 - 20,000;51;5;46;0;0;0
1796450;Momo's Mansion;;0 - 20,000;4;0;4;0;0;0
1796500;Twinland;;0 - 20,000;6;0;6;0;0;0
1796510;Nekomimi Nikki;;0 - 20,000;2;2;0;0;0;0
1796550;Lawnarchy;;0 - 20,000;21;1;20;0;0;1
1796630;sCATch: The Painter Cat;;0 - 20,000;28;0;28;0;0;0
1796640;Homunculus Hotel;;0 - 20,000;12;0;12;0;0;0
1796750;Zovid-19 Remake;;0 - 20,000;4;0;4;0;0;0
1796840;Underground escape 地底逃生;;0 - 20,000;1;0;1;0;0;0
1796900;航天计划;;0 - 20,000;8;0;8;0;0;0
1796920;Sword of Elpisia;;0 - 20,000;7;0;7;0;0;0
1796930;Ambition Record;;0 - 20,000;5;0;5;0;0;1
1796980;CareUEyes - Blue Light Filter;;0 - 20,000;7;0;7;0;0;1
1797040;Dungeon Explorer;;0 - 20,000;14;2;12;0;0;0
1797140;UFOTOFU: HEX;;0 - 20,000;7;0;7;0;0;0
1797250;Block Collide;;0 - 20,000;9;3;6;0;0;0
1797380;7 Days Of Rose;;20,000 - 50,000;1;0;1;0;0;0
1797440;Cradle of Souls;;0 - 20,000;0;2;-2;0;0;0
1797450;FPS Arena Online;;0 - 20,000;0;1;-1;0;0;0
1797490;Showbiz Tycoon;;0 - 20,000;31;8;23;0;0;3
1797510;Tower of the Sage;;0 - 20,000;12;2;10;0;0;2
1797580;Square Shooter;;0 - 20,000;9;1;8;0;0;0
1797590;Last Space Guardian;;0 - 20,000;7;0;7;0;0;0
1797610;Barro 22;;0 - 20,000;81;12;69;0;0;1
1797680;Wee Tanks!;;0 - 20,000;262;13;249;109;124;9
1797710;Temple of Endless Night;;0 - 20,000;5;1;4;0;0;0
1797840;Cyberpunk Fighting;;0 - 20,000;19;3;16;0;0;0
1797930;Para Eyes;;0 - 20,000;47;0;47;0;0;4
1798130;ReTox;;0 - 20,000;7;0;7;0;0;0
1798150;Burning Faith;;20,000 - 50,000;2;2;0;0;0;0
1798160;Gaslamp Cases 2;;0 - 20,000;3;2;1;0;0;0
1798170;Tether;;0 - 20,000;11;0;11;0;0;0
1798290;Only Mine;;0 - 20,000;1;2;-1;0;0;1
1798310;Imitating Zombies;;0 - 20,000;1;4;-3;0;0;0
1798320;Serious Breakdown;;0 - 20,000;2;5;-3;0;0;0
1798350;Panda Punch;;0 - 20,000;5;1;4;0;0;0
1798410;Kill The Monster Z;;0 - 20,000;1;0;1;0;0;0
1798420;End of this World;;50,000 - 100,000;14;9;5;0;0;1
1798430;Shadow Сave;;100,000 - 200,000;12;2;10;0;0;0
1798460;NanoMachina;;0 - 20,000;1;0;1;0;0;0
1798470;Toy Kingdom 3;;20,000 - 50,000;1;0;1;0;0;0
1798520;Froggerty Arcade 2;;0 - 20,000;1;3;-2;0;0;1
1798540;Dino Cub;;20,000 - 50,000;20;0;20;0;0;0
1798600;Trigo;;0 - 20,000;28;6;22;0;0;0
1798640;Melodier;;0 - 20,000;17;0;17;0;0;2
1798670;Horoscopicus;;0 - 20,000;12;0;12;0;0;0
1798690;Blackjack Avenue;;0 - 20,000;7;0;7;0;0;0
1798720;Nora: The Wannabe Alchemist;;0 - 20,000;5;1;4;0;0;0
1798740;TEN - Ten Rooms, Ten Seconds;;0 - 20,000;14;0;14;0;0;1
1798750;十三月のふたり姫／The 13th month;;0 - 20,000;7;11;-4;0;0;1
1798770;Blasting Courier;;0 - 20,000;51;5;46;0;0;0
1798770;Blasting Courier;;0 - 20,000;51;5;46;0;0;0
1798780;Dimension Tripper Neptune: TOP NEP;;20,000 - 50,000;354;18;336;0;0;0
1798810;Chefy-Chef;;0 - 20,000;19;0;19;0;0;0
1798820;RoboLingo;;0 - 20,000;2;0;2;0;0;0
1798880;Corridors;;100,000 - 200,000;0;1;-1;0;0;0
1798910;Peril by MDE;;0 - 20,000;14;3;11;0;0;0
1798930;SQUID GUYS;;0 - 20,000;107;73;34;0;0;0
1798970;phoToq;;20,000 - 50,000;26;3;23;0;0;0
1799000;Memory Grove;;0 - 20,000;2;3;-1;0;0;0
1799020;Six Faces | Overpower;;0 - 20,000;19;0;19;0;0;0
1799080;疑義照会ウォーズ;;0 - 20,000;4;13;-9;0;0;0
1799110;Jumper;;0 - 20,000;1;0;1;0;0;0
1799140;Detective Agency: Murder at the Manor;;0 - 20,000;19;9;10;0;0;0
1799140;Detective Agency: Murder at the Manor;;0 - 20,000;19;9;10;0;0;0
1799160;Math+Sticks - Coffee Break Club;;0 - 20,000;38;3;35;0;0;0
1799180;Winning Love by Daylight [Ep 1+2];;0 - 20,000;20;0;20;0;0;0
1799190;120 Yen Stories;;0 - 20,000;58;1;57;0;0;0
1799220;Malice;;50,000 - 100,000;169;676;-507;0;0;6
1799260;There is No Stairs;;0 - 20,000;5;2;3;0;0;0
1799280;PABG: PLAYER ANIME BATTLEGROUNDS;;0 - 20,000;37;15;22;0;0;0
1799290;Ball Boys;;0 - 20,000;10;0;10;0;0;0
1799380;MAGLAM LORD;;0 - 20,000;35;20;15;0;0;1
1799500;Stopocop;;0 - 20,000;1;6;-5;0;0;0
1799520;The Legend of Pomodoro;;0 - 20,000;31;2;29;0;0;7
1799560;Larry The Unlucky Part 3;;0 - 20,000;27;3;24;0;0;0
1799570;Maverta;;50,000 - 100,000;5;4;1;0;0;0
1799580;Date of death: origin;;20,000 - 50,000;2;6;-4;0;0;0
1799580;Date of death: origin;;20,000 - 50,000;2;6;-4;0;0;0
1799660;アニメ Parkour War;;0 - 20,000;1;0;1;0;0;0
1799670;The Thorn of Warldia;;0 - 20,000;2;1;1;0;0;0
1799710;Tarot: Theo's Quest;;0 - 20,000;7;1;6;0;0;1
1799720;Tale of six;;0 - 20,000;1;0;1;0;0;0
1799730;Fall For You;;20,000 - 50,000;4;1;3;0;0;0
1799820;DayDream Mosaics 2: Juliette's Tale;;0 - 20,000;2;0;2;0;0;0
1799930;Redout 2;;50,000 - 100,000;590;157;433;424;424;10
1800010;Ruin or Victory;;0 - 20,000;1;0;1;0;0;0
1800030;Normal SHMUP;;20,000 - 50,000;2;1;1;0;0;0
1800070;accelerating hotkeys;;0 - 20,000;1;0;1;0;0;0
1800080;Furries & Scalies & Scarecrows OH MY!;;0 - 20,000;1;0;1;0;0;0
1800290;Bolt Action;;20,000 - 50,000;3;0;3;0;0;0
1800330;Destiny’s Plan;;0 - 20,000;2;2;0;0;0;0
1800340;cursor0x0;;0 - 20,000;3;0;3;0;0;0
1800360;Tigey's Gift;;0 - 20,000;7;1;6;0;0;0
1800560;Jagged Farm: Birth of a Hero;;0 - 20,000;0;1;-1;0;0;1
1800570;Pet Vet 3D Animal Hospital;;0 - 20,000;5;4;1;0;0;1
1800580;Pranksterz: Off Your Boss;;0 - 20,000;2;1;1;0;0;0
1800600;Punch It Deluxe;;0 - 20,000;3;1;2;0;0;0
1800640;May God Forgive Us;;0 - 20,000;2;4;-2;0;0;0
1800650;Galaxy Citizen;;50,000 - 100,000;7;4;3;0;0;0
1800690;The Piano That Stops Time;;0 - 20,000;36;15;21;0;0;0
1800780;Find Her in Dungeon (3D Quest);;0 - 20,000;0;1;-1;0;0;0
1800790;Father's Day;;0 - 20,000;270;34;236;109;109;11
1800830;Russian Drunken Boxers 2;;20,000 - 50,000;14;2;12;0;0;0
1800890;与芙兰朵露一起捉迷藏吧;;0 - 20,000;51;11;40;0;0;0
1800900;SpaceGaze;;20,000 - 50,000;17;1;16;0;0;0
1800970;Arcade Galaxy;;0 - 20,000;12;8;4;0;0;0
1800980;Fish Story;;0 - 20,000;42;5;37;0;0;0
1801000;Traffic Racing;;0 - 20,000;17;6;11;0;0;0
1801010;ASTRID;;0 - 20,000;0;1;-1;0;0;0
1801030;SOMETHING;;20,000 - 50,000;14;7;7;0;0;0
1801110;違う冬のぼくら／BOKURA;;0 - 20,000;96;37;59;0;0;159
1801190;The Shattered Elements Arena;;20,000 - 50,000;1;0;1;0;0;0
1801220;God Damn The Garden;;0 - 20,000;46;7;39;0;0;0
1801370;Being Ball;;0 - 20,000;1;0;1;0;0;0
1801450;Mysterious Night (The First Night);;0 - 20,000;2;1;1;0;0;0
1801470;Devil's Dungeon;;20,000 - 50,000;181;32;149;56;67;0
1801470;Devil's Dungeon;;20,000 - 50,000;181;32;149;56;67;0
1801560;Electronic Universe;;0 - 20,000;21;0;21;0;0;0
1801620;Being Left The F*** Alone Simulator;;0 - 20,000;11;1;10;0;0;0
1801640;精神病大王花 Flowering Abyss;;0 - 20,000;146;20;126;0;0;1
1801650;Lost: Find;;100,000 - 200,000;1678;212;1466;238;251;21
1801660;未来战士;;0 - 20,000;115;0;115;0;0;0
1801670;Gem Rifts;;0 - 20,000;8;0;8;0;0;0
1801830;Rift Sweepers;;0 - 20,000;8;8;0;0;0;6
1801850;Cats War;;0 - 20,000;261;37;224;0;0;0
1801850;Cats War;;0 - 20,000;261;37;224;0;0;0
1801920;Rorys Restaurant: Winter Rush;;0 - 20,000;5;7;-2;0;0;0
1802080;SGS Operation Hawaii;;0 - 20,000;8;5;3;0;0;5
1802210;MARK'S LIFE;;0 - 20,000;17;1;16;0;0;0
1802270;TypeOut;;0 - 20,000;7;3;4;0;0;2
1802330;INVITATION To FEAR;;100,000 - 200,000;167;94;73;36;36;51
1802430;A Maze Fox;;0 - 20,000;14;0;14;0;0;2
1802460;Pregnant;;0 - 20,000;13;7;6;0;0;1
1802500;Commuter;;0 - 20,000;11;0;11;0;0;0
1802520;Snow Scout;;0 - 20,000;6;5;1;0;0;1
1802620;Consume Thy Flesh: The Pumpkin Smashing Sim;;0 - 20,000;2;1;1;0;0;0
1802690;Carrier Command;;0 - 20,000;5;1;4;0;0;1
1802720;Sixtar Gate: STARTRAIL;;0 - 20,000;884;43;841;467;467;35
1802820;Escape Covid Camp;;0 - 20,000;1;2;-1;0;0;0
1802860;大富翁少女/Rich Girls;;0 - 20,000;217;69;148;7;7;1
1802920;Tear of Time: Lost memory;;0 - 20,000;6;0;6;0;0;0
1802930;Nailed It;;0 - 20,000;1;1;0;0;0;0
1803020;AgriLife;;0 - 20,000;9;0;9;0;0;0
1803060;The Glade;;0 - 20,000;46;14;32;0;0;1
1803150;Void Slayer;;50,000 - 100,000;15;6;9;0;0;0
1803160;CARROT;;0 - 20,000;24;1;23;0;0;0
1803170;Four Animals;;0 - 20,000;5;3;2;0;0;0
1803380;PinballAdventure;;0 - 20,000;1;0;1;0;0;0
1803400;Beneath Oresa;;0 - 20,000;267;73;194;83;83;15
1803420;They Look Like People;;50,000 - 100,000;17;7;10;0;0;0
1803440;Unnamed Arcade Engine;;0 - 20,000;0;1;-1;0;0;0
1803460;Christmas Wonderland 3;;0 - 20,000;0;1;-1;0;0;0
1803470;World Tree;;0 - 20,000;1;0;1;0;0;0
1803490;Neo Spectrum;;0 - 20,000;9;0;9;0;0;0
1803510;Curses of Tarot;;0 - 20,000;3;0;3;0;0;0
1803530;经典象棋;;0 - 20,000;4;1;3;0;0;0
1803550;MegaFactory Titan;;20,000 - 50,000;72;10;62;0;0;5
1803560;Through the world;;0 - 20,000;2;3;-1;0;0;0
1803570;青鳥樂園 Blue Bird Land EP.2 下篇;;20,000 - 50,000;4;0;4;0;0;0
1803590;Cyclone;;0 - 20,000;24;3;21;0;0;0
1803620;The Monstrous Frontier;;0 - 20,000;4;1;3;0;0;0
1803640;ONE WAY;;0 - 20,000;6;0;6;0;0;0
1803720;Escape From Eternity;;0 - 20,000;1;0;1;0;0;0
1803760;Windmills;;0 - 20,000;18;3;15;0;0;4
1803800;Emotes Creator Tool;;0 - 20,000;5;0;5;0;0;0
1803810;Warmonger: Sins of the Naga;;0 - 20,000;2;1;1;0;0;1
1803840;Lucky's Tale;;0 - 20,000;32;2;30;0;0;1
1803870;The Knight of Turn;;0 - 20,000;2;0;2;0;0;0
1803920;TownOfDestruction;;0 - 20,000;1;0;1;0;0;0
1803960;Demon Sword: Incubus;;0 - 20,000;87;28;59;0;0;1
1804070;Asteroids Extreme;;0 - 20,000;3;0;3;0;0;0
1804130;Ghoul Castle 3D: Gold Edition;;0 - 20,000;26;7;19;0;0;0
1804170;Mimicry;;0 - 20,000;49;11;38;0;0;0
1804270;Swordship;;0 - 20,000;59;3;56;0;0;1
1804280;Jo-Jo Fighter;;0 - 20,000;13;4;9;0;0;1
1804290;Circo:Dark Story;;0 - 20,000;0;1;-1;0;0;0
1804300;Patriots: Back to Civilization;;0 - 20,000;11;4;7;0;0;0
1804320;Splash Jumper;;0 - 20,000;3;3;0;0;0;0
1804360;Slot Idler;;0 - 20,000;10;2;8;0;0;0
1804370;Airball;;20,000 - 50,000;2;0;2;0;0;0
1804390;Key;;0 - 20,000;0;1;-1;0;0;0
1804420;Destruction of planets;;0 - 20,000;1;1;0;0;0;0
1804440;Trails Of Gold Privateers;;0 - 20,000;4;4;0;0;0;0
1804450;Kingdom of Maverta;;0 - 20,000;4;10;-6;0;0;3
1804500;Z-Collapse;;;;;0;;;
1804570;RED OPS ARCADE;;20,000 - 50,000;0;1;-1;0;0;0
1804590;Beyond dreams;;20,000 - 50,000;5;0;5;0;0;0
1804600;Banzai Bat;;0 - 20,000;3;0;3;0;0;0
1804640;Autos;;0 - 20,000;0;4;-4;0;0;0
1804710;Spartan;;0 - 20,000;3;0;3;0;0;4
1804720;Gates of Troy;;0 - 20,000;2;1;1;0;0;6
1804760;SEARCH ALL - CANDY;;0 - 20,000;36;3;33;0;0;0
1804820;Guide and Throw;;0 - 20,000;5;0;5;0;0;0
1804870;Dungeon Masters;;20,000 - 50,000;6;1;5;0;0;0
1804890;Turnament;;0 - 20,000;4;0;4;0;0;0
1804900;Puzzlezon;;0 - 20,000;0;2;-2;0;0;0
1804990;Tavolga-12;;0 - 20,000;0;1;-1;0;0;0
1805000;Retired Men's Nude Beach Volleyball League;;0 - 20,000;20;0;20;0;0;0
1805040;Implements of Hell;;0 - 20,000;57;21;36;0;0;0
1805070;Another Day in Paradise;;0 - 20,000;4;2;2;0;0;0
1805100;Dark City: Paris Collector's Edition;;0 - 20,000;3;2;1;0;0;0
1805140;ARAIGNEES;;0 - 20,000;16;7;9;0;0;0
1805150;Five dreams;;0 - 20,000;2;3;-1;0;0;0
1805200;Shirone: the Dragon Girl;;0 - 20,000;81;0;81;0;0;1
1805240;Layer Section & Galactic Attack S-Tribute;;0 - 20,000;22;10;12;0;0;0
1805360;Bounty game;;100,000 - 200,000;2588;693;1895;75;94;0
1805390;Follow the Black Kitten;;0 - 20,000;18;4;14;0;0;0
1805490;问道仙途2;;0 - 20,000;13;15;-2;0;0;0
1805560;Huntress: The cursed Village;;0 - 20,000;6;2;4;0;0;0
1805590;Sacred Valley;;0 - 20,000;11;7;4;0;0;1
1805650;My Universe - Doctors & Nurses;;0 - 20,000;0;3;-3;0;0;0
1805670;Cursed Island;;20,000 - 50,000;18;3;15;0;0;0
1805680;A Contusion;;0 - 20,000;2;0;2;0;0;0
1805720;Letters From the Moon;;0 - 20,000;3;0;3;0;0;0
1805810;Winter Dream;;0 - 20,000;3;0;3;0;0;0
1805930;Pumpkin Eater;;20,000 - 50,000;276;33;243;0;0;0
1806000;How To Bathe Your Cat: Drawing;;0 - 20,000;31;7;24;0;0;0
1806030;Minimal Dungeon RPG;;0 - 20,000;24;26;-2;0;0;0
1806070;畢業生模擬器;;0 - 20,000;7;2;5;0;0;0
1806090;House Sketcher 3D;;0 - 20,000;8;11;-3;0;0;1
1806130;我就是要红;;0 - 20,000;2;2;0;0;0;0
1806200;Scientifically Accurate Dinosaur Mating Simulator 2021;;0 - 20,000;2;0;2;0;0;0
1806340;MuGen - The Music Generator;;0 - 20,000;8;1;7;0;0;0
1806400;Alpha Shark;;0 - 20,000;19;1;18;0;0;0
1806420;Do U Copy?;;0 - 20,000;16;5;11;0;0;0
1806440;Boomerang Woman;;0 - 20,000;1;0;1;0;0;0
1806460;FirePuzzle - Save the House;;20,000 - 50,000;1;0;1;0;0;0
1806460;FirePuzzle - Save the House;;20,000 - 50,000;1;0;1;0;0;0
1806570;OtherSoul;;20,000 - 50,000;5;3;2;0;0;0
1806580;Neon Bricks;;0 - 20,000;15;3;12;0;0;0
1806610;Tep The Destroyer TD;;0 - 20,000;31;11;20;0;0;0
1806640;Mushroom Hunter;;0 - 20,000;15;1;14;0;0;0
1806700;Monster Girl Manager;;0 - 20,000;67;3;64;0;0;2
1806830;Deborg Desolation Pre-Born;;0 - 20,000;11;1;10;0;0;0
1806860;NEW TERRA;;0 - 20,000;7;0;7;0;0;0
1806960;Mythos: Sudoku;;0 - 20,000;21;1;20;0;0;7
1807000;Yui Tui;;0 - 20,000;1;1;0;0;0;0
1807080;Ghost Exile;;200,000 - 500,000;1746;237;1509;471;471;65
1807150;KeyHero;;20,000 - 50,000;4;1;3;0;0;0
1807200;Mirror Forge;;0 - 20,000;91;21;70;0;0;1
1807250;Scroll Of Life;;0 - 20,000;4;10;-6;0;0;0
1807300;NewHrdGame;;0 - 20,000;3;1;2;0;0;0
1807320;Bogdanoff vs. Wojak Simulator;;0 - 20,000;2;0;2;0;0;0
1807330;Tough Love Arena;;0 - 20,000;14;1;13;0;0;1
1807370;Maverta City;;20,000 - 50,000;0;3;-3;0;0;0
1807380;Animal Crusaders;;0 - 20,000;1;1;0;0;0;0
1807500;Invisible Places - Pixel Art Jigsaw Puzzle;;0 - 20,000;22;0;22;0;0;1
1807540;Cat Swap Tiles;;0 - 20,000;17;2;15;0;0;0
1807590;SALVATIONLAND;;0 - 20,000;8;0;8;0;0;1
1807600;Fatal Paws;;0 - 20,000;6;1;5;0;0;0
1807610;Skeleton Scramble Deluxe;;0 - 20,000;24;0;24;0;0;0
1807640;Alpha Zoo;;0 - 20,000;6;0;6;0;0;1
1807660;The Collector;;0 - 20,000;7;4;3;0;0;0
1807690;Roxy Raccoon's Pinball Panic;;0 - 20,000;28;1;27;0;0;2
1807730;Lab Bio-Terror;;100,000 - 200,000;14;4;10;0;0;0
1807750;封神榜2022;;50,000 - 100,000;797;68;729;0;0;1
1807930;Railway Islands - Puzzle;;20,000 - 50,000;141;7;134;0;0;1
1807940;Mortals and Monsters: Blood Orc;;0 - 20,000;9;3;6;0;0;1
1808040;On my own: A Hot Isekai Adventure;;0 - 20,000;4;1;3;0;0;0
1808080;Te Encontré;;0 - 20,000;13;1;12;0;0;1
1808110;Zombie Maze;;0 - 20,000;1;4;-3;0;0;0
1808130;Mysteries Under Lake Ophelia;;0 - 20,000;118;14;104;0;0;0
1808140;Space Waves;;20,000 - 50,000;1;0;1;0;0;0
1808230;Oppcium;;0 - 20,000;2;1;1;0;0;0
1808250;Archery Land;;0 - 20,000;12;1;11;0;0;0
1808270;Palphone-sama : Curse call;;0 - 20,000;7;2;5;0;0;0
1808310;Together My Headers;;0 - 20,000;0;1;-1;0;0;0
1808330;RGBY;;0 - 20,000;0;3;-3;0;0;0
1808350;Void Frame;;0 - 20,000;3;0;3;0;0;0
1808420;Alien Abduction Experience PC HD;;0 - 20,000;1;5;-4;0;0;0
1808480;Poly Puzzle: Cats;;0 - 20,000;3;2;1;0;0;0
1808570;Aurora's Journey and the Pitiful Lackey;;0 - 20,000;4;0;4;0;0;0
1808620;Dragon Evo;;0 - 20,000;8;3;5;0;0;3
1808630;NEDEN?;;0 - 20,000;6;4;2;0;0;0
1808690;Jericho Dungeon;;0 - 20,000;14;1;13;0;0;1
1808700;Dead Man´s Diary;;0 - 20,000;34;42;-8;0;0;0
1808730;Cellings;;0 - 20,000;42;3;39;0;0;0
1808780;祖玛少女/Zuma Girls;;20,000 - 50,000;480;96;384;31;41;3
1808820;Alien Shepherd;;0 - 20,000;3;1;2;0;0;0
1808860;Pizza Man;;0 - 20,000;7;1;6;0;0;0
1808900;GRAND CROSS: ReNOVATION;;20,000 - 50,000;76;3;73;0;0;1
1808900;GRAND CROSS: ReNOVATION;;20,000 - 50,000;76;3;73;0;0;1
1808920;Mr.Empathy: The Canceled Game.;;20,000 - 50,000;3;0;3;0;0;0
1808980;Truco;;0 - 20,000;1;2;-1;0;0;0
1809040;Base Dune;;0 - 20,000;8;4;4;0;0;1
1809310;侠之信条;;20,000 - 50,000;76;73;3;0;0;0
1809370;ANCIENT SOCCER;;0 - 20,000;0;1;-1;0;0;0
1809380;Station-Z;;100,000 - 200,000;3;0;3;0;0;0
1809420;Shankaram: CODE REBORN;;100,000 - 200,000;1;4;-3;0;0;0
1809480;Treefender;;0 - 20,000;2;1;1;0;0;0
1809500;Map Of Materials;;0 - 20,000;39;2;37;0;0;0
1809570;The Gift;;0 - 20,000;1;4;-3;0;0;0
1809700;Persona 3 Portable;;50,000 - 100,000;1650;629;1021;477;610;851
1809710;Adventure Rush;;20,000 - 50,000;37;1;36;0;0;0
1809730;babyquick : Adventure of the Moon Dragon;;0 - 20,000;15;3;12;0;0;1
1809750;Wuhan Clan;;0 - 20,000;1;0;1;0;0;0
1809770;Lust for Darkness VR: M Edition;;0 - 20,000;11;4;7;0;0;0
1809850;Suber Driver;;0 - 20,000;0;6;-6;0;0;0
1809860;Mech Arena;;0 - 20,000;1;0;1;0;0;0
1809930;Christmas With My Family - Jigsaw Puzzle;;0 - 20,000;19;0;19;0;0;0
1810020;Mizu;;0 - 20,000;2;1;1;0;0;0
1810210;Bad Cat;;0 - 20,000;63;7;56;0;0;0
1810220;Gears of Phantasm: Destiny Tailored(Act I);;0 - 20,000;1;2;-1;0;0;0
1810240;Do Something;;100,000 - 200,000;5;11;-6;0;0;0
1810270;Blood Nova;;0 - 20,000;64;1;63;0;0;0
1810310;Hidden Ghost Town;;0 - 20,000;6;8;-2;0;0;1
1810410;DELUGE;;0 - 20,000;21;1;20;0;0;0
1810430;Grim Tales: Echo of the Past Collector's Edition;;0 - 20,000;7;0;7;0;0;0
1810450;Blankiball: Der Trinksportsimulator;;0 - 20,000;5;0;5;0;0;0
1810530;The Dead Prince;;0 - 20,000;3;0;3;0;0;1
1810580;Nobody - The Turnaround;;1,000,000 - 2,000,000;8498;3843;4655;1141;714;328
1810590;Easy Sketch Pose;;0 - 20,000;9;6;3;0;0;1
1810600;Anime Jigsaw Girls - Office;;0 - 20,000;9;5;4;0;0;0
1810610;Pants Quest;;0 - 20,000;56;3;53;0;0;0
1810620;Magnet Crusher;;20,000 - 50,000;1;0;1;0;0;0
1810700;Intralism: Rebuild;;0 - 20,000;27;11;16;0;0;0
1810730;Mr.Egg:Adventure;;0 - 20,000;2;0;2;0;0;0
1810810;Underwater World;;0 - 20,000;13;6;7;0;0;0
1810840;Candy Maker;;0 - 20,000;0;1;-1;0;0;0
1810870;Myths or Reality: Fairy Lands Collector's Edition;;50,000 - 100,000;2;2;0;0;0;0
1811010;Start11;;0 - 20,000;144;27;117;0;0;2
1811040;South of the Circle;;20,000 - 50,000;517;87;430;0;0;3
1811050;Bangman;;0 - 20,000;17;6;11;0;0;0
1811070;Fritz 18 Steam Edition;;0 - 20,000;8;8;0;0;0;2
1811140;SEARCH ALL - STEAMPUNK;;200,000 - 500,000;30;1;29;0;0;0
1811260;EA SPORTS FIFA 23;;2,000,000 - 5,000,000;41497;41088;409;5296;2653;63923
1811290;Paradise Beach Girls;;0 - 20,000;2;1;1;0;0;0
1811410;World Up;;0 - 20,000;2;0;2;0;0;0
1811520;Bounty Hunters;;0 - 20,000;1;0;1;0;0;0
1811590;Heroes of Xanfurth;;0 - 20,000;6;2;4;0;0;0
1811640;The Choice VR (선택VR);;0 - 20,000;1;1;0;0;0;0
1811740;The Plague Doctor of Wippra;;0 - 20,000;140;6;134;0;0;1
1811750;VELONE;;0 - 20,000;11;16;-5;0;0;0
1811780;Throne And Crown;;20,000 - 50,000;1;1;0;0;0;0
1811820;Pixel Robot Return;;0 - 20,000;5;6;-1;0;0;0
1811860;Pussy Palace;;0 - 20,000;8;2;6;0;0;0
1811870;うんこタイピング;;0 - 20,000;7;0;7;0;0;0
1811940;Archipelago;;0 - 20,000;25;5;20;0;0;1
1811950;The Legend of Heroes: Kuro no Kiseki;;20,000 - 50,000;915;67;848;0;0;116
1812060;Yokai Art: Night Parade of One Hundred Demons;;0 - 20,000;457;53;404;245;245;24
1812090;Escape Academy;;0 - 20,000;443;62;381;402;402;46
1812140;Magnificent-1;;20,000 - 50,000;2;0;2;0;0;0
1812200;Dangerous Drift;;0 - 20,000;4;1;3;0;0;0
1812300;Aquatico;;20,000 - 50,000;288;142;146;0;0;43
1812340;Enigmarella;;0 - 20,000;14;3;11;0;0;0
1812400;Vegas Tales;;0 - 20,000;10;0;10;0;0;0
1812410;The Elder Scrolls Adventures: Redguard;;0 - 20,000;46;24;22;0;0;0
1812420;An Elder Scrolls Legend: Battlespire;;0 - 20,000;40;10;30;0;0;1
1812440;Polygon Hunter;;20,000 - 50,000;2;1;1;0;0;0
1812440;Polygon Hunter;;20,000 - 50,000;2;1;1;0;0;0
1812580;Alien Prop Hunt;;50,000 - 100,000;3;2;1;0;0;0
1812620;DSX;;50,000 - 100,000;584;106;478;59;86;13
1812840;The Labyrinth of Greed;;20,000 - 50,000;12;2;10;0;0;0
1812840;The Labyrinth of Greed;;20,000 - 50,000;12;2;10;0;0;0
1812850;Race for Your Life;;0 - 20,000;15;2;13;0;0;0
1812930;Santhai;;0 - 20,000;75;10;65;0;0;2
1812950;Ragdolls Playground: The Sandbox;;0 - 20,000;5;2;3;0;0;1
1812960;Floor is Lava;;200,000 - 500,000;35;8;27;0;0;0
1812970;Immortal Tactics: War of the Eternals;;0 - 20,000;84;8;76;0;0;0
1813100;Super Squidlit;;0 - 20,000;10;0;10;0;0;0
1813140;Christmas Horror;;0 - 20,000;19;12;7;0;0;0
1813190;Little Inner Monsters - Card Game;;0 - 20,000;43;2;41;0;0;0
1813240;Boss Beek-Beekeeping Simulator;;0 - 20,000;3;4;-1;0;0;0
1813270;Poptropica;;0 - 20,000;57;30;27;20;20;16
1813310;Spin Fighter;;0 - 20,000;0;2;-2;0;0;0
1813340;Cube Space;;0 - 20,000;17;2;15;0;0;0
1813370;To Carry a Sword;;20,000 - 50,000;4;2;2;0;0;0
1813400;Santa Protects the Christmas Tree;;0 - 20,000;6;0;6;0;0;0
1813440;Kitten Hero;;0 - 20,000;11;0;11;0;0;1
1813550;ARTISAN;;0 - 20,000;8;1;7;0;0;0
1813560;Deranged;;0 - 20,000;2;4;-2;0;0;0
1813570;jingor sudoku;;0 - 20,000;1;1;0;0;0;0
1813650;VR Sweet Heart;;0 - 20,000;9;8;1;0;0;0
1813690;Parametric Creature: Lab;;0 - 20,000;24;0;24;0;0;0
1813790;Sin Bearers Tactics;;0 - 20,000;1;2;-1;0;0;0
1813890;Flannel Amethyst;;0 - 20,000;19;14;5;0;0;0
1813910;Screaming Loaf;;0 - 20,000;6;0;6;0;0;0
1813930;Angels Prayer;;0 - 20,000;2;2;0;0;0;0
1813940;Fruit Basket;;0 - 20,000;1;9;-8;0;0;0
1813990;Dinosaur Race;;0 - 20,000;4;0;4;0;0;0
1814000;Knight Runaway;;0 - 20,000;1;4;-3;0;0;0
1814010;Stuck In Time;;50,000 - 100,000;527;92;435;5907;9632;58
1814060;Virus at Home;;0 - 20,000;26;3;23;0;0;0
1814100;In Shape 2;;0 - 20,000;1;0;1;0;0;0
1814110;Kitty Cat Squash;;0 - 20,000;9;0;9;0;0;0
1814150;Atomic Cyclecar Racing;;0 - 20,000;4;0;4;0;0;0
1814160;Crazy Santa;;0 - 20,000;34;11;23;0;0;0
1814170;Lingo;;0 - 20,000;39;2;37;0;0;6
1814200;He Will Shoot;;50,000 - 100,000;15;15;0;0;0;1
1814240;The Thing from Nowhere;;0 - 20,000;2;0;2;0;0;0
1814260;Cold Verdict;;0 - 20,000;15;2;13;0;0;0
1814270;Metallophobia;;0 - 20,000;13;0;13;0;0;1
1814460;The Brave vs Dragon;;0 - 20,000;19;5;14;0;0;9
1814490;Scratch Girl;;20,000 - 50,000;157;50;107;14;14;0
1814510;Yavi;;0 - 20,000;15;1;14;0;0;0
1814520;Find The Cat;;0 - 20,000;2;1;1;0;0;0
1814540;Cosmos Conquer;;0 - 20,000;1;1;0;0;0;0
1814560;The Infecting 3;;0 - 20,000;7;2;5;0;0;0
1814570;Transcendence Legacy - Voidswept;;20,000 - 50,000;28;6;22;0;0;2
1814590;Clocknockers;;0 - 20,000;3;1;2;0;0;0
1814610;Middle Ages Jigsaw Puzzles;;0 - 20,000;1;0;1;0;0;1
1814710;Cute Dogs;;0 - 20,000;57;2;55;0;0;0
1814770;Tall Poppy;;0 - 20,000;109;14;95;0;0;1
1814800;Sabotage 1.0;;20,000 - 50,000;2;0;2;0;0;0
1814870;Fire in the Beastlands;;0 - 20,000;12;0;12;0;0;0
1814930;Kurokami-sama's Feast;;0 - 20,000;31;4;27;0;0;0
1814950;Diefrosty;;0 - 20,000;33;5;28;0;0;0
1814990;不充钱还想过关的坦克大战？;;20,000 - 50,000;18;1;17;0;0;0
1815000;Dungeon Alone;;0 - 20,000;22;2;20;0;0;0
1815010;Maid Knight Alicia;;0 - 20,000;76;15;61;0;0;1
1815020;CosmicBreak Gun & Slash;;0 - 20,000;1;6;-5;0;0;0
1815030;G-MODEアーカイブス+ 弾幕検定死験-大往生編-;;0 - 20,000;7;0;7;0;0;0
1815050;Blockgeon;;0 - 20,000;2;0;2;0;0;0
1815110;CubeHook VR;;0 - 20,000;3;1;2;0;0;0
1815170;Asteroides;;0 - 20,000;5;1;4;0;0;0
1815190;Saving Sunrise;;0 - 20,000;1;2;-1;0;0;0
1815230;Summum Aeterna;;0 - 20,000;155;14;141;0;0;1
1815260;CHESS CROWN;;0 - 20,000;2;2;0;0;0;0
1815270;PRIMAFLOOWS;;20,000 - 50,000;12;6;6;0;0;0
1815310;Arcante: Definitive Edition;;0 - 20,000;3;3;0;0;0;0
1815370;咸鱼的挂机游戏;;0 - 20,000;27;3;24;0;0;25
1815400;SKAZKA;;0 - 20,000;14;1;13;0;0;0
1815430;Cursed House 10 - Match 3 Puzzle;;0 - 20,000;3;0;3;0;0;2
1815440;Chinese Driving Test Simulator;;50,000 - 100,000;353;152;201;15;24;4
1815450;The World's Hardest Game 3D 2;;0 - 20,000;4;0;4;0;0;0
1815530;Dungeon Defenders: Going Rogue;;0 - 20,000;124;109;15;83;83;4
1815540;BLINNK and the Vacuum of Space;;0 - 20,000;2;0;2;0;0;1
1815580;Gunner Deadly Expedition;;0 - 20,000;12;4;8;0;0;0
1815630;Fences 4;;0 - 20,000;85;27;58;2;2;2
1815730;BallRoll;;0 - 20,000;1;4;-3;0;0;0
1815750;How to Take Off Your Mask Remastered;;20,000 - 50,000;5;0;5;0;0;0
1815800;How to Fool a Liar King Remastered;;0 - 20,000;4;0;4;0;0;0
1815820;How to Sing to Open Your Heart Remastered;;0 - 20,000;3;0;3;0;0;1
1815860;Maze Art: Black;;0 - 20,000;5;7;-2;0;0;0
1815880;Maze Art: Blue;;0 - 20,000;5;4;1;0;0;0
1815890;Lights;;0 - 20,000;5;3;2;0;0;0
1815970;A Clockwork Ley-Line: Daybreak of Remnants Shadow;;0 - 20,000;15;1;14;0;0;3
1816050;Kamigami: Clash of the Gods;;0 - 20,000;12;2;10;0;0;2
1816070;ILLUMINATI;;0 - 20,000;25;8;17;0;0;3
1816100;VR Tablet PC;;0 - 20,000;1;1;0;0;0;0
1816270;Alone With You;;0 - 20,000;8;2;6;0;0;0
1816300;HARVESTELLA;;20,000 - 50,000;1116;291;825;1123;1185;74
1816380;Golden Age;;20,000 - 50,000;3;2;1;0;0;0
1816410;Maze Art: Brown;;0 - 20,000;5;1;4;0;0;0
1816420;Maze Art: Green;;0 - 20,000;7;4;3;0;0;0
1816520;Motorbike Traffic Splash;;0 - 20,000;2;4;-2;0;0;0
1816530;haunt;;20,000 - 50,000;3;3;0;0;0;0
1816570;江湖十一;;100,000 - 200,000;1820;3146;-1326;402;575;101
1816650;Nelson and the Magic Cauldron: The Journey;;0 - 20,000;26;4;22;0;0;1
1816690;Skew Pong;;0 - 20,000;8;0;8;0;0;0
1816890;TENDY: Robot Gardener;;20,000 - 50,000;23;3;20;0;0;0
1816900;Aberration;;0 - 20,000;6;1;5;0;0;0
1816930;Mad Experiments 2: Escape Room;;0 - 20,000;39;20;19;0;0;2
1816960;Christmas Wonderland 12;;0 - 20,000;2;0;2;0;0;0
1817000;Zodiacats;;0 - 20,000;397;2;395;0;0;7
1817020;Citrus Rampage;;0 - 20,000;8;0;8;0;0;0
1817070;Marvel’s Spider-Man Remastered;;2,000,000 - 5,000,000;55656;1908;53748;1850;1367;3393
1817110;Isaiah 188;;20,000 - 50,000;4;1;3;0;0;0
1817120;Combat Troops VR;;0 - 20,000;13;8;5;0;0;0
1817140;Ending Way;;0 - 20,000;4;0;4;0;0;0
1817190;Marvel’s Spider-Man: Miles Morales;;200,000 - 500,000;12427;761;11666;1455;1501;1301
1817200;this House;;0 - 20,000;5;1;4;0;0;0
1817230;Hi-Fi RUSH;;200,000 - 500,000;10417;211;10206;609;703;1944
1817290;In Nightmare;;0 - 20,000;41;3;38;0;0;2
1817400;Mistake;;0 - 20,000;26;5;21;0;0;0
1817470;An Outcry;;0 - 20,000;75;6;69;0;0;0
1817560;VOIDCRISIS;;0 - 20,000;67;61;6;0;0;0
1817670;SurvivalIsLand;;0 - 20,000;7;3;4;0;0;0
1817880;Vacation Adventures: Park Ranger 8;;0 - 20,000;2;0;2;0;0;0
1817940;Love Delivery;;50,000 - 100,000;1976;71;1905;318;408;34
1818150;Pinecone Game;;0 - 20,000;43;2;41;0;0;1
1818180;The RPG Engine;;0 - 20,000;104;2;102;0;0;9
1818230;Lodventure;;0 - 20,000;41;5;36;0;0;12
1818240;Anime Jigsaw Girls - Christmas;;0 - 20,000;8;2;6;0;0;0
1818250;BOXNIGMA;;0 - 20,000;15;3;12;0;0;0
1818270;Super Yodelland: Legend of the Katzenbär;;0 - 20,000;1;0;1;0;0;0
1818320;いせかいあどべんちゃー;;0 - 20,000;15;7;8;0;0;0
1818340;Creatures: The Albian Years;;100,000 - 200,000;7;1;6;0;0;0
1818580;Creator's Asteroid;;0 - 20,000;3;0;3;0;0;0
1818610;Karagon (Survival Robot Riding FPS);;0 - 20,000;37;18;19;0;0;62
1818640;Thugs Never Die;;0 - 20,000;6;7;-1;0;0;0
1818690;Grindstone;;0 - 20,000;103;7;96;354;354;6
1818750;MultiVersus;;5,000,000 - 10,000,000;80990;11888;69102;457;130;1106
1818770;Nebula Invasion;;0 - 20,000;8;0;8;0;0;0
1818790;Maze Art: Orange;;0 - 20,000;7;5;2;0;0;1
1818800;Maze Art: Pink;;0 - 20,000;8;4;4;0;0;0
1818810;Maze Art: Purple;;0 - 20,000;4;2;2;0;0;0
1818830;Maze Art: Red;;0 - 20,000;8;1;7;0;0;0
1818840;Maze Art: Yellow;;0 - 20,000;0;3;-3;0;0;0
1818880;BangBang PewPew;;20,000 - 50,000;14;1;13;0;0;0
1818880;BangBang PewPew;;20,000 - 50,000;14;1;13;0;0;0
1818940;Typing Land;;0 - 20,000;23;1;22;0;0;2
1819020;救公主？救个屁！ Save the princess？Save a fart！;;20,000 - 50,000;195;56;139;0;0;0
1819090;Watermelon Wars;;0 - 20,000;6;2;4;0;0;0
1819120;死亡编码-Death Code;;0 - 20,000;7;2;5;0;0;0
1819180;Oxide Room 104;;0 - 20,000;96;38;58;0;0;1
1819190;Rescue Helicopter;;0 - 20,000;1;6;-5;0;0;0
1819210;X Virus;;20,000 - 50,000;3;2;1;0;0;0
1819230;UDONGEIN X;;0 - 20,000;229;9;220;0;0;2
1819280;Hot Roads;;0 - 20,000;1;0;1;0;0;0
1819290;Spaceship Hunters;;0 - 20,000;3;0;3;0;0;0
1819340;SUL 3D - Schütze Unser Land;;0 - 20,000;10;2;8;0;0;1
1819430;DREAM;;0 - 20,000;1;0;1;0;0;0
1819440;Block Line Engineer;;0 - 20,000;8;7;1;0;0;1
1819520;Constellations: Puzzles in the Sky;;0 - 20,000;18;0;18;0;0;0
1819540;Santa Slays Nazis;;0 - 20,000;3;1;2;0;0;0
1819560;Ice sugar;;0 - 20,000;9;3;6;0;0;1
1819660;Eyes Over Us;;20,000 - 50,000;12;3;9;0;0;0
1819800;VILLAGE THE SIBERIA;;0 - 20,000;30;10;20;0;0;0
1819860;Thalamus;;0 - 20,000;14;4;10;0;0;1
1819870;Draft Day Sports: Pro Basketball 2022;;0 - 20,000;12;7;5;0;0;13
1819900;Shootvaders: The Beginning;;0 - 20,000;2;1;1;0;0;0
1819950;JETBOUNCE;;0 - 20,000;13;0;13;0;0;0
1819960;Stretchy-Man: The Video Game;;0 - 20,000;4;0;4;0;0;0
1819980;Writer's Life;;20,000 - 50,000;385;89;296;0;0;14
1820020;BattlefieldCars;;0 - 20,000;0;1;-1;0;0;0
1820060;My University Girlfriend;;0 - 20,000;60;9;51;0;0;1
1820090;Trisceli特里西利;;0 - 20,000;2;0;2;0;0;0
1820160;Super Clown: Lost Diamonds;;0 - 20,000;57;14;43;0;0;0
1820180;Color by Number - Monster Heroes;;0 - 20,000;4;1;3;0;0;0
1820320;神徒;;50,000 - 100,000;31;11;20;0;0;0
1820350;Examination Chambers;;0 - 20,000;7;0;7;0;0;0
1820380;Let's Cook;;0 - 20,000;7;0;7;0;0;0
1820390;Solitaire Harmony;;0 - 20,000;15;0;15;0;0;0
1820560;Big Booty Adventures;;20,000 - 50,000;14;2;12;0;0;0
1820570;Panic Porcupine;;0 - 20,000;36;2;34;0;0;1
1820640;Marimo -VS- I.A.S;;0 - 20,000;2;0;2;0;0;0
1820690;One Line;;20,000 - 50,000;22;1;21;0;0;0
1820700;Praecantor Lila ~ Bell Spell;;0 - 20,000;3;0;3;0;0;0
1820710;VR Dodgeball Trainer;;0 - 20,000;1;0;1;0;0;0
1820720;The Divine Deception;;20,000 - 50,000;19;1;18;0;0;1
1820770;DUCK: Dangerous Ultimate Cartridge Kidnapper;;20,000 - 50,000;47;2;45;0;0;3
1820810;Graveyard Spells;;0 - 20,000;4;0;4;0;0;0
1820890;Princess Sera adventures;;50,000 - 100,000;13;1;12;0;0;0
1820910;Labyrinth of death;;0 - 20,000;12;3;9;0;0;0
1820980;Mars parking simulator;;0 - 20,000;12;7;5;0;0;0
1821000;Turk-A-Lurk;;0 - 20,000;2;0;2;0;0;0
1821060;Find The Sunbed;;200,000 - 500,000;6;0;6;0;0;0
1821070;Grey Block;;0 - 20,000;3;2;1;0;0;0
1821090;Cinemoji: Series;;0 - 20,000;19;0;19;0;0;1
1821150;Connectify;;0 - 20,000;2;2;0;0;0;0
1821320;REX;;0 - 20,000;0;2;-2;0;0;0
1821340;Hole in the Clouds;;0 - 20,000;32;1;31;0;0;0
1821410;UNSTABLE;;0 - 20,000;1;2;-1;0;0;0
1821420;Battle Of The Robots;;0 - 20,000;1;3;-2;0;0;0
1821430;Tiny Tank:Dawn of Steel;;0 - 20,000;10;2;8;0;0;0
1821440;Hackers in Battlefield;;0 - 20,000;0;1;-1;0;0;0
1821460;Project Unirah;;0 - 20,000;3;2;1;0;0;0
1821490;Future Tanks Area;;20,000 - 50,000;1;2;-1;0;0;0
1821510;A Space Odyssey;;0 - 20,000;0;1;-1;0;0;0
1821530;Break Through The Illusion;;0 - 20,000;2;0;2;0;0;0
1821580;Just Fly;;0 - 20,000;1;1;0;0;0;0
1821630;They Сame From Above;;0 - 20,000;10;8;2;0;0;0
1821680;The Adventurer's Domain Online;;20,000 - 50,000;83;45;38;0;0;22
1821690;Sakura Sunshine;;0 - 20,000;1;0;1;0;0;0
1821860;TOUGE RACERS;;0 - 20,000;0;2;-2;0;0;0
1821910;Adamanta View;;0 - 20,000;0;2;-2;0;0;0
1821920;Dive Bar Superstars;;0 - 20,000;2;0;2;0;0;0
1821950;Wizard time!;;0 - 20,000;0;2;-2;0;0;0
1821960;The Psychoduck;;0 - 20,000;16;1;15;0;0;0
1822010;Milliopoly - Language Quiz and Learning;;0 - 20,000;1;1;0;0;0;0
1822140;Lobster Game;;0 - 20,000;14;16;-2;0;0;0
1822230;Kokoro Clover Season1;;0 - 20,000;17;2;15;0;0;4
1822450;The Slaverian Trucker;;0 - 20,000;211;30;181;0;0;8
1822490;一花一世界 | The Lotus;;0 - 20,000;4;3;1;0;0;0
1822500;Mixx Island: Remix Vol. 2;;0 - 20,000;11;0;11;0;0;0
1822640;Rogue Dungeon;;0 - 20,000;14;5;9;0;0;3
1822710;Automon;;0 - 20,000;102;8;94;0;0;3
1822770;Abduction;;0 - 20,000;5;4;1;0;0;0
1822900;Soulflow;;0 - 20,000;33;2;31;0;0;0
1822910;Capybara Spa;;20,000 - 50,000;978;25;953;0;0;3
1822940;Sorcerer's Tournament;;0 - 20,000;1;0;1;0;0;0
1822970;Shadowgate VR: The Mines of Mythrok;;0 - 20,000;14;4;10;0;0;0
1823020;Retro TV Game Collection;;0 - 20,000;5;0;5;0;0;0
1823070;Mugen Journey;;0 - 20,000;2;1;1;0;0;0
1823100;The Pest;;0 - 20,000;4;0;4;0;0;0
1823170;Cosmos Bit;;0 - 20,000;34;3;31;0;0;0
1823190;A Violent Revelry;;0 - 20,000;51;21;30;0;0;1
1823260;Gravix;;0 - 20,000;2;0;2;0;0;0
1823400;斗士 Fighter;;0 - 20,000;1;1;0;0;0;0
1823430;KaraCreate;;0 - 20,000;1;1;0;0;0;0
1823540;Criminal Archives: City on Fire Collector's Edition;;20,000 - 50,000;7;0;7;0;0;2
1823570;Age of Valakas: Vietnam;;0 - 20,000;41;7;34;0;0;0
1823600;Power & Revolution 2022 Edition;;0 - 20,000;348;226;122;403;403;201
1823610;7 Days To Save The World;;0 - 20,000;5;1;4;0;0;0
1823630;魔法少女ですがダンジョンで無限に強くなってもいいですか;;0 - 20,000;3;1;2;0;0;0
1823670;Edessa: School of Wizardry;;20,000 - 50,000;11;1;10;0;0;0
1823710;Hot Springs Story;;0 - 20,000;131;9;122;0;0;43
1823740;Drawize - Draw and Guess;;0 - 20,000;1;1;0;0;0;0
1823750;NECROTOPIA;;0 - 20,000;4;2;2;0;0;0
1823830;Basault VR;;0 - 20,000;5;2;3;0;0;0
1823860;Galactic Ravager;;0 - 20,000;1;3;-2;0;0;1
1823900;Creatures Village;;20,000 - 50,000;4;1;3;0;0;0
1823910;Mondrian Squares;;0 - 20,000;3;2;1;0;0;0
1823930;Wavetale;;0 - 20,000;103;11;92;0;0;1
1823940;Defenders Glory;;0 - 20,000;12;2;10;0;0;4
1824010;QuaQua;;0 - 20,000;12;0;12;0;0;0
1824020;Cruise Ship Handling;;0 - 20,000;9;2;7;0;0;0
1824070;Rejoinder;;0 - 20,000;3;2;1;0;0;0
1824080;LUL inc.;;0 - 20,000;99;2;97;0;0;0
1824110;HOSTLIGHT;;0 - 20,000;5;0;5;0;0;0
1824130;Outside the Window;;0 - 20,000;31;3;28;0;0;0
1824150;Tales of Terror;;50,000 - 100,000;12;14;-2;0;0;0
1824160;A Noite Sem Fim;;50,000 - 100,000;6;0;6;0;0;0
1824210;Istanbul Ship Simulator;;0 - 20,000;5;6;-1;0;0;0
1824220;Chivalry 2;;2,000,000 - 5,000,000;18899;4126;14773;1301;648;1912
1824260;Scholar;;0 - 20,000;1;2;-1;0;0;0
1824390;Prototype Blocks 2;;0 - 20,000;13;1;12;0;0;0
1824440;HUNDRED FIRES: The rising of red star - EPISODE 1;;0 - 20,000;22;4;18;0;0;0
1824450;Ricochet;;0 - 20,000;5;2;3;0;0;0
1824520;CaptMeow;;0 - 20,000;3;1;2;0;0;0
1824740;黑白米拖更记;;0 - 20,000;2;0;2;0;0;0
1824750;No Rage Quit Dude;;0 - 20,000;1;0;1;0;0;0
1824750;No Rage Quit Dude;;0 - 20,000;1;0;1;0;0;0
1824800;Fast Fruit;;0 - 20,000;1;0;1;0;0;0
1824820;Popped Up;;0 - 20,000;2;0;2;0;0;0
1824970;Escape from Cronos X;;0 - 20,000;9;4;5;0;0;0
1824990;Marmalade box;;0 - 20,000;10;0;10;0;0;1
1825010;MMA Championship;;0 - 20,000;4;0;4;0;0;0
1825060;Poly Memory: Cats;;0 - 20,000;1;4;-3;0;0;0
1825070;Modest Eyes;;0 - 20,000;10;6;4;0;0;0
1825080;Explosive Snooker;;0 - 20,000;12;2;10;0;0;1
1825130;Ignis Corruption;;0 - 20,000;4;3;1;0;0;0
1825160;The Backrooms;;0 - 20,000;45;11;34;0;0;2
1825180;Auro The Bunny;;0 - 20,000;4;0;4;0;0;0
1825310;Lupa;;0 - 20,000;1;1;0;0;0;0
1825350;Haunted Hotel: Silent Waters Collector's Edition;;0 - 20,000;11;2;9;0;0;1
1825380;Maroon Berets: 2030;;20,000 - 50,000;19;14;5;0;0;0
1825390;MadMan;;0 - 20,000;7;12;-5;0;0;0
1825530;Little Sparks;;0 - 20,000;0;1;-1;0;0;0
1825540;Superposition;;0 - 20,000;9;0;9;0;0;0
1825620;Blank Frame;;20,000 - 50,000;48;6;42;0;0;1
1825670;Santa's Slippery Slope (Ski Stunts);;0 - 20,000;11;1;10;0;0;0
1825690;Starship Wars;;20,000 - 50,000;14;1;13;0;0;0
1825740;Fat Baby;;0 - 20,000;86;14;72;0;0;3
1825780;上班摸鱼模拟器 - Lazy at work;;0 - 20,000;0;8;-8;0;0;0
1825850;Pixel Game Maker Series MEDIUM-NAUT;;0 - 20,000;6;1;5;8;8;0
1825880;作死吧！UP主！;;0 - 20,000;41;9;32;0;0;5
1825910;ChickenZ;;0 - 20,000;20;2;18;0;0;0
1825930;孤岛海妖 The Sea-demon;;0 - 20,000;156;17;139;0;0;2
1825970;Blockworks;;0 - 20,000;21;3;18;0;0;2
1825990;Unidentified;;20,000 - 50,000;2;4;-2;0;0;0
1826030;Dark Reflections - Shiori no Kotoha;;0 - 20,000;5;3;2;0;0;0
1826070;ALONE;;0 - 20,000;4;4;0;0;0;0
1826090;Kalyzmyr;;0 - 20,000;30;0;30;0;0;0
1826100;Legend of Egypt - Jewels of the Gods 2;;0 - 20,000;0;1;-1;0;0;0
1826160;The Asmodian Princesses and the Witch in the Forest;;0 - 20,000;21;8;13;0;0;0
1826210;Relic Adventure;;0 - 20,000;3;0;3;0;0;0
1826290;WWII Tanks: Battlefield;;0 - 20,000;44;8;36;0;0;0
1826300;SOTANO - Mystery Escape Room Adventure;;0 - 20,000;23;11;12;0;0;0
1826410;Runnyk;;0 - 20,000;10;1;9;0;0;1
1826450;Idling Idol;;0 - 20,000;18;3;15;0;0;2
1826500;Endless Match;;100,000 - 200,000;11;4;7;0;0;0
1826530;Forsaken;;0 - 20,000;0;3;-3;0;0;0
1826540;No Haste;;0 - 20,000;9;0;9;0;0;0
1826570;First Class Escape 2: Head in the Clouds;;0 - 20,000;100;21;79;0;0;11
1826640;Wall to Wall;;0 - 20,000;4;4;0;0;0;0
1826760;Among the zombies;;0 - 20,000;17;14;3;0;0;0
1826860;Sewer Rave;;0 - 20,000;129;2;127;0;0;0
1826910;Please Subscribe;;0 - 20,000;92;16;76;0;0;2
1827060;Tower of Ascension;;0 - 20,000;3;4;-1;0;0;0
1827290;Turpedo;;0 - 20,000;4;2;2;0;0;0
1827300;Alone but strong;;20,000 - 50,000;3;4;-1;0;0;0
1827300;Alone but strong;;20,000 - 50,000;3;4;-1;0;0;0
1827310;Imoto No Yume;;0 - 20,000;3;3;0;0;0;0
1827430;Yum Yum Cookstar;;0 - 20,000;1;1;0;0;0;0
1827460;Nonstop;;0 - 20,000;6;0;6;0;0;0
1827500;Generations Of Destruction;;0 - 20,000;1;0;1;0;0;0
1827600;Newton Going Home;;0 - 20,000;34;0;34;0;0;0
1827660;Loco Shortline Operations;;0 - 20,000;43;3;40;0;0;4
1827690;CHEMISTS: Area of infection;;0 - 20,000;38;7;31;0;0;0
1827700;Microbrewery Tycoon;;0 - 20,000;6;1;5;0;0;0
1827720;Sabotris;;0 - 20,000;5;0;5;0;0;0
1827740;Kombinera;;0 - 20,000;10;1;9;0;0;1
1827760;Dungeon Death;;0 - 20,000;12;1;11;0;0;0
1827770;Bouncy Bunnies;;0 - 20,000;3;2;1;0;0;0
1827780;Roof Genocide;;50,000 - 100,000;3;1;2;0;0;0
1827840;LunaQuest;;20,000 - 50,000;0;1;-1;0;0;0
1827870;DarkHouse;;200,000 - 500,000;26;7;19;0;0;0
1827910;星の欠片の物語。しかけ版;;0 - 20,000;5;0;5;0;0;1
1827940;Last Lovers 绿洲之爱;;0 - 20,000;113;22;91;0;0;0
1827960;Saint Maribel;;0 - 20,000;5;2;3;0;0;0
1828010;Deadly Nightmare;;20,000 - 50,000;2;4;-2;0;0;0
1828030;Save the Llama;;0 - 20,000;4;0;4;0;0;0
1828070;Jester Street : Card Counting Trainer;;0 - 20,000;5;0;5;0;0;0
1828090;Krypt;;0 - 20,000;2;2;0;0;0;0
1828140;末世天醒;;0 - 20,000;0;1;-1;0;0;0
1828270;Total Anarchy: Pavilion City;;0 - 20,000;5;2;3;0;0;0
1828540;九州风流;;0 - 20,000;31;12;19;0;0;7
1828640;IllusionCircle;;0 - 20,000;104;4;100;0;0;0
1828690;Security Booth: Director's Cut;;0 - 20,000;115;11;104;0;0;0
1828700;Celestial Project;;0 - 20,000;15;7;8;0;0;0
1828710;Tumble;;0 - 20,000;9;1;8;0;0;0
1828720;Animal Sanctuary;;0 - 20,000;1;1;0;0;0;0
1828740;My Nemesis and Hero - Slice of Life Boys Love (BL) Visual Novel;;0 - 20,000;26;6;20;0;0;0
1828750;They Came From Below;;0 - 20,000;10;8;2;0;0;0
1828790;Timber Story;;0 - 20,000;21;8;13;0;0;0
1828880;Mega Zombie Explosion;;0 - 20,000;12;4;8;0;0;0
1828890;Murder of the Bear lake;;0 - 20,000;11;7;4;0;0;1
1828900;Stickit;;0 - 20,000;45;4;41;0;0;1
1828910;Viy: Retold Story;;20,000 - 50,000;31;6;25;0;0;0
1828940;Hidden Magic Town;;0 - 20,000;5;9;-4;0;0;2
1829000;Puputan Legend VR;;0 - 20,000;0;2;-2;0;0;0
1829010;World of Cube;;0 - 20,000;1;0;1;0;0;0
1829080;遊んで将棋が強くなる！ 銀星将棋DX2;;0 - 20,000;1;4;-3;0;0;1
1829090;Being Stronger While Playing! SilverStar Go;;0 - 20,000;1;0;1;0;0;0
1829120;Carrier Commander;;0 - 20,000;3;4;-1;0;0;0
1829130;Electric;;0 - 20,000;1;3;-2;0;0;0
1829160;Eason;;0 - 20,000;0;3;-3;0;0;1
1829170;NoiseBox.噪音盒子;;0 - 20,000;0;1;-1;0;0;0
1829250;The Wizardz Dungeon;;0 - 20,000;1;0;1;0;0;0
1829420;Before The Night;;0 - 20,000;292;10;282;0;0;0
1829450;Dr. Kobushi's Labyrinthine Laboratory;;0 - 20,000;38;3;35;0;0;1
1829470;Melody's Escape 2;;0 - 20,000;158;6;152;0;0;3
1829500;QuizPoker: Mix of Quiz and Poker;;0 - 20,000;5;0;5;0;0;0
1829540;Seashell;;0 - 20,000;56;3;53;0;0;1
1829620;Late Bird;;0 - 20,000;76;3;73;0;0;0
1829650;Sekai to Sekai no Mannaka de;;0 - 20,000;158;5;153;0;0;4
1829760;Game Of Seven;;0 - 20,000;2;0;2;0;0;0
1829800;Ultimate Super Powers Old Maid～3Days～;;0 - 20,000;24;3;21;0;0;0
1829910;Cute Cats 2;;0 - 20,000;41;1;40;0;0;0
1829940;Downfall of Krynto;;0 - 20,000;2;1;1;0;0;0
1829960;Zephyrus Prelude;;0 - 20,000;2;1;1;0;0;0
1829980;Café Stella and the Reaper's Butterflies;;50,000 - 100,000;2115;38;2077;1;1;78
1830000;Block City: Bus Edition;;0 - 20,000;17;0;17;0;0;0
1830040;False Skies;;20,000 - 50,000;18;1;17;0;0;2
1830040;False Skies;;20,000 - 50,000;18;1;17;0;0;2
1830050;September 28 Pizza;;0 - 20,000;2;1;1;0;0;0
1830100;Space Survival;;0 - 20,000;1;0;1;0;0;0
1830210;The Tribulation Entanglement;;0 - 20,000;23;5;18;0;0;0
1830270;Vanildo's Journey;;0 - 20,000;34;2;32;0;0;0
1830280;Super Company;;0 - 20,000;5;2;3;0;0;0
1830450;Square Farm;;0 - 20,000;15;1;14;0;0;9
1830490;陌生人;;0 - 20,000;9;3;6;0;0;0
1830530;Net Friend Joy Joypad;;0 - 20,000;1;0;1;0;0;0
1830640;Minigolf Adventure;;0 - 20,000;4;2;2;0;0;0
1830720;MOTHERED - A ROLE-PLAYING HORROR GAME;;0 - 20,000;140;6;134;0;0;0
1830830;Splash Fly Fire;;0 - 20,000;5;2;3;0;0;0
1830850;Bethany's Talishop;;0 - 20,000;1;0;1;0;0;0
1830870;ПОСЛЕДНИЙ ДЕНЬ В УРЮПИНСКЕ;;0 - 20,000;191;91;100;0;0;0
1830910;Cow Girls;;0 - 20,000;134;36;98;0;0;0
1830980;VRkanoid - Brick Breaking Game;;0 - 20,000;12;2;10;0;0;1
1831010;Buy it now!;;0 - 20,000;4;0;4;0;0;0
1831020;NeuroWorm;;0 - 20,000;2;1;1;0;0;0
1831060;Chesskoban Bishop;;0 - 20,000;29;0;29;0;0;0
1831140;Nonograms 22;;0 - 20,000;1;2;-1;0;0;0
1831150;GoKart - NewMexico;;0 - 20,000;4;0;4;0;0;0
1831160;Monkey Barrels;;0 - 20,000;6;1;5;0;0;1
1831250;WasteLand Express 废土快递;;50,000 - 100,000;696;59;637;34;34;69
1831290;与我签订契约，成为救世勇者吧！;;0 - 20,000;4;1;3;0;0;1
1831320;Rescue Team: Power Eaters;;0 - 20,000;7;0;7;0;0;3
1831520;GravityPunk;;20,000 - 50,000;1;0;1;0;0;0
1831530;PC Creator - PC Building Simulator;;0 - 20,000;108;38;70;0;0;1
1831550;Aim God;;0 - 20,000;6;1;5;0;0;0
1831560;Sprite Hunter;;0 - 20,000;9;18;-9;0;0;0
1831580;Bathtime Toys;;0 - 20,000;3;0;3;0;0;0
1831630;建筑吧公司;;0 - 20,000;228;35;193;48;48;3
1831630;建筑吧公司;;0 - 20,000;228;35;193;48;48;3
1831680;Waifu Crush;;0 - 20,000;21;11;10;0;0;0
1831770;Only Society: Arena;;0 - 20,000;0;1;-1;0;0;0
1831780;HYPERJUSTICE;;50,000 - 100,000;2;0;2;0;0;0
1831790;Cat Town;;0 - 20,000;4;4;0;0;0;0
1831850;Plentypede;;0 - 20,000;1;0;1;0;0;0
1831870;The Hotel;;0 - 20,000;61;11;50;0;0;0
1831930;LawnMower City;;0 - 20,000;5;2;3;0;0;1
1831960;烈火冲锋The charge is the fire;;20,000 - 50,000;5;2;3;0;0;0
1831980;Idle Superpowers;;0 - 20,000;29;8;21;0;0;20
1832010;Legacy: the last pure heart;;0 - 20,000;2;2;0;0;0;0
1832030;Yonder World: Interview with the Void;;0 - 20,000;10;0;10;0;0;0
1832050;All Quiet Roads;;0 - 20,000;65;0;65;0;0;2
1832070;Desperate: Vladivostok;;0 - 20,000;41;5;36;0;0;0
1832110;Urchins and Ink;;0 - 20,000;3;0;3;0;0;0
1832250;Christmas Stories: Yulemen Collector's Edition;;0 - 20,000;7;1;6;0;0;0
1832260;Chromarena;;0 - 20,000;3;0;3;0;0;0
1832260;Chromarena;;0 - 20,000;3;0;3;0;0;0
1832280;Mugen Abisu;;0 - 20,000;1;0;1;0;0;0
1832370;Charades Movie One;;0 - 20,000;0;3;-3;0;0;0
1832380;The Albino Hunter {Revamp};;20,000 - 50,000;8;0;8;0;0;0
1832620;无限战魂 Infinity BattleSoul;;0 - 20,000;10;2;8;0;0;0
1832640;Mirror 2: Project X;;2,000,000 - 5,000,000;30367;84632;-54265;384;163;157
1832700;Diamond Hands Arena;;50,000 - 100,000;2;0;2;0;0;0
1832710;AstroBytes: Vedic Astrology Future Predictor;;0 - 20,000;2;1;1;0;0;0
1832750;Volume² - advanced Windows volume control;;0 - 20,000;13;1;12;0;0;2
1832760;DarkBlood -Reborn-;;0 - 20,000;5;2;3;0;0;1
1832950;One More Gate : A Wakfu Legend;;0 - 20,000;166;26;140;222;222;60
1833020;Age of Dynasty;;0 - 20,000;2;3;-1;0;0;0
1833040;晴末置雨;;20,000 - 50,000;218;58;160;0;0;0
1833190;The Happy Dismal Town;;0 - 20,000;2;0;2;0;0;0
1833300;Epics of Distant Realm: Holy Return;;20,000 - 50,000;108;6;102;0;0;3
1833340;Anima;;0 - 20,000;0;1;-1;0;0;0
1833350;Straight Ahead;;0 - 20,000;2;0;2;0;0;0
1833360;Triclinium;;0 - 20,000;35;2;33;0;0;0
1833380;Izmir: An Independence Simulator;;20,000 - 50,000;24;1;23;0;0;0
1833380;Izmir: An Independence Simulator;;20,000 - 50,000;24;1;23;0;0;0
1833490;GOODBYE WORLD;;0 - 20,000;423;75;348;0;0;2
1833530;Beatus Creation Solitaire;;0 - 20,000;3;0;3;0;0;0
1833560;Witchhazel Woods;;0 - 20,000;29;0;29;0;0;0
1833620;Mad Geometry;;0 - 20,000;0;3;-3;0;0;0
1833670;2048 3D;;0 - 20,000;9;2;7;0;0;1
1833730;Our Battle Has Just Begun! episode 2;;0 - 20,000;7;1;6;0;0;0
1833820;From Red to Green;;0 - 20,000;15;2;13;0;0;0
1833850;HelloWorld:ESCAPE;;0 - 20,000;15;2;13;0;0;0
1833890;Fish Story: Gourmet Puzzle;;0 - 20,000;31;2;29;0;0;0
1833910;游戏玩家中医体质测试及养生指南;;0 - 20,000;3;2;1;0;0;0
1834110;Headland;;0 - 20,000;14;0;14;0;0;0
1834120;Icemaze Cave: Skate Escape;;0 - 20,000;21;1;20;0;0;0
1834140;Christmas Sort Puzzle;;0 - 20,000;1;0;1;0;0;0
1834170;Vector Elite;;0 - 20,000;2;0;2;0;0;0
1834290;Toy War - Cannon;;0 - 20,000;10;9;1;0;0;0
1834310;100 Hidden Animalnaults - Felicat & Laika;;0 - 20,000;34;11;23;0;0;0
1834540;Spinning Maze;;0 - 20,000;15;0;15;0;0;0
1834550;Dark Flame;;50,000 - 100,000;15;0;15;0;0;0
1834570;Mr Meal;;20,000 - 50,000;3;0;3;0;0;0
1834580;From Heaven To Earth;;0 - 20,000;17;0;17;0;0;0
1834620;The Shore VR;;20,000 - 50,000;20;32;-12;0;0;0
1834640;Spy Robot: Gateways To Humanity;;0 - 20,000;3;0;3;0;0;0
1834710;Last Bastion;;0 - 20,000;5;1;4;0;0;0
1834740;HYPERBLADE;;0 - 20,000;30;1;29;0;0;0
1834760;Humanities Legend: Hollow Ascending;;0 - 20,000;2;1;1;0;0;0
1834820;First Bite;;0 - 20,000;70;10;60;0;0;20
1834920;Countryball: Europe 1890;;0 - 20,000;228;2;226;0;0;18
1834940;Hen in the Foxhouse;;20,000 - 50,000;4;0;4;0;0;0
1834950;Salaryman Shi;;0 - 20,000;3;1;2;0;0;0
1835060;Christmas Celebration With Sakuya Izayoi;;0 - 20,000;103;11;92;0;0;0
1835200;Titanic: Fall Of A Legend;;0 - 20,000;41;13;28;0;0;2
1835210;Roadworks 2;;0 - 20,000;1;0;1;0;0;0
1835220;ILLUMI-NAUGHTY ;;;;;0;;;
1835250;Escape;;0 - 20,000;2;1;1;0;0;0
1835290;CRATES N' MOHAWKS;;0 - 20,000;1;0;1;0;0;0
1835310;Babba Yagga: Woodboy;;0 - 20,000;7;12;-5;0;0;0
1835350;道不可道;;200,000 - 500,000;11;8;3;0;0;0
1835360;Panacle: Back To Wild;;0 - 20,000;9;4;5;0;0;2
1835370;Balls and Dungeons;;0 - 20,000;2;0;2;0;0;0
1835460;VARIABLE PICTOGRAM JUMP;;0 - 20,000;1;0;1;0;0;0
1835490;SLAYER - Survive & Thrive;;0 - 20,000;15;0;15;0;0;2
1835510;The House On Holland Hill;;0 - 20,000;16;2;14;0;0;0
1835530;Zombie Slaughter VR;;0 - 20,000;41;5;36;0;0;0
1835560;Endless Zombie Weekend;;0 - 20,000;0;11;-11;0;0;0
1835580;SEARCH ALL - SEASHELLS;;0 - 20,000;25;1;24;0;0;0
1835640;The Search for MR Fimple;;0 - 20,000;4;4;0;0;0;0
1835790;Neon Horizon: Eclipse;;20,000 - 50,000;6;0;6;0;0;0
1835810;Amelie;;0 - 20,000;166;10;156;0;0;0
1835820;BetWin;;0 - 20,000;1;0;1;0;0;0
1835840;Quarantineer;;50,000 - 100,000;265;68;197;0;0;0
1835870;The Black Cat Magician;;0 - 20,000;189;17;172;295;295;2
1835970;ICEwall;;0 - 20,000;25;4;21;0;0;3
1836030;只兔：不灭的勇者;;0 - 20,000;99;27;72;0;0;4
1836120;QUICKERFLAK;;0 - 20,000;179;13;166;0;0;1
1836180;Turn off the light;;50,000 - 100,000;9;2;7;0;0;0
1836210;Blocky Snake;;0 - 20,000;2;7;-5;0;0;0
1836220;Frigore;;200,000 - 500,000;171;97;74;0;0;0
1836230;Evening Ecchi;;0 - 20,000;5;4;1;0;0;0
1836280;Billy 101;;20,000 - 50,000;16;1;15;0;0;2
1836290;They Die Tomorrow;;0 - 20,000;17;7;10;0;0;0
1836360;Catherine Ragnor and the Legend of the Flying Dutchman;;0 - 20,000;5;2;3;0;0;0
1836380;manaCompiler;;0 - 20,000;3;2;1;0;0;0
1836390;BLANK SPACE;;0 - 20,000;5;2;3;0;0;0
1836680;Slidetracked;;0 - 20,000;15;0;15;0;0;1
1836690;Red Bash;;0 - 20,000;7;1;6;0;0;0
1836740;Elemgate;;100,000 - 200,000;7;0;7;0;0;0
1836770;Maximum Fighterz: Direct Offensive Action;;20,000 - 50,000;6;0;6;0;0;0
1836790;Amshay;;0 - 20,000;4;0;4;0;0;0
1836860;Neptunia x SENRAN KAGURA: Ninja Wars;;20,000 - 50,000;636;127;509;19;34;16
1836880;Yumeiri;;0 - 20,000;26;2;24;0;0;1
1836890;Blaster Alert;;20,000 - 50,000;1;0;1;0;0;0
1836920;Hunt-or-Haunt;;0 - 20,000;11;0;11;0;0;0
1836940;Aria and the Secret of the Labyrinth;;0 - 20,000;16;6;10;0;0;0
1837020;MotionMuse;;0 - 20,000;7;1;6;0;0;0
1837130;星塔星夜MONOBEHEVO;;0 - 20,000;45;10;35;0;0;0
1837140;25°N 71°W;;0 - 20,000;0;2;-2;0;0;0
1837160;Action Ball;;0 - 20,000;9;0;9;0;0;1
1837210;Rabbit Meadow;;0 - 20,000;0;0;0;0;0;0
1837280;Lost Island;;0 - 20,000;18;9;9;0;0;0
1837330;Gibbon: Beyond the Trees;;0 - 20,000;230;13;217;870;870;4
1837400;Kargo;;0 - 20,000;1;0;1;0;0;0
1837440;Pyramid Quest;;0 - 20,000;11;0;11;0;0;0
1837510;KAWAII SLIME ARENA;;0 - 20,000;22;2;20;0;0;0
1837520;Fast Delivery;;0 - 20,000;1;0;1;0;0;0
1837530;Project Myriad 2;;0 - 20,000;3;1;2;0;0;0
1837550;Biblios Dice;;0 - 20,000;1;0;1;0;0;0
1837570;Boat Simulator Apprentice;;0 - 20,000;4;1;3;0;0;0
1837630;Box's Dream;;20,000 - 50,000;13;1;12;0;0;0
1837630;Box's Dream;;20,000 - 50,000;13;1;12;0;0;0
1837690;Archtower;;0 - 20,000;47;4;43;0;0;3
1837750;Demeo: PC Edition;;20,000 - 50,000;443;96;347;269;273;32
1837780;Spellcaster;;0 - 20,000;3;1;2;0;0;0
1837820;Faded Stories: Greenberg;;0 - 20,000;30;2;28;0;0;1
1837840;CatMxn: Chapter 1;;0 - 20,000;1;0;1;0;0;0
1837910;BridgeTeam: Ship Simulator;;0 - 20,000;5;7;-2;0;0;0
1837920;Mining Cats;;0 - 20,000;34;8;26;0;0;1
1838070;BOK;;0 - 20,000;7;0;7;0;0;0
1838080;Agent Stilus;;0 - 20,000;1;0;1;0;0;0
1838100;Conveyance;;0 - 20,000;4;0;4;0;0;0
1838130;Hellscape;;0 - 20,000;2;0;2;0;0;0
1838140;Snowman Adventure;;0 - 20,000;35;4;31;0;0;0
1838170;Broken;;0 - 20,000;2;1;1;0;0;0
1838250;Lost Contact;;0 - 20,000;0;1;-1;0;0;0
1838340;Uninvited;;0 - 20,000;43;9;34;0;0;1
1838380;Radiotelegraphist;;0 - 20,000;2;1;1;0;0;0
1838540;Stealth Kart;;0 - 20,000;1;0;1;0;0;0
1838560;The Defaloon;;0 - 20,000;15;3;12;0;0;0
1838600;Moshcave;;0 - 20,000;3;2;1;0;0;0
1838660;Item synthesis and dungeon exploration;;0 - 20,000;0;3;-3;0;0;0
1838670;The Paribneur Combination;;20,000 - 50,000;2;1;1;0;0;0
1838680;Dream Fruit Farm;;0 - 20,000;7;2;5;0;0;1
1838740;Doxxed;;0 - 20,000;16;6;10;0;0;0
1838790;Angry Rocketeer Frenzy;;0 - 20,000;11;4;7;0;0;1
1838800;V-Fighter 2000;;0 - 20,000;13;3;10;0;0;0
1838820;Life of a Space Force Captain;;0 - 20,000;38;5;33;0;0;0
1838830;Paradox Factor;;0 - 20,000;4;2;2;0;0;0
1838860;79 Pompeii;;0 - 20,000;2;0;2;0;0;0
1838970;Crush the Castle Legacy Collection;;0 - 20,000;63;7;56;0;0;4
1838980;Polyion;;0 - 20,000;1;0;1;0;0;0
1839050;HatMania;;0 - 20,000;8;0;8;0;0;0
1839070;BARK;;0 - 20,000;17;8;9;0;0;1
1839080;The Pointless Car Chase: Refueled;;0 - 20,000;31;4;27;0;0;0
1839190;House Flipper Pets VR;;0 - 20,000;9;6;3;0;0;2
1839260;Mystery Case Files: Incident at Pendle Tower Collector's Edition;;0 - 20,000;5;0;5;0;0;1
1839420;THE GAME;;0 - 20,000;19;2;17;0;0;0
1839510;RPG Time: The Legend of Wright;;0 - 20,000;154;8;146;0;0;2
1839540;Grocket;;0 - 20,000;54;4;50;0;0;1
1839600;Pirate's Gold;;20,000 - 50,000;1;1;0;0;0;0
1839700;Milk Bottle And Monster Girl;;20,000 - 50,000;310;70;240;19;19;1
1839750;POG 6;;0 - 20,000;4;4;0;0;0;0
1839780;Cat Dimension;;0 - 20,000;1;0;1;0;0;0
1839840;Memory Puzzle - Mystery Mermaids;;0 - 20,000;2;3;-1;0;0;0
1839940;Dakar Desert Rally;;20,000 - 50,000;481;317;164;0;0;38
1840060;Shinogi Chess Club;;0 - 20,000;6;1;5;0;0;0
1840120;Devil's Eyes;;0 - 20,000;2;0;2;0;0;0
1840330;Dummy Falls;;0 - 20,000;6;1;5;0;0;0
1840350;Koi-Koi VR: Love Blossoms;;0 - 20,000;86;13;73;0;0;4
1840380;Chester;;0 - 20,000;16;5;11;0;0;1
1840490;Christmas Massacre;;20,000 - 50,000;455;55;400;0;0;1
1840520;Cyber Girls 2022;;0 - 20,000;2;2;0;0;0;0
1840580;Slette Mette;;0 - 20,000;2;0;2;0;0;0
1840620;Trialtime Reborn;;0 - 20,000;1;2;-1;0;0;0
1840700;Attraction;;0 - 20,000;16;6;10;0;0;0
1840730;Ancient Islands;;50,000 - 100,000;17;0;17;0;0;2
1840770;Last Threshold;;0 - 20,000;12;3;9;0;0;0
1840780;Love Accident;;20,000 - 50,000;6;0;6;0;0;1
1840860;Nova Odessa - The Demon Trainer;;0 - 20,000;8;1;7;0;0;1
1840870;Sporty Peppers;;0 - 20,000;2;2;0;0;0;0
1840920;SEARCH ALL - FOXES;;0 - 20,000;65;2;63;0;0;0
1841020;Journey to the Heart of Gaia;;0 - 20,000;8;0;8;0;0;0
1841030;Secret Mission: The Forgotten Island;;0 - 20,000;1;0;1;0;0;1
1841040;Department 42: The Mystery of the Nine;;0 - 20,000;1;3;-2;0;0;0
1841070;Bhop Craze;;0 - 20,000;15;0;15;0;0;2
1841080;Galactic Racing Online;;0 - 20,000;8;0;8;0;0;1
1841220;The Devils - A Visual Novel Of WWII;;50,000 - 100,000;2;0;2;0;0;0
1841320;PAIN;;0 - 20,000;31;1;30;0;0;0
1841350;ToS Gamepad Companion;;0 - 20,000;4;0;4;0;0;0
1841390;100 hidden fish;;0 - 20,000;246;8;238;0;0;0
1841400;灵途;;0 - 20,000;124;21;103;0;0;0
1841520;月影待蚀 / The Incomplete Lunar;;0 - 20,000;13;0;13;0;0;8
1841540;Last Sinner;;0 - 20,000;0;3;-3;0;0;0
1841580;Child vs Clowns;;0 - 20,000;2;2;0;0;0;0
1841590;Insect War;;0 - 20,000;0;1;-1;0;0;0
1841600;Problem Animals;;0 - 20,000;6;5;1;0;0;0
1841630;Armor Clash 2022  [RTS];;0 - 20,000;8;10;-2;0;0;0
1841700;Many Buttons to Press;;0 - 20,000;8;17;-9;0;0;0
1841710;Road Cards;;0 - 20,000;13;2;11;0;0;0
1841720;The Duck Is In Danger;;0 - 20,000;19;2;17;0;0;0
1841740;Drone Simulator;;0 - 20,000;0;1;-1;0;0;0
1841760;Shootball Arena;;0 - 20,000;9;1;8;0;0;0
1841780;It follows you;;20,000 - 50,000;17;22;-5;0;0;0
1841850;Bear Adventures 2;;0 - 20,000;4;3;1;0;0;0
1841910;RMB: Knowledge park - All World;;0 - 20,000;1;0;1;0;0;0
1842050;It's Kooky;;0 - 20,000;50;2;48;0;0;0
1842130;Blinky;;0 - 20,000;0;1;-1;0;0;0
1842190;jingor 2048;;0 - 20,000;1;0;1;0;0;0
1842200;jingor mine;;0 - 20,000;1;1;0;0;0;0
1842200;jingor mine;;0 - 20,000;1;1;0;0;0;0
1842220;3D  Lover;;0 - 20,000;77;23;54;0;0;1
1842270;Bongo Quest;;20,000 - 50,000;21;25;-4;0;0;0
1842300;Uncolored Bob II;;0 - 20,000;4;0;4;0;0;0
1842410;Deadly Racing Duel;;100,000 - 200,000;12;3;9;0;0;0
1842430;Runewaker;;0 - 20,000;2;0;2;0;0;0
1842450;Hotdog Quest: One With Everything;;0 - 20,000;3;0;3;0;0;0
1842480;NeuraGun;;20,000 - 50,000;47;6;41;0;0;0
1842510;Mechanibot;;0 - 20,000;50;5;45;0;0;1
1842540;Medieval Battlegrounds;;0 - 20,000;2;0;2;0;0;0
1842610;Dungeon Wizards;;0 - 20,000;36;5;31;0;0;1
1842690;Station Manager;;0 - 20,000;149;25;124;0;0;7
1842730;Nightmare: The Lunatic;;0 - 20,000;37;4;33;0;0;1
1842890;矿老板模拟器;;0 - 20,000;7;2;5;0;0;0
1842900;Hell of Sins: soul;;0 - 20,000;46;28;18;0;0;0
1842910;Groove Fit Island!!;;0 - 20,000;6;0;6;0;0;0
1842930;Mother Stone;;20,000 - 50,000;1;0;1;0;0;0
1843090;[Chilla's Art] The Closing Shift | 閉店事件;;20,000 - 50,000;1318;197;1121;0;0;17
1843110;Makis Adventure;;0 - 20,000;31;3;28;0;0;1
1843190;Brain Bait;;0 - 20,000;3;0;3;0;0;0
1843230;Win by Definition;;0 - 20,000;2;0;2;0;0;0
1843270;Reef Rivals;;20,000 - 50,000;2;1;1;0;0;0
1843420;Motorcycle Travel Simulator;;0 - 20,000;59;85;-26;0;0;1
1843550;Cursed House;;0 - 20,000;23;13;10;0;0;0
1843730;Last Group Out;;0 - 20,000;59;9;50;0;0;0
1843750;Sphere Game Epic;;0 - 20,000;9;2;7;0;0;1
1843760;Rogue Tower;;500,000 - 1,000,000;3513;748;2765;627;709;504
1843780;Khoros;;0 - 20,000;2;0;2;0;0;0
1843860;The Redress of Mira;;0 - 20,000;22;4;18;0;0;0
1843880;Tumblebugs;;0 - 20,000;23;0;23;0;0;2
1843900;Ball;;0 - 20,000;4;0;4;0;0;0
1843920;Communist Clicker;;0 - 20,000;9;2;7;0;0;1
1843940;Brigandine The Legend of Runersia;;20,000 - 50,000;640;93;547;0;0;64
1844060;Holy Purge : Exorcist;;0 - 20,000;125;53;72;0;0;4
1844110;The Legend of the War Axe;;50,000 - 100,000;9;2;7;0;0;0
1844150;Panzer Girls;;0 - 20,000;4;3;1;0;0;0
1844190;Deep Cave;;100,000 - 200,000;15;7;8;0;0;0
1844290;Ultimate Christmas Puzzler 2;;0 - 20,000;1;0;1;0;0;0
1844330;Profession investigator;;0 - 20,000;32;0;32;0;0;1
1844400;Rasetsu Fumaden;;0 - 20,000;38;3;35;0;0;1
1844410;Fear of the Dark;;0 - 20,000;6;4;2;0;0;0
1844500;Box logistics;;0 - 20,000;10;8;2;0;0;0
1844510;Caveman Hunt;;50,000 - 100,000;13;4;9;0;0;0
1844540;Word of the Law: Death Mask Collector's Edition;;20,000 - 50,000;8;1;7;0;0;1
1844550;Royal Legends: Marshes Curse Collector's Edition;;0 - 20,000;1;2;-1;0;0;0
1844610;Reality Mixer - Mixed Reality for Vive and Index;;0 - 20,000;28;3;25;0;0;0
1844640;LiS: Achados & Perdidos dos Confins do Universo;;0 - 20,000;4;0;4;0;0;0
1844650;Krampus Kills;;0 - 20,000;41;6;35;0;0;0
1844680;Satama Puzzle;;0 - 20,000;9;0;9;0;0;0
1844990;Lastone: Behind the Choice;;0 - 20,000;10;1;9;0;0;0
1845030;Snakepit Larry;;0 - 20,000;4;0;4;0;0;0
1845040;Panzers on the Steppe;;0 - 20,000;1;0;1;0;0;0
1845050;Mirrorama;;20,000 - 50,000;19;1;18;0;0;0
1845180;Ambition;;0 - 20,000;1;0;1;0;0;0
1845280;Momo is Here;;0 - 20,000;39;13;26;0;0;0
1845370;Dungeonball;;0 - 20,000;5;1;4;0;0;0
1845460;Milo;;0 - 20,000;3;0;3;0;0;0
1845560;真 麻雀天下布武;;0 - 20,000;7;6;1;0;0;2
1845760;MOLOGA;;100,000 - 200,000;9;0;9;0;0;0
1845840;Mystery of Island;;0 - 20,000;2;3;-1;0;0;0
1845880;SEARCH ALL - POTIONS;;0 - 20,000;24;1;23;0;0;0
1846020;10 Seconds to Win!;;0 - 20,000;68;6;62;0;0;0
1846030;HyperLeague Heroes;;0 - 20,000;24;9;15;0;0;12
1846060;Scripture;;0 - 20,000;3;3;0;0;0;0
1846170;Iron Lung;;100,000 - 200,000;4919;348;4571;94;105;14
1846240;Land Of Eno;;0 - 20,000;6;4;2;0;0;0
1846290;Avocado Love;;0 - 20,000;16;2;14;0;0;6
1846300;Mystery Trackers: Queen of Hearts Collector's Edition;;0 - 20,000;2;3;-1;0;0;0
1846330;Nope Nope Nurses;;0 - 20,000;247;68;179;165;205;2
1846330;Nope Nope Nurses;;0 - 20,000;247;68;179;165;205;2
1846340;EEP 17 Rail- / Railway Construction and Train Simulation Game;;0 - 20,000;4;2;2;0;0;1
1846380;Need for Speed Unbound;;200,000 - 500,000;6810;3806;3004;2189;1531;1036
1846380;Need for Speed Unbound;;200,000 - 500,000;6810;3806;3004;2189;1531;1036
1846390;Einherjar;;0 - 20,000;1;0;1;0;0;0
1846390;Einherjar;;0 - 20,000;1;0;1;0;0;0
1846460;Burnhouse Lane;;0 - 20,000;393;19;374;0;0;9
1846480;Refraction: Beyond the Mirror;;0 - 20,000;11;2;9;0;0;1
1846510;The First Odyssey;;0 - 20,000;1;3;-2;0;0;0
1846630;花都之恋;;0 - 20,000;117;5;112;0;0;1
1846830;Gummings;;0 - 20,000;4;1;3;0;0;0
1846850;Exploria;;0 - 20,000;6;3;3;0;0;0
1846870;Super Kit: TO THE TOP;;0 - 20,000;7;3;4;0;0;2
1846890;Shores of Loci;;0 - 20,000;47;2;45;0;0;1
1846940;There Won't be Light;;0 - 20,000;30;13;17;0;0;0
1846960;Where's My Horse? An Escape the Room Adventure;;0 - 20,000;2;1;1;0;0;0
1846980;Skeletons;;0 - 20,000;1;2;-1;0;0;0
1847020;Jet Fighters with Friends  (Multiplayer);;0 - 20,000;6;1;5;0;0;0
1847100;Shadow Watcher;;0 - 20,000;9;7;2;0;0;0
1847110;Satan's puzzle 666;;0 - 20,000;19;6;13;0;0;0
1847160;Johnny Boy: Red Moon's Kiss - Episode 1;;0 - 20,000;6;3;3;0;0;0
1847210;中国传统武术 八卦掌 六十四手 Chinese martial arts (kungfu) The 64 Hands of Bagua Zhang;;0 - 20,000;13;7;6;0;0;1
1847230;Island Berry;;0 - 20,000;3;2;1;0;0;0
1847240;Game Dev Story;;20,000 - 50,000;488;51;437;7;7;14
1847250;The Unearthened;;0 - 20,000;1;2;-1;0;0;0
1847440;FREEZEFRAME;;0 - 20,000;1;0;1;0;0;0
1847460;Japanese DoJo;;0 - 20,000;9;1;8;0;0;0
1847510;Boba Simulator : Idle Shop Management;;0 - 20,000;52;2;50;0;0;4
1847600;Kingdom's Life;;0 - 20,000;148;50;98;11;11;0
1847750;Project Kunai;;20,000 - 50,000;13;0;13;0;0;1
1847810;Tkium Exclusion Area;;0 - 20,000;4;1;3;0;0;0
1847820;HiddenFrog;;0 - 20,000;7;2;5;0;0;0
1847830;Swing the Universe;;0 - 20,000;1;0;1;0;0;0
1847860;Jigsaw Souls;;0 - 20,000;15;0;15;0;0;0
1847920;Shrumblo and the Magical Grumblo;;0 - 20,000;3;0;3;0;0;0
1847950;Fencing Girl;;0 - 20,000;68;8;60;0;0;0
1848080;Incursion: Reforged;;0 - 20,000;16;5;11;0;0;1
1848130;无限投影;;20,000 - 50,000;137;47;90;0;0;12
1848140;Road Mayhem;;100,000 - 200,000;12;0;12;0;0;0
1848150;Mysterious House;;0 - 20,000;9;4;5;0;0;0
1848160;AMaze DOS;;20,000 - 50,000;13;7;6;0;0;0
1848220;Amelite;;0 - 20,000;15;0;15;0;0;1
1848250;Dog Adventure;;0 - 20,000;15;0;15;0;0;1
1848280;Pirates of the Maverta;;0 - 20,000;1;1;0;0;0;0
1848290;Maverta Island;;0 - 20,000;2;1;1;0;0;0
1848300;The House Of Closed Doors;;0 - 20,000;2;3;-1;0;0;0
1848330;Clarent Saga: Chronicles;;0 - 20,000;28;4;24;0;0;0
1848350;Gelatine;;0 - 20,000;14;0;14;0;0;0
1848380;Era Dream I: The New House (Arabic Game)(POWR ESPORT);;0 - 20,000;4;3;1;0;0;0
1848450;Nightmare of Decay;;100,000 - 200,000;2352;73;2279;133;133;6
1848470;System Critical: The Race Against Time;;0 - 20,000;8;1;7;0;0;0
1848570;Skelton Zone Traveler Emergence;;0 - 20,000;16;5;11;0;0;0
1848580;WAVECADE;;0 - 20,000;24;1;23;0;0;0
1848590;Kaichu - The Kaiju Dating Sim;;0 - 20,000;51;8;43;0;0;5
1848640;VR Async Balls;;0 - 20,000;1;0;1;0;0;0
1848650;Hunter A Hunter;;0 - 20,000;1;0;1;0;0;0
1848660;Remembrance;;0 - 20,000;1;1;0;0;0;0
1848710;Ninja Soul;;0 - 20,000;132;21;111;0;0;1
1848730;IKUSAAAAAAAN!;;0 - 20,000;21;0;21;0;0;0
1848860;Ember Crusade IV;;0 - 20,000;3;1;2;0;0;0
1848870;Hologram;;0 - 20,000;1;5;-4;0;0;0
1848890;Gordon Streaman 2;;0 - 20,000;48;17;31;0;0;0
1848960;Medieval Fantasy Survival Simulator;;0 - 20,000;226;8;218;0;0;0
1848970;Project Valkyrie;;20,000 - 50,000;1;2;-1;0;0;0
1849070;WHMIS 2015 VR;;0 - 20,000;1;1;0;0;0;0
1849170;Nested Rooms;;0 - 20,000;2;0;2;0;0;0
1849190;I AM BUTTER VR;;0 - 20,000;23;8;15;0;0;0
1849200;It's On You;;0 - 20,000;5;2;3;0;0;0
1849230;如果还有明天 If I Still Had Tomorrow;;0 - 20,000;11;1;10;0;0;0
1849270;Nectar Wars;;0 - 20,000;9;0;9;0;0;0
1849300;La Jetée;;0 - 20,000;8;2;6;0;0;1
1849310;天天地下城;;0 - 20,000;108;3;105;0;0;0
1849370;SGS Pacific D-Day;;0 - 20,000;14;0;14;0;0;0
1849380;Levitation Simulator;;0 - 20,000;47;12;35;0;0;0
1849430;Alchemist of War;;0 - 20,000;13;2;11;0;0;0
1849440;Claire's Cruisin' Cafe: High Seas Cuisine;;0 - 20,000;11;0;11;0;0;2
1849530;Save Us: Island Escape;;0 - 20,000;7;3;4;0;0;0
1849560;Funny Pets;;0 - 20,000;7;3;4;0;0;0
1849570;恋~一些小清新的猎奇故事~;;0 - 20,000;124;25;99;0;0;0
1849760;Siege of Treboulain;;0 - 20,000;25;0;25;0;0;0
1849800;Cramit's Keep;;0 - 20,000;9;0;9;0;0;0
1849820;Telepath Tactics Liberated;;20,000 - 50,000;81;6;75;3;3;1
1849840;镜世界;;0 - 20,000;1;0;1;0;0;0
1849870;amazin' George Remastered;;0 - 20,000;4;0;4;0;0;0
1849880;Fallen Spirit;;0 - 20,000;1;0;1;0;0;0
1849890;Neko Maid;;0 - 20,000;112;20;92;0;0;0
1849900;Among Us VR;;50,000 - 100,000;1453;445;1008;79;105;40
1849930;helicopter 2.0;;0 - 20,000;14;8;6;0;0;0
1850100;Note of Janus;;0 - 20,000;4;0;4;0;0;0
1850280;GwenBlade;;0 - 20,000;16;2;14;0;0;0
1850390;MOVEIT;;20,000 - 50,000;19;8;11;0;0;1
1850420;BYLITSA: VASNA;;0 - 20,000;15;1;14;0;0;0
1850490;Warmonium;;0 - 20,000;4;0;4;0;0;0
1850510;TRIANGLE STRATEGY;;20,000 - 50,000;943;224;719;284;284;186
1850550;I'm on Observation Duty 5;;0 - 20,000;360;13;347;0;0;49
1850570;DEATH STRANDING DIRECTOR'S CUT;;500,000 - 1,000,000;13909;951;12958;1473;876;1258
1850610;Winter and People;;20,000 - 50,000;3;0;3;0;0;0
1850690;Zombies Killer Machine;;20,000 - 50,000;12;14;-2;0;0;0
1850740;Ghost Watchers;;200,000 - 500,000;8985;1396;7589;481;423;601
1850790;Would you like to run an idol café? 3;;0 - 20,000;11;2;9;0;0;0
1850840;MAFIA: Family's Secret;;20,000 - 50,000;30;4;26;0;0;0
1850960;The Jackbox Party Pack 9;;20,000 - 50,000;355;75;280;352;497;206
1850980;Ver;;0 - 20,000;1;0;1;0;0;0
1851020;River City Girls Zero;;0 - 20,000;70;17;53;126;126;2
1851060;Mysteria of the World: The forest of Death;;0 - 20,000;12;1;11;0;0;0
1851120;File Under Kingdom;;0 - 20,000;14;1;13;0;0;0
1851120;File Under Kingdom;;0 - 20,000;14;1;13;0;0;0
1851240;That Castle;;0 - 20,000;3;2;1;0;0;0
1851280;Samurai Bringer;;50,000 - 100,000;730;98;632;620;620;6
1851300;EM;;0 - 20,000;1;0;1;0;0;0
1851320;MonsterAmongUs;;0 - 20,000;18;5;13;0;0;0
1851370;The Living Handra;;0 - 20,000;5;1;4;0;0;0
1851410;Trigger Dungeon;;0 - 20,000;8;0;8;0;0;1
1851440;幻梦之城(C T O D);;0 - 20,000;1;1;0;0;0;0
1851450;Bubbles shot;;0 - 20,000;10;1;9;0;0;0
1851520;The Final Answer;;0 - 20,000;0;1;-1;0;0;0
1851530;MORE ENEMIES;;0 - 20,000;5;0;5;0;0;0
1851630;Man of Sterling Quality;;20,000 - 50,000;0;3;-3;0;0;0
1851640;Police Hot Pursuit;;0 - 20,000;12;4;8;0;0;1
1851680;Lost Alone Ep.2 - Paparino;;20,000 - 50,000;36;5;31;0;0;1
1851690;Blood Bay: Card History;;0 - 20,000;14;0;14;0;0;0
1851730;Meow Express;;0 - 20,000;223;13;210;0;0;0
1851790;Dungeon Maker;;0 - 20,000;6;1;5;0;0;0
1851910;A Flicker of Light;;0 - 20,000;101;12;89;0;0;0
1852100;Wrong train;;0 - 20,000;13;7;6;0;0;0
1852100;Wrong train;;0 - 20,000;13;7;6;0;0;0
1852140;Mathletix;;0 - 20,000;15;0;15;0;0;0
1852180;Undercraft;;0 - 20,000;0;1;-1;0;0;0
1852290;CrazyParty;;0 - 20,000;2;2;0;0;0;0
1852380;MAGICAL DEATHPAIR;;0 - 20,000;39;1;38;0;0;1
1852520;元宇宙普信男生存指南;;0 - 20,000;142;69;73;0;0;0
1852530;Kung Fu Er San;;0 - 20,000;8;2;6;0;0;0
1852600;Cellar;;0 - 20,000;1;0;1;0;0;0
1852610;Candy Match 3;;0 - 20,000;1;5;-4;0;0;0
1852830;SPACE ACCIDENT;;0 - 20,000;95;23;72;0;0;0
1852840;Slaughter Cannon;;0 - 20,000;19;5;14;0;0;0
1852890;Farmer Adventure;;0 - 20,000;13;12;1;0;0;0
1852940;Highline Volleyball VR;;0 - 20,000;12;4;8;0;0;1
1852990;Disaster;;0 - 20,000;22;13;9;0;0;0
1853080;Cyber Runner;;0 - 20,000;10;0;10;0;0;0
1853090;Axiallis;;0 - 20,000;6;0;6;0;0;0
1853120;Cannon Canines;;0 - 20,000;4;0;4;0;0;0
1853140;Who Is Zombie;;0 - 20,000;10;7;3;0;0;3
1853150;American Christmas;;0 - 20,000;3;0;3;0;0;0
1853190;Life is Paine;;0 - 20,000;8;2;6;0;0;0
1853200;TYRONE vs COPS;;50,000 - 100,000;1518;71;1447;336;472;6
1853270;Army To Army;;0 - 20,000;10;6;4;0;0;1
1853560;Cloud Girl;;0 - 20,000;6;3;3;0;0;1
1853690;Monster of Nyum;;0 - 20,000;0;1;-1;0;0;0
1853790;Saviour of Humanity;;0 - 20,000;1;3;-2;0;0;0
1853810;Blood Island;;0 - 20,000;11;1;10;0;0;0
1853850;A lost jellyfish: Return to its parents;;20,000 - 50,000;1;0;1;0;0;0
1853880;Fluid FX;;0 - 20,000;5;0;5;0;0;0
1853890;Eggroll;;20,000 - 50,000;10;0;10;0;0;0
1853920;CYBERSTELLAR;;0 - 20,000;13;1;12;0;0;0
1853970;Anthropocene Epoch;;0 - 20,000;3;3;0;0;0;0
1853990;Hidden Treasures in the Forest of Dreams;;0 - 20,000;2;0;2;0;0;0
1854050;V696;;20,000 - 50,000;50;25;25;0;0;0
1854090;Peach Territory;;0 - 20,000;9;4;5;0;0;1
1854100;VIrus Killer;;20,000 - 50,000;9;1;8;0;0;0
1854110;Kitsune Slasher;;0 - 20,000;1;0;1;0;0;0
1854120;PINK ELEPHANT;;0 - 20,000;16;4;12;0;0;0
1854190;Hot Pickle!;;0 - 20,000;2;0;2;0;0;0
1854270;風の祝子 ～早苗さんの妖怪退治～;;0 - 20,000;5;0;5;0;0;0
1854280;The Vision Of The Ant;;0 - 20,000;1;0;1;0;0;0
1854290;Kakureza Library;;0 - 20,000;16;4;12;0;0;2
1854340;Another Sight;;0 - 20,000;2;0;2;0;0;0
1854510;Billiards of the Round Table (BRT);;0 - 20,000;2;0;2;0;0;0
1854540;Untitled Survival Game;;0 - 20,000;6;1;5;0;0;0
1854580;In The Space - Escape Room;;0 - 20,000;11;5;6;0;0;1
1854590;Green Alert;;0 - 20,000;1;0;1;0;0;0
1854630;Morph King;;0 - 20,000;14;1;13;0;0;2
1854730;Mental Math Tutor;;0 - 20,000;1;2;-1;0;0;0
1854740;HINA-CHAN's BIG TRADE! Millionaire Lunch;;0 - 20,000;15;1;14;0;0;2
1854790;Space Penguins;;0 - 20,000;3;1;2;0;0;0
1854830;消失的纪元   The Lost Era;;0 - 20,000;6;1;5;0;0;0
1854840;城堡与冒险;;0 - 20,000;10;5;5;0;0;0
1854870;Le Avventure di Blue;;0 - 20,000;9;0;9;0;0;0
1854890;Kill To Live;;20,000 - 50,000;1;4;-3;0;0;0
1854900;.G;;0 - 20,000;3;0;3;0;0;0
1854940;Far Far Away From Here;;20,000 - 50,000;11;4;7;0;0;0
1854980;Madohi Shiroki no Kamikakushi;;0 - 20,000;294;14;280;1338;1338;6
1855020;Freeze the time;;0 - 20,000;11;0;11;0;0;0
1855030;Stairway to Heaven's Gate;;20,000 - 50,000;16;0;16;0;0;2
1855040;Deja Vu;;20,000 - 50,000;2;0;2;0;0;0
1855070;Kukumushi Virtual Pet;;0 - 20,000;8;2;6;0;0;0
1855100;Dog Adventure;;0 - 20,000;50;8;42;0;0;0
1855150;Helm or High Water;;0 - 20,000;2;1;1;0;0;0
1855170;SEARCH ALL - CHRISTMAS;;0 - 20,000;27;2;25;0;0;0
1855190;Vektor Z;;0 - 20,000;3;2;1;0;0;0
1855240;PRINCESS;;0 - 20,000;1;0;1;0;0;0
1855270;Pachillinko;;0 - 20,000;24;16;8;0;0;11
1855340;Birth Patrol;;20,000 - 50,000;1;0;1;0;0;0
1855380;Spirits of Light;;0 - 20,000;4;1;3;0;0;0
1855470;Dark Haunting;;0 - 20,000;15;12;3;0;0;0
1855480;Blue Jay Joyride;;0 - 20,000;2;0;2;0;0;0
1855490;Elemental War: Dawn of the Crystals;;0 - 20,000;1;0;1;0;0;0
1855500;Neko Doll;;0 - 20,000;71;13;58;0;0;0
1855590;Color Lab;;0 - 20,000;4;1;3;0;0;0
1855610;Happy Island Life;;0 - 20,000;13;3;10;0;0;1
1855620;Intimate Relationship;;0 - 20,000;0;1;-1;0;0;0
1855660;我有一座冒险屋 I have an adventure house;;0 - 20,000;34;24;10;0;0;0
1855690;Bessarabian Nightmares;;0 - 20,000;3;0;3;0;0;0
1855920;Missing Plane: Survival;;0 - 20,000;8;16;-8;0;0;0
1855930;Recruit&Adventure;;0 - 20,000;14;4;10;0;0;1
1855950;Leningrad;;50,000 - 100,000;9;6;3;0;0;0
1856000;DIKDIK Video Kit 2023;;0 - 20,000;3;1;2;0;0;2
1856010;Eagle Simulator;;0 - 20,000;8;3;5;0;0;0
1856020;Gav-Gav Odyssey;;0 - 20,000;16;0;16;0;0;0
1856030;Fresh Start Cleaning Simulator;;0 - 20,000;508;66;442;528;528;21
1856040;XenoTown;;20,000 - 50,000;9;0;9;0;0;0
1856080;Ambushed;;0 - 20,000;0;2;-2;0;0;0
1856090;World of Haiku;;20,000 - 50,000;74;19;55;0;0;5
1856110;Escape From Hard Drive;;0 - 20,000;6;0;6;0;0;0
1856130;Catoise;;0 - 20,000;4;0;4;0;0;0
1856160;The Last Rite of Death;;0 - 20,000;3;2;1;0;0;0
1856170;Poker - Texas;;0 - 20,000;1;0;1;0;0;0
1856480;KamiYaba: Destiny on a Dicey Deadline;;0 - 20,000;87;4;83;0;0;3
1856550;Magnus Imago;;0 - 20,000;14;2;12;0;0;0
1856680;The Age of Navigation;;0 - 20,000;81;56;25;0;0;12
1856730;Poly Puzzle: Dogs;;0 - 20,000;3;2;1;0;0;0
1856750;Relayer Advanced;;0 - 20,000;28;12;16;0;0;5
1856840;MaDevil;;20,000 - 50,000;7;1;6;0;0;0
1856850;TukTuk;;0 - 20,000;5;1;4;0;0;0
1856860;Magic City Detective: Wings Of Revenge Collector's Edition;;20,000 - 50,000;5;1;4;0;0;1
1856890;Zhazari VR;;20,000 - 50,000;0;1;-1;0;0;0
1856900;Andro Dunos II;;0 - 20,000;75;2;73;0;0;1
1856910;Ganryu 2;;0 - 20,000;54;14;40;0;0;1
1857010;Polygon Hunter VR;;0 - 20,000;2;0;2;0;0;0
1857040;Under Iron Water;;0 - 20,000;1;0;1;0;0;0
1857070;Golden Mine Pickaxe;;0 - 20,000;4;3;1;0;0;0
1857080;The Last Starship;;50,000 - 100,000;80;13;67;0;0;270
1857140;RetroDrift: Retrowave Online Road;;0 - 20,000;57;14;43;0;0;0
1857150;The Christmas Spirit: Golden Ticket Collector's Edition;;0 - 20,000;6;0;6;0;0;1
1857160;Ms. Holmes: The Adventure of the McKirk Ritual Collector's Edition;;0 - 20,000;9;0;9;0;0;0
1857220;OtterQuest;;0 - 20,000;3;0;3;0;0;0
1857340;Spy Network;;0 - 20,000;3;9;-6;0;0;0
1857550;Bad Credit;;0 - 20,000;20;1;19;0;0;1
1857580;Get Achievements for Achievements;;0 - 20,000;87;5;82;0;0;0
1857640;Forest Kingdom;;0 - 20,000;1;0;1;0;0;0
1857650;DEEP FOG;;20,000 - 50,000;88;0;88;0;0;0
1857650;DEEP FOG;;20,000 - 50,000;88;0;88;0;0;0
1857690;Retrievable;;0 - 20,000;0;1;-1;0;0;0
1857730;Color Patterns;;0 - 20,000;1;2;-1;0;0;0
1857780;Cursed Quest;;0 - 20,000;6;0;6;0;0;0
1857840;Xolotl;;0 - 20,000;7;1;6;0;0;0
1857850;Down the Hill;;0 - 20,000;1;3;-2;0;0;0
1857870;Space Demon Combat Tactics III;;0 - 20,000;2;0;2;0;0;0
1857910;Forest Mystery;;0 - 20,000;3;5;-2;0;0;0
1857980;The Paper Game;;0 - 20,000;6;0;6;0;0;0
1858090;A Modest Legacy;;0 - 20,000;5;3;2;0;0;1
1858260;Go Fetch!;;0 - 20,000;0;0;0;0;0;0
1858270;Cat Adventure;;0 - 20,000;9;3;6;0;0;0
1858400;Squarena;;0 - 20,000;2;0;2;0;0;0
1858550;Grand Hike;;0 - 20,000;16;6;10;0;0;0
1858580;巨 ~Gigantify~;;0 - 20,000;6;0;6;0;0;0
1858600;Santa Jump;;0 - 20,000;5;4;1;0;0;0
1858620;DRAWER;;0 - 20,000;23;1;22;0;0;0
1858750;SpriteMancer;;0 - 20,000;37;0;37;0;0;7
1858760;Gem Worlds;;0 - 20,000;6;0;6;0;0;0
1858780;Spooky Story;;0 - 20,000;13;3;10;0;0;0
1858900;Stardust Exile;;0 - 20,000;8;1;7;0;0;9
1858920;DRAGON NINJA BYOKA;;0 - 20,000;4;0;4;0;0;0
1858940;Bridge to Another World: Christmas Flight Collector's Edition;;0 - 20,000;2;1;1;0;0;1
1859060;Jigsaw Puzzle Beach Season;;0 - 20,000;2;1;1;0;0;0
1859100;Royal Jigsaw;;0 - 20,000;0;1;-1;0;0;0
1859110;Holiday Jigsaw Christmas;;0 - 20,000;1;1;0;0;0;0
1859130;Solitaire Jack Frost Winter Adventures 3;;0 - 20,000;0;1;-1;0;0;0
1859140;Pirate's Solitaire;;0 - 20,000;1;0;1;0;0;0
1859150;Knight Solitaire 2;;0 - 20,000;1;0;1;0;0;0
1859220;疯狂厨房VR;;0 - 20,000;0;1;-1;0;0;0
1859280;7 Days to End with You;;50,000 - 100,000;728;49;679;154;158;8
1859290;Crypto Miner Tycoon Simulator;;0 - 20,000;79;9;70;0;0;3
1859310;C.O.D.E.R.E.D;;0 - 20,000;0;2;-2;0;0;0
1859360;Dungeon Village;;20,000 - 50,000;359;45;314;977;1110;26
1859360;Dungeon Village;;20,000 - 50,000;359;45;314;977;1110;26
1859370;Dream House Days DX;;0 - 20,000;180;31;149;0;0;7
1859470;PAC-MAN WORLD Re-PAC;;20,000 - 50,000;558;27;531;0;0;6
1859490;Planet TD;;0 - 20,000;63;11;52;0;0;1
1859590;The Zombie Smasher;;0 - 20,000;23;12;11;0;0;0
1859610;Size It;;100,000 - 200,000;13;9;4;0;0;0
1859630;Jean and Josie;;0 - 20,000;14;5;9;0;0;0
1859640;SIMULATTE - Coffee Shop Simulator;;0 - 20,000;9;9;0;0;0;0
1859650;Ryzer: The Reflectors Path;;20,000 - 50,000;24;1;23;0;0;2
1859680;Avalanches;;0 - 20,000;2;0;2;0;0;0
1859730;Forest;;0 - 20,000;3;10;-7;0;0;0
1859770;Cubes and Knights;;0 - 20,000;53;6;47;0;0;0
1859800;The Hierophant;;20,000 - 50,000;3;0;3;0;0;0
1859840;Pixa Clicker;;0 - 20,000;4;0;4;0;0;0
1859870;执剑九霄;;100,000 - 200,000;1;2;-1;0;0;0
1859980;AURUM;;0 - 20,000;0;3;-3;0;0;0
1860040;Samurai Tactics;;20,000 - 50,000;2;0;2;0;0;0
1860050;Adventures Nearby;;0 - 20,000;8;6;2;0;0;0
1860110;Rabbit Canyon;;0 - 20,000;1;1;0;0;0;0
1860160;Horrifical Maze;;0 - 20,000;2;0;2;0;0;0
1860260;The SCALING;;0 - 20,000;1;0;1;0;0;0
1860270;Prototype: Paradise Lost;;0 - 20,000;0;1;-1;0;0;0
1860330;Cubelander;;0 - 20,000;5;0;5;0;0;0
1860370;Weapons Simulator;;0 - 20,000;17;2;15;0;0;0
1860440;Anges & Gardiens - Journey to the Center of the Earth;;0 - 20,000;1;0;1;0;0;0
1860500;Sweet Collector;;0 - 20,000;7;2;5;0;0;0
1860530;SAVE BILLY;;0 - 20,000;12;2;10;0;0;0
1860590;Extreme Race;;0 - 20,000;10;0;10;0;0;1
1860600;The World According to Girl;;0 - 20,000;81;29;52;0;0;0
1860610;Wild West Old Sam;;0 - 20,000;1;2;-1;0;0;0
1860710;Breaking Newton;;0 - 20,000;5;0;5;0;0;0
1860870;ShapeGrid;;0 - 20,000;15;0;15;0;0;1
1860900;Antivine;;0 - 20,000;92;3;89;0;0;1
1860960;Eira;;0 - 20,000;45;2;43;0;0;1
1861100;VR LightingClimbing;;0 - 20,000;2;1;1;0;0;0
1861230;TAISHO x ALICE: HEADS & TAILS;;0 - 20,000;40;3;37;0;0;4
1861290;Devil Spire;;50,000 - 100,000;224;11;213;0;0;2
1861310;Nevedomo;;0 - 20,000;6;0;6;0;0;0
1861390;Way On Where;;0 - 20,000;2;0;2;0;0;0
1861610;Endorphin Vice;;0 - 20,000;37;14;23;0;0;1
1861700;Drop one NPC to another;;0 - 20,000;6;1;5;0;0;0
1861760;SAMURAI CHALLENGE;;0 - 20,000;5;3;2;0;0;0
1861780;Psychic;;0 - 20,000;15;2;13;0;0;0
1861870;Shadow Fate;;0 - 20,000;27;1;26;0;0;1
1861880;Air Traffic: Greenlight;;0 - 20,000;58;5;53;0;0;9
1861940;Monsters and Weapons;;0 - 20,000;16;4;12;0;0;0
1861980;Di-Da-Dobble;;0 - 20,000;16;0;16;0;0;0
1862010;Double Time;;0 - 20,000;4;1;3;0;0;0
1862100;Quest for Cathay Kingdom Mah Jong;;0 - 20,000;5;0;5;0;0;0
1862180;Lunar Odyssey;;0 - 20,000;3;4;-1;0;0;0
1862260;Ryclaw: Save Yourself;;0 - 20,000;4;0;4;0;0;0
1862270;BLOWFLY;;0 - 20,000;90;1;89;0;0;0
1862280;Hell's Delivery;;0 - 20,000;2;0;2;0;0;0
1862420;Spryward;;0 - 20,000;1;0;1;0;0;0
1862500;Catch them!;;0 - 20,000;11;2;9;0;0;0
1862520;Just Go;;50,000 - 100,000;1452;108;1344;533;579;209
1862530;Space Dragons;;20,000 - 50,000;23;4;19;0;0;0
1862600;Dino Island Adventure;;0 - 20,000;1;0;1;0;0;0
1862690;My Gaming Club;;0 - 20,000;335;38;297;179;179;66
1862710;Space Ducks: The great escape;;0 - 20,000;20;4;16;0;0;0
1862730;FORTRESS OF FEAR;;0 - 20,000;3;0;3;0;0;0
1862790;Siienaa;;0 - 20,000;6;1;5;0;0;0
1862830;Lost Artifacts Mysterious Book Collector's Edition;;0 - 20,000;6;3;3;0;0;0
1862840;Bash the Teacher! - Classroom Clicker;;0 - 20,000;45;24;21;0;0;0
1862850;Nerraia;;0 - 20,000;1;1;0;0;0;0
1862980;Knight Riot;;0 - 20,000;2;2;0;0;0;0
1862990;Nervous Granny;;0 - 20,000;0;1;-1;0;0;0
1863010;DuckHunt - Missouri;;0 - 20,000;1;0;1;0;0;0
1863030;Cake4D;;0 - 20,000;3;1;2;0;0;0
1863080;Beat Invaders;;0 - 20,000;140;4;136;0;0;2
1863090;Word Crack;;0 - 20,000;2;2;0;0;0;0
1863100;Spooky Shooter 3D;;0 - 20,000;17;9;8;0;0;0
1863170;From Dusk To Dawn;;0 - 20,000;5;3;2;0;0;0
1863240;Game City;;0 - 20,000;0;1;-1;0;0;0
1863250;Life of Pepe;;50,000 - 100,000;11;1;10;0;0;0
1863310;Dogs and Pigs;;0 - 20,000;2;0;2;0;0;0
1863370;Funny Street Football;;0 - 20,000;6;1;5;0;0;0
1863420;Crazy Cube Adventure;;0 - 20,000;16;1;15;0;0;1
1863460;Pixel Art School - 今から始めるドット絵入門 -;;0 - 20,000;2;2;0;0;0;0
1863470;Claus Adventure;;0 - 20,000;15;7;8;0;0;0
1863490;Protecting Santa;;0 - 20,000;2;8;-6;0;0;0
1863570;YUZA;;0 - 20,000;14;3;11;0;0;0
1863610;Thumb-Thump;;0 - 20,000;2;1;1;0;0;0
1863630;B-1LL1;;20,000 - 50,000;6;0;6;0;0;0
1863650;Van Van Up!;;0 - 20,000;10;5;5;0;0;0
1863750;挂机神话;;200,000 - 500,000;1259;103;1156;10740;20608;205
1863940;Bunny Box Breakout;;0 - 20,000;5;0;5;0;0;0
1863980;Tor-tor cubes;;0 - 20,000;12;1;11;0;0;0
1863990;Stapel;;0 - 20,000;0;1;-1;0;0;0
1864050;DEBUG;;0 - 20,000;4;7;-3;0;0;0
1864070;YUME : Special Edition;;0 - 20,000;23;54;-31;0;0;1
1864210;Zombie War;;0 - 20,000;2;0;2;0;0;0
1864320;Race! Beauty! Bugs!;;0 - 20,000;11;11;0;0;0;0
1864460;Room Prison;;0 - 20,000;6;9;-3;0;0;0
1864580;Dinosaurs A Prehistoric Adventure 2;;0 - 20,000;6;6;0;0;0;2
1864620;Boss Of The Mafia;;0 - 20,000;6;4;2;0;0;0
1864630;Virago;;0 - 20,000;18;12;6;0;0;1
1864710;Coin Operated Carnage;;20,000 - 50,000;4;1;3;0;0;0
1864790;1BITDRAGON;;0 - 20,000;121;7;114;0;0;4
1864850;Hidden Map;;0 - 20,000;5;10;-5;0;0;0
1864860;Hidden Islands;;0 - 20,000;11;12;-1;0;0;0
1865050;Hellfire 1988: An Oregon Story;;20,000 - 50,000;17;0;17;0;0;0
1865060;14 Minesweeper Variants;;0 - 20,000;366;5;361;205;205;205
1865080;Idol Queens Production;;0 - 20,000;13;20;-7;0;0;0
1865100;Pengu Never Left;;0 - 20,000;25;0;25;0;0;0
1865160;Safe and Sound - Indie Game;;0 - 20,000;5;0;5;0;0;0
1865170;Eden's Last Sunrise;;50,000 - 100,000;23;0;23;0;0;8
1865220;Ouija Rumours;;0 - 20,000;31;9;22;0;0;0
1865230;The Dreaming Fox;;0 - 20,000;1;0;1;0;0;0
1865280;Novalie;;0 - 20,000;7;0;7;0;0;0
1865340;Menu Please!;;0 - 20,000;22;2;20;0;0;0
1865470;Dimension Shifter;;0 - 20,000;1;0;1;0;0;0
1865510;Notebook Entries Vol. 1;;0 - 20,000;23;1;22;0;0;1
1865590;BombSweeperVR;;0 - 20,000;2;1;1;0;0;0
1865650;Aldebaran Legend;;0 - 20,000;2;1;1;0;0;1
1865660;MUGEN Avatar;;0 - 20,000;5;2;3;0;0;1
1865680;瓔珞事件簿之誰殺了愛情;;0 - 20,000;51;2;49;0;0;1
1865880;Dungeon & Burglar;;0 - 20,000;2;2;0;0;0;0
1865890;Creature Hunter;;20,000 - 50,000;2;0;2;0;0;0
1865940;Lead the Way - Full Collection;;0 - 20,000;2;0;2;0;0;0
1866090;Insect Simulator;;0 - 20,000;1;3;-2;0;0;0
1866110;Anime Gas Station;;0 - 20,000;12;13;-1;0;0;0
1866180;Hooked on You: A Dead by Daylight Dating Sim;;200,000 - 500,000;4613;486;4127;177;214;24
1866230;Jetpackman;;0 - 20,000;16;8;8;0;0;0
1866250;Dangerous Hobby;;0 - 20,000;6;6;0;0;0;0
1866260;Lighthouse Stories - Book one: Part one;;0 - 20,000;1;2;-1;0;0;0
1866390;Dimension Dash;;0 - 20,000;1;0;1;0;0;0
1866420;La Pucelle: Ragnarok;;20,000 - 50,000;43;4;39;61;61;5
1866430;Rhapsody: A Musical Adventure;;0 - 20,000;58;3;55;0;0;1
1866470;Guns N Stuff 2;;0 - 20,000;15;0;15;0;0;0
1866570;Xross Dreams;;0 - 20,000;12;0;12;0;0;4
1866610;Traction Control;;0 - 20,000;24;1;23;0;0;0
1866670;赋灵牌;;0 - 20,000;1;0;1;0;0;0
1866700;Sharon and the Last Garden;;0 - 20,000;1;2;-1;0;0;0
1866710;Draft Day Sports: College Football 2022;;0 - 20,000;8;7;1;0;0;11
1866780;Natural;;0 - 20,000;3;0;3;0;0;0
1866840;Mysterious Adventure of Michael 2;;0 - 20,000;2;0;2;0;0;0
1866880;Cultivation Story: Reincarnation;;20,000 - 50,000;1284;86;1198;388;461;564
1866880;Cultivation Story: Reincarnation;;20,000 - 50,000;1284;86;1198;388;461;564
1866960;I am on Fire (小小火神）;;0 - 20,000;2;0;2;0;0;0
1866970;When I Die;;0 - 20,000;2;0;2;0;0;0
1866990;Scoop Kick!;;0 - 20,000;30;1;29;0;0;0
1867000;Pretty Girls Speed;;0 - 20,000;18;0;18;0;0;0
1867050;Jules;;0 - 20,000;5;0;5;0;0;0
1867070;Darxanadon;;0 - 20,000;27;14;13;0;0;0
1867100;Merge Hero;;0 - 20,000;6;19;-13;0;0;0
1867190;Wordle 5;;0 - 20,000;39;19;20;0;0;1
1867260;Way Down;;0 - 20,000;1;2;-1;0;0;0
1867280;Cyberpunk Girls;;0 - 20,000;32;11;21;0;0;0
1867330;Surreal Nightmare;;0 - 20,000;10;5;5;0;0;0
1867450;How To Bathe Your Cat: Impossible Mission;;0 - 20,000;33;2;31;0;0;0
1867470;Death By Tomato;;0 - 20,000;1;0;1;0;0;0
1867480;The Hike;;0 - 20,000;12;9;3;0;0;0
1867530;Solar Ash;;0 - 20,000;329;45;284;216;216;9
1867540;Mission: Santa;;0 - 20,000;1;0;1;0;0;0
1867550;Armageddon War:Old Era Wreckers / 大鏖战:旧时代的残党;;0 - 20,000;3;0;3;0;0;0
1867580;Final Space - The Rescue;;0 - 20,000;20;3;17;0;0;0
1867590;Mannequin The Passing;;0 - 20,000;18;5;13;0;0;0
1867640;观星VR / Oriental stars;;0 - 20,000;6;0;6;0;0;0
1867740;Like Dreamer;;20,000 - 50,000;77;1;76;275;275;0
1867790;For Sparta;;0 - 20,000;6;1;5;0;0;0
1867810;Mercenaries Rebirth: Call of the Wild Lynx;;0 - 20,000;30;11;19;0;0;3
1867840;西游戰棋（West Journey War）;;0 - 20,000;0;2;-2;0;0;0
1867930;Mini Putt Camelot;;0 - 20,000;6;0;6;0;0;0
1868000;Resist the succubus—The end of the female Knight;;50,000 - 100,000;747;196;551;2;2;14
1868050;Vortex;;50,000 - 100,000;8;1;7;0;0;0
1868060;Who Shuffled My Shapes?;;0 - 20,000;8;0;8;0;0;0
1868080;MotorSim 3;;0 - 20,000;6;0;6;0;0;0
1868140;DAVE THE DIVER;;200,000 - 500,000;8106;183;7923;714;861;407
1868220;AstoriaVR;;0 - 20,000;1;0;1;0;0;0
1868240;Ink Bunny;;0 - 20,000;4;3;1;0;0;0
1868280;Coins Collector Simulator;;0 - 20,000;11;6;5;0;0;0
1868310;Light of Life;;0 - 20,000;14;1;13;0;0;0
1868400;PerformVR;;0 - 20,000;2;0;2;0;0;0
1868450;Crazi Lift;;0 - 20,000;1;0;1;0;0;0
1868510;Wordish;;0 - 20,000;6;3;3;0;0;0
1868520;Super Perils of Baking;;0 - 20,000;8;0;8;0;0;0
1868540;Zenteni;;0 - 20,000;1;0;1;0;0;0
1868550;Crossroads: On a Just Path Collector's Edition;;0 - 20,000;2;1;1;0;0;0
1868600;Fighting Heart;;0 - 20,000;3;0;3;0;0;0
1868710;Pirates on Target;;0 - 20,000;12;0;12;0;0;0
1868820;Contact;;0 - 20,000;12;4;8;0;0;0
1868840;Alien Defense;;0 - 20,000;4;2;2;0;0;0
1868980;素数ガール;;0 - 20,000;3;0;3;0;0;0
1869090;Witches of the Fourth Multiplayer;;200,000 - 500,000;1;0;1;0;0;0
1869200;The Adventures of Mr. Hat;;0 - 20,000;17;0;17;0;0;0
1869280;INTO THE CTHULHU MYTHOLOGY;;0 - 20,000;6;0;6;0;0;0
1869510;Telestians;;0 - 20,000;18;1;17;0;0;0
1869580;Riley & Rochelle;;0 - 20,000;21;0;21;0;0;0
1869690;SEARCH ALL - SUSHI;;0 - 20,000;22;3;19;0;0;0
1869710;Invention 3;;0 - 20,000;33;11;22;0;0;0
1869870;Cartomancy Anthology;;0 - 20,000;29;0;29;0;0;0
1869890;DESTROY Simulator;;0 - 20,000;20;3;17;0;0;0
1869900;A Ghostly Rose;;0 - 20,000;10;0;10;0;0;0
1869980;Grisaia Phantom Trigger Vol.8;;0 - 20,000;61;5;56;0;0;0
1869990;Survivor Day;;100,000 - 200,000;4;0;4;0;0;0
1870020;欢迎回家-Welcome Home;;0 - 20,000;5;0;5;0;0;0
1870140;Xuan-Yuan Sword: The Cloud of Han;;0 - 20,000;38;8;30;0;0;19
1870150;Xuan-Yuan Sword: The Clouds Faraway;;0 - 20,000;39;11;28;0;0;44
1870170;Emiko's Pledge;;0 - 20,000;3;2;1;0;0;0
1870210;amazin' George 2 Digital Deluxe;;0 - 20,000;24;0;24;0;0;1
1870280;ZPlague;;0 - 20,000;5;2;3;0;0;0
1870320;World Seed;;20,000 - 50,000;233;75;158;0;0;3
1870410;Gangsta: The Return;;0 - 20,000;18;18;0;0;0;0
1870440;Funny Panda;;0 - 20,000;17;4;13;0;0;0
1870490;Prop Hunt 2.0;;0 - 20,000;13;5;8;0;0;3
1870580;Winter With You;;0 - 20,000;13;0;13;0;0;0
1870630;Virtual Virtual Reality 2;;0 - 20,000;10;11;-1;0;0;1
1870710;Circuit: Laser Maze;;0 - 20,000;4;0;4;0;0;0
1870810;Visualis Electromagnetism;;0 - 20,000;2;0;2;0;0;0
1870910;Dimension Quest Pinball;;0 - 20,000;13;0;13;0;0;1
1871010;Dubu Rush;;0 - 20,000;3;0;3;0;0;0
1871020;休闲拼一拼;;0 - 20,000;0;1;-1;0;0;0
1871030;My Little Colony;;0 - 20,000;2;5;-3;0;0;0
1871090;Sabbuth;;0 - 20,000;5;0;5;0;0;0
1871160;Blind wizard's assistant;;0 - 20,000;1;0;1;0;0;0
1871230;Bitcoin Chill;;0 - 20,000;9;0;9;0;0;0
1871290;Finger Football;;0 - 20,000;15;5;10;0;0;0
1871310;Hook 2;;0 - 20,000;413;5;408;0;0;3
1871340;Red Conquer;;100,000 - 200,000;12;6;6;0;0;0
1871350;OS:Memories;;0 - 20,000;10;5;5;0;0;1
1871410;Qrabbles;;0 - 20,000;1;0;1;0;0;0
1871420;Fresh Out The Oven;;0 - 20,000;1;0;1;0;0;0
1871430;Tekla;;0 - 20,000;10;1;9;0;0;0
1871490;Tactical Recon;;0 - 20,000;4;0;4;0;0;0
1871500;One Line: Letters and Codes;;0 - 20,000;33;2;31;0;0;0
1871510;Within Skerry;;20,000 - 50,000;153;28;125;0;0;2
1871510;Within Skerry;;20,000 - 50,000;153;28;125;0;0;2
1871600;The Great War of Jorth;;20,000 - 50,000;1;0;1;0;0;0
1871620;Covid Simulator;;0 - 20,000;54;13;41;0;0;0
1871670;Three Sons;;0 - 20,000;2;0;2;0;0;0
1871700;Yeah Yeah Beebiss II;;0 - 20,000;6;0;6;0;0;0
1871740;GRADUATER;;0 - 20,000;22;1;21;0;0;0
1871780;Rorys Restaurant Origins;;0 - 20,000;5;1;4;0;0;0
1871790;Bad Faith;;0 - 20,000;38;3;35;0;0;0
1871810;Otome No Himitsu;;0 - 20,000;1;3;-2;0;0;0
1871840;Eyo - Jump 'n' Run RPG;;0 - 20,000;10;0;10;0;0;0
1871880;Num One: Revised Edition;;0 - 20,000;16;0;16;0;0;3
1871900;LOST BETWEEN;;0 - 20,000;3;1;2;0;0;0
1871920;Fantasy Mosaics 35: Day at the Museum;;0 - 20,000;3;0;3;0;0;0
1872040;Toziuha Night: Dracula's Revenge;;0 - 20,000;27;4;23;0;0;0
1872130;Cat and fish;;0 - 20,000;7;5;2;0;0;1
1872160;EPIC KNIGHT;;0 - 20,000;11;5;6;0;0;0
1872200;IRON GUARD;;0 - 20,000;17;3;14;0;0;0
1872470;HardWorker Simulator;;0 - 20,000;16;3;13;0;0;0
1872500;Rivalia: Dungeon Raiders;;0 - 20,000;14;3;11;0;0;1
1872550;Destroy All Humans! – Clone Carnage;;0 - 20,000;72;113;-41;36;36;5
1872680;The Knight Witch;;20,000 - 50,000;212;63;149;0;0;8
1872730;Math Game;;0 - 20,000;4;9;-5;0;0;0
1872790;Luckitown;;0 - 20,000;155;24;131;0;0;2
1872860;Conrad Stevenson's Paranormal P.I.;;50,000 - 100,000;483;47;436;0;0;31
1872920;Pillars of Sorrow;;0 - 20,000;3;0;3;0;0;0
1873040;Poly Memory: Dogs;;0 - 20,000;1;1;0;0;0;0
1873080;Datascape;;20,000 - 50,000;2;0;2;0;0;0
1873210;A Siren's Call VR: Death Comes At Night;;0 - 20,000;0;2;-2;0;0;0
1873230;Cursed Exped;;0 - 20,000;32;6;26;0;0;0
1873410;Witch Sacrifice;;0 - 20,000;3;0;3;0;0;0
1873440;I Am Two People;;0 - 20,000;28;3;25;0;0;0
1873540;World Empire 2027;;0 - 20,000;33;14;19;0;0;2
1873570;Everblade;;0 - 20,000;20;6;14;0;0;0
1873720;Return Ace;;0 - 20,000;0;1;-1;0;0;0
1873740;Peace Maker VR;;0 - 20,000;4;1;3;0;0;0
1873750;Periphery;;0 - 20,000;18;13;5;0;0;4
1873780;NecroFarm;;0 - 20,000;8;1;7;0;0;0
1873800;DEAD GUN;;0 - 20,000;15;3;12;0;0;0
1873880;Collect Objects;;0 - 20,000;1;0;1;0;0;0
1873920;Fracked;;0 - 20,000;31;20;11;0;0;0
1873960;Dungeon Crawler;;100,000 - 200,000;6;3;3;0;0;0
1873990;3D PUZZLE - Old House;;0 - 20,000;23;16;7;0;0;0
1874010;Robert: Space Stories and Battles;;50,000 - 100,000;14;1;13;0;0;0
1874060;Blobbs: Remastered;;0 - 20,000;6;0;6;0;0;0
1874170;Shredders;;20,000 - 50,000;1348;61;1287;21;21;245
1874200;I don't think I've walked this stretch of road before;;0 - 20,000;15;2;13;0;0;0
1874220;GO;;0 - 20,000;0;2;-2;0;0;0
1874260;Far Away From Home;;0 - 20,000;29;4;25;0;0;3
1874340;WILD WEST;;0 - 20,000;20;10;10;0;0;0
1874380;Karolina;;20,000 - 50,000;1;2;-1;0;0;0
1874400;Mini Mini-Golf;;0 - 20,000;7;7;0;0;0;0
1874420;Don't Push Me;;0 - 20,000;1;0;1;0;0;0
1874490;Potionomics;;200,000 - 500,000;3355;390;2965;921;1286;126
1874500;Mori;;0 - 20,000;2;0;2;0;0;0
1874510;Knightlife;;0 - 20,000;0;1;-1;0;0;0
1874530;Peep Invasion;;0 - 20,000;3;0;3;0;0;0
1874660;浮生箓 Floating Life;;0 - 20,000;89;56;33;0;0;0
1874660;浮生箓 Floating Life;;0 - 20,000;89;56;33;0;0;0
1874680;Tower Words;;0 - 20,000;16;5;11;0;0;0
1874780;月夜赞歌 Melody in the moonlight;;0 - 20,000;13;4;9;0;0;0
1874840;RUNNER RTX;;0 - 20,000;17;6;11;0;0;0
1874880;Arma Reforger;;200,000 - 500,000;4274;3193;1081;1489;838;206
1874920;100 Days without delays;;0 - 20,000;7;6;1;0;0;0
1874950;Runner Party;;0 - 20,000;21;0;21;0;0;1
1874990;Fluids & Sounds: Mind relaxing and meditative;;0 - 20,000;13;0;13;0;0;0
1875140;黎明为歌 - Melody before the Dawn;;20,000 - 50,000;50;3;47;0;0;0
1875160;The Blunderbuss;;0 - 20,000;6;5;1;0;0;0
1875280;Miner Ultra Adventures 2;;0 - 20,000;267;84;183;0;0;2
1875280;Miner Ultra Adventures 2;;0 - 20,000;267;84;183;0;0;2
1875310;Pro Basketball Manager 2023;;0 - 20,000;81;22;59;0;0;35
1875360;Off-Road Farming;;0 - 20,000;38;25;13;0;0;0
1875470;Ninjas Against the Machines;;0 - 20,000;2;0;2;0;0;0
1875560;Mare;;0 - 20,000;21;5;16;0;0;1
1875670;Gigant;;0 - 20,000;18;4;14;0;0;0
1875710;PARACHUTER;;50,000 - 100,000;2;0;2;0;0;0
1875720;Zoo Tales;;0 - 20,000;4;4;0;0;0;0
1875810;Slashers;;20,000 - 50,000;51;30;21;0;0;0
1875850;Reds Adventure A Seasons New Beginning;;0 - 20,000;3;0;3;0;0;0
1875950;Gilded Shadows;;0 - 20,000;104;5;99;0;0;9
1876000;IFO;;20,000 - 50,000;49;9;40;0;0;1
1876050;Labyrinth deLux - A Crusoe Quest;;0 - 20,000;4;0;4;0;0;0
1876060;Dark Hood;;0 - 20,000;0;1;-1;0;0;0
1876150;Melania;;0 - 20,000;25;3;22;0;0;0
1876180;Villager comes alive;;0 - 20,000;3;1;2;0;0;0
1876240;Watashi Suzume;;0 - 20,000;6;0;6;0;0;0
1876340;EVERING;;0 - 20,000;6;1;5;0;0;1
1876350;HEROish;;0 - 20,000;38;1;37;0;0;4
1876390;Stakeholder Game;;0 - 20,000;4;8;-4;0;0;0
1876410;Brick Cracker 3D;;0 - 20,000;4;1;3;0;0;0
1876530;Potions!;;0 - 20,000;6;0;6;0;0;0
1876530;Potions!;;0 - 20,000;6;0;6;0;0;0
1876540;Loopback;;0 - 20,000;1;0;1;0;0;0
1876560;Save the Reactor;;0 - 20,000;58;0;58;0;0;1
1876660;Start Programming;;0 - 20,000;5;1;4;0;0;0
1876670;Woodcutter Deluxe Edition;;0 - 20,000;4;2;2;0;0;0
1876680;Roma VR - Domus;;0 - 20,000;3;4;-1;0;0;0
1876690;One day after the snow and wind;;0 - 20,000;1;1;0;0;0;0
1876730;蔚蓝月下的回忆~SAPPHIRE MOON-FOREVER MEMORIES;;0 - 20,000;252;48;204;0;0;1
1876750;Minecart Madness;;0 - 20,000;1;0;1;0;0;0
1876810;Jumping Knight;;0 - 20,000;2;0;2;0;0;0
1876830;Life after Death;;0 - 20,000;59;25;34;0;0;2
1876980;戛然而止的音符;;0 - 20,000;16;7;9;0;0;2
1877000;Retro Kart Rush;;0 - 20,000;26;0;26;0;0;0
1877060;Haunted Stories;;0 - 20,000;8;4;4;0;0;0
1877100;Emu;;0 - 20,000;23;1;22;0;0;0
1877190;Astrogon;;0 - 20,000;15;0;15;0;0;0
1877300;Lo-Fi: THEXNERXXM;;0 - 20,000;4;1;3;0;0;0
1877330;NEXT DOOR - An Eternal World;;100,000 - 200,000;2;1;1;0;0;1
1877360;Mars Rover Simulator;;50,000 - 100,000;1;11;-10;0;0;0
1877370;ConflictCraft 2 - Game of the Year Edition;;0 - 20,000;33;10;23;0;0;0
1877410;Fairy Deer;;0 - 20,000;28;3;25;0;0;1
1877440;The Battle Never Ends;;20,000 - 50,000;20;0;20;0;0;1
1877460;Ghost;;20,000 - 50,000;4;7;-3;0;0;0
1877460;Ghost;;20,000 - 50,000;4;7;-3;0;0;0
1877780;Shibainu - VR Katana Simulator;;0 - 20,000;25;12;13;0;0;2
1877790;Armchair Racer;;0 - 20,000;6;0;6;0;0;0
1877800;ARMS DOLL;;0 - 20,000;14;2;12;0;0;2
1877830;I Am Gangster;;0 - 20,000;4;0;4;0;0;0
1877920;Shadow Running;;0 - 20,000;16;3;13;0;0;0
1877930;Total CATastrophe;;20,000 - 50,000;13;2;11;0;0;0
1877970;Swinging-Man;;0 - 20,000;9;2;7;0;0;0
1878000;Elven Warmaiden;;0 - 20,000;5;0;5;0;0;0
1878050;TNTODION;;0 - 20,000;2;1;1;0;0;0
1878050;TNTODION;;0 - 20,000;2;1;1;0;0;0
1878070;Roma Invicta;;0 - 20,000;134;26;108;0;0;1
1878110;Victorian Debutante;;0 - 20,000;2;0;2;0;0;0
1878220;TV Thief;;0 - 20,000;5;3;2;0;0;0
1878290;Project Utgardr;;0 - 20,000;1;0;1;0;0;0
1878300;Animaddicts;;0 - 20,000;2;3;-1;0;0;0
1878310;NFT Museum;;0 - 20,000;2;0;2;0;0;0
1878350;Prayer of the Faithless;;50,000 - 100,000;9;1;8;0;0;1
1878530;升级打怪换装备;;0 - 20,000;6;3;3;0;0;4
1878570;Immortal Mantis;;0 - 20,000;134;3;131;0;0;2
1878580;Infinite Construction;;0 - 20,000;5;6;-1;0;0;0
1878660;Ink and Paper: Wandering;;0 - 20,000;1;0;1;0;0;0
1878710;Crowd Sign: Emission;;20,000 - 50,000;1;2;-1;0;0;0
1878740;Five Nights At Floppa;;20,000 - 50,000;889;35;854;28;28;3
1878770;ASCIILL;;0 - 20,000;23;0;23;0;0;0
1878840;Luna: Supernatural Hunter;;0 - 20,000;16;2;14;0;0;0
1878850;Perfect Balance Collection;;0 - 20,000;6;0;6;0;0;0
1878920;Animalistic;;0 - 20,000;44;6;38;0;0;0
1878970;Boom Bears on Stream;;0 - 20,000;17;0;17;0;0;3
1879000;In The End;;20,000 - 50,000;5;7;-2;0;0;0
1879030;Return the Backrooms;;50,000 - 100,000;74;34;40;0;0;2
1879170;Invaders from another dimension;;0 - 20,000;1;0;1;0;0;0
1879200;她曾经活过啊;;0 - 20,000;6;0;6;0;0;0
1879220;Zeppelin: Escape Room;;0 - 20,000;4;11;-7;0;0;0
1879290;Sould Dub;;100,000 - 200,000;13;6;7;0;0;0
1879330;WARRIORS OROCHI 3 Ultimate Definitive Edition;;100,000 - 200,000;1257;151;1106;2939;4939;244
1879380;Paper Bride 2 Zangling Village;;50,000 - 100,000;680;61;619;350;378;11
1879540;Super Rolling Heroes;;0 - 20,000;9;1;8;0;0;0
1879560;Lucky Tlhalerwa - Super Incursion;;50,000 - 100,000;3;1;2;0;0;0
1879570;Insipid;;0 - 20,000;2;3;-1;0;0;0
1879620;1000 Needles;;0 - 20,000;18;4;14;0;0;0
1879640;甜點王子2 典藏版;;0 - 20,000;108;14;94;0;0;24
1879690;Spirits Chronicles: Born in Flames Collector's Edition;;0 - 20,000;4;0;4;0;0;0
1879700;Cheat Day;;0 - 20,000;4;1;3;0;0;0
1879720;AFTERLIFE: KILLING DEATH;;50,000 - 100,000;9;8;1;0;0;2
1879730;Marine Radar Simulator - VR;;0 - 20,000;1;2;-1;0;0;1
1879750;YONESAWARA HOSPITAL;;0 - 20,000;19;1;18;0;0;1
1879820;Will Die Alone;;0 - 20,000;33;8;25;0;0;0
1879850;Loading Zone;;0 - 20,000;7;3;4;0;0;0
1879970;Gun Ugly;;0 - 20,000;6;0;6;0;0;0
1880020;Kojimachi;;0 - 20,000;9;1;8;0;0;6
1880030;Math it Right 3D Adventure;;0 - 20,000;1;1;0;0;0;0
1880080;The Baleful Tower;;0 - 20,000;1;0;1;0;0;1
1880160;元卡牌MetaCard;;0 - 20,000;19;3;16;0;0;1
1880310;Oogy: Can You Help;;0 - 20,000;1;1;0;0;0;0
1880490;Meet me at NooN;;0 - 20,000;60;0;60;0;0;0
1880640;A Butterfly's Dream;;0 - 20,000;31;2;29;0;0;0
1880670;OrcVsUndead;;0 - 20,000;1;0;1;0;0;0
1880690;Familiar;;0 - 20,000;6;0;6;0;0;0
1880720;Ninja Noboken;;0 - 20,000;14;2;12;0;0;2
1880770;REAL LIFE OF SOLDIERS;;0 - 20,000;3;0;3;0;0;0
1880840;Dead End City;;0 - 20,000;19;2;17;0;0;2
1880890;LOST EMBER - VR Edition;;0 - 20,000;31;24;7;0;0;0
1880910;Zombie Good Guy;;0 - 20,000;11;4;7;0;0;1
1880930;Rugby Union Team Manager 4;;0 - 20,000;15;3;12;0;0;6
1880960;Running on Empty;;50,000 - 100,000;8;0;8;0;0;0
1880980;Trapped In Stone - World War II Horror;;20,000 - 50,000;30;5;25;0;0;0
1881120;Titan Station;;0 - 20,000;149;12;137;0;0;0
1881160;Covid Carl;;0 - 20,000;14;1;13;0;0;0
1881180;Aery - Calm Mind 2;;0 - 20,000;28;1;27;0;0;0
1881200;TRYP FPV : The Drone Racer Simulator;;20,000 - 50,000;594;66;528;95;95;29
1881370;Sinister;;0 - 20,000;2;0;2;0;0;0
1881390;Exodus Vigil;;0 - 20,000;1;0;1;0;0;0
1881420;Cardfight!! Vanguard Dear Days;;20,000 - 50,000;549;89;460;0;0;163
1881420;Cardfight!! Vanguard Dear Days;;20,000 - 50,000;549;89;460;0;0;163
1881440;Fatal Blade;;0 - 20,000;2;2;0;0;0;0
1881460;admeowture;;0 - 20,000;1;0;1;0;0;0
1881480;MEDIEVAL KNIGHTMARE;;0 - 20,000;9;7;2;0;0;0
1881520;AI CG Generation Engine;;0 - 20,000;1;8;-7;0;0;0
1881540;Escape The Living Nebula;;0 - 20,000;4;2;2;0;0;0
1881570;A Hero's wish;;0 - 20,000;0;1;-1;0;0;0
1881670;MARY;;0 - 20,000;11;3;8;0;0;0
1881710;Bitlands;;0 - 20,000;6;0;6;0;0;0
1881840;ボクロボ ~Boxed Cell Robot Armies~;;0 - 20,000;3;0;3;0;0;0
1881850;Maze Twister;;0 - 20,000;5;1;4;0;0;0
1881950;Reimei no Gakuen - Otome/Visual Novel;;20,000 - 50,000;14;0;14;0;0;1
1882040;Craft Hero;;20,000 - 50,000;277;52;225;4779;4779;11
1882120;Destinesia;;0 - 20,000;11;0;11;0;0;0
1882140;Decisive Campaigns: Ardennes Offensive;;0 - 20,000;60;8;52;0;0;9
1882160;山海皆可平;;0 - 20,000;40;6;34;0;0;0
1882200;Krek Da Frog;;0 - 20,000;7;2;5;0;0;0
1882230;Rockstar Life;;0 - 20,000;8;3;5;0;0;0
1882240;Forgotten Realms: The Archives - Collection One;;0 - 20,000;97;7;90;14;14;19
1882280;Forgotten Realms: The Archives - Collection Two;;0 - 20,000;103;6;97;0;0;26
1882330;ELEVATED;;0 - 20,000;5;0;5;0;0;0
1882350;Sweet Surge;;0 - 20,000;0;1;-1;0;0;0
1882420;Learn Programming: Python - Remake;;0 - 20,000;16;8;8;0;0;4
1882520;Zombie Shotgun Rampage;;20,000 - 50,000;10;8;2;0;0;0
1882550;MECH PUNK;;0 - 20,000;44;5;39;0;0;1
1882580;FALL GIRLS;;0 - 20,000;80;45;35;3;3;0
1882600;...Knew the Beginning;;0 - 20,000;14;0;14;0;0;0
1882640;Hero for Hire;;0 - 20,000;1;0;1;0;0;0
1882730;Detective Agency 2;;0 - 20,000;0;1;-1;0;0;0
1882780;Space Maxwell: Arcade;;0 - 20,000;0;1;-1;0;0;0
1882820;My Little Dictator;;20,000 - 50,000;16;1;15;0;0;3
1882830;Nuts Protocol;;0 - 20,000;3;0;3;0;0;0
1882930;Mupple;;0 - 20,000;6;1;5;0;0;0
1882960;Lucie's Potager;;0 - 20,000;1;0;1;0;0;0
1883090;The Symbiant;;0 - 20,000;206;2;204;0;0;15
1883110;小艺的异世界冒险-Xiao Yi's strange world adventure;;0 - 20,000;1;0;1;0;0;0
1883220;Herbheim's Mine;;0 - 20,000;0;1;-1;0;0;0
1883230;Clive vs Hives 2;;50,000 - 100,000;2;0;2;0;0;0
1883260;Little Noah: Scion of Paradise;;50,000 - 100,000;1140;53;1087;309;593;24
1883280;Drag Battle Top Fuel;;0 - 20,000;0;4;-4;0;0;0
1883320;剑与桃花 the sword and peachblossom;;0 - 20,000;48;2;46;0;0;0
1883400;The Exodus;;0 - 20,000;3;1;2;0;0;0
1883420;The Oathkeeper;;0 - 20,000;0;1;-1;0;0;0
1883430;Moonfall;;0 - 20,000;1;0;1;0;0;0
1883440;Child of Hope;;0 - 20,000;1;0;1;0;0;0
1883450;The Darkest Road;;0 - 20,000;2;1;1;0;0;0
1883480;Hockey Shooter VR;;0 - 20,000;3;1;2;0;0;0
1883530;SnackHunter;;0 - 20,000;12;0;12;0;0;0
1883570;Supercow;;0 - 20,000;31;0;31;0;0;1
1883580;Cactus Simulator;;0 - 20,000;186;18;168;0;0;7
1883600;Find a way out: Abode of darkness.;;0 - 20,000;2;1;1;0;0;0
1883670;Race On Ice 2022 Pro;;0 - 20,000;4;0;4;0;0;0
1883990;The Hepatica Spring;;0 - 20,000;4;1;3;0;0;0
1884050;Annual Intruders 2.0;;0 - 20,000;2;0;2;0;0;0
1884140;Dungeon Castle;;0 - 20,000;1;1;0;0;0;0
1884160;Tick;;0 - 20,000;4;0;4;0;0;0
1884160;Tick;;0 - 20,000;4;0;4;0;0;0
1884300;Deathsmiles I・II;;0 - 20,000;41;2;39;0;0;0
1884350;CellSar;;0 - 20,000;5;0;5;0;0;0
1884390;Frequency Dissonance;;20,000 - 50,000;22;4;18;0;0;1
1884430;Succubus Girl Story;;0 - 20,000;94;31;63;0;0;0
1884440;Cute Snake;;0 - 20,000;4;0;4;0;0;0
1884450;Unwind;;0 - 20,000;0;3;-3;0;0;0
1884470;Construction Machines SIM: Bridges, buildings and constructor trucks simulator;;0 - 20,000;0;3;-3;0;0;0
1884480;Big Screen Games - Pack 1;;0 - 20,000;3;1;2;0;0;0
1884570;The Gallery;;0 - 20,000;21;10;11;0;0;0
1884650;AstroNOTs;;0 - 20,000;1;0;1;0;0;0
1884720;BOX RUSH;;0 - 20,000;1;1;0;0;0;0
1884800;Omitted;;0 - 20,000;18;21;-3;0;0;0
1884850;Sad Ghouls;;0 - 20,000;14;0;14;0;0;0
1884890;Pieces of Beauty 3;;0 - 20,000;12;0;12;0;0;1
1884960;Chordwatch;;0 - 20,000;5;0;5;0;0;2
1884970;TheDark;;0 - 20,000;0;2;-2;0;0;0
1885010;Hidden Ghost Town 2;;0 - 20,000;12;12;0;0;0;0
1885030;Queen of the flies 蝇后;;0 - 20,000;213;15;198;0;0;0
1885080;Ark Defender;;0 - 20,000;3;0;3;0;0;0
1885090;3D PUZZLE - Modern House;;50,000 - 100,000;17;10;7;0;0;0
1885120;13 Steps;;0 - 20,000;13;0;13;0;0;1
1885130;The Future You've Been Dreaming Of;;0 - 20,000;15;24;-9;0;0;8
1885160;Tumblefire;;0 - 20,000;15;2;13;0;0;1
1885200;Rally: Endless Conquest;;0 - 20,000;25;1;24;0;0;0
1885250;Axiom of Maria;;0 - 20,000;11;0;11;0;0;0
1885480;Fung Guys;;0 - 20,000;6;0;6;0;0;0
1885530;My Kindergarten Learning Adventure;;0 - 20,000;4;0;4;0;0;0
1885540;SEARCH ALL - CATS;;20,000 - 50,000;78;9;69;0;0;0
1885640;Warehouse Simulator: Forklift Driver;;0 - 20,000;30;13;17;0;0;0
1885670;SAOMI;;0 - 20,000;52;1;51;0;0;0
1885690;Virtual Circuit Board;;20,000 - 50,000;132;10;122;86;86;9
1885690;Virtual Circuit Board;;20,000 - 50,000;132;10;122;86;86;9
1885750;Betrayal At Club Low;;20,000 - 50,000;244;7;237;0;0;5
1885820;Putridness;;0 - 20,000;4;6;-2;0;0;0
1885820;Putridness;;0 - 20,000;4;6;-2;0;0;0
1885880;Might of the Stones;;0 - 20,000;3;0;3;0;0;0
1885980;Lost Souls;;0 - 20,000;7;2;5;0;0;0
1886010;Surreal Experience;;0 - 20,000;9;0;9;0;0;0
1886070;Bonding Ambivalence;;0 - 20,000;153;12;141;0;0;6
1886170;The Final Hour;;0 - 20,000;1;4;-3;0;0;0
1886200;Chernobyl Trap;;0 - 20,000;26;10;16;0;0;0
1886290;Slot Shots Pinball Collection;;0 - 20,000;34;1;33;0;0;0
1886320;Healing Simulator;;0 - 20,000;1;0;1;0;0;0
1886370;Labyrinth;;50,000 - 100,000;3;1;2;0;0;0
1886400;Golden Rails: Road To Klondike;;0 - 20,000;18;0;18;0;0;14
1886420;Break It;;0 - 20,000;0;1;-1;0;0;0
1886440;For Runner Night;;0 - 20,000;2;0;2;0;0;0
1886480;Alien Space Bastards;;0 - 20,000;9;0;9;0;0;0
1886600;Trapped in the Forest;;20,000 - 50,000;0;4;-4;0;0;0
1886830;The Legend of The Sacred Stone EX;;50,000 - 100,000;257;15;242;1716;1716;4
1886850;Horror In Valkeala;;0 - 20,000;19;21;-2;0;0;0
1887010;Tiny Football;;0 - 20,000;22;3;19;0;0;0
1887020;Raubritter;;20,000 - 50,000;144;55;89;0;0;7
1887050;Nachkriegsratten Punk-Rock Puzzle;;0 - 20,000;18;0;18;0;0;0
1887150;Anime Girls VS  Soldiers;;0 - 20,000;1;0;1;0;0;0
1887200;Mechaguard;;0 - 20,000;17;6;11;0;0;1
1887250;Sand Castle;;20,000 - 50,000;87;4;83;0;0;0
1887260;Timberman VR ;;0 - 20,000;9;2;7;0;0;0
1887280;Get Off My Space!;;0 - 20,000;0;1;-1;0;0;0
1887360;FACTOR D;;0 - 20,000;9;0;9;0;0;0
1887420;The Lost Oregon City Gold;;0 - 20,000;6;0;6;0;0;0
1887490;Dymension:Scary Horror Survival Shooter;;0 - 20,000;5;8;-3;0;0;0
1887550;TETRIS RTX;;0 - 20,000;12;8;4;0;0;0
1887570;Dragon Battle;;0 - 20,000;1;1;0;0;0;0
1887730;Valley of the Dead: MalnaZidos;;0 - 20,000;4;6;-2;0;0;0
1887960;Shadow of Egypt;;0 - 20,000;20;9;11;0;0;0
1887990;Deep Night Runner;;1,000,000 - 2,000,000;14;2;12;0;0;1
1888000;Bloody Rampage City;;0 - 20,000;11;4;7;0;0;0
1888080;Gaslamp Cases 3: Ancient Secrets;;0 - 20,000;3;1;2;0;0;0
1888100;Cleaning The System;;0 - 20,000;15;0;15;0;0;0
1888120;Tabbellarius;;20,000 - 50,000;1;2;-1;0;0;0
1888130;ALAN-13 Reformation;;20,000 - 50,000;17;3;14;0;0;1
1888200;Skycliffs;;0 - 20,000;3;0;3;0;0;0
1888210;Mini Battle Ground;;0 - 20,000;0;1;-1;0;0;0
1888270;Lazerball;;0 - 20,000;3;0;3;0;0;0
1888440;Frite Medium;;0 - 20,000;6;0;6;0;0;0
1888460;Survive;;0 - 20,000;0;2;-2;0;0;0
1888520;AI Stories;;0 - 20,000;6;0;6;0;0;0
1888590;Rotund Zero;;0 - 20,000;21;0;21;0;0;0
1888620;Save The Bear Cubs;;0 - 20,000;10;3;7;0;0;0
1888660;Mini Pipes - A Logic Puzzle Pipes Game;;0 - 20,000;56;0;56;0;0;0
1888720;Barry of Wrath;;0 - 20,000;18;0;18;0;0;0
1888740;DELAY SIMULATOR / ゲーミングハード技能検定;;0 - 20,000;1;0;1;0;0;0
1888800;SEARCH ALL - CRABS;;0 - 20,000;25;0;25;0;0;0
1888920;Chess vs Chat;;0 - 20,000;2;1;1;0;0;1
1888970;Really Another True;;0 - 20,000;1;1;0;0;0;0
1889000;To Make a Game;;0 - 20,000;51;4;47;0;0;0
1889040;Birth;;0 - 20,000;73;1;72;0;0;62
1889050;Legends And Lore;;0 - 20,000;1;1;0;0;0;0
1889100;Foot Odor Girl;;0 - 20,000;18;15;3;0;0;0
1889120;The Forked Road;;0 - 20,000;7;0;7;0;0;0
1889130;Escape from the 70's;;0 - 20,000;19;8;11;0;0;0
1889200;Ableford;;0 - 20,000;7;2;5;0;0;0
1889320;Timeline;;50,000 - 100,000;23;1;22;0;0;2
1889330;Hypermind;;0 - 20,000;11;5;6;0;0;1
1889440;The Unfamiliar Story of Grandfather's Heritage;;0 - 20,000;4;3;1;0;0;0
1889500;Video Game Tutorial;;50,000 - 100,000;6;2;4;0;0;0
1889620;AI Roguelite;;100,000 - 200,000;152;35;117;0;0;5
1889640;The Backrooms: Survival;;0 - 20,000;765;115;650;517;517;10
1889650;Jigsaw Bestiary;;50,000 - 100,000;25;0;25;0;0;2
1889670;My Destiny;;0 - 20,000;5;1;4;0;0;0
1889760;Maze Of Realities: Flower Of Discord Collector's Edition;;20,000 - 50,000;2;1;1;0;0;0
1889770;BALLYGON;;0 - 20,000;15;2;13;0;0;0
1889790;Chest Mate;;0 - 20,000;11;1;10;0;0;0
1889870;Detective Max - Double Clues;;0 - 20,000;5;1;4;0;0;0
1889930;Baldur's Gate: Dark Alliance II;;50,000 - 100,000;318;86;232;543;543;12
1890000;Fly&Poop;;0 - 20,000;1;0;1;0;0;0
1890010;OOZEscape;;0 - 20,000;10;0;10;0;0;2
1890030;PROJECT : KNIGHT 2 Dusk of Souls;;0 - 20,000;1;1;0;0;0;0
1890120;9-nine-:NewEpisode;;0 - 20,000;277;16;261;0;0;2
1890120;9-nine-:NewEpisode;;0 - 20,000;277;16;261;0;0;2
1890170;An Indie Game a Month: Unreal Journey;;0 - 20,000;2;0;2;0;0;0
1890200;POG 7;;0 - 20,000;3;4;-1;0;0;0
1890280;Athemore;;0 - 20,000;8;0;8;0;0;0
1890340;drowning;;0 - 20,000;10;3;7;0;0;6
1890430;Golden Jetpackman;;0 - 20,000;1;0;1;0;0;0
1890520;Tide Up;;0 - 20,000;161;14;147;0;0;1
1890550;Triga;;0 - 20,000;28;0;28;0;0;0
1890590;SUPER NANARU;;0 - 20,000;23;5;18;0;0;0
1890610;Headpunk: The Comic-Style Battle Chaos;;0 - 20,000;4;2;2;0;0;0
1890680;Milk Girl -Sweet memories of summer;;0 - 20,000;12;13;-1;0;0;1
1890690;Guns and Roses;;0 - 20,000;3;0;3;0;0;0
1890710;Flipstown;;0 - 20,000;18;9;9;0;0;0
1890740;Voice of Cards: The Beasts of Burden;;0 - 20,000;60;12;48;0;0;1
1890810;A Tale of Synapse : The Chaos Theories;;0 - 20,000;2;0;2;0;0;0
1890820;Journey To Destiny;;0 - 20,000;3;0;3;0;0;0
1891010;Expansion Core;;100,000 - 200,000;6;0;6;0;0;0
1891090;Final Vendetta;;0 - 20,000;151;31;120;0;0;2
1891120;Kapital13;;0 - 20,000;0;1;-1;0;0;0
1891140;Tightrope Theatre;;0 - 20,000;21;2;19;0;0;0
1891210;Quest: Escape Dungeon;;0 - 20,000;18;3;15;0;0;1
1891230;Hidden Tavern Top-Down 3D;;0 - 20,000;14;8;6;0;0;0
1891300;Pic Fed Evolution;;0 - 20,000;1;0;1;0;0;0
1891350;WORDLAND - Let's Travel;;0 - 20,000;20;1;19;0;0;0
1891460;I am not legend;;0 - 20,000;1;1;0;0;0;0
1891570;Sokonashi No Me;;0 - 20,000;1;1;0;0;0;0
1891640;AZUR BEAM;;0 - 20,000;95;20;75;0;0;0
1891680;Sel Quinta - The Six City Quest;;0 - 20,000;1;0;1;0;0;0
1891740;Lost Wish: In the desperate world;;0 - 20,000;16;5;11;0;0;0
1891840;Ploc;;0 - 20,000;5;0;5;0;0;0
1891920;Sandream;;0 - 20,000;12;0;12;0;0;0
1891940;Dr. Science quest;;200,000 - 500,000;11;5;6;0;0;1
1892030;Dummynation;;0 - 20,000;247;79;168;0;0;21
1892210;Explosion;;0 - 20,000;3;0;3;0;0;0
1892240;Maze: Pedestal of Trials;;0 - 20,000;3;0;3;0;0;0
1892290;Jumpy Ball Happy Fun Time;;0 - 20,000;4;0;4;0;0;0
1892430;VillageBlade;;20,000 - 50,000;1;1;0;0;0;0
1892450;Bouldering Robot 3D;;0 - 20,000;1;0;1;0;0;0
1892470;王子斗恶龙(The prince fights the Dragon);;0 - 20,000;1;2;-1;0;0;0
1892550;Quad Dice Defence;;0 - 20,000;1;4;-3;0;0;0
1892600;Red Hero Adventure;;0 - 20,000;0;4;-4;0;0;0
1892620;CEO;;0 - 20,000;50;13;37;0;0;3
1892640;Marble Ball Friends;;0 - 20,000;10;5;5;0;0;33
1892670;Coins, Chests and Loot;;0 - 20,000;4;0;4;0;0;0
1892790;Polimines;;0 - 20,000;29;4;25;0;0;0
1892810;Fishy Business;;500,000 - 1,000,000;12;7;5;0;0;0
1892890;Fun Machine;;0 - 20,000;3;0;3;0;0;0
1892950;The Golden Rose: Book One;;0 - 20,000;112;9;103;0;0;3
1893020;Nekomew's Nightmares;;0 - 20,000;31;0;31;0;0;2
1893080;Scare Train VR;;0 - 20,000;6;2;4;0;0;0
1893100;Relics 2: The Crusader's Tomb;;0 - 20,000;7;0;7;0;0;1
1893150;COG Back To The 80s;;0 - 20,000;8;7;1;0;0;0
1893180;SKY JUMP;;0 - 20,000;0;1;-1;0;0;0
1893200;Travelers in Space Crack;;0 - 20,000;11;6;5;0;0;2
1893210;Find The Murderer 2;;50,000 - 100,000;1;0;1;0;0;0
1893300;Planet Collectors: Episode Earth;;0 - 20,000;0;1;-1;0;0;0
1893310;Steel Shell;;0 - 20,000;10;19;-9;0;0;0
1893330;Zadel Princess;;0 - 20,000;10;6;4;0;0;2
1893460;Pick The Lock;;0 - 20,000;9;5;4;0;0;0
1893490;Razed Earth;;0 - 20,000;1;1;0;0;0;0
1893530;Call of Senpai: Waifu Warfare 2;;0 - 20,000;7;22;-15;0;0;1
1893590;Cat Follow Me;;0 - 20,000;4;1;3;0;0;0
1893600;Smashball;;0 - 20,000;2;0;2;0;0;0
1893620;Circadian Dice;;20,000 - 50,000;422;21;401;0;0;11
1893880;Wormhole;;0 - 20,000;13;0;13;0;0;0
1893890;Skedaddle Out The Dungeon;;0 - 20,000;1;0;1;0;0;0
1893940;SynthWaves;;0 - 20,000;3;2;1;0;0;0
1893950;One Life;;0 - 20,000;3;0;3;0;0;0
1894210;Let's go to the moon;;0 - 20,000;1;0;1;0;0;0
1894220;Square;;0 - 20,000;16;2;14;0;0;0
1894230;Afterlife Work;;0 - 20,000;50;36;14;0;0;0
1894240;Chicken Coop;;0 - 20,000;10;2;8;0;0;0
1894250;Garden Madness;;0 - 20,000;0;2;-2;0;0;0
1894310;Penguin Hunting;;0 - 20,000;3;9;-6;0;0;0
1894320;Dr. Professor Scientist's Weapons Testing Facility;;20,000 - 50,000;61;9;52;0;0;1
1894430;Plan B: Terraform;;50,000 - 100,000;441;49;392;86;154;1784
1894450;11 Islands 2: Story of Love;;0 - 20,000;6;1;5;0;0;0
1894550;Facility 386;;0 - 20,000;2;0;2;0;0;0
1894650;Music Thief;;0 - 20,000;1;3;-2;0;0;0
1894730;Asterix & Obelix XXXL : The Ram From Hibernia;;20,000 - 50,000;4;12;-8;0;0;1
1894760;SnakeGame;;50,000 - 100,000;17;6;11;0;0;0
1894770;Bloody Forest;;50,000 - 100,000;5;11;-6;0;0;0
1894940;zomboDRIVE: Apocalyptic Road Trip;;0 - 20,000;1;3;-2;0;0;0
1894980;costrutto;;0 - 20,000;2;1;1;0;0;0
1894990;I NEED A NAME;;20,000 - 50,000;9;5;4;0;0;0
1895040;Avatar Raiders;;0 - 20,000;7;0;7;0;0;1
1895080;Zombie City;;0 - 20,000;2;3;-1;0;0;0
1895220;Horrors of the North;;0 - 20,000;1;2;-1;0;0;0
1895230;SUPER RUNNER VR;;0 - 20,000;1;9;-8;0;0;0
1895270;TRICK SHOT;;0 - 20,000;1;0;1;0;0;0
1895280;MacShot;;0 - 20,000;3;0;3;0;0;1
1895410;Desktop Mars;;0 - 20,000;30;6;24;0;0;6
1895540;1001 Jigsaw Legends of Mystery 3;;0 - 20,000;2;2;0;0;0;0
1895550;1001 Jigsaw Detective 2;;0 - 20,000;1;1;0;0;0;0
1895560;1001 Black Raven Jigsaw;;0 - 20,000;4;2;2;0;0;0
1895630;VRM Posing Desktop;;0 - 20,000;103;3;100;0;0;23
1895640;I Love Finding Critters;;0 - 20,000;9;0;9;0;0;0
1895650;Crupt;;0 - 20,000;3;0;3;0;0;1
1895760;Coral Drive;;0 - 20,000;6;1;5;0;0;0
1895860;Monster Girls and the Mysterious Adventure 2;;0 - 20,000;202;15;187;0;0;93
1895870;Pusher;;0 - 20,000;1;0;1;0;0;0
1895890;9 Childs Street;;0 - 20,000;72;2;70;0;0;23
1895950;Doki Doki House;;0 - 20,000;12;2;10;0;0;1
1896140;RoguePG;;0 - 20,000;4;1;3;0;0;0
1896160;Warplan Pacific;;0 - 20,000;48;4;44;0;0;3
1896190;Apocalyptic;;20,000 - 50,000;1;1;0;0;0;0
1896420;The Ghost Ship;;0 - 20,000;4;4;0;0;0;0
1896510;Nova Slash: Unparalleled Power;;0 - 20,000;4;0;4;0;0;0
1896530;Foreign Dreams;;0 - 20,000;1;0;1;0;0;0
1896610;Edge of Reality: Lost Secrets of the Forest Collector's Edition;;0 - 20,000;4;1;3;0;0;0
1896630;Everplast;;0 - 20,000;5;0;5;0;0;0
1896700;Wylde Flowers;;0 - 20,000;637;18;619;2208;2208;121
1896720;Dumb Little Robots;;0 - 20,000;3;0;3;0;0;0
1896810;Still be a Human;;0 - 20,000;20;2;18;0;0;1
1896820;JUNGLE RUNNER;;0 - 20,000;13;4;9;0;0;0
1896880;Dungeons of Dreadrock;;0 - 20,000;201;9;192;0;0;1
1896920;Magic crystals;;0 - 20,000;9;5;4;0;0;0
1896930;Elephant's Graveyard;;0 - 20,000;6;0;6;0;0;0
1896980;The Chronicles of Hercules II - Wrath of Kronos;;0 - 20,000;5;1;4;0;0;0
1897000;Pow! 2;;0 - 20,000;17;0;17;0;0;0
1897050;VARIOUS DAYLIFE;;0 - 20,000;30;46;-16;0;0;6
1897140;Vacuum Ball;;20,000 - 50,000;7;1;6;0;0;0
1897150;Brothers;;0 - 20,000;14;0;14;0;0;0
1897250;The Sword of Rhivenia;;0 - 20,000;38;16;22;0;0;3
1897320;Garden Guardian;;0 - 20,000;35;1;34;0;0;0
1897330;Helga the Viking Warrior;;0 - 20,000;3;4;-1;0;0;1
1897340;Innocence Island;;0 - 20,000;2;1;1;0;0;0
1897350;THE NEW CHRONICLES OF NOAH'S ARK;;0 - 20,000;5;1;4;0;0;0
1897380;Zemblanity;;0 - 20,000;54;6;48;0;0;0
1897400;Master Show VR;;0 - 20,000;3;0;3;0;0;0
1897410;The Thief;;20,000 - 50,000;1;6;-5;0;0;0
1897420;Radio Free Europa;;20,000 - 50,000;4;0;4;0;0;0
1897430;Obsessive Revenge;;0 - 20,000;0;4;-4;0;0;0
1897460;DANGER OF LOSS;;0 - 20,000;10;5;5;0;0;0
1897510;LAETUS.;;0 - 20,000;1;0;1;0;0;0
1897520;Behind Border Zone;;0 - 20,000;0;2;-2;0;0;0
1897540;Valkalim;;0 - 20,000;1;0;1;0;0;0
1897570;Visualis Dynamics;;0 - 20,000;1;0;1;0;0;0
1897580;SEARCH ALL - RUNES;;50,000 - 100,000;21;1;20;0;0;0
1897600;Dungeon Blocks;;0 - 20,000;1;1;0;0;0;0
1897630;Garbage Pail Kids: Mad Mike and the Quest for Stale Gum;;0 - 20,000;18;0;18;0;0;0
1897680;ToyCar;;0 - 20,000;10;0;10;0;0;0
1897740;Chrono Survival;;0 - 20,000;54;16;38;0;0;5
1897970;Mini Island: Aroma;;0 - 20,000;6;0;6;0;0;0
1897980;Project:Sphere;;0 - 20,000;1;0;1;0;0;0
1897990;Lulu Way;;0 - 20,000;1;0;1;0;0;0
1898050;Buried;;0 - 20,000;1;0;1;0;0;0
1898100;Initium Legenda;;0 - 20,000;0;1;-1;0;0;0
1898290;LEGO Bricktales;;20,000 - 50,000;428;37;391;946;946;20
1898410;Ruins & Switch;;0 - 20,000;2;0;2;0;0;0
1898420;ENDGAME: Survival;;0 - 20,000;17;17;0;0;0;2
1898430;HORDE Survival;;0 - 20,000;8;17;-9;0;0;7
1898530;Battle Support (mini game);;0 - 20,000;1;0;1;0;0;0
1898550;Brutal Rifters;;50,000 - 100,000;1;0;1;0;0;0
1898560;Pillars of Light;;0 - 20,000;17;0;17;0;0;0
1898570;Square Knight;;0 - 20,000;8;0;8;0;0;0
1898610;Hands of Necromancy;;0 - 20,000;81;7;74;0;0;0
1898640;Dark Journey;;0 - 20,000;18;20;-2;0;0;0
1898670;All the Words She Wrote;;0 - 20,000;25;1;24;0;0;1
1898790;A Crown of Sorcery and Steel;;0 - 20,000;10;6;4;0;0;19
1898830;VBridger;;0 - 20,000;27;9;18;0;0;67
1898860;whale.;;0 - 20,000;13;1;12;0;0;0
1898950;O.D.T.: Escape... Or Die Trying;;0 - 20,000;3;2;1;0;0;0
1898970;HYDE;;0 - 20,000;5;1;4;0;0;0
1898990;Jigsaw Pink;;0 - 20,000;15;1;14;0;0;0
1899150;灵异爱情.冷;;0 - 20,000;1;0;1;0;0;0
1899180;Night Of Disturbance;;0 - 20,000;2;3;-1;0;0;0
1899200;Bombardier;;0 - 20,000;6;1;5;0;0;0
1899240;一个极好的剪贴板;;0 - 20,000;5;1;4;0;0;1
1899270;Battle of Finland: Winter War;;0 - 20,000;9;1;8;0;0;0
1899290;Gems of Destiny: Homeless Dwarf;;0 - 20,000;9;2;7;0;0;2
1899370;3D将棋;;0 - 20,000;0;1;-1;0;0;0
1899400;Rolling in the Maze;;50,000 - 100,000;457;112;345;15;16;2
1899430;VEREDA - Mystery Escape Room Adventure;;0 - 20,000;22;7;15;0;0;0
1899450;Z-Rush Survival;;0 - 20,000;0;2;-2;0;0;0
1899620;Outdoor Adventures With Marisa Kirisame;;0 - 20,000;73;2;71;0;0;3
1899800;Raisond'etre;;0 - 20,000;32;2;30;0;0;1
1899810;Dread X Collection 5;;20,000 - 50,000;164;30;134;251;251;2
1899950;Dolmenjord - Viking Islands;;0 - 20,000;42;3;39;0;0;1
1899990;GEHENA;;0 - 20,000;5;2;3;0;0;0
1900020;PunjiVR;;0 - 20,000;35;8;27;0;0;0
1900070;Battle for the Droid Station;;0 - 20,000;7;2;5;0;0;0
1900230;Vetrex;;0 - 20,000;6;0;6;0;0;0
1900280;Just Ignore Them: Brea's Story Tape 1;;20,000 - 50,000;39;5;34;0;0;0
1900300;The Bad Son;;0 - 20,000;12;1;11;0;0;0
1900340;Ten Trials of Babel: The Doppelganger Maze;;100,000 - 200,000;2689;204;2485;975;975;31
1900400;Mixed Feelings: While You Were Away - Boys Love (BL) Visual Novel;;0 - 20,000;13;0;13;0;0;1
1900520;Hyperstrix;;0 - 20,000;3;0;3;0;0;0
1900650;A Night With Gigsjaw VR;;0 - 20,000;3;1;2;0;0;0
1900680;Mystery Solitaire. Grimm's Tales 4;;0 - 20,000;1;0;1;0;0;1
1900690;Mystery Solitaire. The Black Raven 2;;0 - 20,000;6;2;4;0;0;2
1900720;For The Fatherland;;0 - 20,000;8;1;7;0;0;0
1900790;Exorzine;;0 - 20,000;2;2;0;0;0;0
1900820;Mighty Castles;;0 - 20,000;3;3;0;0;0;0
1900860;Diamon Jones and the Amulet of the World;;0 - 20,000;3;0;3;0;0;0
1900930;DANGO!;;0 - 20,000;115;93;22;0;0;0
1900970;The Red Hood;;0 - 20,000;31;17;14;0;0;1
1901010;Blob Boy;;0 - 20,000;4;0;4;0;0;0
1901030;Dungeon Reels Tactics;;0 - 20,000;24;4;20;0;0;2
1901050;Jack Saves Easter;;0 - 20,000;2;0;2;0;0;0
1901060;Dungeon Dueler;;0 - 20,000;0;4;-4;0;0;0
1901090;World of Retailing;;0 - 20,000;2;2;0;0;0;0
1901170;Galactoids - Galactic Invaders;;0 - 20,000;2;0;2;0;0;0
1901180;Aster Force;;0 - 20,000;4;0;4;0;0;0
1901340;Ero Manager;;0 - 20,000;233;19;214;35;61;3
1901360;Space;;0 - 20,000;0;1;-1;0;0;0
1901370;Ib;;50,000 - 100,000;2202;18;2184;285;480;25
1901380;Goddess Of War Ashley Ⅱ;;0 - 20,000;15;4;11;0;0;0
1901510;Zombies ate my dog;;0 - 20,000;14;9;5;0;0;0
1901560;Rescue Team: Heist of the Century;;0 - 20,000;12;2;10;0;0;2
1901580;Fireworks Show VR;;0 - 20,000;2;3;-1;0;0;0
1901730;Lootbox RPG;;0 - 20,000;3;1;2;0;0;0
1901740;SworLd;;0 - 20,000;1;0;1;0;0;0
1901780;Routine Feat;;0 - 20,000;41;8;33;0;0;0
1901830;SønderDø;;0 - 20,000;3;0;3;0;0;0
1901870;BadTrip:Survival Horror Shooter;;0 - 20,000;4;10;-6;0;0;0
1901950;Raid on Taihoku;;0 - 20,000;70;12;58;0;0;21
1901970;One Step After Fall;;0 - 20,000;22;4;18;0;0;0
1901990;Machine Gun Fury;;0 - 20,000;10;0;10;0;0;0
1902040;Escape To School;;0 - 20,000;4;0;4;0;0;0
1902050;the DEEP LOST;;0 - 20,000;15;9;6;0;0;0
1902110;Rising Sun VR;;0 - 20,000;2;0;2;0;0;0
1902120;Bigfield 2042;;20,000 - 50,000;43;19;24;0;0;0
1902150;STRANGER;;0 - 20,000;38;11;27;0;0;0
1902200;Scorpion Overdrive;;0 - 20,000;0;1;-1;0;0;0
1902210;Hidden Floating City Top-Down 3D;;0 - 20,000;12;7;5;0;0;0
1902230;Soulbaby: Remastered;;0 - 20,000;2;0;2;0;0;0
1902240;Furry Hentai Quest;;0 - 20,000;11;0;11;0;0;1
1902260;Hidden Western;;0 - 20,000;10;23;-13;0;0;0
1902290;Run Away SkyDancer;;0 - 20,000;10;0;10;0;0;0
1902350;Polar Bear Riding A Ninja;;0 - 20,000;8;0;8;0;0;0
1902650;Come See My Hole;;0 - 20,000;117;7;110;0;0;0
1902710;Weird RPG;;100,000 - 200,000;2754;154;2600;260;221;146
1902730;The Pathema 疫途;;0 - 20,000;2;0;2;0;0;0
1902750;PIPELINE RTX;;0 - 20,000;15;8;7;0;0;0
1902790;刻印战记：冰冻之剑 RE;;20,000 - 50,000;99;28;71;0;0;5
1902820;Virtual AI - Lily;;0 - 20,000;9;2;7;0;0;0
1902830;Night Racer;;0 - 20,000;23;4;19;0;0;0
1902850;Dreams in the Witch House;;0 - 20,000;25;0;25;0;0;27
1902900;The Eternal Battlefields;;0 - 20,000;1;2;-1;0;0;0
1903080;Sharing Lights;;0 - 20,000;14;1;13;0;0;0
1903130;HellFull - The Last Hope;;0 - 20,000;3;0;3;0;0;0
1903170;The Quest For Excalibur - Puy Du Fou;;0 - 20,000;2;1;1;0;0;0
1903200;Foreign Galaxies;;0 - 20,000;10;3;7;0;0;0
1903220;Paint To Pixel;;20,000 - 50,000;1;1;0;0;0;0
1903280;Heroes of The Sacred Tree;;20,000 - 50,000;1;0;1;0;0;0
1903330;The Giant of Torridge Island;;0 - 20,000;1;2;-1;0;0;0
1903360;Amazing Girl;;0 - 20,000;1;3;-2;0;0;0
1903400;Bicycle Rider Simulator;;0 - 20,000;21;12;9;0;0;0
1903420;Undeads vs Humans;;0 - 20,000;5;0;5;0;0;0
1903480;Banana Hunter;;50,000 - 100,000;16;2;14;0;0;0
1903490;Crabby Beach;;100,000 - 200,000;10;4;6;0;0;0
1903530;Heart attack;;0 - 20,000;74;27;47;0;0;0
1903540;The Nightmare Inside;;0 - 20,000;18;6;12;0;0;0
1903590;了不起的棋盘;;0 - 20,000;2;1;1;0;0;0
1903600;Zombie VS Police;;0 - 20,000;13;8;5;0;0;1
1903630;Evasion from Hell;;0 - 20,000;32;3;29;0;0;0
1903690;Princess Pyro;;0 - 20,000;3;0;3;0;0;0
1903720;With Good Intentions;;20,000 - 50,000;19;9;10;0;0;0
1903720;With Good Intentions;;20,000 - 50,000;19;9;10;0;0;0
1903730;IT Simulator;;0 - 20,000;80;8;72;0;0;2
1903770;Koni: The Secrets of Castle;;0 - 20,000;15;0;15;0;0;0
1903780;Blood Camp;;0 - 20,000;11;25;-14;0;0;0
1903810;Alley Twitch Bot;;0 - 20,000;6;3;3;0;0;0
1903830;Jessica Mysterious Journey;;0 - 20,000;0;1;-1;0;0;0
1903970;World Championship Boxing Manager 2;;0 - 20,000;27;11;16;0;0;4
1904030;Maze Dungeon;;0 - 20,000;2;0;2;0;0;0
1904040;Fantasy Fishing Town;;0 - 20,000;47;7;40;0;0;0
1904160;Trainz Plus;;50,000 - 100,000;23;9;14;0;0;21
1904220;我死后的那些天-After Death;;20,000 - 50,000;4;1;3;0;0;0
1904260;Anime Manga Style Girl - Color By Number Pixel Art Coloring;;0 - 20,000;1;0;1;0;0;0
1904280;Feartress;;0 - 20,000;24;21;3;0;0;97
1904310;Go Ace It;;20,000 - 50,000;1;0;1;0;0;0
1904320;Animaddicts 2;;0 - 20,000;0;1;-1;0;0;0
1904330;The Tribe Game;;0 - 20,000;22;6;16;0;0;10
1904400;My Pet Rock;;0 - 20,000;7;0;7;0;0;0
1904530;Forgotten Realms: The Archives - Collection Three;;0 - 20,000;20;2;18;0;0;4
1904540;Football Manager 2023;;200,000 - 500,000;8227;1245;6982;7268;5072;65996
1904560;Dungeons & Dragons: Ravenloft Series;;0 - 20,000;22;2;20;0;0;3
1904580;Dungeons & Dragons: Dark Sun Series;;0 - 20,000;22;4;18;6;6;3
1904590;Project Medved;;0 - 20,000;15;1;14;0;0;0
1904610;Dungeons & Dragons: Krynn Series;;0 - 20,000;54;3;51;0;0;29
1904640;Dungeons & Dragons - Al-Qadim: The Genie's Curse;;0 - 20,000;9;0;9;0;0;0
1904650;Dungeons & Dragons - Stronghold: Kingdom Simulator;;0 - 20,000;20;2;18;0;0;2
1904730;Adventure Academia: The Fractured Continent;;0 - 20,000;10;25;-15;0;0;1
1904860;Legends of Kingdom Rush;;50,000 - 100,000;611;308;303;1178;1178;27
1905000;SimVoiceAssistant;;0 - 20,000;6;0;6;0;0;1
1905050;Clocknockers 2;;0 - 20,000;1;2;-1;0;0;0
1905080;FireSquad;;0 - 20,000;2;1;1;0;0;0
1905110;Fantasylandia World;;0 - 20,000;0;4;-4;0;0;0
1905230;Hinter;;0 - 20,000;3;3;0;0;0;0
1905230;Hinter;;0 - 20,000;3;3;0;0;0;0
1905260;Mini Gardens - Logic Puzzle;;0 - 20,000;0;0;0;0;0;1
1905270;Aery - A New Frontier;;0 - 20,000;52;0;52;0;0;0
1905310;Wordies;;0 - 20,000;4;0;4;0;0;0
1905350;Skullnight;;0 - 20,000;39;29;10;0;0;0
1905430;Gravitar: Recharged;;0 - 20,000;23;1;22;0;0;0
1905940;Painting VR;;0 - 20,000;33;10;23;8;8;0
1906000;Popplings;;0 - 20,000;5;1;4;0;0;0
1906020;Drums Rock;;0 - 20,000;147;6;141;32;32;1
1906050;Dragon Map Maker;;0 - 20,000;4;0;4;0;0;7
1906110;Chaos Girl;;0 - 20,000;10;1;9;0;0;0
1906130;Yum Collector;;0 - 20,000;21;2;19;0;0;0
1906140;SEARCH ALL - BERRIES;;0 - 20,000;44;5;39;0;0;0
1906150;Pixel Trouble;;100,000 - 200,000;13;2;11;0;0;2
1906160;Sprout Lands;;0 - 20,000;14;9;5;0;0;0
1906180;Memory Traces: Japan;;0 - 20,000;55;4;51;0;0;1
1906250;Instant Artist: Puzzle Mashup;;0 - 20,000;15;3;12;0;0;0
1906320;Arena Drift Master;;0 - 20,000;10;5;5;0;0;0
1906400;Kedama's Adventure;;0 - 20,000;14;0;14;0;0;0
1906410;Battle 19XX;;0 - 20,000;0;2;-2;0;0;0
1906540;Lofi Hollow;;0 - 20,000;3;1;2;0;0;0
1906660;SOF - Spirits Of Freedom;;0 - 20,000;2;0;2;0;0;0
1906670;Chimeras: Mark of Death Collector's Edition;;20,000 - 50,000;1;0;1;0;0;1
1906680;Surface: Strings of Fate Collector's Edition;;0 - 20,000;0;1;-1;0;0;0
1906680;Surface: Strings of Fate Collector's Edition;;0 - 20,000;0;1;-1;0;0;0
1906750;Roly Poly;;0 - 20,000;4;0;4;0;0;0
1906800;Legend of Radiance;;0 - 20,000;9;0;9;0;0;0
1906860;Path to Ruin;;0 - 20,000;6;0;6;0;0;0
1906870;烈山海前传之黑帝君临;;20,000 - 50,000;11;1;10;0;0;2
1906890;Jump Like An Egyptian;;0 - 20,000;1;0;1;0;0;0
1906910;BeatNClean;;0 - 20,000;2;4;-2;0;0;0
1907000;Gloomgrave;;0 - 20,000;99;9;90;0;0;1
1907020;Nea Edem;;20,000 - 50,000;2;1;1;0;0;0
1907070;Rock Snake;;0 - 20,000;14;4;10;0;0;0
1907140;Dungeon: Faster & Deadlier;;0 - 20,000;34;5;29;0;0;2
1907150;Barbarous 2 - Tavern Wars;;0 - 20,000;11;0;11;0;0;2
1907230;An Uninvited Guest;;0 - 20,000;16;1;15;0;0;1
1907280;Collab Ball;;0 - 20,000;10;0;10;0;0;0
1907290;Pathogen;;0 - 20,000;1;0;1;0;0;0
1907380;Arcane Vale;;0 - 20,000;88;10;78;0;0;7
1907420;SEARCH ALL - MUSHROOMS;;0 - 20,000;27;1;26;0;0;1
1907440;Super Lone Survivor;;0 - 20,000;37;2;35;0;0;0
1907620;Gamma Space;;0 - 20,000;1;1;0;0;0;0
1907640;Lost in Place;;0 - 20,000;2;0;2;0;0;0
1907690;DungeonSlime;;0 - 20,000;4;5;-1;0;0;0
1907720;Autonauts vs Piratebots;;20,000 - 50,000;270;39;231;257;257;18
1907820;Sokobear: Cave;;0 - 20,000;2;0;2;0;0;0
1907900;Halftime Heroes;;20,000 - 50,000;196;66;130;0;0;1
1908200;VHS PLATFORM: 2D;;0 - 20,000;2;1;1;0;0;0
1908220;Adventure Trip: Wonders of the World;;0 - 20,000;2;0;2;0;0;1
1908250;雪之本境S Conspiracy Field: Snow Trap;;20,000 - 50,000;343;82;261;0;0;1
1908320;物质与魔法;;0 - 20,000;17;9;8;0;0;40
1908330;Swift Attack;;0 - 20,000;0;2;-2;0;0;0
1908430;Pipe connect;;0 - 20,000;11;0;11;0;0;0
1908460;Dead Profit;;0 - 20,000;10;7;3;0;0;3
1908500;RUNES Magica;;0 - 20,000;13;3;10;0;0;4
1908560;Hungry Zombies;;0 - 20,000;2;0;2;0;0;0
1908640;NeonHAT;;0 - 20,000;4;1;3;0;0;0
1908650;Blastocitos;;50,000 - 100,000;12;2;10;0;0;0
1908650;Blastocitos;;50,000 - 100,000;12;2;10;0;0;0
1908660;Lollipop Knight;;0 - 20,000;2;1;1;0;0;0
1908680;SEARCH ALL - CACTUSES;;0 - 20,000;27;1;26;0;0;0
1908740;Poly Puzzle: Birds;;0 - 20,000;3;2;1;0;0;0
1908850;Quick Words;;0 - 20,000;13;0;13;0;0;0
1908900;RogueClick;;0 - 20,000;9;7;2;0;0;0
1909020;三国記II;;0 - 20,000;19;2;17;0;0;3
1909030;Planet after us;;0 - 20,000;1;0;1;0;0;0
1909080;Polychromia;;0 - 20,000;4;0;4;0;0;0
1909090;Kapellmeister;;0 - 20,000;13;2;11;0;0;0
1909150;Yosemite Forest Ranger;;0 - 20,000;9;1;8;0;0;1
1909170;Alien Decimation;;0 - 20,000;3;0;3;0;0;0
1909170;Alien Decimation;;0 - 20,000;3;0;3;0;0;0
1909220;Movie Quest;;0 - 20,000;55;3;52;0;0;0
1909260;Looping Bravery;;0 - 20,000;11;0;11;0;0;1
1909330;SEARCH ALL - SPIDERS;;0 - 20,000;45;2;43;0;0;0
1909370;Just Power: The Papal States;;20,000 - 50,000;4;7;-3;0;0;0
1909420;Tinyfolks;;50,000 - 100,000;744;36;708;177;177;11
1909430;Story of You: The Allied Kingdoms;;0 - 20,000;5;1;4;0;0;0
1909560;Mission Twentyeight;;0 - 20,000;2;0;2;0;0;0
1909670;Tegridy Puzzles;;0 - 20,000;1;2;-1;0;0;0
1909740;Starchild Velta and loadtosky;;0 - 20,000;0;1;-1;0;0;0
1909770;Aim Climb;;0 - 20,000;168;20;148;96;96;1
1909810;Seventh Lair;;0 - 20,000;194;10;184;0;0;0
1909820;ALTAIR BREAKER;;0 - 20,000;32;17;15;0;0;0
1909830;1001 Jigsaw Castles And Palaces 2;;0 - 20,000;1;2;-1;0;0;0
1910020;Pretty Girls Four Kings Solitaire;;0 - 20,000;15;3;12;0;0;0
1910080;Super Ate in Wonderland;;0 - 20,000;1;0;1;0;0;0
1910180;Ghosts of Hollow Creek;;0 - 20,000;4;1;3;0;0;0
1910230;Spirit of Shotgun;;0 - 20,000;12;0;12;0;0;0
1910240;The Finnish War;;0 - 20,000;3;1;2;0;0;0
1910250;Fists of Stone;;0 - 20,000;1;0;1;0;0;0
1910260;Geballer;;0 - 20,000;39;0;39;0;0;0
1910300;JoJo Siwa: Worldwide Party;;0 - 20,000;3;1;2;0;0;0
1910320;TAPE: Unveil the Memories;;0 - 20,000;63;1;62;0;0;0
1910360;Burial Stone;;0 - 20,000;10;1;9;0;0;0
1910490;A2 Zygon;;20,000 - 50,000;6;0;6;0;0;0
1910560;THE UNKNOWN HALLS;;0 - 20,000;3;1;2;0;0;0
1910560;THE UNKNOWN HALLS;;0 - 20,000;3;1;2;0;0;0
1910590;Ganbaru;;0 - 20,000;6;0;6;0;0;0
1910610;Pixel Artist;;0 - 20,000;15;2;13;0;0;1
1910630;Empty War;;0 - 20,000;1;0;1;0;0;0
1910680;Orb of Creation;;20,000 - 50,000;657;46;611;15337;15337;44
1910740;Perfect Ball;;0 - 20,000;3;0;3;0;0;0
1910750;TIME TO HUNT;;0 - 20,000;5;4;1;0;0;3
1910790;Lunar Mirror;;20,000 - 50,000;533;68;465;242;242;34
1910790;Lunar Mirror;;20,000 - 50,000;533;68;465;242;242;34
1910820;Bacterial edge;;0 - 20,000;8;7;1;0;0;0
1910830;Cruise Ship Horse Racing;;0 - 20,000;1;1;0;0;0;0
1910890;Hacking for Hermann;;0 - 20,000;3;0;3;0;0;0
1911010;Voxel Digger;;0 - 20,000;2;1;1;0;0;0
1911050;Reversilly;;0 - 20,000;5;0;5;0;0;0
1911090;Meliora;;20,000 - 50,000;3;0;3;0;0;0
1911170;Chronescher;;0 - 20,000;32;2;30;0;0;2
1911230;Lockout Tagout (LOTO) VR Training;;0 - 20,000;0;1;-1;0;0;0
1911390;Knightfall: A Daring Journey;;100,000 - 200,000;4931;543;4388;93;43;5
1911400;Blink God;;0 - 20,000;1;1;0;0;0;0
1911420;Search and Rescue;;20,000 - 50,000;2;0;2;0;0;0
1911510;Stone Protectors;;0 - 20,000;3;1;2;0;0;0
1911530;Armored Firestorm;;0 - 20,000;10;1;9;0;0;0
1911560;Class Escape;;20,000 - 50,000;45;2;43;0;0;1
1911600;Lost Alone Ep.3 - Nonnina;;20,000 - 50,000;20;3;17;0;0;0
1911640;Mana Chess;;50,000 - 100,000;2;0;2;0;0;0
1911780;Lost Fleet;;0 - 20,000;18;15;3;0;0;3
1911800;Atari Mania;;0 - 20,000;15;9;6;0;0;1
1911900;OverNight;;0 - 20,000;8;10;-2;0;0;0
1911960;DarkSpar;;0 - 20,000;11;9;2;0;0;9
1912140;The Dreamland;;0 - 20,000;2;4;-2;0;0;0
1912190;VR Mini World Roller Coaster;;0 - 20,000;1;2;-1;0;0;0
1912230;HARDDRIVE;;0 - 20,000;4;2;2;0;0;0
1912330;12 Labours of Hercules XIV: Message in a Bottle;;0 - 20,000;5;0;5;0;0;2
1912380;Soccer Story;;0 - 20,000;47;37;10;0;0;3
1912480;Vacant Planet;;0 - 20,000;4;5;-1;0;0;0
1912490;Koncolos;;0 - 20,000;17;4;13;0;0;0
1912500;ISOLATE;;0 - 20,000;35;2;33;0;0;0
1912510;Anicon - Animal Complex - Party;;0 - 20,000;1;0;1;0;0;0
1912560;Super Gosu Cars;;0 - 20,000;3;0;3;0;0;0
1912590;vision\memory\maze;;0 - 20,000;2;8;-6;0;0;0
1912630;Champs TD;;0 - 20,000;22;8;14;0;0;1
1912660;Dotto Botto;;0 - 20,000;2;0;2;0;0;0
1912700;3D PUZZLE - Wood House;;0 - 20,000;13;21;-8;0;0;0
1912710;Hidden Post-Apocalyptic Top-Down 3D;;0 - 20,000;13;10;3;0;0;0
1912770;Zombie Crush Driver;;0 - 20,000;13;6;7;0;0;0
1912870;Inyoku Shoujo;;0 - 20,000;2;5;-3;0;0;0
1912880;DRUNKKNIGHT;;0 - 20,000;15;6;9;0;0;0
1912900;Maximum Velocity;;100,000 - 200,000;3;1;2;0;0;1
1912930;Cursed Blood;;0 - 20,000;14;13;1;0;0;0
1912970;Late photographer 3;;0 - 20,000;23;11;12;0;0;0
1913160;COPS 2170 The Power of Law;;0 - 20,000;4;0;4;0;0;0
1913190;Paranormal Motel;;20,000 - 50,000;13;15;-2;0;0;0
1913200;Mark's Magnificent Marble Maze;;0 - 20,000;17;2;15;0;0;0
1913220;Back 2 School;;0 - 20,000;3;0;3;0;0;0
1913320;Cat Adventure 2;;0 - 20,000;19;7;12;0;0;0
1913360;Frog Fall Down;;20,000 - 50,000;12;2;10;0;0;1
1913490;Adorable Witch 3;;0 - 20,000;400;61;339;13;24;1
1913530;DopeMine Arena;;0 - 20,000;4;4;0;0;0;0
1913620;Puzzle Bobble2X/BUST-A-MOVE2 Arcade Edition & Puzzle Bobble3/BUST-A-MOVE3 S-Tribute;;0 - 20,000;8;6;2;0;0;3
1913670;Metal Black S-Tribute;;0 - 20,000;10;2;8;0;0;3
1913680;Elevator Action -Returns- S-Tribute;;0 - 20,000;24;3;21;0;0;1
1913690;Cleopatra Fortune S-Tribute;;0 - 20,000;9;0;9;0;0;1
1913810;Beastmaster;;0 - 20,000;1;6;-5;0;0;0
1913940;Underground Dungeon;;0 - 20,000;8;1;7;0;0;0
1913970;PSYCHO;;0 - 20,000;26;7;19;0;0;0
1914140;Orkhon Inscriptions Mongolia VR;;0 - 20,000;2;1;1;0;0;0
1914190;Sharp Trouble;;0 - 20,000;9;2;7;0;0;4
1914200;Cosmoblaster Exodia;;0 - 20,000;9;1;8;0;0;4
1914240;Scapegoat;;0 - 20,000;2;0;2;0;0;0
1914270;Ultimate Super Bean;;0 - 20,000;7;1;6;0;0;0
1914460;Ancient Medieval Empire;;0 - 20,000;4;2;2;0;0;0
1914580;Spirit Hunters: Infinite Horde;;100,000 - 200,000;854;274;580;1217;1474;147
1914630;Draft Day Sports: College Basketball 2022;;0 - 20,000;12;5;7;0;0;19
1914700;Elteria Hunter;;20,000 - 50,000;1;1;0;0;0;0
1914740;A HERO AND A GARDEN;;0 - 20,000;46;2;44;0;0;1
1914750;Resist;;0 - 20,000;32;7;25;0;0;0
1914770;TumbleWeed;;0 - 20,000;8;0;8;0;0;0
1914790;R'lyeh;;50,000 - 100,000;5;1;4;0;0;0
1914900;Dragons On Desktop;;0 - 20,000;13;0;13;0;0;1
1914970;Help Me Remember, Satori-sama!;;50,000 - 100,000;544;48;496;141;141;2
1914980;Golfing In Aether;;0 - 20,000;7;1;6;0;0;0
1915160;Night Blood : Avenger's Tide;;0 - 20,000;11;2;9;0;0;0
1915170;Four Winds Fantasy;;0 - 20,000;6;0;6;0;0;0
1915210;The Mensional;;0 - 20,000;48;4;44;0;0;1
1915240;Sparkle Milla: Eight Genetic Abnormalities and a Blood Ghost;;0 - 20,000;17;1;16;0;0;12
1915330;The Castle Of Time;;0 - 20,000;1;1;0;0;0;0
1915410;Arachnophobia;;0 - 20,000;0;15;-15;0;0;0
1915420;Tiny Hill;;50,000 - 100,000;12;3;9;0;0;0
1915450;Death Damnation : Zombies, Ghosts and Vampires !;;0 - 20,000;25;10;15;0;0;2
1915460;Retro three kingdoms : Special edition;;0 - 20,000;6;10;-4;0;0;6
1915550;Nemesis: Lockdown;;0 - 20,000;313;95;218;129;129;6
1915580;Jumping Horses Champions;;0 - 20,000;0;5;-5;0;0;0
1915700;Immortal Love: True Treasure Collector's Edition;;0 - 20,000;3;0;3;0;0;1
1915910;Hidden Build Top-Down 3D;;0 - 20,000;14;8;6;0;0;0
1915940;Hidden World Top-Down 3D;;0 - 20,000;10;10;0;0;0;0
1916090;Dial-In;;0 - 20,000;9;0;9;0;0;0
1916100;Day of the Dino: Survival;;100,000 - 200,000;10;5;5;0;0;1
1916150;SnakeByte;;0 - 20,000;10;1;9;0;0;0
1916240;遗落迷途lost  in tomorrow;;20,000 - 50,000;1;0;1;0;0;0
1916250;Magic crystals 2;;0 - 20,000;4;4;0;0;0;0
1916310;Remnant Records;;0 - 20,000;234;33;201;0;0;8
1916340;Digital Diamond Baseball V10;;0 - 20,000;17;3;14;0;0;2
1916350;Lord of the Click 3;;0 - 20,000;14;4;10;0;0;3
1916450;Summer With You;;0 - 20,000;19;6;13;0;0;0
1916510;Pop Top Adventure;;0 - 20,000;3;1;2;0;0;0
1916540;Valley Dash;;0 - 20,000;1;0;1;0;0;0
1916580;Red Yet Capers: Math vs Mayhem;;0 - 20,000;1;0;1;0;0;0
1916610;Frame - Portals on Steroids;;0 - 20,000;10;0;10;0;0;1
1916660;WTC : Recruitment Day;;0 - 20,000;1;2;-1;0;0;0
1916690;Mindfulness Simulator - ASMR Meditation Game;;0 - 20,000;8;0;8;0;0;0
1916850;Doomed to Hell;;0 - 20,000;128;21;107;0;0;0
1916860;『絵話 -kaiwa-』;;0 - 20,000;10;2;8;0;0;0
1916880;Neon Racer;;0 - 20,000;4;3;1;0;0;1
1916950;GoodNight;;0 - 20,000;12;4;8;0;0;2
1916960;Yokai Hunter Shintaro;;0 - 20,000;23;6;17;0;0;0
1916970;Tree Simulator 2023;;0 - 20,000;538;18;520;116;116;23
1916970;Tree Simulator 2023;;0 - 20,000;538;18;520;116;116;23
1917020;COVID KILLER;;0 - 20,000;2;0;2;0;0;0
1917170;Ink'n'Think;;0 - 20,000;6;0;6;0;0;0
1917310;Who is the hero of this Game;;0 - 20,000;16;12;4;0;0;0
1917320;A Slit of Joy;;0 - 20,000;6;3;3;0;0;1
1917320;A Slit of Joy;;0 - 20,000;6;3;3;0;0;1
1917350;Mysterious Island - A Hidden Object Adventure;;0 - 20,000;18;11;7;0;0;0
1917370;HyperPortals;;0 - 20,000;16;5;11;0;0;0
1917390;Roxy Raccoon's Bowling Bash;;0 - 20,000;13;2;11;0;0;2
1917410;Elemental Angel Ⅱ;;0 - 20,000;15;3;12;0;0;1
1917450;fault - StP - LIGHTKRAVTE;;0 - 20,000;287;35;252;0;0;0
1917460;Underground Lords;;0 - 20,000;0;1;-1;0;0;0
1917560;Milk Bottle And Monster Girl 2;;20,000 - 50,000;209;36;173;8;8;1
1917610;Twin Mind: Ghost Hunter Collector's Edition;;0 - 20,000;1;0;1;0;0;1
1917660;A Factory Job;;0 - 20,000;6;0;6;0;0;0
1917720;Two Sedans Driving Simulator;;0 - 20,000;11;3;8;0;0;1
1917740;The Ultimate Shot;;0 - 20,000;11;2;9;0;0;0
1917760;Through the Kill Screen;;50,000 - 100,000;25;1;24;0;0;0
1917780;Humans vs Tigers;;0 - 20,000;9;6;3;0;0;0
1917800;Parasite;;0 - 20,000;2;0;2;0;0;0
1917840;Funny Village;;0 - 20,000;9;5;4;0;0;0
1917860;Visionarium 2 - The Descent;;0 - 20,000;20;3;17;0;0;1
1917870;STAY ALIVE;;0 - 20,000;1;0;1;0;0;0
1917920;Polda 7;;20,000 - 50,000;532;33;499;648;648;25
1917950;Spiriat;;0 - 20,000;4;0;4;0;0;0
1917970;Laruaville 12;;0 - 20,000;3;0;3;0;0;2
1918040;Army of Ruin;;50,000 - 100,000;814;118;696;610;610;169
1918080;Path Of Destruction;;0 - 20,000;4;0;4;0;0;0
1918100;Mythic Defender;;0 - 20,000;5;0;5;0;0;0
1918110;Simultaneous Control;;0 - 20,000;1;0;1;0;0;0
1918130;Grim Quest - Old School RPG;;0 - 20,000;80;5;75;0;0;3
1918300;Fishing Vacation;;0 - 20,000;116;1;115;0;0;1
1918330;Interactive Fiction and Adventure Creator (IFAC);;0 - 20,000;3;0;3;0;0;0
1918340;Voxquest: The Firebird;;0 - 20,000;3;0;3;0;0;0
1918400;SECOND WORLD;;0 - 20,000;12;5;7;0;0;0
1918410;Ball Pain;;0 - 20,000;4;0;4;0;0;0
1918440;Championship Wrestling Promoter;;0 - 20,000;10;1;9;0;0;1
1918450;HunterX;;50,000 - 100,000;334;52;282;7;7;7
1918470;Vacation Paradise: California Collector's Edition;;0 - 20,000;3;0;3;0;0;0
1918520;Ninja Village;;0 - 20,000;198;4;194;0;0;12
1918530;Pocket Stables;;0 - 20,000;73;9;64;0;0;13
1918540;The Ramen Sensei;;0 - 20,000;53;7;46;0;0;33
1918550;London Ripper;;20,000 - 50,000;36;4;32;0;0;0
1918560;Cloud Heart;;0 - 20,000;1;0;1;0;0;0
1918670;Dulce et Decorum;;0 - 20,000;1;0;1;0;0;0
1918680;Sword and Fairy Inn 2;;100,000 - 200,000;957;1058;-101;494;494;54
1918710;Investigation Stories : windsound;;0 - 20,000;6;0;6;0;0;0
1918790;The Dark Realm;;0 - 20,000;13;1;12;0;0;0
1918880;Tales of Autumn;;0 - 20,000;21;0;21;0;0;0
1918890;Heaven Keepers;;20,000 - 50,000;9;2;7;0;0;0
1918920;Chinese Train Trip;;0 - 20,000;4;9;-5;0;0;0
1919040;Winter;;20,000 - 50,000;74;28;46;0;0;0
1919070;Iron Age;;200,000 - 500,000;16;6;10;0;0;0
1919100;Lulu's Temple;;0 - 20,000;26;4;22;0;0;0
1919140;Antioch: Scarlet Bay;;200,000 - 500,000;138;23;115;0;0;9
1919150;Smudge Coin Run;;0 - 20,000;21;13;8;0;0;0
1919220;Automoji;;0 - 20,000;1;0;1;0;0;0
1919240;Spelldash;;0 - 20,000;10;2;8;0;0;0
1919310;Jasper Vice: Legends Untold;;0 - 20,000;5;0;5;0;0;0
1919440;SPE:X;;0 - 20,000;12;0;12;0;0;0
1919460;Seraph's Last Stand;;100,000 - 200,000;2647;166;2481;362;459;72
1919470;Atari 50: The Anniversary Celebration;;20,000 - 50,000;133;8;125;0;0;4
1919530;Prototype TD 2;;0 - 20,000;6;0;6;0;0;0
1919540;The Lost Condor - Walking Simulator;;0 - 20,000;3;0;3;0;0;0
1919550;Hidden Cats in Paris;;0 - 20,000;239;11;228;0;0;1
1919590;NBA 2K23;;1,000,000 - 2,000,000;12088;7595;4493;5297;2412;29753
1919700;No Lights 2;;0 - 20,000;0;1;-1;0;0;0
1919710;WHY I was Born;;0 - 20,000;2;1;1;0;0;0
1919720;Crimson Dawn;;200,000 - 500,000;174;34;140;0;0;0
1919750;Ponchoman;;50,000 - 100,000;95;1;94;0;0;2
1919850;Edgar;;0 - 20,000;2;0;2;0;0;0
1919910;Aoihana;;0 - 20,000;11;2;9;0;0;0
1919920;眼球大師 Eyeball Master;;0 - 20,000;10;0;10;0;0;4
1920040;One By One;;0 - 20,000;2;2;0;0;0;0
1920100;Backfirewall_;;0 - 20,000;150;9;141;0;0;7
1920120;Tasty Love;;0 - 20,000;23;2;21;0;0;0
1920210;PREDATOR AND WRECK;;0 - 20,000;4;1;3;0;0;0
1920270;Slackline VR;;0 - 20,000;9;1;8;0;0;0
1920320;Parasite;;50,000 - 100,000;20;3;17;0;0;2
1920390;Yummy Girl 2;;0 - 20,000;61;8;53;0;0;0
1920400;Bunny Girl Story;;0 - 20,000;110;14;96;0;0;2
1920410;The Sargosian Abyss;;0 - 20,000;9;3;6;0;0;0
1920420;SONOHIGURASHI VS. TOUHOU UNIVERSE;;20,000 - 50,000;9;0;9;0;0;0
1920440;Big Tower Tiny Square 2;;0 - 20,000;5;1;4;0;0;0
1920450;Colors! Maze 2;;0 - 20,000;25;4;21;0;0;0
1920460;Reset Memory;;0 - 20,000;3;0;3;0;0;0
1920480;River City Girls 2;;20,000 - 50,000;652;133;519;464;658;66
1920510;The Elevator Game;;0 - 20,000;0;3;-3;0;0;0
1920540;Dreamin' Her - 僕は、彼女の夢を見る。-;;0 - 20,000;100;2;98;0;0;1
1920650;Contrablade: Stadium Rush;;0 - 20,000;23;8;15;0;0;0
1920660;YiYi;;0 - 20,000;150;11;139;0;0;0
1920700;Candle Prick;;0 - 20,000;23;0;23;0;0;0
1920790;生人症候群;;0 - 20,000;27;7;20;0;0;2
1920800;Project Angels - Visual Novel;;20,000 - 50,000;11;0;11;0;0;0
1920800;Project Angels - Visual Novel;;20,000 - 50,000;11;0;11;0;0;0
1920810;Calmie Dots;;0 - 20,000;5;0;5;0;0;0
1920850;Air Museum VR;;0 - 20,000;2;6;-4;0;0;0
1920940;Minebot expedition;;0 - 20,000;10;2;8;0;0;0
1920950;Space Voyager;;50,000 - 100,000;3;0;3;0;0;0
1921040;Wizard of Hunting Life;;0 - 20,000;0;2;-2;0;0;0
1921120;Emoji Merge - Puzzle Matching;;0 - 20,000;0;1;-1;0;0;0
1921130;Disinfection;;0 - 20,000;15;5;10;0;0;0
1921140;Into The Underdusk;;0 - 20,000;17;6;11;0;0;1
1921160;TINY ISLANDS;;0 - 20,000;14;12;2;0;0;0
1921180;Escape Game - FORT BOYARD 2022;;0 - 20,000;5;2;3;0;0;0
1921200;A List Of People Who Went Missing In The Scheleirland National Forest;;0 - 20,000;3;2;1;0;0;0
1921210;Hidden Objects: Tranquil Valley;;0 - 20,000;2;2;0;0;0;0
1921340;Fallen Legion Revenants;;0 - 20,000;6;2;4;0;0;0
1921390;Build Lands;;0 - 20,000;25;1;24;0;0;0
1921450;Quoin;;0 - 20,000;5;0;5;0;0;0
1921460;Zap Dem Rats;;20,000 - 50,000;5;0;5;0;0;0
1921500;Pet Vet 3D Animal hospital Down Under;;0 - 20,000;2;1;1;0;0;0
1921510;Pet Vet 3D Wild Animal Hospital;;0 - 20,000;3;0;3;0;0;0
1921550;Chico and the Magic Orchards DX;;0 - 20,000;16;0;16;0;0;1
1921560;Flowers -Le volume sur hiver-;;0 - 20,000;421;54;367;422;422;9
1921570;GrumpyTunez;;0 - 20,000;5;0;5;0;0;0
1921610;Roaming The Stars;;0 - 20,000;1;0;1;0;0;0
1921610;Roaming The Stars;;0 - 20,000;1;0;1;0;0;0
1921680;VR AirHockey / VR エアホッケー;;0 - 20,000;2;1;1;0;0;0
1921740;CRAYON SHINCHAN The Storm Called! FLAMING KASUKABE RUNNER!!;;0 - 20,000;43;2;41;0;0;2
1921760;Pocket Academy;;0 - 20,000;107;7;100;0;0;16
1921770;The Manga Works;;0 - 20,000;115;15;100;0;0;22
1921780;The Sushi Spinnery;;0 - 20,000;223;5;218;12;12;12
1921840;Terra Flame;;0 - 20,000;17;0;17;0;0;1
1921850;Lenin Simulator;;0 - 20,000;16;6;10;0;0;0
1921880;Max Traffic;;0 - 20,000;2;0;2;0;0;0
1921900;The Testing Chamber;;20,000 - 50,000;447;15;432;0;0;2
1921940;Hero Ring;;0 - 20,000;2;7;-5;0;0;0
1921950;Conflict 3048;;0 - 20,000;0;1;-1;0;0;0
1922000;Towerland;;0 - 20,000;4;1;3;0;0;1
1922060;BrVR Backrooms Virtual Reality;;0 - 20,000;45;7;38;0;0;1
1922100;RC Death Race: Multiplayer;;0 - 20,000;8;4;4;0;0;0
1922120;Mystery Solitaire. Powerful Alchemist 2;;0 - 20,000;3;0;3;0;0;0
1922140;1001 Jigsaw. Cute Cats;;0 - 20,000;7;1;6;0;0;0
1922150;1001 Jigsaw. Wild Animals;;0 - 20,000;4;1;3;0;0;0
1922180;Package Inspector;;0 - 20,000;27;8;19;0;0;0
1922200;Spoils Of War;;0 - 20,000;10;2;8;0;0;0
1922210;Lucky Villager;;0 - 20,000;11;1;10;0;0;0
1922320;Stay away from zombies;;0 - 20,000;2;2;0;0;0;0
1922340;CRASH TEST IDIOT;;0 - 20,000;6;6;0;0;0;0
1922360;SCALEPLANET;;0 - 20,000;13;3;10;0;0;0
1922530;Frontier Fortress - Tower Defense;;20,000 - 50,000;2;1;1;0;0;0
1922540;The Reflection;;0 - 20,000;1;3;-2;0;0;0
1922550;Psychosis;;20,000 - 50,000;17;1;16;0;0;1
1922560;Plants vs. Zombies Garden Warfare 2: Deluxe Edition;;200,000 - 500,000;8755;979;7776;831;237;541
1922600;Protect Ukraine;;0 - 20,000;15;6;9;0;0;0
1922620;Saber Ship;;0 - 20,000;1;1;0;0;0;0
1922870;Shady Business;;50,000 - 100,000;9;1;8;0;0;1
1922880;Fun Quest;;50,000 - 100,000;10;1;9;0;0;0
1923070;Deadland 4000;;0 - 20,000;16;0;16;0;0;2
1923170;Pizza Synthwave;;0 - 20,000;11;1;10;0;0;0
1923180;Vitality Girl Ⅲ:Pixel;;0 - 20,000;12;1;11;0;0;0
1923290;DreamPusher;;0 - 20,000;2;0;2;0;0;1
1923380;Robot-X;;0 - 20,000;5;0;5;0;0;0
1923420;Fruit Basket TV;;20,000 - 50,000;5;0;5;0;0;0
1923450;Building destruction;;0 - 20,000;44;30;14;0;0;0
1923630;HexTD;;0 - 20,000;17;4;13;0;0;0
1923640;RecMaster Pro - Gameplay & Screen Recorder;;0 - 20,000;11;2;9;0;0;0
1923650;Psycho Crab;;0 - 20,000;4;0;4;0;0;0
1923670;Venture Towns;;0 - 20,000;99;9;90;5;5;9
1923680;Mega Mall Story;;0 - 20,000;101;4;97;1;1;8
1923690;Pocket League Story;;0 - 20,000;85;9;76;0;0;12
1923720;Wildlife Planet: The Incremental;;0 - 20,000;15;8;7;0;0;2
1923730;Little Ninja;;0 - 20,000;5;0;5;0;0;0
1923780;Space Out;;0 - 20,000;1;0;1;0;0;0
1923790;Linelith;;20,000 - 50,000;359;4;355;0;0;1
1923790;Linelith;;20,000 - 50,000;359;4;355;0;0;1
1923820;Meowtopia: Expedition;;0 - 20,000;27;1;26;0;0;0
1923860;Neon Outlast;;0 - 20,000;1;1;0;0;0;0
1923860;Neon Outlast;;0 - 20,000;1;1;0;0;0;0
1923900;Magnetic Structures;;0 - 20,000;8;1;7;0;0;0
1923920;Base Craft: Desolate Survival;;20,000 - 50,000;1;0;1;0;0;0
1924010;Shapebreaker - Tower Defense Deckbuilder;;0 - 20,000;30;4;26;0;0;1
1924020;QUIJOTE: Quest for Glory;;0 - 20,000;10;1;9;0;0;1
1924150;CYBERHUNK;;0 - 20,000;65;13;52;0;0;0
1924270;Shooting Covid;;0 - 20,000;1;0;1;0;0;0
1924310;Pixel Pirate;;0 - 20,000;13;1;12;0;0;1
1924340;King of the Savage Realms;;0 - 20,000;1;0;1;0;0;0
1924350;Bargue;;0 - 20,000;11;0;11;0;0;0
1924380;Dashing Orange;;0 - 20,000;6;0;6;0;0;0
1924440;Directly Drink Milk from Cow　【直に牛乳を飲め】;;0 - 20,000;12;4;8;0;0;0
1924460;Light The Lamp Hockey;;0 - 20,000;4;0;4;0;0;0
1924590;Sokobalien;;0 - 20,000;29;1;28;0;0;0
1924710;Night Janitor;;0 - 20,000;35;3;32;0;0;0
1924730;M-1グランプリへの道　～俺たちの出囃子はもう鳴っている～;;0 - 20,000;7;0;7;0;0;0
1924740;捍卫SafeGuard;;0 - 20,000;5;4;1;0;0;0
1924810;Kamiwaza: Way of the Thief;;0 - 20,000;36;5;31;1;1;1
1924820;StudioS Fighters: Climax Champions;;0 - 20,000;13;0;13;0;0;2
1924910;Dr. Chatelet: Faith 神医;;0 - 20,000;60;4;56;0;0;0
1924940;Hexrogue;;0 - 20,000;19;2;17;0;0;2
1925170;Rick and Josh adventures;;0 - 20,000;8;2;6;0;0;0
1925250;Immortal life of Confucius;;0 - 20,000;1;1;0;0;0;0
1925310;Locked Up;;0 - 20,000;49;5;44;0;0;1
1925320;Escape Memoirs: Mansion Heist;;0 - 20,000;131;15;116;0;0;22
1925330;cyVeRpunk;;0 - 20,000;4;0;4;0;0;0
1925340;Menace Labs;;0 - 20,000;1;0;1;0;0;0
1925530;Medusa Frontier;;0 - 20,000;1;2;-1;0;0;0
1925550;Flight 737 - MAXIMUM;;0 - 20,000;4;5;-1;0;0;0
1925600;Puzzle: Nature;;0 - 20,000;10;6;4;0;0;0
1925700;Galpa the no limbs guy;;0 - 20,000;6;0;6;0;0;0
1925710;Mirror Spirits;;20,000 - 50,000;2;3;-1;0;0;0
1925730;Block Breaker;;0 - 20,000;64;32;32;0;0;0
1925830;轮回之理-MOBIUS THEORY;;0 - 20,000;5;2;3;0;0;0
1925910;Raven;;0 - 20,000;15;0;15;0;0;1
1925930;KONGEER;;0 - 20,000;10;1;9;0;0;0
1925970;SIMULACRA 3;;0 - 20,000;109;70;39;0;0;2
1926080;ENDRR;;0 - 20,000;10;3;7;0;0;0
1926110;Bibi & Tina - New adventures with horses;;0 - 20,000;5;2;3;0;0;1
1926160;LAB;;0 - 20,000;4;0;4;0;0;1
1926170;Forgotten Hill Tales;;0 - 20,000;42;5;37;0;0;5
1926180;Lilium;;0 - 20,000;6;0;6;0;0;0
1926220;Ludo XXL;;0 - 20,000;5;6;-1;0;0;0
1926240;REPULSOR;;0 - 20,000;11;1;10;0;0;0
1926330;Ladder Larry;;0 - 20,000;1;0;1;0;0;0
1926360;SPACE MOLMAE;;0 - 20,000;8;0;8;0;0;0
1926370;Yeah！Fighting Girl;;0 - 20,000;13;7;6;0;0;5
1926390;TPORT;;0 - 20,000;27;0;27;0;0;0
1926440;Twin Edge;;0 - 20,000;26;1;25;0;0;0
1926470;Hanna Must Run;;0 - 20,000;10;3;7;0;0;0
1926490;John Christian 2;;0 - 20,000;10;0;10;0;0;0
1926560;Freshman Magic: Spellbooks and Tangled Sheets;;0 - 20,000;7;1;6;0;0;1
1926620;The Backrooms: Lost Tape;;0 - 20,000;79;17;62;0;0;42
1926630;Waves Running Simulator;;0 - 20,000;12;6;6;0;0;0
1926660;OUTLANDER;;0 - 20,000;5;0;5;0;0;0
1926670;Cyber Dungeon: Excalibur;;50,000 - 100,000;1;0;1;0;0;0
1926780;Find The Cats - Memory;;0 - 20,000;0;1;-1;0;0;0
1926790;LillyMonster;;0 - 20,000;1;0;1;0;0;0
1926810;The Detroit After;;0 - 20,000;6;0;6;0;0;0
1926820;BURNER;;20,000 - 50,000;1;0;1;0;0;0
1927000;PlanetVRium;;0 - 20,000;3;0;3;0;0;0
1927020;The Breadmaker;;0 - 20,000;7;0;7;0;0;0
1927030;UFOBIA;;20,000 - 50,000;6;17;-11;0;0;0
1927040;Survirus;;0 - 20,000;7;3;4;0;0;0
1927050;GlassBox;;0 - 20,000;4;0;4;0;0;0
1927140;start;;;;;0;;;
1927140;start;;;;;0;;;
1927160;同居創作人;;0 - 20,000;1;0;1;0;0;0
1927220;Underliner;;20,000 - 50,000;3;0;3;0;0;1
1927270;Administrators;;0 - 20,000;23;6;17;0;0;0
1927370;Down n' Up;;0 - 20,000;5;0;5;0;0;0
1927400;Boating Simulator 2022;;0 - 20,000;5;2;3;0;0;0
1927410;Horse and Go Seek;;0 - 20,000;7;0;7;0;0;0
1927520;The Last World;;20,000 - 50,000;8;3;5;0;0;2
1927540;The Hidden Ghost;;0 - 20,000;9;2;7;0;0;0
1927550;Terror Shooter Apocalypse;;0 - 20,000;1;2;-1;0;0;0
1927560;Surface Rush;;0 - 20,000;10;2;8;0;0;0
1927570;Tilefinder;;20,000 - 50,000;9;1;8;0;0;1
1927580;Poly Memory: Birds;;0 - 20,000;4;2;2;0;0;0
1927710;Supreme Race on Highway;;0 - 20,000;16;5;11;0;0;1
1927720;Monument Valley: Panoramic Edition;;100,000 - 200,000;1573;15;1558;167;191;28
1927740;Monument Valley 2: Panoramic Edition;;20,000 - 50,000;636;25;611;75;76;17
1928120;Swords & Bones 2;;0 - 20,000;10;0;10;0;0;1
1928160;Taya's Alphabet;;0 - 20,000;1;0;1;0;0;0
1928190;Between Two Stars;;0 - 20,000;3;2;1;0;0;0
1928220;SACROSANCT;;0 - 20,000;0;1;-1;0;0;0
1928280;Harakiri! Geisha Girls;;0 - 20,000;2;1;1;0;0;0
1928290;Hoverkitty: Hoververse;;0 - 20,000;2;0;2;0;0;0
1928290;Hoverkitty: Hoververse;;0 - 20,000;2;0;2;0;0;0
1928320;PopSlinger;;20,000 - 50,000;23;1;22;0;0;0
1928330;Adventures of Samuel: The Worst Game Ever Made;;0 - 20,000;4;0;4;0;0;0
1928350;Davey;;0 - 20,000;1;3;-2;0;0;0
1928360;Please Teach Me Onedari Shogi;;0 - 20,000;2;0;2;0;0;0
1928370;Exodemic;;0 - 20,000;40;2;38;0;0;0
1928390;Sheep's Territory;;0 - 20,000;8;0;8;0;0;0
1928450;dweeMIXED: Thwee Pack;;0 - 20,000;5;0;5;0;0;0
1928460;Permanence TD;;0 - 20,000;2;1;1;0;0;0
1928590;Saimai Rd;;0 - 20,000;6;1;5;0;0;0
1928620;内卷三年竟穿越：皇帝模拟器;;0 - 20,000;4;9;-5;0;0;1
1928650;Niflhel's Fables: The Book of Gypsies;;0 - 20,000;17;1;16;0;0;0
1928660;SNOT;;0 - 20,000;14;0;14;0;0;0
1928670;Hajis (Beta);;0 - 20,000;14;8;6;0;0;1
1928710;Cooking Festival;;0 - 20,000;21;6;15;0;0;5
1928810;Plunder Dungeons;;0 - 20,000;7;0;7;0;0;0
1928850;STAR MATH: Interstellar Rogue 2;;0 - 20,000;5;0;5;0;0;0
1928910;TETRIS: Flower Garden;;0 - 20,000;8;5;3;0;0;0
1928930;Voice from Beyond;;0 - 20,000;0;2;-2;0;0;0
1928940;Wild Adventures;;0 - 20,000;16;2;14;0;0;0
1928960;Wild West Gringos;;0 - 20,000;0;1;-1;0;0;0
1929210;Block KUZUSHI;;0 - 20,000;1;0;1;0;0;0
1929270;Murasame;;0 - 20,000;3;0;3;0;0;0
1929330;Pinzzo;;0 - 20,000;1;1;0;0;0;0
1929360;Tumbleweed Destiny;;20,000 - 50,000;296;14;282;333;474;17
1929380;Caverns of Evil;;0 - 20,000;1;1;0;0;0;0
1929460;SOOT;;0 - 20,000;6;0;6;0;0;0
1929550;Stranger Danger or Horror, Quest and Magic;;20,000 - 50,000;1;0;1;0;0;0
1929590;Crusader: Dungeon Series;;0 - 20,000;1;1;0;0;0;0
1929650;Island Assault;;0 - 20,000;0;6;-6;0;0;0
1929720;Pixel Petkeeper;;0 - 20,000;1;0;1;0;0;0
1929770;Xpraize Beta;;0 - 20,000;1;0;1;0;0;0
1929790;隐秘任务  the Secret Ops;;0 - 20,000;2;1;1;0;0;0
1929810;The Thief In The Dark;;0 - 20,000;4;1;3;0;0;0
1929850;散落之瓣：華 - Falling Petals: Bloom Edition;;0 - 20,000;16;0;16;0;0;1
1929870;Nomad Survival;;100,000 - 200,000;1327;161;1166;456;538;43
1929900;Touhou: Dreamland of Infinity;;0 - 20,000;79;5;74;0;0;2
1929910;Wind Angel Ⅲ;;0 - 20,000;11;2;9;0;0;0
1929930;Elite School Roof Club;;0 - 20,000;11;0;11;0;0;0
1930030;Trash Pit;;0 - 20,000;10;0;10;0;0;1
1930040;The President;;0 - 20,000;1;3;-2;0;0;0
1930060;New Lands Paradise Island Collector's Edition;;0 - 20,000;7;1;6;0;0;3
1930070;Mahjong Business Style;;0 - 20,000;1;1;0;0;0;0
1930090;Pirate Solitaire 2;;0 - 20,000;1;1;0;0;0;0
1930100;Solitaire Match 2 Cards. Thanksgiving Day;;0 - 20,000;2;0;2;0;0;1
1930120;Solitaire Beach Season 2;;0 - 20,000;0;1;-1;0;0;0
1930130;Solitaire Beach Season 3;;0 - 20,000;0;1;-1;0;0;0
1930160;1001 Jigsaw American Puzzles;;0 - 20,000;0;1;-1;0;0;0
1930170;1001 Jigsaw: Earth Chronicles 7;;0 - 20,000;1;1;0;0;0;0
1930180;1001 Jigsaw: Earth Chronicles 8;;0 - 20,000;1;1;0;0;0;0
1930230;The Hole;;0 - 20,000;2;1;1;0;0;0
1930360;Fever Dream;;20,000 - 50,000;1;0;1;0;0;0
1930360;Fever Dream;;20,000 - 50,000;1;0;1;0;0;0
1930380;Chico's Family-Friendly Circus;;0 - 20,000;2;7;-5;0;0;0
1930580;Devil's 5 Days Mischief Game;;0 - 20,000;31;4;27;0;0;14
1930600;Beautiful Mystic Survivors;;50,000 - 100,000;721;274;447;0;0;20
1930640;Lost2;;20,000 - 50,000;908;148;760;95;119;23
1930920;Warplanes: Battles over Pacific;;0 - 20,000;82;17;65;0;0;4
1930950;The Butcher;;0 - 20,000;2;3;-1;0;0;0
1930960;Jewel Match Origins 2 - Bavarian Palace Collector's Edition;;0 - 20,000;16;1;15;0;0;6
1931050;CyberScope;;20,000 - 50,000;2;0;2;0;0;0
1931090;Hexagonal Tower;;0 - 20,000;27;25;2;0;0;4
1931150;Z-STOP;;0 - 20,000;1;0;1;0;0;0
1931160;Hate's Offering;;0 - 20,000;0;3;-3;0;0;0
1931200;Bleeding Abyss;;0 - 20,000;1;0;1;0;0;0
1931240;MOTHERGUNSHIP: FORGE;;50,000 - 100,000;148;11;137;0;0;7
1931370;JellyMen;;100,000 - 200,000;7;0;7;0;0;0
1931400;Blocknator;;0 - 20,000;1;0;1;0;0;0
1931440;Miko no Kanata: Curious Tales from Oguni Shrine -Cycles-;;0 - 20,000;3;1;2;0;0;0
1931470;Car Quest Deluxe;;0 - 20,000;4;2;2;0;0;0
1931510;Attacker-chan!;;0 - 20,000;60;6;54;0;0;1
1931640;Emiko's Pledge 2;;0 - 20,000;0;3;-3;0;0;0
1931690;Azure Striker GUNVOLT 3;;0 - 20,000;218;25;193;189;189;11
1931760;Tetris(俄罗斯方块收纳版);;0 - 20,000;0;1;-1;0;0;0
1931870;Tomb Robbing with Friends;;0 - 20,000;6;0;6;0;0;0
1931890;Trivia Party;;0 - 20,000;7;1;6;0;0;0
1931950;Vade Retro : Exorcist;;20,000 - 50,000;638;170;468;158;180;46
1932160;Neptunia: Sisters VS Sisters;;0 - 20,000;320;33;287;102;102;43
1932230;100 hidden hares;;0 - 20,000;130;2;128;0;0;1
1932280;Medieval Fantasy Survival Simulator 2: Gladiator Edition;;0 - 20,000;45;2;43;0;0;0
1932350;LogiNode;;0 - 20,000;15;4;11;0;0;0
1932430;Duline;;0 - 20,000;2;0;2;0;0;0
1932470;You will die a lot buddy, trust me!;;0 - 20,000;10;0;10;0;0;0
1932670;NEVERLAND;;0 - 20,000;2;10;-8;0;0;0
1932690;Liar Moon Shangri-La;;0 - 20,000;13;6;7;0;0;5
1932700;Entomophobia;;0 - 20,000;6;0;6;0;0;0
1932860;Brick Breaker;;0 - 20,000;3;1;2;0;0;0
1932890;DIRTYBLOCK;;0 - 20,000;11;2;9;0;0;0
1933020;Sentry City;;0 - 20,000;4;1;3;0;0;0
1933050;Omega Pilot;;0 - 20,000;76;16;60;0;0;1
1933060;Lovely Moments: Dad and daughter. Jigsaw Puzzle Game;;0 - 20,000;5;0;5;0;0;0
1933070;Emorrior;;0 - 20,000;17;2;15;0;0;0
1933090;Samurai(The Rise Of Warrior)- 武士の台頭;;0 - 20,000;0;1;-1;0;0;0
1933140;Jeu de Tarot;;0 - 20,000;0;1;-1;0;0;0
1933230;Let's Go!;;0 - 20,000;1;0;1;0;0;0
1933320;Black Hole Pool VR;;0 - 20,000;54;19;35;0;0;0
1933330;Tales from the Crossing: The Captain's Chair;;20,000 - 50,000;0;1;-1;0;0;0
1933490;Let's Play! Oink Games;;0 - 20,000;23;10;13;0;0;24
1933510;Delusions of a Lost Soul;;0 - 20,000;12;1;11;0;0;0
1933580;MindSweeper;;0 - 20,000;1;0;1;0;0;0
1933650;The Imperial Gatekeeper;;20,000 - 50,000;772;168;604;361;361;33
1933660;Demons Roots;;0 - 20,000;438;30;408;2;2;25
1933670;Ariel’s Daily Grind;;0 - 20,000;12;35;-23;0;0;9
1933700;Smilemo;;0 - 20,000;359;73;286;0;0;37
1933740;The Caligula Effect 2;;0 - 20,000;249;18;231;941;941;2
1933780;My Divorce Story;;0 - 20,000;9;3;6;0;0;1
1933800;Zombie Survivors;;0 - 20,000;16;15;1;0;0;0
1933820;SGS Korean War;;0 - 20,000;43;8;35;0;0;6
1933850;HUNGRY PIGS;;0 - 20,000;0;0;0;0;0;0
1933890;Nightmare House;;0 - 20,000;33;4;29;0;0;3
1933970;Anime Studio Story;;0 - 20,000;41;9;32;0;0;4
1933980;Pool Slide Story;;0 - 20,000;103;8;95;1;1;3
1933990;Burger Bistro Story;;0 - 20,000;40;2;38;0;0;34
1934020;Polar Penguin Post;;0 - 20,000;20;1;19;0;0;5
1934180;Hot“Sento Girls”and love;;0 - 20,000;24;0;24;0;0;0
1934270;Dance of Decapods;;0 - 20,000;2;0;2;0;0;0
1934330;Joshua's Legs;;50,000 - 100,000;25;0;25;0;0;1
1934340;Epic Pirate;;0 - 20,000;5;3;2;0;0;0
1934350;Wildfox Surfing Paradise;;0 - 20,000;1;0;1;0;0;0
1934420;Die Die Die And Try;;0 - 20,000;4;0;4;0;0;0
1934540;Madville+;;0 - 20,000;23;1;22;0;0;2
1934550;The Legend of Gandar;;0 - 20,000;2;1;1;0;0;0
1934650;Girbal;;0 - 20,000;3;0;3;0;0;0
1934700;Drifting Kings;;0 - 20,000;17;1;16;0;0;0
1934740;VR Archery;;0 - 20,000;3;6;-3;0;0;0
1934790;The Endless Summer Surfing Challenge;;0 - 20,000;2;1;1;0;0;0
1934800;a pet shop after dark;;0 - 20,000;244;33;211;253;459;2
1934930;Conquest Emperor;;0 - 20,000;24;24;0;0;0;1
1934980;Infinite Links;;0 - 20,000;2;1;1;0;0;0
1934990;Senpai and the Mysterious Dungeon;;0 - 20,000;34;11;23;0;0;10
1935070;一念成仙;;0 - 20,000;1;2;-1;0;0;0
1935100;Nightfall Comes;;0 - 20,000;17;0;17;0;0;1
1935130;Terry Poorflyer;;0 - 20,000;3;0;3;0;0;0
1935160;Hit Him;;0 - 20,000;9;0;9;0;0;0
1935240;Planet Conqueror;;0 - 20,000;4;0;4;0;0;0
1935410;The Smash Cars Tournament;;0 - 20,000;11;2;9;0;0;0
1935430;Cowboy Hell;;0 - 20,000;8;2;6;0;0;0
1935460;EMPYRE: Dukes of the Far Frontier;;100,000 - 200,000;7;5;2;0;0;2
1935470;The Tales of Bayun;;0 - 20,000;45;5;40;0;0;17
1935490;Fluffy Milo;;0 - 20,000;32;0;32;0;0;0
1935580;Office Elevator;;0 - 20,000;21;4;17;0;0;0
1935630;HoopsFPS;;0 - 20,000;1;0;1;0;0;0
1935660;Chop Goblins;;50,000 - 100,000;1190;18;1172;0;0;3
1935800;Absolute Tennis Manager;;0 - 20,000;7;3;4;0;0;2
1935830;Stoney's Adventure;;0 - 20,000;4;0;4;0;0;0
1935850;Graffiti Battle;;0 - 20,000;0;1;-1;0;0;0
1935910;Pro Strategy Football 2023;;50,000 - 100,000;46;8;38;0;0;20
1935940;Vendetta: Mafia Wars;;20,000 - 50,000;12;10;2;0;0;2
1935940;Vendetta: Mafia Wars;;20,000 - 50,000;12;10;2;0;0;2
1935960;Drifter's Tales;;0 - 20,000;5;3;2;0;0;0
1936000;The Infernal Return;;0 - 20,000;3;1;2;0;0;0
1936030;Card Girl Army;;0 - 20,000;13;11;2;0;0;0
1936070;School Simulator RPG;;0 - 20,000;4;2;2;0;0;0
1936140;One Last Memory - Reimagined;;0 - 20,000;10;1;9;0;0;0
1936180;GPMoto Challenge;;0 - 20,000;3;1;2;0;0;0
1936190;Radon Break;;0 - 20,000;11;0;11;0;0;0
1936230;별에게 소원을 (When you wish upon a star);;0 - 20,000;41;8;33;0;0;1
1936240;SimpleRoad;;0 - 20,000;6;1;5;0;0;0
1936250;DownTheDead;;0 - 20,000;10;3;7;0;0;1
1936270;Chinese SimpleLife;;0 - 20,000;18;18;0;0;0;0
1936300;Target:Summit(目标：登顶 );;0 - 20,000;3;1;2;0;0;0
1936360;Escape From Mandrillia: Local Asymmetric VR vs PC;;0 - 20,000;76;1;75;0;0;0
1936430;I.D.F.K.;;0 - 20,000;0;2;-2;0;0;0
1936520;Jim's Adventure;;0 - 20,000;1;1;0;0;0;0
1936600;Darkness Of The Coast;;0 - 20,000;2;0;2;0;0;0
1936630;Firewerx;;0 - 20,000;1;0;1;0;0;0
1936700;GENIUS VS ANTICHRIST 1;;0 - 20,000;2;2;0;0;0;0
1936860;Oliver;;0 - 20,000;6;0;6;0;0;0
1936940;Vayan;;0 - 20,000;8;0;8;0;0;0
1937050;Chased Around The World;;0 - 20,000;1;0;1;0;0;0
1937110;Card Craft;;0 - 20,000;15;2;13;0;0;0
1937140;HRD 3 Pegasus Island;;0 - 20,000;7;1;6;0;0;0
1937160;The Nightmare Catcher;;0 - 20,000;44;9;35;0;0;0
1937170;Pokaban;;0 - 20,000;2;1;1;0;0;0
1937180;EvoluShip;;0 - 20,000;18;2;16;0;0;0
1937230;Shatter Remastered Deluxe;;50,000 - 100,000;18;11;7;0;0;0
1937260;Simple Boxing Drills VR;;0 - 20,000;6;0;6;0;0;0
1937360;Findme ～３０才の夢追い人～;;0 - 20,000;1;0;1;0;0;0
1937460;I wanna Reach the TOP;;0 - 20,000;3;0;3;0;0;0
1937470;Franchise Hockey Manager 9;;0 - 20,000;97;10;87;0;0;159
1937510;Mirages of Winter;;0 - 20,000;3;0;3;0;0;0
1937570;Horse Club Adventures 2: Hazelwood Stories;;0 - 20,000;8;0;8;0;0;10
1937600;Сrime Сity;;0 - 20,000;8;3;5;0;0;0
1937620;Tennis Manager 2022;;0 - 20,000;89;28;61;0;0;33
1937710;Egg Bunny 2;;0 - 20,000;2;0;2;0;0;0
1937720;Kamifuda;;0 - 20,000;67;4;63;0;0;0
1937750;Prime of Flames;;50,000 - 100,000;663;82;581;0;0;56
1937850;Satan's Puzzle 2;;0 - 20,000;16;0;16;0;0;0
1937900;Wild Earth - Africa;;0 - 20,000;6;2;4;0;0;0
1937970;Narcotics Ninja;;0 - 20,000;9;1;8;0;0;0
1937980;DUST - A Post Apocalyptic RPG;;20,000 - 50,000;2;2;0;0;0;1
1938010;WILD HEARTS;;200,000 - 500,000;1872;2645;-773;328;421;24585
1938090;Call of Duty: Modern Warfare II;;10,000,000 - 20,000,000;198536;120801;77735;2436;622;139928
1938120;QUALIA ~The Path of Promise~;;0 - 20,000;25;0;25;0;0;1
1938150;Melon Dusk;;20,000 - 50,000;18;0;18;0;0;0
1938180;Axolotl is Dry;;0 - 20,000;35;1;34;0;0;0
1938200;Desktop Dog;;0 - 20,000;26;7;19;0;0;2
1938220;The Game of Unknown;;0 - 20,000;2;0;2;0;0;0
1938260;起飞吧！兔兔;;0 - 20,000;52;0;52;0;0;0
1938290;Vactics;;0 - 20,000;25;0;25;0;0;1
1938330;Into The Dark;;0 - 20,000;26;4;22;0;0;1
1938360;PLASMATIC;;0 - 20,000;5;0;5;0;0;0
1938410;Cyber Pool;;0 - 20,000;2;2;0;0;0;0
1938460;Masterchef Chinese Food Edition;;0 - 20,000;10;16;-6;0;0;0
1938530;Knightblade;;0 - 20,000;7;2;5;0;0;0
1938670;Easter Bunny;;0 - 20,000;10;0;10;0;0;0
1938690;DEVIL DEVOUR ALIVE DX;;0 - 20,000;10;0;10;0;0;0
1938740;Valkyrie Nemesis;;0 - 20,000;4;8;-4;0;0;0
1938830;Blow Fish Music Quiz;;0 - 20,000;1;0;1;0;0;0
1938850;Temp Zero;;0 - 20,000;114;4;110;0;0;0
1939040;No Anglerfish;;0 - 20,000;9;0;9;0;0;1
1939140;Snooze: A Sleeping Adventure;;0 - 20,000;2;0;2;0;0;0
1939160;Shadows Over Loathing;;200,000 - 500,000;1901;63;1838;0;0;268
1939350;Hide & Chick;;0 - 20,000;19;13;6;0;0;2
1939560;镇邪;;50,000 - 100,000;1906;171;1735;1899;2459;84
1939600;Sillage;;0 - 20,000;4;1;3;0;0;0
1939690;Letter Bender;;0 - 20,000;1;0;1;0;0;0
1939740;Little Merchant Legend;;0 - 20,000;9;4;5;0;0;0
1939770;Bash The Party;;0 - 20,000;16;0;16;0;0;0
1939790;Paper Bride 3 Unresolved Love;;20,000 - 50,000;488;37;451;0;0;21
1939810;Sanctum Breach: Rebirth;;50,000 - 100,000;17;7;10;0;0;0
1939930;Quantum Apex;;0 - 20,000;3;1;2;0;0;0
1939940;Roll Player - The Board Game;;0 - 20,000;44;4;40;0;0;1
1940090;Murder Is Game Over;;0 - 20,000;26;1;25;0;0;0
1940140;Tiles and Towers TD;;0 - 20,000;16;1;15;0;0;1
1940190;Oil Invasion;;20,000 - 50,000;11;4;7;0;0;0
1940190;Oil Invasion;;20,000 - 50,000;11;4;7;0;0;0
1940320;Nature's Habit;;0 - 20,000;2;1;1;0;0;0
1940370;Lonely Knight;;50,000 - 100,000;19;8;11;0;0;0
1940490;Tilebreaker;;0 - 20,000;5;3;2;0;0;0
1940550;PVNP;;0 - 20,000;0;1;-1;0;0;0
1940880;Scary Wife HD: Anime Horror Game;;0 - 20,000;7;9;-2;0;0;0
1940980;Fortress Building Puzzle;;0 - 20,000;10;9;1;0;0;0
1941110;Higurashi When They Cry Hou - Rei;;0 - 20,000;101;2;99;0;0;2
1941130;Golden Mine Pickaxe 2: Mummy Tombs;;0 - 20,000;1;1;0;0;0;0
1941140;Outcasts of Dungeon:Epic Magic World Fight Rogue Game Simulator;;0 - 20,000;0;2;-2;0;0;0
1941170;The Jelly Adventure;;0 - 20,000;11;3;8;0;0;0
1941180;Lucky Tlhalerwa - Zombie Rampage;;0 - 20,000;9;9;0;0;0;0
1941220;Nora's AdventurEscape;;0 - 20,000;2;0;2;0;0;0
1941310;Sleep Paralysis: The Uncanny Valley;;50,000 - 100,000;16;3;13;0;0;1
1941400;Tonikk Tycoon;;0 - 20,000;11;3;8;0;0;4
1941510;Adventures of the Old Testament - The Bible Video Game;;20,000 - 50,000;39;10;29;0;0;2
1941550;The Coven of Calahree;;0 - 20,000;1;2;-1;0;0;1
1941660;Spider Solitaire Collection;;0 - 20,000;5;2;3;0;0;2
1941700;Exterminate Zombies: Get Paid;;0 - 20,000;3;1;2;0;0;0
1941740;The Adventures of Poppe;;0 - 20,000;27;7;20;0;0;0
1941760;Irritability & Mood Swings;;0 - 20,000;9;4;5;0;0;1
1941850;Goddess Of War Essa;;0 - 20,000;2;2;0;0;0;0
1941870;The Slime;;0 - 20,000;1;0;1;0;0;0
1942000;Shape Puzzle;;0 - 20,000;3;0;3;0;0;0
1942010;Vengeful Guardian: Moonrider;;0 - 20,000;201;18;183;137;137;2
1942050;Alchemist;;0 - 20,000;0;1;-1;0;0;0
1942140;Eastern Europe Truck Simulator;;0 - 20,000;25;14;11;0;0;0
1942280;Brotato;;1,000,000 - 2,000,000;25740;750;24990;1884;789;21197
1942300;Outer Darkness;;0 - 20,000;0;2;-2;0;0;0
1942360;Breakers World;;50,000 - 100,000;1;8;-7;0;0;0
1942370;Going Into The Unknown;;0 - 20,000;1;0;1;0;0;0
1942380;Toe To Toe VR Party Games;;0 - 20,000;10;2;8;0;0;0
1942390;Him & Her Collection;;0 - 20,000;3;2;1;0;0;0
1942440;最后的仙门 The last Practice Sect;;50,000 - 100,000;272;225;47;0;0;10
1942450;Gemlands;;0 - 20,000;9;1;8;0;0;0
1942480;Cursed Fables: White as Snow Collector's Edition;;0 - 20,000;1;0;1;0;0;0
1942490;Prison of the mind;;0 - 20,000;0;1;-1;0;0;0
1942510;Arcis Ultima;;0 - 20,000;6;0;6;0;0;0
1942540;No Cat Fights Here;;0 - 20,000;28;2;26;0;0;0
1942580;Find And Kill The Evil King;;50,000 - 100,000;3;0;3;0;0;0
1942850;Sunshower;;0 - 20,000;1;0;1;0;0;0
1942920;Bird and Beast Fantasy;;0 - 20,000;2;0;2;0;0;0
1943070;Daydream Mosaics 3: Shards Of Hope;;0 - 20,000;1;0;1;0;0;2
1943160;Overdriven Evolution;;0 - 20,000;1;0;1;0;0;0
1943160;Overdriven Evolution;;0 - 20,000;1;0;1;0;0;0
1943280;Past Particles;;0 - 20,000;16;1;15;0;0;0
1943310;Dragon Caffi;;0 - 20,000;19;0;19;0;0;0
1943360;The Horror Story: Remastered - The Prequel;;20,000 - 50,000;3;0;3;0;0;0
1943370;Invercity;;0 - 20,000;21;0;21;0;0;6
1943440;Royal Mahjong King's Journey;;0 - 20,000;1;1;0;0;0;0
1943450;Holiday Jigsaw Easter 2;;0 - 20,000;3;0;3;0;0;0
1943460;Holiday Jigsaw Easter 3;;0 - 20,000;0;1;-1;0;0;0
1943470;Holiday Jigsaw Halloween 3;;0 - 20,000;1;0;1;0;0;0
1943490;Magic Griddlers 2;;0 - 20,000;2;0;2;0;0;1
1943530;Solitaire Beach Season A Vacation Time;;0 - 20,000;3;1;2;0;0;1
1943740;Arrival of Beasts;;0 - 20,000;22;0;22;0;0;1
1943750;Shirazu Yama;;0 - 20,000;2;3;-1;0;0;0
1943810;Pitchfork Kingdom;;0 - 20,000;10;1;9;0;0;0
1943870;FreeCell Solitaire Collection;;0 - 20,000;3;2;1;0;0;2
1943880;Forty Thieves Solitaire Collection;;0 - 20,000;4;2;2;0;0;1
1943950;Escape the Backrooms;;200,000 - 500,000;9675;1619;8056;249;184;1725
1943980;FITRIZ;;0 - 20,000;6;1;5;0;0;0
1944000;THE DREADFUL SPACE;;0 - 20,000;20;0;20;0;0;1
1944060;Super Alloy Ranger;;0 - 20,000;145;9;136;0;0;3
1944140;Lys and Ruka's Magical Bag;;0 - 20,000;25;15;10;0;0;22
1944210;Infindustry;;0 - 20,000;24;12;12;0;0;3
1944240;Touch Some Grass;;0 - 20,000;466;15;451;719;719;3
1944240;Touch Some Grass;;0 - 20,000;466;15;451;719;719;3
1944250;Hana no No ni Saku Utakata no;;0 - 20,000;376;10;366;1399;1399;8
1944250;Hana no No ni Saku Utakata no;;0 - 20,000;376;10;366;1399;1399;8
1944300;楚汉争霸;;0 - 20,000;3;1;2;0;0;1
1944330;Fruit Bonanza;;0 - 20,000;2;0;2;0;0;0
1944360;Rune Teller;;20,000 - 50,000;312;81;231;0;0;57
1944440;The Farmer's Story of Slow Life;;0 - 20,000;6;1;5;0;0;0
1944520;S E V E R A N C E;;200,000 - 500,000;1;4;-3;0;0;0
1944560;Vacation Adventures: Park Ranger 13;;0 - 20,000;4;0;4;0;0;0
1944570;Boneraiser Minions;;100,000 - 200,000;1986;64;1922;137;142;74
1944600;GAMEDOG;;0 - 20,000;6;1;5;0;0;0
1944640;Escape Dark Tunnels;;0 - 20,000;1;0;1;0;0;0
1944660;AlexanderBall: A Countryball Tale;;0 - 20,000;30;2;28;0;0;13
1944670;WorldMaker;;0 - 20,000;80;10;70;0;0;0
1944700;GunQuest;;0 - 20,000;3;0;3;0;0;0
1944730;Square Keeper;;0 - 20,000;13;1;12;0;0;0
1944780;Jewel Match Solitaire X Collector's Edition;;0 - 20,000;15;2;13;0;0;6
1944790;Train Sim World 3;;20,000 - 50,000;1519;351;1168;488;488;576
1944970;Hidden Farm Top-Down 3D;;0 - 20,000;19;27;-8;0;0;0
1945010;Achievement Cage;;0 - 20,000;6;0;6;0;0;0
1945160;KELVIN;;20,000 - 50,000;4;1;3;0;0;0
1945170;Another Side;;0 - 20,000;3;2;1;0;0;0
1945190;Heroes Rally;;0 - 20,000;12;7;5;0;0;2
1945220;Rhythm Journey;;0 - 20,000;70;20;50;0;0;3
1945560;World of Mines Creator's Edition;;0 - 20,000;20;4;16;0;0;1
1945590;Linguist FPS - The Language Learning FPS;;0 - 20,000;85;31;54;0;0;0
1945670;Bear Adventure;;0 - 20,000;11;3;8;0;0;0
1945740;Jungle Resistance;;0 - 20,000;1;1;0;0;0;0
1945750;Tearstone: Thieves of the Heart;;0 - 20,000;11;3;8;0;0;4
1945750;Tearstone: Thieves of the Heart;;0 - 20,000;11;3;8;0;0;4
1945780;Under The Moon;;0 - 20,000;18;4;14;0;0;0
1945800;[Speer DX];;0 - 20,000;7;0;7;0;0;0
1945820;Boxel Golf;;20,000 - 50,000;10;0;10;0;0;0
1945850;Dark ill 暗黑蛊国;;0 - 20,000;7;7;0;0;0;2
1945880;Financial freedom for the few;;0 - 20,000;3;2;1;0;0;0
1945890;Rocco's Inferno;;0 - 20,000;1;0;1;0;0;0
1945970;Epic Vampire;;0 - 20,000;7;0;7;0;0;0
1945980;The Rusty Sword: Vanguard Island;;0 - 20,000;16;9;7;0;0;0
1946010;I'm looking for 3024 people;;0 - 20,000;18;1;17;0;0;4
1946070;Ten Dates;;0 - 20,000;105;18;87;0;0;60
1946260;Just a ball: Jumping in the space;;0 - 20,000;11;0;11;0;0;0
1946280;Small phrases Great stories;;0 - 20,000;1;0;1;0;0;0
1946300;Masks Of Deception;;20,000 - 50,000;113;45;68;33;33;0
1946430;Garage: Bad Dream Adventure;;0 - 20,000;111;3;108;0;0;1
1946460;Groovy;;0 - 20,000;3;0;3;0;0;0
1946490;Bullet Quest;;0 - 20,000;1;0;1;0;0;0
1946530;Futuristic Museum;;0 - 20,000;1;1;0;0;0;0
1946550;Toilet Chronicles;;50,000 - 100,000;719;74;645;53;65;3
1946550;Toilet Chronicles;;50,000 - 100,000;719;74;645;53;65;3
1946590;Strategy;;0 - 20,000;14;10;4;0;0;0
1946620;Dino-D;;100,000 - 200,000;9;1;8;0;0;2
1946650;hehe;;0 - 20,000;9;0;9;0;0;0
1946810;心Soul;;0 - 20,000;10;2;8;0;0;1
1946810;心Soul;;0 - 20,000;10;2;8;0;0;1
1946840;Midway:Sink the Japanese Aircraft Carriers;;0 - 20,000;0;2;-2;0;0;0
1946970;Isle of Arrows;;50,000 - 100,000;463;96;367;29;33;106
1946980;All Alone with Mannie;;0 - 20,000;4;0;4;0;0;0
1946990;Astrocat: Milky Way Journey;;0 - 20,000;29;0;29;0;0;0
1947050;Delivery in Space;;0 - 20,000;17;1;16;0;0;0
1947060;On the Dragon Wings - Birth of a Hero;;0 - 20,000;58;4;54;0;0;1
1947070;Broken Edge;;2,000,000 - 5,000,000;123;24;99;44;44;5
1947090;Natural Spirit;;0 - 20,000;2;0;2;0;0;0
1947110;PIPI IS YOU;;0 - 20,000;4;0;4;0;0;0
1947120;Cosmic Ascension;;0 - 20,000;6;0;6;0;0;0
1947260;Hidden Harbor Top-Down 3D;;0 - 20,000;14;4;10;0;0;0
1947270;Zom Tom;;0 - 20,000;2;4;-2;0;0;0
1947280;KAOS SurVival;;20,000 - 50,000;68;40;28;0;0;4
1947350;Heartstop;;0 - 20,000;33;0;33;0;0;1
1947530;Fidget Spinner RPG;;20,000 - 50,000;122;11;111;60;60;4
1947660;LiMiT's Escape Room Games;;0 - 20,000;44;13;31;0;0;0
1947670;polyemisokos;;0 - 20,000;7;0;7;0;0;0
1947750;Queen's Wish 2: The Tormentor;;0 - 20,000;63;9;54;0;0;6
1947930;Recreation Room;;0 - 20,000;7;0;7;0;0;0
1947940;beat refle;;0 - 20,000;135;49;86;38;38;0
1947950;Boxing Gym Story;;0 - 20,000;24;7;17;19;19;79
1947990;Pirates - Digital Strategy Game;;0 - 20,000;4;0;4;0;0;0
1948110;Egg Over It: Fall Flat From the Top;;0 - 20,000;4;1;3;0;0;0
1948140;Friend or Foe;;0 - 20,000;15;3;12;0;0;2
1948150;Moonphase Pass;;0 - 20,000;2;1;1;0;0;0
1948210;Mineralis;;0 - 20,000;7;0;7;0;0;0
1948220;Intraquartz;;0 - 20,000;16;0;16;0;0;0
1948240;Shark Assault Simulator;;0 - 20,000;18;8;10;0;0;0
1948280;Stacklands;;500,000 - 1,000,000;0;0;0;319;280;827
1948290;Before The Last Hour;;0 - 20,000;33;10;23;0;0;1
1948330;魂之独颂歌 Song of Souls;;0 - 20,000;1;3;-2;0;0;0
1948540;Exipelago;;0 - 20,000;3;1;2;0;0;0
1948680;CYCO;;0 - 20,000;1;0;1;0;0;0
1948740;Dodge & Weave;;0 - 20,000;9;0;9;0;0;0
1948780;First Time in Rome;;0 - 20,000;3;0;3;0;0;0
1948800;Yi Xian: The Cultivation Card Game;;100,000 - 200,000;1982;604;1378;1574;2156;2048
1948870;Pierre's Adventures in French [Learn French];;0 - 20,000;31;0;31;0;0;0
1948930;Ambitious;;50,000 - 100,000;2;7;-5;0;0;0
1948960;Other;;0 - 20,000;4;0;4;0;0;0
1949000;Catgirls From My Sweet Dream;;20,000 - 50,000;79;8;71;0;0;1
1949010;Room 301 NO.6;;0 - 20,000;109;7;102;0;0;0
1949050;Curley Laboratory;;0 - 20,000;28;1;27;0;0;0
1949100;My Fantastic Ranch;;0 - 20,000;10;4;6;0;0;1
1949140;Rule The World CHESS;;0 - 20,000;4;1;3;0;0;0
1949170;星之传说;;0 - 20,000;1;1;0;0;0;0
1949190;Necrosmith;;200,000 - 500,000;3268;430;2838;408;443;28
1949270;Light Of The Past;;50,000 - 100,000;12;2;10;0;0;1
1949280;Space egg shooter;;20,000 - 50,000;37;24;13;0;0;0
1949300;EXIT - The Curse of Ophir;;0 - 20,000;18;3;15;0;0;1
1949330;Jigsaw Savant;;0 - 20,000;2;0;2;0;0;0
1949370;8/8/88 Needle AL;;0 - 20,000;74;12;62;0;0;0
1949380;Capture Creatures;;0 - 20,000;3;2;1;0;0;0
1949440;Burrow of the Fallen Bear: A Gay Furry Visual Novel;;0 - 20,000;11;0;11;0;0;1
1949490;YUMMY CHICKEN DRAGON;;0 - 20,000;16;0;16;0;0;0
1949640;Cyber Virus;;0 - 20,000;0;1;-1;0;0;0
1949650;OZ Chord Player;;0 - 20,000;4;0;4;0;0;1
1949670;bluem;;0 - 20,000;4;0;4;0;0;0
1949700;Monsters In The Shadows;;0 - 20,000;2;0;2;0;0;0
1949720;Dandi World;;0 - 20,000;2;0;2;0;0;0
1949780;Industrial Trouble;;20,000 - 50,000;39;23;16;0;0;0
1949810;Rocket Mania;;0 - 20,000;8;0;8;0;0;0
1949840;Disharmonia;;0 - 20,000;2;4;-2;0;0;0
1949850;Collapsed;;0 - 20,000;9;1;8;0;0;0
1949880;Fantasy Adventure;;0 - 20,000;6;9;-3;0;0;0
1949910;Skyscraper Jump;;100,000 - 200,000;57;29;28;0;0;0
1949930;Animaddicts 4;;0 - 20,000;2;3;-1;0;0;0
1949960;Super Kiwi 64;;0 - 20,000;648;21;627;0;0;3
1950000;Merge Cats - Idle Game;;0 - 20,000;3;0;3;0;0;0
1950070;Samurai Story;;0 - 20,000;56;30;26;0;0;0
1950080;Cyber Bay;;0 - 20,000;9;5;4;0;0;0
1950140;SAVE THE SCHOOL FLOWER ACTION;;0 - 20,000;3;3;0;0;0;0
1950240;TERROVOX;;0 - 20,000;4;0;4;0;0;0
1950310;Until The End;;0 - 20,000;6;2;4;0;0;0
1950440;Mage and Monsters;;50,000 - 100,000;451;35;416;243;317;23
1950470;Rotten Apple - VR Arcade Version;;20,000 - 50,000;3;0;3;0;0;0
1950570;The witch of the Ihanashi;;0 - 20,000;170;2;168;0;0;0
1950610;Sweet Solitaire. School Witch 2;;0 - 20,000;1;0;1;0;0;0
1950620;Mystery Solitaire. The Black Raven 3;;0 - 20,000;1;0;1;0;0;0
1950680;1001 Jigsaw. Legends of Mystery 4;;0 - 20,000;1;1;0;0;0;1
1950680;1001 Jigsaw. Legends of Mystery 4;;0 - 20,000;1;1;0;0;0;1
1950700;1001 Jigsaw. Castles And Palaces 3;;0 - 20,000;1;1;0;0;0;1
1950700;1001 Jigsaw. Castles And Palaces 3;;0 - 20,000;1;1;0;0;0;1
1950710;1001 Jigsaw. Legends of Mystery 5;;0 - 20,000;3;2;1;0;0;0
1950720;1001 Jigsaw. Interior Design;;0 - 20,000;1;0;1;0;0;0
1950770;Tales of Fire;;0 - 20,000;13;2;11;0;0;0
1950820;Mechabot Defender;;0 - 20,000;8;1;7;0;0;0
1950830;Arena Brutal;;0 - 20,000;2;0;2;0;0;0
1950920;Vacuum Story;;0 - 20,000;9;3;6;0;0;0
1951070;Wind Angel Challenge;;0 - 20,000;3;2;1;0;0;0
1951140;Kaiju;;0 - 20,000;8;0;8;0;0;0
1951260;Spotted Garden Eel Adventure;;0 - 20,000;1;0;1;0;0;0
1951300;My Girlfriend is a Musician;;0 - 20,000;4;1;3;0;0;0
1951380;Diptych: The Great War;;20,000 - 50,000;20;1;19;0;0;0
1951480;Researchity | Open World Survival Game;;0 - 20,000;0;1;-1;0;0;0
1951530;Carnival of Gods: Oppression;;0 - 20,000;12;0;12;0;0;1
1951560;Heart of Battle;;0 - 20,000;10;3;7;0;0;9
1951660;We See You;;0 - 20,000;14;0;14;0;0;0
1951680;Wibble;;0 - 20,000;6;0;6;0;0;0
1951700;Areigna Tactics;;0 - 20,000;1;0;1;0;0;0
1951840;Dungeoneer;;0 - 20,000;17;7;10;0;0;0
1951850;Fluff;;0 - 20,000;6;0;6;0;0;0
1951910;Dash And Slash;;0 - 20,000;3;0;3;0;0;0
1951940;Eschaton;;20,000 - 50,000;40;1;39;0;0;0
1951950;3D Controller Overlay;;0 - 20,000;9;2;7;0;0;1
1951970;Abedot Family Estate: Search For Hidden Objects;;0 - 20,000;15;15;0;0;0;0
1952030;Magic Tower (Destroy the Wormhole);;0 - 20,000;6;0;6;0;0;1
1952160;March to a Million;;0 - 20,000;17;4;13;0;0;0
1952170;Cafeteria Nipponica;;0 - 20,000;104;9;95;57;57;13
1952240;Pixel Game Maker Series OMA2RI ADVENTURE;;0 - 20,000;1;0;1;0;0;0
1952250;SAMURAI MAIDEN;;0 - 20,000;293;216;77;149;149;7
1952340;Poly Skies;;0 - 20,000;5;0;5;0;0;0
1952400;New Horizon;;0 - 20,000;13;5;8;0;0;2
1952440;God Souls;;20,000 - 50,000;63;6;57;0;0;0
1952440;God Souls;;20,000 - 50,000;63;6;57;0;0;0
1952490;Alice | 愛莉澄;;0 - 20,000;17;6;11;0;0;0
1952550;Mini Island: Cosmos;;0 - 20,000;7;0;7;0;0;0
1952560;K9 Uprising;;0 - 20,000;6;0;6;0;0;0
1952740;Infinite Turtles;;0 - 20,000;33;0;33;0;0;1
1952760;RGB Rush;;0 - 20,000;114;5;109;0;0;0
1952780;Spider Slingers;;0 - 20,000;14;0;14;0;0;1
1952890;Scary Husband HD: Anime Horror Game;;0 - 20,000;5;2;3;0;0;0
1952910;Social Moth;;0 - 20,000;51;1;50;0;0;0
1952930;Soul Wargame;;0 - 20,000;99;16;83;38;38;6
1952950;Restaurant Simulator;;0 - 20,000;9;3;6;0;0;0
1952960;Movie Theater Simulator;;0 - 20,000;3;1;2;0;0;0
1952990;BATTLE OF BILLIONAIRES;;0 - 20,000;0;1;-1;0;0;0
1953020;Lab Remnants;;0 - 20,000;14;2;12;0;0;1
1953170;Rose Action;;0 - 20,000;12;15;-3;0;0;0
1953210;Hungry Animals;;0 - 20,000;1;1;0;0;0;0
1953220;Gem Tower Defense 2;;20,000 - 50,000;2;2;0;0;0;0
1953380;Dungeon Rummage - Tiqee's Escape;;0 - 20,000;11;0;11;0;0;0
1953490;Seven Deadly Dates;;0 - 20,000;26;1;25;0;0;2
1953520;WRC Generations – The FIA WRC Official Game;;50,000 - 100,000;1030;434;596;1426;1807;300
1953530;The Last Man;;0 - 20,000;5;0;5;0;0;0
1953570;TerraNova: Escape Room;;0 - 20,000;2;7;-5;0;0;0
1953580;Samurai Solitaire. Threads of Fate;;0 - 20,000;1;0;1;0;0;0
1953590;Sailor’s Stories Solitaire;;0 - 20,000;1;1;0;0;0;0
1953800;Beat The Clock;;0 - 20,000;5;0;5;0;0;0
1953860;Garden In!;;0 - 20,000;101;10;91;0;0;9
1953920;Crescent Bloom;;0 - 20,000;2;0;2;0;0;0
1954010;Escape from Deathmark Dungeon;;0 - 20,000;1;0;1;0;0;0
1954020;Cupid Kiss (Cute Puzzle);;0 - 20,000;24;0;24;0;0;1
1954050;Memory Shards;;0 - 20,000;12;1;11;0;0;0
1954070;Egg Ascent;;0 - 20,000;17;0;17;0;0;0
1954100;Bunny Hop : Eggstreme;;0 - 20,000;6;0;6;0;0;0
1954200;Kena: Bridge of Spirits;;200,000 - 500,000;6667;526;6141;410;323;279
1954250;Dragon's Dilemma;;0 - 20,000;5;1;4;0;0;0
1954390;Tamashi Party;;0 - 20,000;1;0;1;0;0;0
1954440;OneShotRogue;;0 - 20,000;3;0;3;0;0;1
1954570;Death Dungeon;;0 - 20,000;2;0;2;0;0;0
1954640;真空战姬;;0 - 20,000;136;6;130;0;0;1
1954670;Reforger;;0 - 20,000;3;0;3;0;0;0
1954750;Acquitted;;50,000 - 100,000;756;18;738;19;19;1
1954880;剑冢 Swords Tomb;;0 - 20,000;21;4;17;0;0;0
1954930;Stronghold’s Dungeon;;0 - 20,000;32;13;19;0;0;8
1955000;3D PUZZLE - Alchemist House;;0 - 20,000;14;32;-18;0;0;0
1955100;怯懦 Cowardice;;0 - 20,000;3;0;3;0;0;0
1955260;Nightmare Rooms VR;;0 - 20,000;2;0;2;0;0;0
1955330;Save Room - Organization Puzzle;;50,000 - 100,000;1483;36;1447;96;102;9
1955380;Sarissa and the Legendary Sword;;0 - 20,000;0;1;-1;0;0;0
1955390;Playable Mockup;;0 - 20,000;47;5;42;0;0;2
1955410;Dash Shooters;;0 - 20,000;5;0;5;0;0;0
1955500;Creature Discomfort;;0 - 20,000;1;1;0;0;0;0
1955700;Kids On Site - Hard Hat Edition;;0 - 20,000;1;0;1;0;0;0
1955820;Bubble Shot;;0 - 20,000;7;1;6;0;0;1
1955950;Poker Loafer;;0 - 20,000;2;0;2;0;0;0
1955970;Something Weird in Space -  A Hidden Object Adventure;;0 - 20,000;15;9;6;0;0;0
1955980;Arsilon;;0 - 20,000;5;0;5;0;0;0
1955990;RogueStone;;50,000 - 100,000;0;2;-2;0;0;0
1956140;A HAUNTED HISTORY;;20,000 - 50,000;2;0;2;0;0;0
1956180;Catbusters;;0 - 20,000;2;0;2;0;0;0
1956240;World of Music Interactive Simulator;;0 - 20,000;2;0;2;0;0;0
1956270;Dastardly;;0 - 20,000;1;0;1;0;0;0
1956300;Beer Break;;0 - 20,000;2;3;-1;0;0;0
1956310;Scandal Notes;;0 - 20,000;4;0;4;0;0;0
1956370;WTF Do You Know?;;0 - 20,000;108;3;105;0;0;0
1956400;PISTOLA;;0 - 20,000;22;5;17;0;0;0
1956420;TacTac Prologue;;0 - 20,000;1;0;1;0;0;0
1956490;Smash Therapy;;0 - 20,000;1;2;-1;0;0;0
1956600;Yusetsu;;20,000 - 50,000;805;71;734;96;119;20
1956820;Edge Run;;0 - 20,000;5;0;5;0;0;0
1956830;[Chilla's Art] The Bathhouse | 地獄銭湯♨️;;20,000 - 50,000;0;0;0;0;0;3
1956860;Down Fast VR;;0 - 20,000;5;0;5;0;0;1
1957010;Undead Under Night Rain;;0 - 20,000;1;2;-1;0;0;0
1957080;Our Fate Forsaken - Boys Love (BL) Visual Novel;;0 - 20,000;6;1;5;0;0;1
1957100;Natal Perdido;;0 - 20,000;17;2;15;0;0;0
1957160;L'Avancée du désert;;0 - 20,000;1;1;0;0;0;0
1957210;Dogs Cyberpuzzle;;0 - 20,000;21;0;21;0;0;0
1957220;Departure.;;0 - 20,000;9;0;9;0;0;0
1957230;Employee of The Month;;0 - 20,000;56;1;55;0;0;3
1957240;Hacker Man;;200,000 - 500,000;1;6;-5;0;0;0
1957270;The Missing Thing;;0 - 20,000;1;1;0;0;0;0
1957330;VTuber Plus;;0 - 20,000;100;8;92;14620;14620;30
1957480;Card Girl Army Ⅱ;;0 - 20,000;2;0;2;0;0;0
1957560;Spyer;;50,000 - 100,000;2;2;0;0;0;0
1957590;Armored Lab Force VULVEHICLES;;0 - 20,000;22;0;22;0;0;1
1957620;Restart your life Adventures of Tainuote;;0 - 20,000;2;4;-2;0;0;0
1957650;Bitch demon twins;;0 - 20,000;1;0;1;0;0;0
1957680;Mount Wingsuit 2;;0 - 20,000;12;2;10;0;0;0
1957750;Minarchy: Active Shooter;;50,000 - 100,000;0;1;-1;0;0;0
1957820;The Detail's In The Devils;;0 - 20,000;0;1;-1;0;0;0
1957860;Anna VS the A.I.maze;;0 - 20,000;4;2;2;0;0;0
1957880;Manglepaw;;0 - 20,000;7;0;7;0;0;0
1957910;Farmland Realm;;50,000 - 100,000;48;13;35;0;0;0
1957990;Tile Cities;;50,000 - 100,000;397;16;381;61;61;8
1958040;Maps: U.S.A.;;0 - 20,000;2;0;2;0;0;0
1958120;Rail Walkers;;0 - 20,000;0;2;-2;0;0;0
1958130;The Backrooms: Found Footage;;0 - 20,000;33;11;22;0;0;1
1958190;MiniTrans;;0 - 20,000;3;3;0;0;0;0
1958230;LOONY;;0 - 20,000;3;1;2;0;0;0
1958240;TRUE SKATE;;0 - 20,000;27;14;13;0;0;3
1958250;鬥犬 Dog Fighting;;0 - 20,000;0;1;-1;0;0;0
1958350;River Rush;;0 - 20,000;0;0;0;0;0;0
1958460;New Yankee: Battle for the Bride;;0 - 20,000;9;1;8;0;0;4
1958530;Wathitdew Record Game Studio BATTLEFIELD;;0 - 20,000;1;0;1;0;0;0
1958600;Barro F22;;0 - 20,000;67;12;55;0;0;0
1958620;Aznak;;0 - 20,000;0;1;-1;0;0;0
1958750;Hexfactory;;20,000 - 50,000;3;2;1;0;0;0
1958810;My Bunny Girl;;0 - 20,000;54;17;37;0;0;1
1958890;Outrace;;0 - 20,000;1;3;-2;0;0;0
1958950;Doggo Estates;;0 - 20,000;5;0;5;0;0;0
1958970;Idle Galaxy;;0 - 20,000;7;10;-3;0;0;1
1959380;C&T;;0 - 20,000;9;1;8;0;0;0
1959400;Arobynn: The First Adventure;;0 - 20,000;0;1;-1;0;0;0
1959440;Balance Knight;;0 - 20,000;1;1;0;0;0;0
1959470;Ambulance Emergency Simulation;;0 - 20,000;13;0;13;0;0;0
1959490;The Last Tater;;20,000 - 50,000;9;0;9;0;0;1
1959530;Extra Case: My Girlfriend's Secrets;;0 - 20,000;81;10;71;0;0;1
1959610;Bloodied Fear;;0 - 20,000;2;0;2;0;0;0
1959660;孤星蒲公英;;0 - 20,000;2;0;2;0;0;0
1959780;七月-July;;0 - 20,000;13;6;7;0;0;1
1959880;Rogue Door Defense;;0 - 20,000;15;2;13;0;0;1
1959900;转生成为史莱姆的我变成了美少女的宠物;;0 - 20,000;5;5;0;0;0;0
1960010;Insanity Ice;;0 - 20,000;1;0;1;0;0;0
1960100;Valera The Drunken Lobster;;0 - 20,000;1;0;1;0;0;0
1960170;ALUMNI - Escape Room Adventure;;0 - 20,000;22;11;11;0;0;0
1960270;Lootun;;0 - 20,000;225;11;214;0;0;71
1960270;Lootun;;0 - 20,000;225;11;214;0;0;71
1960320;Rhythmic Keyboard;;0 - 20,000;1;0;1;0;0;0
1960330;Alchemia: Creatio Ex Nihilo;;0 - 20,000;21;2;19;0;0;0
1960400;SokoChess;;0 - 20,000;36;0;36;0;0;0
1960570;Plank Road;;0 - 20,000;7;0;7;0;0;0
1960590;I Am Sakuya: Touhou FPS Game;;50,000 - 100,000;330;32;298;214;214;4
1960610;The Ball Flow - Nature and Light;;0 - 20,000;1;1;0;0;0;0
1960650;Dash Around Madly;;0 - 20,000;1;0;1;0;0;0
1960710;Simulacrum;;0 - 20,000;11;1;10;0;0;0
1960790;Battle of Heroes 3;;0 - 20,000;1;4;-3;0;0;0
1960790;Battle of Heroes 3;;0 - 20,000;1;4;-3;0;0;0
1960800;Overrogue;;0 - 20,000;16;9;7;0;0;3
1960870;Hypnosis Reveries;;0 - 20,000;10;2;8;0;0;0
1960890;Jishogi;;0 - 20,000;17;0;17;0;0;1
1960950;Monsterlands;;0 - 20,000;17;2;15;0;0;1
1961040;Zion Survivors;;0 - 20,000;2;1;1;0;0;0
1961060;Pawsecuted;;0 - 20,000;5;0;5;0;0;0
1961130;La Vie La Rue;;0 - 20,000;2;0;2;0;0;0
1961210;Ai-(Onic);;0 - 20,000;1;1;0;0;0;0
1961230;Crazy Cook;;0 - 20,000;2;1;1;0;0;0
1961250;Extinction Eclipse;;0 - 20,000;23;2;21;0;0;0
1961260;Running on Magic;;0 - 20,000;30;4;26;0;0;0
1961300;Is Simon There?;;0 - 20,000;181;23;158;0;0;0
1961380;Taiga;;0 - 20,000;1;1;0;0;0;0
1961390;Sakura Succubus 6;;0 - 20,000;44;3;41;0;0;0
1961410;Askaya: Remnants of Ajuna;;0 - 20,000;1;0;1;0;0;0
1961480;3D PUZZLE - Farm House;;0 - 20,000;17;11;6;0;0;0
1961490;Ukko & Guará: Stellarbound;;0 - 20,000;5;0;5;0;0;0
1961520;FIND ALL 3: Travel;;0 - 20,000;165;9;156;0;0;7
1961520;FIND ALL 3: Travel;;0 - 20,000;165;9;156;0;0;7
1961770;Ball Go Home;;0 - 20,000;3;0;3;0;0;0
1961780;Gordianaut;;0 - 20,000;9;5;4;0;0;0
1961860;- Doki Doki Family - 特異体質者のドキドキ家族生活;;0 - 20,000;1;3;-2;0;0;0
1961870;- Mischief Dungeon Life - 異世界転生した俺のイタズラダンジョンライフ;;0 - 20,000;0;3;-3;0;0;0
1961930;I Love Finding MORE Pups;;0 - 20,000;3;0;3;0;0;0
1961950;CHAOS;;;;;0;;;
1962030;Blade Jumper;;0 - 20,000;15;5;10;0;0;1
1962100;My Life: Pet Vet;;0 - 20,000;1;2;-1;0;0;1
1962150;My Life: Riding Stables 3;;0 - 20,000;1;2;-1;0;0;2
1962170;Suddenly Meow 2;;0 - 20,000;7;1;6;0;0;1
1962430;Monochrome Mobius: Rights and Wrongs Forgotten;;20,000 - 50,000;406;103;303;0;0;20
1962490;FurBalls Racing;;20,000 - 50,000;4;0;4;0;0;0
1962490;FurBalls Racing;;20,000 - 50,000;4;0;4;0;0;0
1962520;Rise of Fox Hero;;0 - 20,000;4;0;4;0;0;1
1962540;Still Heroes;;0 - 20,000;20;4;16;0;0;0
1962560;Grim Horde;;0 - 20,000;37;15;22;611;611;1
1962570;STOLEN CITY;;0 - 20,000;21;12;9;0;0;0
1962650;Horrid Henry's Krazy Karts;;0 - 20,000;3;1;2;0;0;0
1962930;Jacks or Better - Video Poker;;0 - 20,000;7;0;7;0;0;1
1963010;Purgatory Dungeoneer;;0 - 20,000;22;3;19;0;0;2
1963040;The Lost Village;;0 - 20,000;196;123;73;7835;7835;45
1963080;난중설화: The Tales of Imjin War;;20,000 - 50,000;21;4;17;0;0;2
1963120;Elemental Angel Ⅲ;;0 - 20,000;4;0;4;0;0;0
1963180;Raccoon Tales;;0 - 20,000;5;1;4;0;0;0
1963210;VALKYRIE ELYSIUM;;20,000 - 50,000;471;267;204;14;14;29
1963280;JAMPING FISH;;0 - 20,000;17;1;16;0;0;0
1963370;No One Survived;;50,000 - 100,000;1238;375;863;643;748;3476
1963470;Little Witch;;0 - 20,000;1;1;0;0;0;0
1963480;Race to Kyiv;;0 - 20,000;26;2;24;0;0;0
1963510;Herald of Havoc;;0 - 20,000;9;0;9;0;0;0
1963520;Cygnus Enterprises;;0 - 20,000;148;33;115;0;0;7
1963590;ME_iON;;0 - 20,000;4;1;3;0;0;0
1963600;Eyes of Darkness;;0 - 20,000;1;1;0;0;0;0
1963630;Space City - Build Your Empire;;0 - 20,000;0;3;-3;0;0;0
1963660;Neodori Forever;;0 - 20,000;44;9;35;0;0;0
1963750;Joker Poker - Video Poker;;0 - 20,000;3;1;2;0;0;1
1963760;Deuces Wild - Video Poker;;0 - 20,000;2;0;2;0;0;2
1963900;Knotwords;;0 - 20,000;43;4;39;0;0;6
1963950;Gasnator;;0 - 20,000;16;5;11;0;0;0
1963980;LENDARIOS STORY BRIGHTNESS PART 1;;0 - 20,000;3;3;0;0;0;0
1963990;Deliver Us From Evil (DUFE) - Masquerade;;0 - 20,000;4;1;3;0;0;0
1964140;Erroneous;;0 - 20,000;6;1;5;0;0;0
1964260;Void Prison;;20,000 - 50,000;50;4;46;0;0;0
1964310;MORODASHI SUMO;;0 - 20,000;51;3;48;0;0;1
1964320;THERE'S A RIKISHI IN MY HOUSE;;0 - 20,000;5;1;4;0;0;0
1964330;Madcap Mosaic;;0 - 20,000;43;2;41;0;0;1
1964440;Tower Of Wishes 2: Vikings Collector's Edition (Match 3);;0 - 20,000;3;0;3;0;0;1
1964480;Yami RPG Editor;;0 - 20,000;26;0;26;0;0;7
1964490;True_Aim;;0 - 20,000;1;0;1;0;0;0
1964540;Isolate ME!;;0 - 20,000;2;0;2;0;0;0
1964580;ZEROCRON;;0 - 20,000;2;0;2;0;0;0
1964620;AISZplus;;0 - 20,000;6;0;6;0;0;0
1964690;Dwarfenstein;;0 - 20,000;21;1;20;0;0;1
1964750;DOLPHIN HUSTLE;;0 - 20,000;11;6;5;0;0;2
1964760;WFO World Football Online;;0 - 20,000;4;0;4;0;0;0
1964780;The Revenge of Mr.Samuel;;0 - 20,000;11;0;11;0;0;0
1964810;Meekanoid;;0 - 20,000;12;3;9;0;0;0
1964870;Rule No. 2;;0 - 20,000;56;4;52;0;0;0
1964940;Damien Crawford's Golf Experience 2022;;0 - 20,000;6;1;5;0;0;0
1964990;Galactic Explorers;;20,000 - 50,000;2;0;2;0;0;0
1965000;Hotel Manager Simulator;;0 - 20,000;0;1;-1;0;0;0
1965020;Curro;;0 - 20,000;4;0;4;0;0;0
1965050;Mortificare;;0 - 20,000;1;0;1;0;0;0
1965060;Quest room;;0 - 20,000;22;7;15;0;0;0
1965130;Key Puss;;0 - 20,000;30;14;16;0;0;1
1965260;Mini Putt;;0 - 20,000;12;0;12;0;0;0
1965360;Wet Dreams;;0 - 20,000;1;1;0;0;0;0
1965390;Online Sparkler;;0 - 20,000;44;8;36;0;0;0
1965490;Mist Monkey: wanderer;;0 - 20,000;3;0;3;0;0;0
1965560;Rogue Warlords;;0 - 20,000;3;3;0;0;0;0
1965610;Froggie;;0 - 20,000;49;1;48;0;0;0
1965670;It's high noon;;20,000 - 50,000;3;0;3;0;0;0
1965680;HopDodge;;20,000 - 50,000;5;0;5;0;0;1
1965800;Dice Tribes: Ambitions;;0 - 20,000;62;1;61;0;0;0
1965840;Mini Mecum;;20,000 - 50,000;20;2;18;0;0;0
1965920;Cthulhu Mythos ADV Lunatic Whispers;;20,000 - 50,000;21;7;14;0;0;16
1965920;Cthulhu Mythos ADV Lunatic Whispers;;20,000 - 50,000;21;7;14;0;0;16
1965940;Ninja Sneaking R;;0 - 20,000;2;0;2;0;0;0
1966070;～Daydream～蝶が舞う頃に;;0 - 20,000;98;22;76;0;0;1
1966080;rododendron;;0 - 20,000;2;0;2;0;0;0
1966130;Strategic Command: American Civil War;;0 - 20,000;87;13;74;0;0;43
1966170;SenS;;0 - 20,000;34;12;22;0;0;0
1966170;SenS;;0 - 20,000;34;12;22;0;0;0
1966240;Trouble Town;;0 - 20,000;0;1;-1;0;0;0
1966260;Idle Business Tycoon - Build Simulator;;0 - 20,000;2;6;-4;0;0;0
1966300;Army of One;;20,000 - 50,000;28;17;11;0;0;0
1966310;Kuggs;;20,000 - 50,000;5;4;1;0;0;0
1966370;NEON SPEED;;0 - 20,000;32;12;20;0;0;0
1966370;NEON SPEED;;0 - 20,000;32;12;20;0;0;0
1966450;MAXIM;;0 - 20,000;0;2;-2;0;0;0
1966610;HRS: devil game I;;0 - 20,000;1;0;1;0;0;0
1966690;Tad the Lost Explorer;;0 - 20,000;29;3;26;0;0;2
1966700;Windfolk: Sky is just the Beginning;;0 - 20,000;31;4;27;0;0;2
1966870;Cyber Car;;0 - 20,000;47;27;20;0;0;0
1966900;20 Minutes Till Dawn;;500,000 - 1,000,000;17879;1391;16488;483;321;535
1966930;Ballistic Zen;;0 - 20,000;30;0;30;0;0;0
1966940;Automata Ecosystem - Cellular Automata Simulation;;0 - 20,000;3;0;3;0;0;1
1967010;Updog;;0 - 20,000;20;0;20;0;0;0
1967090;Mythos;;0 - 20,000;15;15;0;0;0;0
1967320;Fairy Biography;;20,000 - 50,000;487;125;362;13;13;3
1967330;Spell Welders;;0 - 20,000;4;0;4;0;0;0
1967340;Last Day: Zombie Survival VR;;0 - 20,000;0;3;-3;0;0;0
1967360;2Week : Death World;;0 - 20,000;11;3;8;0;0;4
1967390;Lenny Loosejocks in Space;;0 - 20,000;7;0;7;0;0;0
1967390;Lenny Loosejocks in Space;;0 - 20,000;7;0;7;0;0;0
1967400;MasterQ;;0 - 20,000;3;1;2;0;0;0
1967450;捉妖物语/Monster Girl;;20,000 - 50,000;376;75;301;26;26;3
1967480;One Many Nobody;;0 - 20,000;25;0;25;0;0;2
1967510;Railbound;;20,000 - 50,000;710;20;690;535;773;25
1967520;Ski3;;0 - 20,000;2;0;2;0;0;0
1967550;Heroes of Rome 2 - The Revenge of Discordia;;0 - 20,000;1;0;1;0;0;1
1967620;Tuk Tuk Extreme Simulator;;0 - 20,000;39;16;23;0;0;0
1967670;Northland Heroes - The missing druid;;0 - 20,000;1;0;1;0;0;0
1967830;武儒绘卷 - 天地奇缘;;0 - 20,000;1;8;-7;0;0;0
1967840;Eshe's Wish Adventure;;0 - 20,000;5;0;5;0;0;0
1967920;Krystals with A K;;0 - 20,000;2;1;1;0;0;0
1967950;Moi Mei: Hidden Objects;;0 - 20,000;14;1;13;0;0;1
1968140;The Flames;;0 - 20,000;1;2;-1;0;0;0
1968270;Corridor Sigma;;0 - 20,000;3;0;3;0;0;0
1968280;AvatarShop;;0 - 20,000;1;1;0;0;0;0
1968300;Ambushed;;0 - 20,000;6;2;4;0;0;0
1968320;Relapse;;0 - 20,000;137;13;124;0;0;4
1968330;The Trasamire Campaigns;;0 - 20,000;7;0;7;0;0;1
1968340;Project Gunship;;0 - 20,000;224;39;185;25;25;1
1968500;Super Asqr;;20,000 - 50,000;2;1;1;0;0;0
1968520;Unknown;;0 - 20,000;1;0;1;0;0;0
1968530;Bounda;;0 - 20,000;1;0;1;0;0;0
1968540;Crafting Town;;0 - 20,000;35;9;26;0;0;0
1968570;The Quintessential Quintuplets OMOIDE VR ~ITSUKI~;;0 - 20,000;16;2;14;0;0;3
1968600;Lander Odyssey;;0 - 20,000;12;2;10;0;0;0
1968650;DesktopMMD4:Born to Dance;;0 - 20,000;144;32;112;0;0;23
1968730;Bounty of One;;100,000 - 200,000;1097;150;947;552;867;350
1968790;Alkali;;0 - 20,000;14;0;14;0;0;3
1968810;Meteor Blasters;;0 - 20,000;7;0;7;0;0;0
1968870;Fix Me Up - Hospital Edition;;0 - 20,000;6;6;0;0;0;0
1968880;Art Mahjong 4;;0 - 20,000;2;0;2;0;0;0
1969060;Path of the Midnight Sun;;0 - 20,000;76;9;67;0;0;7
1969080;A Building Full of Cats;;20,000 - 50,000;2052;21;2031;94;117;19
1969100;MIGHT'N MOW'EM;;0 - 20,000;81;28;53;0;0;6
1969140;Deep;;0 - 20,000;7;1;6;0;0;0
1969180;What was;;0 - 20,000;0;1;-1;0;0;0
1969230;Tirsy's Tale;;20,000 - 50,000;3;0;3;0;0;0
1969260;Ewephoria;;0 - 20,000;1;0;1;0;0;0
1969320;Elena's Journal - Unfinished Expedition;;0 - 20,000;10;0;10;0;0;3
1969410;戦乙女 ikusaotome;;0 - 20,000;0;1;-1;0;0;0
1969420;The Struggle of Combat;;0 - 20,000;5;0;5;0;0;0
1969430;Desert Revenant;;0 - 20,000;24;4;20;0;0;0
1969460;Joyride;;0 - 20,000;4;2;2;0;0;0
1969530;Paranormal Preparatory School;;0 - 20,000;11;6;5;0;0;16
1969620;Your Computer Might Be At Risk;;20,000 - 50,000;5;0;5;0;0;0
1969720;Delta Manifold;;0 - 20,000;20;1;19;0;0;0
1969740;Aqorel;;0 - 20,000;6;12;-6;0;0;1
1969790;Capture Note;;0 - 20,000;0;2;-2;0;0;0
1969820;Legacy of Sin blood oath;;0 - 20,000;24;2;22;0;0;0
1969830;Dadish 3;;0 - 20,000;25;4;21;0;0;0
1969840;RoastTogether;;0 - 20,000;5;1;4;0;0;0
1969850;Downpurr;;0 - 20,000;26;0;26;0;0;0
1969910;Some Synergy;;0 - 20,000;7;0;7;0;0;0
1969930;Decisive Strike;;100,000 - 200,000;0;1;-1;0;0;0
1970010;Light Bringer;;0 - 20,000;13;1;12;0;0;0
1970060;Tomboy Adventure;;0 - 20,000;40;2;38;0;0;1
1970210;Connected Hearts: Fortune Play Collector's Edition;;0 - 20,000;3;0;3;0;0;1
1970300;Whisper Books;;50,000 - 100,000;34;6;28;0;0;1
1970460;Garden Galaxy;;0 - 20,000;393;10;383;0;0;78
1970510;Missing Persons;;0 - 20,000;1;9;-8;0;0;0
1970520;Brave Survivor;;0 - 20,000;11;4;7;0;0;1
1970530;Long Journey;;0 - 20,000;36;25;11;0;0;0
1970540;CARDMON;;0 - 20,000;20;3;17;0;0;0
1970560;Bobbi Adventure;;20,000 - 50,000;56;29;27;0;0;0
1970580;Backpack Hero;;200,000 - 500,000;2603;259;2344;444;546;469
1970590;Fearless Rider;;0 - 20,000;2;3;-1;0;0;0
1970610;Duterra;;200,000 - 500,000;1;0;1;0;0;0
1970620;Murdo's Quest;;0 - 20,000;1;1;0;0;0;0
1970670;Conditus;;0 - 20,000;1;0;1;0;0;0
1970700;CowboysShowdown;;0 - 20,000;11;3;8;0;0;1
1970730;BeachRun;;0 - 20,000;10;0;10;0;0;0
1970740;Magic War;;0 - 20,000;10;2;8;0;0;0
1970750;SpearFrog;;0 - 20,000;10;2;8;0;0;0
1970770;Purrate Adventure: Volcano Isle;;0 - 20,000;4;0;4;0;0;0
1970820;EvoMon;;0 - 20,000;24;2;22;0;0;1
1970850;The Rhythm of the Knight;;0 - 20,000;3;0;3;0;0;0
1970910;Escape Jump;;0 - 20,000;0;1;-1;0;0;0
1970970;TDS - War Games;;0 - 20,000;2;0;2;0;0;0
1970980;Warlord: Britannia;;20,000 - 50,000;914;99;815;538;538;24
1971100;絶叫死人（Zombie Scream）;;0 - 20,000;22;8;14;0;0;1
1971190;风墓战记;;20,000 - 50,000;17;0;17;0;0;0
1971190;风墓战记;;20,000 - 50,000;17;0;17;0;0;0
1971260;Olgob The Bold;;0 - 20,000;15;1;14;0;0;2
1971330;Stonegeon 迷石地牢;;0 - 20,000;5;4;1;0;0;0
1971360;Fruit farmer;;0 - 20,000;4;2;2;0;0;0
1971380;Letux Game;;0 - 20,000;1;0;1;0;0;0
1971400;사괴야행;;0 - 20,000;16;0;16;0;0;1
1971690;The Orb of Darkness;;0 - 20,000;2;0;2;0;0;0
1971730;Put Your Brain On;;0 - 20,000;18;3;15;0;0;0
1971750;New Year's Eve Miracle;;0 - 20,000;5;0;5;0;0;0
1971770;Wandering in space VR;;50,000 - 100,000;127;23;104;0;0;0
1971790;Uligo: A Slime's Hike;;0 - 20,000;11;3;8;0;0;1
1971810;Mawthorne;;0 - 20,000;0;2;-2;0;0;0
1971820;Miner of Minerals;;0 - 20,000;11;12;-1;0;0;0
1971880;Whispered Secrets: Tying the Knot Collector's Edition;;0 - 20,000;1;0;1;0;0;0
1971930;tiltfire;;0 - 20,000;4;0;4;0;0;0
1971980;Grey Eyes of Death;;0 - 20,000;3;7;-4;0;0;1
1972160;Virtual Hunting Experience;;0 - 20,000;3;0;3;0;0;0
1972190;Animal Trail ☆ Girlish Square;;0 - 20,000;25;1;24;0;0;0
1972200;Link The Cubes;;0 - 20,000;17;1;16;0;0;0
1972360;Cryptr;;0 - 20,000;10;2;8;0;0;0
1972400;Package Rush;;0 - 20,000;20;2;18;0;0;0
1972410;Siege of Dungeon;;20,000 - 50,000;119;10;109;0;0;19
1972440;Shotgun King: The Final Checkmate;;100,000 - 200,000;3083;202;2881;88;116;143
1972460;Portobugia;;0 - 20,000;6;1;5;0;0;1
1972550;paradise of desire;;0 - 20,000;63;22;41;0;0;4
1972590;M87;;0 - 20,000;2;1;1;0;0;0
1972710;Ever Seen A Cat? 2;;0 - 20,000;263;4;259;0;0;0
1972740;Lit Up;;0 - 20,000;34;0;34;0;0;0
1972830;Molecule Make Lab;;0 - 20,000;18;2;16;0;0;0
1972880;Lamoneo;;0 - 20,000;12;0;12;0;0;0
1972910;修仙者黎明;;0 - 20,000;4;10;-6;0;0;0
1972990;Armor Girl Simulator;;0 - 20,000;2;0;2;0;0;0
1973010;Kid Ball Adventure;;0 - 20,000;26;0;26;0;0;0
1973090;Ukraine Defender;;0 - 20,000;5;0;5;0;0;0
1973130;Island of Aito;;0 - 20,000;12;1;11;0;0;1
1973170;She is mad : Fairies must die;;0 - 20,000;1;2;-1;0;0;0
1973240;Dominate - Board Game;;0 - 20,000;4;0;4;0;0;0
1973250;Hexxagon - Board Game;;0 - 20,000;2;0;2;0;0;0
1973260;MazezaM - Puzzle Game;;0 - 20,000;4;0;4;0;0;0
1973270;Push the Box - Puzzle Game;;0 - 20,000;1;0;1;0;0;1
1973270;Push the Box - Puzzle Game;;0 - 20,000;1;0;1;0;0;1
1973320;Road Defense: Outsiders;;0 - 20,000;55;10;45;0;0;2
1973360;ThanksTaking;;0 - 20,000;1;0;1;0;0;0
1973470;Before The Kingdom Falls;;0 - 20,000;0;1;-1;0;0;0
1973600;My Naughty Summer Vacation ~Days in Countryside and Memories of Summer~;;0 - 20,000;10;3;7;0;0;0
1973610;建安外史 The Tales of Jian An;;0 - 20,000;100;19;81;0;0;10
1973620;Go To Heck;;0 - 20,000;2;0;2;0;0;0
1973670;1001 Jigsaw. Home Sweet Home 3;;0 - 20,000;2;0;2;0;0;0
1973680;1001 Jigsaw. Legends of Mystery 6;;0 - 20,000;3;0;3;0;0;0
1973700;Lianhai Casino;;0 - 20,000;73;5;68;0;0;1
1973730;Sheep in Dreams;;0 - 20,000;26;14;12;0;0;3
1973800;出发吧冒险家;;0 - 20,000;2;1;1;0;0;0
1973840;Space Bees 太空蜜蜂;;0 - 20,000;6;2;4;0;0;0
1974010;Running Over Zombies;;0 - 20,000;5;0;5;0;0;0
1974040;The Questing;;0 - 20,000;4;1;3;0;0;0
1974110;WestFallen;;0 - 20,000;1;0;1;0;0;0
1974310;Airport Administrator Simulator;;0 - 20,000;23;3;20;0;0;0
1974320;Colors! Platform;;0 - 20,000;36;2;34;0;0;2
1974510;Beanstalk;;0 - 20,000;3;1;2;0;0;0
1975080;여동생 ♡ 만들기 : 당신이 바라는 소녀의 모습 - Teen version;;0 - 20,000;0;0;0;0;0;0
1975100;Playback Trauma: In Sickness;;0 - 20,000;1;0;1;0;0;0
1975160;Be;;0 - 20,000;21;2;19;0;0;0
1975180;The Night of the Scissors;;0 - 20,000;242;5;237;0;0;1
1975290;Tomorrow for Mar;;0 - 20,000;15;0;15;0;0;1
1975320;Kronos: Titan of Time;;0 - 20,000;36;13;23;0;0;2
1975340;HAITENAI RPG;;0 - 20,000;79;30;49;0;0;3
1975360;DRAINUS;;0 - 20,000;569;21;548;0;0;1
1975370;Snipe Hunt;;0 - 20,000;16;16;0;0;0;0
1975420;Othello：Daynight Time Clash;;0 - 20,000;86;38;48;0;0;0
1975450;Aery - Vikings;;0 - 20,000;17;0;17;0;0;0
1975530;Choice of the Viking;;0 - 20,000;5;4;1;0;0;1
1975550;Skystrike: Wings of Justice;;0 - 20,000;3;2;1;0;0;0
1975570;Cricket Captain 2022;;0 - 20,000;20;9;11;0;0;48
1975660;Space Tail: Every Journey Leads Home;;0 - 20,000;57;4;53;0;0;2
1975670;White Lavender;;0 - 20,000;97;7;90;65;65;1
1975730;Grimhunt;;0 - 20,000;4;3;1;0;0;0
1975810;Girls' civilization 3;;0 - 20,000;4;2;2;0;0;0
1975860;Drift Type C;;100,000 - 200,000;0;1;-1;0;0;0
1975890;Alone;;0 - 20,000;4;0;4;0;0;0
1976130;KickNSlap;;0 - 20,000;15;9;6;0;0;0
1976180;Rhythm Knights: Double Treble;;0 - 20,000;3;2;1;0;0;0
1976240;Dreams of Pain;;100,000 - 200,000;4;0;4;0;0;0
1976450;MeiQi:Story;;0 - 20,000;16;0;16;0;0;0
1976590;Eternal Space;;20,000 - 50,000;0;1;-1;0;0;0
1976590;Eternal Space;;20,000 - 50,000;0;1;-1;0;0;0
1976800;不可能犯罪事件簿-Impossible Crime Book;;0 - 20,000;4;4;0;0;0;0
1976850;魔法书起源(Origin of the magic book);;0 - 20,000;1;0;1;0;0;0
1977110;Line Path;;0 - 20,000;106;2;104;0;0;0
1977190;Happy Hops;;0 - 20,000;8;0;8;0;0;0
1977230;Ralph's party RPG;;50,000 - 100,000;6;2;4;0;0;5
1977250;Aery - Last Day of Earth;;0 - 20,000;18;0;18;0;0;0
1977270;Super Indiemania;;20,000 - 50,000;4;0;4;0;0;0
1977280;School Bus Driver Simulator;;0 - 20,000;21;12;9;0;0;0
1977360;Chords Enchanter;;0 - 20,000;21;4;17;0;0;0
1977550;Under Waves;;0 - 20,000;2;0;2;0;0;0
1977640;Twogether: Project Indigos Chapter 1;;0 - 20,000;4;1;3;0;0;0
1977640;Twogether: Project Indigos Chapter 1;;0 - 20,000;4;1;3;0;0;0
1977750;HoverRider;;0 - 20,000;2;2;0;0;0;0
1977840;HyperNova;;0 - 20,000;3;0;3;0;0;0
1977900;Bonza Boom;;0 - 20,000;12;3;9;0;0;3
1977910;Shinonome;;0 - 20,000;19;4;15;0;0;7
1978010;Red Valley;;0 - 20,000;63;11;52;0;0;0
1978080;Is It You?;;0 - 20,000;13;0;13;0;0;9
1978100;Grand Prix Story;;0 - 20,000;47;2;45;207;207;10
1978110;HUMDLE;;0 - 20,000;1;1;0;0;0;0
1978180;Charlotte: Dragon Slayer;;50,000 - 100,000;2;4;-2;0;0;0
1978200;Jumping Jack;;0 - 20,000;1;0;1;0;0;0
1978330;Life Gallery;;0 - 20,000;109;16;93;0;0;5
1978380;Rival Rides;;0 - 20,000;10;1;9;0;0;0
1978460;Death's Playground;;20,000 - 50,000;17;0;17;0;0;0
1978490;Pixel drawing block;;0 - 20,000;1;2;-1;0;0;0
1978500;月圆之堡 Castle of Full Moon;;50,000 - 100,000;24;1;23;0;0;0
1978520;Heartless;;50,000 - 100,000;4;4;0;0;0;0
1978580;SGS Operation Downfall;;0 - 20,000;9;3;6;0;0;0
1978650;Blickel;;0 - 20,000;1;0;1;0;0;0
1978750;PH0B0S;;20,000 - 50,000;6;0;6;0;0;0
1978790;Naxos;;0 - 20,000;26;5;21;0;0;0
1978890;Cartographer;;20,000 - 50,000;2;0;2;0;0;0
1978900;Defying Fate;;20,000 - 50,000;1;0;1;0;0;0
1978920;Bean Story;;0 - 20,000;5;2;3;0;0;0
1979120;烛光迷局 Candlelight;;20,000 - 50,000;38;1;37;0;0;0
1979190;Finding America: The Heartland;;0 - 20,000;1;1;0;0;0;0
1979300;Village Guardians;;0 - 20,000;2;0;2;0;0;0
1979320;Amber City;;0 - 20,000;36;0;36;0;0;1
1979340;Anihance;;0 - 20,000;3;0;3;0;0;1
1979390;King;;0 - 20,000;0;2;-2;0;0;0
1979430;Dreadful Hours;;0 - 20,000;1;1;0;0;0;0
1979460;Sinister Night;;0 - 20,000;105;62;43;116;116;1
1979470;Spacewing War;;0 - 20,000;3;0;3;0;0;0
1979480;Garbage Collect;;0 - 20,000;2;0;2;0;0;0
1979550;Doorman;;0 - 20,000;2;3;-1;0;0;0
1979590;Lunaela;;0 - 20,000;10;0;10;0;0;0
1979610;The FED;;0 - 20,000;1;0;1;0;0;0
1979700;Logica Emotica;;0 - 20,000;11;1;10;0;0;0
1979850;Eternal Samurai;;0 - 20,000;7;0;7;0;0;0
1979990;Galactic Escape;;0 - 20,000;2;0;2;0;0;0
1980000;Made Beaver;;0 - 20,000;2;0;2;0;0;0
1980350;Run Build Pew!;;20,000 - 50,000;330;99;231;219;219;8
1980440;Versus.;;0 - 20,000;6;5;1;0;0;0
1980470;Fantasy Background Generator;;0 - 20,000;5;1;4;0;0;0
1980490;Speedway Challenge 2022;;0 - 20,000;51;6;45;0;0;39
1980500;Squarely Blue;;0 - 20,000;1;0;1;0;0;0
1980510;Lunch Tycoon;;0 - 20,000;0;2;-2;0;0;0
1980530;Kiwi Clicker - Juiced Up;;20,000 - 50,000;730;24;706;5752;11281;107
1980570;Grederys;;0 - 20,000;3;5;-2;0;0;0
1980590;Revans;;50,000 - 100,000;19;13;6;0;0;0
1980600;Dueledged;;20,000 - 50,000;2;0;2;0;0;0
1980680;Aurelia: Stellar Arising;;0 - 20,000;2;3;-1;0;0;0
1980770;Floor44;;0 - 20,000;40;36;4;0;0;0
1980780;GOOG;;0 - 20,000;9;3;6;0;0;2
1980860;Goofy Man;;0 - 20,000;2;0;2;0;0;0
1980890;Sky in your eyes;;0 - 20,000;39;6;33;0;0;0
1980930;S&M: FL;;0 - 20,000;1;1;0;0;0;0
1980980;The Backroom Project;;0 - 20,000;93;30;63;0;0;0
1980980;The Backroom Project;;0 - 20,000;93;30;63;0;0;0
1981000;Vintage Records from Hell;;0 - 20,000;6;1;5;0;0;0
1981010;Space Survival;;0 - 20,000;5;1;4;0;0;0
1981370;Down the Drain;;0 - 20,000;4;1;3;0;0;0
1981370;Down the Drain;;0 - 20,000;4;1;3;0;0;0
1981480;Thrill Penguin;;0 - 20,000;31;1;30;0;0;1
1981500;Archmage Ricka;;0 - 20,000;91;11;80;0;0;0
1981530;StressTest;;20,000 - 50,000;0;1;-1;0;0;0
1981540;Penetrator;;0 - 20,000;1;1;0;0;0;0
1981570;Land of the Vikings;;20,000 - 50,000;731;134;597;4626;4626;79
1981590;Batho[tel];;0 - 20,000;13;4;9;0;0;0
1981610;Wanted: Dead;;20,000 - 50,000;174;148;26;2055;2055;47
1981700;Jacob's Quest;;50,000 - 100,000;4;1;3;0;0;1
1981740;Palmas;;0 - 20,000;4;0;4;0;0;0
1981780;FAMILY BATTLE タッグアリーナ;;0 - 20,000;5;4;1;0;0;9
1981860;Green Diver;;0 - 20,000;14;1;13;0;0;0
1982050;Watercolor Hell;;0 - 20,000;3;1;2;0;0;0
1982130;Kraino Origins;;0 - 20,000;31;1;30;0;0;1
1982150;RWBY: Arrowfell;;0 - 20,000;92;38;54;0;0;6
1982180;Trade Sails;;0 - 20,000;8;1;7;0;0;0
1982240;KITBASHERS UNITED;;0 - 20,000;2;0;2;0;0;0
1982310;NeoPiano;;0 - 20,000;35;5;30;0;0;2
1982340;Blanc;;0 - 20,000;120;53;67;170;170;38
1982600;修仙世界;;0 - 20,000;1;3;-2;0;0;0
1982620;Mirror War - Reincarnation of Holiness SA;;0 - 20,000;23;22;1;0;0;2
1982640;Mosaics Galore. Glorious Journey;;0 - 20,000;3;0;3;0;0;0
1982650;Jigsaw Puzzle Beach Season 2;;0 - 20,000;2;0;2;0;0;0
1982660;Royal Jigsaw 2;;0 - 20,000;1;0;1;0;0;0
1982670;Mystery Solitaire Cthulhu Mythos;;0 - 20,000;1;1;0;0;0;1
1982680;Knight Solitaire 3;;0 - 20,000;0;1;-1;0;0;0
1982730;Minion Slayer;;0 - 20,000;6;1;5;0;0;0
1982810;Amanda's Magic Book 4: True Love;;0 - 20,000;3;2;1;0;0;0
1982900;Coding Learn;;0 - 20,000;21;8;13;0;0;0
1982990;纷争之世;;0 - 20,000;4;2;2;0;0;1
1983000;HAYAI;;0 - 20,000;177;2;175;0;0;0
1983020;Caterpillar;;0 - 20,000;3;0;3;0;0;0
1983100;Lost Bits;;0 - 20,000;3;0;3;0;0;0
1983140;Primal Roar - Jurassic Dinosaur Era;;0 - 20,000;3;2;1;0;0;0
1983270;The Days Without Gods;;0 - 20,000;88;10;78;0;0;1
1983330;Exorcist;;20,000 - 50,000;12;14;-2;0;0;0
1983420;LoFi Hotel;;0 - 20,000;31;0;31;0;0;0
1983450;Brave Builder Construct A Climb;;0 - 20,000;2;0;2;0;0;0
1983480;War in Europe: 1940;;0 - 20,000;2;4;-2;0;0;0
1983540;Symmetry Lines;;0 - 20,000;3;0;3;0;0;0
1983550;Volvalis;;0 - 20,000;1;0;1;0;0;0
1983560;Breaking & Entering;;0 - 20,000;1;0;1;0;0;0
1983580;There Swings a Skull: Grim Tidings;;0 - 20,000;40;0;40;0;0;0
1983600;TYPER GIRL;;0 - 20,000;36;19;17;0;0;0
1983670;Cosmopoly;;0 - 20,000;12;2;10;0;0;0
1983690;Forest Camp Story;;0 - 20,000;58;5;53;26;26;16
1983740;Cryptid Coffeehouse;;0 - 20,000;18;1;17;0;0;1
1983780;Chronicle of Forgotten Times: Pawn of the Gods;;0 - 20,000;5;0;5;0;0;0
1984000;Godless grove;;0 - 20,000;0;8;-8;0;0;0
1984030;Vowel Movements;;0 - 20,000;1;0;1;0;0;0
1984110;Goetia 2;;20,000 - 50,000;8;8;0;0;0;1
1984220;Dungeon Fall;;50,000 - 100,000;3;0;3;0;0;0
1984240;Victim;;0 - 20,000;1;1;0;0;0;0
1984260;Baron of Blood;;0 - 20,000;2;0;2;0;0;0
1984390;Crazy shark;;0 - 20,000;7;11;-4;0;0;0
1984400;Pirate fishing;;0 - 20,000;0;1;-1;0;0;0
1984490;CROPPED;;50,000 - 100,000;10;0;10;0;0;0
1984610;Barbaria;;0 - 20,000;73;4;69;0;0;7
1984630;Gone;;50,000 - 100,000;2;1;1;0;0;0
1984710;Synthwave FURY;;0 - 20,000;5;5;0;0;0;0
1984790;Drago Noka;;0 - 20,000;78;11;67;0;0;47
1984810;Gale of Windoria;;0 - 20,000;2;2;0;0;0;0
1984890;The Golden Time in high school;;20,000 - 50,000;0;1;-1;0;0;0
1985150;We are definitely the baddies;;;;;0;;;
1985200;Home Designer - Architecture;;0 - 20,000;5;10;-5;0;0;0
1985240;Putinist Slayer;;0 - 20,000;53;0;53;0;0;0
1985260;Kinkoi: Golden Time;;0 - 20,000;342;8;334;0;0;12
1985350;Pixel Gangsters: Mafia Manager;;0 - 20,000;4;1;3;0;0;1
1985360;Cute Cats 3;;0 - 20,000;34;1;33;0;0;1
1985410;Eger;;0 - 20,000;4;8;-4;0;0;0
1985420;This is a Ghost;;0 - 20,000;175;18;157;163;163;17
1985630;Tom's Adventure;;0 - 20,000;5;0;5;0;0;0
1985930;The Backrooms 1998 - Found Footage Survival Horror Game;;20,000 - 50,000;525;82;443;245;245;3
1985950;Duel Jousting VR;;0 - 20,000;0;1;-1;0;0;0
1986010;灵墟;;20,000 - 50,000;453;66;387;0;0;92
1986010;灵墟;;20,000 - 50,000;453;66;387;0;0;92
1986070;Cook OL;;0 - 20,000;5;6;-1;0;0;1
1986120;Chaste Tris;;0 - 20,000;2;0;2;0;0;0
1986170;Mad Bullz;;0 - 20,000;6;1;5;0;0;0
1986230;What if your girl was a frog?;;0 - 20,000;180;20;160;0;0;2
1986240;Maid PizzaHub;;0 - 20,000;49;6;43;0;0;0
1986250;ヒロイン忍法帖 姫影・ 壱／Pretty Ninja HIMEKAGE_01;;0 - 20,000;4;2;2;0;0;0
1986380;Surflexers;;0 - 20,000;4;1;3;0;0;0
1986430;CARROT: Pancakes and Waffles;;0 - 20,000;4;0;4;0;0;0
1986440;The Finally รักเราชั่วนิรันดร์;;0 - 20,000;7;0;7;0;0;0
1986630;Royal Legends: Raised in Exile Collector's Edition;;0 - 20,000;1;3;-2;0;0;1
1986840;POPGOES Arcade;;20,000 - 50,000;1020;19;1001;0;0;9
1986840;POPGOES Arcade;;20,000 - 50,000;1020;19;1001;0;0;9
1986880;Growing My Grandpa!;;0 - 20,000;209;3;206;0;0;0
1986900;BLOCKED ZONA;;0 - 20,000;70;34;36;0;0;0
1986970;Phone Seller Simulator;;0 - 20,000;1;2;-1;0;0;0
1986980;The Legend of Chibi Ninja;;0 - 20,000;10;0;10;0;0;0
1986990;Knights of the Exploding Table;;0 - 20,000;4;0;4;0;0;0
1987030;Heroes of Time;;50,000 - 100,000;6;2;4;0;0;1
1987040;Jim The Spy;;0 - 20,000;1;0;1;0;0;0
1987040;Jim The Spy;;0 - 20,000;1;0;1;0;0;0
1987050;Metal World: Street Scraps;;0 - 20,000;4;0;4;0;0;0
1987060;The Journey - Episode 2: Words of Wisdom;;0 - 20,000;72;2;70;0;0;0
1987080;Inside the Backrooms;;500,000 - 1,000,000;25653;4389;21264;346;201;1949
1987110;虚幻宇宙：重启;;50,000 - 100,000;1;0;1;0;0;0
1987150;棋物语 Stick Go story;;0 - 20,000;8;1;7;0;0;0
1987160;The Kobolds Left Behind;;0 - 20,000;13;2;11;0;0;1
1987280;Arth Island;;0 - 20,000;2;3;-1;0;0;0
1987330;Cyberpoly;;0 - 20,000;0;2;-2;0;0;0
1987350;Seasons;;0 - 20,000;13;0;13;0;0;1
1987440;PARANECRO;;0 - 20,000;14;6;8;0;0;0
1987450;BYTE CATS;;0 - 20,000;13;1;12;0;0;0
1987490;Save All Monsters!;;0 - 20,000;1;0;1;0;0;0
1987550;Via Mortis;;0 - 20,000;1;2;-1;0;0;0
1987590;Intergalactic Taxi Co.;;0 - 20,000;23;1;22;0;0;0
1987630;1651;;0 - 20,000;1;1;0;0;0;0
1987650;Lone elven wanderer;;0 - 20,000;11;5;6;0;0;0
1987660;Arc Intelligence;;0 - 20,000;1;0;1;0;0;0
1987900;Ante Mortem;;0 - 20,000;5;1;4;0;0;0
1988010;Lightout 2;;20,000 - 50,000;22;15;7;0;0;0
1988020;The Bastonnes;;0 - 20,000;1;0;1;0;0;0
1988030;Rain Ruin;;0 - 20,000;11;7;4;0;0;0
1988050;CAVE VR;;50,000 - 100,000;1;1;0;0;0;0
1988210;Astro Bandits;;0 - 20,000;5;4;1;0;0;0
1988320;SANONTA - Finnish Proverb Game;;0 - 20,000;6;0;6;0;0;0
1988390;Hard landing: Arrival;;0 - 20,000;0;4;-4;0;0;0
1988430;Slaughter Cannon 2;;0 - 20,000;14;6;8;0;0;0
1988440;Block Breaker 2;;0 - 20,000;10;6;4;0;0;0
1988540;The Zachtronics Solitaire Collection;;0 - 20,000;315;4;311;335;335;45
1988570;The Trials Of Beadie;;;;;0;;;
1988670;封妖录;;0 - 20,000;3;0;3;0;0;0
1988730;Nano Organism;;0 - 20,000;2;1;1;0;0;0
1988880;BOX RUSH 2: Ice worlds;;0 - 20,000;69;33;36;0;0;0
1988960;Game Of The Dead;;0 - 20,000;0;2;-2;0;0;0
1988990;Animals Transport Simulator;;0 - 20,000;21;6;15;0;0;0
1989090;Summer Photo Album;;0 - 20,000;12;0;12;0;0;0
1989100;Tomb Defender;;0 - 20,000;0;1;-1;0;0;0
1989130;The Otherwilde;;0 - 20,000;12;3;9;0;0;1
1989140;Tower of Spirit;;0 - 20,000;22;1;21;0;0;0
1989150;Thread;;0 - 20,000;13;1;12;0;0;1
1989180;The World of a Mermaid;;0 - 20,000;18;2;16;0;0;0
1989190;Knight Story;;0 - 20,000;21;12;9;0;0;0
1989200;Space Crafting;;0 - 20,000;17;21;-4;0;0;0
1989280;THE ILLUSION: NIGHTMARE;;0 - 20,000;6;2;4;0;0;0
1989290;Ultimate Starfighter;;0 - 20,000;2;1;1;0;0;0
1989310;Dragon Mine;;0 - 20,000;30;0;30;0;0;0
1989460;Ahack Adventure 2: Quest For The Ciggy;;0 - 20,000;1;1;0;0;0;0
1989560;Endless waves survival;;0 - 20,000;126;40;86;0;0;5
1989610;Knights of Fate;;0 - 20,000;1;1;0;0;0;0
1989620;Reborn Souls;;0 - 20,000;0;1;-1;0;0;0
1989630;That Which Was Lost;;0 - 20,000;1;0;1;0;0;0
1989630;That Which Was Lost;;0 - 20,000;1;0;1;0;0;0
1989640;From Within;;0 - 20,000;2;1;1;0;0;0
1989650;Hearts United;;0 - 20,000;1;0;1;0;0;0
1989680;Airport Service Simulator;;0 - 20,000;1;9;-8;0;0;1
1989740;禁忌taboo;;0 - 20,000;17;1;16;0;0;0
1989780;Tiny Arcade Racers;;0 - 20,000;4;0;4;0;0;0
1989800;Apocalive;;20,000 - 50,000;6;3;3;0;0;0
1989920;白娘子;;0 - 20,000;9;6;3;0;0;1
1989980;Lightfire Defense;;0 - 20,000;2;0;2;0;0;0
1990050;Creature Creator;;20,000 - 50,000;254;27;227;0;0;53
1990060;Unbearable;;0 - 20,000;3;4;-1;0;0;0
1990230;Mysterious Things;;0 - 20,000;3;6;-3;0;0;0
1990260;Phantom Tentacle;;100,000 - 200,000;306;36;270;0;0;0
1990270;Bank Robber;;20,000 - 50,000;15;1;14;0;0;1
1990280;The Killer;;20,000 - 50,000;2;0;2;0;0;0
1990300;Frog Game;;0 - 20,000;1;0;1;0;0;0
1990310;3D PUZZLE - Castle;;0 - 20,000;13;7;6;0;0;0
1990380;Sciophobia: The Fear of Shadows;;0 - 20,000;1;0;1;0;0;0
1990400;Tales of Agaris;;50,000 - 100,000;2;1;1;0;0;1
1990550;Late photographer 5;;0 - 20,000;15;6;9;0;0;0
1990580;异界生存;;0 - 20,000;3;1;2;0;0;0
1990590;Nightmare Hunter;;0 - 20,000;80;11;69;0;0;1
1990610;Nedia Hotel;;0 - 20,000;6;6;0;0;0;0
1990620;Night Escaper;;0 - 20,000;1;0;1;0;0;0
1990670;Vacation Adventures: Cruise Director 6;;0 - 20,000;2;0;2;0;0;0
1990740;Barro GT;;0 - 20,000;96;10;86;0;0;0
1990790;AstraX;;50,000 - 100,000;16;5;11;0;0;0
1990810;Monkey Adventure;;0 - 20,000;11;3;8;0;0;0
1990820;Z-Warp;;0 - 20,000;15;1;14;0;0;0
1990880;Leave No One Behind: Ia Drang VR;;0 - 20,000;6;5;1;0;0;0
1990900;方境战记BlockFight;;0 - 20,000;113;22;91;147;147;2
1990910;Thrice in a row: Last Adventure;;0 - 20,000;9;2;7;0;0;0
1990980;The Siege of Brimir;;0 - 20,000;20;3;17;0;0;0
1991010;Beautiful Ukraine;;0 - 20,000;6;0;6;0;0;0
1991090;Falling Elevator;;0 - 20,000;10;4;6;0;0;1
1991340;Sky Captain's Return;;0 - 20,000;3;0;3;0;0;0
1991360;Dream Walk: Mortgage;;0 - 20,000;2;0;2;0;0;0
1991420;SuperDuck!;;0 - 20,000;2;2;0;0;0;0
1991450;Philosophical Jigsaw - The Zen Koans;;0 - 20,000;20;0;20;0;0;0
1991470;Cold Land;;0 - 20,000;22;1;21;0;0;0
1991590;Guacamojo;;0 - 20,000;1;2;-1;0;0;0
1991630;Blitz in the Paper Kingdom;;0 - 20,000;4;0;4;0;0;0
1991670;Fantasy Fighters;;0 - 20,000;2;2;0;0;0;0
1991780;MIRADOR;;0 - 20,000;4;4;0;0;0;0
1991790;Sudoqube;;0 - 20,000;1;0;1;0;0;0
1991830;Click Lovers;;0 - 20,000;3;10;-7;0;0;2
1991900;Breath of Ghosts;;20,000 - 50,000;12;12;0;0;0;0
1992020;Demons Happened;;0 - 20,000;12;0;12;0;0;1
1992110;FIND YOUR WINGS;;0 - 20,000;7;1;6;0;0;0
1992260;Space Turbo;;0 - 20,000;11;2;9;0;0;0
1992420;格斗少女;;0 - 20,000;1;2;-1;0;0;0
1992480;Robo Legend;;0 - 20,000;1;0;1;0;0;0
1992500;The Life of Arthur;;0 - 20,000;2;0;2;0;0;0
1992530;Party Words;;0 - 20,000;0;2;-2;0;0;0
1992640;Anime vs Evil: Apocalypse;;0 - 20,000;23;3;20;0;0;0
1992940;Realm of Cubes;;20,000 - 50,000;4;2;2;0;0;0
1992980;Pentomino;;0 - 20,000;7;0;7;0;0;0
1993010;Clown Theft Auto: Woke City;;0 - 20,000;14;20;-6;0;0;0
1993030;Clown For Speed;;0 - 20,000;70;11;59;0;0;0
1993060;IMAGO: Beyond the Nightmares;;0 - 20,000;23;2;21;0;0;0
1993120;Death Below;;0 - 20,000;44;23;21;0;0;0
1993140;Shooting girl;;20,000 - 50,000;1;3;-2;0;0;0
1993150;轮回修仙路;;200,000 - 500,000;631;145;486;526;526;153
1993160;GUN BLADE;;0 - 20,000;1;0;1;0;0;0
1993480;Ah Diddums;;0 - 20,000;1;0;1;0;0;0
1993510;Spellarium 8 Match 3 Puzzle;;0 - 20,000;3;0;3;0;0;1
1993520;Seasons;;0 - 20,000;2;0;2;0;0;0
1993530;DEAD ZONE;;0 - 20,000;3;12;-9;0;0;0
1993670;Flappy Butt;;0 - 20,000;2;0;2;0;0;0
1993830;ROTA;;0 - 20,000;11;1;10;0;0;0
1993900;Not Your Mama's Autobattler;;0 - 20,000;6;1;5;0;0;0
1993960;Path of a Player;;0 - 20,000;1;0;1;0;0;0
1994110;Fiefdom;;0 - 20,000;20;13;7;0;0;0
1994270;Eat Fish, Get Achievements;;0 - 20,000;7;0;7;0;0;0
1994300;Mega Demon Blaster;;0 - 20,000;1;0;1;0;0;0
1994350;Stickman Synthwave Escape;;0 - 20,000;3;1;2;0;0;0
1994380;Galactic Liberation;;0 - 20,000;2;4;-2;0;0;0
1994400;MAGITERRA;;0 - 20,000;11;1;10;0;0;1
1994430;Arsolid Productions;;0 - 20,000;3;0;3;0;0;0
1994480;Sword and Shadow;;0 - 20,000;3;4;-1;0;0;0
1994510;Upirja;;20,000 - 50,000;2;0;2;0;0;0
1994520;Akapulka - The Rainbow;;0 - 20,000;3;1;2;0;0;0
1994540;Jacob Larkin's Wild Europe;;0 - 20,000;1;0;1;0;0;0
1994630;2D Brick Breaker Game | REMASTERED;;0 - 20,000;15;3;12;0;0;1
1994680;Cazzarion: Demon Hunting;;0 - 20,000;3;1;2;0;0;0
1994710;Bullet Chase;;0 - 20,000;1;0;1;0;0;0
1994720;Escape From Meat City;;0 - 20,000;18;2;16;0;0;0
1994760;The Fairy's Secret;;0 - 20,000;12;2;10;0;0;3
1994850;Winter tramp;;0 - 20,000;73;30;43;0;0;0
1994860;BoomCrash;;0 - 20,000;12;8;4;0;0;0
1994960;Survive 10 Minutes Please;;0 - 20,000;13;0;13;0;0;1
1995030;Lord of Darkness: Prologue;;0 - 20,000;3;1;2;0;0;0
1995040;Yuonger Adventure;;100,000 - 200,000;13;2;11;0;0;0
1995050;SPLAIT RAGE;;50,000 - 100,000;10;0;10;0;0;0
1995060;Demons Crusher;;50,000 - 100,000;9;3;6;0;0;0
1995070;StoneDEF;;0 - 20,000;11;0;11;0;0;0
1995080;Frog lands;;0 - 20,000;14;5;9;0;0;0
1995080;Frog lands;;0 - 20,000;14;5;9;0;0;0
1995090;STEIIARIA;;50,000 - 100,000;16;3;13;0;0;0
1995100;DouDas Danger;;20,000 - 50,000;11;5;6;0;0;0
1995110;Slime Dungeon;;100,000 - 200,000;12;4;8;0;0;1
1995120;CHICKWEED;;0 - 20,000;15;10;5;0;0;0
1995180;EpicRecovery;;0 - 20,000;7;0;7;0;0;1
1995210;Dark Slime;;50,000 - 100,000;10;1;9;0;0;0
1995220;30 days in red army;;0 - 20,000;2;0;2;0;0;0
1995230;Chaotic Loop;;0 - 20,000;3;0;3;0;0;0
1995240;Deer Journey;;0 - 20,000;27;9;18;0;0;0
1995300;QuickMatrix;;0 - 20,000;10;0;10;0;0;7
1995340;Zoo Chess;;0 - 20,000;1;0;1;0;0;0
1995450;Police Scanner Radio - Real Live Audio - Happening Now!;;0 - 20,000;4;1;3;0;0;0
1995460;FIRE HEAT;;0 - 20,000;11;5;6;0;0;0
1995470;Space Turbo 2;;0 - 20,000;82;37;45;0;0;0
1995490;House of the Soul;;0 - 20,000;3;1;2;0;0;0
1995590;The Block;;0 - 20,000;54;17;37;4;4;1
1995600;Anime Armpits;;0 - 20,000;20;5;15;0;0;2
1995680;Twilight bride :VORMSLEGEND;;20,000 - 50,000;61;4;57;0;0;0
1995760;Dream magic will;;0 - 20,000;12;0;12;0;0;0
1995840;Shadow Angel;;0 - 20,000;7;6;1;0;0;0
1995870;Pixel Survivors : Roguelike;;20,000 - 50,000;220;46;174;547;547;16
1995890;Aerofly FS 4 Flight Simulator;;0 - 20,000;200;41;159;0;0;19
1995940;Jelly Forest;;20,000 - 50,000;11;1;10;0;0;0
1996000;Grid Words;;0 - 20,000;1;0;1;0;0;0
1996210;Sakura Hime 3;;0 - 20,000;223;10;213;9;9;7
1996420;I commissioned some bees;;0 - 20,000;145;6;139;0;0;3
1996570;Eschew;;0 - 20,000;4;0;4;0;0;0
1996600;Byte Lynx;;0 - 20,000;53;1;52;0;0;0
1996710;Sokolor;;0 - 20,000;23;0;23;0;0;2
1996780;Pizza Delivery Bagel;;0 - 20,000;6;1;5;0;0;0
1996800;Bulletkour;;0 - 20,000;6;1;5;0;0;0
1996810;Redemption Cemetery: The Stolen Time Collector's Edition;;0 - 20,000;2;0;2;0;0;1
1997010;Was it a cat I saw?;;0 - 20,000;10;0;10;0;0;0
1997070;HEN, CHICKS AND CATS;;0 - 20,000;20;1;19;0;0;0
1997170;Blitz Roads;;0 - 20,000;0;1;-1;0;0;0
1997270;PUT PUD Nudli's Adventure;;0 - 20,000;5;1;4;0;0;0
1997300;Pretty Girls Escape;;0 - 20,000;17;2;15;0;0;3
1997550;Square Journey;;0 - 20,000;15;0;15;0;0;0
1997790;Soul Night;;0 - 20,000;10;3;7;0;0;2
1997800;Delusional;;0 - 20,000;4;4;0;0;0;0
1997830;GUTTER: The Cursed;;50,000 - 100,000;11;0;11;0;0;0
1997880;Lawnmower game: Mortal Race;;0 - 20,000;25;6;19;0;0;0
1997900;F*ckable Kim;;0 - 20,000;26;4;22;0;0;0
1997910;Breakyo;;0 - 20,000;4;0;4;0;0;0
1997920;Isolania;;0 - 20,000;11;2;9;0;0;1
1998030;Bug Dolls: Soviet Project;;0 - 20,000;28;8;20;0;0;0
1998040;Psycho Reign;;50,000 - 100,000;38;14;24;0;0;0
1998110;Station Osirius;;0 - 20,000;12;4;8;0;0;0
1998120;Pirate treasure;;0 - 20,000;12;6;6;0;0;0
1998130;TOTEMS;;0 - 20,000;11;5;6;0;0;0
1998170;Second Thoughts;;0 - 20,000;50;16;34;0;0;0
1998200;God Edge;;0 - 20,000;7;0;7;0;0;0
1998260;Ancient Aliens: The Game;;0 - 20,000;9;2;7;0;0;7
1998300;Where's Oswald;;0 - 20,000;4;4;0;0;0;0
1998320;Death Bind;;0 - 20,000;3;0;3;0;0;0
1998330;Yomawari: Lost in the Dark;;0 - 20,000;131;10;121;641;641;10
1998340;Labyrinth of Galleria: The Moon Society;;20,000 - 50,000;64;4;60;0;0;696
1998340;Labyrinth of Galleria: The Moon Society;;20,000 - 50,000;64;4;60;0;0;696
1998380;Crash Forts;;0 - 20,000;11;1;10;0;0;0
1998390;Road Trip;;0 - 20,000;13;17;-4;0;0;0
1998420;Mida's Adventure;;20,000 - 50,000;7;0;7;0;0;0
1998470;Canterz Paranormies;;0 - 20,000;4;1;3;0;0;0
1998530;Yoiyami Dancers: Twilight Danmaku Dancers;;0 - 20,000;312;3;309;0;0;3
1998540;Pumpkin head;;0 - 20,000;1;0;1;0;0;0
1998580;Breath of Ghosts 2;;0 - 20,000;12;14;-2;0;0;0
1998590;Russian Hunter;;0 - 20,000;17;15;2;0;0;0
1998840;Arcadia;;0 - 20,000;1;0;1;0;0;0
1999030;Goddess Of Card War 2;;0 - 20,000;1;2;-1;0;0;0
1999120;Heroes of Time 2 - Aizack's Return;;20,000 - 50,000;1;0;1;0;0;0
1999140;Extraneum;;20,000 - 50,000;28;0;28;0;0;2
1999170;Insect Swarm;;20,000 - 50,000;722;99;623;373;425;102
1999360;Placid Plastic Duck Simulator;;100,000 - 200,000;6358;105;6253;1391;2006;464
1999460;E-ON;;0 - 20,000;3;1;2;0;0;0
1999540;Grimland;;0 - 20,000;1;6;-5;0;0;0
1999700;Something Strange;;0 - 20,000;23;3;20;0;0;1
1999910;Nightmare Hunter;;0 - 20,000;3;0;3;0;0;0
2000000;Round Table;;20,000 - 50,000;0;1;-1;0;0;0
2000040;Space Menace;;0 - 20,000;10;4;6;0;0;2
2000070;Snacky Tower;;0 - 20,000;7;0;7;0;0;0
2000190;SSS222: HyperSpace;;0 - 20,000;1;1;0;0;0;1
2000220;FunnyPizzaLand 2;;0 - 20,000;5;0;5;0;0;0
2000270;Dual Universe;;20,000 - 50,000;252;213;39;0;0;64
2000280;I’m going to die if I don’t eat sushi!;;0 - 20,000;116;3;113;29;29;0
2000300;无路可退;;0 - 20,000;40;1;39;0;0;0
2000360;CORGI;;0 - 20,000;16;5;11;0;0;0
2000460;Seven Spirits;;0 - 20,000;3;0;3;0;0;0
2000480;The Meaning;;0 - 20,000;18;5;13;0;0;0
2000490;Legendary Heroes;;0 - 20,000;1;2;-1;0;0;0
2000540;Chance at Life;;0 - 20,000;35;9;26;0;0;0
2000980;Idle Maku;;0 - 20,000;18;9;9;0;0;3
2001000;Rivalry warlord Sengoku;;0 - 20,000;1;0;1;0;0;0
2001050;三国英雄坛;;0 - 20,000;5;2;3;0;0;0
2001060;Nine Lives or Less;;0 - 20,000;2;1;1;0;0;0
2001140;Putinator;;0 - 20,000;13;0;13;0;0;0
2001190;Zombie Spree: The Dawn;;0 - 20,000;0;1;-1;0;0;0
2001220;Keita's Adventures on the African Savannah;;0 - 20,000;4;0;4;0;0;0
2001280;The Last City;;0 - 20,000;22;10;12;0;0;1
2001300;CANDY EATERS TOURNAMENT;;0 - 20,000;3;4;-1;0;0;0
2001360;Mystical Riddles: Behind Doll’s Eyes Collector's Edition;;50,000 - 100,000;1;1;0;0;0;0
2001460;国際指定怪異123号 廃村;;0 - 20,000;18;2;16;0;0;0
2001570;Yakiniku simulator;;0 - 20,000;269;16;253;0;0;2
2001670;BURST WITCH;;0 - 20,000;22;25;-3;0;0;0
2001680;The Gun Goes;;;;;0;;;
2001690;Super Arkanoid;;0 - 20,000;14;1;13;0;0;0
2001800;Spintales;;0 - 20,000;2;0;2;0;0;0
2001910;Spermination: Cream of the Crop;;0 - 20,000;7;1;6;0;0;0
2001970;Raspberry Cube;;0 - 20,000;36;1;35;0;0;2
2002140;StarMech;;0 - 20,000;12;0;12;0;0;3
2002200;Future Mirror;;20,000 - 50,000;3;1;2;0;0;0
2002250;Death Bowl;;0 - 20,000;6;0;6;0;0;0
2002280;Make It In Time;;0 - 20,000;1;0;1;0;0;0
2002320;Little Town Shooter VR;;0 - 20,000;1;3;-2;0;0;0
2002380;Over City;;0 - 20,000;10;2;8;0;0;1
2002430;♡beAt! -After the Summer-;;0 - 20,000;2;0;2;0;0;0
2002450;停留此刻 Stay in the moment;;0 - 20,000;118;18;100;0;0;0
2002470;Easy Poetry;;0 - 20,000;2;0;2;0;0;0
2002510;SHPR;;0 - 20,000;9;5;4;0;0;0
2002520;Youmandriver;;0 - 20,000;8;1;7;0;0;0
2002550;Chloe Puzzle Game;;0 - 20,000;7;5;2;0;0;0
2002670;Get Trolled;;0 - 20,000;1;0;1;0;0;0
2002700;AI UNDER TEST;;20,000 - 50,000;7;0;7;0;0;0
2002720;CubeShooter;;0 - 20,000;7;2;5;0;0;0
2002790;Midnight Renegade: Recollections;;0 - 20,000;2;1;1;0;0;0
2002850;Raiden IV x MIKADO remix;;0 - 20,000;7;2;5;0;0;1
2003030;Arcade Flight;;0 - 20,000;3;0;3;0;0;0
2003050;Perseus: Titan Slayer;;0 - 20,000;189;46;143;0;0;180
2003090;Saving Sheep;;0 - 20,000;3;2;1;0;0;0
2003200;Castle Reborn;;0 - 20,000;4;12;-8;0;0;0
2003220;TitTok 3;;0 - 20,000;44;2;42;0;0;0
2003260;Shake Ground;;0 - 20,000;0;3;-3;0;0;0
2003270;Smokyflex;;0 - 20,000;10;2;8;0;0;0
2003320;Merge Beasts - Defense Game;;0 - 20,000;0;1;-1;0;0;0
2003350;Plane Attack;;0 - 20,000;4;1;3;0;0;0
2003370;Match Village;;0 - 20,000;23;2;21;0;0;2
2003420;Bonk'd Audio Visualizer;;0 - 20,000;6;0;6;0;0;0
2003550;Alice's Warped Wonderland:REcollection;;0 - 20,000;12;0;12;0;0;0
2003660;Bullet Hell Monday;;0 - 20,000;35;1;34;0;0;1
2003690;Skies Of Blue: Remake;;0 - 20,000;1;0;1;0;0;0
2003730;The Fantasy World of Mahjong Princess: General Version;;0 - 20,000;6;2;4;0;0;0
2003740;茶叶蛋大冒险;;0 - 20,000;33;3;30;0;0;2
2003840;FarmingCat;;20,000 - 50,000;3;2;1;0;0;0
2003870;YOW;;0 - 20,000;2;0;2;0;0;1
2004180;DAGURI: Gambling Apocalypse;;0 - 20,000;52;1;51;0;0;2
2004200;Pickup One;;0 - 20,000;3;4;-1;0;0;0
2004300;Stonkers;;0 - 20,000;1;0;1;0;0;0
2004340;Eternal;;0 - 20,000;3;0;3;0;0;0
2004360;Hell Division;;0 - 20,000;60;6;54;0;0;0
2004370;Sinner 97;;0 - 20,000;24;4;20;0;0;0
2004380;ROD Multiplayer Car Driving;;0 - 20,000;1;1;0;0;0;0
2004430;The Search for Fran 2;;0 - 20,000;16;3;13;0;0;0
2004440;Pocket City;;0 - 20,000;100;3;97;0;0;10
2004520;The Chronicle;;20,000 - 50,000;2;1;1;0;0;0
2004610;A Mage Reborn;;0 - 20,000;66;6;60;0;0;3
2004650;SailSim;;0 - 20,000;4;4;0;0;0;0
2004800;Ink World;;0 - 20,000;9;4;5;0;0;1
2004810;Panda Run;;0 - 20,000;9;0;9;0;0;0
2004940;Crazy Zoo;;0 - 20,000;10;1;9;0;0;1
2004980;Revenge of the Orcs: Flag of Conquest;;0 - 20,000;17;2;15;0;0;0
2005070;Putin Orcs Defender;;0 - 20,000;4;0;4;0;0;0
2005080;Samurai Solitaire. Return of the Ronin;;0 - 20,000;1;0;1;0;0;0
2005150;Tiny Robo Puzzles;;0 - 20,000;3;1;2;0;0;0
2005210;Void Scrappers;;50,000 - 100,000;325;27;298;231;231;22
2005240;Space Shells;;0 - 20,000;6;1;5;0;0;0
2005290;The Farnese Hercules;;0 - 20,000;2;0;2;0;0;0
2005320;Illusion 幻覚;;0 - 20,000;20;0;20;0;0;0
2005370;Drunk Games;;0 - 20,000;6;8;-2;0;0;0
2005380;Mayor T-Rex;;0 - 20,000;14;7;7;0;0;0
2005390;Paper Flight - Super Speed Dash;;0 - 20,000;11;0;11;0;0;0
2005410;Advent Calendar;;0 - 20,000;3;4;-1;0;0;0
2005440;Revived Forest;;0 - 20,000;1;5;-4;0;0;0
2005490;Meat Beating: The Second Coming;;0 - 20,000;3;0;3;0;0;0
2005630;Babysitter Simulator;;0 - 20,000;14;2;12;0;0;0
2005660;Ukraine Defense Force Tactics;;20,000 - 50,000;186;2;184;0;0;0
2005670;Alien Task Force;;0 - 20,000;1;1;0;0;0;0
2005710;Wizcave;;0 - 20,000;4;0;4;0;0;0
2005750;Collapse Relapse;;0 - 20,000;2;1;1;0;0;0
2005790;Gleeb Glob;;0 - 20,000;0;0;0;0;0;0
2005810;Project Sundown;;0 - 20,000;5;2;3;0;0;0
2005930;Boltcraft;;0 - 20,000;2;1;1;0;0;0
2006040;VR CHINESE KUNG FU;;0 - 20,000;2;1;1;0;0;1
2006120;GameZero;;0 - 20,000;1;0;1;0;0;0
2006140;Withering Rooms;;0 - 20,000;55;0;55;0;0;3
2006210;Red Fury;;0 - 20,000;1;2;-1;0;0;0
2006310;我感染HIV了吗;;20,000 - 50,000;4;0;4;0;0;0
2006360;Pizza Death;;0 - 20,000;7;0;7;0;0;0
2006390;Valand;;100,000 - 200,000;35;15;20;0;0;0
2006440;Secret Backrooms;;20,000 - 50,000;9;3;6;0;0;0
2006470;Chronos Builder;;0 - 20,000;12;7;5;0;0;5
2006530;Adventures at the North Pole;;0 - 20,000;13;5;8;0;0;0
2006560;Lockdown VR: Circus of the Dead;;0 - 20,000;4;1;3;0;0;2
2006570;カテゴリーI -死線上のサバイバー-;;0 - 20,000;0;2;-2;0;0;0
2006700;impossiBot;;0 - 20,000;11;1;10;0;0;0
2006730;Godumas;;0 - 20,000;38;21;17;0;0;0
2006770;180 SECONDS;;0 - 20,000;7;0;7;0;0;0
2006830;Maniacs;;0 - 20,000;0;1;-1;0;0;0
2006840;The Horace Trilogy;;0 - 20,000;3;0;3;0;0;0
2007000;Shadow of Asha;;0 - 20,000;7;0;7;0;0;0
2007010;Welcome To The Backrooms;;20,000 - 50,000;12;2;10;0;0;1
2007030;Platformity;;0 - 20,000;18;0;18;0;0;0
2007050;Penguins Can Fly;;0 - 20,000;10;2;8;0;0;0
2007060;垃圾游戏;;0 - 20,000;0;1;-1;0;0;0
2007080;AsteroIdle;;0 - 20,000;3;5;-2;0;0;2
2007180;CandySweet;;0 - 20,000;10;5;5;0;0;1
2007240;Lil' Horror Stories: The Camp Fire;;0 - 20,000;3;0;3;0;0;0
2007270;The Mystery of William Moore;;0 - 20,000;1;3;-2;0;0;0
2007270;The Mystery of William Moore;;0 - 20,000;1;3;-2;0;0;0
2007280;العدم;;0 - 20,000;0;2;-2;0;0;0
2007410;Strange Investigations: Two for Solitaire Collector's Edition;;0 - 20,000;3;0;3;0;0;1
2007470;SEARCH ALL - BIRDS;;0 - 20,000;16;1;15;0;0;0
2007530;Spellbook Demonslayers;;50,000 - 100,000;725;102;623;644;731;68
2007700;Scared Tube;;20,000 - 50,000;14;4;10;0;0;1
2007740;The Roots;;0 - 20,000;0;1;-1;0;0;0
2007840;Desert Things;;0 - 20,000;10;3;7;0;0;1
2007850;City Things;;0 - 20,000;7;3;4;0;0;0
2007930;Fallen Bride Mege;;0 - 20,000;74;41;33;0;0;2
2008010;Succubus Dating;;0 - 20,000;3;15;-12;0;0;0
2008040;Survivor Legends;;0 - 20,000;3;3;0;0;0;0
2008050;Right and Down;;0 - 20,000;123;23;100;0;0;0
2008060;99 Fails Lite;;0 - 20,000;45;4;41;0;0;0
2008110;Rooftop Garden Simulator;;0 - 20,000;5;0;5;0;0;0
2008230;Under Siege;;0 - 20,000;5;9;-4;0;0;0
2008240;Space Theory;;0 - 20,000;1;5;-4;0;0;0
2008330;Lost in Hell;;100,000 - 200,000;5;8;-3;0;0;0
2008350;Crush Them！;;0 - 20,000;6;0;6;0;0;0
2008410;Garfield Lasagna Party;;0 - 20,000;35;10;25;0;0;0
2008460;Infinity War Land;;0 - 20,000;0;3;-3;0;0;0
2008560;วีรบุรุษไร้พลัง ไข่ต้ม;;0 - 20,000;10;0;10;0;0;0
2008600;Who Stole My Sheep?;;0 - 20,000;2;1;1;0;0;0
2008650;Marpi ᵒˢ;;0 - 20,000;1;0;1;0;0;0
2008720;Mailman;;0 - 20,000;12;5;7;0;0;0
2008850;Cube Decider;;0 - 20,000;3;0;3;0;0;0
2008930;Living Legends: Bound by Wishes Collector's Edition;;0 - 20,000;4;1;3;0;0;1
2009340;Defend The Bits TD;;0 - 20,000;36;7;29;0;0;2
2009350;Out of Ore;;20,000 - 50,000;316;81;235;284;560;23
2009380;They Don't Sleep;;0 - 20,000;136;5;131;0;0;1
2009420;Zaxterion: Space Frenzy!;;0 - 20,000;6;1;5;0;0;0
2009460;War of Wizards;;0 - 20,000;29;5;24;0;0;1
2009510;Chess Variants - Omnichess;;0 - 20,000;2;2;0;0;0;0
2009560;Music Man;;0 - 20,000;16;0;16;0;0;2
2009670;Moontrain;;0 - 20,000;4;4;0;0;0;0
2009770;Eternal Pinball RPG;;0 - 20,000;13;3;10;0;0;1
2009840;Plop Saga;;0 - 20,000;7;0;7;0;0;0
2009930;Blade Bros IMPACT!;;0 - 20,000;1;0;1;0;0;0
2010110;QUICKERFLAK_RUTHLESSMOD;;0 - 20,000;36;4;32;0;0;0
2010200;Chuhou Joutai 3: Three Nights of Scarlet Abscess;;50,000 - 100,000;2;0;2;0;0;0
2010220;Slime Jumper Adventure;;0 - 20,000;1;0;1;0;0;0
2010240;FOG;;0 - 20,000;2;0;2;0;0;0
2010310;369;;0 - 20,000;5;1;4;0;0;0
2010320;TitTok Kitty;;0 - 20,000;19;0;19;0;0;1
2010340;TheFighters Online;;0 - 20,000;2;1;1;0;0;2
2010360;Uncharted Space - project 3062;;0 - 20,000;0;1;-1;0;0;0
2010370;The True Love Rings;;0 - 20,000;274;62;212;11;11;4
2010370;The True Love Rings;;0 - 20,000;274;62;212;11;11;4
2010390;Bug Butcher;;20,000 - 50,000;12;14;-2;0;0;0
2010400;Hell Green Blue;;200,000 - 500,000;15;7;8;0;0;0
2010410;Psyolence;;20,000 - 50,000;13;8;5;0;0;0
2010440;Lost Dream: Memories;;0 - 20,000;8;4;4;0;0;0
2010500;Run4YourLight;;0 - 20,000;2;0;2;0;0;0
2010520;Martial Story;;0 - 20,000;3;0;3;0;0;0
2010540;SEARCH ALL - BITCOIN;;0 - 20,000;13;3;10;0;0;0
2010570;Me Alone Reissue;;0 - 20,000;12;13;-1;0;0;0
2010600;Pirates Things;;0 - 20,000;12;3;9;0;0;1
2010700;Hunter Survivors;;0 - 20,000;27;17;10;0;0;2
2010720;MORLUSH;;0 - 20,000;11;4;7;0;0;0
2010740;Roomli;;0 - 20,000;4;0;4;0;0;0
2010830;Your Love Story 被你忘记的那个夏天;;0 - 20,000;116;17;99;0;0;1
2010920;Symphony Of Motion;;0 - 20,000;4;0;4;0;0;0
2010930;TRESPASSER 2;;0 - 20,000;3;1;2;0;0;0
2011010;King Pig;;0 - 20,000;3;0;3;0;0;0
2011030;Atria;;0 - 20,000;4;1;3;0;0;0
2011080;Tawako The Forest Hedgehog;;0 - 20,000;3;1;2;0;0;0
2011130;DonutCrabs;;0 - 20,000;13;10;3;0;0;0
2011140;Art your brains;;0 - 20,000;9;4;5;0;0;0
2011160;Puzzles with nature;;0 - 20,000;11;1;10;0;0;0
2011190;Doodle Drive;;0 - 20,000;3;0;3;0;0;0
2011470;大侠请重来;;100,000 - 200,000;2140;530;1610;0;0;3
2011480;Paranoya;;0 - 20,000;2;1;1;0;0;0
2011520;Goddess Of War Essa Ⅱ;;0 - 20,000;0;2;-2;0;0;0
2011610;MAZE RUNNER;;0 - 20,000;0;1;-1;0;0;0
2011640;死亡旅店Ⅱ亡者归来-Death Inn Ⅱ The Immortal Is Coming;;20,000 - 50,000;6;1;5;0;0;0
2011650;Spiritus:One;;0 - 20,000;1;1;0;0;0;0
2011730;Long Drop;;0 - 20,000;7;1;6;0;0;0
2011750;Silver Lines;;0 - 20,000;1;0;1;0;0;0
2011860;Refund Me If You Can;;0 - 20,000;91;26;65;0;0;0
2011900;Zero Wing;;0 - 20,000;13;1;12;0;0;5
2012020;Dis Pontibus 2;;0 - 20,000;4;0;4;0;0;0
2012100;WHAT THE BAT?;;0 - 20,000;28;6;22;0;0;1
2012140;Helicopter Gunship DEX;;0 - 20,000;31;6;25;0;0;1
2012160;Stranded Nightmare;;0 - 20,000;58;5;53;0;0;0
2012170;Ashzel & The Power Dagger;;0 - 20,000;0;1;-1;0;0;0
2012420;Under Siege 2;;0 - 20,000;2;2;0;0;0;0
2012500;The Katydids Incident;;50,000 - 100,000;30;0;30;0;0;0
2012520;Aero Striker - World Invasion;;0 - 20,000;16;2;14;0;0;0
2012570;ZOSU VR Explosive Bow Hunting;;0 - 20,000;3;3;0;0;0;0
2012610;Age of Undead;;0 - 20,000;36;10;26;0;0;0
2012630;A Pact With Me - Boys Love (BL) Visual Novel;;0 - 20,000;10;0;10;0;0;0
2012690;Before the explosion;;0 - 20,000;14;0;14;0;0;0
2012790;Mini Star Fishing;;0 - 20,000;5;2;3;0;0;0
2012830;边缘世界 Edge Worlds;;0 - 20,000;1;1;0;0;0;0
2012890;Dungeon Liberator;;0 - 20,000;0;2;-2;0;0;0
2012910;嗜憶 Swallow;;0 - 20,000;21;5;16;0;0;1
2012990;Boxman Adventures;;0 - 20,000;1;0;1;0;0;0
2013010;Blood Scheme;;0 - 20,000;0;2;-2;0;0;0
2013080;Unders_core;;0 - 20,000;16;3;13;0;0;3
2013150;BUBBLE NIGHT;;0 - 20,000;9;0;9;0;0;0
2013270;骸亡禁决：Skeleton King;;50,000 - 100,000;0;3;-3;0;0;0
2013300;Alien Shooter 2 - New Era;;20,000 - 50,000;88;80;8;0;0;3
2013330;BTank;;0 - 20,000;9;1;8;0;0;1
2013360;The Oregon Trail;;0 - 20,000;288;89;199;302;302;157
2013480;Mugsy & Mugsy's Revenge;;0 - 20,000;2;0;2;0;0;0
2013580;XP Soccer;;0 - 20,000;69;11;58;0;0;3
2013610;Animals;;0 - 20,000;3;6;-3;0;0;0
2013650;Logicality;;0 - 20,000;30;7;23;0;0;1
2013720;Retrowave Rider;;0 - 20,000;7;0;7;0;0;0
2013740;Underwater World - Idle Desktop Colony Building Simulator;;0 - 20,000;15;5;10;0;0;0
2013770;Worker Riot;;0 - 20,000;14;3;11;0;0;0
2013800;Pedro Land DX;;0 - 20,000;3;1;2;0;0;0
2013870;Idle Hero;;0 - 20,000;6;11;-5;0;0;2
2013900;100 hidden turtles;;0 - 20,000;159;4;155;0;0;1
2013970;Bots Crusher Arena;;0 - 20,000;10;1;9;0;0;0
2013990;Villwars;;0 - 20,000;14;4;10;0;0;0
2014180;大分・別府ミステリー案内  歪んだ竹灯篭;;0 - 20,000;2;0;2;0;0;0
2014220;Game Cycle;;0 - 20,000;3;0;3;0;0;0
2014370;魔塔三国之群雄争霸;;0 - 20,000;46;5;41;0;0;2
2014410;Sword King;;0 - 20,000;0;1;-1;0;0;0
2014510;COLORIDER;;0 - 20,000;0;2;-2;0;0;0
2014560;Birds Are Real;;0 - 20,000;0;1;-1;0;0;0
2014610;Crazy Traffic Racer;;0 - 20,000;6;0;6;0;0;0
2014650;PHOBOS Project;;20,000 - 50,000;7;2;5;0;0;0
2014750;Gilligan's Gold;;0 - 20,000;2;0;2;0;0;0
2014780;X-Plane 12;;20,000 - 50,000;771;254;517;185;296;196
2014870;EXECUTE DADDY～パパが何度も死ぬゲーム～;;0 - 20,000;21;0;21;0;0;0
2014930;A Last Will and TESTament: Horror adventure;;0 - 20,000;37;13;24;0;0;2
2014950;Leave a Light;;0 - 20,000;1;0;1;0;0;0
2014990;Exhale XR | VR Wellness;;0 - 20,000;4;2;2;0;0;0
2015110;Nightmare Slash;;0 - 20,000;1;0;1;0;0;0
2015120;Madman Catcher;;0 - 20,000;4;2;2;0;0;0
2015170;Bad Chicken;;0 - 20,000;2;0;2;0;0;0
2015200;Grot Slasher;;0 - 20,000;9;6;3;0;0;0
2015260;Rich Taste of Ecchi;;20,000 - 50,000;14;3;11;0;0;0
2015430;Jigoku Unko: Toripuru;;0 - 20,000;1;9;-8;0;0;0
2015460;Flip of Light;;0 - 20,000;6;0;6;0;0;0
2015500;Hatup;;0 - 20,000;39;4;35;0;0;0
2015610;Blood Hospital;;20,000 - 50,000;4;1;3;0;0;0
2015610;Blood Hospital;;20,000 - 50,000;4;1;3;0;0;0
2015620;Valkyrie of Phantasm;;0 - 20,000;342;53;289;0;0;2
2015650;Disembowel;;0 - 20,000;25;35;-10;0;0;1
2015700;东方心之解束~Saving from the devil;;0 - 20,000;72;1;71;0;0;0
2015740;SnailQuest;;0 - 20,000;3;1;2;0;0;0
2015860;江湖百异图;;20,000 - 50,000;29;22;7;0;0;10
2016110;Blaze in Space: Beat a-Maze;;50,000 - 100,000;17;0;17;0;0;0
2016140;Obelixes Tower Defense;;0 - 20,000;11;3;8;0;0;0
2016210;Knights of the Kitchen Table;;0 - 20,000;3;0;3;0;0;0
2016220;EarthRoyale;;0 - 20,000;93;7;86;0;0;10
2016230;Puzzle World: Cute Monsters;;0 - 20,000;9;2;7;0;0;0
2016240;Winter Things;;0 - 20,000;11;8;3;0;0;0
2016290;The Cute Fighter;;0 - 20,000;1;0;1;0;0;0
2016370;Adorable Witch 4 ：Lust;;0 - 20,000;308;53;255;19;19;3
2016470;Against All Odds;;0 - 20,000;3;0;3;0;0;0
2016540;Chess Pills;;0 - 20,000;26;0;26;0;0;0
2016580;Deneb: Across the Stars;;0 - 20,000;22;2;20;0;0;0
2016600;Vikindor;;0 - 20,000;0;3;-3;0;0;0
2016610;Heavenly Puzzle;;0 - 20,000;4;1;3;0;0;0
2016650;Hot Speed;;0 - 20,000;5;2;3;0;0;0
2016840;Al Andalus 711: Epic history battle game;;20,000 - 50,000;2;2;0;0;0;0
2016960;STREAM WAR;;0 - 20,000;0;1;-1;0;0;0
2016980;Highway Driving;;0 - 20,000;1;0;1;0;0;0
2017000;VAR paradise lifetime VIP;;0 - 20,000;1;1;0;0;0;0
2017020;Cowboy Girl;;0 - 20,000;15;3;12;0;0;0
2017060;Para-Lax;;0 - 20,000;1;1;0;0;0;0
2017270;Pixel Samurai;;0 - 20,000;74;4;70;0;0;0
2017330;Blocked!;;0 - 20,000;1;0;1;0;0;0
2017370;Trash Horror Collection;;0 - 20,000;260;11;249;0;0;2
2017380;Gomorrah;;100,000 - 200,000;0;2;-2;0;0;0
2017460;Paperback Vol. 2;;0 - 20,000;4;1;3;0;0;1
2017600;鬼人偶/Ghost Doll;;0 - 20,000;4;2;2;0;0;0
2017630;Hero of war;;0 - 20,000;12;1;11;0;0;0
2017640;Sakura Gym Girls;;0 - 20,000;5;2;3;0;0;0
2017730;The Chicken Game;;0 - 20,000;5;2;3;0;0;0
2017840;Kit's Quest;;0 - 20,000;10;0;10;0;0;1
2017890;My Dream is a Lost Memory;;0 - 20,000;114;11;103;0;0;0
2017980;Haunted Mansion;;50,000 - 100,000;1;3;-2;0;0;0
2018130;Desktopia: A Desktop Village Simulator;;0 - 20,000;133;39;94;134;178;2
2018140;LEEN;;0 - 20,000;8;0;8;0;0;0
2018190;River Raid 3D;;0 - 20,000;1;2;-1;0;0;0
2018220;TOTO Quest;;0 - 20,000;10;3;7;0;0;0
2018250;SMUTA: Inception;;0 - 20,000;21;13;8;0;0;0
2018260;DUCK Mission;;50,000 - 100,000;11;3;8;0;0;0
2018270;Ragedanger Earth;;50,000 - 100,000;13;3;10;0;0;0
2018280;CAR DESTROYER;;0 - 20,000;11;6;5;0;0;0
2018320;War Tanks;;0 - 20,000;2;2;0;0;0;0
2018380;Neon Invaders;;20,000 - 50,000;4;1;3;0;0;0
2018540;Rally Car;;0 - 20,000;3;5;-2;0;0;0
2018610;Violet Wisteria;;0 - 20,000;13;1;12;0;0;1
2018810;Mello Haunted House;;0 - 20,000;1;0;1;0;0;0
2018850;Fire Truck Simulator;;0 - 20,000;13;6;7;0;0;0
2018900;Big Flying Asteroid;;0 - 20,000;1;1;0;0;0;0
2019050;Privateer Escape;;0 - 20,000;1;0;1;0;0;0
2019360;World Cruise Story;;0 - 20,000;28;1;27;0;0;11
2019370;Oh! Edo Towns;;0 - 20,000;42;2;40;0;0;7
2019380;Pocket Harvest;;0 - 20,000;18;1;17;0;0;18
2019630;Storekeeper Revenge;;0 - 20,000;10;3;7;0;0;0
2019650;The Snow Fable: Mystery of the Flame;;0 - 20,000;5;1;4;0;0;1
2019670;Solo War Medieval;;0 - 20,000;3;3;0;0;0;0
2019710;Gift from the Gods;;0 - 20,000;4;0;4;0;0;0
2019840;Atama;;0 - 20,000;27;2;25;0;0;0
2019920;Food Factory;;0 - 20,000;25;7;18;0;0;1
2019990;Yars: Recharged;;50,000 - 100,000;45;3;42;0;0;1
2019990;Yars: Recharged;;50,000 - 100,000;45;3;42;0;0;1
2020080;Chess Dungeons;;0 - 20,000;15;2;13;0;0;1
2020090;Space Eating Croc;;0 - 20,000;56;1;55;0;0;1
2020210;Ye Olde Cribbage Club;;0 - 20,000;4;0;4;0;0;0
2020380;Astrocat: Skylar´s Memories;;0 - 20,000;26;0;26;0;0;0
2020460;Bring It On!;;0 - 20,000;9;3;6;0;0;0
2020480;魔導聖戰:風色幻想;;50,000 - 100,000;67;12;55;120;120;1
2020490;風色幻想2:Alive;;0 - 20,000;23;24;-1;0;0;0
2020500;風色幻想3:罪與罰的鎮魂歌;;0 - 20,000;83;25;58;0;0;9
2020510;風色幻想4:聖戰的終焉;;0 - 20,000;44;8;36;0;0;7
2020520;風色幻想5:赤月戰爭;;0 - 20,000;100;18;82;0;0;10
2020530;風色幻想6:冒險奏鳴;;0 - 20,000;75;8;67;0;0;12
2020540;風色幻想SP:封神之刻;;0 - 20,000;50;19;31;0;0;10
2020550;風色幻想XX:交錯的軌跡;;0 - 20,000;27;13;14;0;0;8
2020590;Dragon Fury;;0 - 20,000;5;1;4;0;0;0
2020630;廃村巡り | Haisonmeguri;;0 - 20,000;68;18;50;0;0;0
2020670;StarMaker VR;;0 - 20,000;3;2;1;0;0;1
2020670;StarMaker VR;;0 - 20,000;3;2;1;0;0;1
2020750;Where are my potatoes?;;0 - 20,000;12;4;8;0;0;0
2020770;Xeno Last Stand;;0 - 20,000;0;2;-2;0;0;0
2020860;Rush Rally 3;;0 - 20,000;149;4;145;0;0;10
2020870;Mystical Island;;0 - 20,000;13;2;11;0;0;0
2020930;Cat Lovescapes;;0 - 20,000;3;0;3;0;0;0
2020950;Immortelle;;0 - 20,000;8;0;8;0;0;0
2021050;Board;;0 - 20,000;24;0;24;0;0;0
2021170;The Grim Nightmare of Nibras;;0 - 20,000;14;5;9;0;0;0
2021190;Pimania;;0 - 20,000;1;0;1;0;0;0
2021220;White Paper;;0 - 20,000;41;8;33;0;0;0
2021280;Inside My Mind 2;;0 - 20,000;13;1;12;0;0;0
2021410;Make Love Not War;;0 - 20,000;25;2;23;0;0;0
2021540;Defenders of Asteria;;0 - 20,000;3;0;3;0;0;0
2021690;Sakura Alien 2;;0 - 20,000;5;1;4;0;0;1
2022020;Hidden Desert War Top-Down 3D;;0 - 20,000;12;4;8;0;0;0
2022090;HeatStroke;;0 - 20,000;59;6;53;0;0;0
2022180;Miss Neko 3;;50,000 - 100,000;1028;79;949;79;139;40
2022190;Tower of Darkness;;20,000 - 50,000;1;0;1;0;0;0
2022380;The Secret of Rooms;;0 - 20,000;28;0;28;0;0;0
2022380;The Secret of Rooms;;0 - 20,000;28;0;28;0;0;0
2022410;RoadRace;;0 - 20,000;6;2;4;0;0;0
2022450;TrackRace;;0 - 20,000;3;0;3;0;0;0
2022680;NIRAVASI;;0 - 20,000;5;0;5;0;0;0
2022880;Truxton;;0 - 20,000;22;1;21;0;0;7
2022910;Twin Cobra;;0 - 20,000;8;0;8;0;0;5
2022920;Out Zone;;0 - 20,000;16;3;13;0;0;0
2023050;Lighthouse Keeper;;0 - 20,000;216;29;187;0;0;1
2023070;Mine Seeker;;0 - 20,000;7;2;5;0;0;0
2023210;Meteorites 3D;;20,000 - 50,000;14;0;14;0;0;0
2023250;Redaxium 2;;0 - 20,000;0;1;-1;0;0;0
2023330;Fright Night;;20,000 - 50,000;9;3;6;0;0;0
2023350;Non Fingo VR;;0 - 20,000;1;0;1;0;0;0
2023440;Jettatura;;0 - 20,000;13;1;12;0;0;0
2023610;Terror Brain: Night Out;;0 - 20,000;7;1;6;0;0;0
2023630;Hidden Battle Top-Down 3D;;0 - 20,000;10;2;8;0;0;1
2023640;Hidden Industries Top-Down 3D;;0 - 20,000;10;2;8;0;0;0
2023670;Incoherence;;0 - 20,000;10;1;9;0;0;1
2023680;ATurd - Abuser Escape;;0 - 20,000;1;0;1;0;0;0
2023800;The Blight;;0 - 20,000;17;12;5;0;0;0
2023810;Island Idle RPG;;0 - 20,000;34;15;19;0;0;1
2023880;The Tale of Onogoro;;0 - 20,000;26;2;24;0;0;3
2023960;快乐小家 Home Sick;;0 - 20,000;1;0;1;0;0;0
2023970;Light Them Up;;0 - 20,000;15;0;15;0;0;0
2024210;Witness of the Night;;100,000 - 200,000;3;3;0;0;0;0
2024230;Project Lazarus;;100,000 - 200,000;839;132;707;320;325;84
2024300;Hide Alone;;0 - 20,000;81;27;54;0;0;1
2024840;Push The Blocks;;0 - 20,000;5;0;5;0;0;0
2024870;The Lobster Game;;0 - 20,000;4;1;3;0;0;0
2024990;Pedigree Tactics;;50,000 - 100,000;4;1;3;0;0;0
2025000;Trippy Tavern;;0 - 20,000;3;0;3;0;0;0
2025210;Egg Hop;;0 - 20,000;2;0;2;0;0;0
2025280;3D Joys;;0 - 20,000;0;1;-1;0;0;0
2025320;Estencel;;0 - 20,000;28;17;11;0;0;7
2025340;GALXAGAR;;20,000 - 50,000;2;1;1;0;0;0
2025550;Hacker life simulator;;0 - 20,000;2;0;2;0;0;0
2025610;Once Again;;0 - 20,000;407;22;385;0;0;0
2025660;Trust No Bunny;;0 - 20,000;103;3;100;0;0;14
2025770;Let Me Out;;0 - 20,000;1;2;-1;0;0;0
2025780;Panda legend;;0 - 20,000;26;8;18;0;0;2
2025840;Gunvein;;0 - 20,000;94;2;92;0;0;1
2025930;Robot Revolt;;0 - 20,000;6;1;5;0;0;1
2025960;海岛守卫 Island guards;;0 - 20,000;2;1;1;0;0;0
2025970;Bell Kingdom;;0 - 20,000;2;0;2;0;0;0
2026060;Aviation Manager;;0 - 20,000;2;5;-3;0;0;0
2026070;Tank Commander: Battlefield;;100,000 - 200,000;4;5;-1;0;0;1
2026140;Telos Pragmaton;;0 - 20,000;1;0;1;0;0;0
2026140;Telos Pragmaton;;0 - 20,000;1;0;1;0;0;0
2026170;L-Racers;;0 - 20,000;4;0;4;0;0;0
2026290;Military Attack;;100,000 - 200,000;1;4;-3;0;0;0
2026340;Unichrome: A 1-Bit Unicorn Adventure;;0 - 20,000;7;1;6;0;0;0
2026370;A game that saves the muscles caught in the ceiling of the gymnasium;;0 - 20,000;74;7;67;0;0;0
2026470;Cyber Blades;;0 - 20,000;3;2;1;0;0;0
2026510;Invasive;;0 - 20,000;3;0;3;0;0;0
2026520;东方异乡录 ~the Apocryphal Gensoukyou;;0 - 20,000;165;8;157;0;0;1
2026580;Bolu;;0 - 20,000;3;3;0;0;0;0
2026690;A toad well travelled;;0 - 20,000;1;0;1;0;0;0
2026750;Astra Protocol 2;;0 - 20,000;7;1;6;0;0;0
2026750;Astra Protocol 2;;0 - 20,000;7;1;6;0;0;0
2026790;Boulder Island;;0 - 20,000;0;1;-1;0;0;0
2026870;Night At the Gates of Hell;;0 - 20,000;408;45;363;0;0;6
2026880;Deadly Night;;0 - 20,000;129;28;101;0;0;1
2027000;I commissioned some bees 2;;0 - 20,000;32;1;31;0;0;2
2027040;WOE;;20,000 - 50,000;4;1;3;0;0;0
2027090;LiMiT's Escape Room Games 2;;0 - 20,000;6;0;6;0;0;2
2027130;Protect My Cheese;;0 - 20,000;7;1;6;0;0;0
2027170;SIMBA THE CAT;;0 - 20,000;19;4;15;0;0;0
2027180;Silver Wire;;0 - 20,000;2;0;2;0;0;0
2027220;Perfect Jump;;0 - 20,000;2;2;0;0;0;0
2027270;Bravery;;0 - 20,000;5;4;1;0;0;0
2027290;Stunts Contest Police Car;;0 - 20,000;13;7;6;0;0;0
2027300;RUUUUUUN;;0 - 20,000;0;1;-1;0;0;0
2027310;Hanako in the abandoned school;;0 - 20,000;26;2;24;0;0;1
2027350;Wanderer;;0 - 20,000;17;4;13;0;0;0
2027370;Ball Torture;;100,000 - 200,000;16;10;6;0;0;1
2027440;피랍 일지 - 그 남자로부터의 탈출;;20,000 - 50,000;3;2;1;0;0;0
2027470;鬼魂街;;0 - 20,000;2;5;-3;0;0;0
2027490;Paramnesia;;0 - 20,000;18;6;12;0;0;0
2027540;Zombies Attack;;0 - 20,000;2;0;2;0;0;0
2027560;Valkyrie Champions;;0 - 20,000;21;5;16;0;0;3
2027570;Zombies Invasion;;0 - 20,000;14;3;11;0;0;0
2027600;Armored Battalion;;0 - 20,000;2;3;-1;0;0;0
2027810;DracoFighter;;0 - 20,000;14;0;14;0;0;0
2027820;Art Girl 2;;0 - 20,000;3;4;-1;0;0;0
2027850;RecNaviClub;;0 - 20,000;4;1;3;0;0;0
2027860;Search 4 Bigfoot;;20,000 - 50,000;2;5;-3;0;0;0
2050050;Rift Loopers;;0 - 20,000;66;21;45;147;147;2
2050120;Mission: Driver;;0 - 20,000;0;1;-1;0;0;0
2050150;Siphonopolis;;0 - 20,000;4;1;3;0;0;0
2050200;THROWDOWN BOXING 2;;20,000 - 50,000;4;1;3;0;0;0
2050380;Bolt Bot Screwy Viruses;;0 - 20,000;1;0;1;0;0;0
2050400;3D PUZZLE - Japan;;0 - 20,000;18;14;4;0;0;0
2050430;Starting Life In Another World Naked;;20,000 - 50,000;7;2;5;0;0;0
2050450;THE MADMAN;;0 - 20,000;10;5;5;0;0;0
2050460;HordounD;;0 - 20,000;9;1;8;0;0;0
2050470;Crash Forts 2;;0 - 20,000;10;4;6;0;0;0
2050480;TOTEMS 2;;0 - 20,000;10;1;9;0;0;0
2050490;A LONEY;;0 - 20,000;10;2;8;0;0;0
2050510;Oriental Dynasty - Silk Road defense war;;0 - 20,000;65;58;7;0;0;5
2050530;Age of Solitaire : Build Civilization;;0 - 20,000;17;4;13;0;0;1
2050540;Pocket Clothier;;0 - 20,000;44;3;41;1;1;4
2050590;Fhtagn Simulator;;0 - 20,000;293;15;278;0;0;2
2050680;Warbox Sandbox;;20,000 - 50,000;114;19;95;0;0;3
2050680;Warbox Sandbox;;20,000 - 50,000;114;19;95;0;0;3
2050720;隐秘的原罪8;;0 - 20,000;41;4;37;0;0;1
2050740;Hidden Objects with Edgar Allan Poe - Mystery Detective;;0 - 20,000;24;7;17;0;0;3
2050820;SENGOKU Princess ～天下統一は姫武将と共に～;;0 - 20,000;0;1;-1;0;0;0
2050870;Internet Exploring;;0 - 20,000;3;0;3;0;0;0
2050910;Fairy Elements;;0 - 20,000;2;0;2;0;0;0
2050920;Scranny;;0 - 20,000;1;1;0;0;0;0
2050960;The Shadelight;;0 - 20,000;11;2;9;0;0;0
2051100;ALPHA-NIGHTHAWK;;0 - 20,000;21;3;18;0;0;0
2051110;BETA-SIXDOUZE;;0 - 20,000;9;0;9;0;0;1
2051220;CrystalKeepers;;0 - 20,000;0;1;-1;0;0;0
2051420;Beltex;;0 - 20,000;92;11;81;0;0;14
2051440;Guardener;;0 - 20,000;67;8;59;0;0;2
2051450;Don't Die, Mr. Robot! DX;;0 - 20,000;6;0;6;0;0;0
2051450;Don't Die, Mr. Robot! DX;;0 - 20,000;6;0;6;0;0;0
2051530;Quick Tower Defence Ultimate;;0 - 20,000;3;0;3;0;0;0
2051540;Beat Blitz;;0 - 20,000;9;0;9;0;0;0
2051590;ALIEN XENOBLASTER;;0 - 20,000;20;0;20;0;0;0
2051820;Yakuza Undisputed;;0 - 20,000;5;4;1;0;0;1
2051830;Red Hood Adventure;;0 - 20,000;10;3;7;0;0;0
2051990;Midnight Zone;;0 - 20,000;8;0;8;0;0;0
2052140;AN IOU;;0 - 20,000;10;0;10;0;0;0
2052170;In to the 029;;0 - 20,000;29;9;20;0;0;0
2052200;Mea`s saifu collection party;;0 - 20,000;2;0;2;0;0;1
2052270;AI WAR;;50,000 - 100,000;0;1;-1;0;0;0
2052540;The Cursed Knight;;0 - 20,000;1;0;1;0;0;0
2052640;Anomalous Zone ███;;0 - 20,000;8;3;5;0;0;1
2052680;Colorful Recolor;;0 - 20,000;30;0;30;0;0;3
2052770;Aquarist VR;;0 - 20,000;5;2;3;0;0;0
2053050;Nightly Maintenance: Malcom's Story;;0 - 20,000;7;0;7;0;0;0
2053060;Travel The Words;;0 - 20,000;1;0;1;0;0;0
2053080;Opaloid Kingdom;;0 - 20,000;7;0;7;0;0;0
2053110;Bubble Wars;;0 - 20,000;1;0;1;0;0;0
2053200;Magic and Elements;;0 - 20,000;13;6;7;0;0;0
2053360;PUTRID SHOT ULTRA;;0 - 20,000;24;0;24;0;0;1
2053450;The Western Rooms;;0 - 20,000;1;0;1;0;0;0
2053580;Nonozle;;0 - 20,000;17;0;17;0;0;3
2053750;你与选择 You and Choice;;0 - 20,000;4;0;4;0;0;0
2053760;Haunted Girls;;0 - 20,000;3;4;-1;0;0;0
2053890;冥界崛起;;0 - 20,000;1;0;1;0;0;0
2053950;言++ WordsPlus;;0 - 20,000;8;2;6;0;0;0
2053990;The Monster Under Your Skin;;0 - 20,000;6;0;6;0;0;0
2054100;Chess VR: Multiverse Journey;;0 - 20,000;7;7;0;0;0;4
2054140;Checkers VR: Multiverse Journey;;0 - 20,000;1;1;0;0;0;0
2054150;Tower Defender VR: Last Adventure;;0 - 20,000;10;1;9;0;0;0
2054200;Elektrosoul;;0 - 20,000;1;0;1;0;0;0
2054230;ONCE UPON A TIME IN MOROCCO;;0 - 20,000;2;1;1;0;0;0
2054300;Futr8;;0 - 20,000;0;1;-1;0;0;0
2054340;Witch Story;;0 - 20,000;24;8;16;0;0;1
2054450;Zombies Midnight;;0 - 20,000;2;10;-8;0;0;0
2054670;开路先锋S:Open Road First Front S;;0 - 20,000;1;0;1;0;0;0
2054680;Odd One Out;;0 - 20,000;12;1;11;0;0;0
2054730;Tempusia;;0 - 20,000;4;2;2;0;0;0
2054740;Cozy Time;;0 - 20,000;134;10;124;0;0;24
2054760;Ein's Sword~アインズソード~;;0 - 20,000;2;0;2;0;0;0
2054800;Magazine Mogul;;0 - 20,000;19;1;18;0;0;13
2054810;Tennis Club Story;;0 - 20,000;14;2;12;0;0;11
2054820;POPTANK;;0 - 20,000;0;2;-2;0;0;0
2055130;Demon Go!;;0 - 20,000;29;2;27;0;0;0
2055180;Waitventure;;0 - 20,000;13;2;11;0;0;17
2055220;Desktop Girlfriend;;20,000 - 50,000;524;198;326;6;7;6
2055270;Tile Tale;;0 - 20,000;25;9;16;0;0;0
2055290;Sonic Colors: Ultimate;;0 - 20,000;126;59;67;88;88;25
2055370;KaBoom!;;0 - 20,000;0;0;0;0;0;0
2055370;KaBoom!;;0 - 20,000;0;0;0;0;0;0
2055470;Neko Loop;;0 - 20,000;21;0;21;0;0;1
2055500;Repetendium;;0 - 20,000;109;6;103;0;0;6
2055650;Rolling Rush;;0 - 20,000;3;1;2;0;0;0
2055680;Nuclear Fighter;;0 - 20,000;14;3;11;0;0;0
2055720;Limited Lifetime Corp;;20,000 - 50,000;6;0;6;0;0;0
2055730;미연시 시뮬레이터 : 미소녀 게임의 주인공을 조종하는 게임;;0 - 20,000;7;1;6;0;0;0
2055740;DnD Adventure: Rogue's Choice;;0 - 20,000;5;1;4;0;0;1
2056030;Rainbow Runner;;0 - 20,000;1;0;1;0;0;0
2056160;凶宅 HouseHaunting;;50,000 - 100,000;3;0;3;0;0;1
2056160;凶宅 HouseHaunting;;50,000 - 100,000;3;0;3;0;0;1
2056380;Space Assistance;;0 - 20,000;0;1;-1;0;0;0
2056400;Invader Signal;;0 - 20,000;11;3;8;0;0;0
2056410;Alien Time;;0 - 20,000;3;0;3;0;0;0
2056420;DEAD TRAIN;;50,000 - 100,000;3;2;1;0;0;0
2056480;Classic Memory Game;;0 - 20,000;2;0;2;0;0;0
2056490;Forrader Hero;;20,000 - 50,000;26;1;25;0;0;0
2056550;City Limits;;0 - 20,000;17;0;17;0;0;0
2056800;Just Jump;;0 - 20,000;1;1;0;0;0;0
2056880;Mystery of Mortlake Mansion;;0 - 20,000;31;5;26;0;0;3
2056910;Hitstream;;0 - 20,000;4;0;4;0;0;0
2056970;Animal Wish;;0 - 20,000;29;7;22;0;0;1
2056990;尋找自我 MastEr;;0 - 20,000;0;1;-1;0;0;0
2057040;PARTHIAN STRIKE;;0 - 20,000;3;0;3;0;0;0
2057070;Voxrush;;50,000 - 100,000;16;4;12;0;0;0
2057110;Chonky - From Breakfast to Domination;;0 - 20,000;21;2;19;0;0;0
2057170;Happy's Clocks;;0 - 20,000;6;2;4;0;0;0
2057220;Oxyjet;;0 - 20,000;2;0;2;0;0;0
2057300;Pixel;;0 - 20,000;1;0;1;0;0;0
2057310;Stardust Valkyries;;0 - 20,000;23;5;18;0;0;1
2057400;Ferrule Instincts;;0 - 20,000;0;2;-2;0;0;0
2057430;The Wraith of the Galaxy;;0 - 20,000;22;2;20;0;0;2
2057460;The Ballad of Radolf;;0 - 20,000;0;2;-2;0;0;0
2057490;Dancing Hime: Rhythm Matching;;0 - 20,000;0;3;-3;0;0;0
2057620;Pandemic 1993;;0 - 20,000;2;2;0;0;0;0
2057710;Sweet Office;;0 - 20,000;109;19;90;0;0;0
2057720;Battle of Tanks;;20,000 - 50,000;0;3;-3;0;0;0
2057790;Loop;;0 - 20,000;17;0;17;0;0;0
2057820;Desstroke;;0 - 20,000;3;0;3;0;0;0
2057830;FERD;;0 - 20,000;8;2;6;0;0;0
2057840;BEAT AIMER!;;0 - 20,000;2;4;-2;0;0;0
2057850;Dick Ranger;;0 - 20,000;6;1;5;0;0;0
2057850;Dick Ranger;;0 - 20,000;6;1;5;0;0;0
2057910;Take no Prisoners;;0 - 20,000;1;3;-2;0;0;0
2057970;Rainy Butcher;;20,000 - 50,000;49;11;38;0;0;0
2057980;Kokoro's Gensokyo Journey: The Lost Masks;;0 - 20,000;7;0;7;0;0;0
2058120;Worm Runner;;0 - 20,000;14;9;5;0;0;0
2058130;Fortitude invasion;;0 - 20,000;11;1;10;0;0;0
2058170;Haunted Places;;0 - 20,000;1;1;0;0;0;0
2058180;Judgment;;200,000 - 500,000;3777;150;3627;1524;1957;461
2058190;Lost Judgment;;100,000 - 200,000;2375;110;2265;1764;1764;519
2058200;Showrunner;;0 - 20,000;32;10;22;0;0;3
2058220;Artifacts of Eyru;;0 - 20,000;2;0;2;0;0;0
2058370;Jack Big Chin: Alien Invasion;;0 - 20,000;14;0;14;0;0;0
2058380;Procemon: You Must Catch Them;;0 - 20,000;7;2;5;0;0;0
2058420;Wormmy;;0 - 20,000;3;0;3;0;0;0
2058430;Bomb Dolls;;0 - 20,000;7;0;7;0;0;0
2058610;Death Slave : You Need to Master Death;;0 - 20,000;8;1;7;0;0;0
2058660;Maelstrom;;0 - 20,000;3;1;2;0;0;0
2058800;Try to Fly;;0 - 20,000;4;0;4;0;0;1
2058920;Jelly's Adventure;;0 - 20,000;0;1;-1;0;0;0
2058970;For What Will Come;;0 - 20,000;11;0;11;0;0;0
2059230;mrFOX;;0 - 20,000;3;7;-4;0;0;0
2059250;Five nights at Floppa 0;;0 - 20,000;53;2;51;0;0;0
2059280;Nightmare knock;;0 - 20,000;26;2;24;0;0;0
2059390;The Patient: After Hours;;0 - 20,000;11;0;11;0;0;0
2059400;Kenomaze;;0 - 20,000;2;3;-1;0;0;0
2059480;Interrogation Simulator;;0 - 20,000;22;0;22;0;0;0
2059550;Brain Syndrome VR;;100,000 - 200,000;0;1;-1;0;0;0
2059600;Vain Ascendance;;0 - 20,000;4;0;4;0;0;0
2059650;FETUS;;0 - 20,000;16;4;12;0;0;0
2059670;Moss: Book II;;0 - 20,000;206;2;204;0;0;7
2059690;TargetPOP;;0 - 20,000;11;0;11;0;0;0
2059730;Dare to Stay;;0 - 20,000;6;4;2;0;0;1
2059760;Elden Gunfire 2;;0 - 20,000;38;11;27;0;0;0
2059790;再刷一把 PlayAgain;;200,000 - 500,000;2851;1418;1433;2934;2712;1323
2059810;Richman 4;;20,000 - 50,000;558;343;215;272;407;156
2059960;The Rumble Fish 2;;0 - 20,000;4;23;-19;189;189;0
2060000;Great Deceiver;;0 - 20,000;74;25;49;2;2;0
2060130;Return to Monkey Island;;200,000 - 500,000;6462;486;5976;762;700;245
2060160;The Farmer Was Replaced;;0 - 20,000;11;0;11;0;0;6
2060240;Quriocity;;0 - 20,000;23;3;20;0;0;1
2060410;Kingdom Quest;;0 - 20,000;0;1;-1;0;0;0
2060450;Wanted! Monty Mole;;0 - 20,000;3;0;3;0;0;0
2060480;PomoFarm;;0 - 20,000;146;2;144;1;1;61
2060670;Sue Shi Survival;;0 - 20,000;16;3;13;0;0;2
2060740;Zankinzoken;;20,000 - 50,000;5;3;2;0;0;0
2061000;Infinity Project: PATTERNS;;0 - 20,000;2;0;2;0;0;0
2061020;筒楼异事;;0 - 20,000;103;7;96;0;0;2
2061060;The Marson Home;;0 - 20,000;3;2;1;0;0;0
2061140;The Mangotronics Employment Collection;;0 - 20,000;1;0;1;0;0;0
2061140;The Mangotronics Employment Collection;;0 - 20,000;1;0;1;0;0;0
2061150;Ikki Unite;;20,000 - 50,000;235;82;153;0;0;3342
2061230;Chasm: The Rift;;0 - 20,000;170;13;157;21;21;1
2061250;Shin chan: Me and the Professor on Summer Vacation The Endless Seven-Day Journey;;0 - 20,000;148;18;130;0;0;2
2061260;发现姐姐是妹控的我今后该如何是好;;0 - 20,000;74;12;62;0;0;0
2061270;Alien Gladiator;;0 - 20,000;4;0;4;0;0;0
2061280;Monty on the Run (CPC/Spectrum);;0 - 20,000;4;1;3;0;0;0
2061300;The Way Home: Pixel Roguelike;;0 - 20,000;39;6;33;0;0;1
2061340;Mottia - The gem hunters;;20,000 - 50,000;1;1;0;0;0;0
2061480;Inexperienced Driver;;0 - 20,000;10;7;3;0;0;0
2061530;Our Home;;0 - 20,000;0;5;-5;0;0;0
2061540;Chompies!;;0 - 20,000;6;0;6;0;0;0
2061630;(square);;0 - 20,000;4;1;3;0;0;0
2061710;DO NOT OPEN;;0 - 20,000;23;3;20;0;0;0
2061720;Metapilot;;0 - 20,000;10;2;8;0;0;0
2061820;Charging Out Dead Zone;;0 - 20,000;2;1;1;0;0;0
2062150;Quadrobat;;0 - 20,000;5;1;4;0;0;0
2062160;Hold Controller;;0 - 20,000;4;0;4;0;0;0
2062190;Oh Sheep!;;0 - 20,000;13;0;13;0;0;0
2062210;Watamari - A Match Made in Heaven Part1;;0 - 20,000;123;8;115;0;0;2
2062300;I am Bjorn : Escape Room;;0 - 20,000;3;1;2;0;0;0
2062330;Omega Squad;;0 - 20,000;9;0;9;0;0;0
2062350;May's Mysteries: The Secret of Dragonville Remastered;;0 - 20,000;2;1;1;0;0;0
2062390;Clockwork Survivors;;0 - 20,000;4;0;4;0;0;0
2062390;Clockwork Survivors;;0 - 20,000;4;0;4;0;0;0
2062420;Battle Rift;;0 - 20,000;1;0;1;0;0;0
2062480;Bounder (CPC/Spectrum);;0 - 20,000;2;0;2;0;0;0
2062550;hololive ERROR;;0 - 20,000;300;45;255;52;52;2
2062550;hololive ERROR;;0 - 20,000;300;45;255;52;52;2
2062600;Cable Clutter;;0 - 20,000;1;1;0;0;0;0
2062630;WalkBot;;0 - 20,000;4;0;4;0;0;0
2062660;Cyber Drift;;0 - 20,000;5;0;5;0;0;0
2062750;A Path to Light;;0 - 20,000;1;0;1;0;0;0
2062780;SharkDrag Episode 5: Uniting the 5 Kingdoms;;0 - 20,000;2;0;2;0;0;0
2062800;Blockhead 2D;;0 - 20,000;1;0;1;0;0;0
2062820;Backroom Beyond;;0 - 20,000;6;9;-3;0;0;1
2062830;Dan the Inmortal;;0 - 20,000;4;1;3;0;0;0
2062910;Just Sign!;;0 - 20,000;14;2;12;0;0;0
2062920;TTV4;;0 - 20,000;31;0;31;0;0;0
2062940;Territory;;0 - 20,000;29;4;25;0;0;1
2063000;The Clown's Forest;;20,000 - 50,000;6;2;4;0;0;0
2063010;SUSHI ALONe;;0 - 20,000;4;0;4;0;0;0
2063050;TVs: The Awakening;;20,000 - 50,000;32;2;30;0;0;0
2063130;Special Agent Squeaky's Simple VTubing App;;0 - 20,000;0;1;-1;0;0;1
2063140;NetaJump;;0 - 20,000;2;0;2;0;0;0
2063160;Courage;;0 - 20,000;1;4;-3;0;0;0
2063210;Icarus Challenge;;0 - 20,000;0;1;-1;0;0;0
2063230;Doctor Nanobot;;0 - 20,000;2;0;2;0;0;0
2063240;POG 8;;0 - 20,000;5;3;2;0;0;0
2063290;Rock Wrecker;;0 - 20,000;3;0;3;0;0;0
2063310;Joe Wander and the Enigmatic Adventures;;0 - 20,000;16;1;15;0;0;4
2063370;Once in Yaissor 3;;0 - 20,000;8;0;8;0;0;0
2063400;Descension;;500,000 - 1,000,000;1;2;-1;0;0;0
2063420;CozyTyper;;0 - 20,000;99;5;94;0;0;4
2063450;Hidden Shapes Animals - VR;;0 - 20,000;2;0;2;0;0;0
2063480;Voltage High Society;;20,000 - 50,000;60;0;60;0;0;1
2063500;The Rat Plague;;0 - 20,000;66;4;62;0;0;0
2063530;Methods: The Canada Files;;0 - 20,000;25;0;25;0;0;3
2063550;Japanese TeTris;;0 - 20,000;12;3;9;0;0;0
2063560;Space Route;;20,000 - 50,000;10;0;10;0;0;3
2063560;Space Route;;20,000 - 50,000;10;0;10;0;0;3
2063580;Trigger Henry;;0 - 20,000;10;0;10;0;0;1
2063870;bloody lonely cold;;0 - 20,000;7;10;-3;0;0;0
2063890;Toggle Cube;;20,000 - 50,000;2;0;2;0;0;0
2063930;夺宝蠢兵;;0 - 20,000;4;0;4;0;0;0
2063990;XanChuchamel;;0 - 20,000;1;0;1;0;0;0
2063990;XanChuchamel;;0 - 20,000;1;0;1;0;0;0
2064000;Tater Spud;;0 - 20,000;5;0;5;0;0;0
2064090;Streamers' Secret Life;;0 - 20,000;4;0;4;0;0;0
2064110;U96;;20,000 - 50,000;15;4;11;0;0;0
2064120;Cows&Co;;0 - 20,000;13;3;10;0;0;0
2064180;Maze Mart;;0 - 20,000;3;1;2;0;0;0
2064230;Bay Bell;;0 - 20,000;2;0;2;0;0;0
2064370;Space Monkeys;;0 - 20,000;8;0;8;0;0;0
2064410;Truck Rally Hyper Hardcore;;0 - 20,000;0;1;-1;0;0;0
2064500;Harry Is A Porter;;0 - 20,000;5;0;5;0;0;0
2064530;Pinball Girlfriend;;0 - 20,000;2;1;1;0;0;0
2064580;Hausmeister;;0 - 20,000;67;3;64;0;0;0
2064950;Alone Again: The Countryside;;50,000 - 100,000;17;5;12;0;0;1
2065000;Chess Survivors;;0 - 20,000;58;1;57;0;0;2
2065010;I Was Wrong;;0 - 20,000;0;1;-1;0;0;0
2065090;John Brick;;0 - 20,000;2;0;2;0;0;0
2065110;Alexander the Great: Secrets of Power;;0 - 20,000;13;1;12;0;0;1
2065200;The Stone Cutter and the Mountain Spirit;;0 - 20,000;20;1;19;0;0;0
2065260;Don't Touch Lava;;0 - 20,000;1;0;1;0;0;0
2065510;Bots City;;0 - 20,000;12;2;10;0;0;0
2065520;Endless Nightmare;;50,000 - 100,000;6;1;5;0;0;0
2065560;Acanthoceras;;0 - 20,000;5;0;5;0;0;0
2065570;Silver Nornir;;0 - 20,000;1;4;-3;0;0;0
2065610;Rush Rush Rally Reloaded;;0 - 20,000;4;0;4;0;0;0
2065610;Rush Rush Rally Reloaded;;0 - 20,000;4;0;4;0;0;0
2065620;IndividuaLand;;0 - 20,000;3;1;2;0;0;0
2065630;Goat's Tale 2;;0 - 20,000;21;3;18;0;0;0
2065810;Undead Horde 2: Necropolis;;0 - 20,000;40;4;36;0;0;13
2065820;The Legend of Azarias;;0 - 20,000;2;1;1;0;0;0
2065920;Dark Jungle;;20,000 - 50,000;10;3;7;0;0;0
2065990;FREM Sprite32!;;0 - 20,000;5;0;5;0;0;0
2066020;Soulstone Survivors;;200,000 - 500,000;8455;822;7633;881;736;1978
2066030;The Grizzled: Armistice Digital;;0 - 20,000;4;4;0;0;0;2
2066130;Cutie Tutti Frutti;;0 - 20,000;4;9;-5;0;0;0
2066210;War Dots;;0 - 20,000;1;1;0;0;0;0
2066240;Bughouse;;0 - 20,000;107;10;97;0;0;0
2066300;Escape: The Endless Dogwatch;;0 - 20,000;27;1;26;0;0;0
2066360;Yumahorome ~Toki o Tometa Yakata de Asu o Sagasu Maigo-tachi~;;0 - 20,000;189;14;175;0;0;5
2066420;这里有妖;;0 - 20,000;9;6;3;0;0;2
2066430;The Sea of Death;;0 - 20,000;3;0;3;0;0;2
2066460;二十一 The Twenty One;;20,000 - 50,000;27;30;-3;0;0;0
2066490;Robot Resistors;;50,000 - 100,000;21;3;18;0;0;4
2066530;传颂的种族 The Celebrated Race;;0 - 20,000;5;0;5;0;0;0
2066540;Metro Mover;;0 - 20,000;1;0;1;0;0;0
2066780;洛神见月;;0 - 20,000;6;7;-1;0;0;0
2066920;ColorCube;;0 - 20,000;22;0;22;0;0;0
2066940;Sagger;;0 - 20,000;6;2;4;0;0;1
2066950;Quadrata;;0 - 20,000;42;0;42;0;0;1
2066960;New Tanks;;0 - 20,000;12;2;10;0;0;0
2067140;AirRaid;;0 - 20,000;2;0;2;0;0;0
2067150;Nitro Racers;;0 - 20,000;1;0;1;0;0;0
2067170;Caged Beast;;0 - 20,000;16;5;11;0;0;0
2067200;Blobble Wars 2;;0 - 20,000;1;0;1;0;0;0
2067220;Auf Wiedersehen Monty (CPC/Spectrum);;0 - 20,000;4;0;4;0;0;0
2067280;Devils 'n Dragons Arcade;;0 - 20,000;0;1;-1;0;0;0
2067300;Crossfar;;0 - 20,000;8;0;8;0;0;0
2067570;Egghead Gumpty;;0 - 20,000;34;11;23;0;0;0
2067590;Upload Simulator;;0 - 20,000;56;8;48;0;0;11
2067700;哪吒三太子;;0 - 20,000;3;1;2;0;0;0
2067720;Space Bunny Explorers;;0 - 20,000;1;0;1;0;0;0
2067730;Daybreaker VR;;0 - 20,000;10;11;-1;0;0;3
2067790;Crimson Snow (2023);;50,000 - 100,000;656;28;628;0;0;12
2067910;What The Fortress!?;;0 - 20,000;4;3;1;0;0;0
2067920;Rogue: Genesia;;100,000 - 200,000;3751;240;3511;1117;1338;289
2067950;Nash Racing 3: Drifter;;0 - 20,000;3;1;2;0;0;0
2068040;Boxing Queen;;0 - 20,000;4;3;1;0;0;1
2068050;CLASHBOWL;;0 - 20,000;1;2;-1;0;0;0
2068120;From Hell;;0 - 20,000;13;5;8;0;0;0
2068140;FaceWorld Pro;;0 - 20,000;1;1;0;0;0;0
2068140;FaceWorld Pro;;0 - 20,000;1;1;0;0;0;0
2068280;Nordic Ashes: Survivors of Ragnarok;;100,000 - 200,000;938;154;784;422;546;1036
2068320;2 Late 2 Evade;;0 - 20,000;1;0;1;0;0;0
2068400;Radiant Cell;;0 - 20,000;4;1;3;0;0;0
2068690;Space FURY - The Phantom Menace;;0 - 20,000;2;0;2;0;0;0
2068710;Hot Lap League: Deluxe Edition;;0 - 20,000;59;16;43;0;0;4
2068750;Through the night;;0 - 20,000;1;0;1;0;0;0
2068810;Solar Nations;;0 - 20,000;6;5;1;0;0;1
2068820;Radial Flow;;0 - 20,000;11;0;11;0;0;0
2069030;Gronk Want Rock;;0 - 20,000;10;0;10;0;0;0
2069110;I commissioned some bees 3;;0 - 20,000;22;1;21;0;0;0
2069160;Platfuzzles;;0 - 20,000;3;0;3;0;0;0
2069310;RealFlight Evolution;;0 - 20,000;98;32;66;0;0;283
2069410;Road Draftsman;;0 - 20,000;11;3;8;0;0;0
2069420;Fossil Finder;;0 - 20,000;9;5;4;0;0;0
2069500;流星降临的小镇：来自过去的幽灵;;0 - 20,000;9;0;9;0;0;0
2069540;Opalescence;;0 - 20,000;1;0;1;0;0;0
2069550;Slime Rule;;100,000 - 200,000;10;2;8;0;0;0
2069560;Imaginari;;0 - 20,000;1;0;1;0;0;0
2069580;Road Stones;;0 - 20,000;11;2;9;0;0;0
2069630;HERO YOUSEIJYO;;0 - 20,000;1;0;1;0;0;0
2069680;The Great;;0 - 20,000;0;1;-1;0;0;0
2069710;Finding Ice;;0 - 20,000;8;0;8;0;0;0
2069750;Islet Hell;;0 - 20,000;2;1;1;0;0;0
2069800;The Apple Tree;;0 - 20,000;3;0;3;0;0;0
2069960;ROGUELINE;;0 - 20,000;7;0;7;0;0;0
2070030;Super Kenney;;0 - 20,000;3;1;2;0;0;0
2070190;Alice in Wonderland Jigsaw Puzzle;;0 - 20,000;16;1;15;0;0;0
2070210;Small Shop;;0 - 20,000;1;1;0;0;0;0
2070220;Yukar From The Abyss;;0 - 20,000;16;0;16;0;0;0
2070310;抓紧最后一朵;;0 - 20,000;2;0;2;0;0;0
2070400;Smash;;0 - 20,000;3;0;3;0;0;0
2070410;Flightpath;;0 - 20,000;7;1;6;0;0;1
2070420;Escape Yourself;;0 - 20,000;4;3;1;0;0;0
2070440;Lunatic;;0 - 20,000;2;4;-2;0;0;0
2070510;Going Deep;;20,000 - 50,000;2;0;2;0;0;1
2070540;Shogunaria;;50,000 - 100,000;11;1;10;0;0;2
2070550;A Castle Full of Cats;;20,000 - 50,000;1407;10;1397;84;89;26
2070980;Cowgirl Adventures;;0 - 20,000;4;5;-1;0;0;0
2070990;VEGAS Edit 20 Steam Edition;;0 - 20,000;6;1;5;0;0;6
2071010;Movie Studio 2023 Platinum Steam Edition;;0 - 20,000;2;0;2;0;0;1
2071020;ボクらの消しゴム落とし 新学期;;0 - 20,000;1;1;0;0;0;1
2071040;DRIVE DRIFT X（ドライブドリフトX）;;0 - 20,000;1;1;0;0;0;0
2071060;Acassia;;0 - 20,000;1;1;0;0;0;0
2071200;The Bad Kids;;20,000 - 50,000;305;94;211;0;0;25
2071240;The Wire Man;;0 - 20,000;10;0;10;0;0;0
2071340;Cosmic Wartoad;;0 - 20,000;1;0;1;0;0;0
2071350;Motorbike Video Puzzle;;0 - 20,000;13;0;13;0;0;0
2071390;Chess: The Lost Pieces;;0 - 20,000;10;2;8;0;0;1
2071460;Agile firefighter;;0 - 20,000;13;4;9;0;0;0
2071770;Sokorun: One Box;;0 - 20,000;15;0;15;0;0;0
2071800;Rezzil Player;;0 - 20,000;2;0;2;0;0;1
2072040;Azrael;;0 - 20,000;6;2;4;0;0;0
2072080;Super Demon Survivors;;0 - 20,000;25;12;13;0;0;0
2072110;Hop Step Sing! VR Live Hop☆Summer 2nd;;0 - 20,000;19;1;18;0;0;0
2072130;Pocket Arcade Story;;0 - 20,000;22;3;19;0;0;8
2072140;Epic Astro Story;;0 - 20,000;14;0;14;0;0;5
2072150;Kairobotica;;0 - 20,000;16;0;16;0;0;1
2072170;Shiny Ski Resort;;0 - 20,000;29;0;29;0;0;8
2072190;Cursed Colors;;0 - 20,000;3;0;3;0;0;0
2072420;Beastie Bay DX;;0 - 20,000;36;7;29;0;0;14
2072480;Virus Protocol;;0 - 20,000;1;0;1;0;0;0
2072540;icosi-do;;0 - 20,000;6;1;5;0;0;0
2072550;The Solar Ring;;0 - 20,000;1;0;1;0;0;0
2072580;WordBed;;0 - 20,000;2;2;0;0;0;0
2072620;Dice Roller VR;;0 - 20,000;3;1;2;0;0;0
2072680;Jack the Nipper;;0 - 20,000;2;0;2;0;0;0
2072690;CYCLEBREAKER;;0 - 20,000;3;0;3;0;0;0
2072820;Book Quest;;0 - 20,000;2;3;-1;0;0;0
2072830;Dr.Pumpkin;;0 - 20,000;6;3;3;0;0;0
2072900;Ultimate Soldier;;0 - 20,000;1;4;-3;0;0;1
2072910;Frido;;0 - 20,000;11;1;10;0;0;0
2072930;Mountain Offroad Simulator;;0 - 20,000;23;6;17;0;0;0
2072950;Heavy Works;;0 - 20,000;13;4;9;0;0;0
2073010;Berserker: A Viking Board Game;;0 - 20,000;3;0;3;0;0;0
2073040;Earth's Center of Gravity;;20,000 - 50,000;2;0;2;0;0;0
2073050;Emma's Armaments;;0 - 20,000;32;38;-6;0;0;1
2073110;Play With;;0 - 20,000;1;0;1;0;0;0
2073140;Another World - Thought Taboo;;20,000 - 50,000;23;0;23;0;0;1
2073200;Police on Duty;;0 - 20,000;17;4;13;0;0;0
2073280;INCARNAGE;;50,000 - 100,000;1;0;1;0;0;0
2073370;Ansiolisis;;50,000 - 100,000;4;0;4;0;0;0
2073420;Paresis;;0 - 20,000;14;3;11;0;0;0
2073470;Kanjozoku Game レーサー Online Street Racing & Drift;;50,000 - 100,000;2299;386;1913;153;213;37
2073520;Minimal Bubble Pop;;0 - 20,000;2;3;-1;0;0;0
2073530;Stereo Boy;;0 - 20,000;21;0;21;0;0;0
2073570;Holy Paladin Cynthia;;0 - 20,000;14;4;10;0;0;0
2073710;面具古墓;;0 - 20,000;44;4;40;0;0;2
2073750;memory – The Original Matching Game from Ravensburger;;0 - 20,000;1;0;1;0;0;0
2073760;Rush Hour Deluxe – The ultimate traffic jam game!;;0 - 20,000;2;1;1;0;0;1
2073820;Steel Torrent;;0 - 20,000;1;0;1;0;0;0
2073820;Steel Torrent;;0 - 20,000;1;0;1;0;0;0
2073900;Magicians And Monsters;;20,000 - 50,000;49;13;36;0;0;1
2073960;Missing Cat;;0 - 20,000;6;0;6;0;0;0
2073970;Brave Heroes;;0 - 20,000;17;4;13;0;0;0
2074040;Third Wild;;0 - 20,000;8;7;1;0;0;3
2074130;Binary: A Puzzling Platformer;;0 - 20,000;1;0;1;0;0;0
2074140;Tommy Gun Carnage;;0 - 20,000;0;3;-3;0;0;0
2074190;1001 Jigsaw. Cute Cats 2;;0 - 20,000;6;0;6;0;0;0
2074390;Soul Maze;;0 - 20,000;1;3;-2;0;0;0
2074440;Master of the Tattooverse;;0 - 20,000;10;2;8;0;0;0
2074480;Sunset Routes;;20,000 - 50,000;188;5;183;0;0;3
2074490;MOAR - Appeteaser;;0 - 20,000;6;2;4;0;0;0
2074500;OrbiTank;;0 - 20,000;4;0;4;0;0;0
2074520;Captain!;;0 - 20,000;1;1;0;0;0;0
2074530;SHAFTED;;50,000 - 100,000;6;0;6;0;0;0
2074560;Mr.Brocco & Co;;0 - 20,000;26;1;25;0;0;0
2074600;Pentacore;;0 - 20,000;4;1;3;0;0;1
2074690;Loplight;;0 - 20,000;27;2;25;0;0;1
2074710;Microbes and Machines;;0 - 20,000;27;5;22;0;0;0
2074760;Star Boss;;0 - 20,000;1;0;1;0;0;0
2074790;What's your emergency;;0 - 20,000;1;1;0;0;0;0
2074800;Richman 11;;20,000 - 50,000;574;558;16;635;940;562
2074810;8-Bit Farm;;0 - 20,000;13;2;11;0;0;3
2074910;Photogenic Minds : Identity;;0 - 20,000;57;4;53;0;0;18
2074940;Phantom Alchemy ~Silvia's Dynamic Urban Planning~;;0 - 20,000;30;9;21;0;0;7
2074960;PAWN SHOP SIMULATOR;;0 - 20,000;9;21;-12;0;0;0
2074970;幻想世界中的平民被忽悠著走上拯救公主的道路;;0 - 20,000;1;1;0;0;0;0
2075050;Boom Slingers;;0 - 20,000;32;0;32;0;0;1
2075120;A Clumsy Flight;;0 - 20,000;43;17;26;0;0;0
2075130;Fastest Fantasy Life Simulator;;0 - 20,000;2;2;0;0;0;0
2075170;Jelly In The Dark;;0 - 20,000;7;0;7;0;0;0
2075230;Witch girl got killed.;;0 - 20,000;4;0;4;0;0;0
2075250;ESCAPE IT;;20,000 - 50,000;15;4;11;0;0;0
2075250;ESCAPE IT;;20,000 - 50,000;15;4;11;0;0;0
2075370;Old Tunnel;;0 - 20,000;13;2;11;0;0;1
2075390;Super Geisha Neon;;0 - 20,000;16;2;14;0;0;0
2075410;初夏倾语 - Summer Whisper;;0 - 20,000;17;7;10;0;0;1
2075540;Valete vos viatores;;0 - 20,000;1;2;-1;0;0;0
2075590;PASSAGE;;0 - 20,000;3;0;3;0;0;0
2075680;Hidden Farm 2 Top-Down 3D;;0 - 20,000;12;11;1;0;0;0
2075760;Mech Shuffle;;0 - 20,000;16;0;16;0;0;1
2075770;Coin Blitz;;0 - 20,000;1;1;0;0;0;0
2075820;Controller Sync;;0 - 20,000;4;0;4;0;0;0
2075930;Angkor: Beginnings: Match 3 Puzzle;;0 - 20,000;1;0;1;0;0;1
2075960;Spirits Chronicles: Flower Of Hope Collector's Edition;;0 - 20,000;2;1;1;0;0;6
2076200;NYYO;;0 - 20,000;5;0;5;0;0;0
2076220;Akai Katana Shin;;0 - 20,000;45;2;43;0;0;2
2076240;Elementals: The Magic Key;;0 - 20,000;8;2;6;0;0;0
2076260;Slaughter Horse 2;;20,000 - 50,000;36;0;36;0;0;3
2076320;The Voices Games 2d Collection;;0 - 20,000;1;1;0;0;0;0
2076490;Endless Chaos: Hordes of the Afterlife;;0 - 20,000;1;2;-1;0;0;0
2076730;Mud Way;;0 - 20,000;1;1;0;0;0;0
2076810;Further Still: Survivors;;0 - 20,000;28;3;25;0;0;1
2076820;VANQUISH;;0 - 20,000;2;0;2;0;0;0
2076850;Keyboard Warrior: Dreamstate;;0 - 20,000;14;0;14;0;0;0
2076910;The Last Metal Shooter;;0 - 20,000;1;1;0;0;0;0
2076920;Our Hero! Last;;0 - 20,000;3;1;2;0;0;0
2077020;GirlPuzzle;;0 - 20,000;8;0;8;0;0;0
2077060;SATUS;;0 - 20,000;35;2;33;0;0;1
2077070;Shufflepoker;;0 - 20,000;3;0;3;0;0;0
2077080;Pitstop in Purgatory;;0 - 20,000;20;0;20;0;0;1
2077120;Hive;;0 - 20,000;6;1;5;0;0;0
2077130;Bounce your Bullets!;;0 - 20,000;3;1;2;0;0;0
2077170;Aim Trainer X;;0 - 20,000;5;0;5;0;0;0
2077210;RC SIM 2022;;0 - 20,000;1;0;1;0;0;0
2077330;Kentor and also Bloby in: Part 1 - The Krookening;;0 - 20,000;1;0;1;0;0;0
2077380;The Multi-Medium;;0 - 20,000;70;2;68;0;0;3
2077580;Destroiders;;0 - 20,000;2;0;2;0;0;0
2077590;Sidestep Legends;;0 - 20,000;12;3;9;0;0;2
2077610;Can Gym Break This?;;0 - 20,000;1;2;-1;0;0;0
2077650;Amok Runner;;0 - 20,000;100;39;61;2589;2589;0
2077700;PTRL Stockcar Edition;;0 - 20,000;2;2;0;0;0;0
2077720;Moth Lake: A Horror Story;;20,000 - 50,000;29;5;24;0;0;2
2077800;Streamer's Court;;0 - 20,000;11;0;11;0;0;0
2077950;Pretty Girls Breakout! PLUS;;0 - 20,000;8;1;7;0;0;1
2077970;Finding Felicia;;0 - 20,000;0;4;-4;0;0;0
2077990;Junkyard Fury 2;;0 - 20,000;7;0;7;0;0;0
2078040;White Day2: The Flower That Tells Lies - EP1;;0 - 20,000;64;174;-110;0;0;68
2078120;Hot And Lovely 5;;0 - 20,000;132;37;95;10;10;5
2078210;Bulls and Cows;;0 - 20,000;2;0;2;0;0;0
2078240;Super Owlboy;;0 - 20,000;1;5;-4;0;0;0
2078370;Tesla Legacy;;0 - 20,000;2;1;1;0;0;0
2078460;Mirror Chains;;0 - 20,000;1;16;-15;0;0;2
2078480;Anomalia;;0 - 20,000;1;0;1;0;0;0
2078530;Light Kin;;0 - 20,000;11;1;10;0;0;0
2078540;Just Shoot: Slimes;;0 - 20,000;4;0;4;0;0;0
2078580;Invadead;;0 - 20,000;0;2;-2;0;0;0
2078600;Afterslave;;100,000 - 200,000;1;0;1;0;0;0
2078640;A Frog's Job;;0 - 20,000;3;0;3;0;0;0
2078680;In Your Nightmares!;;0 - 20,000;1;3;-2;0;0;0
2078780;Lovelorn sanatoriumⅠ;;20,000 - 50,000;1191;495;696;19;19;27
2078810;Zombie Apocalypse - The Last Defense;;0 - 20,000;15;2;13;0;0;1
2078820;Gummy Jump;;0 - 20,000;5;0;5;0;0;0
2078970;Cult Of Babel;;0 - 20,000;19;17;2;0;0;0
2079000;Totally Ratical Adventures;;0 - 20,000;3;1;2;0;0;0
2079020;Sippin Hot Blickety Block N Bop Those Bad Battle Boys Down To Size Supreme;;0 - 20,000;10;0;10;0;0;0
2079110;Agent1218;;0 - 20,000;3;2;1;0;0;0
2079240;Cavelon;;0 - 20,000;1;0;1;0;0;0
2079280;Slingshot Adventure;;0 - 20,000;3;0;3;0;0;0
2079370;Bicycle Challenge - Wastelands;;0 - 20,000;10;10;0;0;0;0
2079380;Old Retro Shooter;;0 - 20,000;13;12;1;0;0;0
2079400;Sleepy Sheep;;0 - 20,000;3;0;3;0;0;0
2079500;Colorless World;;0 - 20,000;12;1;11;0;0;0
2079530;Lewis Carroll's Alice;;0 - 20,000;3;0;3;0;0;0
2079710;Fantôme;;0 - 20,000;21;12;9;0;0;0
2079800;你与月光同罪-As Guilty As the Moon;;20,000 - 50,000;1;2;-1;0;0;0
2079960;Light;;50,000 - 100,000;6;1;5;0;0;0
2080010;They Came From the Sky 2;;0 - 20,000;14;1;13;0;0;0
2080060;Better Off Dead - Life as a Prison Guard;;20,000 - 50,000;8;4;4;0;0;0
2080070;Avocado Puzzle Quest;;0 - 20,000;18;6;12;0;0;0
2080100;Ruadh: Warbands;;0 - 20,000;22;6;16;0;0;1
2080160;Cosmic Cruiser;;0 - 20,000;1;0;1;0;0;0
2080340;European Football Dynasty 2023;;0 - 20,000;8;0;8;0;0;1
2080380;Retro Invasion;;0 - 20,000;3;0;3;0;0;0
2080420;Vault Circuit;;0 - 20,000;1;0;1;0;0;0
2080480;Harpoon;;20,000 - 50,000;13;2;11;0;0;0
2080510;Mongrel Games Minigames;;0 - 20,000;3;0;3;0;0;0
2080560;Fly Tales;;0 - 20,000;20;2;18;0;0;1
2080570;NoAmmo;;0 - 20,000;21;4;17;0;0;0
2080580;Hell Madness;;0 - 20,000;8;9;-1;0;0;0
2080640;First Date : Late To Date;;0 - 20,000;348;70;278;0;0;2
2080660;Bright Garden;;0 - 20,000;2;2;0;0;0;0
2080670;Dark Lady;;0 - 20,000;0;1;-1;0;0;0
2080880;Farmhand Go!;;0 - 20,000;0;1;-1;0;0;0
2080930;Whispering Abyss;;0 - 20,000;1;1;0;0;0;0
2081180;SquishCraft;;0 - 20,000;48;2;46;0;0;3
2081200;Haunted:Live;;0 - 20,000;3;2;1;0;0;0
2081220;OVERTOP;;0 - 20,000;3;4;-1;0;0;0
2081240;幻恋逢星之时;;0 - 20,000;0;1;-1;0;0;0
2081360;Humans Are Useless;;0 - 20,000;8;1;7;0;0;0
2081420;Witch Amelia;;0 - 20,000;16;2;14;0;0;3
2081470;Red Matter 2;;0 - 20,000;236;15;221;0;0;6
2081490;Die O'Clock;;0 - 20,000;12;2;10;0;0;1
2081640;The Voices Games 3d Collection;;20,000 - 50,000;3;1;2;0;0;0
2081770;Northern Kingdoms;;0 - 20,000;5;2;3;0;0;0
2081850;Galactic Story;;0 - 20,000;0;1;-1;0;0;0
2081860;The Van Game;;0 - 20,000;16;2;14;0;0;2
2081960;Moon Whalers;;0 - 20,000;0;1;-1;0;0;0
2082040;Volunteer;;50,000 - 100,000;4;7;-3;0;0;0
2082260;TAXINAUT;;0 - 20,000;13;1;12;0;0;2
2082290;Monkey Milk;;20,000 - 50,000;3;0;3;0;0;0
2082290;Monkey Milk;;20,000 - 50,000;3;0;3;0;0;0
2082300;Legacy;;100,000 - 200,000;2;1;1;0;0;0
2082440;Jumping!;;0 - 20,000;1;0;1;0;0;0
2082520;永恒至尊 Eternal Supreme;;0 - 20,000;17;8;9;0;0;0
2082560;Mutagenic;;0 - 20,000;25;2;23;0;0;3
2082620;Loot Express Delivery Service;;0 - 20,000;8;0;8;0;0;0
2082730;Empire of Empires;;0 - 20,000;21;6;15;0;0;0
2082830;Sapper Robot;;0 - 20,000;1;0;1;0;0;1
2082900;Star Devil;;0 - 20,000;5;1;4;0;0;1
2083130;PD Howler 2023;;0 - 20,000;2;0;2;0;0;0
2083180;Cat Herder;;0 - 20,000;33;0;33;0;0;0
2083280;FAST FOOD SHOP ONLINE;;0 - 20,000;4;8;-4;0;0;1
2083330;An old school adventure FPS - Go To Hell;;0 - 20,000;1;0;1;0;0;0
2083360;Spectre Of Eternity;;0 - 20,000;7;0;7;0;0;0
2083540;Disc Golf Online;;0 - 20,000;7;2;5;0;0;0
2083560;Eva：Final Mission;;0 - 20,000;81;16;65;0;0;0
2083580;Oblige Of CHAOS;;0 - 20,000;1;2;-1;0;0;0
2083670;Cats Yakuza - Online card game;;0 - 20,000;14;1;13;0;0;2
2083680;PegSoli+;;0 - 20,000;1;0;1;0;0;0
2083700;Ashen Will;;0 - 20,000;5;1;4;0;0;0
2083720;Box Runner!;;0 - 20,000;2;1;1;0;0;0
2083730;Physics Playground;;0 - 20,000;6;2;4;0;0;0
2083760;Tiki Tiki Hop;;0 - 20,000;0;1;-1;0;0;0
2083840;Her Name Was Fire;;0 - 20,000;161;50;111;0;0;1
2083870;Enworden;;0 - 20,000;4;0;4;0;0;0
2083900;FLERP;;20,000 - 50,000;229;38;191;6;6;8
2083960;Students of Psionic Power;;0 - 20,000;0;1;-1;0;0;0
2084010;CosmoOdyssey:Trip to Mars;;0 - 20,000;64;1;63;0;0;0
2084030;Pitch Black: A Dusklight Story - Episode One;;200,000 - 500,000;4;1;3;0;0;0
2084100;The Dancer: Definitive Edition;;0 - 20,000;7;0;7;0;0;0
2084170;TEND;;0 - 20,000;7;2;5;0;0;0
2084240;Starshifter;;0 - 20,000;7;2;5;0;0;1
2084260;Magefall;;0 - 20,000;1;0;1;0;0;0
2084270;Maze Ablaze;;0 - 20,000;2;0;2;0;0;0
2084410;SONOHIGURASHI VS. TOUHOU UNIVERSE2;;20,000 - 50,000;7;0;7;0;0;0
2084470;Jet Dancer;;0 - 20,000;3;1;2;0;0;0
2084510;Pathogen: Survival;;20,000 - 50,000;4;0;4;0;0;0
2084720;Home Run High;;0 - 20,000;26;4;22;0;0;5
2084930;Ever Seen A Cat? 3;;0 - 20,000;121;0;121;0;0;1
2084940;Mysterious School;;0 - 20,000;80;32;48;0;0;324
2084960;BattlefieldPriest;;0 - 20,000;1;2;-1;0;0;0
2085130;Monster Girl Dormitory;;0 - 20,000;126;19;107;0;0;1
2085230;Dawn of Kagura: Maika's Story - The Dragon's Wrath;;0 - 20,000;16;0;16;0;0;0
2085270;Arcade Waifu;;0 - 20,000;9;7;2;0;0;0
2085320;Meow Defence;;0 - 20,000;10;0;10;0;0;0
2085360;Insomnia: Theater in the Head;;50,000 - 100,000;855;21;834;0;0;3
2085460;The Last Fighter;;0 - 20,000;16;3;13;0;0;0
2085500;Restaurant Manager Simulator;;0 - 20,000;13;4;9;0;0;0
2085510;Fly Fly Tuk Tuk;;0 - 20,000;27;4;23;0;0;0
2085550;Truck Simulator in City;;0 - 20,000;2;8;-6;0;0;0
2085600;Gyro Gear Tournament+;;0 - 20,000;6;1;5;0;0;0
2085790;Mutant Meltdown;;0 - 20,000;29;6;23;0;0;1
2085800;Kalinur;;20,000 - 50,000;395;8;387;0;0;1
2085800;Kalinur;;20,000 - 50,000;395;8;387;0;0;1
2085860;Cat Dungeon;;0 - 20,000;5;0;5;0;0;0
2085870;Land of chaos;;0 - 20,000;0;2;-2;0;0;0
2085910;No Time For Caution;;0 - 20,000;9;1;8;0;0;0
2085920;TYRONE vs COPS VR;;0 - 20,000;80;4;76;0;0;1
2086060;DIMENSIONAL SLAUGHTER;;100,000 - 200,000;25;6;19;0;0;0
2086090;Violet's Party Mania;;0 - 20,000;1;0;1;0;0;0
2086120;Royal Idiots;;0 - 20,000;4;1;3;0;0;0
2086130;Canfield Solitaire Collection;;0 - 20,000;4;0;4;0;0;0
2086180;I commissioned some bees 4;;0 - 20,000;15;0;15;0;0;2
2086190;Protocol Aftertime;;0 - 20,000;1;0;1;0;0;0
2086190;Protocol Aftertime;;0 - 20,000;1;0;1;0;0;0
2086270;DodgeKing;;20,000 - 50,000;5;0;5;0;0;1
2086320;Lofi Checkers;;0 - 20,000;2;0;2;0;0;0
2086380;Miss Kobayashi's Dragon Maid Burst Forth!! Choro-gon☆Breath DIRECTOR'S CUT;;0 - 20,000;40;3;37;0;0;1
2086460;Idle Factory;;0 - 20,000;18;8;10;0;0;5
2086570;MMI;;0 - 20,000;18;1;17;0;0;0
2086580;Hiddens Awakening;;20,000 - 50,000;2;0;2;0;0;0
2086730;Fruit Girl Kiss;;0 - 20,000;3;4;-1;0;0;0
2086810;Golden Rails: World’s Fair;;0 - 20,000;12;1;11;0;0;4
2086820;Heroes of Hellas Origins: Part Two;;0 - 20,000;9;0;9;0;0;2
2086880;Upgrader;;0 - 20,000;2;1;1;0;0;0
2086890;Connect the Dots 3D;;0 - 20,000;3;2;1;0;0;0
2086990;Tanks Boom Boom;;0 - 20,000;10;13;-3;0;0;0
2087070;Obviously Inappropriate Content;;0 - 20,000;2;0;2;0;0;0
2087180;都市媚影-CityFascination;;0 - 20,000;7;1;6;0;0;3
2087350;Climb and Fight: Mafia;;0 - 20,000;10;1;9;0;0;1
2087470;I commissioned some bees 5;;0 - 20,000;14;0;14;0;0;0
2087480;I commissioned some bees 6;;0 - 20,000;8;0;8;0;0;1
2087850;Tribe War;;;;;0;;;
2087940;Non-Stop Raiders;;0 - 20,000;21;0;21;0;0;0
2088000;亂噏三國;;0 - 20,000;1;0;1;0;0;0
2088070;Zombie Hunter;;0 - 20,000;0;3;-3;0;0;0
2088120;Bloodwatch;;0 - 20,000;0;2;-2;0;0;0
2088160;天外武林 (Traveler of Wuxia);;20,000 - 50,000;1843;329;1514;165;165;304
2088170;Medal of Guardians;;50,000 - 100,000;8;5;3;0;0;23
2088340;Bratz: Flaunt your fashion;;0 - 20,000;113;53;60;0;0;4
2088360;Watch Your Plastic Duck;;0 - 20,000;94;7;87;0;0;7
2088420;Fill and Cross Pirate Riddles 3;;0 - 20,000;1;0;1;0;0;1
2088430;Holiday Jigsaw Christmas 2;;0 - 20,000;2;1;1;0;0;1
2088440;Holiday Jigsaw Christmas 3;;0 - 20,000;1;0;1;0;0;0
2088570;Tiny Rogues;;100,000 - 200,000;2553;62;2491;1555;1637;242
2088600;Vacation Adventures: Park Ranger 14;;0 - 20,000;3;0;3;0;0;0
2088630;Airport Ground Handling Simulator VR;;0 - 20,000;54;27;27;20;20;2
2088670;Puzzline;;0 - 20,000;8;0;8;0;0;6
2088680;天香与小百合 - Tinheung & Sayuri;;0 - 20,000;30;0;30;0;0;0
2088720;Hellfire;;0 - 20,000;1;0;1;0;0;0
2088720;Hellfire;;0 - 20,000;1;0;1;0;0;0
2088750;Mystic Gate;;0 - 20,000;18;1;17;0;0;8
2088960;Roghill Incident;;0 - 20,000;0;2;-2;0;0;0
2089080;Loot Box Waifus;;0 - 20,000;0;2;-2;0;0;0
2089110;HOTEL GREENWOOD;;0 - 20,000;72;20;52;0;0;0
2089110;HOTEL GREENWOOD;;0 - 20,000;72;20;52;0;0;0
2089330;双线交锋：收获日;;0 - 20,000;0;3;-3;0;0;0
2089350;Hatsune Miku Logic Paint S;;0 - 20,000;477;31;446;57;57;31
2089350;Hatsune Miku Logic Paint S;;0 - 20,000;477;31;446;57;57;31
2089450;Hot Springs Story 2;;0 - 20,000;27;4;23;0;0;22
2089460;Demong Hunter;;0 - 20,000;7;1;6;0;0;0
2089620;Dragon Prana;;0 - 20,000;3;2;1;0;0;0
2089710;A Most Extraordinary Gnome;;0 - 20,000;21;0;21;0;0;1
2089920;Shadow Heroes;;0 - 20,000;38;2;36;0;0;1
2090050;Girls vs Zombies;;0 - 20,000;2;3;-1;0;0;0
2090140;Power Ball 2022;;20,000 - 50,000;4;2;2;0;0;0
2090160;Sissa's Path;;0 - 20,000;12;0;12;0;0;0
2090450;LUMbA: REDUX;;20,000 - 50,000;9;0;9;0;0;0
2090480;War of Bellrook;;0 - 20,000;2;1;1;0;0;0
2090500;DON'T STOP, YOU'LL DIE!;;0 - 20,000;8;0;8;0;0;0
2090580;Matcha;;0 - 20,000;19;2;17;0;0;0
2090630;PLANETOIDS;;0 - 20,000;9;2;7;0;0;0
2090660;狠斗篮球;;0 - 20,000;1;0;1;0;0;0
2090700;WikiArena;;0 - 20,000;38;0;38;0;0;0
2090830;The Sob Island;;0 - 20,000;2;1;1;0;0;0
2091000;黄金矿工大冒险;;0 - 20,000;5;6;-1;0;0;0
2091080;Knights vs Nature;;0 - 20,000;1;0;1;0;0;0
2091120;天天萌泡泡;;0 - 20,000;2;1;1;0;0;0
2091130;True Idle Simulator;;0 - 20,000;46;4;42;0;0;16
2091190;Path;;0 - 20,000;3;0;3;0;0;0
2091230;Stories school;;0 - 20,000;10;0;10;0;0;0
2091240;Dagger of heroes;;0 - 20,000;10;2;8;0;0;0
2091280;Veggies War;;0 - 20,000;1;0;1;0;0;0
2091290;Moving Forward;;0 - 20,000;1;1;0;0;0;0
2091350;Twistingo Collector's Edition;;0 - 20,000;3;1;2;0;0;1
2091350;Twistingo Collector's Edition;;0 - 20,000;3;1;2;0;0;1
2091500;Warlords Under Siege;;20,000 - 50,000;206;37;169;0;0;13
2091510;TRAFFIC;;0 - 20,000;33;4;29;0;0;0
2091520;Aftertime;;0 - 20,000;10;7;3;0;0;0
2091530;Angry Angus;;0 - 20,000;3;0;3;0;0;0
2091610;MIDIToKey;;0 - 20,000;1;0;1;0;0;0
2091640;Hi Eggplant!;;0 - 20,000;18;2;16;0;0;0
2091650;MYAOSOFTガラケーコレクション;;0 - 20,000;5;1;4;0;0;0
2091680;Tap the Blocks;;0 - 20,000;5;0;5;0;0;0
2091720;Nightmare;;0 - 20,000;12;7;5;0;0;1
2091750;Cold Way;;0 - 20,000;3;0;3;0;0;0
2091810;Logic Circuit: Marble Puzzle;;0 - 20,000;2;0;2;0;0;0
2091830;Math Tower 2;;0 - 20,000;6;0;6;0;0;0
2091840;Planetary Defense: An Orbital Turret Defense System;;50,000 - 100,000;2;0;2;0;0;0
2091890;Hidden in the Dark;;0 - 20,000;8;0;8;0;0;0
2091910;Minschima;;0 - 20,000;6;0;6;0;0;0
2091930;2MD:VR Football Unleashed ALL✰STAR;;0 - 20,000;16;1;15;0;0;6
2091960;The Utility Room;;0 - 20,000;15;3;12;0;0;0
2092010;Attack of the Trafalas;;50,000 - 100,000;1;0;1;0;0;0
2092180;Underwater battles;;0 - 20,000;9;2;7;0;0;0
2092200;PixCursor;;0 - 20,000;0;1;-1;0;0;0
2092260;Pinch of Fighting Girls;;0 - 20,000;27;7;20;0;0;4
2092320;Broken System;;0 - 20,000;2;5;-3;0;0;0
2092410;Pink Explorer;;0 - 20,000;19;1;18;0;0;0
2092660;Magnet Block;;0 - 20,000;5;0;5;0;0;0
2092680;Where's the Bathroom!?!;;0 - 20,000;7;1;6;0;0;0
2092700;江湖群雄传;;0 - 20,000;3;8;-5;0;0;0
2092700;江湖群雄传;;0 - 20,000;3;8;-5;0;0;0
2092710;FootPool;;0 - 20,000;0;2;-2;0;0;0
2093020;Lonely White;;0 - 20,000;15;0;15;0;0;0
2093100;异世界的回响千雪之歌;;0 - 20,000;25;4;21;0;0;0
2093110;Sharp Eyed;;20,000 - 50,000;3;0;3;0;0;0
2093250;Witch Schools: Love Potions;;0 - 20,000;55;4;51;0;0;0
2093270;Death in the Night;;0 - 20,000;17;2;15;0;0;0
2093290;Neon Circle;;0 - 20,000;14;2;12;0;0;0
2093300;Robot Tormod;;0 - 20,000;13;1;12;0;0;0
2093330;Party Bunch;;0 - 20,000;10;7;3;0;0;1
2093340;Summer Games (Atari 2600/CPC/Master System/Spectrum);;0 - 20,000;1;0;1;0;0;0
2093380;Noclipped;;0 - 20,000;22;4;18;0;0;1
2093420;Making Lovers After Stories;;0 - 20,000;51;0;51;0;0;1
2093540;The Pier Arcade;;0 - 20,000;2;0;2;0;0;0
2093590;Moorhuhn X - Crazy Chicken X;;0 - 20,000;15;0;15;0;0;1
2093640;Hook&Loop;;20,000 - 50,000;10;1;9;0;0;0
2093650;NEAVE 2;;0 - 20,000;6;0;6;0;0;0
2093860;Get the Ball Rolling;;0 - 20,000;8;1;7;0;0;0
2093870;Reddish;;0 - 20,000;1;1;0;0;0;0
2093900;Island Cities - Jigsaw Puzzle;;0 - 20,000;96;2;94;0;0;0
2093950;Boots Quest DX;;0 - 20,000;36;0;36;0;0;0
2094160;GHOSTKEEPER;;0 - 20,000;0;1;-1;0;0;0
2094170;The Cold Forest;;0 - 20,000;11;12;-1;0;0;0
2094180;SHOOT THE BUUUUUUUGS;;0 - 20,000;1;0;1;0;0;0
2094190;苍白花树繁茂之时Blood Flowers;;0 - 20,000;65;9;56;0;0;1
2094250;Valhalla：Awakening of Valkyrie;;0 - 20,000;123;132;-9;14;14;3
2094300;Virtual AI - Aki & Mika;;0 - 20,000;10;7;3;0;0;0
2094340;Legend of Zero;;0 - 20,000;3;0;3;0;0;0
2094380;Chai;;0 - 20,000;1;0;1;0;0;0
2094480;Senet;;0 - 20,000;2;0;2;0;0;0
2094520;World Serpent;;0 - 20,000;2;0;2;0;0;0
2094620;Noblesse Oblige;;0 - 20,000;13;1;12;0;0;5
2094640;Save Daddy Trump 3: Rise Of Evil;;0 - 20,000;25;6;19;0;0;0
2094720;Tower Fall;;0 - 20,000;10;3;7;0;0;0
2094730;Tux and Fanny;;0 - 20,000;18;0;18;0;0;1
2094750;Timeloop: Sink Again Beach;;20,000 - 50,000;118;8;110;0;0;1
2094850;The Backrooms Footage;;0 - 20,000;39;19;20;0;0;0
2094890;Walk with the Living 2;;0 - 20,000;2;0;2;0;0;0
2095010;Coffee Break: A sip away from doom;;0 - 20,000;5;1;4;0;0;0
2095040;猟奇リスナー ～ 狙われた姫配信者 ～ Lunatic Viewer - Streamer Girl at Risk -;;0 - 20,000;2;0;2;0;0;0
2095060;Inhabit;;0 - 20,000;19;0;19;0;0;1
2095070;外道催眠術師と囚われのマリオネット - The Savage Hypnotist's Puppets -;;0 - 20,000;0;2;-2;0;0;0
2095080;Paperback Adventures;;0 - 20,000;35;1;34;0;0;5
2095100;Nature Escapes;;0 - 20,000;3;0;3;0;0;1
2095120;S.E.C.U.;;0 - 20,000;20;1;19;0;0;1
2095140;Locked in my darkness;;0 - 20,000;15;3;12;0;0;1
2095150;Wash Card;;0 - 20,000;0;1;-1;0;0;0
2095180;Numeral Lord;;0 - 20,000;50;2;48;0;0;4
2095190;CrossHud - Crosshair Overlay;;0 - 20,000;18;18;0;0;0;23
2095230;Limousine Parking Simulator;;0 - 20,000;20;8;12;0;0;0
2095290;Theseus Protocol;;20,000 - 50,000;183;49;134;227;227;8
2095300;Breakout 13;;200,000 - 500,000;3628;593;3035;593;838;719
2095330;BackRoomsNew;;0 - 20,000;4;1;3;0;0;0
2095350;NONOGRAM - KAWAII CUTIES;;0 - 20,000;4;1;3;0;0;0
2095430;Dwarf's Adventure;;0 - 20,000;6;2;4;0;0;1
2095450;Tiny Tactics;;50,000 - 100,000;462;77;385;663;663;31
2095600;KIKURA;;0 - 20,000;12;4;8;0;0;1
2095740;Survivor Of The Journey;;0 - 20,000;51;19;32;0;0;3
2095770;Pipes Puzzles;;0 - 20,000;1;3;-2;0;0;0
2095860;异界双子 -Twin Souls-;;50,000 - 100,000;4;1;3;0;0;0
2095860;异界双子 -Twin Souls-;;50,000 - 100,000;4;1;3;0;0;0
2095870;Expense;;0 - 20,000;1;0;1;0;0;0
2095900;This Girl Does Not Exist;;0 - 20,000;5;4;1;0;0;0
2095960;Isostasy;;0 - 20,000;1;0;1;0;0;0
2096040;VIRUSUM;;0 - 20,000;1;1;0;0;0;0
2096050;Warrior Maiden;;0 - 20,000;1;2;-1;0;0;0
2096080;Agent in Depth;;0 - 20,000;78;1;77;0;0;0
2096180;A Hero's Quest pt1;;0 - 20,000;2;0;2;0;0;0
2096310;Novastella Island;;0 - 20,000;151;171;-20;0;0;2
2096400;TAMAKAGURA: Tales of Turmoil;;0 - 20,000;14;0;14;0;0;1
2096480;Shattered Star;;0 - 20,000;6;1;5;0;0;0
2096560;The Top;;0 - 20,000;6;0;6;0;0;0
2096580;NekoNecro;;0 - 20,000;21;1;20;0;0;1
2096600;Crysis 2 Remastered;;100,000 - 200,000;1625;200;1425;221;355;145
2096610;Crysis 3 Remastered;;50,000 - 100,000;1244;150;1094;301;530;135
2096710;I Can't Hear Your Words, So I Want To Listen To Your Heart;;0 - 20,000;10;0;10;0;0;0
2096790;Assassin's Vol.;;0 - 20,000;48;19;29;0;0;0
2096800;Steel Saviour Reloaded;;0 - 20,000;4;1;3;0;0;0
2096960;Roll On Dice;;0 - 20,000;7;0;7;0;0;0
2097090;Snow Problem;;0 - 20,000;6;1;5;0;0;0
2097100;Jylko: Through The Song;;0 - 20,000;4;3;1;0;0;0
2097180;OxU;;0 - 20,000;21;0;21;0;0;2
2097550;Folktale;;0 - 20,000;6;1;5;0;0;0
2097670;Everett Isle;;0 - 20,000;0;2;-2;0;0;0
2097720;Black Market of Bulletphilia  ~ 100th Black Market.;;20,000 - 50,000;381;75;306;0;0;7
2097720;Black Market of Bulletphilia  ~ 100th Black Market.;;20,000 - 50,000;381;75;306;0;0;7
2097790;Kemomi-chan's Journey ~Enlightened Girl and the Innocent Doll~;;0 - 20,000;1;0;1;0;0;0
2097810;Burger Butt;;0 - 20,000;1;1;0;0;0;0
2097810;Burger Butt;;0 - 20,000;1;1;0;0;0;0
2097860;LO FI - A YEAR TO FULFILL MY DREAM.mp3;;0 - 20,000;1;0;1;0;0;0
2097900;Hold or Die;;0 - 20,000;1;2;-1;0;0;0
2097920;Fly to hope;;0 - 20,000;1;1;0;0;0;0
2097920;Fly to hope;;0 - 20,000;1;1;0;0;0;0
2098040;Lich Clicker;;20,000 - 50,000;2;1;1;0;0;0
2098070;Star Ring;;0 - 20,000;46;3;43;0;0;6
2098090;Lost Lands: Sand Captivity;;0 - 20,000;25;0;25;0;0;28
2098100;The madness of death;;0 - 20,000;13;5;8;0;0;0
2098130;International Basketball Manager 23;;0 - 20,000;48;9;39;0;0;14
2098210;Poly Memory: Primates;;0 - 20,000;2;0;2;0;0;0
2098280;The Perfect Garden;;0 - 20,000;14;0;14;0;0;0
2098390;Planet Surfer;;0 - 20,000;14;0;14;0;0;1
2098510;Zenkcraft;;0 - 20,000;23;1;22;0;0;6
2098540;슬픈 가족사 - 산장으로부터의 탈출;;0 - 20,000;2;0;2;0;0;0
2098540;슬픈 가족사 - 산장으로부터의 탈출;;0 - 20,000;2;0;2;0;0;0
2098600;Kiss the Demiurge;;0 - 20,000;14;0;14;0;0;0
2098730;Hammer 2 Reloaded;;0 - 20,000;1;3;-2;0;0;0
2098820;Galaxy Survivors;;0 - 20,000;17;4;13;0;0;1
2098860;Magic Сity Detective: Secret Desire Collector's Edition;;0 - 20,000;0;5;-5;0;0;0
2098930;Lucky Tlhalerwa - IMS Death Squad;;0 - 20,000;3;14;-11;0;0;0
2098960;Crossroads of life;;0 - 20,000;3;3;0;0;0;0
2099050;Home Deco Puzzles;;0 - 20,000;1;3;-2;0;0;0
2099060;Rikki Kuu;;0 - 20,000;1;0;1;0;0;0
2099080;Hidden Cats in London;;0 - 20,000;111;1;110;0;0;3
2099110;The Classrooms;;0 - 20,000;83;2;81;0;0;3
2099120;STARR RINGER;;0 - 20,000;5;0;5;0;0;0
2099150;Dark Maidens;;0 - 20,000;11;2;9;0;0;0
2099180;Kati The Astronaut;;0 - 20,000;1;0;1;0;0;0
2099190;Edge Of The End;;0 - 20,000;0;4;-4;0;0;0
2099220;Mobmania;;0 - 20,000;162;28;134;0;0;63
2099270;ProjectZombieSurvivors;;20,000 - 50,000;3;1;2;0;0;0
2099270;ProjectZombieSurvivors;;20,000 - 50,000;3;1;2;0;0;0
2099350;Fighter X Fighter;;0 - 20,000;6;1;5;0;0;0
2099370;PIP;;0 - 20,000;3;3;0;0;0;0
2099390;Umbral Omen;;0 - 20,000;1;1;0;0;0;0
2099400;Odd Guy Meets Odd Farmers - Comedy Boys Love (BL) Visual Novel;;0 - 20,000;5;0;5;0;0;0
2099420;NOTALONE;;0 - 20,000;4;1;3;0;0;0
2099430;Dork;;0 - 20,000;4;0;4;0;0;0
2099510;Smash The Synth;;0 - 20,000;1;1;0;0;0;0
2099610;Tales of Tarium: Awakening from the Ashes;;20,000 - 50,000;1;1;0;0;0;0
2099900;4X4;;50,000 - 100,000;37;2;35;0;0;5
2099910;Infinity Pinball;;0 - 20,000;2;0;2;0;0;0
2099940;Action: Vengeance;;0 - 20,000;1;1;0;0;0;0
2099960;Tuning Champions;;0 - 20,000;1;0;1;0;0;0
2100010;Breakthrough;;0 - 20,000;3;0;3;0;0;0
2100050;Spell Defender;;0 - 20,000;106;5;101;0;0;5
2100060;TurboMania Fog Racers;;0 - 20,000;4;2;2;0;0;0
2100090;Dodge;;0 - 20,000;7;0;7;0;0;1
2100200;Idle Zombies Clicker;;0 - 20,000;2;3;-1;0;0;0
2100210;LEGENO SLAYER;;0 - 20,000;4;3;1;0;0;0
2100230;Easy Simple Game;;0 - 20,000;17;2;15;0;0;0
2100250;Stanislav;;0 - 20,000;4;0;4;0;0;0
2100710;Ambulance Chauffeur Simulator;;0 - 20,000;11;6;5;0;0;0
2100720;Rat Cage;;0 - 20,000;12;2;10;0;0;2
2100740;Save the Girl;;0 - 20,000;17;7;10;0;0;0
2100780;Spin Time;;0 - 20,000;15;4;11;0;0;0
2100790;FunnyPizzaLand;;0 - 20,000;13;1;12;0;0;1
2100810;cheesequest;;0 - 20,000;17;1;16;0;0;1
2100830;The Imaginary Circle;;0 - 20,000;5;1;4;0;0;0
2100840;Neutrino;;0 - 20,000;1;0;1;0;0;0
2100940;Redhot Rabbit;;0 - 20,000;5;0;5;0;0;0
2101110;Touhou Soujinengi V -The Genius of Sappheiros-;;0 - 20,000;28;0;28;0;0;11
2101180;Underworld Re: Card;;0 - 20,000;2;4;-2;0;0;0
2101250;Nebula;;0 - 20,000;50;1;49;0;0;33
2101280;The Pyraplex;;0 - 20,000;5;0;5;0;0;7
2101330;City Legends: Trapped In Mirror Collector's Edition;;0 - 20,000;2;0;2;0;0;1
2101340;Maze Of Realities: Reflection Of Light Collector's Edition;;0 - 20,000;0;2;-2;0;0;0
2101350;BLACK SHEEP TOWN;;0 - 20,000;72;1;71;0;0;6
2101360;Crossroad of Worlds: 100 Doors Collector's Edition;;0 - 20,000;1;1;0;0;0;0
2101370;Sylvarcon 2049: A Cybersecurity Adventure;;0 - 20,000;2;2;0;0;0;0
2101410;Lost Beyond;;0 - 20,000;2;2;0;0;0;1
2101440;DreamCell: Lost in Nightmares;;0 - 20,000;7;0;7;0;0;0
2101480;Drunk: Relapsed;;0 - 20,000;7;0;7;0;0;1
2101490;After Wave: Downfall;;0 - 20,000;1;2;-1;0;0;0
2101630;Coins Collector Sport Car;;0 - 20,000;20;2;18;0;0;0
2101670;Miners and Machines;;0 - 20,000;17;1;16;0;0;0
2101680;good game;;0 - 20,000;4;2;2;0;0;0
2101690;Space Voyage: The Puzzle Game;;0 - 20,000;6;0;6;0;0;0
2101710;Cube Farmer - Puzzle;;0 - 20,000;19;0;19;0;0;0
2101760;Magus Pocus;;0 - 20,000;3;1;2;0;0;0
2101800;The Pinball Wizard;;0 - 20,000;39;7;32;0;0;1
2101880;Hard Life;;0 - 20,000;0;1;-1;0;0;0
2102070;无极修仙传·序章;;0 - 20,000;10;0;10;0;0;0
2102080;Spacetime Dimension;;50,000 - 100,000;1;0;1;0;0;0
2102110;Speed the Card Game;;0 - 20,000;1;0;1;0;0;0
2102130;Girl And Demon 1;;50,000 - 100,000;0;1;-1;0;0;0
2102150;JuXiaoYou;;0 - 20,000;15;5;10;0;0;1
2102240;Ravage Road;;0 - 20,000;15;8;7;0;0;9
2102330;The Reaper Survivors;;0 - 20,000;0;2;-2;0;0;0
2102530;Mega Fast Food: A Fast Food Simulator Game;;0 - 20,000;3;9;-6;0;0;0
2102680;Blinded by Fear;;0 - 20,000;20;2;18;0;0;1
2102770;EvoLife;;0 - 20,000;3;0;3;0;0;1
2102810;Cookie Clicker but You Type;;0 - 20,000;13;3;10;0;0;0
2102940;Jade Order;;20,000 - 50,000;9;1;8;0;0;0
2103290;Anvil Life;;50,000 - 100,000;2;1;1;0;0;0
2103320;Screaming Noppy;;0 - 20,000;1;0;1;0;0;0
2103340;Paragon Pioneers;;0 - 20,000;34;3;31;0;0;12
2103350;Nick Bounty - The Goat in the Grey Fedora: Remastered;;0 - 20,000;11;2;9;0;0;2
2103630;77 Oleander Avenue;;0 - 20,000;3;0;3;0;0;0
2103640;Axis Football 2023;;0 - 20,000;162;39;123;0;0;22
2103940;Skate Rift;;0 - 20,000;16;1;15;0;0;1
2104110;Little Hellions;;0 - 20,000;4;0;4;0;0;0
2104340;Neon Dungeon;;0 - 20,000;4;0;4;0;0;0
2104450;Termalloc;;0 - 20,000;1;1;0;0;0;0
2104530;DragonScales 1-7 Collection;;0 - 20,000;9;1;8;0;0;0
2104560;SOWON;;0 - 20,000;39;3;36;0;0;5
2104570;Stunning Policewoman;;0 - 20,000;4;9;-5;0;0;0
2104700;Bubble Shooter;;0 - 20,000;0;4;-4;0;0;0
2104760;The Absolute Destroyer;;0 - 20,000;14;4;10;0;0;1
2104770;Car Wash Simulator;;0 - 20,000;20;7;13;0;0;0
2104780;Spooky Mansion Manager;;0 - 20,000;10;1;9;0;0;0
2104790;Griddy;;0 - 20,000;73;4;69;0;0;0
2104850;Moving Jigsaw Puzzles;;0 - 20,000;4;0;4;0;0;1
2104960;Dash FPS;;0 - 20,000;2;1;1;0;0;0
2104970;Planked! Survive & Thrive;;0 - 20,000;0;2;-2;0;0;0
2105000;Super Choppy Orc;;0 - 20,000;21;0;21;0;0;2
2105010;The Edge Of The World Z (Will Shock You) حافه العالم زيد;;0 - 20,000;1;2;-1;0;0;0
2105010;The Edge Of The World Z (Will Shock You) حافه العالم زيد;;0 - 20,000;1;2;-1;0;0;0
2105090;Speedrunner's Paradise: Sky is the limit;;0 - 20,000;1;1;0;0;0;0
2105130;Observo;;0 - 20,000;22;2;20;0;0;2
2105140;The Packages;;20,000 - 50,000;2;1;1;0;0;0
2105170;Nature & Wildlife - Jigsaw Puzzle;;0 - 20,000;2;0;2;0;0;0
2105230;Adventure Trip: New York Collector's Edition;;0 - 20,000;1;0;1;0;0;1
2105390;3D Pacman;;0 - 20,000;0;1;-1;0;0;0
2105400;Terrorform;;0 - 20,000;4;0;4;0;0;0
2105410;Run Sheldon;;0 - 20,000;0;1;-1;0;0;0
2105420;Flappy Bird;;0 - 20,000;0;1;-1;0;0;0
2105460;Scorphius;;0 - 20,000;2;2;0;0;0;1
2105480;Soulsland: Last Fight;;0 - 20,000;14;6;8;0;0;0
2105490;Pocket Tank;;0 - 20,000;0;1;-1;0;0;0
2105660;I live under your house.;;0 - 20,000;75;3;72;0;0;0
2105660;I live under your house.;;0 - 20,000;75;3;72;0;0;0
2105670;Single Player: Horror;;0 - 20,000;2;1;1;0;0;0
2105760;Headz Go Racing;;0 - 20,000;0;1;-1;0;0;0
2105880;Kitty's Venture;;0 - 20,000;3;1;2;0;0;0
2105910;Garbanzo Quest;;0 - 20,000;18;0;18;0;0;0
2106080;Infinimine;;0 - 20,000;18;5;13;0;0;12
2106170;Super Weapon Master 超级武器大师;;0 - 20,000;27;5;22;0;0;1
2106340;Night Flight;;0 - 20,000;9;0;9;0;0;0
2106390;PERCNOPS VIRTUAL RIG;;0 - 20,000;4;0;4;0;0;0
2106420;Magic Market;;0 - 20,000;1;0;1;0;0;0
2106450;Brave survivors;;20,000 - 50,000;44;11;33;0;0;0
2106520;私のリアルは充実しすぎている フルボイス版;;50,000 - 100,000;1987;53;1934;1623;1623;134
2106530;PUTIN IN JAIL;;0 - 20,000;5;0;5;0;0;0
2106590;Dyestributor;;0 - 20,000;1;0;1;0;0;0
2106660;Mirror Beauty;;20,000 - 50,000;3;7;-4;0;0;0
2106760;The Burrito Quest;;0 - 20,000;5;0;5;0;0;0
2106770;Morris Cave;;0 - 20,000;26;0;26;0;0;0
2106810;The Forest of Drizzling Rain;;0 - 20,000;108;1;107;0;0;18
2106820;Picot Ether;;20,000 - 50,000;8;2;6;0;0;2
2106860;Spy Bros. (Pipi & Bibi's DX);;0 - 20,000;9;0;9;0;0;0
2107060;Deathrun Guys;;0 - 20,000;7;2;5;0;0;0
2107130;BirdsBorough : Town of Alchemy;;0 - 20,000;2;0;2;0;0;0
2107270;Closed Island;;0 - 20,000;12;7;5;0;0;2
2107290;Pixxxel;;0 - 20,000;14;2;12;0;0;0
2107420;Projekt Everblood;;0 - 20,000;1;0;1;0;0;0
2107480;Hypogean;;0 - 20,000;1;0;1;0;0;0
2107640;Bleeding Metal Rainbow;;0 - 20,000;6;2;4;0;0;0
2107650;Guardian of the jungle;;0 - 20,000;2;2;0;0;0;0
2107740;Freestyle Mage;;0 - 20,000;10;2;8;0;0;0
2107810;Marine Survivors;;20,000 - 50,000;16;14;2;0;0;1
2107860;Yggdra Union;;0 - 20,000;66;6;60;0;0;34
2107870;Jade's Adventure;;0 - 20,000;1;0;1;0;0;0
2107920;Mystery Solitaire. Dreamcatcher 2;;0 - 20,000;2;0;2;0;0;1
2108400;ATCo2;;0 - 20,000;1;0;1;0;0;0
2108420;Climb Challenge - Castle;;0 - 20,000;10;1;9;0;0;0
2108430;Charley's Day;;0 - 20,000;2;1;1;0;0;0
2108440;Lawless West;;0 - 20,000;28;5;23;0;0;0
2108600;Potato Survival;;0 - 20,000;123;1;122;0;0;1
2108730;Mythlands: Dragon Flight VR;;0 - 20,000;8;1;7;0;0;0
2108760;Hidden Cube World Top-Down 3D;;0 - 20,000;13;4;9;0;0;0
2108820;Pounce Cat;;0 - 20,000;4;1;3;0;0;0
2108840;REDDOOR;;0 - 20,000;1;0;1;0;0;0
2108870;Square Rounds;;0 - 20,000;1;0;1;0;0;0
2108980;MEDIEVAL WARRIOR SIMULATOR;;0 - 20,000;0;1;-1;0;0;0
2108990;GUILT;;0 - 20,000;0;6;-6;0;0;0
2109090;Joey and Penguin's 2 Player Adventure;;0 - 20,000;2;0;2;0;0;0
2109220;Special Agent Squeaky's Simple Video Converter;;0 - 20,000;1;0;1;0;0;0
2109440;Vajont VR;;0 - 20,000;6;2;4;0;0;0
2109460;VillageRhapsody;;200,000 - 500,000;7892;269;7623;242;293;231
2109530;Classic Snake;;0 - 20,000;2;0;2;0;0;0
2109550;Office Racer;;0 - 20,000;2;4;-2;0;0;0
2109610;Police Radar;;0 - 20,000;17;1;16;0;0;1
2109620;Aery - Path of Corruption;;0 - 20,000;27;0;27;0;0;0
2109630;SKY TOMB;;0 - 20,000;4;0;4;0;0;0
2109640;Cross Concerto;;0 - 20,000;186;12;174;0;0;2
2109650;Raid Healing;;0 - 20,000;6;2;4;0;0;1
2109660;Beam Splitter;;0 - 20,000;4;0;4;0;0;0
2109700;Temple of Horror;;0 - 20,000;21;0;21;0;0;1
2109720;The Wild: Survival Game;;0 - 20,000;0;2;-2;0;0;0
2109800;My Dear Sister;;20,000 - 50,000;5;1;4;0;0;0
2109850;Barbershop Simulator VR;;0 - 20,000;25;8;17;0;0;1
2110070;Tribe Explorer;;0 - 20,000;10;2;8;0;0;1
2110240;PUCK RUNNER;;0 - 20,000;4;0;4;0;0;0
2110320;Ash Battle;;0 - 20,000;3;0;3;0;0;0
2110430;after the meteor shower;;50,000 - 100,000;1;0;1;0;0;0
2110440;ARROW;;0 - 20,000;3;0;3;0;0;0
2110510;DREAM LOGIC;;0 - 20,000;113;11;102;0;0;1
2110520;Find Me In The Maze;;0 - 20,000;1;1;0;0;0;0
2110550;eXecutor;;0 - 20,000;0;1;-1;0;0;0
2110570;Farma Force;;0 - 20,000;0;5;-5;0;0;0
2110760;Heist Master;;0 - 20,000;1;0;1;0;0;0
2110930;Zombie Prison Break;;0 - 20,000;2;1;1;0;0;0
2111000;Klitorax;;0 - 20,000;13;0;13;0;0;0
2111040;Dead Beacon;;0 - 20,000;49;3;46;0;0;2
2111220;The Resurrection Of Amelia : Across two worlds;;0 - 20,000;27;1;26;0;0;0
2111300;The City Cards Challenge;;0 - 20,000;0;1;-1;0;0;0
2111390;The Lost Abyss;;0 - 20,000;10;1;9;0;0;0
2111400;SUN SHOT;;0 - 20,000;12;2;10;0;0;0
2111410;Unreal Vendetta;;0 - 20,000;9;0;9;0;0;0
2111420;Obedient Servant;;0 - 20,000;10;2;8;0;0;0
2111470;Wandering Duelist;;0 - 20,000;4;2;2;0;0;0
2111490;Sins From Magdala;;0 - 20,000;1;1;0;0;0;0
2111630;JR EAST Train Simulator;;0 - 20,000;348;242;106;0;0;34
2111770;Star Trust - 3D Shooter Game;;0 - 20,000;2;6;-4;0;0;0
2111860;勇者之书;;0 - 20,000;114;21;93;0;0;16
2111920;Fantasy Climber. Fun Adventure;;0 - 20,000;1;0;1;0;0;0
2111980;Unstable Rock;;0 - 20,000;1;0;1;0;0;0
2112000;Boat Rage;;0 - 20,000;0;5;-5;0;0;0
2112020;AdvLite;;0 - 20,000;0;5;-5;0;0;0
2112140;CAPTROON;;0 - 20,000;7;0;7;0;0;0
2112150;Fishing Game;;0 - 20,000;28;0;28;0;0;1
2112200;古巫竞技场 Ancient Witch Arena;;0 - 20,000;62;22;40;0;0;1
2112210;Ensora;;0 - 20,000;10;3;7;0;0;3
2112270;进入后室 Get into Backrooms;;0 - 20,000;4;0;4;0;0;0
2112330;Epileptic Seizure Battle Ball Challenge;;0 - 20,000;1;0;1;0;0;0
2112360;Droneboi 2;;0 - 20,000;7;2;5;0;0;0
2112390;Water Chaos;;0 - 20,000;0;5;-5;0;0;0
2112420;Pillazon: MMO Drug Lord Tycoon;;0 - 20,000;32;6;26;0;0;8
2112500;Kaiju Klash;;0 - 20,000;3;0;3;0;0;0
2112520;her tears were my light;;0 - 20,000;188;0;188;0;0;0
2112550;Ice Nosfe;;0 - 20,000;6;0;6;0;0;0
2112570;Zombies TD;;0 - 20,000;2;2;0;0;0;0
2112580;Elite Forces;;20,000 - 50,000;1;1;0;0;0;0
2112580;Elite Forces;;20,000 - 50,000;1;1;0;0;0;0
2112910;The Fish;;0 - 20,000;1;0;1;0;0;0
2112990;王子斗恶龙2 Prince fighting dragon 2;;0 - 20,000;2;0;2;0;0;0
2113010;Fragment of Humanity;;0 - 20,000;1;0;1;0;0;0
2113030;The Nameless;;0 - 20,000;7;0;7;0;0;0
2113160;Flying Umbrella;;0 - 20,000;3;0;3;0;0;0
2113170;Sticky Steve's Sticky Situation;;0 - 20,000;3;0;3;0;0;0
2113180;Into the Sinkhole;;0 - 20,000;67;17;50;0;0;1
2113210;Blue Print;;0 - 20,000;0;1;-1;0;0;0
2113230;Oil-Manager;;0 - 20,000;2;2;0;0;0;0
2113250;GasolineGypsiesGame;;0 - 20,000;3;0;3;0;0;0
2113290;Spam Text;;0 - 20,000;6;0;6;0;0;0
2113310;Morning Kiss;;0 - 20,000;2;1;1;0;0;0
2113320;Pure Love;;0 - 20,000;3;1;2;0;0;0
2113330;Pixel Boy: The Legend of Tain;;0 - 20,000;3;1;2;0;0;0
2113370;Hex Picross;;0 - 20,000;21;11;10;0;0;0
2113440;Hooligan James;;0 - 20,000;4;0;4;0;0;0
2113490;Mess Quest;;0 - 20,000;59;1;58;0;0;0
2113530;Arrogation: Unlight of Day;;50,000 - 100,000;149;23;126;0;0;1
2113540;梦魇：无归 Nightmare without return;;20,000 - 50,000;533;13;520;0;0;13
2113580;Haste-Miner 2;;0 - 20,000;15;4;11;0;0;90
2113690;Splash Ship;;0 - 20,000;1;3;-2;0;0;0
2113770;In Woods;;0 - 20,000;43;7;36;0;0;4
2113790;Home Office Simulator;;0 - 20,000;0;2;-2;0;0;0
2113900;Touge Shakai;;0 - 20,000;151;33;118;0;0;15
2113920;"The Legend of Heroes: Kuro no Kiseki Ⅱ -CRIMSON SiN-	";;0 - 20,000;237;29;208;0;0;247
2113970;The Original Island;;0 - 20,000;1;1;0;0;0;0
2113990;山海长歌;;0 - 20,000;4;2;2;0;0;0
2114020;山间有点田-Sweet In the Mountains;;0 - 20,000;6;2;4;0;0;0
2114070;Talon City: Death from Above;;0 - 20,000;5;1;4;0;0;0
2114090;Goetita: Turn-based City;;0 - 20,000;0;2;-2;0;0;0
2114150;Warna;;0 - 20,000;0;1;-1;0;0;0
2114170;눈 떠보니 임진왜란이었다 - Back To the Joseon;;0 - 20,000;9;17;-8;0;0;0
2114180;MAGNET EFFECT;;0 - 20,000;11;0;11;0;0;1
2114190;Interstellar Turtle Legend;;20,000 - 50,000;3;0;3;0;0;0
2114240;Ean's End;;0 - 20,000;14;1;13;0;0;0
2114360;Maze Blaze;;0 - 20,000;5;2;3;0;0;0
2114370;Takoyaki Party Survival;;0 - 20,000;170;13;157;692;730;2
2114390;Cube Adventure;;50,000 - 100,000;13;2;11;0;0;0
2114390;Cube Adventure;;50,000 - 100,000;13;2;11;0;0;0
2114430;ACHIEVEMENTS CITY;;0 - 20,000;19;4;15;0;0;0
2114440;Elland: The Crystal Wars;;0 - 20,000;2;0;2;0;0;0
2114500;伏魔天师;;0 - 20,000;17;3;14;0;0;1
2114520;Blood and Sorcery;;0 - 20,000;3;0;3;0;0;0
2114790;AIdventure;;0 - 20,000;13;1;12;0;0;2
2114790;AIdventure;;0 - 20,000;13;1;12;0;0;2
2114810;Tetris Girls;;0 - 20,000;13;15;-2;0;0;2
2114830;Belt Colony;;0 - 20,000;7;1;6;0;0;0
2114860;Gumnaam;;20,000 - 50,000;1;1;0;0;0;0
2114890;War Obelisks;;0 - 20,000;0;1;-1;0;0;0
2114960;Built Different;;0 - 20,000;1;0;1;0;0;0
2114990;Missile Command: Recharged;;0 - 20,000;7;1;6;0;0;0
2115020;Froggin Up;;0 - 20,000;2;0;2;0;0;0
2115050;Puzzle: Nature 2;;0 - 20,000;9;2;7;0;0;0
2115060;Magic Kingdom;;0 - 20,000;13;6;7;0;0;1
2115080;Hex;;20,000 - 50,000;2;0;2;0;0;0
2115140;The Levels of Backrooms;;0 - 20,000;2;1;1;0;0;0
2115170;Jurassic Clans;;0 - 20,000;10;7;3;0;0;1
2115190;Unify;;0 - 20,000;2;0;2;0;0;0
2115260;Real Virtual Desktops;;0 - 20,000;3;1;2;0;0;0
2115300;Chroma Key;;0 - 20,000;1;0;1;0;0;0
2115400;Muse&Barbarian;;0 - 20,000;10;1;9;0;0;0
2115470;PIP 2;;0 - 20,000;2;2;0;0;0;0
2115480;Poly Puzzle: Predators;;0 - 20,000;0;1;-1;0;0;1
2115560;Slime Runner;;0 - 20,000;1;0;1;0;0;0
2115620;CyberLink PowerDirector 21 Ultra;;0 - 20,000;1;1;0;0;0;0
2115650;Xeno Command;;0 - 20,000;33;5;28;0;0;2
2115710;Necropolis of the Angels;;20,000 - 50,000;1;0;1;0;0;0
2115720;Botanical TD;;0 - 20,000;2;0;2;0;0;1
2116250;Draft Day Sports: College Football 2023;;0 - 20,000;5;4;1;0;0;9
2116260;Relic Dudes;;0 - 20,000;134;9;125;0;0;3
2116300;Epic Survivors;;0 - 20,000;3;3;0;0;0;0
2116460;Anomaly;;0 - 20,000;4;0;4;0;0;0
2116710;Windsurfing MMX;;0 - 20,000;2;2;0;0;0;0
2116750;Lawnmower Game: Space Race;;0 - 20,000;15;3;12;0;0;0
2116770;Armoured Cavalry: Operation Varkiri;;0 - 20,000;27;3;24;0;0;4
2116800;モノマギア・カンタービレ;;0 - 20,000;5;1;4;0;0;0
2116840;最后四人-The last four;;0 - 20,000;2;1;1;0;0;0
2116850;Another Farm Roguelike;;0 - 20,000;183;28;155;117;117;14
2116850;Another Farm Roguelike;;0 - 20,000;183;28;155;117;117;14
2116890;Zodiac fantasy 2;;50,000 - 100,000;103;12;91;2;2;0
2116920;Runic Survivor;;0 - 20,000;131;32;99;0;0;6
2116930;Mozart Requiem;;20,000 - 50,000;3;5;-2;0;0;0
2116950;Tiny Solar System;;0 - 20,000;10;0;10;0;0;0
2116980;The Hideaway;;0 - 20,000;5;3;2;0;0;0
2117070;Asteria: Daniel Bélanger;;0 - 20,000;1;0;1;0;0;0
2117080;Asian Truck Simulator;;0 - 20,000;38;2;36;0;0;1
2117090;Let's Park Backyard Edition;;0 - 20,000;14;1;13;0;0;1
2117170;Kardun;;0 - 20,000;3;0;3;0;0;0
2117190;Spliced;;0 - 20,000;3;0;3;0;0;0
2117230;Night of the Wererat;;0 - 20,000;9;4;5;0;0;0
2117360;Terror Time;;0 - 20,000;6;1;5;0;0;0
2117410;Cosmotica;;0 - 20,000;8;0;8;0;0;0
2117790;Crash Override;;0 - 20,000;2;0;2;0;0;0
2117930;Drakkon World Builder;;20,000 - 50,000;14;0;14;0;0;0
2117960;Slay The Zone;;0 - 20,000;8;2;6;0;0;0
2118030;MushRun;;20,000 - 50,000;1;0;1;0;0;0
2118110;Catlike Magic;;0 - 20,000;19;1;18;0;0;0
2118130;Chicken Feet;;0 - 20,000;211;21;190;0;0;1
2118290;Lovely Trap;;0 - 20,000;2;1;1;0;0;0
2118500;Touhou Library Survivors;;0 - 20,000;48;7;41;0;0;1
2118540;My Big Sister: Remastered;;0 - 20,000;34;1;33;0;0;0
2118550;FastRogue;;0 - 20,000;1;1;0;0;0;1
2118570;Hear Your Path;;0 - 20,000;15;4;11;0;0;0
2118580;SuperTotalCarnage!;;0 - 20,000;42;17;25;0;0;10
2118690;Blockpop Heroes;;0 - 20,000;5;1;4;0;0;0
2118910;The Chaput's Baby;;0 - 20,000;29;2;27;0;0;0
2118990;Mars: The New Eden;;0 - 20,000;2;2;0;0;0;0
2119050;Idle Vikings Clicker;;0 - 20,000;7;2;5;0;0;1
2119070;Bridge to Another World: Cursed Clouds Collector's Edition;;0 - 20,000;1;0;1;0;0;1
2119210;VOYAGER;;0 - 20,000;66;0;66;0;0;3
2119380;Amaya's Lost Soul;;0 - 20,000;1;0;1;0;0;0
2119390;Discvivors;;0 - 20,000;4;0;4;0;0;0
2119420;Soldier;;0 - 20,000;8;1;7;0;0;0
2119570;Panda Roll;;0 - 20,000;11;0;11;0;0;0
2119700;Cyber Tetris;;20,000 - 50,000;0;2;-2;0;0;0
2119730;Arcane Arts Academy 2;;0 - 20,000;9;1;8;0;0;4
2119940;Her World;;0 - 20,000;323;4;319;42;42;0
2119960;Cursed House 11 Match 3 Puzzle;;0 - 20,000;2;0;2;0;0;1
2120100;Top Fun 10 VR;;0 - 20,000;0;1;-1;0;0;0
2120120;Grim Tales: Horizon Of Wishes Collector's Edition;;0 - 20,000;2;0;2;0;0;1
2120140;Marble on Rails;;0 - 20,000;1;0;1;0;0;0
2120240;Christmas Blaster;;0 - 20,000;4;0;4;0;0;0
2120270;Bite Nite;;0 - 20,000;5;0;5;0;0;0
2120340;Zombie Mansion;;0 - 20,000;1;0;1;0;0;0
2120410;The Letter: Classic Edition;;0 - 20,000;12;2;10;0;0;0
2120510;Simple Builder;;0 - 20,000;3;3;0;0;0;0
2120670;诡仙志异;;0 - 20,000;7;2;5;0;0;1
2120790;Ringborn;;0 - 20,000;1;1;0;0;0;0
2120810;The Peak Climb VR;;0 - 20,000;1;6;-5;0;0;0
2120820;Final Recurrence;;0 - 20,000;6;4;2;0;0;1
2120830;Mortal Dark;;0 - 20,000;3;1;2;0;0;0
2120880;Doomsday Contact;;0 - 20,000;1;0;1;0;0;0
2120900;Fears to Fathom - Carson House;;20,000 - 50,000;545;67;478;0;0;28
2120910;Petite Adventure;;0 - 20,000;3;0;3;0;0;0
2121130;Tankron;;0 - 20,000;4;0;4;0;0;0
2121130;Tankron;;0 - 20,000;4;0;4;0;0;0
2121260;My Mad Scientist Roommate Turned Me Into Her Personal Robotic Battle Maiden?!?;;0 - 20,000;12;0;12;0;0;2
2121350;ALPHA BOX;;0 - 20,000;3;0;3;0;0;0
2121440;Monster Slayer Extermination;;0 - 20,000;1;0;1;0;0;0
2121480;The Silent Huntress;;0 - 20,000;11;0;11;0;0;0
2121490;Otome Legends;;0 - 20,000;9;0;9;0;0;1
2121770;reflex runner;;0 - 20,000;2;0;2;0;0;1
2121840;江山如画;;0 - 20,000;7;3;4;0;0;1
2121910;Bunny Eureka;;0 - 20,000;11;0;11;0;0;0
2122010;Rise Of A Hero;;0 - 20,000;4;2;2;0;0;0
2122070;Girl & Gem Magic;;0 - 20,000;5;3;2;0;0;0
2122170;MEGA;;20,000 - 50,000;42;7;35;0;0;0
2122190;From atom to modern;;0 - 20,000;14;4;10;0;0;10
2122210;Battle of Vukovar: Rain of Steel;;0 - 20,000;33;10;23;0;0;2
2122230;Glass Bridge;;0 - 20,000;1;1;0;0;0;0
2122430;Renai X Royale - Love's a Battle;;0 - 20,000;56;5;51;0;0;9
2122490;机械兽：进化（Mechanical beast: Evolution）;;0 - 20,000;1;4;-3;0;0;0
2122550;Mushroom Card RPG;;0 - 20,000;32;1;31;0;0;0
2122590;Call of Dusk;;0 - 20,000;0;1;-1;0;0;0
2122700;TK-cosgan;;0 - 20,000;0;1;-1;0;0;0
2122770;Kings and Catapults;;20,000 - 50,000;2;0;2;0;0;0
2122810;Alpaclands;;0 - 20,000;2;0;2;0;0;0
2122840;Fast or Dead VR;;0 - 20,000;0;1;-1;0;0;0
2123000;Save and Conquer : 8 Years;;0 - 20,000;4;0;4;0;0;0
2123020;Across The Globe;;0 - 20,000;6;1;5;0;0;0
2123030;Idle magic herb;;0 - 20,000;7;15;-8;0;0;0
2123050;TAKIBI;;0 - 20,000;9;2;7;0;0;1
2123100;Kitty May Cry;;0 - 20,000;51;4;47;0;0;1
2123110;Space Bot;;0 - 20,000;2;1;1;0;0;0
2123120;Ultimate Protector;;0 - 20,000;36;5;31;0;0;1
2123140;The Scarlet Demonslayer;;0 - 20,000;158;41;117;0;0;10
2123270;Dragon Must Die;;0 - 20,000;4;3;1;0;0;0
2123320;ClearIt 13;;0 - 20,000;5;0;5;0;0;3
2123390;CyberBlocker Complete Edition;;20,000 - 50,000;5;0;5;0;0;0
2123420;Vilomah;;0 - 20,000;14;5;9;0;0;0
2123510;LocoMotion;;0 - 20,000;1;0;1;0;0;0
2123530;STELLABITS;;0 - 20,000;1;0;1;0;0;0
2123550;Road Frog;;0 - 20,000;0;1;-1;0;0;0
2123560;Frenzy;;0 - 20,000;2;0;2;0;0;0
2123690;Forest Tower Defense;;0 - 20,000;19;7;12;0;0;0
2123800;TheTravelGame;;0 - 20,000;12;0;12;0;0;0
2123840;回忆画册~MemoriesAlbum~;;0 - 20,000;45;32;13;0;0;1
2123990;Shift of War;;0 - 20,000;3;3;0;0;0;0
2124040;Department of the Devil;;0 - 20,000;12;0;12;0;0;0
2124210;Orebody: Binder's Tale;;0 - 20,000;2;1;1;0;0;0
2124240;RichBroker;;0 - 20,000;1;1;0;0;0;0
2124380;Super Lesbian Animal RPG;;0 - 20,000;453;4;449;0;0;18
2124420;Fate Seeker: Journey;;50,000 - 100,000;773;217;556;1042;1042;24
2124460;Asteroids and more asteroids;;0 - 20,000;4;0;4;0;0;0
2124470;活字引擎;;0 - 20,000;93;0;93;0;0;14
2124560;Jump Journey;;0 - 20,000;1;1;0;0;0;0
2124590;City Bus Driver Simulator;;0 - 20,000;14;10;4;0;0;0
2124640;Ninja Hagakure;;0 - 20,000;1;0;1;0;0;0
2124650;The King's Castle;;0 - 20,000;10;3;7;0;0;0
2124660;Fix My Cat Doc;;0 - 20,000;12;0;12;0;0;0
2124670;The Pizza Courier;;0 - 20,000;27;6;21;0;0;0
2124760;Manifest;;0 - 20,000;1;0;1;0;0;0
2124770;Tuin;;0 - 20,000;50;11;39;0;0;1
2124780;Endoparasitic;;100,000 - 200,000;1498;103;1395;180;234;12
2124790;Sir Questionnaire;;50,000 - 100,000;1;2;-1;0;0;0
2124800;Elya Richi vs Blackstone : Nuclear War;;0 - 20,000;1;0;1;0;0;0
2124810;İfrit;;0 - 20,000;11;12;-1;0;0;0
2124900;Swords and Adventures;;0 - 20,000;3;0;3;0;0;1
2125050;Out of the Cube;;0 - 20,000;12;0;12;0;0;0
2125070;孤胆惊魂3:起源 Fear3:Origins;;0 - 20,000;6;3;3;0;0;0
2125100;Be My Loyal Subject - Historical Boys Love (BL) Visual Novel;;0 - 20,000;6;0;6;0;0;0
2125140;Eat Me Alive;;0 - 20,000;1;2;-1;0;0;0
2125190;Bowling Hills;;0 - 20,000;2;0;2;0;0;0
2125300;Off to Sleep;;0 - 20,000;1;0;1;0;0;0
2125400;Snuff;;0 - 20,000;16;0;16;0;0;0
2125420;Zorbus;;20,000 - 50,000;106;12;94;185;185;5
2125500;Two Move Chess;;0 - 20,000;1;0;1;0;0;0
2125530;Love Photo Studio/真爱照相馆;;0 - 20,000;1;0;1;0;0;0
2125580;锻灵ElementForger;;0 - 20,000;8;0;8;0;0;0
2125720;RX Racing 2022 Pro;;0 - 20,000;0;1;-1;0;0;0
2125770;Beeny;;0 - 20,000;206;3;203;0;0;1
2125880;Poly Parkour;;0 - 20,000;5;1;4;0;0;0
2125920;Mining Odyssey;;0 - 20,000;1;0;1;0;0;0
2125950;HUNDRED FIRES: The rising of red star - EPISODE 2;;0 - 20,000;6;0;6;0;0;1
2126210;Bone Lover - Horror Escape;;0 - 20,000;14;0;14;0;0;0
2126250;My Bloody Weekend;;0 - 20,000;11;5;6;0;0;0
2126300;Fix My Legs Doc;;0 - 20,000;15;2;13;0;0;0
2126310;Stunts Contest Super Bike;;0 - 20,000;5;0;5;0;0;0
2126340;恋ひ焦がるるカミカクシ;;0 - 20,000;1;0;1;0;0;0
2126380;Fight Until Death;;0 - 20,000;0;1;-1;0;0;0
2126500;WWII Tanks: Forgotten Battles;;20,000 - 50,000;1;2;-1;0;0;0
2126590;Brichi Quest;;0 - 20,000;1;0;1;0;0;0
2126600;Astro VR;;0 - 20,000;3;0;3;0;0;0
2126620;Super DynoStory;;0 - 20,000;11;0;11;0;0;0
2126630;The Fantastic Kitty Rue;;0 - 20,000;12;0;12;0;0;0
2126650;The Myriad;;0 - 20,000;0;1;-1;0;0;0
2126700;Double Trouble;;0 - 20,000;4;0;4;0;0;0
2126830;ZOOGARNIAN;;0 - 20,000;1;0;1;0;0;0
2126840;Witch's Mystery;;0 - 20,000;5;5;0;0;0;0
2126870;HimeYoku: A Sacrifice of Lust and Grace;;0 - 20,000;84;3;81;0;0;2
2126990;Lost World;;0 - 20,000;125;53;72;22;22;24
2127100;Grappling Dash;;0 - 20,000;28;3;25;0;0;1
2127160;Tarot for Storytelling;;0 - 20,000;1;0;1;0;0;0
2127230;MOONPONG: Tales of Epic Lunacy;;0 - 20,000;19;0;19;0;0;0
2127440;中国式富豪;;0 - 20,000;0;3;-3;0;0;0
2127550;Detective tales: A Study in Scarlet;;0 - 20,000;7;0;7;0;0;0
2127590;Lost In The Backrooms;;0 - 20,000;1;11;-10;0;0;0
2127610;一号(One);;0 - 20,000;1;1;0;0;0;0
2127660;Zimmer;;0 - 20,000;6;0;6;0;0;0
2127700;Noracam's Slider Challenge;;0 - 20,000;4;1;3;0;0;0
2127720;Hexcross;;0 - 20,000;3;0;3;0;0;0
2127810;Learning Geography: Countries of the World;;0 - 20,000;3;0;3;0;0;1
2127930;PixelType;;0 - 20,000;1;0;1;0;0;0
2127990;when we lost;;0 - 20,000;1;0;1;0;0;0
2128010;world of motors 2;;0 - 20,000;0;1;-1;0;0;0
2128020;Step Journey;;0 - 20,000;10;0;10;0;0;0
2128030;Catch Them If You Can;;0 - 20,000;3;0;3;0;0;0
2128130;The Legend of Gandar II;;0 - 20,000;2;0;2;0;0;0
2128140;DeerHunterFan.com TV - The Season;;0 - 20,000;5;0;5;0;0;1
2128220;The Most Awesome Game Ever Made;;0 - 20,000;41;2;39;0;0;1
2128300;Dungeon in a Bottle;;0 - 20,000;8;0;8;0;0;0
2128310;Ceaseless Night;;0 - 20,000;8;0;8;0;0;0
2128340;Death Trials (Director's Cut);;0 - 20,000;2;1;1;0;0;0
2128360;Waking Knightmare;;0 - 20,000;3;0;3;0;0;0
2128390;Leviathan: An Interactive Comic Book;;0 - 20,000;1;0;1;0;0;0
2128400;Code:29;;50,000 - 100,000;2;3;-1;0;0;0
2128410;World of Naples;;0 - 20,000;1;0;1;0;0;0
2128560;Mycorrhiza;;0 - 20,000;4;0;4;0;0;0
2128570;海峡の故郷;;0 - 20,000;5;0;5;0;0;0
2128610;The Blood Amulet;;20,000 - 50,000;2;0;2;0;0;0
2128630;To Eternity;;0 - 20,000;1;0;1;0;0;0
2128690;Super Block Crush;;0 - 20,000;11;0;11;0;0;0
2128710;Chilljong;;0 - 20,000;2;0;2;0;0;0
2128760;Heartless;;0 - 20,000;4;0;4;0;0;0
2128770;SGS Okinawa;;0 - 20,000;4;0;4;0;0;1
2128840;Hunting grounds;;0 - 20,000;1;0;1;0;0;0
2128930;Crescent Cauldron Cafe;;0 - 20,000;7;0;7;0;0;0
2128970;Nightmare Hunter;;20,000 - 50,000;1;0;1;0;0;0
2128990;Gold Of Lotusland;;20,000 - 50,000;2;0;2;0;0;0
2129140;My House Is Haunted;;0 - 20,000;3;0;3;0;0;0
2129150;Horror Tale 1: Kidnapper;;0 - 20,000;18;6;12;0;0;0
2129190;Plan B - Goddess's cards;;0 - 20,000;3;3;0;0;0;0
2129200;Silen House;;0 - 20,000;25;16;9;0;0;14
2129280;Trap of MUSK:Europe Night;;0 - 20,000;58;16;42;0;0;21
2129290;Scary School Simulator;;0 - 20,000;4;9;-5;0;0;0
2129410;Salt Game;;0 - 20,000;2;0;2;0;0;0
2129540;Peregrine;;0 - 20,000;7;1;6;0;0;0
2129660;Village and The Witch;;20,000 - 50,000;1;1;0;0;0;0
2129720;GUILTY;;0 - 20,000;10;1;9;0;0;0
2129780;The Impossible Knight Runner;;0 - 20,000;2;0;2;0;0;0
2129830;Deathwish;;0 - 20,000;0;1;-1;0;0;0
2129850;Corgi Cove;;0 - 20,000;1;0;1;0;0;0
2129860;Little Horror Raiser;;0 - 20,000;1;0;1;0;0;0
2129950;HorrorBox;;0 - 20,000;4;2;2;0;0;0
2130060;Tower Walker: MMO Grind Simulator;;0 - 20,000;24;5;19;0;0;54
2130170;Bubbbles;;0 - 20,000;2;0;2;0;0;0
2130440;Decopins -Asset Fighters Series-;;0 - 20,000;5;0;5;0;0;0
2130470;Evening Vibes;;0 - 20,000;18;11;7;0;0;0
2130500;Under Observation;;0 - 20,000;2;0;2;0;0;0
2130510;Divinus Vanitas;;0 - 20,000;22;4;18;0;0;3
2130540;目盲/Blind;;20,000 - 50,000;479;57;422;0;0;6
2130540;目盲/Blind;;20,000 - 50,000;479;57;422;0;0;6
2130650;城市工人模拟器;;0 - 20,000;1;0;1;0;0;0
2130750;Cracked;;0 - 20,000;2;1;1;0;0;0
2130940;Puzzle Park;;0 - 20,000;23;8;15;0;0;1
2130980;Todd's Adventures in Slime World (Lynx/Mega Drive);;0 - 20,000;3;0;3;0;0;0
2131050;Handyman;;0 - 20,000;11;11;0;0;0;1
2131100;Zombie Age;;0 - 20,000;2;0;2;0;0;0
2131140;Jungle Survivor;;0 - 20,000;1;0;1;0;0;0
2131200;NeverSynth;;0 - 20,000;65;16;49;0;0;0
2131260;Magnetism;;0 - 20,000;1;1;0;0;0;0
2131350;My Coworker is an Idiot;;0 - 20,000;43;4;39;0;0;4
2131380;Until Lights Out;;20,000 - 50,000;3;10;-7;0;0;0
2131670;Ant in Training;;0 - 20,000;4;0;4;0;0;0
2131780;Pure-hearted Gyaru and the Shape of Happiness;;0 - 20,000;0;1;-1;0;0;0
2131820;红月;;0 - 20,000;56;5;51;0;0;1
2131840;Thelos;;0 - 20,000;3;0;3;0;0;0
2131920;Super Hamster Ball;;0 - 20,000;4;0;4;0;0;0
2131930;Shooting Waltz;;0 - 20,000;5;0;5;0;0;0
2131960;RunBean Galactic;;0 - 20,000;20;0;20;0;0;0
2131980;Lamp Simulator;;0 - 20,000;2;0;2;0;0;0
2132040;Catherine Ragnor - Blackbeards Fury;;0 - 20,000;4;0;4;0;0;0
2132060;RC Dash;;0 - 20,000;1;0;1;0;0;0
2132070;The Billion Clicker;;0 - 20,000;21;9;12;0;0;2
2132090;Save The Princess;;0 - 20,000;1;1;0;0;0;0
2132190;CapoeiRogue: Dandara Cordão de Ouro;;0 - 20,000;7;0;7;0;0;0
2132230;Reach the Hilltop;;0 - 20,000;0;5;-5;0;0;0
2132450;Spectator;;0 - 20,000;45;4;41;0;0;6
2132460;Mr. Healer;;0 - 20,000;2;0;2;0;0;2
2132510;32 in 1 Game Special;;20,000 - 50,000;4;0;4;0;0;0
2132510;32 in 1 Game Special;;20,000 - 50,000;4;0;4;0;0;0
2132530;Last Order;;0 - 20,000;1;1;0;0;0;1
2132710;SokoMelody;;0 - 20,000;13;0;13;0;0;0
2132870;Equilibrium;;0 - 20,000;1;1;0;0;0;0
2133040;荆轲新传（重制版）;;0 - 20,000;5;0;5;0;0;0
2133250;Poly Memory: Predators;;0 - 20,000;0;0;0;0;0;0
2133300;The Entity Code;;0 - 20,000;8;0;8;0;0;0
2133350;みらくるすいーぱー;;0 - 20,000;4;0;4;0;0;0
2133360;Fury of West;;0 - 20,000;16;1;15;0;0;0
2133370;Stunts Contest Beach Edition;;0 - 20,000;3;1;2;0;0;0
2133380;Unrushed Defence;;0 - 20,000;1;6;-5;0;0;0
2133390;Chick Rage;;0 - 20,000;0;5;-5;0;0;0
2133440;Pixelmancer;;0 - 20,000;14;0;14;0;0;0
2133490;Live Cycling Manager 2022;;0 - 20,000;1;1;0;0;0;0
2133530;Graveyard Architect;;20,000 - 50,000;17;0;17;0;0;0
2133540;BLÖCK;;0 - 20,000;2;0;2;0;0;0
2133580;Mimetic Love;;0 - 20,000;1;0;1;0;0;0
2133590;fig.;;0 - 20,000;1;2;-1;0;0;0
2133730;FantasyKingdom：Fantasy Tiny Forest;;0 - 20,000;1;1;0;0;0;0
2133770;Tyler Tactics;;0 - 20,000;2;0;2;0;0;0
2133940;Precision Break;;0 - 20,000;1;0;1;0;0;0
2133950;Living Legends: The Blue Chamber Collector's Edition;;0 - 20,000;4;0;4;0;0;1
2134060;Quarterstaff;;0 - 20,000;6;0;6;0;0;0
2134120;Super Anime Waifu BBQ Simulator;;0 - 20,000;5;0;5;0;0;0
2134280;Eclipse of the Moon;;0 - 20,000;3;0;3;0;0;0
2134300;ParkTo;;0 - 20,000;10;0;10;0;0;1
2134360;89;;0 - 20,000;3;1;2;0;0;0
2134420;EXTREME BIKE X;;0 - 20,000;2;0;2;0;0;0
2134430;Desktop Basketball;;0 - 20,000;2;0;2;0;0;1
2134440;Our Winter Sports;;0 - 20,000;2;0;2;0;0;0
2134550;Mirror Broken;;0 - 20,000;3;1;2;0;0;0
2134580;实习班主任 Practice Teacher;;0 - 20,000;10;2;8;0;0;0
2134600;PIP 3;;0 - 20,000;1;3;-2;0;0;0
2134630;Hot Cleopatra;;0 - 20,000;23;9;14;0;0;0
2134640;Viking Heroes 3;;0 - 20,000;11;1;10;0;0;4
2134650;New Yankee: Karma Tales;;0 - 20,000;7;0;7;0;0;14
2134760;Math Adventures;;0 - 20,000;0;1;-1;0;0;0
2134900;Scribbleman Army;;0 - 20,000;22;11;11;0;0;4
2134970;The Hotel;;0 - 20,000;41;4;37;0;0;1
2135030;HellEscape;;0 - 20,000;15;1;14;0;0;1
2135460;The Slaughterday;;0 - 20,000;1;0;1;0;0;0
2135500;Sora no Ao to Shiro to;;0 - 20,000;144;10;134;0;0;2
2135510;カルマの回収屋(Karma Collector);;0 - 20,000;1;2;-1;0;0;0
2135580;Again and Again;;0 - 20,000;52;10;42;0;0;1
2135580;Again and Again;;0 - 20,000;52;10;42;0;0;1
2135740;Moto Trophy VR;;0 - 20,000;2;1;1;0;0;0
2135780;Shin Galaxy - Alpha War;;0 - 20,000;1;0;1;0;0;0
2135810;Mark of the Void;;0 - 20,000;1;0;1;0;0;0
2135890;Planet Barren Objective;;0 - 20,000;4;0;4;0;0;0
2135920;Tivick'ing! Chronicles;;0 - 20,000;2;1;1;0;0;0
2135940;Light Eater;;0 - 20,000;1;0;1;0;0;0
2135970;Magnus Positive Phototaxis;;50,000 - 100,000;10;0;10;0;0;0
2135980;The Icon Battles;;0 - 20,000;23;3;20;0;0;16
2135990;Ringlorn Saga;;0 - 20,000;41;0;41;0;0;2
2136200;无尽星海(Endless Stars);;0 - 20,000;3;0;3;0;0;0
2136220;Andromeda Survivors;;0 - 20,000;37;5;32;0;0;0
2136380;HVS: Hitler VS Stalin - Battle Of Moscow;;0 - 20,000;44;5;39;0;0;0
2136470;Eraser;;0 - 20,000;7;1;6;0;0;0
2136620;Bandit Realms;;0 - 20,000;1;0;1;0;0;0
2136690;Honey Magician;;0 - 20,000;2;3;-1;0;0;0
2136700;ソラナと陽の工房;;0 - 20,000;2;3;-1;0;0;0
2136860;ALIEN WAR;;0 - 20,000;4;0;4;0;0;0
2136880;Midnight Rhapsody;;0 - 20,000;2;1;1;0;0;0
2136920;Content creator tool (CCT);;0 - 20,000;1;0;1;0;0;0
2136970;Are You Afraid of the Dark;;0 - 20,000;4;1;3;0;0;0
2137000;Hidden Object Vacation;;0 - 20,000;4;0;4;0;0;3
2137150;Super Pentagon;;0 - 20,000;6;2;4;0;0;0
2137200;Novi Cube;;0 - 20,000;30;4;26;0;0;0
2137280;Graviton - A Relaxing Sand Simulation;;0 - 20,000;2;0;2;0;0;0
2137350;Input Chaos;;0 - 20,000;4;0;4;0;0;2
2137570;Cairn Stone Balancing;;0 - 20,000;2;3;-1;0;0;0
2137600;Huge Jaws;;0 - 20,000;10;4;6;0;0;0
2137620;Korean BBQ Simulator;;0 - 20,000;8;1;7;0;0;0
2137660;SANRI;;0 - 20,000;13;6;7;0;0;4
2137680;RKR - Rush Kill Repeat;;0 - 20,000;1;0;1;0;0;0
2137920;Umbra;;0 - 20,000;14;2;12;0;0;0
2138000;Hoshizora no Memoria -Eternal Heart- HD;;0 - 20,000;17;1;16;0;0;4
2138010;A Clockwork Ley-Line: Flowers Falling in the Morning Mist;;0 - 20,000;13;0;13;0;0;1
2138120;NONOGRAM - GIRL's SWEETS;;0 - 20,000;0;1;-1;0;0;0
2138140;Didactic Jesus Game;;0 - 20,000;2;0;2;0;0;0
2138190;StarTron;;0 - 20,000;1;0;1;0;0;0
2138230;Devolution 魔剣の王としもべたち;;0 - 20,000;8;1;7;0;0;0
2138380;Goliath: Playing With Reality;;0 - 20,000;2;1;1;0;0;0
2138400;Slime Hero;;0 - 20,000;9;2;7;0;0;0
2138480;Capsule Rush;;0 - 20,000;4;1;3;0;0;0
2138520;I'm a sardine Keita;;0 - 20,000;1;1;0;0;0;0
2138580;Exotica: Petshop Simulator;;0 - 20,000;33;11;22;0;0;8
2138600;Tapering Tower;;0 - 20,000;1;1;0;0;0;0
2138780;CashGrab;;50,000 - 100,000;82;8;74;0;0;0
2138790;Mr. White;;0 - 20,000;10;0;10;0;0;0
2138850;Prince Akazaka x Princess;;0 - 20,000;1;0;1;0;0;0
2138910;Athereon: Advent I;;20,000 - 50,000;1;0;1;0;0;0
2138920;Budgie Genetics Simulator;;0 - 20,000;10;0;10;0;0;1
2138930;Dodge The Missionaries;;0 - 20,000;4;0;4;0;0;0
2139030;Boomshine Plus;;0 - 20,000;2;0;2;0;0;0
2139100;Morbid;;20,000 - 50,000;1;9;-8;0;0;0
2139290;One Tank Army;;0 - 20,000;2;2;0;0;0;0
2139310;Endless;;100,000 - 200,000;8;2;6;0;0;2
2139350;Dead Second;;0 - 20,000;20;2;18;0;0;0
2139440;The Wall Mustn't Fall;;0 - 20,000;26;1;25;0;0;20
2139480;Girls slap;;0 - 20,000;1;2;-1;0;0;0
2139500;Waste Life 消耗阳寿;;0 - 20,000;6;1;5;0;0;0
2139510;Amber Trail;;0 - 20,000;2;0;2;0;0;1
2139540;Archery Simulator;;0 - 20,000;21;0;21;0;0;0
2139550;City Construction Simulator;;0 - 20,000;6;1;5;0;0;0
2139560;Crocodile Transformator;;0 - 20,000;7;4;3;0;0;1
2139620;FFF;;0 - 20,000;7;0;7;0;0;3
2139680;Masterchef Cakes Edition;;0 - 20,000;8;0;8;0;0;0
2139690;Everest Truck Simulator;;0 - 20,000;6;2;4;0;0;0
2139710;Stunts Contest Extreme Cars;;0 - 20,000;10;0;10;0;0;0
2139730;Maskonauts: Chat'Attack;;100,000 - 200,000;4;0;4;0;0;0
2139790;Halloween Trouble 4;;0 - 20,000;1;0;1;0;0;0
2139800;Orcen Axe;;0 - 20,000;10;0;10;0;0;0
2139890;Dream Fight Will;;0 - 20,000;4;0;4;0;0;2
2140110;Chiky Poky;;0 - 20,000;0;1;-1;0;0;0
2140180;Fright Knight Legend;;20,000 - 50,000;3;0;3;0;0;0
2140410;Target React Force;;100,000 - 200,000;11;3;8;0;0;0
2140590;Cat and Watermouse;;0 - 20,000;2;1;1;0;0;0
2140680;Code R.U.B.I.K.;;0 - 20,000;3;0;3;0;0;0
2140700;SO BELOW;;0 - 20,000;20;6;14;0;0;2
2140760;Magic Kingdom War;;0 - 20,000;3;2;1;0;0;1
2140770;千灵大陆-Qianling Mainland;;0 - 20,000;1;0;1;0;0;0
2140870;Stunt Legends;;0 - 20,000;1;0;1;0;0;0
2140960;AQRA Tenses [Learn English];;0 - 20,000;0;1;-1;0;0;1
2141470;Bad Writer;;0 - 20,000;2;0;2;0;0;0
2141640;Jump Ball;;0 - 20,000;1;1;0;0;0;0
2141650;Endless Engines;;0 - 20,000;2;0;2;0;0;0
2141690;Car Dealership Simulator;;20,000 - 50,000;793;212;581;127;127;34
2141720;Tower Numbers;;0 - 20,000;15;1;14;0;0;0
2141730;Backrooms: Escape Together;;0 - 20,000;862;207;655;57;57;24
2141820;Onion Assault;;0 - 20,000;18;1;17;0;0;0
2141990;魔塔三国之逆乱时空;;0 - 20,000;17;1;16;0;0;5
2142030;Fishton: A Town to Remember;;0 - 20,000;15;2;13;0;0;5
2142040;In the Dark;;0 - 20,000;0;3;-3;0;0;0
2142100;A Smooth Game (Unlike... Life);;0 - 20,000;8;0;8;0;0;0
2142110;VR Rock Climbing;;0 - 20,000;0;1;-1;0;0;0
2142150;Crazy Click Thursday;;0 - 20,000;0;2;-2;0;0;0
2142210;Project Alex;;0 - 20,000;5;6;-1;0;0;0
2142220;VR Dragon Flight;;0 - 20,000;0;2;-2;0;0;0
2142370;King Of Water;;0 - 20,000;25;1;24;0;0;1
2142430;Score Gun;;0 - 20,000;5;0;5;0;0;0
2142440;Charlie's Delivery;;0 - 20,000;1;0;1;0;0;0
2142610;Night Light;;0 - 20,000;6;1;5;0;0;0
2142810;Nameless - The Departed Cycle;;0 - 20,000;2;0;2;0;0;0
2142820;Grave-Queen;;0 - 20,000;0;1;-1;0;0;0
2142860;Neuro Horror;;0 - 20,000;17;5;12;0;0;0
2142870;Water City;;0 - 20,000;1;0;1;0;0;0
2142930;꿈을 빼앗긴 남자 - Dream invader;;0 - 20,000;1;0;1;0;0;0
2143010;Convenient;;0 - 20,000;47;2;45;0;0;0
2143150;Weird Japan;;20,000 - 50,000;14;2;12;0;0;0
2143160;Air defenders;;0 - 20,000;11;1;10;0;0;0
2143190;The Cat Maze;;0 - 20,000;1;0;1;0;0;0
2143290;Hidden Shapes - Cat Realm;;0 - 20,000;16;0;16;0;0;0
2143390;The Adventures of Snacky;;0 - 20,000;1;0;1;0;0;0
2143450;Strong Moon;;0 - 20,000;1;1;0;0;0;0
2143590;Run and Gun;;0 - 20,000;1;1;0;0;0;0
2143590;Run and Gun;;0 - 20,000;1;1;0;0;0;0
2143700;Blackjack at Carrot;;0 - 20,000;1;0;1;0;0;0
2143710;Huntscape;;0 - 20,000;1;0;1;0;0;0
2143740;FukTopia 4;;0 - 20,000;2;0;2;0;0;0
2143770;Drift racing car;;0 - 20,000;123;3;120;1322;1322;149
2143950;Don't Shit On My #!$@& Roof;;0 - 20,000;82;5;77;0;0;3
2144110;Pot Breaker;;0 - 20,000;2;1;1;0;0;0
2144120;Lord of Midchester;;100,000 - 200,000;6;0;6;0;0;0
2144180;勇者联盟星耀传说;;0 - 20,000;24;2;22;0;0;1
2144270;自在逍遥：风起 Tales of TianYuan Dynasty;;0 - 20,000;30;14;16;0;0;3
2144320;Seven Days;;0 - 20,000;0;1;-1;0;0;0
2144360;Pretty Girls Tile Match;;0 - 20,000;16;1;15;0;0;0
2144460;Path to purge;;0 - 20,000;44;3;41;0;0;0
2144470;Arata Haunted Asylum;;0 - 20,000;1;0;1;0;0;0
2144530;No Random Novels;;0 - 20,000;10;3;7;0;0;4
2144630;Link Bomb☆Party/链接炸弹☆派对;;0 - 20,000;3;1;2;0;0;0
2144670;Llama the Farm Drama;;0 - 20,000;3;0;3;0;0;0
2145000;Twilight Of The Gods;;0 - 20,000;2;0;2;0;0;0
2145080;Ballspell;;0 - 20,000;7;0;7;0;0;0
2145300;The Game Store;;0 - 20,000;5;2;3;0;0;0
2145480;Inversion Institute;;0 - 20,000;2;0;2;0;0;0
2145480;Inversion Institute;;0 - 20,000;2;0;2;0;0;0
2145490;Sneaky Rat;;0 - 20,000;31;0;31;0;0;0
2145550;CyberHeroes Arena;;0 - 20,000;19;2;17;0;0;1
2145560;Imaginefield 2042;;50,000 - 100,000;3;8;-5;0;0;0
2145740;Dancing Pandas;;0 - 20,000;3;0;3;0;0;0
2145740;Dancing Pandas;;0 - 20,000;3;0;3;0;0;0
2145750;Cute Fight;;0 - 20,000;2;0;2;0;0;0
2145810;Bumblebee - Little Bee Adventure;;0 - 20,000;51;1;50;0;0;0
2145830;Don't Get Eaten!;;0 - 20,000;3;0;3;0;0;0
2145960;Pixel chan;;0 - 20,000;8;2;6;0;0;0
2146270;Way Of Vulcan;;0 - 20,000;2;0;2;0;0;0
2146320;Dry School;;0 - 20,000;9;0;9;0;0;0
2146440;Salvation of the soul;;0 - 20,000;2;2;0;0;0;1
2146450;Car Racing Highway Driving Simulator, real parking driver sim speed traffic deluxe 2023;;0 - 20,000;26;4;22;0;0;3
2146520;Love Spell: Aslan's Story;;20,000 - 50,000;8;0;8;0;0;1
2146550;Great Pilots;;0 - 20,000;1;0;1;0;0;0
2146600;I commissioned some bees 7;;0 - 20,000;6;0;6;0;0;1
2146720;EON Fighter;;0 - 20,000;27;0;27;0;0;0
2146730;Parlor;;0 - 20,000;3;0;3;0;0;0
2146960;VOID;;0 - 20,000;15;8;7;0;0;0
2147020;Cards with Personalities;;0 - 20,000;11;0;11;0;0;1
2147050;Jumping Cat;;0 - 20,000;24;4;20;0;0;2
2147130;Crazy Edition of Stunts;;0 - 20,000;5;3;2;0;0;0
2147260;Extermination Cars Stadium;;0 - 20,000;0;1;-1;0;0;0
2147310;PermaNight;;0 - 20,000;1;2;-1;0;0;0
2147350;Military Division;;0 - 20,000;0;5;-5;0;0;0
2147370;Europe Bus Driver;;0 - 20,000;6;3;3;0;0;0
2147410;Worldest D izzy Game;;0 - 20,000;1;0;1;0;0;0
2147550;Tech Invaders TD;;0 - 20,000;1;2;-1;0;0;0
2147580;1990;;0 - 20,000;6;0;6;0;0;0
2147600;Chamber's Reunion;;0 - 20,000;1;1;0;0;0;0
2147640;Chacara;;0 - 20,000;18;1;17;0;0;4
2147670;Meme Quiz;;0 - 20,000;7;0;7;0;0;0
2147710;Forest Spring;;0 - 20,000;5;13;-8;0;0;0
2147860;Midnight Calling: Wise Dragon Collector's Edition;;0 - 20,000;1;1;0;0;0;0
2147890;Demolish or Die;;0 - 20,000;14;1;13;0;0;0
2147900;Evil Nightmares;;0 - 20,000;1;1;0;0;0;0
2148060;Hack & Schlitz;;0 - 20,000;12;0;12;0;0;0
2148080;Saga Cube;;0 - 20,000;7;0;7;0;0;0
2148220;Soul After;;0 - 20,000;2;2;0;0;0;0
2148240;Insomnia;;0 - 20,000;5;1;4;0;0;0
2148280;末日竟在我身边3 - Zombies Everywhere 3;;0 - 20,000;5;0;5;0;0;1
2148370;Sky Puzzle;;0 - 20,000;1;1;0;0;0;0
2148540;Fly Missions;;0 - 20,000;1;2;-1;0;0;0
2148690;Let's Go Camping;;0 - 20,000;13;2;11;0;0;0
2148700;Moto Pizza Courier;;0 - 20,000;3;3;0;0;0;0
2148720;Cruise Control Mode On!;;0 - 20,000;0;3;-3;0;0;0
2148730;Masterchef Ice Cream Edition;;0 - 20,000;4;0;4;0;0;0
2148740;Fix My Hand Doc;;0 - 20,000;9;0;9;0;0;0
2148750;Jeeps Offroad Simulator;;0 - 20,000;0;2;-2;0;0;0
2148760;Extreme Truck Stunts;;0 - 20,000;24;4;20;0;0;0
2148990;Waste It;;0 - 20,000;3;0;3;0;0;0
2149000;Zombies;;0 - 20,000;3;0;3;0;0;0
2149190;Detriot;;0 - 20,000;1;0;1;0;0;0
2149270;PHYAKH;;0 - 20,000;8;0;8;0;0;0
2149310;Strong Protection;;0 - 20,000;0;5;-5;0;0;0
2149330;Predictors;;0 - 20,000;26;3;23;0;0;0
2149430;Click To Sail;;0 - 20,000;39;6;33;0;0;2
2149480;Card Cowboy;;0 - 20,000;16;0;16;0;0;0
2149480;Card Cowboy;;0 - 20,000;16;0;16;0;0;0
2149660;Personal Chef to the Stars;;0 - 20,000;4;0;4;0;0;0
2149850;Touch Love;;0 - 20,000;1;2;-1;0;0;0
2149870;Closer To Home;;50,000 - 100,000;24;1;23;0;0;1
2149880;Hallway Defender;;0 - 20,000;5;0;5;0;0;0
2149900;The Moon Hell;;0 - 20,000;32;4;28;0;0;11
2149980;The First Mountain;;0 - 20,000;13;1;12;0;0;1
2150090;Fury Turn;;0 - 20,000;10;0;10;0;0;1
2150100;Village Defender;;0 - 20,000;1;0;1;0;0;0
2150170;Decent Checkers;;0 - 20,000;8;0;8;0;0;1
2150180;Deep Dungeon;;0 - 20,000;12;2;10;0;0;1
2150460;Fisher's Qualm;;0 - 20,000;2;0;2;0;0;0
2150530;Rubble;;0 - 20,000;3;0;3;0;0;0
2150560;Street Paint Playground;;0 - 20,000;1;2;-1;0;0;0
2150700;Magic Axolotl;;0 - 20,000;59;1;58;0;0;0
2150740;Survive The Forest;;0 - 20,000;0;2;-2;0;0;0
2150760;Seaberry Keep;;0 - 20,000;20;0;20;0;0;0
2150820;Living With Dragons;;0 - 20,000;0;2;-2;0;0;0
2150830;Underworld Island;;50,000 - 100,000;278;61;217;0;0;1
2150870;你农哦农-Need Know What Know;;0 - 20,000;59;3;56;0;0;10
2150950;Paranormal Observation;;0 - 20,000;21;3;18;0;0;2
2151020;街机捕鱼;;0 - 20,000;1;1;0;0;0;1
2151030;Magic Staves;;0 - 20,000;0;7;-7;0;0;0
2151130;Valora Survival;;0 - 20,000;4;1;3;0;0;0
2151150;Run Foxy, Run!;;0 - 20,000;2;0;2;0;0;0
2151290;Football Coach: College Dynasty;;0 - 20,000;209;8;201;0;0;126
2151360;Street volleyball - Invitation;;0 - 20,000;2;0;2;0;0;0
2151410;STRAY CAT;;0 - 20,000;3;1;2;0;0;0
2151430;NSG;;0 - 20,000;8;0;8;0;0;1
2151530;YOU ARE THE DINNER;;0 - 20,000;0;1;-1;0;0;0
2151540;The Last Escape;;0 - 20,000;0;5;-5;0;0;0
2151580;Infinite Tao;;50,000 - 100,000;519;121;398;1799;1847;416
2151630;PIP 4;;0 - 20,000;0;1;-1;0;0;1
2151650;Look Find Find;;0 - 20,000;0;1;-1;0;0;0
2151700;Yokai's Wish;;0 - 20,000;14;3;11;0;0;1
2151740;Treasure Trap;;0 - 20,000;1;0;1;0;0;0
2151820;Zombie Arena;;0 - 20,000;38;8;30;0;0;0
2152060;Astraea;;0 - 20,000;3;0;3;0;0;0
2152120;Open Course;;0 - 20,000;1;1;0;0;0;0
2152180;Dark Moon Motel;;0 - 20,000;10;0;10;0;0;0
2152190;Zombie Apocalypse Survival Simulator;;0 - 20,000;72;1;71;0;0;0
2152290;The Night Of The Penanggalan;;0 - 20,000;2;1;1;0;0;0
2152410;WitchCraft TD;;0 - 20,000;22;4;18;0;0;1
2152420;Duck Race;;0 - 20,000;4;0;4;0;0;1
2152480;Bowling;;0 - 20,000;0;3;-3;0;0;0
2152690;Actua Soccer 2;;0 - 20,000;12;2;10;0;0;3
2152710;Actua Ice Hockey;;0 - 20,000;1;1;0;0;0;0
2152720;Actua Ice Hockey 2;;0 - 20,000;2;0;2;0;0;0
2152730;Actua Tennis;;0 - 20,000;1;0;1;0;0;0
2153050;Clutter's Greatest Hits - Collector's Edition;;0 - 20,000;7;0;7;0;0;3
2153280;Rhythm Any Music;;0 - 20,000;5;3;2;0;0;0
2153290;Geese And Gats;;0 - 20,000;3;0;3;0;0;0
2153330;Otome * Domain;;0 - 20,000;164;6;158;0;0;7
2153390;西部幻想 WestFantasy;;20,000 - 50,000;6;1;5;0;0;0
2153590;Detective Super Star;;0 - 20,000;2;1;1;0;0;1
2153600;Hero Jumper;;0 - 20,000;0;2;-2;0;0;0
2153610;Virtual Sailor NG;;0 - 20,000;9;1;8;0;0;11
2153770;Coin Flipper;;0 - 20,000;87;7;80;3153;3153;26
2153780;Survival Nation;;0 - 20,000;53;14;39;0;0;10
2153780;Survival Nation;;0 - 20,000;53;14;39;0;0;10
2153800;Christmas Wonderland 5;;0 - 20,000;1;0;1;0;0;0
2153850;DEFECTIVE;;0 - 20,000;17;0;17;0;0;1
2153920;DOWNFALLEN;;20,000 - 50,000;7;0;7;0;0;0
2153950;Broken Blade: Prelude;;100,000 - 200,000;5;1;4;0;0;1
2154000;TOKKI;;0 - 20,000;9;0;9;0;0;0
2154090;Vs Chat Pack;;0 - 20,000;12;0;12;0;0;0
2154190;Stellar Fight;;0 - 20,000;2;2;0;0;0;0
2154230;AI: Art Impostor;;20,000 - 50,000;182;89;93;112;112;16
2154350;Zombie Slapper;;0 - 20,000;3;0;3;0;0;0
2154660;Toast The Ghost;;0 - 20,000;2;0;2;0;0;0
2154700;Sokosignal;;0 - 20,000;1;0;1;0;0;0
2154730;Building Destruction;;0 - 20,000;3;2;1;0;0;0
2154790;SEKISAI puzzle action;;0 - 20,000;6;0;6;0;0;0
2154820;EL PASO, NIGHTMARE;;100,000 - 200,000;51;8;43;0;0;0
2154890;Survival Academy;;0 - 20,000;53;14;39;0;0;2
2154960;俺が私に変わった日…～Becoming a She～;;0 - 20,000;0;2;-2;0;0;0
2154990;Angels Bleeding;;0 - 20,000;5;2;3;0;0;0
2155010;MindHunt;;0 - 20,000;5;1;4;0;0;0
2155080;Finger Soccer;;0 - 20,000;0;1;-1;0;0;0
2155090;Secret Battle;;0 - 20,000;0;3;-3;0;0;0
2155220;Petty's Adventure: Desert;;0 - 20,000;0;0;0;0;0;0
2155280;DEFCON: Xenos;;0 - 20,000;19;2;17;0;0;3
2155460;Orbital Clash;;20,000 - 50,000;1;0;1;0;0;0
2155500;KFZ;;0 - 20,000;0;1;-1;0;0;0
2155650;Slayer Of Sin;;0 - 20,000;2;1;1;0;0;0
2155720;Camouflet;;0 - 20,000;4;0;4;0;0;0
2155740;Elkabir;;0 - 20,000;1;1;0;0;0;0
2155760;8 Ball 2;;0 - 20,000;10;2;8;0;0;1
2156010;Wallpaper Web;;0 - 20,000;2;0;2;0;0;1
2156120;StickmanThug3D火柴人暴徒;;0 - 20,000;34;1;33;0;0;0
2156260;Asian Cargo Sim;;0 - 20,000;15;3;12;0;0;1
2156270;Taxi Taxi Sim;;0 - 20,000;8;1;7;0;0;0
2156280;Police Transporter Simulator;;0 - 20,000;1;0;1;0;0;0
2156590;Ruins;;0 - 20,000;3;1;2;0;0;0
2156620;The Future Radio and the Artificial Pigeons;;0 - 20,000;28;1;27;0;0;91
2156630;Zad Maldan My Bloody Sacrifice;;0 - 20,000;1;1;0;0;0;0
2157050;Sacred Ember;;0 - 20,000;0;2;-2;0;0;0
2157060;Project Malice;;0 - 20,000;15;0;15;0;0;5
2157070;Funeral;;0 - 20,000;23;3;20;0;0;1
2157100;The Villager and the Werewolf - A jigsaw puzzle tale;;0 - 20,000;15;0;15;0;0;0
2157130;This is Hell;;0 - 20,000;26;1;25;0;0;0
2157260;Tahoe Dragon: The Beginning;;0 - 20,000;1;1;0;0;0;0
2157290;Azarine Heart;;0 - 20,000;2;0;2;0;0;0
2157340;Meowjiro;;0 - 20,000;328;36;292;0;0;22
2157440;Run Run Boy;;0 - 20,000;2;0;2;0;0;0
2157450;Stunts Contest Monster Car;;0 - 20,000;2;2;0;0;0;0
2157540;Lost Amulets: Mystic Land;;0 - 20,000;8;0;8;0;0;2
2157670;Big Adventure: Trip to Europe 2 - Collector's Edition;;0 - 20,000;2;0;2;0;0;0
2157860;IceLine;;0 - 20,000;1;0;1;0;0;0
2158050;Space Cheetah Hyper Runner;;0 - 20,000;7;0;7;0;0;0
2158130;Deadly Harvest;;0 - 20,000;25;0;25;0;0;1
2158190;Robot Programmer;;0 - 20,000;7;0;7;0;0;0
2158240;The Trench;;20,000 - 50,000;54;5;49;0;0;0
2158290;Necroffense;;0 - 20,000;3;0;3;0;0;0
2158430;Hell Grocery;;0 - 20,000;18;9;9;0;0;3
2158510;Freedom Drive;;0 - 20,000;22;0;22;0;0;0
2158540;Mount Farewell;;0 - 20,000;3;0;3;0;0;0
2158670;RPG Architect;;0 - 20,000;23;0;23;0;0;8
2158700;Candlehead;;0 - 20,000;7;0;7;0;0;0
2158710;Up & Away;;0 - 20,000;10;1;9;0;0;0
2158740;Within the Backrooms;;0 - 20,000;28;1;27;0;0;4
2158800;BATTLE GEAR;;0 - 20,000;1;1;0;0;0;0
2158820;DIVINITY;;0 - 20,000;0;1;-1;0;0;0
2158850;Spooky Halloween in the Voxel World;;0 - 20,000;12;0;12;0;0;0
2158880;Tkium Underground;;0 - 20,000;4;2;2;0;0;0
2158900;Automaton Lung;;0 - 20,000;35;1;34;0;0;0
2159020;Under The Shack;;0 - 20,000;1;0;1;0;0;0
2159040;Save Santa;;0 - 20,000;2;2;0;0;0;0
2159050;Blessed Work;;0 - 20,000;7;0;7;0;0;0
2159060;Big Adventure: Trip to Europe 3 - Collector's Edition;;0 - 20,000;4;0;4;0;0;0
2159180;Hidden Shapes - Trick or Cats;;0 - 20,000;23;0;23;0;0;0
2159200;Asia Empire 2027;;20,000 - 50,000;0;1;-1;0;0;0
2159230;Ace Pilot Europe;;0 - 20,000;10;1;9;0;0;0
2159240;Tribu;;0 - 20,000;4;2;2;0;0;0
2159280;Flappy Bat 2;;0 - 20,000;3;0;3;0;0;0
2159350;Super Jumpy Ball;;0 - 20,000;5;0;5;0;0;0
2159370;Click For Points;;0 - 20,000;6;3;3;0;0;2
2159390;Sumiii;;0 - 20,000;3;1;2;0;0;0
2159520;Desktop Farm Remastered;;0 - 20,000;7;2;5;0;0;0
2159870;City Metro Simulator;;0 - 20,000;1;4;-3;0;0;0
2159880;Highway Cross;;0 - 20,000;13;1;12;0;0;0
2159890;Two Cars Stunts Edition;;0 - 20,000;11;0;11;0;0;0
2159920;Lion King Simulator;;0 - 20,000;7;1;6;0;0;0
2160230;Morrow;;0 - 20,000;12;0;12;0;0;0
2160340;Island Defender Jets;;0 - 20,000;0;1;-1;0;0;0
2160430;X-Racing;;0 - 20,000;1;2;-1;0;0;0
2160460;Da Tutu;;0 - 20,000;3;1;2;0;0;0
2160500;Many Minigames;;0 - 20,000;7;0;7;0;0;0
2160560;VariDungeon;;0 - 20,000;3;0;3;0;0;0
2160680;Last Kids on Earth: Hit the Deck!;;0 - 20,000;3;1;2;0;0;1
2160710;Lost Memories;;0 - 20,000;2;1;1;0;0;0
2161090;SPY SWATTER 2;;0 - 20,000;1;1;0;0;0;0
2161110;The end is nahual: If I may say so;;0 - 20,000;2;3;-1;0;0;2
2161120;Slime Ranger;;50,000 - 100,000;20;2;18;0;0;0
2161330;I Love Finding Birds;;0 - 20,000;4;0;4;0;0;1
2161410;Gust;;20,000 - 50,000;4;0;4;0;0;0
2161440;Sailing Era;;50,000 - 100,000;2072;561;1511;916;1449;1534
2161450;Sorry We're Open;;50,000 - 100,000;8;0;8;0;0;10
2161450;Sorry We're Open;;50,000 - 100,000;8;0;8;0;0;10
2161580;Fast Food Chef;;0 - 20,000;1;0;1;0;0;0
2161590;Bike Arena;;0 - 20,000;0;1;-1;0;0;0
2161600;Ghost Bus Simulator;;0 - 20,000;1;3;-2;0;0;0
2161630;Not born to be King;;0 - 20,000;1;1;0;0;0;0
2161660;Little Witchelsa: Pumpkin Peril;;0 - 20,000;2;1;1;0;0;0
2161730;Mike's Arcade;;0 - 20,000;2;0;2;0;0;0
2161840;Aircraft Pushback Simulator;;0 - 20,000;0;3;-3;0;0;0
2161900;Spin Quest: A Slot Adventure;;0 - 20,000;6;0;6;0;0;2
2162070;Ooglians;;0 - 20,000;107;65;42;0;0;0
2162150;VR Run;;0 - 20,000;3;0;3;0;0;0
2162160;The Passenger;;0 - 20,000;69;6;63;0;0;4
2162210;Road Trip USA 2: West Collector's Edition;;0 - 20,000;3;0;3;0;0;0
2162220;CRAP;;0 - 20,000;2;0;2;0;0;0
2162350;Routemania;;0 - 20,000;16;0;16;0;0;0
2162780;E.E.R.I.E2;;20,000 - 50,000;200;25;175;0;0;2
2162880;X-RACER;;0 - 20,000;0;1;-1;0;0;0
2162890;Keep of the Witch;;0 - 20,000;1;0;1;0;0;0
2162950;A Maiden Astrologer Divines the Future;;0 - 20,000;14;2;12;0;0;0
2162970;Bargain Platformer;;0 - 20,000;2;2;0;0;0;0
2163050;夢隠し - Dreamed Away;;0 - 20,000;3;1;2;0;0;0
2163230;Witch Guild Survivor;;0 - 20,000;1;0;1;0;0;0
2163460;FEATHERED RUN;;0 - 20,000;13;4;9;0;0;0
2163560;Samurai's Zenith: Shifting of the Guard;;0 - 20,000;3;0;3;0;0;0
2163600;Tomb of the Dead;;20,000 - 50,000;2;1;1;0;0;0
2163620;Azazel's Christmas Fable;;0 - 20,000;42;0;42;0;0;0
2163630;SWAP;;0 - 20,000;2;0;2;0;0;0
2163680;It's Locked;;0 - 20,000;3;0;3;0;0;0
2163760;Bitter Belief;;0 - 20,000;4;4;0;0;0;0
2163790;Lighten Up;;0 - 20,000;9;0;9;0;0;0
2163800;Draft Day Sports: Pro Football 2023;;0 - 20,000;5;3;2;0;0;9
2163860;Eureka;;0 - 20,000;0;2;-2;0;0;0
2163890;Magic Bubbles;;20,000 - 50,000;1;0;1;0;0;1
2164040;²Pattern;;0 - 20,000;1;0;1;0;0;0
2164200;Acretia - Guardians of Lian;;20,000 - 50,000;60;11;49;0;0;1
2164220;Who is There?;;0 - 20,000;3;4;-1;0;0;0
2164580;Puzzle Pieces 5: Fairy Ring;;0 - 20,000;2;0;2;0;0;0
2164780;Tile Town;;0 - 20,000;29;1;28;0;0;0
2164790;Putin Destroys Alien;;20,000 - 50,000;3;0;3;0;0;0
2164880;Tilecraft;;0 - 20,000;33;16;17;0;0;0
2164970;Keep Me Posted;;0 - 20,000;4;2;2;0;0;0
2165030;DEATHWATCH;;0 - 20,000;80;4;76;0;0;2
2165120;Pogo Rage: The Awakening;;0 - 20,000;4;0;4;0;0;0
2165300;Africa Empire 2027;;0 - 20,000;0;1;-1;0;0;0
2165350;Lazerhawk;;0 - 20,000;0;1;-1;0;0;0
2165380;Hunting Labyrinth;;0 - 20,000;16;2;14;0;0;2
2165520;FukTopia 5;;0 - 20,000;1;0;1;0;0;0
2165560;Motherboard Under Attack;;0 - 20,000;4;0;4;0;0;0
2165600;Boo!;;0 - 20,000;8;0;8;0;0;0
2165650;Hoiwa Hub;;0 - 20,000;8;1;7;0;0;0
2165690;PRO ERA;;0 - 20,000;68;28;40;0;0;6
2165720;Monsters of Seabrook;;0 - 20,000;1;1;0;0;0;3
2165740;SokoFrog;;0 - 20,000;25;1;24;0;0;0
2166120;Digit Factory;;0 - 20,000;12;4;8;0;0;2
2166140;Milky Quest II;;0 - 20,000;136;40;96;0;0;19
2166190;Juan Sin Miedo;;0 - 20,000;6;1;5;0;0;0
2166220;Students of Light Bonds - Typing RPG with Character Creation -;;0 - 20,000;2;0;2;0;0;0
2166250;Hungry Caveman;;0 - 20,000;10;3;7;0;0;0
2166260;Beat The Devil;;0 - 20,000;3;4;-1;0;0;0
2166290;The Dead City;;20,000 - 50,000;21;8;13;0;0;0
2166290;The Dead City;;20,000 - 50,000;21;8;13;0;0;0
2166310;Bones of Halloween;;20,000 - 50,000;2;0;2;0;0;0
2166420;Orbtangle;;0 - 20,000;5;0;5;0;0;0
2166480;Supermarket Duck Dash;;0 - 20,000;0;1;-1;0;0;0
2166500;That Makes Sense;;0 - 20,000;1;0;1;0;0;0
2166520;THE TRADER -Goods Dealer Simulator-;;0 - 20,000;1;3;-2;0;0;0
2166540;Candice DeBébé's Tantalising Tricks;;0 - 20,000;4;0;4;0;0;0
2166600;Dear Nostalgia;;0 - 20,000;1;4;-3;0;0;0
2166710;Fabric Of Reality;;0 - 20,000;25;0;25;0;0;3
2166820;史莱姆冒险战SlimeWarfare;;0 - 20,000;5;1;4;0;0;4
2166850;Chased;;0 - 20,000;4;2;2;0;0;0
2166990;Crazy Drift;;0 - 20,000;3;0;3;0;0;1
2167040;Pocket Witch;;0 - 20,000;24;0;24;0;0;0
2167220;The Bible;;0 - 20,000;327;35;292;0;0;17
2167560;一本橋ワタル;;0 - 20,000;1;1;0;0;0;0
2167590;Slicing Slicing;;0 - 20,000;0;1;-1;0;0;0
2167660;Brisk Square;;0 - 20,000;4;0;4;0;0;0
2167750;The Monster Within Me;;0 - 20,000;20;5;15;0;0;0
2167790;风暴行动;;0 - 20,000;2;10;-8;0;0;0
2167800;Idle Cyber Dungeon;;0 - 20,000;5;16;-11;0;0;5
2167830;Epic Ninja;;0 - 20,000;4;1;3;0;0;0
2167840;Inner Call;;0 - 20,000;10;1;9;0;0;0
2167850;Puzzle: Triangles;;0 - 20,000;10;0;10;0;0;0
2167860;Dungeon & Adventure;;0 - 20,000;13;3;10;0;0;0
2167880;Oylinder;;0 - 20,000;2;0;2;0;0;0
2167890;Lost Hammer;;0 - 20,000;9;5;4;0;0;0
2167900;Puny BOB;;0 - 20,000;10;1;9;0;0;2
2167910;Reeve;;0 - 20,000;1;0;1;0;0;0
2168000;Trader of the Night;;50,000 - 100,000;9;1;8;0;0;2
2168090;Stealth;;0 - 20,000;7;1;6;0;0;0
2168450;DREAMWILD;;0 - 20,000;74;9;65;0;0;0
2168490;Masarada Town Story;;0 - 20,000;15;0;15;0;0;0
2168590;Zombie Defence TD;;0 - 20,000;509;204;305;0;0;66
2168650;The Asafo Journey;;0 - 20,000;19;0;19;0;0;0
2168820;Classical Music Minesweeper;;0 - 20,000;2;0;2;0;0;1
2168830;The Story of Barker;;0 - 20,000;8;2;6;0;0;0
2168880;Rogue Blaster;;0 - 20,000;8;1;7;0;0;1
2169040;Portal war;;0 - 20,000;4;1;3;0;0;0
2169050;Never Rain;;0 - 20,000;4;1;3;0;0;0
2169100;五代十国之玉知;;0 - 20,000;4;0;4;0;0;0
2169230;I'm Late;;0 - 20,000;2;1;1;0;0;0
2169250;Throw Wizard;;0 - 20,000;1;0;1;0;0;0
2169270;Innocent's purgatory;;0 - 20,000;1;1;0;0;0;0
2169370;RCPG;;0 - 20,000;2;1;1;0;0;0
2169460;Argol - Kronoss' Castle;;0 - 20,000;11;0;11;0;0;0
2169620;Frog In the Well;;0 - 20,000;5;0;5;0;0;0
2169700;Gramm;;0 - 20,000;2;0;2;0;0;0
2169810;Mermaid;;0 - 20,000;5;5;0;0;0;0
2170090;Each Other;;0 - 20,000;8;1;7;0;0;0
2170160;Metal March;;0 - 20,000;5;0;5;0;0;1
2170170;Gallery : Moa's Room;;0 - 20,000;2;2;0;0;0;0
2170240;I'll save the world of harem - Isekai Harem Saver -;;0 - 20,000;2;1;1;0;0;0
2170320;Final Beacon;;0 - 20,000;1;1;0;0;0;0
2170350;Free My Sight;;0 - 20,000;1;0;1;0;0;0
2170490;Kind Heart Defenders;;0 - 20,000;20;0;20;0;0;0
2170580;Glass Hearts;;0 - 20,000;1;0;1;0;0;0
2170680;Astonishing Basketball Manager;;20,000 - 50,000;2;1;1;0;0;1
2170760;Saturn Quest: R. U. N. E. 3000;;0 - 20,000;9;4;5;0;0;0
2171010;The secret pyramid VR;;0 - 20,000;15;0;15;0;0;1
2171060;Starway: BaRaider;;0 - 20,000;11;0;11;0;0;0
2171270;Legend of Feather;;0 - 20,000;27;7;20;0;0;3
2171280;Movavi Video Editor 2023;;0 - 20,000;18;17;1;0;0;19
2171290;Movavi Video Suite 2023 Steam Edition - An all-in-one video maker: an editor, converter, screen recorder, and more!;;0 - 20,000;22;12;10;62;62;13
2171300;Movavi Photo Editor 23;;0 - 20,000;10;4;6;0;0;0
2171310;Lost Cartridge - Cold Read;;0 - 20,000;27;1;26;0;0;2
2171350;骑士与工匠 Knights and Craftsmen;;20,000 - 50,000;1;2;-1;0;0;0
2171420;Platonically Mauled by a Magic Cougar;;0 - 20,000;10;1;9;0;0;0
2171450;Bizarr Adventure;;0 - 20,000;0;1;-1;0;0;0
2171530;Step By Step Hero;;0 - 20,000;6;0;6;0;0;0
2171580;Chewing Gum Tests;;0 - 20,000;0;5;-5;0;0;0
2171600;Enemy at the Gates:Commander;;0 - 20,000;1;1;0;0;0;0
2171610;Mini Star Bakery;;0 - 20,000;9;0;9;0;0;0
2171650;Walking In The Abyss;;0 - 20,000;22;0;22;0;0;0
2171720;Mikos Wish;;0 - 20,000;4;7;-3;0;0;0
2171970;Unified;;0 - 20,000;1;1;0;0;0;0
2172120;Rift Rangers;;0 - 20,000;8;0;8;0;0;1
2172150;ANGEL DROID;;0 - 20,000;2;1;1;0;0;0
2172190;Stickman's Arena;;0 - 20,000;11;1;10;0;0;0
2172410;100animalease;;0 - 20,000;4;0;4;0;0;0
2172470;姬恋~缚羽的欠片 纯净中文版;;0 - 20,000;20;4;16;0;0;0
2172510;Fairy Biography2：Confidante;;0 - 20,000;186;38;148;15;15;2
2172600;My Universe - My Baby Dragon;;0 - 20,000;2;0;2;0;0;0
2172620;Wojak This Game;;0 - 20,000;2;2;0;0;0;0
2172660;The Heart Defenders;;0 - 20,000;1;2;-1;0;0;0
2172670;War of Kings;;0 - 20,000;0;5;-5;0;0;0
2172780;Poly Puzzle: Dinosaurs;;0 - 20,000;0;0;0;0;0;0
2172870;PIP 5;;0 - 20,000;0;0;0;0;0;0
2172920;Christmas Wonderland 4;;0 - 20,000;1;0;1;0;0;0
2172950;TheCube;;0 - 20,000;2;0;2;0;0;0
2172980;Fading Light: Antiworld;;50,000 - 100,000;3;1;2;0;0;0
2173200;Age of Heroes: The Beginning;;0 - 20,000;1;0;1;0;0;0
2173270;FORTUNE the FATED;;0 - 20,000;0;1;-1;0;0;0
2173420;Bugs and Bullets;;0 - 20,000;2;0;2;0;0;1
2173480;Non-Euclidean;;0 - 20,000;1;0;1;0;0;0
2173530;LOCOSOCCER;;0 - 20,000;4;0;4;0;0;0
2173550;冒险与魔法;;0 - 20,000;15;7;8;0;0;2
2173620;Eagle Hunting Journey;;0 - 20,000;4;1;3;0;0;1
2173670;Aery VR - Calm Mind;;0 - 20,000;30;0;30;0;0;0
2173680;ArenaMania;;0 - 20,000;6;0;6;0;0;0
2173750;A Potion For Chamomile;;0 - 20,000;4;0;4;0;0;0
2173760;Super Video Golf;;0 - 20,000;8;0;8;0;0;1
2173810;Listen Me;;20,000 - 50,000;1;0;1;0;0;1
2173820;Pirates Gold;;0 - 20,000;0;5;-5;0;0;0
2173870;I commissioned some bees 8;;0 - 20,000;3;1;2;0;0;0
2173880;I commissioned some bees 9;;0 - 20,000;5;0;5;0;0;0
2173890;I commissioned some bees 10;;0 - 20,000;7;0;7;0;0;2
2174030;Park Ranger: Lost In The Woods;;0 - 20,000;2;1;1;0;0;0
2174170;VInput;;0 - 20,000;2;0;2;0;0;0
2174220;DoTeam;;0 - 20,000;0;1;-1;0;0;0
2174330;Together With Me;;0 - 20,000;0;1;-1;0;0;0
2174370;Slugmania;;0 - 20,000;1;0;1;0;0;0
2174420;Lucky Goal;;0 - 20,000;20;2;18;0;0;1
2174710;Broken In Time;;20,000 - 50,000;3;0;3;0;0;0
2174840;Pressure Within;;0 - 20,000;2;1;1;0;0;0
2174930;Slippery Richard! ~ He's Taller Than My Husband ~;;0 - 20,000;11;2;9;0;0;0
2175040;Loser's Romance;;0 - 20,000;2;0;2;0;0;0
2175080;Banana Quest;;0 - 20,000;5;0;5;0;0;0
2175170;MetaMorphic Rippers;;0 - 20,000;3;0;3;0;0;0
2175250;Volley Court;;0 - 20,000;55;1;54;0;0;5
2175350;Nelu's Adventure;;0 - 20,000;1;0;1;0;0;0
2175400;IPO TOWER;;0 - 20,000;1;0;1;0;0;0
2175450;Rhythm Stones;;0 - 20,000;12;1;11;0;0;0
2175490;Lost Between the Lines;;0 - 20,000;9;2;7;0;0;0
2175650;Polda 3;;20,000 - 50,000;32;1;31;0;0;2
2175700;Odd Woods;;0 - 20,000;18;5;13;0;0;2
2175790;Meticulous;;0 - 20,000;1;0;1;0;0;0
2175800;LONGEYED PROJ;;0 - 20,000;18;11;7;0;0;0
2175900;THE LAST SCAPE;;0 - 20,000;0;1;-1;0;0;0
2176000;The Search For Paradisus;;0 - 20,000;4;0;4;0;0;0
2176020;Brutal TD;;0 - 20,000;3;0;3;0;0;0
2176070;Transliminal;;0 - 20,000;2;1;1;0;0;0
2176090;Cursed Angel: Time Paradox;;20,000 - 50,000;0;1;-1;0;0;0
2176130;Tower! Simulator 3;;0 - 20,000;98;57;41;0;0;22
2176140;云城异闻录;;0 - 20,000;6;3;3;0;0;0
2176150;Santa's Gifts;;0 - 20,000;0;2;-2;0;0;0
2176540;Daemonum;;20,000 - 50,000;2;2;0;0;0;0
2176640;Gloomy Tales: Horrific Show Collector's Edition;;0 - 20,000;2;1;1;0;0;4
2176730;Escape From Ithara;;0 - 20,000;4;1;3;0;0;0
2176760;Maid for Loving You;;0 - 20,000;30;0;30;0;0;2
2177020;Kanji RPG;;0 - 20,000;0;1;-1;0;0;0
2177060;The Lost Village;;0 - 20,000;5;6;-1;0;0;0
2177150;The Sentient Box;;0 - 20,000;7;0;7;0;0;2
2177200;Mission In Space;;0 - 20,000;3;0;3;0;0;0
2177210;Mantra;;0 - 20,000;50;22;28;0;0;0
2177260;Super Planet Life;;0 - 20,000;9;0;9;0;0;3
2177450;Futtony y el Copón Mundial;;0 - 20,000;2;0;2;0;0;1
2177490;Spring X Elixir;;0 - 20,000;7;5;2;0;0;0
2177530;The Experiment;;0 - 20,000;1;1;0;0;0;0
2177540;Jewel Match Twilight;;0 - 20,000;5;0;5;0;0;3
2177550;Jewel Match Twilight 2;;0 - 20,000;4;0;4;0;0;1
2177590;Solid Flight;;0 - 20,000;0;1;-1;0;0;0
2177610;Reality Noclip: The Backrooms;;0 - 20,000;11;4;7;0;0;1
2177990;Halloween Stories: Mark on the Bone Collector's Edition;;0 - 20,000;1;0;1;0;0;0
2178310;盗墓密探;;0 - 20,000;1;0;1;0;0;0
2178340;Reality;;0 - 20,000;3;2;1;0;0;0
2178400;LIU (Light It Up);;0 - 20,000;4;0;4;0;0;1
2178440;Bazooka Cat: First Episode;;0 - 20,000;2;0;2;0;0;1
2178550;Black Cycle;;0 - 20,000;2;0;2;0;0;0
2178560;Horde Hunters;;0 - 20,000;13;1;12;0;0;33
2178570;Arthas - The Game;;0 - 20,000;188;62;126;0;0;37
2178590;Coin Pusher Casino;;0 - 20,000;9;3;6;0;0;1
2178650;Fastraq;;0 - 20,000;1;0;1;0;0;0
2178780;Uproot;;0 - 20,000;3;0;3;0;0;1
2178800;Teresa Moontyners - In the lair of the beast;;0 - 20,000;4;0;4;0;0;1
2178820;Space Adventure;;0 - 20,000;2;0;2;0;0;0
2178840;The Umbridge Estate;;0 - 20,000;3;3;0;0;0;0
2178970;Shanubis;;20,000 - 50,000;5;0;5;0;0;0
2179030;BOT.vinnik Chess: Prodigies;;0 - 20,000;7;0;7;0;0;0
2179060;A hundred kinds of your smile;;0 - 20,000;3;0;3;0;0;0
2179100;Talesworth Adventure: The Lost Artifacts;;0 - 20,000;4;0;4;0;0;0
2179130;Patty Pepperton in The Pumpkin Patch;;0 - 20,000;2;1;1;0;0;0
2179270;Mudoba;;0 - 20,000;4;1;3;0;0;0
2179290;HerrAnwalt: Lawyers Legacy;;20,000 - 50,000;387;84;303;0;0;4
2179350;Detective Agency Gray Tie - Collector's Edition;;0 - 20,000;6;3;3;0;0;1
2179360;INCUR Survival;;0 - 20,000;7;1;6;0;0;1
2179380;Sand:box;;0 - 20,000;89;7;82;0;0;7
2179450;Massi;;0 - 20,000;1;1;0;0;0;0
2179460;The Legend of Gwen;;0 - 20,000;10;0;10;0;0;0
2179470;Rocket Inc;;20,000 - 50,000;2;1;1;0;0;0
2179650;SPACE DUDES vs ALIEN DUDES;;20,000 - 50,000;2;0;2;0;0;0
2179720;The Seekers: Survival;;0 - 20,000;20;10;10;0;0;6
2179790;Carpe Diem Project;;50,000 - 100,000;7;3;4;0;0;0
2179990;Art AI Compass: Prompt Randomizer & Manager;;0 - 20,000;1;0;1;0;0;0
2180060;Trouble in Tornado Town;;0 - 20,000;10;0;10;0;0;1
2180310;Basement of Hellish;;20,000 - 50,000;15;4;11;0;0;0
2180350;幻斋阴阳录 Genzai:Serialization;;0 - 20,000;109;11;98;0;0;0
2180390;Boing;;0 - 20,000;1;0;1;0;0;0
2180410;Dark spell;;0 - 20,000;1;2;-1;0;0;0
2180430;MeiQi 2023;;0 - 20,000;24;0;24;0;0;2
2180530;Ragnarok: Fallen Legends;;0 - 20,000;39;15;24;0;0;1
2180570;Detective Solitaire The Ghost Agency 2;;0 - 20,000;1;0;1;0;0;1
2180580;Mystery Solitaire. Dreamcatcher 3;;0 - 20,000;1;0;1;0;0;2
2180610;Cabbagers;;0 - 20,000;11;0;11;0;0;0
2180660;Heimwald;;0 - 20,000;1;0;1;0;0;0
2180750;Five Nights At Furry's;;0 - 20,000;18;5;13;0;0;0
2180830;Super Crazy Chickens;;0 - 20,000;4;0;4;0;0;0
2180980;War Of Gold 2 Mission 99;;20,000 - 50,000;3;1;2;0;0;0
2181000;Primordial Pain;;0 - 20,000;13;1;12;0;0;0
2181110;Tiny Detour;;0 - 20,000;6;0;6;0;0;0
2181230;CAMPING;;0 - 20,000;4;0;4;0;0;0
2181280;Omega Mouse;;0 - 20,000;1;0;1;0;0;0
2181440;Delivery Man;;0 - 20,000;20;6;14;0;0;0
2181450;幻境恋人-Fairy tale plan;;0 - 20,000;1;0;1;0;0;0
2181480;I Fought the Lawn;;0 - 20,000;8;0;8;0;0;0
2181550;Flife;;0 - 20,000;2;0;2;0;0;0
2181640;人类动物园 Human Zoo;;0 - 20,000;35;3;32;0;0;0
2181710;Me With Me;;0 - 20,000;13;1;12;0;0;0
2181720;Scarlet Tower;;0 - 20,000;562;87;475;285;313;67
2181770;The Outer Space Bugs;;0 - 20,000;0;1;-1;0;0;0
2181790;Robox;;0 - 20,000;0;1;-1;0;0;0
2181820;Touch the Balls VR;;0 - 20,000;1;0;1;0;0;1
2181880;Keeper of the Keys;;0 - 20,000;1;0;1;0;0;0
2181930;DR LIVESEY ROM AND DEATH EDITION;;100,000 - 200,000;2599;102;2497;53;59;108
2181990;Good Night, Peregrine;;0 - 20,000;29;5;24;0;0;0
2182020;Assassins Guild;;0 - 20,000;12;3;9;0;0;0
2182130;Wrapped With a Kiss;;0 - 20,000;4;0;4;0;0;0
2182200;UNRUSH;;0 - 20,000;2;1;1;0;0;0
2182240;Dots in line;;0 - 20,000;2;2;0;0;0;1
2182420;Idle Shapes;;0 - 20,000;7;2;5;0;0;0
2182450;Fairy Girl;;0 - 20,000;20;4;16;0;0;0
2182540;MEKA SIGURAT;;0 - 20,000;3;0;3;0;0;0
2182570;Boat Builder: Andy's Story;;0 - 20,000;0;2;-2;0;0;0
2182580;Christmas Wonderland 6;;0 - 20,000;1;0;1;0;0;0
2182590;The Fernweh Saga: Book One;;0 - 20,000;58;5;53;0;0;4
2182690;Gore Screaming Show;;0 - 20,000;45;2;43;0;0;4
2182690;Gore Screaming Show;;0 - 20,000;45;2;43;0;0;4
2182700;Echo Divide;;0 - 20,000;1;0;1;0;0;0
2182770;Escape From Zombies;;50,000 - 100,000;8;3;5;0;0;0
2182930;The Music Trivia Challenge;;0 - 20,000;1;0;1;0;0;0
2182960;Martian Invaders;;0 - 20,000;4;0;4;0;0;0
2182970;The Sports Trivia Challenge;;0 - 20,000;1;0;1;0;0;0
2183030;山谷主;;0 - 20,000;0;1;-1;0;0;0
2183080;Princess Dating Sim;;0 - 20,000;4;0;4;0;0;0
2183180;BACCHANALIA;;0 - 20,000;17;41;-24;0;0;1
2183200;CHAQS;;0 - 20,000;7;3;4;0;0;1
2183210;Fairy Card Rogue;;0 - 20,000;5;2;3;0;0;0
2183230;Talent Club ~ Match 3 Puzzle;;0 - 20,000;48;15;33;44;44;0
2183240;SUKUR;;0 - 20,000;61;10;51;0;0;0
2183320;For Your Tranquility;;0 - 20,000;70;36;34;0;0;2
2183370;Survival Shot;;0 - 20,000;0;3;-3;0;0;0
2183380;DobbyxEscape: Halloween Adventure;;0 - 20,000;3;0;3;0;0;0
2183460;Secret Agent 001;;0 - 20,000;0;1;-1;0;0;0
2183470;Two Skateboards Driving Simulator;;0 - 20,000;2;1;1;0;0;0
2183480;Put Your Stamp On;;0 - 20,000;1;0;1;0;0;0
2183490;Zombies in Metropolis;;0 - 20,000;1;1;0;0;0;0
2183500;Moto Offroad Simulator;;0 - 20,000;2;2;0;0;0;0
2183580;OUTSTAND;;0 - 20,000;4;9;-5;0;0;0
2183590;Urban Night Battle Girl;;0 - 20,000;4;1;3;0;0;0
2183730;The Gravehouse;;0 - 20,000;10;4;6;0;0;0
2183770;KICK MASTER;;0 - 20,000;4;1;3;0;0;0
2183780;ARCADE VS PLAYER;;0 - 20,000;1;1;0;0;0;0
2183790;Bad-Draw;;0 - 20,000;2;0;2;0;0;0
2183800;Actua Golf;;0 - 20,000;2;0;2;0;0;0
2183860;The Witch's House;;0 - 20,000;4;0;4;0;0;0
2183920;Cat Herders: Couch Coop Cat Corralling!;;0 - 20,000;5;0;5;0;0;0
2183940;Perfect Inventory - Organization Puzzle;;0 - 20,000;5;1;4;0;0;0
2184110;SURVIVAL IN THE BACKROOMS;;0 - 20,000;4;4;0;0;0;1
2184180;Tales of Therapy;;0 - 20,000;3;0;3;0;0;0
2184230;Red Tape;;0 - 20,000;27;3;24;0;0;5
2184270;Traveler;;50,000 - 100,000;2;0;2;0;0;0
2184490;Alphadia Neo;;0 - 20,000;3;0;3;0;0;0
2184600;声灵（The whisper soul）;;0 - 20,000;0;1;-1;0;0;0
2184640;Drive West Coast;;0 - 20,000;6;1;5;0;0;0
2184720;Survivors: Three Kingdoms;;0 - 20,000;30;20;10;0;0;18
2184870;Neon Noir;;50,000 - 100,000;1;1;0;0;0;0
2184970;Lost Amulets: Four Guardians;;0 - 20,000;3;1;2;0;0;0
2185190;Pumpkin Ripper;;0 - 20,000;26;3;23;0;0;1
2185240;STARLITE: Defender of Justice Ultimate HD Edition;;0 - 20,000;1;0;1;0;0;0
2185280;Alien on the Radar;;0 - 20,000;1;0;1;0;0;0
2185470;Chinese Characters;;0 - 20,000;12;1;11;0;0;0
2185490;奇克八号盲目发射 Blind No.8 Chick Shoot;;20,000 - 50,000;2;0;2;0;0;0
2185760;Under the Sky World;;0 - 20,000;20;7;13;0;0;7
2185770;Aonatsu Line;;0 - 20,000;547;26;521;0;0;8
2185780;Return to abyss 重返深渊;;50,000 - 100,000;475;98;377;1403;1403;262
2185810;Ghost Village;;0 - 20,000;2;1;1;0;0;0
2185880;wurdweb;;0 - 20,000;28;3;25;0;0;1
2186090;Checkered Flag;;0 - 20,000;1;0;1;0;0;0
2186100;Kaiser;;0 - 20,000;2;0;2;0;0;0
2186130;Zarlor Mercenary;;0 - 20,000;2;0;2;0;0;0
2186140;Early Worm;;0 - 20,000;16;0;16;0;0;0
2186240;Saint Kotar: The Crawling Man;;0 - 20,000;21;0;21;0;0;0
2186380;Teahouse of the Gods;;20,000 - 50,000;5;4;1;0;0;3
2186450;Dear Friend;;0 - 20,000;1;0;1;0;0;0
2186490;Refuge;;0 - 20,000;11;2;9;0;0;0
2186500;Vispo - The Video Spot the Difference game.;;0 - 20,000;3;0;3;0;0;0
2186530;My Desktop Girlfriend;;0 - 20,000;3;1;2;0;0;0
2186610;Dark City: International Intrigue Collector's Edition;;0 - 20,000;2;1;1;0;0;2
2186670;System Escape;;0 - 20,000;2;0;2;0;0;0
2186740;Darkness Reborn;;20,000 - 50,000;2;0;2;0;0;0
2186740;Darkness Reborn;;20,000 - 50,000;2;0;2;0;0;0
2186780;The Heart of the Teddy Bear;;0 - 20,000;12;0;12;0;0;0
2186940;Dark Sweeper;;0 - 20,000;10;0;10;0;0;2
2187190;Poly Shoot;;20,000 - 50,000;1;0;1;0;0;0
2187270;Automatic war;;0 - 20,000;6;2;4;0;0;0
2187570;MUSHROOMAN;;20,000 - 50,000;10;12;-2;0;0;1
2187640;Hero Z TPS;;0 - 20,000;1;0;1;0;0;0
2187670;Electrocop;;0 - 20,000;1;0;1;0;0;0
2187840;The Legend Of Tiger And Phoenix;;0 - 20,000;16;2;14;0;0;0
2187850;Minesweeper Arcade;;0 - 20,000;5;0;5;0;0;0
2188030;Elemental Adventure;;0 - 20,000;1;0;1;0;0;2
2188030;Elemental Adventure;;0 - 20,000;1;0;1;0;0;2
2188220;Across-Stitch;;0 - 20,000;8;0;8;0;0;0
2188230;Phoenix Nightmare;;0 - 20,000;1;2;-1;0;0;0
2188380;Halcyon;;0 - 20,000;8;2;6;0;0;0
2188430;Equinox;;0 - 20,000;2;4;-2;0;0;0
2188470;Save the Queen;;0 - 20,000;2;2;0;0;0;0
2188520;The Dragon's Prophecy;;0 - 20,000;2;0;2;0;0;1
2188620;It Returned To The Desert;;50,000 - 100,000;5;0;5;0;0;2
2188660;NONOGRAM - KAWAII CUTIES 2nd;;0 - 20,000;2;1;1;0;0;0
2188820;The shelter of patient;;0 - 20,000;1;1;0;0;0;0
2188890;Fantasy of War;;0 - 20,000;1;0;1;0;0;0
2188910;Waifu Museum;;0 - 20,000;5;1;4;0;0;0
2188920;Angelic Wishes;;0 - 20,000;2;1;1;0;0;0
2188960;Vampire Slayer: The Resurrection;;0 - 20,000;30;5;25;0;0;0
2189110;Escape From This Planet;;0 - 20,000;0;2;-2;0;0;0
2189230;Hell O Corn;;0 - 20,000;1;0;1;0;0;0
2189370;Feathered Run: Worlds;;0 - 20,000;10;2;8;0;0;0
2189420;骸心 Mainbody;;0 - 20,000;28;2;26;0;0;0
2189580;The last lover;;0 - 20,000;2;2;0;0;0;0
2189640;Cannibal Abduction;;0 - 20,000;122;3;119;0;0;3
2189690;Speed Up;;0 - 20,000;3;1;2;0;0;0
2189750;Mission: Aliens;;0 - 20,000;3;0;3;0;0;0
2189910;Mystic Forest;;0 - 20,000;12;1;11;0;0;1
2189930;New Hire;;0 - 20,000;6;0;6;0;0;0
2190080;Beam Cat;;0 - 20,000;2;0;2;0;0;0
2190160;未然探偵 The Protea Cases;;0 - 20,000;1;0;1;0;0;0
2190180;SmileXCorp 3;;0 - 20,000;2;0;2;0;0;0
2190190;StrayCatDoors2;;0 - 20,000;7;0;7;0;0;1
2190240;GameDev LiTuber Simulator;;0 - 20,000;0;1;-1;0;0;0
2190250;Blocks Tracks Trains;;0 - 20,000;4;0;4;0;0;0
2190290;To Be or Not to Be;;50,000 - 100,000;2309;350;1959;132;179;398
2190410;Beach Runner;;0 - 20,000;2;0;2;0;0;0
2190500;VR Painting: Time;;0 - 20,000;2;0;2;0;0;0
2190590;Valkie 64;;0 - 20,000;51;14;37;0;0;0
2190740;Gates of Zendocon;;0 - 20,000;1;0;1;0;0;0
2190880;WEAPONEER;;0 - 20,000;1;0;1;0;0;0
2190900;HÜDDAM;;0 - 20,000;8;5;3;0;0;1
2190950;WORDKOUR;;0 - 20,000;1;1;0;0;0;0
2191140;Rayna Survivors;;0 - 20,000;2;5;-3;0;0;0
2191180;Little Devil;;50,000 - 100,000;3;3;0;0;0;0
2191230;sunny-place-2;;0 - 20,000;4;0;4;0;0;0
2191320;Boat Train;;20,000 - 50,000;5;0;5;0;0;0
2191370;A Path to the Princess;;0 - 20,000;4;0;4;0;0;0
2191460;The Exorcist's Story;;0 - 20,000;14;3;11;0;0;0
2191530;IronKnight;;0 - 20,000;1;0;1;0;0;0
2191620;铭日记 重书 / Mikoto Remake;;0 - 20,000;13;2;11;0;0;0
2191880;Naturia;;0 - 20,000;2;1;1;0;0;0
2191920;PESTICIDE;;20,000 - 50,000;6;1;5;0;0;1
2192120;Wipe Factor;;0 - 20,000;1;0;1;0;0;0
2192170;Whackerball;;0 - 20,000;29;2;27;0;0;7
2192220;Doughball Descent;;0 - 20,000;8;1;7;0;0;0
2192400;Aunewyth;;0 - 20,000;1;1;0;0;0;0
2192480;Luna & Monsters Tower Defense -The deprived magical kingdom-;;0 - 20,000;4;2;2;0;0;0
2192500;Train Operator 377;;0 - 20,000;21;1;20;0;0;0
2192530;Dark Box;;0 - 20,000;5;0;5;0;0;0
2192570;Vosphia;;0 - 20,000;9;3;6;0;0;0
2192640;The Iron Union;;200,000 - 500,000;3;1;2;0;0;0
2192650;Super Clown 3: Revenge;;0 - 20,000;15;3;12;0;0;0
2192670;G-MODEアーカイブス+ 女神転生外伝 新約ラストバイブル;;0 - 20,000;3;2;1;0;0;1
2192680;G-MODEアーカイブス+ 女神転生外伝 新約ラストバイブルII 始まりの福音;;0 - 20,000;1;1;0;0;0;0
2192700;PEBI - Preview Emotes Badges Icons;;0 - 20,000;0;0;0;0;0;2
2192840;Terfenstein 3D;;0 - 20,000;11;5;6;0;0;0
2192850;One Shot Challenge;;0 - 20,000;2;2;0;0;0;0
2193080;Amabilly;;0 - 20,000;3;0;3;0;0;0
2193170;Funplace: After Hours;;0 - 20,000;3;0;3;0;0;0
2193370;Creative Continents;;0 - 20,000;1;0;1;0;0;0
2193380;Image;;0 - 20,000;17;7;10;0;0;0
2193410;Undercover - Blood Bonds;;0 - 20,000;6;0;6;0;0;1
2193500;Book Travelers: A Victorian Story Collector's Edition;;0 - 20,000;2;1;1;0;0;1
2193670;Cymut X Mutrobo RPG - Mutants VS. Robots;;0 - 20,000;3;0;3;0;0;0
2193690;SPEEDRUNNER;;0 - 20,000;1;0;1;0;0;0
2193770;Our Summer Sports;;0 - 20,000;1;0;1;0;0;0
2193870;多比大冒险(Doobi's Adventure);;0 - 20,000;17;9;8;0;0;1
2193900;Creepy Forest;;;;;0;;;
2193920;Homerun Miko;;0 - 20,000;2;0;2;0;0;0
2193940;The Hidden and Unknown;;0 - 20,000;0;0;0;0;0;0
2193970;DanceXR Pure;;0 - 20,000;1;0;1;0;0;0
2193990;Monster Hunters: Frost Giant;;0 - 20,000;3;0;3;0;0;1
2194300;G-MODEアーカイブス+ 女神転生外伝 新約ラストバイブルIII 夢幻の英雄;;0 - 20,000;1;1;0;0;0;0
2194410;Idle Hamburgers Save the World;;0 - 20,000;26;9;17;0;0;3
2194660;Criminal Expert;;0 - 20,000;3;2;1;0;0;1
2194950;Cluppets;;0 - 20,000;2;0;2;0;0;0
2195050;Princess Ruby;;0 - 20,000;3;0;3;0;0;0
2195060;The Lost Castle: Escape Room;;0 - 20,000;5;9;-4;0;0;0
2195090;Cuppy's;;0 - 20,000;10;0;10;0;0;0
2195150;The Helper;;0 - 20,000;6;0;6;0;0;0
2195200;Find The Key;;0 - 20,000;0;7;-7;0;0;0
2195230;仙界之剑 仙王少女战记;;20,000 - 50,000;17;0;17;0;0;6
2195530;Theocracy;;20,000 - 50,000;8;0;8;0;0;2
2195560;Hallowed Pumpkins;;0 - 20,000;0;1;-1;0;0;0
2195630;circloO;;0 - 20,000;3;0;3;0;0;1
2195670;Epic Princess;;0 - 20,000;7;1;6;0;0;0
2195690;Tropical Hearts;;0 - 20,000;10;0;10;0;0;0
2195720;Lil Baby Poop's NIGHTMARES;;0 - 20,000;4;1;3;0;0;0
2195750;Liars Race in Lost Ruins;;20,000 - 50,000;0;1;-1;0;0;0
2196050;Outworld Patrol;;0 - 20,000;4;0;4;0;0;0
2196100;Barren Depths;;50,000 - 100,000;3;2;1;0;0;0
2196120;Baker Business 3;;0 - 20,000;5;2;3;0;0;2
2196140;HellRazor64;;0 - 20,000;7;0;7;0;0;0
2196150;Castle Defense Battles;;50,000 - 100,000;1;1;0;0;0;0
2196230;SlasherRPG;;0 - 20,000;9;4;5;0;0;0
2196280;查理公馆事件簿;;0 - 20,000;3;0;3;0;0;0
2196320;Space Yugoslav 2D;;20,000 - 50,000;2;0;2;0;0;0
2196370;Cherry Lady;;20,000 - 50,000;0;1;-1;0;0;0
2196380;Candy Maid;;0 - 20,000;1;1;0;0;0;0
2196410;Simple Rolling;;0 - 20,000;1;0;1;0;0;0
2196440;Gray;;20,000 - 50,000;3;2;1;0;0;0
2196680;CHARGED: RC Racing;;0 - 20,000;4;1;3;0;0;0
2196770;Spartacus: Born to be free;;0 - 20,000;14;0;14;0;0;0
2196790;Jianghu Survivor;;0 - 20,000;232;29;203;0;0;388
2196980;Arcadie: Second-Born;;0 - 20,000;192;6;186;0;0;5
2197000;DrugRunner;;0 - 20,000;1;2;-1;0;0;0
2197050;Xmas Apocalypse;;0 - 20,000;35;5;30;0;0;0
2197130;Wintersdawn in the Deep;;0 - 20,000;3;1;2;0;0;0
2197170;Aswang Detective: The Case of New York;;0 - 20,000;0;1;-1;0;0;0
2197430;Knockback Knockout;;0 - 20,000;2;0;2;0;0;0
2197500;Mining Copper;;0 - 20,000;2;4;-2;0;0;0
2197550;Love Quest;;0 - 20,000;4;0;4;0;0;1
2197760;Midnight Scenes: From the Woods;;0 - 20,000;33;5;28;0;0;11
2197780;Nash Racing: Pursuit;;0 - 20,000;12;7;5;0;0;0
2197830;What A Ball;;0 - 20,000;5;1;4;0;0;0
2197890;Paranormal Cleanup;;20,000 - 50,000;35;15;20;0;0;0
2198460;Draft Day Sports: Pro Basketball 2023;;0 - 20,000;1;0;1;0;0;7
2198740;One Wheel Guy;;0 - 20,000;7;0;7;0;0;0
2198800;CRUMB Circuit Simulator;;0 - 20,000;200;45;155;47;47;12
2198970;Land of Towers;;0 - 20,000;12;1;11;0;0;0
2199300;Tower Skydiver;;0 - 20,000;3;0;3;0;0;0
2199300;Tower Skydiver;;0 - 20,000;3;0;3;0;0;0
2199360;Cow Girl 2;;0 - 20,000;13;9;4;0;0;1
2199380;Laruaville 13 Match 3 Puzzle;;0 - 20,000;1;0;1;0;0;3
2199440;My Heart Your Soul;;20,000 - 50,000;1;0;1;0;0;0
2199450;Finding Fifi;;0 - 20,000;4;0;4;0;0;0
2199540;80's Mania Pinball;;0 - 20,000;8;0;8;0;0;0
2199570;Station 117;;0 - 20,000;11;3;8;0;0;0
2199580;Interstellar Pilot 2;;0 - 20,000;27;3;24;0;0;5
2199610;Lincoln Green;;0 - 20,000;3;1;2;0;0;1
2199810;Cyber Skirmish;;0 - 20,000;6;3;3;0;0;0
2199830;Bavovna included!;;0 - 20,000;7;0;7;0;0;0
2199970;Substance 3D Painter 2023;;0 - 20,000;30;8;22;0;0;49
2199990;Substance 3D Stager 2023;;0 - 20,000;1;1;0;0;0;2
2200000;Substance 3D Sampler 2023;;0 - 20,000;3;0;3;0;0;1
2200010;Substance 3D Designer 2023;;0 - 20,000;9;1;8;0;0;17
2200220;VR Pekin Royal Palace;;0 - 20,000;1;0;1;0;0;0
2200260;Millie and Molly;;0 - 20,000;1;0;1;0;0;0
2200560;N₂O;;0 - 20,000;1;0;1;0;0;0
2200760;The Bogtavern;;0 - 20,000;16;1;15;0;0;0
2201040;IN CELL;;0 - 20,000;5;2;3;0;0;0
2201110;Sotidrokhima;;0 - 20,000;5;0;5;0;0;0
2201130;Distributor Simulator;;0 - 20,000;3;1;2;0;0;0
2201160;Freddy Frog 2;;0 - 20,000;1;0;1;0;0;0
2201170;Christmas Wonderland 13;;0 - 20,000;2;1;1;0;0;1
2201210;Cursor Engine;;0 - 20,000;9;0;9;0;0;5
2201340;Crossroads: Escaping the Dark Collector's Edition;;0 - 20,000;2;1;1;0;0;0
2201390;Palladise Island：Legendary Space;;0 - 20,000;8;1;7;0;0;1
2201450;laf the game;;0 - 20,000;6;1;5;0;0;0
2201680;Rocket Escape;;20,000 - 50,000;5;1;4;0;0;0
2201790;Don't Kill the Cat;;0 - 20,000;4;1;3;0;0;0
2201840;그녀가 다시 노래할 때까지.;;0 - 20,000;6;1;5;0;0;0
2202270;Hunting Life VR: Dove Season;;0 - 20,000;0;1;-1;0;0;0
2202400;SoundStorm;;0 - 20,000;2;0;2;0;0;0
2202500;Rapscallions On Deck - Otome;;0 - 20,000;3;0;3;0;0;0
2202880;Car Parking;;0 - 20,000;13;3;10;0;0;0
2202890;Furious Sword;;0 - 20,000;10;0;10;0;0;0
2202900;Out of the ground;;0 - 20,000;11;0;11;0;0;0
2202910;Shadow Lens;;0 - 20,000;1;1;0;0;0;0
2203030;Girl Fantasy;;0 - 20,000;381;31;350;2;2;7
2203140;Keep Sheep;;0 - 20,000;2;2;0;0;0;1
2203200;Akari: School Trip;;0 - 20,000;2;1;1;0;0;0
2203430;PUB FASCINATION;;0 - 20,000;11;2;9;0;0;0
2203490;My Land!;;0 - 20,000;1;1;0;0;0;0
2203500;Cars vs Train;;0 - 20,000;3;2;1;0;0;0
2203510;Kung Fu School;;0 - 20,000;0;1;-1;0;0;0
2203540;Escape From School : F.E.L.I.K;;0 - 20,000;1;0;1;0;0;0
2203610;Ants of Duty;;20,000 - 50,000;15;4;11;0;0;0
2203620;Blood Exile;;50,000 - 100,000;12;2;10;0;0;1
2203630;Bot World;;0 - 20,000;15;3;12;0;0;0
2203640;Breathspace;;20,000 - 50,000;15;3;12;0;0;0
2203650;Computer Cats;;0 - 20,000;11;1;10;0;0;0
2203660;Crispy Puppy;;50,000 - 100,000;16;2;14;0;0;0
2203680;Cult of the Mask;;20,000 - 50,000;12;1;11;0;0;1
2203680;Cult of the Mask;;20,000 - 50,000;12;1;11;0;0;1
2203690;DICE GAME;;20,000 - 50,000;13;2;11;0;0;1
2203700;Drag and Drop;;50,000 - 100,000;16;3;13;0;0;0
2203720;Female Prison;;0 - 20,000;2;10;-8;0;0;0
2203730;IN THE BUILDING: CATS;;0 - 20,000;35;8;27;0;0;2
2203890;Hank's Quest for Soup;;0 - 20,000;2;0;2;0;0;0
2203990;Commando Hero;;0 - 20,000;31;1;30;0;0;1
2204220;Full Moon Kit;;0 - 20,000;4;0;4;0;0;0
2204360;Squid Fighter;;0 - 20,000;1;0;1;0;0;0
2204450;BALLDVENTURE;;0 - 20,000;2;0;2;0;0;0
2204540;GrandStrategy;;0 - 20,000;1;0;1;0;0;0
2204680;Cyber West: Hidden Object Games - Western;;0 - 20,000;18;0;18;0;0;2
2204710;Green Garden;;0 - 20,000;0;1;-1;0;0;0
2204720;Sunny Memories;;0 - 20,000;1;3;-2;0;0;0
2204760;Cat Life;;0 - 20,000;4;1;3;0;0;0
2204810;Backrooms - Surreality;;0 - 20,000;4;5;-1;0;0;0
2204830;Street Lords;;0 - 20,000;50;17;33;0;0;27
2204840;Adventure's Pixel World;;0 - 20,000;1;0;1;0;0;0
2204860;Dungeons and Myths;;0 - 20,000;0;1;-1;0;0;0
2204940;Battle Robots;;0 - 20,000;10;1;9;0;0;0
2205100;七星探偵倶楽部~黄金虫たちの帰巣~;;20,000 - 50,000;1;0;1;0;0;0
2205130;5 Days;;0 - 20,000;1;0;1;0;0;0
2205130;5 Days;;0 - 20,000;1;0;1;0;0;0
2205160;Dungeon of Death;;0 - 20,000;12;0;12;0;0;0
2205190;Clown Of Duty;;0 - 20,000;70;23;47;0;0;2
2205270;Cuana;;0 - 20,000;3;0;3;0;0;0
2205290;流光易逝的夏末 - Fleeting Summer's End;;0 - 20,000;150;0;150;0;0;2
2205420;PAIN: Below Sanity;;0 - 20,000;8;1;7;0;0;0
2205460;İBLİS2:sorcery;;0 - 20,000;7;20;-13;0;0;1
2205510;WITCH'S;;0 - 20,000;3;0;3;0;0;0
2206150;Hot And Lovely ：Charm;;20,000 - 50,000;296;40;256;0;0;70
2206310;BlueTricks;;0 - 20,000;1;1;0;0;0;0
2206310;BlueTricks;;0 - 20,000;1;1;0;0;0;0
2206450;Dwarfer;;200,000 - 500,000;13;1;12;0;0;0
2206460;Furry Killer;;20,000 - 50,000;17;4;13;0;0;0
2206570;Geolosys;;100,000 - 200,000;13;1;12;0;0;0
2206580;Gravity Magician;;50,000 - 100,000;10;1;9;0;0;1
2206590;Fateel - فتيل;;0 - 20,000;4;1;3;0;0;0
2206680;Halt;;0 - 20,000;13;1;12;0;0;0
2206690;Kalzoon;;0 - 20,000;14;0;14;0;0;0
2206720;Lab Inspect;;20,000 - 50,000;14;1;13;0;0;0
2206720;Lab Inspect;;20,000 - 50,000;14;1;13;0;0;0
2206970;Keepers of the Forest;;0 - 20,000;1;0;1;0;0;0
2206980;與魔共舞;;0 - 20,000;9;0;9;0;0;1
2207030;下山的试炼之江湖遗失录 A test before Jianghu;;0 - 20,000;8;0;8;0;0;0
2207040;Myasoid;;0 - 20,000;12;1;11;0;0;0
2207050;My Soul Forever;;0 - 20,000;15;2;13;0;0;0
2207060;Nanali in another world;;0 - 20,000;14;1;13;0;0;1
2207070;Social Credit Simulator;;50,000 - 100,000;15;4;11;0;0;0
2207080;Stolen Dolls;;0 - 20,000;13;3;10;0;0;0
2207100;Tiny Onion Knight;;20,000 - 50,000;10;3;7;0;0;0
2207110;Power Driver;;0 - 20,000;14;1;13;0;0;0
2207120;My Darkest Witch;;200,000 - 500,000;10;2;8;0;0;1
2207250;ZigZagging Ski;;0 - 20,000;0;1;-1;0;0;0
2207520;MIND CORRIDORS: Paroniria;;0 - 20,000;30;0;30;0;0;1
2207560;TROJAN;;0 - 20,000;1;0;1;0;0;0
2207590;Exorcist 2: Crow Magic;;0 - 20,000;4;1;3;0;0;0
2207610;Beat the Heat;;0 - 20,000;3;0;3;0;0;0
2207690;Bewells;;0 - 20,000;1;1;0;0;0;0
2207980;House of Ghosts;;0 - 20,000;5;4;1;0;0;0
2208070;Jigsaw Puzzle Best Places;;0 - 20,000;17;2;15;0;0;3
2208230;Save Kill them all;;0 - 20,000;1;1;0;0;0;0
2208300;Terrarium Builder;;0 - 20,000;1;0;1;0;0;1
2208320;Explore the forest Kill!!!;;0 - 20,000;10;3;7;0;0;0
2208390;Rabbit Maze;;0 - 20,000;1;0;1;0;0;0
2208730;Raiders of Ruin;;20,000 - 50,000;13;0;13;0;0;0
2208770;Battle of the Lost Continent;;0 - 20,000;10;0;10;0;0;0
2208820;Grabitoons!;;0 - 20,000;3;0;3;0;0;0
2208870;Wrestling Manager 2023;;0 - 20,000;1;3;-2;0;0;0
2208920;Assassin's Creed Valhalla;;100,000 - 200,000;4243;2624;1619;2722;1764;2562
2208940;Geometric Hell;;0 - 20,000;1;0;1;0;0;0
2208950;See Ya Later!;;0 - 20,000;1;0;1;0;0;0
2208990;Simulators2023;;0 - 20,000;2;0;2;0;0;0
2209130;Scavenia Survivors;;0 - 20,000;5;2;3;0;0;0
2209370;Lost in Memory;;0 - 20,000;1;0;1;0;0;0
2209470;Interplayer;;0 - 20,000;13;0;13;0;0;0
2209560;NoEL - Nothing on Elysion Line;;0 - 20,000;8;3;5;0;0;6
2209580;Digital Frida;;0 - 20,000;10;2;8;0;0;2
2209660;Awaken;;20,000 - 50,000;13;7;6;0;0;0
2209680;Beach Invasion 1944;;0 - 20,000;371;65;306;7;7;10
2209710;Skybox;;20,000 - 50,000;3;0;3;0;0;0
2209880;Nightmare Inside;;0 - 20,000;0;1;-1;0;0;0
2210210;A Matter of Principle;;0 - 20,000;7;1;6;0;0;0
2210590;自由人生模拟 Free Life Simulation;;0 - 20,000;14;7;7;0;0;4
2210620;Head Basketball;;0 - 20,000;2;1;1;0;0;0
2210630;Pretty Girls 2048 Strike;;0 - 20,000;10;0;10;0;0;0
2210670;Torecower;;0 - 20,000;19;3;16;0;0;0
2210710;Zombie Shooting Star: ARCADE;;0 - 20,000;23;6;17;0;0;2
2210760;VR Jurassic Adventure HD;;0 - 20,000;0;1;-1;0;0;0
2210810;Mining Factory;;0 - 20,000;8;5;3;0;0;7
2210980;Cloudy Days;;0 - 20,000;8;0;8;0;0;0
2211110;Brick Odyssey;;0 - 20,000;8;0;8;0;0;1
2211120;Grapple Whip;;0 - 20,000;1;2;-1;0;0;0
2211150;WordSpiral;;0 - 20,000;0;1;-1;0;0;0
2211190;BYTE FYTE (MULTIPLAYER);;0 - 20,000;30;7;23;0;0;0
2211440;Vampire Tourist;;0 - 20,000;1;0;1;0;0;0
2211500;Cambrian Dawn;;0 - 20,000;1;0;1;0;0;0
2211640;Who Knocks;;20,000 - 50,000;26;7;19;0;0;2
2211790;Space Moonshiner;;0 - 20,000;6;0;6;0;0;1
2211800;Mama Die and Retry;;0 - 20,000;4;0;4;0;0;0
2211870;HOSPICE Vol. 1;;0 - 20,000;9;4;5;0;0;0
2211960;Counterspell;;0 - 20,000;3;0;3;0;0;0
2212200;Amber Time Pocket [RPG];;0 - 20,000;0;1;-1;0;0;0
2212250;SURRENDER;;0 - 20,000;1;0;1;0;0;0
2212310;Zen Paint;;0 - 20,000;1;1;0;0;0;1
2212330;Your Only Move Is HUSTLE;;200,000 - 500,000;3295;124;3171;292;233;2870
2212390;AOI;;0 - 20,000;30;6;24;0;0;4
2212660;Boom 2020;;0 - 20,000;2;0;2;0;0;0
2212690;The Dungeon Rules;;0 - 20,000;0;1;-1;0;0;0
2212740;DAB 12;;0 - 20,000;1;0;1;0;0;0
2212810;Crown of Thorns;;20,000 - 50,000;2;0;2;0;0;0
2212850;Robocoder - Dwarf Mountain;;0 - 20,000;1;0;1;0;0;0
2212880;Olho;;0 - 20,000;2;0;2;0;0;0
2213420;Recoil VS The World;;0 - 20,000;1;0;1;0;0;0
2213450;Hell Runner;;0 - 20,000;14;0;14;0;0;0
2213460;Ghost Guy;;0 - 20,000;5;0;5;0;0;0
2213600;Medusa;;0 - 20,000;12;0;12;0;0;1
2213640;Susurye of Shadows;;0 - 20,000;7;0;7;0;0;0
2213650;PinCOL;;0 - 20,000;1;0;1;0;0;0
2213730;ShovelBear;;0 - 20,000;2;0;2;0;0;0
2213850;List: Game of Candles;;0 - 20,000;10;0;10;0;0;0
2213880;The Future Ends;;0 - 20,000;10;3;7;0;0;1
2213930;Survive and Revenge;;0 - 20,000;0;1;-1;0;0;0
2214010;Slime Evolution;;0 - 20,000;1;1;0;0;0;0
2214020;Reflections of Life: Spindle of Fate Collector's Edition;;0 - 20,000;3;1;2;0;0;0
2214030;Aim Expert;;0 - 20,000;4;0;4;0;0;0
2214050;Dwarven Mercenaries;;0 - 20,000;0;1;-1;0;0;0
2214090;Hyper Shapes;;0 - 20,000;6;2;4;0;0;0
2214140;Tsubaki Hata;;0 - 20,000;0;1;-1;0;0;0
2214150;Pichi Girl;;0 - 20,000;1;1;0;0;0;0
2214160;Stream Runners: Heroes;;0 - 20,000;1;0;1;0;0;1
2214250;Falsepine;;50,000 - 100,000;19;5;14;0;0;1
2214250;Falsepine;;50,000 - 100,000;19;5;14;0;0;1
2214430;星辰封神;;0 - 20,000;0;2;-2;0;0;0
2214480;すいころ;;0 - 20,000;2;0;2;0;0;0
2214840;The Shadow Over Route 80;;20,000 - 50,000;18;0;18;0;0;0
2214860;Look for connecting stars;;0 - 20,000;1;0;1;0;0;0
2214890;Commander: Modern War;;0 - 20,000;13;1;12;0;0;2
2214940;A Slime In Time;;0 - 20,000;1;0;1;0;0;0
2214950;cat and rat;;0 - 20,000;131;8;123;0;0;0
2215100;Balloon Man;;0 - 20,000;0;5;-5;0;0;0
2215220;Jewel Match Winter Wonderland 2 Collector's Edition;;0 - 20,000;11;2;9;0;0;5
2215260;Scott Pilgrim vs. The World: The Game – Complete Edition;;50,000 - 100,000;379;322;57;70;110;23
2215330;Speluncaphobia;;0 - 20,000;0;2;-2;0;0;0
2215540;Colossal Cave;;0 - 20,000;38;6;32;0;0;4
2215590;30-50 Feral Hogs;;0 - 20,000;2;0;2;0;0;0
2215780;抵御者 Defender;;0 - 20,000;8;0;8;0;0;0
2215820;Late photographer 6;;0 - 20,000;10;2;8;0;0;0
2216010;Winter;;0 - 20,000;1;0;1;0;0;0
2216030;GODDESS OF VICTORY;;0 - 20,000;5;0;5;0;0;0
2216320;Eggcelerate! to the North Pole;;0 - 20,000;4;0;4;0;0;0
2216360;Disaster Band;;0 - 20,000;252;45;207;79;79;21
2216510;Zombie Land - Survival;;0 - 20,000;1;3;-2;0;0;0
2216650;A Slime And A Civil War;;0 - 20,000;3;1;2;0;0;0
2216690;Turret Girl;;20,000 - 50,000;0;2;-2;0;0;0
2216960;Super Psycho Baseball;;0 - 20,000;109;4;105;0;0;2
2217060;Graceward - Complete Edition;;0 - 20,000;3;0;3;0;0;0
2217060;Graceward - Complete Edition;;0 - 20,000;3;0;3;0;0;0
2217440;Pair Of Stamps;;0 - 20,000;45;0;45;0;0;2
2217450;Stellar Echoes;;0 - 20,000;11;1;10;0;0;0
2217540;3 Households;;0 - 20,000;2;0;2;0;0;0
2217560;Sudden Market;;0 - 20,000;9;0;9;0;0;0
2217840;In The Backrooms;;0 - 20,000;29;21;8;0;0;13
2218140;Alien Slayers;;0 - 20,000;40;4;36;0;0;10
2218210;The paladin & The succubi servant;;0 - 20,000;33;7;26;0;0;0
2218350;RPG Maker 3D Character Converter;;0 - 20,000;4;4;0;0;0;1
2218570;Idle interstellar Factory 2;;0 - 20,000;5;0;5;0;0;2
2218630;Festive Finds: Happy Holidays Calendar;;0 - 20,000;3;0;3;0;0;0
2218660;Onefold Taxi Simulator;;0 - 20,000;1;0;1;0;0;0
2218830;GrandTraveler;;0 - 20,000;1;0;1;0;0;0
2218840;The Children's Friend;;0 - 20,000;6;0;6;0;0;1
2218850;1 Day Later: Escape Zombie Hospital;;0 - 20,000;7;2;5;0;0;0
2218950;Derision;;0 - 20,000;1;0;1;0;0;0
2218970;Plains of Pain;;20,000 - 50,000;5;3;2;0;0;3
2218980;Sperma;;0 - 20,000;18;2;16;0;0;0
2219160;A Christmas Yarn;;0 - 20,000;1;0;1;0;0;0
2219360;String Along;;0 - 20,000;1;0;1;0;0;0
2219520;Isolated Room;;0 - 20,000;40;4;36;0;0;0
2219640;Kanji Drive;;0 - 20,000;4;0;4;0;0;0
2219830;Ricky's Rockin' Arcade;;0 - 20,000;3;0;3;0;0;0
2219930;Laruaville 4 Christmas Match 3 Puzzle;;0 - 20,000;1;0;1;0;0;0
2220040;Eye of D'akess;;20,000 - 50,000;1;0;1;0;0;1
2220070;Encoded War;;0 - 20,000;15;2;13;0;0;1
2220130;Chaos Saw;;0 - 20,000;0;1;-1;0;0;0
2220320;Space Mercenary Defense Force;;20,000 - 50,000;8;1;7;0;0;1
2220350;I commissioned some bees (advent);;0 - 20,000;9;1;8;0;0;0
2220480;Burst Hero;;0 - 20,000;15;3;12;0;0;6
2220590;华夏五千年;;0 - 20,000;3;1;2;0;0;1
2220740;GameVRoom;;0 - 20,000;6;0;6;0;0;1
2220750;Color Invader VR;;0 - 20,000;1;0;1;0;0;0
2220810;Spire of Glory;;0 - 20,000;67;21;46;0;0;1
2220850;Combine And Conquer;;0 - 20,000;6;0;6;0;0;0
2220980;错误之事;;0 - 20,000;11;9;2;0;0;1
2221090;Escape of Pig;;0 - 20,000;1;0;1;0;0;0
2221100;Just One;;0 - 20,000;1;0;1;0;0;0
2221190;Neon Blast;;0 - 20,000;1;0;1;0;0;0
2221230;Candyboy;;0 - 20,000;2;0;2;0;0;0
2221260;Tetris Christmas;;0 - 20,000;3;0;3;0;0;0
2221490;Tom Clancy’s The Division 2;;50,000 - 100,000;2464;1508;956;1761;1286;2357
2221540;Extinction / Zombie İnvasion 1;;20,000 - 50,000;4;0;4;0;0;0
2221620;Finding America: The Pacific Northwest;;0 - 20,000;1;0;1;0;0;0
2221710;Ultra Rhythm;;0 - 20,000;6;5;1;0;0;1
2221740;VataZombie;;0 - 20,000;3;1;2;0;0;0
2221790;幻境咖啡馆-Dreamland coffee;;0 - 20,000;5;0;5;0;0;0
2221820;7 Sins : Lost in Labyrinth;;0 - 20,000;20;5;15;0;0;6
2221920;Immortals Fenyx Rising;;0 - 20,000;437;149;288;2187;2187;77
2221920;Immortals Fenyx Rising;;0 - 20,000;437;149;288;2187;2187;77
2222160;Martial Fire;;0 - 20,000;10;0;10;0;0;0
2222170;Crazy City Driving;;0 - 20,000;10;1;9;0;0;0
2222180;Car Parking 2;;0 - 20,000;10;0;10;0;0;0
2222190;Way of the Wizard;;0 - 20,000;10;0;10;0;0;0
2222200;Springblades;;0 - 20,000;0;0;0;0;0;3
2222260;Gummy Dummy Battles;;0 - 20,000;10;0;10;0;0;0
2222480;Clash: Robot Detective - Complete Edition;;0 - 20,000;5;0;5;0;0;0
2222670;Mystery Case Files: The Last Resort Collector's Edition;;0 - 20,000;3;5;-2;0;0;3
2222710;The Awakening Program;;0 - 20,000;10;0;10;0;0;0
2222750;Hidden Mars;;0 - 20,000;12;1;11;0;0;0
2222770;Cats and Sokoban - Mimi's Scratcher;;0 - 20,000;20;0;20;0;0;0
2223010;DragonHill VR;;0 - 20,000;2;5;-3;0;0;1
2223020;Glass Heart;;0 - 20,000;9;0;9;0;0;2
2223130;Tactical Command;;20,000 - 50,000;22;0;22;0;0;3
2223380;Twistingo: Bird Paradise Collector's Edition;;0 - 20,000;10;0;10;0;0;2
2223470;Skeleton Runner;;0 - 20,000;3;3;0;0;0;1
2223550;Ecocoru : Euclidean Constructions -- Compass & Ruler;;0 - 20,000;1;0;1;0;0;4
2223590;2112TD: Tower Defense Survival;;20,000 - 50,000;79;14;65;0;0;15
2223640;Towers, Turrets, Turtles;;0 - 20,000;0;1;-1;0;0;0
2223900;Backrooms: The Game;;0 - 20,000;0;2;-2;0;0;0
2223920;GLOBE DRONE;;0 - 20,000;4;1;3;0;0;0
2224200;Heirs of the Kings;;0 - 20,000;1;1;0;0;0;1
2224330;Outbreak 2030;;0 - 20,000;14;5;9;0;0;1
2224430;Asian Food Cart Tycoon;;0 - 20,000;1;3;-2;0;0;0
2224440;Rice Bowl Restaurant;;0 - 20,000;1;0;1;0;0;0
2224520;No13Shelter;;20,000 - 50,000;2;0;2;0;0;0
2224600;Boat Simulator;;0 - 20,000;0;1;-1;0;0;0
2224660;Animal Survivors;;0 - 20,000;3;2;1;0;0;0
2224790;PIEN & PAON plus;;0 - 20,000;26;0;26;0;0;1
2224830;Ansoku;;0 - 20,000;1;0;1;0;0;0
2225030;Anubis Clicker;;0 - 20,000;0;0;0;0;0;0
2225060;black idea | فكرة سوداء;;0 - 20,000;0;4;-4;0;0;0
2225080;Jump Dash Soar;;0 - 20,000;5;0;5;0;0;0
2225290;Beau & Bow;;0 - 20,000;4;0;4;0;0;0
2225300;WAR Card Game_uvr;;0 - 20,000;0;1;-1;0;0;0
2225460;Word x Word;;0 - 20,000;4;0;4;0;0;0
2225500;Contract Bridge Solo;;20,000 - 50,000;0;1;-1;0;0;0
2225530;Drawing From Memory;;0 - 20,000;128;4;124;0;0;7
2225730;MannyTD;;0 - 20,000;2;0;2;0;0;0
2225890;Neo Shock;;0 - 20,000;2;1;1;0;0;0
2226100;The Molfar: Call of Heart;;50,000 - 100,000;9;3;6;0;0;0
2226140;Crypt Architect;;0 - 20,000;7;0;7;0;0;0
2226310;Orc Survivors;;0 - 20,000;0;1;-1;0;0;0
2226350;Cat + Dog;;0 - 20,000;3;0;3;0;0;0
2226440;The Black Knight;;0 - 20,000;17;3;14;0;0;1
2226500;monsterLabShooter;;0 - 20,000;0;3;-3;0;0;0
2226750;Potion Brew: Co-op;;0 - 20,000;25;1;24;0;0;0
2226830;Royale Battle: Warzone;;0 - 20,000;1;0;1;0;0;0
2226930;EsoTarot VR;;0 - 20,000;2;0;2;0;0;0
2226940;Space Haste 2;;0 - 20,000;2;0;2;0;0;0
2227070;KittenMouse: Summer Of Love;;0 - 20,000;1;0;1;0;0;0
2227130;Caves of Lore;;0 - 20,000;119;2;117;0;0;25
2227340;DFL2;;0 - 20,000;0;1;-1;0;0;0
2227380;Air Attack VR;;0 - 20,000;2;0;2;0;0;0
2227420;Stream Counter;;0 - 20,000;0;1;-1;0;0;0
2227490;CodingPack;;0 - 20,000;5;0;5;0;0;0
2227500;Dig Down;;100,000 - 200,000;1;0;1;0;0;0
2227710;The Rocket Jumper;;0 - 20,000;1;0;1;0;0;0
2228040;Legacy Of The Pact;;0 - 20,000;5;1;4;0;0;0
2228150;The Soul's Choice;;0 - 20,000;3;0;3;0;0;0
2228220;Variant 22;;50,000 - 100,000;0;10;-10;0;0;2
2228320;Feisty Festivities;;0 - 20,000;2;0;2;0;0;0
2228330;Package Dudes;;0 - 20,000;2;2;0;0;0;0
2228400;Unsolved Case: Fatal Clue Collector's Edition;;0 - 20,000;1;0;1;0;0;0
2228730;Mountain Parkour;;0 - 20,000;0;5;-5;0;0;0
2228890;A Lonely Cabin Trip;;0 - 20,000;12;3;9;0;0;0
2228960;Ninja VS Zombies;;0 - 20,000;2;2;0;0;0;0
2229080;Beauty from Wisdom;;0 - 20,000;1;9;-8;0;0;0
2229170;pata;;0 - 20,000;1;0;1;0;0;0
2229380;Dance Fight;;0 - 20,000;5;1;4;0;0;0
2229420;Cleaning Queens;;0 - 20,000;1;2;-1;0;0;0
2229440;The Alien Space Cat;;0 - 20,000;0;1;-1;0;0;0
2229670;Lucy´s World;;0 - 20,000;2;0;2;0;0;0
2229990;DARK NIGHT WITH FLOPPA;;0 - 20,000;175;15;160;0;0;3
2230030;Resultarias;;0 - 20,000;5;0;5;0;0;0
2230040;2 Many Pixels;;0 - 20,000;1;0;1;0;0;0
2230120;Inky & Blinky;;0 - 20,000;0;1;-1;0;0;0
2230220;Wilderless;;0 - 20,000;29;8;21;0;0;3
2230250;Labyrinth of Chaos;;0 - 20,000;0;1;-1;0;0;0
2230280;Tiny Civilization;;50,000 - 100,000;679;38;641;85;95;66
2230300;NIKKA : RISE;;0 - 20,000;1;3;-2;0;0;0
2230330;Pot Farmer;;0 - 20,000;2;0;2;0;0;0
2230540;Open Fishing XL;;0 - 20,000;8;1;7;0;0;0
2230630;Web or Dead;;0 - 20,000;4;0;4;0;0;0
2230770;Overrun Survivors;;0 - 20,000;10;3;7;0;0;5
2230790;Scary pictures: Yavez - seven deadly sins;;20,000 - 50,000;6;2;4;0;0;0
2230800;Secret Diaries: Manage a Manor;;0 - 20,000;8;1;7;0;0;3
2230890;Foxventures;;0 - 20,000;0;6;-6;0;0;0
2230900;Magic Corgi;;0 - 20,000;0;5;-5;0;0;0
2230910;Tasty Defense;;0 - 20,000;0;7;-7;0;0;0
2230920;Logic and Candy;;0 - 20,000;0;5;-5;0;0;0
2231000;Match Day & International Match Day (C64/CPC/Spectrum);;0 - 20,000;1;0;1;0;0;1
2231080;Sword of Fargoal;;20,000 - 50,000;2;0;2;0;0;1
2231160;The Past;;0 - 20,000;5;1;4;0;0;0
2231380;Tom Clancy's Ghost Recon Breakpoint;;50,000 - 100,000;1817;1279;538;592;688;1428
2231450;Pizza Tower;;100,000 - 200,000;5963;40;5923;740;916;2423
2231490;Squared;;20,000 - 50,000;1;0;1;0;0;0
2231530;Idle Drift Kings;;0 - 20,000;2;1;1;0;0;0
2231610;Secret Dimension;;0 - 20,000;1;1;0;0;0;0
2231630;Chorus of the Night;;20,000 - 50,000;3;1;2;0;0;0
2231700;Crazy World VR;;0 - 20,000;1;0;1;0;0;0
2231730;Stay Still;;0 - 20,000;22;18;4;0;0;2
2231740;TRADER LIFE SIMULATOR 2;;0 - 20,000;183;46;137;97;97;34
2231920;Die Känguru-Verschwörung;;0 - 20,000;35;2;33;0;0;0
2232040;Exalted Seracthon;;0 - 20,000;1;0;1;0;0;0
2232130;Doggerfall;;0 - 20,000;11;3;8;0;0;2
2232190;Temple and Secrets;;0 - 20,000;1;0;1;0;0;0
2232200;First Snow;;0 - 20,000;54;7;47;0;0;0
2232290;From The Rain;;20,000 - 50,000;25;2;23;0;0;0
2232350;SHATTER;;0 - 20,000;3;1;2;0;0;1
2232380;Glory to the Robots!;;0 - 20,000;9;2;7;0;0;1
2232660;Call of the Abyss;;0 - 20,000;11;3;8;0;0;1
2233110;MazeCraft;;0 - 20,000;3;3;0;0;0;0
2233140;Double Line Confrontation：New World（双线交锋：新世界）;;0 - 20,000;4;0;4;0;0;0
2233240;CyberHeroes Arena DX;;0 - 20,000;1;1;0;0;0;0
2233270;God Busters : Who watches the watchers?;;0 - 20,000;4;0;4;0;0;0
2233320;Trouble In Space;;0 - 20,000;3;0;3;0;0;0
2233370;DICED Pilot;;0 - 20,000;2;0;2;0;0;0
2233510;City of Scary Zombies;;0 - 20,000;1;5;-4;0;0;0
2233520;Dotgeon;;0 - 20,000;0;5;-5;0;0;0
2233590;mummification;;0 - 20,000;1;1;0;0;0;0
2233700;Last Night in Zombie Village;;0 - 20,000;3;1;2;0;0;0
2233860;タイピングで愛を伝えよ;;0 - 20,000;3;0;3;0;0;0
2233890;Prison Wars;;0 - 20,000;13;2;11;0;0;0
2233900;CATACOMBS: The Beginning;;0 - 20,000;10;2;8;0;0;0
2234100;Deadly Platform;;0 - 20,000;3;0;3;0;0;0
2234150;BACKROOMS: APPREHENSION;;0 - 20,000;19;2;17;0;0;3
2234190;Artificial Wallpaper;;20,000 - 50,000;2;0;2;0;0;1
2234260;BeatPlane;;0 - 20,000;0;1;-1;0;0;0
2234310;TUMBLE;;0 - 20,000;0;1;-1;0;0;0
2234320;You're Fired! Revenge!;;0 - 20,000;3;0;3;0;0;0
2234370;Grinded Meat;;0 - 20,000;5;1;4;0;0;0
2234390;JLGJ;;0 - 20,000;1;0;1;0;0;0
2234420;Flower Memories;;0 - 20,000;12;0;12;0;0;0
2234440;idle Party Leader;;0 - 20,000;1;1;0;0;0;0
2234600;See You Later;;0 - 20,000;29;0;29;0;0;0
2234720;Project Sail;;0 - 20,000;1;0;1;0;0;0
2234820;That's a lot of pixels!;;0 - 20,000;4;1;3;0;0;0
2234920;Holiday Haywire;;0 - 20,000;8;1;7;0;0;0
2234930;The Last Hair;;0 - 20,000;9;0;9;0;0;1
2235090;回溯勇者 Backdate Hero;;0 - 20,000;22;2;20;0;0;1
2235140;Spring Puzzle;;0 - 20,000;0;1;-1;0;0;0
2235250;Crystal Winter;;100,000 - 200,000;22;1;21;0;0;22
2235390;Detective Rosie Morgan: Death at a Dinner Party;;0 - 20,000;1;0;1;0;0;0
2235450;Marble Ball Racing 2022;;0 - 20,000;0;1;-1;0;0;0
2235500;Forest Of Relics;;0 - 20,000;30;2;28;0;0;1
2235530;The Green Room Experiment (Episode 1);;0 - 20,000;2;0;2;0;0;0
2235610;Sakura Mirror;;0 - 20,000;12;5;7;0;0;2
2235670;Changeling Charade;;0 - 20,000;5;0;5;0;0;2
2236230;Christmas Stories: Taxi of Miracles Collector's Edition;;0 - 20,000;2;1;1;0;0;2
2236320;Ice Battle;;0 - 20,000;0;6;-6;0;0;0
2236330;Demonic Labyrinth;;0 - 20,000;0;5;-5;0;0;0
2236340;Talevania;;0 - 20,000;0;5;-5;0;0;0
2236350;Medieval Defence;;0 - 20,000;0;5;-5;0;0;0
2236360;Medieval towers;;0 - 20,000;0;5;-5;0;0;0
2236370;Prisonfall;;0 - 20,000;0;5;-5;0;0;0
2236380;UfoScare;;0 - 20,000;0;5;-5;0;0;0
2236390;Forest towers;;0 - 20,000;0;5;-5;0;0;0
2236480;僵尸（THE JIANG SHI）;;0 - 20,000;9;3;6;0;0;1
2236490;Lost Abroad Café: A Language Learning Management Sim;;0 - 20,000;3;0;3;0;0;0
2236730;Jedi Survive;;0 - 20,000;6;3;3;0;0;0
2236780;Zombie World Pixel;;0 - 20,000;1;4;-3;0;0;1
2236790;Cool Cats;;0 - 20,000;0;1;-1;0;0;0
2236800;Elves Castle and Secrets;;0 - 20,000;1;0;1;0;0;0
2236810;Medieval and Secrets;;0 - 20,000;1;0;1;0;0;0
2236820;Anyone There?;;0 - 20,000;3;1;2;0;0;0
2236960;Qiybz;;0 - 20,000;0;1;-1;0;0;0
2237010;ThanksKilling Day;;20,000 - 50,000;5;0;5;0;0;0
2237070;Deathtide Survivors;;0 - 20,000;20;4;16;0;0;3
2237090;Fast Coffee Simulator;;0 - 20,000;0;1;-1;0;0;0
2237350;100 Keys To Your Heart;;0 - 20,000;12;0;12;0;0;0
2237370;Cubis;;0 - 20,000;5;0;5;0;0;1
2237510;Polaroid;;0 - 20,000;7;2;5;0;0;0
2237720;Grievous Survivors;;50,000 - 100,000;5;0;5;0;0;0
2237770;Mummy Rumble VR;;0 - 20,000;0;1;-1;0;0;0
2237800;Dragon's Treasure;;0 - 20,000;14;4;10;0;0;0
2237820;Aeolus Fighter;;0 - 20,000;2;1;1;0;0;0
2237940;IN THE BUILDING: CATS 2;;20,000 - 50,000;10;1;9;0;0;0
2238000;Jump Jump;;0 - 20,000;2;1;1;0;0;0
2238080;Pretty Dancer;;0 - 20,000;1;3;-2;0;0;0
2238200;Roll Ball;;0 - 20,000;0;1;-1;0;0;0
2238240;Backrooms Mainframe;;0 - 20,000;2;7;-5;0;0;3
2238270;ComputerKeyboard;;0 - 20,000;0;1;-1;0;0;0
2238310;The Cooking Class;;0 - 20,000;9;2;7;0;0;1
2238340;Lendas do Pebol: Mythic Football;;0 - 20,000;2;0;2;0;0;0
2238350;AutoSim 2;;0 - 20,000;2;0;2;0;0;1
2238750;LOST EGG 3: The Final;;0 - 20,000;37;7;30;58;58;9
2238780;Sky Goddess Remaking;;0 - 20,000;0;2;-2;0;0;0
2238810;《乱步馆》-断崖 -Precipice;;50,000 - 100,000;1;0;1;0;0;0
2238890;DancingSim;;0 - 20,000;25;36;-11;0;0;1
2238970;推箱子;;0 - 20,000;0;2;-2;0;0;1
2239000;The Forgotten Tapes: Analog Nightmares;;20,000 - 50,000;26;2;24;0;0;0
2239020;Pitch Silent;;0 - 20,000;0;0;0;0;0;0
2239060;勇者起源;;0 - 20,000;0;1;-1;0;0;0
2239550;Watch Dogs: Legion;;50,000 - 100,000;916;758;158;669;942;483
2239730;小厨杂记;;0 - 20,000;5;0;5;0;0;0
2239850;One Tap Golf VR;;0 - 20,000;0;1;-1;0;0;0
2240030;Girls Eliminate;;0 - 20,000;0;2;-2;0;0;0
2240130;Towering;;0 - 20,000;0;1;-1;0;0;0
2240320;A dream that never wakes up;;0 - 20,000;2;0;2;0;0;0
2240360;虹城;;0 - 20,000;1;1;0;0;0;0
2240430;ResttW;;0 - 20,000;3;0;3;0;0;0
2240450;Helga the Viking Warrior 2: Ivar's Revenge;;0 - 20,000;2;0;2;0;0;1
2240470;Amanda's Magic Book 6: Aladdin's Magic Lamp;;0 - 20,000;2;0;2;0;0;0
2240600;シンセティック・デイズ;;0 - 20,000;2;0;2;0;0;1
2240660;Seventh Star;;0 - 20,000;15;0;15;0;0;1
2240700;Simple Rally;;0 - 20,000;7;2;5;0;0;0
2240900;The King's Feast;;0 - 20,000;3;0;3;0;0;0
2241020;Garbage Truck Simulator;;0 - 20,000;22;7;15;0;0;5
2241200;Dyztopia: Post-Human RPG;;0 - 20,000;6;0;6;0;0;0
2241220;Beneath Her Starry Sky;;20,000 - 50,000;4;0;4;0;0;1
2241240;DUNGEON WALK－竜迷宮の管理者－;;0 - 20,000;3;2;1;0;0;0
2241390;Spelp;;50,000 - 100,000;36;3;33;0;0;4
2241540;Attack Zone;;0 - 20,000;1;0;1;0;0;0
2241560;Angel's Gear;;0 - 20,000;47;15;32;0;0;10
2241590;Mage Ball;;0 - 20,000;3;0;3;0;0;0
2241620;Starless Hotel;;0 - 20,000;1;3;-2;0;0;0
2241710;Gravlist;;0 - 20,000;1;0;1;0;0;0
2241760;MotorCubs RC;;0 - 20,000;4;1;3;0;0;0
2241860;World of Fate;;0 - 20,000;23;30;-7;0;0;4
2241880;Gunslinger Top down shooter;;0 - 20,000;1;0;1;0;0;0
2241910;Sweets Pusher Friends;;0 - 20,000;39;21;18;1677;1677;0
2241920;Stay Human;;0 - 20,000;6;0;6;0;0;0
2242090;Midnight Alert;;0 - 20,000;1;1;0;0;0;0
2242100;Fargone;;0 - 20,000;90;19;71;0;0;24
2242130;Summer Village;;0 - 20,000;1;0;1;0;0;0
2242220;Forest Fire;;0 - 20,000;35;2;33;0;0;4
2242360;Ferus-The dark abyss;;50,000 - 100,000;0;1;-1;0;0;0
2242500;Cartoon Cagematch;;0 - 20,000;4;0;4;0;0;0
2242610;Time Thief;;0 - 20,000;6;1;5;0;0;0
2242760;The Escape: Together;;0 - 20,000;159;37;122;0;0;44
2242810;Ninety-Six;;0 - 20,000;10;0;10;0;0;1
2242890;Grim Knight;;0 - 20,000;3;0;3;0;0;0
2243000;Medieval Tales Solitaire;;0 - 20,000;1;0;1;0;0;0
2243040;The Cleaner;;0 - 20,000;10;3;7;0;0;1
2243060;Moley Christmas;;0 - 20,000;0;1;-1;0;0;0
2243130;Remy Raccoon and the Lost Temple - Festive Frolics (Volume 2);;0 - 20,000;1;0;1;0;0;0
2243140;Guns & Fishes;;0 - 20,000;22;0;22;0;0;1
2243550;Vega;;0 - 20,000;7;1;6;0;0;0
2243920;The 2nd page of the medical examination diary: Another story of exciting days of me and my senpai;;0 - 20,000;27;6;21;0;0;3
2244090;Miss LU;;0 - 20,000;1;3;-2;0;0;0
2244150;Tristia:restore;;0 - 20,000;9;2;7;0;0;2
2244160;Tristia:legacy;;0 - 20,000;28;4;24;0;0;8
2244330;Crossroad of Worlds: Mystery Agency Collector's Edition;;0 - 20,000;1;0;1;0;0;0
2244420;情人泪;;0 - 20,000;40;24;16;0;0;1
2244530;Christmas Land: Opposite Worlds;;0 - 20,000;2;2;0;0;0;0
2244550;Don't Steal My Christmas!;;0 - 20,000;10;0;10;0;0;0
2244620;Blacklight;;0 - 20,000;8;0;8;0;0;0
2244640;Trophy Chaser;;0 - 20,000;25;3;22;0;0;0
2244770;Stonga Bird;;0 - 20,000;8;1;7;0;0;0
2245450;Champ at Dawn;;0 - 20,000;1;0;1;0;0;0
2245670;Stella's Pointless Castle Awakening;;0 - 20,000;1;0;1;0;0;0
2245700;Idle Game x100;;0 - 20,000;6;4;2;0;0;2
2245840;ZAVOD;;0 - 20,000;12;1;11;0;0;0
2245900;Tennis Online Duel;;0 - 20,000;3;0;3;0;0;0
2246070;回响之战;;0 - 20,000;1;0;1;0;0;0
2246120;Coralina;;0 - 20,000;130;7;123;0;0;3
2246310;A Rum Tale;;0 - 20,000;3;3;0;0;0;0
2246350;Backroom Warfare II;;0 - 20,000;7;2;5;0;0;0
2246390;Void: Edge of Existence;;0 - 20,000;1;0;1;0;0;0
2246400;Confabulation;;0 - 20,000;47;0;47;0;0;7
2246550;Interkosmos 2000;;50,000 - 100,000;3;2;1;0;0;1
2246820;Lord of Bones;;0 - 20,000;2;0;2;0;0;0
2246940;Only A Dream;;0 - 20,000;7;1;6;0;0;0
2247080;Glyph Guesser;;0 - 20,000;2;0;2;0;0;0
2247340;DIY - CAD Designer;;0 - 20,000;2;0;2;0;0;0
2247480;Pixel Slayer;;0 - 20,000;2;5;-3;0;0;0
2247670;Hide and Seek;;0 - 20,000;3;0;3;0;0;0
2247680;Read Clock Time;;0 - 20,000;10;2;8;0;0;0
2247750;Drive Maker;;0 - 20,000;5;0;5;0;0;0
2247820;Rogue Station;;0 - 20,000;31;3;28;0;0;7
2247880;游戏策划面试模拟器;;0 - 20,000;2;0;2;0;0;0
2248340;UNRESTRAINED;;0 - 20,000;13;5;8;0;0;0
2248350;Taste of War;;0 - 20,000;12;0;12;0;0;0
2248390;Citadelic;;0 - 20,000;4;0;4;0;0;3
2248810;Dungeon Shooter : Dark Temple;;0 - 20,000;3;1;2;0;0;0
2248880;The Cullfield Ritual;;0 - 20,000;2;2;0;0;0;0
2248920;Super Kids Racing : Mini Edition;;0 - 20,000;0;1;-1;0;0;0
2249020;Mindbytes: Learn to Read Japanese;;0 - 20,000;0;1;-1;0;0;0
2249160;September 7th;;20,000 - 50,000;595;101;494;30;30;24
2249320;Metal Detecting Simulator;;0 - 20,000;3;1;2;0;0;0
2249540;Remember U;;0 - 20,000;1;1;0;0;0;0
2249730;The Great Artists;;0 - 20,000;1;0;1;0;0;0
2249830;《奇门遁甲》;;0 - 20,000;162;24;138;0;0;21
2249960;Jetpack George!;;0 - 20,000;2;0;2;0;0;0
2250100;Red Flower;;0 - 20,000;0;1;-1;0;0;0
2250110;Blue Sky;;0 - 20,000;1;2;-1;0;0;0
2250180;Don't blame you;;0 - 20,000;6;1;5;0;0;0
2250210;Office Mayhem;;0 - 20,000;0;1;-1;0;0;0
2250250;Mighty Mage;;0 - 20,000;4;2;2;0;0;0
2250290;Castle Capture Topkapi;;0 - 20,000;5;0;5;0;0;0
2250340;I commissioned some bunnies;;0 - 20,000;27;0;27;0;0;4
2250710;Sapu;;0 - 20,000;9;1;8;0;0;1
2250820;Party Party Time;;0 - 20,000;4;0;4;0;0;1
2250870;XenoFeud;;0 - 20,000;4;0;4;0;0;0
2251030;Mutant Monty (C64/CPC/Spectrum);;0 - 20,000;2;0;2;0;0;0
2251120;League Manager 2023;;0 - 20,000;39;23;16;0;0;5
2251240;Police Car Simulator;;0 - 20,000;3;8;-5;0;0;1
2251410;Hike Isle;;0 - 20,000;8;3;5;0;0;0
2251480;Crowd Medieval City War;;0 - 20,000;1;1;0;0;0;0
2251540;IBIS AM;;0 - 20,000;1;0;1;0;0;1
2251680;Epic Assassin;;20,000 - 50,000;5;2;3;0;0;0
2251810;Hole in Won;;0 - 20,000;18;1;17;0;0;0
2251870;The Backrooms - Nightmare Dimension;;0 - 20,000;0;3;-3;0;0;0
2252170;World Soccer Kid;;0 - 20,000;1;1;0;0;0;0
2252550;Hope;;0 - 20,000;13;0;13;0;0;0
2252830;Johnny Explorer;;0 - 20,000;1;0;1;0;0;0
2252850;IN THE BUILDING: CATS 3;;0 - 20,000;16;3;13;0;0;0
2253290;My Grandparents' Christmas Mystery;;0 - 20,000;17;2;15;0;0;0
2253360;Mistcaller;;0 - 20,000;2;0;2;0;0;0
2253490;X-Sports;;0 - 20,000;1;1;0;0;0;1
2253560;Terix Survivors;;0 - 20,000;3;0;3;0;0;0
2253730;Madorica Real Estate 2 - The mystery of the new property -;;0 - 20,000;12;0;12;0;0;2
2253740;国产手机帝国-Mobile phone empire;;0 - 20,000;1;2;-1;0;0;0
2253880;Christmas Wonderland 13: Collector's Edition;;0 - 20,000;0;1;-1;0;0;0
2253910;Mothership Forever;;0 - 20,000;7;1;6;0;0;0
2253950;Race in Desert;;0 - 20,000;2;1;1;0;0;0
2254020;Take Care VR;;0 - 20,000;3;0;3;0;0;0
2254110;Old Bira´s Farm;;0 - 20,000;5;0;5;0;0;0
2254200;ShiodomeTrainSimulator;;0 - 20,000;1;0;1;0;0;0
2254310;Mecha Blade;;50,000 - 100,000;1;0;1;0;0;0
2254390;Neptune's Garden;;0 - 20,000;1;0;1;0;0;0
2254540;Grip on Reality;;100,000 - 200,000;1;0;1;0;0;0
2254550;2032: A New Threat;;0 - 20,000;0;1;-1;0;0;0
2254600;Let's Pet Pets;;0 - 20,000;61;0;61;0;0;7
2254750;Black cotton: Wuneng;;20,000 - 50,000;26;9;17;0;0;0
2254830;DiggerSim - Excavator & Heavy Equipment Simulator VR;;0 - 20,000;2;1;1;0;0;0
2255020;Qdice;;0 - 20,000;2;0;2;0;0;0
2255050;The Sword That Kills Christmas;;0 - 20,000;2;0;2;0;0;0
2255290;EL NE RUE;;0 - 20,000;21;3;18;0;0;0
2255310;Px2d;;0 - 20,000;5;0;5;0;0;1
2255350;Wild Seas;;0 - 20,000;8;0;8;0;0;0
2255380;Sass VS Fash: Girlballs of Steel;;0 - 20,000;4;4;0;0;0;0
2255480;Idle Banshee Alliance;;0 - 20,000;14;3;11;0;0;20
2255850;Beat animals;;0 - 20,000;1;0;1;0;0;0
2255860;Cut fruit;;0 - 20,000;0;1;-1;0;0;0
2255930;魔女の館;;0 - 20,000;2;0;2;0;0;0
2256030;The Militant Mouse;;0 - 20,000;14;0;14;0;0;0
2256290;Roxroria: An Island Of Treasures;;0 - 20,000;0;1;-1;0;0;0
2256520;Gunslinger Nova;;0 - 20,000;2;0;2;0;0;0
2256550;Choi;;0 - 20,000;5;0;5;0;0;0
2256770;Old Shadow;;0 - 20,000;2;2;0;0;0;0
2256880;Duplicado;;0 - 20,000;3;0;3;0;0;0
2256990;Road Trucker;;0 - 20,000;1;2;-1;0;0;0
2257030;SlimeCatcher;;0 - 20,000;1;0;1;0;0;0
2257050;Flaming Thunderer;;0 - 20,000;10;0;10;0;0;0
2257060;Lone Traveler;;0 - 20,000;10;0;10;0;0;0
2257070;Crime Scene;;0 - 20,000;11;1;10;0;0;0
2257260;PK Girls;;0 - 20,000;1;3;-2;0;0;0
2257380;Easy Game;;;;;0;;;
2257450;Nash Racing: 70 seconds left;;0 - 20,000;7;6;1;0;0;0
2257580;Candy Arkanoid;;0 - 20,000;1;0;1;0;0;0
2257790;Trapers Platformer;;0 - 20,000;3;1;2;0;0;1
2257870;A Legend of Wisdom Part I;;50,000 - 100,000;3;1;2;0;0;0
2257870;A Legend of Wisdom Part I;;50,000 - 100,000;3;1;2;0;0;0
2258040;World of Turtle;;0 - 20,000;5;0;5;0;0;0
2258110;Sphere Game Legendary;;0 - 20,000;5;0;5;0;0;0
2258120;Orcs Coming TD;;0 - 20,000;5;5;0;0;0;1
2258420;PINHI!;;0 - 20,000;1;0;1;0;0;0
2258550;Demon Invasion: Endless;;0 - 20,000;2;1;1;0;0;0
2258590;富甲天下3;;0 - 20,000;203;50;153;0;0;126
2258790;Activate: 激活;;0 - 20,000;2;0;2;0;0;0
2258830;NOTHING TO LOSE;;20,000 - 50,000;3;0;3;0;0;0
2258910;Horror Tale 2: Samantha;;0 - 20,000;13;2;11;0;0;0
2258960;Adventure with the Goddess;;0 - 20,000;5;1;4;0;0;0
2259050;Valkyrie: Dawn of Ragnarok;;50,000 - 100,000;0;1;-1;0;0;0
2260030;Delirium;;0 - 20,000;1;0;1;0;0;0
2260260;Hack and Shoot Heroes;;0 - 20,000;0;7;-7;0;0;1
2260360;Zooblies;;0 - 20,000;5;0;5;0;0;0
2260420;Mushroom Agent;;0 - 20,000;14;3;11;0;0;0
2260540;Endless Nesla;;0 - 20,000;19;0;19;0;0;2
2260720;Fast Burger Simulator;;0 - 20,000;11;3;8;0;0;0
2261070;Chinese Rail SIm;;0 - 20,000;18;7;11;0;0;1
2261090;三國立志傳;;0 - 20,000;21;0;21;0;0;6
2261240;Nope Nope Nope Nurses;;0 - 20,000;44;4;40;0;0;8
2261280;WHITE WATER;;0 - 20,000;1;0;1;0;0;0
2261290;ALPO : Way home;;0 - 20,000;1;0;1;0;0;0
2261410;Bargain Blocz;;0 - 20,000;0;1;-1;0;0;0
2261420;BoxLoop 2;;0 - 20,000;1;0;1;0;0;0
2261440;BallZ;;0 - 20,000;2;0;2;0;0;0
2261650;Pet Dragon Girl;;0 - 20,000;0;0;0;0;0;0
2261660;My Neighbor Neko;;0 - 20,000;8;7;1;0;0;1
2261690;Kitten Kingdom;;0 - 20,000;0;1;-1;0;0;0
2261750;Towers Deck;;0 - 20,000;4;2;2;0;0;0
2261760;Simp;;0 - 20,000;0;1;-1;0;0;0
2262070;INVASION;;0 - 20,000;14;1;13;0;0;0
2262180;Brazen Thief;;0 - 20,000;2;0;2;0;0;0
2262230;Bargain Toader;;0 - 20,000;0;2;-2;0;0;0
2262580;Monsters Mess;;0 - 20,000;2;0;2;0;0;0
2262620;Broombot Battlegrounds;;0 - 20,000;4;1;3;0;0;1
2262680;Epic Race: The Stadium;;0 - 20,000;1;0;1;0;0;0
2262750;Space Escaper;;0 - 20,000;0;1;-1;0;0;0
2262790;Lingyao Garden | 虚空灵药园;;0 - 20,000;6;0;6;0;0;0
2262910;That Last Girl;;0 - 20,000;2;1;1;0;0;0
2262960;Artur's Pinball;;0 - 20,000;5;1;4;0;0;0
2263040;一个人的木偶剧;;0 - 20,000;1;0;1;0;0;0
2263170;Maiz;;0 - 20,000;21;1;20;0;0;0
2263220;Inmortuae Metuunt: Rise of The Undead;;0 - 20,000;5;0;5;0;0;0
2263240;Deep In The Snowy Night;;0 - 20,000;1;0;1;0;0;0
2263260;House of Shadow;;0 - 20,000;4;0;4;0;0;0
2263340;The Duck Song Game;;0 - 20,000;2;1;1;0;0;0
2263390;Lawnmower Game: Ufo Chase;;0 - 20,000;19;5;14;0;0;0
2263510;The Simulacrum;;0 - 20,000;34;2;32;0;0;6
2263550;Touch the Color;;0 - 20,000;1;0;1;0;0;0
2263560;Eternal Fidelity;;0 - 20,000;10;0;10;0;0;0
2263570;Unusual Ghost;;0 - 20,000;11;0;11;0;0;0
2263710;T-Rex Dinosaur Game;;0 - 20,000;1;0;1;0;0;0
2263960;Ultra Fishing;;0 - 20,000;1;1;0;0;0;0
2264200;Domination - War of Nations;;0 - 20,000;5;0;5;0;0;1
2264240;Waiter;;0 - 20,000;1;0;1;0;0;0
2264300;FULLYBROKEN: WAY HOME;;0 - 20,000;1;0;1;0;0;0
2264460;UnderBackrooms;;0 - 20,000;24;35;-11;0;0;0
2264500;Guacomole;;0 - 20,000;5;1;4;0;0;0
2264500;Guacomole;;0 - 20,000;5;1;4;0;0;0
2264550;Fliese;;0 - 20,000;2;0;2;0;0;0
2264700;Infinite Mirror;;0 - 20,000;6;0;6;0;0;0
2264740;Highway Speeder;;0 - 20,000;4;0;4;0;0;3
2265000;Penguin Adventure;;0 - 20,000;0;1;-1;0;0;0
2265010;草食系男子の言いなり入院生活- A passive boy at the Huntress clinic -;;0 - 20,000;1;0;1;0;0;0
2265040;Cracks In Hell;;0 - 20,000;8;1;7;0;0;1
2265130;Survivor:Stay In The Light;;0 - 20,000;1;1;0;0;0;0
2266080;Archer Hero Must Die;;0 - 20,000;0;1;-1;0;0;0
2266320;The You Testament: The 2D Coming;;0 - 20,000;21;1;20;0;0;2
2266410;Drifting with Maxwell Cat: The Game;;0 - 20,000;25;7;18;0;0;3
2266720;Square Life;;0 - 20,000;6;1;5;0;0;0
2266790;键盘侠Keyboardmen;;0 - 20,000;1;0;1;0;0;0
2267010;Kong Hero;;0 - 20,000;0;1;-1;0;0;0
2267040;Light the Backrooms;;0 - 20,000;2;0;2;0;0;0
2267100;Animal Kingdom;;0 - 20,000;0;1;-1;0;0;1
2267170;Vradark's Revenge;;0 - 20,000;1;0;1;0;0;0
2267220;TAMERLANE;;0 - 20,000;5;0;5;0;0;0
2267320;Myristica;;0 - 20,000;2;1;1;0;0;0
2267480;Sandbox War Dispatch;;20,000 - 50,000;1;0;1;0;0;0
2267520;建造师模拟器 Constructor simulator;;0 - 20,000;0;1;-1;0;0;0
2267590;Her Feet;;0 - 20,000;4;6;-2;0;0;1
2267770;Xploquest 3;;0 - 20,000;7;0;7;0;0;1
2267800;Swordy Quest VR;;0 - 20,000;0;1;-1;0;0;0
2267940;Adventurer Flower;;0 - 20,000;1;0;1;0;0;0
2268040;Tracadie Bird Shit;;0 - 20,000;6;0;6;0;0;0
2268110;Hike Valley;;0 - 20,000;7;0;7;0;0;0
2268310;Cookie Match: Enhanced Edition;;0 - 20,000;0;1;-1;0;0;0
2268440;Aby's Playground;;0 - 20,000;1;0;1;0;0;0
2268460;Dark Shrine;;0 - 20,000;2;1;1;0;0;0
2268540;Fall and Destroy;;0 - 20,000;30;3;27;0;0;0
2268720;Mullet Hell;;0 - 20,000;5;0;5;0;0;0
2269120;The Dark Side Of Mars;;20,000 - 50,000;1;1;0;0;0;0
2269320;Natti;;0 - 20,000;14;1;13;0;0;54
2269420;PHANOTIA I: ESCAVIVE;;50,000 - 100,000;4;0;4;0;0;0
2269460;創業王 CEO;;0 - 20,000;17;1;16;0;0;5
2269680;Tedram;;0 - 20,000;1;0;1;0;0;0
2269710;Mega Sudoku - Binary & Suguru;;0 - 20,000;3;0;3;0;0;0
2269770;CallOfTree;;0 - 20,000;0;1;-1;0;0;0
2269880;Battle of 2048 - Fantasy Edition;;0 - 20,000;2;0;2;0;0;0
2270000;Golden Gloves VR;;0 - 20,000;1;0;1;0;0;0
2270640;Grim Tales: The Time Traveler Collector's Edition;;0 - 20,000;1;0;1;0;0;0
2270700;Metal Punch;;0 - 20,000;1;1;0;0;0;0
2270920;Put Your Brain On 2;;0 - 20,000;0;1;-1;0;0;0
2270930;F1 Crazy Stunts;;0 - 20,000;0;1;-1;0;0;0
2270970;Fight & Crush;;0 - 20,000;1;1;0;0;0;0
2270990;School Flight Simulator;;0 - 20,000;0;1;-1;0;0;0
2271280;ROGLE;;0 - 20,000;3;2;1;0;0;0
2271300;Safehouse;;0 - 20,000;10;0;10;0;0;0
2271420;Abandoned drive-in | 廃ドライブイン;;0 - 20,000;5;4;1;0;0;1
2271480;Hike Trip;;0 - 20,000;6;1;5;0;0;0
2271940;Hug Survivor;;0 - 20,000;0;0;0;0;0;2
2272010;Minibots TD;;0 - 20,000;4;0;4;0;0;0
2272880;ParaSHOTical ARKtiviBeatings;;0 - 20,000;7;1;6;0;0;0
2273210;CryptoZoo;;0 - 20,000;2;0;2;0;0;0
2273390;Fantasya;;0 - 20,000;2;0;2;0;0;1
2273400;三国群英战略版;;0 - 20,000;2;1;1;0;0;0
2273440;可识此阵;;0 - 20,000;9;0;9;0;0;1
2273500;JOIN tiles - Anatolian game to play;;0 - 20,000;7;0;7;0;0;0
2273510;Winnie The Pooh: The Serial Killer;;0 - 20,000;6;0;6;0;0;0
2273820;Food Maze;;0 - 20,000;3;0;3;0;0;0
2273920;Wojak Rush;;0 - 20,000;2;0;2;0;0;0
2274010;Animal portal - Puzzle;;0 - 20,000;4;0;4;0;0;0
2274390;Lawbringer;;0 - 20,000;11;4;7;0;0;0
2274510;Hood Warfare;;0 - 20,000;12;4;8;0;0;0
2274700;Daily Dadish;;0 - 20,000;7;0;7;0;0;2
2274800;Agent Roy - Zombie Hunt;;0 - 20,000;8;3;5;0;0;0
2274860;Bus Simulator: Car Driving;;0 - 20,000;4;4;0;0;0;0
2274990;Bargain Invaders;;0 - 20,000;0;1;-1;0;0;0
2275180;In The Gym (Memes Horror Game);;0 - 20,000;10;1;9;0;0;2
2275230;Kindergarten secret;;50,000 - 100,000;4;2;2;0;0;0
2275650;Back Rank Chess;;0 - 20,000;12;0;12;0;0;0
2275870;EscapeGame TimelessRoom;;0 - 20,000;1;0;1;0;0;0
2276000;SUA;;0 - 20,000;3;2;1;0;0;0
2276060;Truck Simulator Ultimate 3D;;0 - 20,000;1;2;-1;0;0;0
2276270;8 Ball 3;;0 - 20,000;1;2;-1;0;0;0
2276440;鞭炮&烟花：春节模拟器Firecrackers&fireworks：china new year simulation;;0 - 20,000;27;8;19;0;0;0
2276540;Iron Sky: A Lunar Adventure;;0 - 20,000;3;1;2;0;0;0
2276580;Beef Jerky;;0 - 20,000;2;0;2;0;0;1
2277410;Under the Sky World~Another~;;0 - 20,000;5;2;3;0;0;0
2277610;Castle Destroyers;;0 - 20,000;1;0;1;0;0;0
2277780;Ara and the Empty Universe;;0 - 20,000;5;0;5;0;0;0
2278120;Break Everything - Park;;0 - 20,000;12;1;11;0;0;0
2278300;A Symmetric Escape;;0 - 20,000;3;0;3;0;0;0
2278380;Haunting of the Evil Spirit - Horror Choose your own adventure Novel;;0 - 20,000;1;0;1;0;0;0
2278920;SUBNET - Escape Room Adventure;;0 - 20,000;6;2;4;0;0;2
2279870;Project Nosferatu;;0 - 20,000;3;0;3;0;0;0
2279920;Meet Ball Girls;;0 - 20,000;2;2;0;0;0;0
2279930;Little Land War SRPG;;0 - 20,000;1;1;0;0;0;0
2280140;Merge Me!;;0 - 20,000;1;4;-3;0;0;3
2280220;GUNWATCH: Conflict Survival;;20,000 - 50,000;1;2;-1;0;0;0
2280460;Disgusting Puzzle;;0 - 20,000;3;0;3;0;0;0
2280510;Side Scape;;0 - 20,000;11;0;11;0;0;1
2280650;Dungeons and Myths 2;;0 - 20,000;0;1;-1;0;0;0
2280670;Fumpers;;0 - 20,000;2;0;2;0;0;1
2281130;EQUAL PEOPLE;;0 - 20,000;1;2;-1;0;0;0
2281470;YourTrain;;0 - 20,000;2;0;2;0;0;0
2281700;Crystal Storm;;0 - 20,000;2;0;2;0;0;0
2282330;Crime Passional;;0 - 20,000;7;1;6;0;0;3
2282540;Scary Turnaround;;0 - 20,000;17;4;13;0;0;0
2282700;Alien Battlefield;;0 - 20,000;8;0;8;0;0;0
2283240;Ultimate Flight Simulator Pro;;0 - 20,000;3;0;3;0;0;0
2283390;Komodo 3K Arena;;0 - 20,000;0;1;-1;0;0;0
2283490;Hexield;;0 - 20,000;1;0;1;0;0;0
2283670;Nurtured human Plan: Meet a Date！;;0 - 20,000;0;1;-1;0;0;0
2283690;The Adventures of LinShanHai;;0 - 20,000;25;1;24;0;0;1
2283850;The Justitia Files;;0 - 20,000;1;0;1;0;0;0
2283940;Ancient Guardians: The Dragon;;0 - 20,000;1;0;1;0;0;0
2284290;Aircraft Infinity;;0 - 20,000;3;0;3;0;0;0
2284430;小白的保卫战 Xiaobai's defense war;;0 - 20,000;8;0;8;0;0;0
2284530;Tears RAIN: Tears of Goddess;;0 - 20,000;1;0;1;0;0;0
2285160;Wak Attak;;0 - 20,000;2;0;2;0;0;0
2285540;Dutch's Chickens;;0 - 20,000;0;1;-1;0;0;0
2285620;WarfareBattle;;50,000 - 100,000;0;2;-2;0;0;0
2285860;Engineering - Mystery of the ancient clock;;0 - 20,000;4;0;4;0;0;0
2286200;Disgusting Puzzle 2;;0 - 20,000;1;0;1;0;0;0
2286510;Move Nature;;0 - 20,000;16;4;12;0;0;0
2286620;Styling Shop VR;;0 - 20,000;1;0;1;0;0;0
2286730;Sleight of Hand: Dominion;;0 - 20,000;3;1;2;0;0;0
2286800;高考夺魁记;;0 - 20,000;4;1;3;0;0;0
2286950;Find The Murderer 3;;50,000 - 100,000;2;0;2;0;0;0
2286990;Beep's Escape;;0 - 20,000;3;0;3;0;0;2
2287030;Sigformation;;0 - 20,000;1;0;1;0;0;0
2287060;Extreme Car Drift Simulator;;0 - 20,000;1;1;0;0;0;0
2287070;Omega Survivors;;0 - 20,000;2;0;2;0;0;0
2287360;Chess Defense Saga;;0 - 20,000;1;1;0;0;0;0
2287760;Brave Soldier - Invasion of Cyborgs;;0 - 20,000;38;0;38;0;0;1
2288480;Kiss Effect;;0 - 20,000;0;0;0;0;0;2
2288580;Berry Madness;;0 - 20,000;10;0;10;0;0;0
2288770;Lawnmower Game: Find Trump;;0 - 20,000;7;0;7;0;0;0
2289130;Weekend Warriors MMA;;0 - 20,000;8;1;7;0;0;3
2289670;Ghosting Vandal;;0 - 20,000;3;0;3;0;0;0
2290070;Army War: Shooting Simulator;;100,000 - 200,000;2;2;0;0;0;0
2291090;Toy Flying Car;;0 - 20,000;0;1;-1;0;0;0
2291190;Doodle TD;;0 - 20,000;1;0;1;0;0;0
2291220;Hill Climb;;0 - 20,000;2;0;2;0;0;0
2291490;City Ambulance Car Driving;;0 - 20,000;1;1;0;0;0;0
2292210;Pigskin Punter!;;0 - 20,000;8;0;8;0;0;0
2292360;Jigsaw Puzzle Lovers;;0 - 20,000;2;0;2;0;0;0
2292610;Horror Adventure;;0 - 20,000;0;1;-1;0;0;0
2292750;Mind The Pipes!;;0 - 20,000;2;0;2;0;0;0
2292940;Multiplayer Werewolves;;0 - 20,000;9;3;6;0;0;0
2293420;СИМУЛЯТОР ЛАЗАНЬЯ ПО ЗАБРОШКАМ;;0 - 20,000;11;10;1;0;0;10
2293510;The Last Pawn;;20,000 - 50,000;1;0;1;0;0;0
2293520;Roman Empire vs. Barbarians;;0 - 20,000;0;1;-1;0;0;0
2294790;Vivat Sloboda (2019);;0 - 20,000;2;0;2;0;0;0
2295580;Police Car Armored: Cop Simulator;;0 - 20,000;1;0;1;0;0;0
2295830;Jigsaw Realm 3D;;0 - 20,000;3;2;1;0;0;0
2296080;Sector 598;;20,000 - 50,000;1;0;1;0;0;0
2296790;Idlenetics;;0 - 20,000;1;5;-4;0;0;0
2296910;Book of Shadows;;0 - 20,000;0;1;-1;0;0;0
2296980;De Feet;;0 - 20,000;1;0;1;0;0;0
2297150;Taxi Driver Simulator: Car Parking;;0 - 20,000;1;1;0;0;0;1
2297320;Robot Room Cleaner;;0 - 20,000;1;0;1;0;0;1
2298060;Polyrhythm Master;;0 - 20,000;3;0;3;0;0;0
2298630;E30 Drift Car Simulator;;0 - 20,000;0;2;-2;0;0;0
2298990;Web Crawlies {Multiplayer};;0 - 20,000;3;1;2;0;0;0
2299070;OVE : The Sword of Liberation;;0 - 20,000;1;1;0;0;0;1
2299270;The Abyss;;0 - 20,000;3;1;2;0;0;0
2299610;連縁无現里 ~ Misremembered Memories;;0 - 20,000;4;0;4;0;0;0
2299890;CosmoOdyssey 2: Comeback to origin;;0 - 20,000;6;0;6;0;0;3
2300040;Gangster City: Mafia Car Driving;;0 - 20,000;0;1;-1;0;0;0
2300350;The Lone Alien;;20,000 - 50,000;12;0;12;0;0;0
2300390;I commissioned some cats;;0 - 20,000;9;0;9;0;0;4
2301370;Fantasy World Souls;;0 - 20,000;14;1;13;0;0;9
2302180;DESTROY Simulator VR;;0 - 20,000;0;1;-1;0;0;0
2302240;Gallery Manager;;0 - 20,000;6;0;6;0;0;1
2303300;Real Zombie War Simulator;;100,000 - 200,000;1;1;0;0;0;1
2303720;Multiplayer Cowboys;;0 - 20,000;7;1;6;0;0;2
2304030;天下霸圖;;0 - 20,000;41;4;37;0;0;171
2304130;Grounded Sim: Steam Edition;;0 - 20,000;5;0;5;0;0;0
2304230;I'm On Merrymaking Watch;;0 - 20,000;2;0;2;0;0;0
2304340;Jack the Nipper II (C64/CPC/Spectrum);;0 - 20,000;1;0;1;0;0;0
2304680;Tofas Sahin: Online Car Driving;;0 - 20,000;18;4;14;0;0;3
2306160;MULTIPLAYER KNIGHTS;;0 - 20,000;3;3;0;0;0;2
2306390;Soul Knight: The Forest of Spirits;;0 - 20,000;11;0;11;0;0;0
